State FIPS Code,County FIPS Code,County,Year,Labor Force Size,Employed,Unemployed,Unemployment Rate
1,1,Autauga,2000,21861,20971,890,4.1
1,3,Baldwin,2000,69979,67370,2609,3.7
1,5,Barbour,2000,11449,10812,637,5.6
1,7,Bibb,2000,8623,8160,463,5.4
1,9,Blount,2000,25266,24375,891,3.5
1,11,Bullock,2000,3997,3656,341,8.5
1,13,Butler,2000,9221,8496,725,7.9
1,15,Calhoun,2000,53244,50522,2722,5.1
1,17,Chambers,2000,17486,16709,777,4.4
1,19,Cherokee,2000,11378,10862,516,4.5
1,21,Chilton,2000,19601,18752,849,4.3
1,23,Choctaw,2000,6226,5815,411,6.6
1,25,Clarke,2000,11677,10814,863,7.4
1,27,Clay,2000,6608,6199,409,6.2
1,29,Cleburne,2000,7002,6715,287,4.1
1,31,Coffee,2000,20037,18861,1176,5.9
1,33,Colbert,2000,26124,24657,1467,5.6
1,35,Conecuh,2000,5521,5158,363,6.6
1,37,Coosa,2000,5329,5038,291,5.5
1,39,Covington,2000,17436,16221,1215,7.0
1,41,Crenshaw,2000,6155,5800,355,5.8
1,43,Cullman,2000,38898,37274,1624,4.2
1,45,Dale,2000,20923,19820,1103,5.3
1,47,Dallas,2000,17948,16487,1461,8.1
1,49,DeKalb,2000,32516,31194,1322,4.1
1,51,Elmore,2000,31195,29944,1251,4.0
1,53,Escambia,2000,16199,15348,851,5.3
1,55,Etowah,2000,48496,45652,2844,5.9
1,57,Fayette,2000,8332,7839,493,5.9
1,59,Franklin,2000,14729,13756,973,6.6
1,61,Geneva,2000,12261,11631,630,5.1
1,63,Greene,2000,3534,3291,243,6.9
1,65,Hale,2000,7023,6596,427,6.1
1,67,Henry,2000,7684,7302,382,5.0
1,69,Houston,2000,45464,43444,2020,4.4
1,71,Jackson,2000,28083,26612,1471,5.2
1,73,Jefferson,2000,331141,317868,13273,4.0
1,75,Lamar,2000,7497,6970,527,7.0
1,77,Lauderdale,2000,43733,41531,2202,5.0
1,79,Lawrence,2000,16682,15843,839,5.0
1,81,Lee,2000,58396,56042,2354,4.0
1,83,Limestone,2000,33039,31770,1269,3.8
1,85,Lowndes,2000,5087,4732,355,7.0
1,87,Macon,2000,9139,8606,533,5.8
1,89,Madison,2000,149626,144268,5358,3.6
1,91,Marengo,2000,9072,8594,478,5.3
1,93,Marion,2000,14302,13339,963,6.7
1,95,Marshall,2000,40809,38836,1973,4.8
1,97,Mobile,2000,186171,176895,9276,5.0
1,99,Monroe,2000,10343,9669,674,6.5
1,101,Montgomery,2000,106415,101919,4496,4.2
1,103,Morgan,2000,56614,54205,2409,4.3
1,105,Perry,2000,4132,3747,385,9.3
1,107,Pickens,2000,8657,8000,657,7.6
1,109,Pike,2000,14153,13364,789,5.6
1,111,Randolph,2000,10026,9534,492,4.9
1,113,Russell,2000,22142,21109,1033,4.7
1,115,St. Clair,2000,31555,30359,1196,3.8
1,117,Shelby,2000,82798,80512,2286,2.8
1,119,Sumter,2000,5420,4922,498,9.2
1,121,Talladega,2000,35828,33954,1874,5.2
1,123,Tallapoosa,2000,19486,18522,964,4.9
1,125,Tuscaloosa,2000,82181,78918,3263,4.0
1,127,Walker,2000,31714,29851,1863,5.9
1,129,Washington,2000,7781,7243,538,6.9
1,131,Wilcox,2000,3968,3617,351,8.8
1,133,Winston,2000,11768,10841,927,7.9
2,13,Aleutians East Borough,2000,942,860,82,8.7
2,16,Aleutians West Census Area,2000,2738,2597,141,5.1
2,20,Anchorage Borough/municipality,2000,140750,133661,7089,5.0
2,50,Bethel Census Area,2000,6406,5833,573,8.9
2,60,Bristol Bay Borough,2000,925,866,59,6.4
2,68,Denali Borough,2000,1341,1244,97,7.2
2,70,Dillingham Census Area,2000,1964,1820,144,7.3
2,90,Fairbanks North Star Borough,2000,41048,38543,2505,6.1
2,100,Haines Borough,2000,1397,1285,112,8.0
2,110,Juneau Borough/city,2000,18040,17203,837,4.6
2,122,Kenai Peninsula Borough,2000,24609,22597,2012,8.2
2,130,Ketchikan Gateway Borough,2000,8299,7782,517,6.2
2,150,Kodiak Island Borough,2000,6548,6004,544,8.3
2,158,Kusilvak Census Area,2000,2237,1897,340,15.2
2,164,Lake and Peninsula Borough,2000,1036,982,54,5.2
2,170,Matanuska-Susitna Borough,2000,28896,26793,2103,7.3
2,180,Nome Census Area,2000,3705,3348,357,9.6
2,185,North Slope Borough,2000,3407,3121,286,8.4
2,188,Northwest Arctic Borough,2000,2948,2682,266,9.0
2,201,Prince of Wales-Outer Ketchikan Census Area,2000,2666,2289,377,14.1
2,220,Sitka Borough/city,2000,4458,4245,213,4.8
2,232,Skagway-Hoonah-Angoon Census Area,2000,1830,1650,180,9.8
2,240,Southeast Fairbanks Census Area,2000,2271,1991,280,12.3
2,261,Valdez-Cordova Census Area,2000,5226,4830,396,7.6
2,280,Wrangell-Petersburg Census Area,2000,3077,2780,297,9.7
2,282,Yakutat Borough/city,2000,370,345,25,6.8
2,290,Yukon-Koyukuk Census Area,2000,2645,2342,303,11.5
4,1,Apache,2000,19039,17320,1719,9.0
4,3,Cochise,2000,48657,46466,2191,4.5
4,5,Coconino,2000,62634,59889,2745,4.4
4,7,Gila,2000,20341,19269,1072,5.3
4,9,Graham,2000,12274,11605,669,5.5
4,11,Greenlee,2000,3922,3756,166,4.2
4,12,La Paz,2000,7626,7141,485,6.4
4,13,Maricopa,2000,1598523,1546575,51948,3.2
4,15,Mohave,2000,68818,65752,3066,4.5
4,17,Navajo,2000,34281,31794,2487,7.3
4,19,Pima,2000,409884,394670,15214,3.7
4,21,Pinal,2000,69640,66458,3182,4.6
4,23,Santa Cruz,2000,14755,13539,1216,8.2
4,25,Yavapai,2000,75826,72773,3053,4.0
4,27,Yuma,2000,64393,53819,10574,16.4
5,1,Arkansas,2000,10161,9704,457,4.5
5,3,Ashley,2000,10505,9895,610,5.8
5,5,Baxter,2000,16294,15626,668,4.1
5,7,Benton,2000,76911,74795,2116,2.8
5,9,Boone,2000,16246,15577,669,4.1
5,11,Bradley,2000,5103,4777,326,6.4
5,13,Calhoun,2000,2558,2419,139,5.4
5,15,Carroll,2000,13038,12533,505,3.9
5,17,Chicot,2000,5434,5041,393,7.2
5,19,Clark,2000,11228,10753,475,4.2
5,21,Clay,2000,8075,7645,430,5.3
5,23,Cleburne,2000,10736,10258,478,4.5
5,25,Cleveland,2000,3903,3712,191,4.9
5,27,Columbia,2000,11279,10708,571,5.1
5,29,Conway,2000,9349,8786,563,6.0
5,31,Craighead,2000,42796,41119,1677,3.9
5,33,Crawford,2000,24785,23910,875,3.5
5,35,Crittenden,2000,21967,21071,896,4.1
5,37,Cross,2000,8685,8283,402,4.6
5,39,Dallas,2000,3864,3653,211,5.5
5,41,Desha,2000,6318,5810,508,8.0
5,43,Drew,2000,8745,8233,512,5.9
5,45,Faulkner,2000,45490,43862,1628,3.6
5,47,Franklin,2000,8076,7807,269,3.3
5,49,Fulton,2000,4971,4780,191,3.8
5,51,Garland,2000,38473,36850,1623,4.2
5,53,Grant,2000,8098,7781,317,3.9
5,55,Greene,2000,18144,17284,860,4.7
5,57,Hempstead,2000,11081,10580,501,4.5
5,59,Hot Spring,2000,14296,13699,597,4.2
5,61,Howard,2000,6636,6357,279,4.2
5,63,Independence,2000,16720,15922,798,4.8
5,65,Izard,2000,5225,4984,241,4.6
5,67,Jackson,2000,7703,7130,573,7.4
5,69,Jefferson,2000,35952,33898,2054,5.7
5,71,Johnson,2000,10203,9781,422,4.1
5,73,Lafayette,2000,3455,3253,202,5.8
5,75,Lawrence,2000,7870,7457,413,5.2
5,77,Lee,2000,3897,3610,287,7.4
5,79,Lincoln,2000,5040,4735,305,6.1
5,81,Little River,2000,6395,6105,290,4.5
5,83,Logan,2000,9872,9472,400,4.1
5,85,Lonoke,2000,26444,25578,866,3.3
5,87,Madison,2000,6925,6712,213,3.1
5,89,Marion,2000,6657,6405,252,3.8
5,91,Miller,2000,18216,17413,803,4.4
5,93,Mississippi,2000,22678,20943,1735,7.7
5,95,Monroe,2000,4076,3871,205,5.0
5,97,Montgomery,2000,4079,3914,165,4.0
5,99,Nevada,2000,4610,4394,216,4.7
5,101,Newton,2000,3761,3601,160,4.3
5,103,Ouachita,2000,12402,11682,720,5.8
5,105,Perry,2000,4811,4576,235,4.9
5,107,Phillips,2000,9706,9115,591,6.1
5,109,Pike,2000,5439,5216,223,4.1
5,111,Poinsett,2000,11451,10914,537,4.7
5,113,Polk,2000,8992,8629,363,4.0
5,115,Pope,2000,26805,25683,1122,4.2
5,117,Prairie,2000,4406,4216,190,4.3
5,119,Pulaski,2000,184451,177647,6804,3.7
5,121,Randolph,2000,8293,7862,431,5.2
5,123,St. Francis,2000,10919,10170,749,6.9
5,125,Saline,2000,42748,41368,1380,3.2
5,127,Scott,2000,4937,4767,170,3.4
5,129,Searcy,2000,3309,3148,161,4.9
5,131,Sebastian,2000,56523,54646,1877,3.3
5,133,Sevier,2000,7244,6972,272,3.8
5,135,Sharp,2000,6565,6227,338,5.1
5,137,Stone,2000,4666,4464,202,4.3
5,139,Union,2000,20204,19262,942,4.7
5,141,Van Buren,2000,6629,6280,349,5.3
5,143,Washington,2000,82281,79877,2404,2.9
5,145,White,2000,30997,29541,1456,4.7
5,147,Woodruff,2000,3777,3545,232,6.1
5,149,Yell,2000,9939,9547,392,3.9
6,1,Alameda,2000,768654,741264,27390,3.6
6,3,Alpine,2000,555,520,35,6.3
6,5,Amador,2000,15260,14477,783,5.1
6,7,Butte,2000,93071,87362,5709,6.1
6,9,Calaveras,2000,18133,17134,999,5.5
6,11,Colusa,2000,9253,8194,1059,11.4
6,13,Contra Costa,2000,500681,483153,17528,3.5
6,15,Del Norte,2000,10228,9478,750,7.3
6,17,El Dorado,2000,82122,78763,3359,4.1
6,19,Fresno,2000,387784,347882,39902,10.3
6,21,Glenn,2000,11277,10335,942,8.4
6,23,Humboldt,2000,60073,56634,3439,5.7
6,25,Imperial,2000,55945,46291,9654,17.3
6,27,Inyo,2000,8847,8440,407,4.6
6,29,Kern,2000,293341,269403,23938,8.2
6,31,Kings,2000,49156,44299,4857,9.9
6,33,Lake,2000,23058,21402,1656,7.2
6,35,Lassen,2000,11343,10542,801,7.1
6,37,Los Angeles,2000,4665167,4413213,251954,5.4
6,39,Madera,2000,54852,50136,4716,8.6
6,41,Marin,2000,141747,137758,3989,2.8
6,43,Mariposa,2000,7971,7485,486,6.1
6,45,Mendocino,2000,43545,41150,2395,5.5
6,47,Merced,2000,90193,81627,8566,9.5
6,49,Modoc,2000,3749,3471,278,7.4
6,51,Mono,2000,7392,7053,339,4.6
6,53,Monterey,2000,203030,188232,14798,7.3
6,55,Napa,2000,66592,64225,2367,3.6
6,57,Nevada,2000,45437,43575,1862,4.1
6,59,Orange,2000,1480373,1428975,51398,3.5
6,61,Placer,2000,132043,127349,4694,3.6
6,63,Plumas,2000,9753,9066,687,7.0
6,65,Riverside,2000,680221,644150,36071,5.3
6,67,Sacramento,2000,608389,582325,26064,4.3
6,69,San Benito,2000,27430,25802,1628,5.9
6,71,San Bernardino,2000,738895,703922,34973,4.7
6,73,San Diego,2000,1375223,1322119,53104,3.9
6,75,San Francisco/city,2000,472525,456633,15892,3.4
6,77,San Joaquin,2000,258695,240902,17793,6.9
6,79,San Luis Obispo,2000,122394,117520,4874,4.0
6,81,San Mateo,2000,397997,386727,11270,2.8
6,83,Santa Barbara,2000,202270,193546,8724,4.3
6,85,Santa Clara,2000,940298,911499,28799,3.1
6,87,Santa Cruz,2000,148261,140770,7491,5.1
6,89,Shasta,2000,74781,70297,4484,6.0
6,91,Sierra,2000,1800,1696,104,5.8
6,93,Siskiyou,2000,19128,17703,1425,7.4
6,95,Solano,2000,194085,185199,8886,4.6
6,97,Sonoma,2000,253136,244734,8402,3.3
6,99,Stanislaus,2000,207563,191596,15967,7.7
6,101,Sutter,2000,37817,34304,3513,9.3
6,103,Tehama,2000,23593,22072,1521,6.4
6,105,Trinity,2000,5104,4609,495,9.7
6,107,Tulare,2000,171627,153986,17641,10.3
6,109,Tuolumne,2000,22872,21540,1332,5.8
6,111,Ventura,2000,392421,374884,17537,4.5
6,113,Yolo,2000,86130,81841,4289,5.0
6,115,Yuba,2000,24268,22361,1907,7.9
8,1,Adams,2000,186637,181511,5126,2.7
8,3,Alamosa,2000,7205,6946,259,3.6
8,5,Arapahoe,2000,281688,274886,6802,2.4
8,7,Archuleta,2000,5012,4853,159,3.2
8,9,Baca,2000,2105,2044,61,2.9
8,11,Bent,2000,2273,2185,88,3.9
8,13,Boulder,2000,159943,156127,3816,2.4
8,14,Broomfield/city,2000,22552,22014,538,2.4
8,15,Chaffee,2000,7344,7102,242,3.3
8,17,Cheyenne,2000,1120,1092,28,2.5
8,19,Clear Creek,2000,6042,5878,164,2.7
8,21,Conejos,2000,3338,3171,167,5.0
8,23,Costilla,2000,1247,1155,92,7.4
8,25,Crowley,2000,1488,1409,79,5.3
8,27,Custer,2000,1665,1608,57,3.4
8,29,Delta,2000,12330,11876,454,3.7
8,31,Denver/city,2000,305042,295868,9174,3.0
8,33,Dolores,2000,903,853,50,5.5
8,35,Douglas,2000,105548,103389,2159,2.0
8,37,Eagle,2000,25619,25011,608,2.4
8,39,Elbert,2000,11599,11340,259,2.2
8,41,El Paso,2000,264548,256881,7667,2.9
8,43,Fremont,2000,17845,17149,696,3.9
8,45,Garfield,2000,24742,24084,658,2.7
8,47,Gilpin,2000,3307,3225,82,2.5
8,49,Grand,2000,7624,7437,187,2.5
8,51,Gunnison,2000,8180,7956,224,2.7
8,53,Hinsdale,2000,651,638,13,2.0
8,55,Huerfano,2000,3075,2905,170,5.5
8,57,Jackson,2000,885,860,25,2.8
8,59,Jefferson,2000,309216,301984,7232,2.3
8,61,Kiowa,2000,782,758,24,3.1
8,63,Kit Carson,2000,3843,3746,97,2.5
8,65,Lake,2000,4041,3907,134,3.3
8,67,La Plata,2000,24447,23750,697,2.9
8,69,Larimer,2000,146251,142638,3613,2.5
8,71,Las Animas,2000,6676,6401,275,4.1
8,73,Lincoln,2000,2624,2552,72,2.7
8,75,Logan,2000,10000,9717,283,2.8
8,77,Mesa,2000,58850,56913,1937,3.3
8,79,Mineral,2000,419,404,15,3.6
8,81,Moffat,2000,6995,6749,246,3.5
8,83,Montezuma,2000,11798,11310,488,4.1
8,85,Montrose,2000,16204,15613,591,3.6
8,87,Morgan,2000,12542,12166,376,3.0
8,89,Otero,2000,8815,8436,379,4.3
8,91,Ouray,2000,2198,2140,58,2.6
8,93,Park,2000,8524,8309,215,2.5
8,95,Phillips,2000,2052,1999,53,2.6
8,97,Pitkin,2000,9921,9650,271,2.7
8,99,Prowers,2000,6927,6728,199,2.9
8,101,Pueblo,2000,63915,61420,2495,3.9
8,103,Rio Blanco,2000,3236,3143,93,2.9
8,105,Rio Grande,2000,5817,5557,260,4.5
8,107,Routt,2000,12505,12193,312,2.5
8,109,Saguache,2000,2707,2557,150,5.5
8,111,San Juan,2000,513,490,23,4.5
8,113,San Miguel,2000,4722,4580,142,3.0
8,115,Sedgwick,2000,1398,1361,37,2.6
8,117,Summit,2000,16062,15703,359,2.2
8,119,Teller,2000,11881,11531,350,2.9
8,121,Washington,2000,2439,2377,62,2.5
8,123,Weld,2000,93466,90971,2495,2.7
8,125,Yuma,2000,5036,4905,131,2.6
9,1,Fairfield,2000,451537,443029,8508,1.9
9,3,Hartford,2000,434286,424221,10065,2.3
9,5,Litchfield,2000,100655,98819,1836,1.8
9,7,Middlesex,2000,86509,84884,1625,1.9
9,9,New Haven,2000,419397,409754,9643,2.3
9,11,New London,2000,133429,130662,2767,2.1
9,13,Tolland,2000,76613,75314,1299,1.7
9,15,Windham,2000,58271,56909,1362,2.3
10,1,Kent,2000,63388,60946,2442,3.9
10,3,New Castle,2000,270201,260831,9370,3.5
10,5,Sussex,2000,79367,76410,2957,3.7
11,1,District of Colu,2000,309977,292299,17678,5.7
12,1,Alachua,2000,117215,113652,3563,3.0
12,3,Baker,2000,10487,10168,319,3.0
12,5,Bay,2000,72654,69241,3413,4.7
12,7,Bradford,2000,10679,10274,405,3.8
12,9,Brevard,2000,234063,225478,8585,3.7
12,11,Broward,2000,862804,831089,31715,3.7
12,13,Calhoun,2000,5200,4953,247,4.8
12,15,Charlotte,2000,55649,53565,2084,3.7
12,17,Citrus,2000,44138,42052,2086,4.7
12,19,Clay,2000,74520,72244,2276,3.1
12,21,Collier,2000,117136,112737,4399,3.8
12,23,Columbia,2000,25908,24879,1029,4.0
12,27,DeSoto,2000,13393,12792,601,4.5
12,29,Dixie,2000,5175,4942,233,4.5
12,31,Duval,2000,411949,398144,13805,3.4
12,33,Escambia,2000,133669,128223,5446,4.1
12,35,Flagler,2000,21195,20427,768,3.6
12,37,Franklin,2000,4453,4276,177,4.0
12,39,Gadsden,2000,20131,19317,814,4.0
12,41,Gilchrist,2000,6487,6252,235,3.6
12,43,Glades,2000,4123,3927,196,4.8
12,45,Gulf,2000,5295,4972,323,6.1
12,47,Hamilton,2000,4623,4374,249,5.4
12,49,Hardee,2000,10851,10204,647,6.0
12,51,Hendry,2000,16447,15251,1196,7.3
12,53,Hernando,2000,50040,47837,2203,4.4
12,55,Highlands,2000,33472,31852,1620,4.8
12,57,Hillsborough,2000,533645,516062,17583,3.3
12,59,Holmes,2000,7811,7431,380,4.9
12,61,Indian River,2000,51517,48860,2657,5.2
12,63,Jackson,2000,19573,18665,908,4.6
12,65,Jefferson,2000,6120,5893,227,3.7
12,67,Lafayette,2000,2744,2631,113,4.1
12,69,Lake,2000,94129,90721,3408,3.6
12,71,Lee,2000,209581,202746,6835,3.3
12,73,Leon,2000,136017,131829,4188,3.1
12,75,Levy,2000,14528,13958,570,3.9
12,77,Liberty,2000,2645,2534,111,4.2
12,79,Madison,2000,7767,7448,319,4.1
12,81,Manatee,2000,124326,120333,3993,3.2
12,83,Marion,2000,110190,105689,4501,4.1
12,85,Martin,2000,56861,54468,2393,4.2
12,86,Miami-Dade,2000,1091659,1043046,48613,4.5
12,87,Monroe,2000,45588,44271,1317,2.9
12,89,Nassau,2000,30549,29531,1018,3.3
12,91,Okaloosa,2000,81126,78110,3016,3.7
12,93,Okeechobee,2000,15804,14948,856,5.4
12,95,Orange,2000,504054,488469,15585,3.1
12,97,Osceola,2000,90374,87372,3002,3.3
12,99,Palm Beach,2000,546593,523327,23266,4.3
12,101,Pasco,2000,151610,145960,5650,3.7
12,103,Pinellas,2000,475357,459600,15757,3.3
12,105,Polk,2000,233350,223624,9726,4.2
12,107,Putnam,2000,29619,28343,1276,4.3
12,109,St. Johns,2000,67048,65047,2001,3.0
12,111,St. Lucie,2000,88254,83132,5122,5.8
12,113,Santa Rosa,2000,55471,53327,2144,3.9
12,115,Sarasota,2000,150154,145304,4850,3.2
12,117,Seminole,2000,214509,207963,6546,3.1
12,119,Sumter,2000,17077,16335,742,4.3
12,121,Suwannee,2000,15561,14999,562,3.6
12,123,Taylor,2000,8354,7939,415,5.0
12,125,Union,2000,4571,4370,201,4.4
12,127,Volusia,2000,211550,204337,7213,3.4
12,129,Wakulla,2000,11800,11418,382,3.2
12,131,Walton,2000,19592,18906,686,3.5
12,133,Washington,2000,9029,8617,412,4.6
13,1,Appling,2000,8519,8062,457,5.4
13,3,Atkinson,2000,3489,3305,184,5.3
13,5,Bacon,2000,4641,4431,210,4.5
13,7,Baker,2000,1735,1661,74,4.3
13,9,Baldwin,2000,18875,17970,905,4.8
13,11,Banks,2000,7768,7535,233,3.0
13,13,Barrow,2000,25014,24267,747,3.0
13,15,Bartow,2000,40350,38875,1475,3.7
13,17,Ben Hill,2000,8112,7721,391,4.8
13,19,Berrien,2000,8015,7697,318,4.0
13,21,Bibb,2000,69989,66992,2997,4.3
13,23,Bleckley,2000,5145,4930,215,4.2
13,25,Brantley,2000,6754,6472,282,4.2
13,27,Brooks,2000,7521,7177,344,4.6
13,29,Bryan,2000,11543,11184,359,3.1
13,31,Bulloch,2000,27152,26109,1043,3.8
13,33,Burke,2000,9131,8673,458,5.0
13,35,Butts,2000,9026,8615,411,4.6
13,37,Calhoun,2000,2346,2194,152,6.5
13,39,Camden,2000,17712,17072,640,3.6
13,43,Candler,2000,3966,3783,183,4.6
13,45,Carroll,2000,44637,42986,1651,3.7
13,47,Catoosa,2000,29536,28749,787,2.7
13,49,Charlton,2000,3929,3769,160,4.1
13,51,Chatham,2000,111047,107100,3947,3.6
13,53,Chattahoochee,2000,2619,2406,213,8.1
13,55,Chattooga,2000,11576,11142,434,3.7
13,57,Cherokee,2000,82374,80258,2116,2.6
13,59,Clarke,2000,53962,52126,1836,3.4
13,61,Clay,2000,1335,1262,73,5.5
13,63,Clayton,2000,125561,121368,4193,3.3
13,65,Clinch,2000,2752,2605,147,5.3
13,67,Cobb,2000,358689,348740,9949,2.8
13,69,Coffee,2000,17071,16286,785,4.6
13,71,Colquitt,2000,19258,18373,885,4.6
13,73,Columbia,2000,46982,45623,1359,2.9
13,75,Cook,2000,7225,6898,327,4.5
13,77,Coweta,2000,48441,46854,1587,3.3
13,79,Crawford,2000,5841,5610,231,4.0
13,81,Crisp,2000,9682,9232,450,4.6
13,83,Dade,2000,7668,7439,229,3.0
13,85,Dawson,2000,8980,8739,241,2.7
13,87,Decatur,2000,12239,11691,548,4.5
13,89,DeKalb,2000,379055,366653,12402,3.3
13,91,Dodge,2000,8464,8064,400,4.7
13,93,Dooly,2000,4770,4543,227,4.8
13,95,Dougherty,2000,41285,39144,2141,5.2
13,97,Douglas,2000,51166,49661,1505,2.9
13,99,Early,2000,5329,5064,265,5.0
13,101,Echols,2000,1848,1785,63,3.4
13,103,Effingham,2000,18917,18325,592,3.1
13,105,Elbert,2000,9663,9159,504,5.2
13,107,Emanuel,2000,9883,9327,556,5.6
13,109,Evans,2000,4668,4467,201,4.3
13,111,Fannin,2000,9027,8677,350,3.9
13,113,Fayette,2000,49508,48201,1307,2.6
13,115,Floyd,2000,44476,42788,1688,3.8
13,117,Forsyth,2000,56976,55615,1361,2.4
13,119,Franklin,2000,9887,9502,385,3.9
13,121,Fulton,2000,427776,413133,14643,3.4
13,123,Gilmer,2000,11247,10876,371,3.3
13,125,Glascock,2000,1184,1136,48,4.1
13,127,Glynn,2000,34626,33414,1212,3.5
13,129,Gordon,2000,24190,23380,810,3.3
13,131,Grady,2000,10948,10465,483,4.4
13,133,Greene,2000,6340,6061,279,4.4
13,135,Gwinnett,2000,344558,335186,9372,2.7
13,137,Habersham,2000,18275,17639,636,3.5
13,139,Hall,2000,73188,71036,2152,2.9
13,141,Hancock,2000,3257,3003,254,7.8
13,143,Haralson,2000,12334,11898,436,3.5
13,145,Harris,2000,12842,12441,401,3.1
13,147,Hart,2000,11314,10867,447,4.0
13,149,Heard,2000,5099,4898,201,3.9
13,151,Henry,2000,67159,65374,1785,2.7
13,153,Houston,2000,53336,51537,1799,3.4
13,155,Irwin,2000,4516,4308,208,4.6
13,157,Jackson,2000,21251,20581,670,3.2
13,159,Jasper,2000,5748,5564,184,3.2
13,161,Jeff Davis,2000,5755,5491,264,4.6
13,163,Jefferson,2000,6729,6282,447,6.6
13,165,Jenkins,2000,3707,3513,194,5.2
13,167,Johnson,2000,3383,3180,203,6.0
13,169,Jones,2000,11731,11282,449,3.8
13,171,Lamar,2000,8006,7650,356,4.4
13,173,Lanier,2000,3317,3155,162,4.9
13,175,Laurens,2000,21297,20335,962,4.5
13,177,Lee,2000,13081,12637,444,3.4
13,179,Liberty,2000,19522,18503,1019,5.2
13,181,Lincoln,2000,3751,3538,213,5.7
13,183,Long,2000,4297,4142,155,3.6
13,185,Lowndes,2000,43232,41319,1913,4.4
13,187,Lumpkin,2000,10854,10535,319,2.9
13,189,McDuffie,2000,9851,9419,432,4.4
13,191,McIntosh,2000,4866,4659,207,4.3
13,193,Macon,2000,5390,5035,355,6.6
13,195,Madison,2000,13734,13291,443,3.2
13,197,Marion,2000,3305,3175,130,3.9
13,199,Meriwether,2000,10082,9628,454,4.5
13,201,Miller,2000,3237,3104,133,4.1
13,205,Mitchell,2000,9859,9357,502,5.1
13,207,Monroe,2000,11295,10880,415,3.7
13,209,Montgomery,2000,3898,3676,222,5.7
13,211,Morgan,2000,8132,7855,277,3.4
13,213,Murray,2000,19512,18860,652,3.3
13,215,Muscogee,2000,83224,79319,3905,4.7
13,217,Newton,2000,32130,31090,1040,3.2
13,219,Oconee,2000,14270,13908,362,2.5
13,221,Oglethorpe,2000,6594,6395,199,3.0
13,223,Paulding,2000,45527,44320,1207,2.7
13,225,Peach,2000,10756,10270,486,4.5
13,227,Pickens,2000,12420,12049,371,3.0
13,229,Pierce,2000,7600,7296,304,4.0
13,231,Pike,2000,6946,6692,254,3.7
13,233,Polk,2000,17500,16788,712,4.1
13,235,Pulaski,2000,4348,4172,176,4.0
13,237,Putnam,2000,8999,8683,316,3.5
13,239,Quitman,2000,1035,970,65,6.3
13,241,Rabun,2000,7234,7004,230,3.2
13,243,Randolph,2000,2988,2812,176,5.9
13,245,Richmond,2000,86749,82949,3800,4.4
13,247,Rockdale,2000,36702,35571,1131,3.1
13,249,Schley,2000,1707,1637,70,4.1
13,251,Screven,2000,6565,6246,319,4.9
13,253,Seminole,2000,3987,3791,196,4.9
13,255,Spalding,2000,27970,26775,1195,4.3
13,257,Stephens,2000,13146,12674,472,3.6
13,259,Stewart,2000,2075,1963,112,5.4
13,261,Sumter,2000,15245,14618,627,4.1
13,263,Talbot,2000,2834,2681,153,5.4
13,265,Taliaferro,2000,844,801,43,5.1
13,267,Tattnall,2000,8802,8298,504,5.7
13,269,Taylor,2000,3390,3212,178,5.3
13,271,Telfair,2000,4403,4064,339,7.7
13,273,Terrell,2000,4631,4388,243,5.2
13,275,Thomas,2000,19739,18914,825,4.2
13,277,Tift,2000,18813,18042,771,4.1
13,279,Toombs,2000,12175,11382,793,6.5
13,281,Towns,2000,4229,4048,181,4.3
13,283,Treutlen,2000,2619,2416,203,7.8
13,285,Troup,2000,29926,28854,1072,3.6
13,287,Turner,2000,4344,4104,240,5.5
13,289,Twiggs,2000,4575,4374,201,4.4
13,291,Union,2000,8060,7744,316,3.9
13,293,Upson,2000,12735,12094,641,5.0
13,295,Walker,2000,30270,29206,1064,3.5
13,297,Walton,2000,32341,31339,1002,3.1
13,299,Ware,2000,15136,14378,758,5.0
13,301,Warren,2000,2628,2484,144,5.5
13,303,Washington,2000,8525,8124,401,4.7
13,305,Wayne,2000,11295,10740,555,4.9
13,307,Webster,2000,1064,1024,40,3.8
13,309,Wheeler,2000,2294,2152,142,6.2
13,311,White,2000,10769,10393,376,3.5
13,313,Whitfield,2000,43422,41904,1518,3.5
13,315,Wilcox,2000,3236,3084,152,4.7
13,317,Wilkes,2000,5015,4783,232,4.6
13,319,Wilkinson,2000,4488,4297,191,4.3
13,321,Worth,2000,10240,9795,445,4.3
15,1,Hawaii,2000,73809,70108,3701,5.0
15,3,Honolulu/city,2000,430500,412780,17720,4.1
15,7,Kauai,2000,30202,28745,1457,4.8
15,9,Maui,2000,70883,68103,2780,3.9
16,1,Ada,2000,170264,164533,5731,3.4
16,3,Adams,2000,1923,1731,192,10.0
16,5,Bannock,2000,38255,36484,1771,4.6
16,7,Bear Lake,2000,2952,2808,144,4.9
16,9,Benewah,2000,4010,3568,442,11.0
16,11,Bingham,2000,19724,18860,864,4.4
16,13,Blaine,2000,11824,11405,419,3.5
16,15,Boise,2000,3425,3257,168,4.9
16,17,Bonner,2000,17648,16292,1356,7.7
16,19,Bonneville,2000,41505,40094,1411,3.4
16,21,Boundary,2000,4203,3879,324,7.7
16,23,Butte,2000,1445,1383,62,4.3
16,25,Camas,2000,536,516,20,3.7
16,27,Canyon,2000,65913,62977,2936,4.5
16,29,Caribou,2000,3264,3098,166,5.1
16,31,Cassia,2000,10281,9774,507,4.9
16,33,Clark,2000,530,502,28,5.3
16,35,Clearwater,2000,3694,3208,486,13.2
16,37,Custer,2000,2594,2450,144,5.6
16,39,Elmore,2000,10617,10012,605,5.7
16,41,Franklin,2000,5216,5048,168,3.2
16,43,Fremont,2000,5636,5365,271,4.8
16,45,Gem,2000,7026,6667,359,5.1
16,47,Gooding,2000,7089,6818,271,3.8
16,49,Idaho,2000,6964,6379,585,8.4
16,51,Jefferson,2000,9007,8670,337,3.7
16,53,Jerome,2000,9153,8756,397,4.3
16,55,Kootenai,2000,56388,52834,3554,6.3
16,57,Latah,2000,17613,16865,748,4.2
16,59,Lemhi,2000,3815,3509,306,8.0
16,61,Lewis,2000,1748,1634,114,6.5
16,63,Lincoln,2000,2161,2066,95,4.4
16,65,Madison,2000,12717,12270,447,3.5
16,67,Minidoka,2000,10150,9571,579,5.7
16,69,Nez Perce,2000,18912,17930,982,5.2
16,71,Oneida,2000,1986,1919,67,3.4
16,73,Owyhee,2000,4785,4599,186,3.9
16,75,Payette,2000,9806,9146,660,6.7
16,77,Power,2000,3598,3392,206,5.7
16,79,Shoshone,2000,6046,5453,593,9.8
16,81,Teton,2000,3659,3551,108,3.0
16,83,Twin Falls,2000,33670,32262,1408,4.2
16,85,Valley,2000,4118,3842,276,6.7
16,87,Washington,2000,5205,4853,352,6.8
17,1,Adams,2000,36030,34749,1281,3.6
17,3,Alexander,2000,3632,3362,270,7.4
17,5,Bond,2000,8321,7972,349,4.2
17,7,Boone,2000,22110,21079,1031,4.7
17,9,Brown,2000,2794,2702,92,3.3
17,11,Bureau,2000,19174,18268,906,4.7
17,13,Calhoun,2000,2545,2411,134,5.3
17,15,Carroll,2000,8640,8163,477,5.5
17,17,Cass,2000,7114,6798,316,4.4
17,19,Champaign,2000,99423,96100,3323,3.3
17,21,Christian,2000,17506,16610,896,5.1
17,23,Clark,2000,8740,8329,411,4.7
17,25,Clay,2000,7192,6775,417,5.8
17,27,Clinton,2000,18385,17716,669,3.6
17,29,Coles,2000,28233,27113,1120,4.0
17,31,Cook,2000,2742036,2607332,134704,4.9
17,33,Crawford,2000,9611,9087,524,5.5
17,35,Cumberland,2000,5851,5582,269,4.6
17,37,DeKalb,2000,51431,49672,1759,3.4
17,39,De Witt,2000,9185,8702,483,5.3
17,41,Douglas,2000,10367,9977,390,3.8
17,43,DuPage,2000,532193,514148,18045,3.4
17,45,Edgar,2000,9897,9471,426,4.3
17,47,Edwards,2000,3655,3472,183,5.0
17,49,Effingham,2000,18396,17615,781,4.2
17,51,Fayette,2000,10267,9652,615,6.0
17,53,Ford,2000,7342,7079,263,3.6
17,55,Franklin,2000,17589,16427,1162,6.6
17,57,Fulton,2000,17702,16758,944,5.3
17,59,Gallatin,2000,2880,2710,170,5.9
17,61,Greene,2000,6962,6606,356,5.1
17,63,Grundy,2000,21200,20069,1131,5.3
17,65,Hamilton,2000,4002,3807,195,4.9
17,67,Hancock,2000,10885,10415,470,4.3
17,69,Hardin,2000,1953,1829,124,6.3
17,71,Henderson,2000,4302,4132,170,4.0
17,73,Henry,2000,27393,26116,1277,4.7
17,75,Iroquois,2000,16460,15776,684,4.2
17,77,Jackson,2000,30403,29133,1270,4.2
17,79,Jasper,2000,5347,5090,257,4.8
17,81,Jefferson,2000,19151,18171,980,5.1
17,83,Jersey,2000,11167,10680,487,4.4
17,85,Jo Daviess,2000,12823,12294,529,4.1
17,87,Johnson,2000,4865,4573,292,6.0
17,89,Kane,2000,222441,213364,9077,4.1
17,91,Kankakee,2000,52559,50257,2302,4.4
17,93,Kendall,2000,32510,31422,1088,3.3
17,95,Knox,2000,28065,26766,1299,4.6
17,97,Lake,2000,339463,327689,11774,3.5
17,99,LaSalle,2000,56516,53621,2895,5.1
17,101,Lawrence,2000,8116,7678,438,5.4
17,103,Lee,2000,17749,17021,728,4.1
17,105,Livingston,2000,19557,18841,716,3.7
17,107,Logan,2000,15082,14512,570,3.8
17,109,McDonough,2000,16893,16196,697,4.1
17,111,McHenry,2000,152092,146543,5549,3.6
17,113,McLean,2000,85770,83044,2726,3.2
17,115,Macon,2000,56024,53227,2797,5.0
17,117,Macoupin,2000,24452,23397,1055,4.3
17,119,Madison,2000,133067,127516,5551,4.2
17,121,Marion,2000,20776,19638,1138,5.5
17,123,Marshall,2000,7022,6744,278,4.0
17,125,Mason,2000,7927,7486,441,5.6
17,127,Massac,2000,7233,6864,369,5.1
17,129,Menard,2000,7037,6797,240,3.4
17,131,Mercer,2000,8859,8387,472,5.3
17,133,Monroe,2000,15564,15075,489,3.1
17,135,Montgomery,2000,14187,13419,768,5.4
17,137,Morgan,2000,18881,18125,756,4.0
17,139,Moultrie,2000,7479,7178,301,4.0
17,141,Ogle,2000,27077,25959,1118,4.1
17,143,Peoria,2000,91598,87642,3956,4.3
17,145,Perry,2000,10319,9624,695,6.7
17,147,Piatt,2000,9074,8761,313,3.4
17,149,Pike,2000,8530,8088,442,5.2
17,151,Pope,2000,2040,1910,130,6.4
17,153,Pulaski,2000,3104,2893,211,6.8
17,155,Putnam,2000,3152,3001,151,4.8
17,157,Randolph,2000,15251,14515,736,4.8
17,159,Richland,2000,7878,7413,465,5.9
17,161,Rock Island,2000,77845,74460,3385,4.3
17,163,St. Clair,2000,119895,114104,5791,4.8
17,165,Saline,2000,11808,11019,789,6.7
17,167,Sangamon,2000,105726,102007,3719,3.5
17,169,Schuyler,2000,3998,3801,197,4.9
17,171,Scott,2000,2992,2853,139,4.6
17,173,Shelby,2000,11742,11185,557,4.7
17,175,Stark,2000,2898,2730,168,5.8
17,177,Stephenson,2000,26054,24738,1316,5.1
17,179,Tazewell,2000,67447,64824,2623,3.9
17,181,Union,2000,8383,7861,522,6.2
17,183,Vermilion,2000,38967,36774,2193,5.6
17,185,Wabash,2000,6906,6560,346,5.0
17,187,Warren,2000,10089,9658,431,4.3
17,189,Washington,2000,8381,8062,319,3.8
17,191,Wayne,2000,8427,7947,480,5.7
17,193,White,2000,7512,7148,364,4.8
17,195,Whiteside,2000,30980,29722,1258,4.1
17,197,Will,2000,280158,268536,11622,4.1
17,199,Williamson,2000,29997,28244,1753,5.8
17,201,Winnebago,2000,146905,140479,6426,4.4
17,203,Woodford,2000,18834,18218,616,3.3
18,1,Adams,2000,16555,16102,453,2.7
18,3,Allen,2000,175673,170933,4740,2.7
18,5,Bartholomew,2000,37289,36314,975,2.6
18,7,Benton,2000,4827,4689,138,2.9
18,9,Blackford,2000,7026,6723,303,4.3
18,11,Boone,2000,24255,23749,506,2.1
18,13,Brown,2000,7869,7643,226,2.9
18,15,Carroll,2000,10492,10200,292,2.8
18,17,Cass,2000,20645,20015,630,3.1
18,19,Clark,2000,52452,50590,1862,3.5
18,21,Clay,2000,12843,12316,527,4.1
18,23,Clinton,2000,16458,15979,479,2.9
18,25,Crawford,2000,5109,4864,245,4.8
18,27,Daviess,2000,14088,13669,419,3.0
18,29,Dearborn,2000,24453,23653,800,3.3
18,31,Decatur,2000,13425,13125,300,2.2
18,33,DeKalb,2000,21694,21046,648,3.0
18,35,Delaware,2000,58619,56601,2018,3.4
18,37,Dubois,2000,22147,21658,489,2.2
18,39,Elkhart,2000,96736,94209,2527,2.6
18,41,Fayette,2000,12397,11861,536,4.3
18,43,Floyd,2000,38020,36731,1289,3.4
18,45,Fountain,2000,8651,8382,269,3.1
18,47,Franklin,2000,11310,10917,393,3.5
18,49,Fulton,2000,10757,10324,433,4.0
18,51,Gibson,2000,16728,16176,552,3.3
18,53,Grant,2000,34805,33438,1367,3.9
18,55,Greene,2000,16009,15250,759,4.7
18,57,Hamilton,2000,101252,99374,1878,1.9
18,59,Hancock,2000,30385,29704,681,2.2
18,61,Harrison,2000,18706,18085,621,3.3
18,63,Hendricks,2000,57463,56337,1126,2.0
18,65,Henry,2000,23333,22433,900,3.9
18,67,Howard,2000,41472,40159,1313,3.2
18,69,Huntington,2000,20778,20142,636,3.1
18,71,Jackson,2000,21691,21115,576,2.7
18,73,Jasper,2000,14694,14195,499,3.4
18,75,Jay,2000,10974,10607,367,3.3
18,77,Jefferson,2000,16163,15634,529,3.3
18,79,Jennings,2000,14044,13647,397,2.8
18,81,Johnson,2000,63220,61880,1340,2.1
18,83,Knox,2000,19466,18752,714,3.7
18,85,Kosciusko,2000,39235,38271,964,2.5
18,87,LaGrange,2000,16887,16490,397,2.4
18,89,Lake,2000,225314,216842,8472,3.8
18,91,LaPorte,2000,53777,51921,1856,3.5
18,93,Lawrence,2000,22907,21984,923,4.0
18,95,Madison,2000,63419,61435,1984,3.1
18,97,Marion,2000,455014,442478,12536,2.8
18,99,Marshall,2000,23297,22578,719,3.1
18,101,Martin,2000,5071,4900,171,3.4
18,103,Miami,2000,17559,16967,592,3.4
18,105,Monroe,2000,63730,62027,1703,2.7
18,107,Montgomery,2000,19659,19146,513,2.6
18,109,Morgan,2000,35533,34668,865,2.4
18,111,Newton,2000,7254,7040,214,3.0
18,113,Noble,2000,24410,23711,699,2.9
18,115,Ohio,2000,2984,2883,101,3.4
18,117,Orange,2000,9578,9159,419,4.4
18,119,Owen,2000,10738,10411,327,3.0
18,121,Parke,2000,8013,7732,281,3.5
18,123,Perry,2000,9485,9042,443,4.7
18,125,Pike,2000,6345,6124,221,3.5
18,127,Porter,2000,77430,75226,2204,2.8
18,129,Posey,2000,13847,13427,420,3.0
18,131,Pulaski,2000,6754,6459,295,4.4
18,133,Putnam,2000,17100,16609,491,2.9
18,135,Randolph,2000,13521,13011,510,3.8
18,137,Ripley,2000,13709,13357,352,2.6
18,139,Rush,2000,9457,9209,248,2.6
18,141,St. Joseph,2000,134138,129851,4287,3.2
18,143,Scott,2000,11272,10900,372,3.3
18,145,Shelby,2000,23538,22919,619,2.6
18,147,Spencer,2000,10974,10587,387,3.5
18,149,Starke,2000,10824,10306,518,4.8
18,151,Steuben,2000,18463,17908,555,3.0
18,153,Sullivan,2000,9215,8733,482,5.2
18,155,Switzerland,2000,5003,4761,242,4.8
18,157,Tippecanoe,2000,77903,75870,2033,2.6
18,159,Tipton,2000,8673,8442,231,2.7
18,161,Union,2000,3790,3673,117,3.1
18,163,Vanderburgh,2000,89664,86792,2872,3.2
18,165,Vermillion,2000,8127,7750,377,4.6
18,167,Vigo,2000,50742,48695,2047,4.0
18,169,Wabash,2000,18065,17524,541,3.0
18,171,Warren,2000,4481,4361,120,2.7
18,173,Warrick,2000,28403,27468,935,3.3
18,175,Washington,2000,14025,13497,528,3.8
18,177,Wayne,2000,35483,34195,1288,3.6
18,179,Wells,2000,14869,14507,362,2.4
18,181,White,2000,13580,13177,403,3.0
18,183,Whitley,2000,17080,16645,435,2.5
19,1,Adair,2000,4463,4342,121,2.7
19,3,Adams,2000,2335,2245,90,3.9
19,5,Allamakee,2000,7964,7690,274,3.4
19,7,Appanoose,2000,6349,6067,282,4.4
19,9,Audubon,2000,3419,3317,102,3.0
19,11,Benton,2000,13695,13376,319,2.3
19,13,Black Hawk,2000,68593,66657,1936,2.8
19,15,Boone,2000,14616,14296,320,2.2
19,17,Bremer,2000,12803,12483,320,2.5
19,19,Buchanan,2000,10678,10373,305,2.9
19,21,Buena Vista,2000,10273,10028,245,2.4
19,23,Butler,2000,7999,7738,261,3.3
19,25,Calhoun,2000,5348,5197,151,2.8
19,27,Carroll,2000,11962,11689,273,2.3
19,29,Cass,2000,7891,7603,288,3.6
19,31,Cedar,2000,10380,10141,239,2.3
19,33,Cerro Gordo,2000,25235,24489,746,3.0
19,35,Cherokee,2000,6966,6800,166,2.4
19,37,Chickasaw,2000,6886,6441,445,6.5
19,39,Clarke,2000,4880,4724,156,3.2
19,41,Clay,2000,9961,9712,249,2.5
19,43,Clayton,2000,10234,9880,354,3.5
19,45,Clinton,2000,26131,25222,909,3.5
19,47,Crawford,2000,8915,8690,225,2.5
19,49,Dallas,2000,23548,23090,458,1.9
19,51,Davis,2000,4164,4026,138,3.3
19,53,Decatur,2000,4272,4127,145,3.4
19,55,Delaware,2000,10175,9883,292,2.9
19,57,Des Moines,2000,22308,21516,792,3.6
19,59,Dickinson,2000,9455,9192,263,2.8
19,61,Dubuque,2000,48501,46906,1595,3.3
19,63,Emmet,2000,6019,5844,175,2.9
19,65,Fayette,2000,11214,10784,430,3.8
19,67,Floyd,2000,8506,8186,320,3.8
19,69,Franklin,2000,5698,5540,158,2.8
19,71,Fremont,2000,4235,4133,102,2.4
19,73,Greene,2000,4991,4825,166,3.3
19,75,Grundy,2000,6521,6369,152,2.3
19,77,Guthrie,2000,6058,5896,162,2.7
19,79,Hamilton,2000,8950,8724,226,2.5
19,81,Hancock,2000,6322,6182,140,2.2
19,83,Hardin,2000,9506,9210,296,3.1
19,85,Harrison,2000,8085,7866,219,2.7
19,87,Henry,2000,10566,10249,317,3.0
19,89,Howard,2000,5127,4963,164,3.2
19,91,Humboldt,2000,5275,5137,138,2.6
19,93,Ida,2000,3990,3902,88,2.2
19,95,Iowa,2000,8845,8657,188,2.1
19,97,Jackson,2000,11150,10742,408,3.7
19,99,Jasper,2000,19817,19319,498,2.5
19,101,Jefferson,2000,9041,8778,263,2.9
19,103,Johnson,2000,67273,66012,1261,1.9
19,105,Jones,2000,10421,10143,278,2.7
19,107,Keokuk,2000,5826,5637,189,3.2
19,109,Kossuth,2000,8842,8613,229,2.6
19,111,Lee,2000,18656,17808,848,4.5
19,113,Linn,2000,111173,108604,2569,2.3
19,115,Louisa,2000,6252,6065,187,3.0
19,117,Lucas,2000,4744,4610,134,2.8
19,119,Lyon,2000,6365,6236,129,2.0
19,121,Madison,2000,7618,7379,239,3.1
19,123,Mahaska,2000,11535,11258,277,2.4
19,125,Marion,2000,17622,17223,399,2.3
19,127,Marshall,2000,20607,20038,569,2.8
19,129,Mills,2000,7900,7740,160,2.0
19,131,Mitchell,2000,5459,5307,152,2.8
19,133,Monona,2000,4988,4830,158,3.2
19,135,Monroe,2000,3905,3783,122,3.1
19,137,Montgomery,2000,6008,5810,198,3.3
19,139,Muscatine,2000,22280,21667,613,2.8
19,141,O'Brien,2000,7770,7590,180,2.3
19,143,Osceola,2000,3611,3521,90,2.5
19,145,Page,2000,8355,8084,271,3.2
19,147,Palo Alto,2000,5205,5083,122,2.3
19,149,Plymouth,2000,13509,13161,348,2.6
19,151,Pocahontas,2000,4200,4084,116,2.8
19,153,Polk,2000,215000,209909,5091,2.4
19,155,Pottawattamie,2000,48091,46942,1149,2.4
19,157,Poweshiek,2000,10364,10080,284,2.7
19,159,Ringgold,2000,2588,2510,78,3.0
19,161,Sac,2000,5959,5801,158,2.7
19,163,Scott,2000,85722,82905,2817,3.3
19,165,Shelby,2000,7084,6915,169,2.4
19,167,Sioux,2000,17617,17271,346,2.0
19,169,Story,2000,46341,45512,829,1.8
19,171,Tama,2000,9242,8925,317,3.4
19,173,Taylor,2000,3487,3373,114,3.3
19,175,Union,2000,6572,6349,223,3.4
19,177,Van Buren,2000,3997,3868,129,3.2
19,179,Wapello,2000,17879,17234,645,3.6
19,181,Warren,2000,23533,23023,510,2.2
19,183,Washington,2000,11313,11061,252,2.2
19,185,Wayne,2000,3241,3142,99,3.1
19,187,Webster,2000,19916,19304,612,3.1
19,189,Winnebago,2000,6451,6318,133,2.1
19,191,Winneshiek,2000,12168,11856,312,2.6
19,193,Woodbury,2000,55444,53985,1459,2.6
19,195,Worth,2000,4363,4233,130,3.0
19,197,Wright,2000,7593,7392,201,2.6
20,1,Allen,2000,7150,6814,336,4.7
20,3,Anderson,2000,4062,3888,174,4.3
20,5,Atchison,2000,8385,8006,379,4.5
20,7,Barber,2000,2647,2573,74,2.8
20,9,Barton,2000,14277,13784,493,3.5
20,11,Bourbon,2000,8191,7871,320,3.9
20,13,Brown,2000,5420,5146,274,5.1
20,15,Butler,2000,30541,29290,1251,4.1
20,17,Chase,2000,1566,1519,47,3.0
20,19,Chautauqua,2000,1888,1803,85,4.5
20,21,Cherokee,2000,10797,10266,531,4.9
20,23,Cheyenne,2000,1608,1565,43,2.7
20,25,Clark,2000,1190,1155,35,2.9
20,27,Clay,2000,4544,4390,154,3.4
20,29,Cloud,2000,5276,5077,199,3.8
20,31,Coffey,2000,4662,4481,181,3.9
20,33,Comanche,2000,1031,1007,24,2.3
20,35,Cowley,2000,17534,16718,816,4.7
20,37,Crawford,2000,18857,18002,855,4.5
20,39,Decatur,2000,1724,1679,45,2.6
20,41,Dickinson,2000,10233,9895,338,3.3
20,43,Doniphan,2000,4107,3902,205,5.0
20,45,Douglas,2000,58374,56726,1648,2.8
20,47,Edwards,2000,1692,1646,46,2.7
20,49,Elk,2000,1429,1356,73,5.1
20,51,Ellis,2000,15291,14878,413,2.7
20,53,Ellsworth,2000,3153,3043,110,3.5
20,55,Finney,2000,20154,19617,537,2.7
20,57,Ford,2000,15784,15356,428,2.7
20,59,Franklin,2000,13161,12660,501,3.8
20,61,Geary,2000,11311,10756,555,4.9
20,63,Gove,2000,1570,1534,36,2.3
20,65,Graham,2000,1433,1391,42,2.9
20,67,Grant,2000,3710,3600,110,3.0
20,69,Gray,2000,2986,2906,80,2.7
20,71,Greeley,2000,760,734,26,3.4
20,73,Greenwood,2000,3712,3530,182,4.9
20,75,Hamilton,2000,1270,1234,36,2.8
20,77,Harper,2000,3169,3049,120,3.8
20,79,Harvey,2000,17545,16909,636,3.6
20,81,Haskell,2000,2074,2025,49,2.4
20,83,Hodgeman,2000,1003,968,35,3.5
20,85,Jackson,2000,6642,6356,286,4.3
20,87,Jefferson,2000,9742,9355,387,4.0
20,89,Jewell,2000,1886,1835,51,2.7
20,91,Johnson,2000,262345,254515,7830,3.0
20,93,Kearny,2000,2024,1967,57,2.8
20,95,Kingman,2000,4236,4079,157,3.7
20,97,Kiowa,2000,1605,1559,46,2.9
20,99,Labette,2000,11317,10749,568,5.0
20,101,Lane,2000,1112,1080,32,2.9
20,103,Leavenworth,2000,31228,29934,1294,4.1
20,105,Lincoln,2000,1894,1839,55,2.9
20,107,Linn,2000,4729,4494,235,5.0
20,109,Logan,2000,1596,1539,57,3.6
20,111,Lyon,2000,18515,17918,597,3.2
20,113,McPherson,2000,15328,14864,464,3.0
20,115,Marion,2000,6689,6481,208,3.1
20,117,Marshall,2000,5544,5340,204,3.7
20,119,Meade,2000,2161,2101,60,2.8
20,121,Miami,2000,15314,14795,519,3.4
20,123,Mitchell,2000,3499,3401,98,2.8
20,125,Montgomery,2000,16964,16057,907,5.3
20,127,Morris,2000,3052,2939,113,3.7
20,129,Morton,2000,1740,1690,50,2.9
20,131,Nemaha,2000,5216,5061,155,3.0
20,133,Neosho,2000,8376,7995,381,4.5
20,135,Ness,2000,1777,1732,45,2.5
20,137,Norton,2000,2653,2569,84,3.2
20,139,Osage,2000,8821,8416,405,4.6
20,141,Osborne,2000,2303,2240,63,2.7
20,143,Ottawa,2000,3361,3257,104,3.1
20,145,Pawnee,2000,3512,3411,101,2.9
20,147,Phillips,2000,3112,3023,89,2.9
20,149,Pottawatomie,2000,9328,9018,310,3.3
20,151,Pratt,2000,5046,4906,140,2.8
20,153,Rawlins,2000,1465,1421,44,3.0
20,155,Reno,2000,32232,30989,1243,3.9
20,157,Republic,2000,2965,2876,89,3.0
20,159,Rice,2000,5187,4990,197,3.8
20,161,Riley,2000,30650,29736,914,3.0
20,163,Rooks,2000,2724,2632,92,3.4
20,165,Rush,2000,1726,1665,61,3.5
20,167,Russell,2000,3534,3388,146,4.1
20,169,Saline,2000,29818,28896,922,3.1
20,171,Scott,2000,2978,2911,67,2.2
20,173,Sedgwick,2000,237680,227718,9962,4.2
20,175,Seward,2000,10351,10037,314,3.0
20,177,Shawnee,2000,91254,87571,3683,4.0
20,179,Sheridan,2000,1483,1450,33,2.2
20,181,Sherman,2000,3609,3506,103,2.9
20,183,Smith,2000,2168,2106,62,2.9
20,185,Stafford,2000,2279,2205,74,3.2
20,187,Stanton,2000,1261,1230,31,2.5
20,189,Stevens,2000,2454,2382,72,2.9
20,191,Sumner,2000,12838,12233,605,4.7
20,193,Thomas,2000,4242,4136,106,2.5
20,195,Trego,2000,1661,1618,43,2.6
20,197,Wabaunsee,2000,3728,3602,126,3.4
20,199,Wallace,2000,928,907,21,2.3
20,201,Washington,2000,3338,3218,120,3.6
20,203,Wichita,2000,1250,1213,37,3.0
20,205,Wilson,2000,4983,4782,201,4.0
20,207,Woodson,2000,1698,1613,85,5.0
20,209,Wyandotte,2000,74200,69553,4647,6.3
21,1,Adair,2000,8203,7794,409,5.0
21,3,Allen,2000,8479,8111,368,4.3
21,5,Anderson,2000,10199,9853,346,3.4
21,7,Ballard,2000,4221,3972,249,5.9
21,9,Barren,2000,19340,18455,885,4.6
21,11,Bath,2000,4949,4647,302,6.1
21,13,Bell,2000,9902,9258,644,6.5
21,15,Boone,2000,49124,47683,1441,2.9
21,17,Bourbon,2000,9996,9669,327,3.3
21,19,Boyd,2000,21471,20239,1232,5.7
21,21,Boyle,2000,13526,12993,533,3.9
21,23,Bracken,2000,4191,4045,146,3.5
21,25,Breathitt,2000,5398,5039,359,6.7
21,27,Breckinridge,2000,8667,8257,410,4.7
21,29,Bullitt,2000,33514,32435,1079,3.2
21,31,Butler,2000,6610,6344,266,4.0
21,33,Caldwell,2000,6207,5934,273,4.4
21,35,Calloway,2000,17309,16634,675,3.9
21,37,Campbell,2000,46627,45111,1516,3.3
21,39,Carlisle,2000,2410,2264,146,6.1
21,41,Carroll,2000,4974,4761,213,4.3
21,43,Carter,2000,11746,10907,839,7.1
21,45,Casey,2000,6869,6557,312,4.5
21,47,Christian,2000,26464,25207,1257,4.7
21,49,Clark,2000,17028,16403,625,3.7
21,51,Clay,2000,7229,6756,473,6.5
21,53,Clinton,2000,4528,4303,225,5.0
21,55,Crittenden,2000,4353,4076,277,6.4
21,57,Cumberland,2000,3187,3007,180,5.6
21,59,Daviess,2000,46839,44887,1952,4.2
21,61,Edmonson,2000,5034,4787,247,4.9
21,63,Elliott,2000,2458,2241,217,8.8
21,65,Estill,2000,6024,5738,286,4.7
21,67,Fayette,2000,149579,145236,4343,2.9
21,69,Fleming,2000,6488,6187,301,4.6
21,71,Floyd,2000,13815,12868,947,6.9
21,73,Franklin,2000,25464,24615,849,3.3
21,75,Fulton,2000,3147,2982,165,5.2
21,77,Gallatin,2000,3917,3764,153,3.9
21,79,Garrard,2000,7567,7305,262,3.5
21,81,Grant,2000,11584,11143,441,3.8
21,83,Graves,2000,17147,16303,844,4.9
21,85,Grayson,2000,11256,10682,574,5.1
21,87,Green,2000,5345,5102,243,4.5
21,89,Greenup,2000,15824,14910,914,5.8
21,91,Hancock,2000,4185,3980,205,4.9
21,93,Hardin,2000,43043,41203,1840,4.3
21,95,Harlan,2000,10039,9216,823,8.2
21,97,Harrison,2000,9145,8823,322,3.5
21,99,Hart,2000,7637,7280,357,4.7
21,101,Henderson,2000,22860,22064,796,3.5
21,103,Henry,2000,7780,7535,245,3.1
21,105,Hickman,2000,2367,2257,110,4.6
21,107,Hopkins,2000,21259,20125,1134,5.3
21,109,Jackson,2000,5043,4760,283,5.6
21,111,Jefferson,2000,362574,349348,13226,3.6
21,113,Jessamine,2000,20689,20084,605,2.9
21,115,Johnson,2000,9091,8573,518,5.7
21,117,Kenton,2000,83076,80423,2653,3.2
21,119,Knott,2000,5708,5293,415,7.3
21,121,Knox,2000,11116,10484,632,5.7
21,123,Larue,2000,6422,6141,281,4.4
21,125,Laurel,2000,24149,23148,1001,4.1
21,127,Lawrence,2000,5496,5119,377,6.9
21,129,Lee,2000,2491,2346,145,5.8
21,131,Leslie,2000,3931,3703,228,5.8
21,133,Letcher,2000,8799,8117,682,7.8
21,135,Lewis,2000,5606,5130,476,8.5
21,137,Lincoln,2000,10827,10389,438,4.0
21,139,Livingston,2000,4929,4654,275,5.6
21,141,Logan,2000,13266,12784,482,3.6
21,143,Lyon,2000,3154,2978,176,5.6
21,145,McCracken,2000,31641,30191,1450,4.6
21,147,McCreary,2000,6068,5668,400,6.6
21,149,McLean,2000,4763,4525,238,5.0
21,151,Madison,2000,37428,36111,1317,3.5
21,153,Magoffin,2000,4448,3984,464,10.4
21,155,Marion,2000,8591,8163,428,5.0
21,157,Marshall,2000,14757,14010,747,5.1
21,159,Martin,2000,3448,3200,248,7.2
21,161,Mason,2000,8303,7995,308,3.7
21,163,Meade,2000,11731,11261,470,4.0
21,165,Menifee,2000,2602,2441,161,6.2
21,167,Mercer,2000,10699,10297,402,3.8
21,169,Metcalfe,2000,4601,4395,206,4.5
21,171,Monroe,2000,5397,4963,434,8.0
21,173,Montgomery,2000,11218,10734,484,4.3
21,175,Morgan,2000,4876,4565,311,6.4
21,177,Muhlenberg,2000,13095,12336,759,5.8
21,179,Nelson,2000,19647,18834,813,4.1
21,181,Nicholas,2000,3265,3038,227,7.0
21,183,Ohio,2000,10573,10036,537,5.1
21,185,Oldham,2000,24078,23363,715,3.0
21,187,Owen,2000,4998,4818,180,3.6
21,189,Owsley,2000,1525,1439,86,5.6
21,191,Pendleton,2000,7169,6923,246,3.4
21,193,Perry,2000,9989,9328,661,6.6
21,195,Pike,2000,24910,23402,1508,6.1
21,197,Powell,2000,5811,5529,282,4.9
21,199,Pulaski,2000,25693,24583,1110,4.3
21,201,Robertson,2000,1092,1045,47,4.3
21,203,Rockcastle,2000,7154,6820,334,4.7
21,205,Rowan,2000,10783,10320,463,4.3
21,207,Russell,2000,7433,7013,420,5.7
21,209,Scott,2000,18354,17784,570,3.1
21,211,Shelby,2000,18345,17797,548,3.0
21,213,Simpson,2000,8475,8187,288,3.4
21,215,Spencer,2000,6532,6337,195,3.0
21,217,Taylor,2000,11191,10618,573,5.1
21,219,Todd,2000,5754,5520,234,4.1
21,221,Trigg,2000,5952,5688,264,4.4
21,223,Trimble,2000,4087,3935,152,3.7
21,225,Union,2000,7415,7068,347,4.7
21,227,Warren,2000,50234,48387,1847,3.7
21,229,Washington,2000,5225,5012,213,4.1
21,231,Wayne,2000,8172,7729,443,5.4
21,233,Webster,2000,6777,6469,308,4.5
21,235,Whitley,2000,14285,13593,692,4.8
21,237,Wolfe,2000,2520,2309,211,8.4
21,239,Woodford,2000,13423,13057,366,2.7
22,1,Acadia Parish,2000,23815,22469,1346,5.7
22,3,Allen Parish,2000,8687,8118,569,6.6
22,5,Ascension Parish,2000,38264,36297,1967,5.1
22,7,Assumption Parish,2000,9957,9335,622,6.2
22,9,Avoyelles Parish,2000,15650,14678,972,6.2
22,11,Beauregard Parish,2000,13959,13238,721,5.2
22,13,Bienville Parish,2000,5911,5524,387,6.5
22,15,Bossier Parish,2000,46913,44731,2182,4.7
22,17,Caddo Parish,2000,114488,108745,5743,5.0
22,19,Calcasieu Parish,2000,86147,81897,4250,4.9
22,21,Caldwell Parish,2000,4332,4045,287,6.6
22,23,Cameron Parish,2000,4520,4300,220,4.9
22,25,Catahoula Parish,2000,4123,3746,377,9.1
22,27,Claiborne Parish,2000,6461,6058,403,6.2
22,29,Concordia Parish,2000,7728,7092,636,8.2
22,31,De Soto Parish,2000,10753,10106,647,6.0
22,33,East Baton Rouge Parish,2000,206329,197064,9265,4.5
22,35,East Carroll Parish,2000,3091,2800,291,9.4
22,37,East Feliciana Parish,2000,8242,7782,460,5.6
22,39,Evangeline Parish,2000,12090,11390,700,5.8
22,41,Franklin Parish,2000,8171,7588,583,7.1
22,43,Grant Parish,2000,7874,7392,482,6.1
22,45,Iberia Parish,2000,30367,28654,1713,5.6
22,47,Iberville Parish,2000,12564,11701,863,6.9
22,49,Jackson Parish,2000,6681,6311,370,5.5
22,51,Jefferson Parish,2000,231068,220742,10326,4.5
22,53,Jefferson Davis Parish,2000,12739,12012,727,5.7
22,55,Lafayette Parish,2000,97017,93156,3861,4.0
22,57,Lafourche Parish,2000,40936,39150,1786,4.4
22,59,LaSalle Parish,2000,5871,5539,332,5.7
22,61,Lincoln Parish,2000,19004,18006,998,5.3
22,63,Livingston Parish,2000,44619,42171,2448,5.5
22,65,Madison Parish,2000,4949,4561,388,7.8
22,67,Morehouse Parish,2000,12414,11490,924,7.4
22,69,Natchitoches Parish,2000,16533,15587,946,5.7
22,71,Orleans Parish,2000,210183,199041,11142,5.3
22,73,Ouachita Parish,2000,69592,66383,3209,4.6
22,75,Plaquemines Parish,2000,10981,10360,621,5.7
22,77,Pointe Coupee Parish,2000,9711,9116,595,6.1
22,79,Rapides Parish,2000,55496,52573,2923,5.3
22,81,Red River Parish,2000,3535,3296,239,6.8
22,83,Richland Parish,2000,8637,8058,579,6.7
22,85,Sabine Parish,2000,9263,8792,471,5.1
22,87,St. Bernard Parish,2000,32101,30398,1703,5.3
22,89,St. Charles Parish,2000,23836,22544,1292,5.4
22,91,St. Helena Parish,2000,4043,3816,227,5.6
22,93,St. James Parish,2000,8809,8073,736,8.4
22,95,St. John the Baptist Parish,2000,19950,18633,1317,6.6
22,97,St. Landry Parish,2000,32607,30545,2062,6.3
22,99,St. Martin Parish,2000,21267,20119,1148,5.4
22,101,St. Mary Parish,2000,22398,20789,1609,7.2
22,103,St. Tammany Parish,2000,96134,92089,4045,4.2
22,105,Tangipahoa Parish,2000,44999,42171,2828,6.3
22,107,Tensas Parish,2000,2469,2286,183,7.4
22,109,Terrebonne Parish,2000,45649,43586,2063,4.5
22,111,Union Parish,2000,10150,9588,562,5.5
22,113,Vermilion Parish,2000,23222,22022,1200,5.2
22,115,Vernon Parish,2000,18230,17140,1090,6.0
22,117,Washington Parish,2000,16722,15711,1011,6.0
22,119,Webster Parish,2000,18383,17289,1094,6.0
22,121,West Baton Rouge Parish,2000,10128,9607,521,5.1
22,123,West Carroll Parish,2000,4830,4379,451,9.3
22,125,West Feliciana Parish,2000,4790,4476,314,6.6
22,127,Winn Parish,2000,6014,5630,384,6.4
23,1,Androscoggin,2000,55658,53781,1877,3.4
23,3,Aroostook,2000,34890,33435,1455,4.2
23,5,Cumberland,2000,149798,146122,3676,2.5
23,7,Franklin,2000,14475,13754,721,5.0
23,9,Hancock,2000,28841,27688,1153,4.0
23,11,Kennebec,2000,61285,59157,2128,3.5
23,13,Knox,2000,21005,20429,576,2.7
23,15,Lincoln,2000,17893,17359,534,3.0
23,17,Oxford,2000,27797,26672,1125,4.0
23,19,Penobscot,2000,75415,72659,2756,3.7
23,21,Piscataquis,2000,7954,7541,413,5.2
23,23,Sagadahoc,2000,18934,18434,500,2.6
23,25,Somerset,2000,25228,24035,1193,4.7
23,27,Waldo,2000,19123,18380,743,3.9
23,29,Washington,2000,15790,14858,932,5.9
23,31,York,2000,103380,100664,2716,2.6
24,1,Allegany,2000,32861,30932,1929,5.9
24,3,Anne Arundel,2000,267305,259292,8013,3.0
24,5,Baltimore,2000,407954,392949,15005,3.7
24,9,Calvert,2000,40333,39130,1203,3.0
24,11,Caroline,2000,15346,14798,548,3.6
24,13,Carroll,2000,83866,81396,2470,2.9
24,15,Cecil,2000,45734,44136,1598,3.5
24,17,Charles,2000,65066,63161,1905,2.9
24,19,Dorchester,2000,15572,14783,789,5.1
24,21,Frederick,2000,109517,106576,2941,2.7
24,23,Garrett,2000,14501,13755,746,5.1
24,25,Harford,2000,119773,115914,3859,3.2
24,27,Howard,2000,144498,140894,3604,2.5
24,29,Kent,2000,10056,9671,385,3.8
24,31,Montgomery,2000,487315,474624,12691,2.6
24,33,Prince George's,2000,428841,413166,15675,3.7
24,35,Queen Anne's,2000,22680,21992,688,3.0
24,37,St. Mary's,2000,44305,42880,1425,3.2
24,39,Somerset,2000,10437,9792,645,6.2
24,41,Talbot,2000,17500,16921,579,3.3
24,43,Washington,2000,66087,63693,2394,3.6
24,45,Wicomico,2000,46184,44279,1905,4.1
24,47,Worcester,2000,25963,24387,1576,6.1
24,510,Baltimore city,2000,279702,263314,16388,5.9
25,1,Barnstable,2000,112651,108650,4001,3.6
25,3,Berkshire,2000,69644,67532,2112,3.0
25,5,Bristol,2000,276086,265425,10661,3.9
25,7,Dukes,2000,9996,9710,286,2.9
25,9,Essex,2000,370168,359545,10623,2.9
25,11,Franklin,2000,38733,37740,993,2.6
25,13,Hampden,2000,217628,210159,7469,3.4
25,15,Hampshire,2000,85354,83415,1939,2.3
25,17,Middlesex,2000,815566,797007,18559,2.3
25,19,Nantucket/town,2000,7228,7118,110,1.5
25,21,Norfolk,2000,354448,345915,8533,2.4
25,23,Plymouth,2000,249496,242500,6996,2.8
25,25,Suffolk,2000,348509,337550,10959,3.1
25,27,Worcester,2000,385069,374091,10978,2.9
26,1,Alcona,2000,4476,4161,315,7.0
26,3,Alger,2000,4379,4136,243,5.5
26,5,Allegan,2000,57841,56128,1713,3.0
26,7,Alpena,2000,15556,14666,890,5.7
26,9,Antrim,2000,11615,11062,553,4.8
26,11,Arenac,2000,7663,7205,458,6.0
26,13,Baraga,2000,4127,3849,278,6.7
26,15,Barry,2000,30460,29413,1047,3.4
26,17,Bay,2000,56876,54488,2388,4.2
26,19,Benzie,2000,8396,8005,391,4.7
26,21,Berrien,2000,82599,79371,3228,3.9
26,23,Branch,2000,23437,22512,925,3.9
26,25,Calhoun,2000,70440,67415,3025,4.3
26,27,Cass,2000,27105,26217,888,3.3
26,29,Charlevoix,2000,13829,13188,641,4.6
26,31,Cheboygan,2000,12973,11884,1089,8.4
26,33,Chippewa,2000,17485,16335,1150,6.6
26,35,Clare,2000,13046,12315,731,5.6
26,37,Clinton,2000,35575,34616,959,2.7
26,39,Crawford,2000,6709,6389,320,4.8
26,41,Delta,2000,19835,18748,1087,5.5
26,43,Dickinson,2000,14012,13411,601,4.3
26,45,Eaton,2000,57825,56143,1682,2.9
26,47,Emmet,2000,18076,17052,1024,5.7
26,49,Genesee,2000,215258,205370,9888,4.6
26,51,Gladwin,2000,10977,10376,601,5.5
26,53,Gogebic,2000,7739,7235,504,6.5
26,55,Grand Traverse,2000,45576,43963,1613,3.5
26,57,Gratiot,2000,19555,18635,920,4.7
26,59,Hillsdale,2000,24188,23264,924,3.8
26,61,Houghton,2000,17140,16272,868,5.1
26,63,Huron,2000,17620,16787,833,4.7
26,65,Ingham,2000,154290,149582,4708,3.1
26,67,Ionia,2000,30034,28896,1138,3.8
26,69,Iosco,2000,11631,10852,779,6.7
26,71,Iron,2000,5669,5327,342,6.0
26,73,Isabella,2000,34809,33615,1194,3.4
26,75,Jackson,2000,79143,76344,2799,3.5
26,77,Kalamazoo,2000,132912,128810,4102,3.1
26,79,Kalkaska,2000,8557,8144,413,4.8
26,81,Kent,2000,319225,308997,10228,3.2
26,83,Keweenaw,2000,1052,984,68,6.5
26,85,Lake,2000,4465,4202,263,5.9
26,87,Lapeer,2000,46111,44285,1826,4.0
26,89,Leelanau,2000,11325,10966,359,3.2
26,91,Lenawee,2000,51742,49736,2006,3.9
26,93,Livingston,2000,90176,88002,2174,2.4
26,95,Luce,2000,2757,2585,172,6.2
26,97,Mackinac,2000,6892,6356,536,7.8
26,99,Macomb,2000,435921,421465,14456,3.3
26,101,Manistee,2000,11847,11192,655,5.5
26,103,Marquette,2000,34199,32658,1541,4.5
26,105,Mason,2000,14746,14007,739,5.0
26,107,Mecosta,2000,18935,18100,835,4.4
26,109,Menominee,2000,13282,12710,572,4.3
26,111,Midland,2000,42571,41136,1435,3.4
26,113,Missaukee,2000,7005,6682,323,4.6
26,115,Monroe,2000,77244,74707,2537,3.3
26,117,Montcalm,2000,29431,28170,1261,4.3
26,119,Montmorency,2000,4096,3754,342,8.3
26,121,Muskegon,2000,85667,82033,3634,4.2
26,123,Newaygo,2000,23067,21973,1094,4.7
26,125,Oakland,2000,679479,661632,17847,2.6
26,127,Oceana,2000,13238,12434,804,6.1
26,129,Ogemaw,2000,9614,9075,539,5.6
26,131,Ontonagon,2000,3656,3415,241,6.6
26,133,Osceola,2000,11184,10659,525,4.7
26,135,Oscoda,2000,3902,3655,247,6.3
26,137,Otsego,2000,12359,11829,530,4.3
26,139,Ottawa,2000,136110,132366,3744,2.8
26,141,Presque Isle,2000,6516,5958,558,8.6
26,143,Roscommon,2000,10395,9804,591,5.7
26,145,Saginaw,2000,100311,96068,4243,4.2
26,147,St. Clair,2000,87419,84040,3379,3.9
26,149,St. Joseph,2000,32591,31453,1138,3.5
26,151,Sanilac,2000,21958,20910,1048,4.8
26,153,Schoolcraft,2000,3933,3604,329,8.4
26,155,Shiawassee,2000,37425,35925,1500,4.0
26,157,Tuscola,2000,28756,27397,1359,4.7
26,159,Van Buren,2000,39663,38015,1648,4.2
26,161,Washtenaw,2000,185256,180782,4474,2.4
26,163,Wayne,2000,956145,918242,37903,4.0
26,165,Wexford,2000,15612,14746,866,5.5
27,1,Aitkin,2000,7157,6732,425,5.9
27,3,Anoka,2000,178460,173770,4690,2.6
27,5,Becker,2000,15564,14815,749,4.8
27,7,Beltrami,2000,20245,19330,915,4.5
27,9,Benton,2000,20503,19813,690,3.4
27,11,Big Stone,2000,2767,2652,115,4.2
27,13,Blue Earth,2000,33769,32854,915,2.7
27,15,Brown,2000,15359,14799,560,3.6
27,17,Carlton,2000,15816,15065,751,4.7
27,19,Carver,2000,40886,39928,958,2.3
27,21,Cass,2000,13341,12634,707,5.3
27,23,Chippewa,2000,7092,6748,344,4.9
27,25,Chisago,2000,23131,22311,820,3.5
27,27,Clay,2000,27944,27073,871,3.1
27,29,Clearwater,2000,4178,3797,381,9.1
27,31,Cook,2000,3122,2999,123,3.9
27,33,Cottonwood,2000,6244,5954,290,4.6
27,35,Crow Wing,2000,28973,27829,1144,3.9
27,37,Dakota,2000,216174,211085,5089,2.4
27,39,Dodge,2000,10188,9891,297,2.9
27,41,Douglas,2000,18139,17554,585,3.2
27,43,Faribault,2000,8576,8264,312,3.6
27,45,Fillmore,2000,11703,11344,359,3.1
27,47,Freeborn,2000,17363,16771,592,3.4
27,49,Goodhue,2000,25043,24295,748,3.0
27,51,Grant,2000,3282,3124,158,4.8
27,53,Hennepin,2000,663451,646167,17284,2.6
27,55,Houston,2000,10903,10474,429,3.9
27,57,Hubbard,2000,9113,8676,437,4.8
27,59,Isanti,2000,17855,17265,590,3.3
27,61,Itasca,2000,21575,20367,1208,5.6
27,63,Jackson,2000,6127,5942,185,3.0
27,65,Kanabec,2000,7889,7522,367,4.7
27,67,Kandiyohi,2000,22843,22124,719,3.1
27,69,Kittson,2000,2570,2431,139,5.4
27,71,Koochiching,2000,7221,6855,366,5.1
27,73,Lac qui Parle,2000,4113,3975,138,3.4
27,75,Lake,2000,5899,5658,241,4.1
27,77,Lake of the Woods,2000,2340,2248,92,3.9
27,79,Le Sueur,2000,14881,14326,555,3.7
27,81,Lincoln,2000,3454,3332,122,3.5
27,83,Lyon,2000,14612,14199,413,2.8
27,85,McLeod,2000,20199,19555,644,3.2
27,87,Mahnomen,2000,2464,2326,138,5.6
27,89,Marshall,2000,5176,4778,398,7.7
27,91,Martin,2000,11677,11279,398,3.4
27,93,Meeker,2000,12277,11764,513,4.2
27,95,Mille Lacs,2000,11821,11306,515,4.4
27,97,Morrison,2000,16629,15877,752,4.5
27,99,Mower,2000,19898,19337,561,2.8
27,101,Murray,2000,5173,4982,191,3.7
27,103,Nicollet,2000,18060,17581,479,2.7
27,105,Nobles,2000,11063,10737,326,2.9
27,107,Norman,2000,3711,3549,162,4.4
27,109,Olmsted,2000,72411,70534,1877,2.6
27,111,Otter Tail,2000,29225,28046,1179,4.0
27,113,Pennington,2000,7646,7202,444,5.8
27,115,Pine,2000,13379,12696,683,5.1
27,117,Pipestone,2000,5394,5215,179,3.3
27,119,Polk,2000,15759,15025,734,4.7
27,121,Pope,2000,5849,5678,171,2.9
27,123,Ramsey,2000,285276,277372,7904,2.8
27,125,Red Lake,2000,2198,2039,159,7.2
27,127,Redwood,2000,8872,8597,275,3.1
27,129,Renville,2000,9134,8780,354,3.9
27,131,Rice,2000,31461,30514,947,3.0
27,133,Rock,2000,5225,5087,138,2.6
27,135,Roseau,2000,9262,8934,328,3.5
27,137,St. Louis,2000,102968,98596,4372,4.2
27,139,Scott,2000,54095,52722,1373,2.5
27,141,Sherburne,2000,37720,36612,1108,2.9
27,143,Sibley,2000,8756,8480,276,3.2
27,145,Stearns,2000,77990,75639,2351,3.0
27,147,Steele,2000,19419,18873,546,2.8
27,149,Stevens,2000,5677,5488,189,3.3
27,151,Swift,2000,5654,5442,212,3.7
27,153,Todd,2000,12331,11865,466,3.8
27,155,Traverse,2000,1808,1724,84,4.6
27,157,Wabasha,2000,12263,11916,347,2.8
27,159,Wadena,2000,6659,6325,334,5.0
27,161,Waseca,2000,10564,10256,308,2.9
27,163,Washington,2000,117541,114732,2809,2.4
27,165,Watonwan,2000,6029,5835,194,3.2
27,167,Wilkin,2000,3681,3572,109,3.0
27,169,Winona,2000,28814,27951,863,3.0
27,171,Wright,2000,52339,50720,1619,3.1
27,173,Yellow Medicine,2000,5708,5473,235,4.1
28,1,Adams,2000,14470,13571,899,6.2
28,3,Alcorn,2000,16633,15831,802,4.8
28,5,Amite,2000,5530,5239,291,5.3
28,7,Attala,2000,8316,7734,582,7.0
28,9,Benton,2000,3191,2986,205,6.4
28,11,Bolivar,2000,16196,15047,1149,7.1
28,13,Calhoun,2000,6914,6524,390,5.6
28,15,Carroll,2000,5015,4732,283,5.6
28,17,Chickasaw,2000,8763,8299,464,5.3
28,19,Choctaw,2000,4021,3723,298,7.4
28,21,Claiborne,2000,4266,3883,383,9.0
28,23,Clarke,2000,7598,6980,618,8.1
28,25,Clay,2000,9734,9141,593,6.1
28,27,Coahoma,2000,11731,10842,889,7.6
28,29,Copiah,2000,12208,11458,750,6.1
28,31,Covington,2000,8378,7921,457,5.5
28,33,DeSoto,2000,58817,57421,1396,2.4
28,35,Forrest,2000,35007,33336,1671,4.8
28,37,Franklin,2000,3434,3212,222,6.5
28,39,George,2000,8367,7740,627,7.5
28,41,Greene,2000,4774,4372,402,8.4
28,43,Grenada,2000,10514,9939,575,5.5
28,45,Hancock,2000,19461,18565,896,4.6
28,47,Harrison,2000,90600,86470,4130,4.6
28,49,Hinds,2000,122075,116000,6075,5.0
28,51,Holmes,2000,7566,6582,984,13.0
28,53,Humphreys,2000,4231,3840,391,9.2
28,55,Issaquena,2000,844,759,85,10.1
28,57,Itawamba,2000,11096,10520,576,5.2
28,59,Jackson,2000,63281,59702,3579,5.7
28,61,Jasper,2000,7416,6989,427,5.8
28,63,Jefferson,2000,3155,2781,374,11.9
28,65,Jefferson Davis,2000,5413,4889,524,9.7
28,67,Jones,2000,29850,28546,1304,4.4
28,69,Kemper,2000,4386,4027,359,8.2
28,71,Lafayette,2000,19696,18849,847,4.3
28,73,Lamar,2000,19975,19190,785,3.9
28,75,Lauderdale,2000,34451,32523,1928,5.6
28,77,Lawrence,2000,5905,5457,448,7.6
28,79,Leake,2000,8873,8322,551,6.2
28,81,Lee,2000,39738,38008,1730,4.4
28,83,Leflore,2000,14549,13282,1267,8.7
28,85,Lincoln,2000,14671,13887,784,5.3
28,87,Lowndes,2000,27567,26054,1513,5.5
28,89,Madison,2000,39219,37614,1605,4.1
28,91,Marion,2000,10605,9979,626,5.9
28,93,Marshall,2000,15221,14593,628,4.1
28,95,Monroe,2000,17639,16412,1227,7.0
28,97,Montgomery,2000,5317,4987,330,6.2
28,99,Neshoba,2000,13313,12613,700,5.3
28,101,Newton,2000,9815,9277,538,5.5
28,103,Noxubee,2000,4705,4293,412,8.8
28,105,Oktibbeha,2000,20670,19628,1042,5.0
28,107,Panola,2000,14679,13667,1012,6.9
28,109,Pearl River,2000,21193,20139,1054,5.0
28,111,Perry,2000,5174,4860,314,6.1
28,113,Pike,2000,16027,15026,1001,6.2
28,115,Pontotoc,2000,13627,13017,610,4.5
28,117,Prentiss,2000,12241,11625,616,5.0
28,119,Quitman,2000,4015,3729,286,7.1
28,121,Rankin,2000,63192,60964,2228,3.5
28,123,Scott,2000,12700,12112,588,4.6
28,125,Sharkey,2000,2629,2374,255,9.7
28,127,Simpson,2000,11822,11259,563,4.8
28,129,Smith,2000,7315,6972,343,4.7
28,131,Stone,2000,6553,6194,359,5.5
28,133,Sunflower,2000,12070,11012,1058,8.8
28,135,Tallahatchie,2000,6011,5528,483,8.0
28,137,Tate,2000,11683,11265,418,3.6
28,139,Tippah,2000,9777,9234,543,5.6
28,141,Tishomingo,2000,8906,8289,617,6.9
28,143,Tunica,2000,4023,3825,198,4.9
28,145,Union,2000,12488,11943,545,4.4
28,147,Walthall,2000,6299,5876,423,6.7
28,149,Warren,2000,24281,23077,1204,5.0
28,151,Washington,2000,25944,23973,1971,7.6
28,153,Wayne,2000,8794,8237,557,6.3
28,155,Webster,2000,4680,4453,227,4.9
28,157,Wilkinson,2000,3511,3218,293,8.3
28,159,Winston,2000,8656,8075,581,6.7
28,161,Yalobusha,2000,5724,5396,328,5.7
28,163,Yazoo,2000,10690,9937,753,7.0
29,1,Adair,2000,13738,13334,404,2.9
29,3,Andrew,2000,8854,8583,271,3.1
29,5,Atchison,2000,3470,3380,90,2.6
29,7,Audrain,2000,13162,12761,401,3.0
29,9,Barry,2000,17280,16706,574,3.3
29,11,Barton,2000,6749,6567,182,2.7
29,13,Bates,2000,8169,7871,298,3.6
29,15,Benton,2000,7753,7351,402,5.2
29,17,Bollinger,2000,6243,5985,258,4.1
29,19,Boone,2000,79087,77331,1756,2.2
29,21,Buchanan,2000,42508,41011,1497,3.5
29,23,Butler,2000,19857,18933,924,4.7
29,25,Caldwell,2000,4467,4319,148,3.3
29,27,Callaway,2000,21850,21229,621,2.8
29,29,Camden,2000,19838,19037,801,4.0
29,31,Cape Girardeau,2000,40258,39073,1185,2.9
29,33,Carroll,2000,5220,5051,169,3.2
29,35,Carter,2000,2627,2483,144,5.5
29,37,Cass,2000,44968,43731,1237,2.8
29,39,Cedar,2000,6114,5892,222,3.6
29,41,Chariton,2000,4490,4326,164,3.7
29,43,Christian,2000,30728,29860,868,2.8
29,45,Clark,2000,3822,3683,139,3.6
29,47,Clay,2000,107238,104635,2603,2.4
29,49,Clinton,2000,9982,9687,295,3.0
29,51,Cole,2000,39799,38767,1032,2.6
29,53,Cooper,2000,8362,8094,268,3.2
29,55,Crawford,2000,11397,10902,495,4.3
29,57,Dade,2000,3880,3746,134,3.5
29,59,Dallas,2000,7192,6875,317,4.4
29,61,Daviess,2000,4044,3916,128,3.2
29,63,DeKalb,2000,4967,4776,191,3.8
29,65,Dent,2000,7085,6751,334,4.7
29,67,Douglas,2000,6270,5990,280,4.5
29,69,Dunklin,2000,15171,14496,675,4.4
29,71,Franklin,2000,51145,49321,1824,3.6
29,73,Gasconade,2000,8070,7797,273,3.4
29,75,Gentry,2000,3438,3331,107,3.1
29,77,Greene,2000,132532,128801,3731,2.8
29,79,Grundy,2000,5401,5229,172,3.2
29,81,Harrison,2000,4657,4514,143,3.1
29,83,Henry,2000,11395,10991,404,3.5
29,85,Hickory,2000,3425,3221,204,6.0
29,87,Holt,2000,2812,2726,86,3.1
29,89,Howard,2000,5380,5219,161,3.0
29,91,Howell,2000,18738,18042,696,3.7
29,93,Iron,2000,4950,4680,270,5.5
29,95,Jackson,2000,348024,335799,12225,3.5
29,97,Jasper,2000,54160,52382,1778,3.3
29,99,Jefferson,2000,110571,107054,3517,3.2
29,101,Johnson,2000,24854,24067,787,3.2
29,103,Knox,2000,2195,2119,76,3.5
29,105,Laclede,2000,17074,16454,620,3.6
29,107,Lafayette,2000,17557,16996,561,3.2
29,109,Lawrence,2000,18438,17852,586,3.2
29,111,Lewis,2000,5683,5495,188,3.3
29,113,Lincoln,2000,20720,20036,684,3.3
29,115,Linn,2000,7238,6874,364,5.0
29,117,Livingston,2000,7581,7374,207,2.7
29,119,McDonald,2000,10700,10320,380,3.6
29,121,Macon,2000,8617,8261,356,4.1
29,123,Madison,2000,5618,5349,269,4.8
29,125,Maries,2000,4704,4533,171,3.6
29,127,Marion,2000,15075,14500,575,3.8
29,129,Mercer,2000,1982,1925,57,2.9
29,131,Miller,2000,12820,12268,552,4.3
29,133,Mississippi,2000,6227,5907,320,5.1
29,135,Moniteau,2000,7472,7242,230,3.1
29,137,Monroe,2000,4917,4733,184,3.7
29,139,Montgomery,2000,6387,6171,216,3.4
29,141,Morgan,2000,9597,9207,390,4.1
29,143,New Madrid,2000,9515,9061,454,4.8
29,145,Newton,2000,27636,26589,1047,3.8
29,147,Nodaway,2000,12404,12118,286,2.3
29,149,Oregon,2000,4479,4306,173,3.9
29,151,Osage,2000,7390,7109,281,3.8
29,153,Ozark,2000,4448,4260,188,4.2
29,155,Pemiscot,2000,8447,7978,469,5.6
29,157,Perry,2000,10353,10086,267,2.6
29,159,Pettis,2000,21290,20582,708,3.3
29,161,Phelps,2000,20248,19559,689,3.4
29,163,Pike,2000,8854,8543,311,3.5
29,165,Platte,2000,45078,44064,1014,2.2
29,167,Polk,2000,13133,12730,403,3.1
29,169,Pulaski,2000,15418,14669,749,4.9
29,171,Putnam,2000,2516,2434,82,3.3
29,173,Ralls,2000,5729,5525,204,3.6
29,175,Randolph,2000,12373,11908,465,3.8
29,177,Ray,2000,12100,11666,434,3.6
29,179,Reynolds,2000,2810,2612,198,7.0
29,181,Ripley,2000,5837,5546,291,5.0
29,183,St. Charles,2000,166638,162482,4156,2.5
29,185,St. Clair,2000,4471,4297,174,3.9
29,186,Ste. Genevieve,2000,9665,9357,308,3.2
29,187,St. Francois,2000,26062,24628,1434,5.5
29,189,St. Louis,2000,556301,539860,16441,3.0
29,195,Saline,2000,12923,12552,371,2.9
29,197,Schuyler,2000,2225,2129,96,4.3
29,199,Scotland,2000,2634,2558,76,2.9
29,201,Scott,2000,21107,20203,904,4.3
29,203,Shannon,2000,3901,3694,207,5.3
29,205,Shelby,2000,3741,3569,172,4.6
29,207,Stoddard,2000,15144,14514,630,4.2
29,209,Stone,2000,14925,14019,906,6.1
29,211,Sullivan,2000,3781,3668,113,3.0
29,213,Taney,2000,23948,22383,1565,6.5
29,215,Texas,2000,10890,10350,540,5.0
29,217,Vernon,2000,10588,10289,299,2.8
29,219,Warren,2000,13559,13114,445,3.3
29,221,Washington,2000,9935,9354,581,5.8
29,223,Wayne,2000,5513,5220,293,5.3
29,225,Webster,2000,15166,14645,521,3.4
29,227,Worth,2000,1216,1172,44,3.6
29,229,Wright,2000,8436,8064,372,4.4
29,510,St. Louis city,2000,161831,153072,8759,5.4
30,1,Beaverhead,2000,5042,4832,210,4.2
30,3,Big Horn,2000,5462,4942,520,9.5
30,5,Blaine,2000,2986,2821,165,5.5
30,7,Broadwater,2000,2243,2141,102,4.5
30,9,Carbon,2000,5006,4782,224,4.5
30,11,Carter,2000,778,750,28,3.6
30,13,Cascade,2000,38426,36506,1920,5.0
30,15,Chouteau,2000,2814,2707,107,3.8
30,17,Custer,2000,6007,5731,276,4.6
30,19,Daniels,2000,978,932,46,4.7
30,21,Dawson,2000,4781,4585,196,4.1
30,23,Deer Lodge,2000,4261,3954,307,7.2
30,25,Fallon,2000,1551,1494,57,3.7
30,27,Fergus,2000,6141,5815,326,5.3
30,29,Flathead,2000,39434,37337,2097,5.3
30,31,Gallatin,2000,41704,40191,1513,3.6
30,33,Garfield,2000,709,679,30,4.2
30,35,Glacier,2000,5735,5265,470,8.2
30,37,Golden Valley,2000,548,519,29,5.3
30,39,Granite,2000,1359,1274,85,6.3
30,41,Hill,2000,8027,7630,397,4.9
30,43,Jefferson,2000,5388,5132,256,4.8
30,45,Judith Basin,2000,1186,1131,55,4.6
30,47,Lake,2000,12358,11671,687,5.6
30,49,Lewis and Clark,2000,31289,30019,1270,4.1
30,51,Liberty,2000,966,925,41,4.2
30,53,Lincoln,2000,7914,7245,669,8.5
30,55,McCone,2000,1106,1065,41,3.7
30,57,Madison,2000,3367,3197,170,5.0
30,59,Meagher,2000,996,937,59,5.9
30,61,Mineral,2000,1894,1770,124,6.5
30,63,Missoula,2000,54341,52135,2206,4.1
30,65,Musselshell,2000,2102,1973,129,6.1
30,67,Park,2000,9075,8606,469,5.2
30,69,Petroleum,2000,253,236,17,6.7
30,71,Phillips,2000,2331,2225,106,4.5
30,73,Pondera,2000,2990,2846,144,4.8
30,75,Powder River,2000,1006,967,39,3.9
30,77,Powell,2000,2894,2725,169,5.8
30,79,Prairie,2000,618,586,32,5.2
30,81,Ravalli,2000,17150,16227,923,5.4
30,83,Richland,2000,4993,4726,267,5.3
30,85,Roosevelt,2000,4275,3971,304,7.1
30,87,Rosebud,2000,4291,4037,254,5.9
30,89,Sanders,2000,4421,4113,308,7.0
30,91,Sheridan,2000,2026,1932,94,4.6
30,93,Silver Bow,2000,17240,16232,1008,5.8
30,95,Stillwater,2000,4434,4231,203,4.6
30,97,Sweet Grass,2000,1996,1932,64,3.2
30,99,Teton,2000,2988,2855,133,4.5
30,101,Toole,2000,2534,2430,104,4.1
30,103,Treasure,2000,459,437,22,4.8
30,105,Valley,2000,3862,3688,174,4.5
30,107,Wheatland,2000,1127,1072,55,4.9
30,109,Wibaux,2000,553,528,25,4.5
30,111,Yellowstone,2000,71661,68698,2963,4.1
31,1,Adams,2000,17137,16699,438,2.6
31,3,Antelope,2000,3954,3845,109,2.8
31,5,Arthur,2000,270,264,6,2.2
31,7,Banner,2000,425,413,12,2.8
31,9,Blaine,2000,317,306,11,3.5
31,11,Boone,2000,3206,3128,78,2.4
31,13,Box Butte,2000,6380,6132,248,3.9
31,15,Boyd,2000,1248,1211,37,3.0
31,17,Brown,2000,1907,1845,62,3.3
31,19,Buffalo,2000,24744,24178,566,2.3
31,21,Burt,2000,4103,3952,151,3.7
31,23,Butler,2000,4672,4541,131,2.8
31,25,Cass,2000,13467,13094,373,2.8
31,27,Cedar,2000,5007,4884,123,2.5
31,29,Chase,2000,2103,2054,49,2.3
31,31,Cherry,2000,3500,3411,89,2.5
31,33,Cheyenne,2000,5618,5489,129,2.3
31,35,Clay,2000,3618,3513,105,2.9
31,37,Colfax,2000,5646,5526,120,2.1
31,39,Cuming,2000,5642,5515,127,2.3
31,41,Custer,2000,6154,5998,156,2.5
31,43,Dakota,2000,10789,10442,347,3.2
31,45,Dawes,2000,5029,4878,151,3.0
31,47,Dawson,2000,12259,11886,373,3.0
31,49,Deuel,2000,1167,1133,34,2.9
31,51,Dixon,2000,3321,3236,85,2.6
31,53,Dodge,2000,19639,19031,608,3.1
31,55,Douglas,2000,256893,249183,7710,3.0
31,57,Dundy,2000,1201,1175,26,2.2
31,59,Fillmore,2000,3494,3404,90,2.6
31,61,Franklin,2000,1803,1754,49,2.7
31,63,Frontier,2000,1732,1689,43,2.5
31,65,Furnas,2000,2624,2551,73,2.8
31,67,Gage,2000,12540,12163,377,3.0
31,69,Garden,2000,1209,1178,31,2.6
31,71,Garfield,2000,1009,984,25,2.5
31,73,Gosper,2000,1134,1105,29,2.6
31,75,Grant,2000,436,426,10,2.3
31,77,Greeley,2000,1395,1354,41,2.9
31,79,Hall,2000,28700,27859,841,2.9
31,81,Hamilton,2000,5104,4984,120,2.4
31,83,Harlan,2000,1910,1861,49,2.6
31,85,Hayes,2000,582,562,20,3.4
31,87,Hitchcock,2000,1530,1490,40,2.6
31,89,Holt,2000,6221,6059,162,2.6
31,91,Hooker,2000,448,433,15,3.3
31,93,Howard,2000,3531,3441,90,2.5
31,95,Jefferson,2000,4345,4207,138,3.2
31,97,Johnson,2000,2489,2336,153,6.1
31,99,Kearney,2000,3717,3641,76,2.0
31,101,Keith,2000,4843,4712,131,2.7
31,103,Keya Paha,2000,496,484,12,2.4
31,105,Kimball,2000,2183,2130,53,2.4
31,107,Knox,2000,4782,4603,179,3.7
31,109,Lancaster,2000,147326,143874,3452,2.3
31,111,Lincoln,2000,18270,17692,578,3.2
31,113,Logan,2000,415,405,10,2.4
31,115,Loup,2000,333,325,8,2.4
31,117,McPherson,2000,271,266,5,1.8
31,119,Madison,2000,19149,18527,622,3.2
31,121,Merrick,2000,4259,4146,113,2.7
31,123,Morrill,2000,2780,2684,96,3.5
31,125,Nance,2000,2050,1988,62,3.0
31,127,Nemaha,2000,3750,3601,149,4.0
31,129,Nuckolls,2000,2562,2495,67,2.6
31,131,Otoe,2000,8270,8012,258,3.1
31,133,Pawnee,2000,1627,1570,57,3.5
31,135,Perkins,2000,1636,1599,37,2.3
31,137,Phelps,2000,5333,5215,118,2.2
31,139,Pierce,2000,4188,4080,108,2.6
31,141,Platte,2000,17356,16877,479,2.8
31,143,Polk,2000,3019,2951,68,2.3
31,145,Red Willow,2000,6148,5988,160,2.6
31,147,Richardson,2000,4695,4460,235,5.0
31,149,Rock,2000,1007,979,28,2.8
31,151,Saline,2000,7585,7389,196,2.6
31,153,Sarpy,2000,65526,64039,1487,2.3
31,155,Saunders,2000,10995,10686,309,2.8
31,157,Scotts Bluff,2000,18652,17906,746,4.0
31,159,Seward,2000,9132,8919,213,2.3
31,161,Sheridan,2000,3273,3178,95,2.9
31,163,Sherman,2000,1772,1722,50,2.8
31,165,Sioux,2000,796,782,14,1.8
31,167,Stanton,2000,3510,3420,90,2.6
31,169,Thayer,2000,3140,3061,79,2.5
31,171,Thomas,2000,414,393,21,5.1
31,173,Thurston,2000,2821,2626,195,6.9
31,175,Valley,2000,2411,2347,64,2.7
31,177,Washington,2000,10808,10548,260,2.4
31,179,Wayne,2000,5666,5522,144,2.5
31,181,Webster,2000,1950,1897,53,2.7
31,183,Wheeler,2000,496,484,12,2.4
31,185,York,2000,7793,7601,192,2.5
32,1,Churchill,2000,12057,11364,693,5.7
32,3,Clark,2000,732863,701741,31122,4.2
32,5,Douglas,2000,21882,21054,828,3.8
32,7,Elko,2000,24401,23519,882,3.6
32,9,Esmeralda,2000,513,472,41,8.0
32,11,Eureka,2000,800,776,24,3.0
32,13,Humboldt,2000,7849,7494,355,4.5
32,15,Lander,2000,2868,2715,153,5.3
32,17,Lincoln,2000,1666,1590,76,4.6
32,19,Lyon,2000,18035,17067,968,5.4
32,21,Mineral,2000,2364,2183,181,7.7
32,23,Nye,2000,14139,13251,888,6.3
32,27,Pershing,2000,2573,2468,105,4.1
32,29,Storey,2000,2011,1952,59,2.9
32,31,Washoe,2000,196275,189584,6691,3.4
32,33,White Pine,2000,3798,3652,146,3.8
32,510,Carson City,2000,26686,25770,916,3.4
33,1,Belknap,2000,30857,30104,753,2.4
33,3,Carroll,2000,23568,22938,630,2.7
33,5,Cheshire,2000,39785,38744,1041,2.6
33,7,Coos,2000,17084,16461,623,3.6
33,9,Grafton,2000,44717,43665,1052,2.4
33,11,Hillsborough,2000,211924,206532,5392,2.5
33,13,Merrimack,2000,74558,72789,1769,2.4
33,15,Rockingham,2000,160058,155304,4754,3.0
33,17,Strafford,2000,61624,59975,1649,2.7
33,19,Sullivan,2000,21626,21091,535,2.5
34,1,Atlantic,2000,128980,122995,5985,4.6
34,3,Bergen,2000,469010,454314,14696,3.1
34,5,Burlington,2000,221369,214546,6823,3.1
34,7,Camden,2000,254250,244464,9786,3.8
34,9,Cape May,2000,55536,51985,3551,6.4
34,11,Cumberland,2000,65531,61751,3780,5.8
34,13,Essex,2000,365927,349602,16325,4.5
34,15,Gloucester,2000,134834,129987,4847,3.6
34,17,Hudson,2000,297595,283334,14261,4.8
34,19,Hunterdon,2000,67939,66361,1578,2.3
34,21,Mercer,2000,180170,174328,5842,3.2
34,23,Middlesex,2000,401450,388130,13320,3.3
34,25,Monmouth,2000,318347,308170,10177,3.2
34,27,Morris,2000,261228,254351,6877,2.6
34,29,Ocean,2000,232237,223649,8588,3.7
34,31,Passaic,2000,236190,225423,10767,4.6
34,33,Salem,2000,31544,30333,1211,3.8
34,35,Somerset,2000,165639,161377,4262,2.6
34,37,Sussex,2000,79520,77188,2332,2.9
34,39,Union,2000,264668,254478,10190,3.9
34,41,Warren,2000,55676,54058,1618,2.9
35,1,Bernalillo,2000,287376,275687,11689,4.1
35,3,Catron,2000,1447,1349,98,6.8
35,5,Chaves,2000,25634,24179,1455,5.7
35,6,Cibola,2000,9907,9220,687,6.9
35,7,Colfax,2000,6927,6575,352,5.1
35,9,Curry,2000,18623,17743,880,4.7
35,11,De Baca,2000,958,912,46,4.8
35,13,Dona Ana,2000,75962,71244,4718,6.2
35,15,Eddy,2000,23123,21794,1329,5.7
35,17,Grant,2000,12772,12020,752,5.9
35,19,Guadalupe,2000,1781,1650,131,7.4
35,21,Harding,2000,413,395,18,4.4
35,23,Hidalgo,2000,2615,2434,181,6.9
35,25,Lea,2000,22501,21303,1198,5.3
35,27,Lincoln,2000,9586,9174,412,4.3
35,28,Los Alamos,2000,10433,10108,325,3.1
35,29,Luna,2000,10686,9002,1684,15.8
35,31,McKinley,2000,24414,22784,1630,6.7
35,33,Mora,2000,1958,1749,209,10.7
35,35,Otero,2000,24229,22922,1307,5.4
35,37,Quay,2000,4415,4194,221,5.0
35,39,Rio Arriba,2000,18840,17672,1168,6.2
35,41,Roosevelt,2000,7981,7624,357,4.5
35,43,Sandoval,2000,43295,41426,1869,4.3
35,45,San Juan,2000,49327,46452,2875,5.8
35,47,San Miguel,2000,12497,11761,736,5.9
35,49,Santa Fe,2000,70259,67678,2581,3.7
35,51,Sierra,2000,5257,5021,236,4.5
35,53,Socorro,2000,7911,7506,405,5.1
35,55,Taos,2000,15492,14433,1059,6.8
35,57,Torrance,2000,7532,7150,382,5.1
35,59,Union,2000,2046,1969,77,3.8
35,61,Valencia,2000,29954,28537,1417,4.7
36,1,Albany,2000,154389,149260,5129,3.3
36,3,Allegany,2000,22711,21608,1103,4.9
36,5,Bronx,2000,485706,451119,34587,7.1
36,7,Broome,2000,97978,94437,3541,3.6
36,9,Cattaraugus,2000,40965,39119,1846,4.5
36,11,Cayuga,2000,40294,38729,1565,3.9
36,13,Chautauqua,2000,67900,65181,2719,4.0
36,15,Chemung,2000,42647,40817,1830,4.3
36,17,Chenango,2000,24434,23461,973,4.0
36,19,Clinton,2000,38466,36678,1788,4.6
36,21,Columbia,2000,31424,30350,1074,3.4
36,23,Cortland,2000,24094,23051,1043,4.3
36,25,Delaware,2000,22124,21206,918,4.1
36,27,Dutchess,2000,138799,134380,4419,3.2
36,29,Erie,2000,466753,447277,19476,4.2
36,31,Essex,2000,18486,17607,879,4.8
36,33,Franklin,2000,22151,20883,1268,5.7
36,35,Fulton,2000,26258,25040,1218,4.6
36,37,Genesee,2000,32509,31228,1281,3.9
36,39,Greene,2000,22550,21533,1017,4.5
36,41,Hamilton,2000,2855,2698,157,5.5
36,43,Herkimer,2000,31620,30279,1341,4.2
36,45,Jefferson,2000,44876,42249,2627,5.9
36,47,Kings,2000,1040727,974617,66110,6.4
36,49,Lewis,2000,12669,12018,651,5.1
36,51,Livingston,2000,32874,31549,1325,4.0
36,53,Madison,2000,34954,33618,1336,3.8
36,55,Monroe,2000,376118,362928,13190,3.5
36,57,Montgomery,2000,23584,22463,1121,4.8
36,59,Nassau,2000,675516,653213,22303,3.3
36,61,New York,2000,853715,810590,43125,5.1
36,63,Niagara,2000,109672,104562,5110,4.7
36,65,Oneida,2000,110679,106407,4272,3.9
36,67,Onondaga,2000,230067,222027,8040,3.5
36,69,Ontario,2000,54445,52530,1915,3.5
36,71,Orange,2000,161703,156284,5419,3.4
36,73,Orleans,2000,20255,19318,937,4.6
36,75,Oswego,2000,58570,55788,2782,4.7
36,77,Otsego,2000,29655,28408,1247,4.2
36,79,Putnam,2000,52159,50650,1509,2.9
36,81,Queens,2000,1062379,1006177,56202,5.3
36,83,Rensselaer,2000,80621,77717,2904,3.6
36,85,Richmond,2000,216807,205797,11010,5.1
36,87,Rockland,2000,144398,139679,4719,3.3
36,89,St. Lawrence,2000,48815,46050,2765,5.7
36,91,Saratoga,2000,110405,106755,3650,3.3
36,93,Schenectady,2000,72405,69904,2501,3.5
36,95,Schoharie,2000,15156,14512,644,4.2
36,97,Schuyler,2000,9375,8957,418,4.5
36,99,Seneca,2000,16382,15706,676,4.1
36,101,Steuben,2000,47928,45979,1949,4.1
36,103,Suffolk,2000,733284,708288,24996,3.4
36,105,Sullivan,2000,33050,31618,1432,4.3
36,107,Tioga,2000,26465,25559,906,3.4
36,109,Tompkins,2000,50666,49018,1648,3.3
36,111,Ulster,2000,88281,85155,3126,3.5
36,113,Warren,2000,33234,31859,1375,4.1
36,115,Washington,2000,30056,28946,1110,3.7
36,117,Wayne,2000,48843,46999,1844,3.8
36,119,Westchester,2000,462283,446737,15546,3.4
36,121,Wyoming,2000,20283,19332,951,4.7
36,123,Yates,2000,12085,11640,445,3.7
37,1,Alamance,2000,69404,67206,2198,3.2
37,3,Alexander,2000,19388,18852,536,2.8
37,5,Alleghany,2000,5641,5301,340,6.0
37,7,Anson,2000,11019,10437,582,5.3
37,9,Ashe,2000,12503,11862,641,5.1
37,11,Avery,2000,7944,7624,320,4.0
37,13,Beaufort,2000,20693,19435,1258,6.1
37,15,Bertie,2000,8384,7789,595,7.1
37,17,Bladen,2000,14682,13780,902,6.1
37,19,Brunswick,2000,35477,33863,1614,4.5
37,21,Buncombe,2000,107737,104346,3391,3.1
37,23,Burke,2000,46301,44655,1646,3.6
37,25,Cabarrus,2000,72014,69824,2190,3.0
37,27,Caldwell,2000,42442,41201,1241,2.9
37,29,Camden,2000,3317,3218,99,3.0
37,31,Carteret,2000,29617,28387,1230,4.2
37,33,Caswell,2000,10889,10480,409,3.8
37,35,Catawba,2000,80294,78070,2224,2.8
37,37,Chatham,2000,26835,26092,743,2.8
37,39,Cherokee,2000,11475,10733,742,6.5
37,41,Chowan,2000,6489,6231,258,4.0
37,43,Clay,2000,4036,3871,165,4.1
37,45,Cleveland,2000,49013,46578,2435,5.0
37,47,Columbus,2000,23528,21709,1819,7.7
37,49,Craven,2000,38592,36980,1612,4.2
37,51,Cumberland,2000,119314,113972,5342,4.5
37,53,Currituck,2000,9220,8966,254,2.8
37,55,Dare,2000,18782,17974,808,4.3
37,57,Davidson,2000,79630,77027,2603,3.3
37,59,Davie,2000,18442,17662,780,4.2
37,61,Duplin,2000,23428,22411,1017,4.3
37,63,Durham,2000,122239,118618,3621,3.0
37,65,Edgecombe,2000,25077,23608,1469,5.9
37,67,Forsyth,2000,161821,156604,5217,3.2
37,69,Franklin,2000,24426,23630,796,3.3
37,71,Gaston,2000,100086,94556,5530,5.5
37,73,Gates,2000,4655,4495,160,3.4
37,75,Graham,2000,3815,3562,253,6.6
37,77,Granville,2000,22522,21526,996,4.4
37,79,Greene,2000,8609,8207,402,4.7
37,81,Guilford,2000,233168,225505,7663,3.3
37,83,Halifax,2000,22933,21542,1391,6.1
37,85,Harnett,2000,42309,40695,1614,3.8
37,87,Haywood,2000,25889,24878,1011,3.9
37,89,Henderson,2000,42232,40954,1278,3.0
37,91,Hertford,2000,9517,9021,496,5.2
37,93,Hoke,2000,14490,13657,833,5.7
37,95,Hyde,2000,2868,2704,164,5.7
37,97,Iredell,2000,65973,63650,2323,3.5
37,99,Jackson,2000,17210,16532,678,3.9
37,101,Johnston,2000,64088,62223,1865,2.9
37,103,Jones,2000,4672,4458,214,4.6
37,105,Lee,2000,24634,23643,991,4.0
37,107,Lenoir,2000,27770,26304,1466,5.3
37,109,Lincoln,2000,34807,33489,1318,3.8
37,111,McDowell,2000,21433,20506,927,4.3
37,113,Macon,2000,14124,13574,550,3.9
37,115,Madison,2000,9381,9029,352,3.8
37,117,Martin,2000,11813,10990,823,7.0
37,119,Mecklenburg,2000,395941,384235,11706,3.0
37,121,Mitchell,2000,7775,7423,352,4.5
37,123,Montgomery,2000,12765,12261,504,3.9
37,125,Moore,2000,34637,33376,1261,3.6
37,127,Nash,2000,43535,41529,2006,4.6
37,129,New Hanover,2000,87717,84495,3222,3.7
37,131,Northampton,2000,8701,8226,475,5.5
37,133,Onslow,2000,53232,50903,2329,4.4
37,135,Orange,2000,64850,63211,1639,2.5
37,137,Pamlico,2000,5424,5203,221,4.1
37,139,Pasquotank,2000,15435,14848,587,3.8
37,141,Pender,2000,19462,18657,805,4.1
37,143,Perquimans,2000,4778,4590,188,3.9
37,145,Person,2000,18166,17371,795,4.4
37,147,Pitt,2000,69930,66991,2939,4.2
37,149,Polk,2000,8501,8191,310,3.6
37,151,Randolph,2000,72356,69870,2486,3.4
37,153,Richmond,2000,20906,19784,1122,5.4
37,155,Robeson,2000,53652,50025,3627,6.8
37,157,Rockingham,2000,46167,43936,2231,4.8
37,159,Rowan,2000,65551,62586,2965,4.5
37,161,Rutherford,2000,31014,29194,1820,5.9
37,163,Sampson,2000,28856,27834,1022,3.5
37,165,Scotland,2000,15740,14729,1011,6.4
37,167,Stanly,2000,29853,28688,1165,3.9
37,169,Stokes,2000,23943,23102,841,3.5
37,171,Surry,2000,37000,35491,1509,4.1
37,173,Swain,2000,6200,5648,552,8.9
37,175,Transylvania,2000,13403,12966,437,3.3
37,177,Tyrrell,2000,1882,1744,138,7.3
37,179,Union,2000,67255,65370,1885,2.8
37,181,Vance,2000,20260,18870,1390,6.9
37,183,Wake,2000,366355,357475,8880,2.4
37,185,Warren,2000,8138,7643,495,6.1
37,187,Washington,2000,5969,5646,323,5.4
37,189,Watauga,2000,23251,22574,677,2.9
37,191,Wayne,2000,50945,48901,2044,4.0
37,193,Wilkes,2000,34020,32799,1221,3.6
37,195,Wilson,2000,37230,35140,2090,5.6
37,197,Yadkin,2000,19081,18396,685,3.6
37,199,Yancey,2000,8516,8202,314,3.7
38,1,Adams,2000,1317,1281,36,2.7
38,3,Barnes,2000,6029,5837,192,3.2
38,5,Benson,2000,2618,2462,156,6.0
38,7,Billings,2000,486,474,12,2.5
38,9,Bottineau,2000,3484,3352,132,3.8
38,11,Bowman,2000,1802,1765,37,2.1
38,13,Burke,2000,1054,1023,31,2.9
38,15,Burleigh,2000,40143,39203,940,2.3
38,17,Cass,2000,75396,73798,1598,2.1
38,19,Cavalier,2000,2358,2279,79,3.4
38,21,Dickey,2000,3065,3000,65,2.1
38,23,Divide,2000,1067,1036,31,2.9
38,25,Dunn,2000,1765,1709,56,3.2
38,27,Eddy,2000,1364,1307,57,4.2
38,29,Emmons,2000,2081,1994,87,4.2
38,31,Foster,2000,1959,1903,56,2.9
38,33,Golden Valley,2000,912,884,28,3.1
38,35,Grand Forks,2000,35959,34946,1013,2.8
38,37,Grant,2000,1365,1323,42,3.1
38,39,Griggs,2000,1372,1338,34,2.5
38,41,Hettinger,2000,1258,1220,38,3.0
38,43,Kidder,2000,1305,1245,60,4.6
38,45,LaMoure,2000,2289,2225,64,2.8
38,47,Logan,2000,1045,1016,29,2.8
38,49,McHenry,2000,2815,2678,137,4.9
38,51,McIntosh,2000,1562,1517,45,2.9
38,53,McKenzie,2000,2681,2597,84,3.1
38,55,McLean,2000,4562,4348,214,4.7
38,57,Mercer,2000,4499,4304,195,4.3
38,59,Morton,2000,13865,13449,416,3.0
38,61,Mountrail,2000,3021,2880,141,4.7
38,63,Nelson,2000,1823,1753,70,3.8
38,65,Oliver,2000,1128,1081,47,4.2
38,67,Pembina,2000,4690,4446,244,5.2
38,69,Pierce,2000,2196,2121,75,3.4
38,71,Ramsey,2000,6191,5983,208,3.4
38,73,Ransom,2000,3101,3028,73,2.4
38,75,Renville,2000,1306,1273,33,2.5
38,77,Richland,2000,9383,9126,257,2.7
38,79,Rolette,2000,5233,4737,496,9.5
38,81,Sargent,2000,2351,2295,56,2.4
38,83,Sheridan,2000,791,750,41,5.2
38,85,Sioux,2000,1264,1193,71,5.6
38,87,Slope,2000,426,415,11,2.6
38,89,Stark,2000,12323,11973,350,2.8
38,91,Steele,2000,1175,1152,23,2.0
38,93,Stutsman,2000,11850,11550,300,2.5
38,95,Towner,2000,1441,1400,41,2.8
38,97,Traill,2000,4270,4147,123,2.9
38,99,Walsh,2000,6459,6227,232,3.6
38,101,Ward,2000,27985,27090,895,3.2
38,103,Wells,2000,2352,2258,94,4.0
38,105,Williams,2000,10532,10227,305,2.9
39,1,Adams,2000,12554,11594,960,7.6
39,3,Allen,2000,51480,49043,2437,4.7
39,5,Ashland,2000,27040,25881,1159,4.3
39,7,Ashtabula,2000,50443,47811,2632,5.2
39,9,Athens,2000,27718,26149,1569,5.7
39,11,Auglaize,2000,25081,24169,912,3.6
39,13,Belmont,2000,31012,28968,2044,6.6
39,15,Brown,2000,20613,19474,1139,5.5
39,17,Butler,2000,173019,166346,6673,3.9
39,19,Carroll,2000,14140,13474,666,4.7
39,21,Champaign,2000,20477,19686,791,3.9
39,23,Clark,2000,72210,68840,3370,4.7
39,25,Clermont,2000,95185,91442,3743,3.9
39,27,Clinton,2000,21848,21010,838,3.8
39,29,Columbiana,2000,54229,51414,2815,5.2
39,31,Coshocton,2000,18190,17342,848,4.7
39,33,Crawford,2000,23451,22362,1089,4.6
39,35,Cuyahoga,2000,685192,664774,20418,3.0
39,37,Darke,2000,27823,26629,1194,4.3
39,39,Defiance,2000,21190,20340,850,4.0
39,41,Delaware,2000,62552,60745,1807,2.9
39,43,Erie,2000,42059,40131,1928,4.6
39,45,Fairfield,2000,65419,63106,2313,3.5
39,47,Fayette,2000,14907,14278,629,4.2
39,49,Franklin,2000,591995,572148,19847,3.4
39,51,Fulton,2000,22633,21653,980,4.3
39,53,Gallia,2000,13338,12345,993,7.4
39,55,Geauga,2000,48654,47534,1120,2.3
39,57,Greene,2000,76112,73064,3048,4.0
39,59,Guernsey,2000,18681,17407,1274,6.8
39,61,Hamilton,2000,427511,410546,16965,4.0
39,63,Hancock,2000,38875,37481,1394,3.6
39,65,Hardin,2000,15706,15008,698,4.4
39,67,Harrison,2000,7176,6775,401,5.6
39,69,Henry,2000,15234,14529,705,4.6
39,71,Highland,2000,19540,18618,922,4.7
39,73,Hocking,2000,13151,12267,884,6.7
39,75,Holmes,2000,17699,17152,547,3.1
39,77,Huron,2000,30662,28863,1799,5.9
39,79,Jackson,2000,14456,13544,912,6.3
39,81,Jefferson,2000,31703,29735,1968,6.2
39,83,Knox,2000,27368,26147,1221,4.5
39,85,Lake,2000,127880,124681,3199,2.5
39,87,Lawrence,2000,26156,24078,2078,7.9
39,89,Licking,2000,77278,74227,3051,3.9
39,91,Logan,2000,24096,23161,935,3.9
39,93,Lorain,2000,146990,142541,4449,3.0
39,95,Lucas,2000,226787,215723,11064,4.9
39,97,Madison,2000,19295,18589,706,3.7
39,99,Mahoning,2000,120087,113475,6612,5.5
39,101,Marion,2000,31706,30279,1427,4.5
39,103,Medina,2000,84092,82082,2010,2.4
39,105,Meigs,2000,9834,9068,766,7.8
39,107,Mercer,2000,21673,20729,944,4.4
39,109,Miami,2000,53782,51741,2041,3.8
39,111,Monroe,2000,6342,5857,485,7.6
39,113,Montgomery,2000,278871,266844,12027,4.3
39,115,Morgan,2000,6601,6127,474,7.2
39,117,Morrow,2000,16408,15741,667,4.1
39,119,Muskingum,2000,42027,39668,2359,5.6
39,121,Noble,2000,5649,5260,389,6.9
39,123,Ottawa,2000,21365,20196,1169,5.5
39,125,Paulding,2000,10467,10036,431,4.1
39,127,Perry,2000,16117,15198,919,5.7
39,129,Pickaway,2000,23829,22797,1032,4.3
39,131,Pike,2000,11433,10584,849,7.4
39,133,Portage,2000,84524,80970,3554,4.2
39,135,Preble,2000,21858,20952,906,4.1
39,137,Putnam,2000,18240,17593,647,3.5
39,139,Richland,2000,63156,59708,3448,5.5
39,141,Ross,2000,33458,31634,1824,5.5
39,143,Sandusky,2000,32734,31261,1473,4.5
39,145,Scioto,2000,32049,29538,2511,7.8
39,147,Seneca,2000,30877,29448,1429,4.6
39,149,Shelby,2000,25487,24425,1062,4.2
39,151,Stark,2000,192444,183827,8617,4.5
39,153,Summit,2000,279598,267057,12541,4.5
39,155,Trumbull,2000,107358,101555,5803,5.4
39,157,Tuscarawas,2000,46348,44258,2090,4.5
39,159,Union,2000,22135,21413,722,3.3
39,161,Van Wert,2000,15620,14910,710,4.5
39,163,Vinton,2000,5440,5037,403,7.4
39,165,Warren,2000,83317,80332,2985,3.6
39,167,Washington,2000,31278,29434,1844,5.9
39,169,Wayne,2000,58739,56623,2116,3.6
39,171,Williams,2000,21211,20403,808,3.8
39,173,Wood,2000,66138,63636,2502,3.8
39,175,Wyandot,2000,12350,11823,527,4.3
40,1,Adair,2000,9187,8868,319,3.5
40,3,Alfalfa,2000,2609,2533,76,2.9
40,5,Atoka,2000,5175,4994,181,3.5
40,7,Beaver,2000,2933,2865,68,2.3
40,9,Beckham,2000,8613,8347,266,3.1
40,11,Blaine,2000,4788,4657,131,2.7
40,13,Bryan,2000,16718,16237,481,2.9
40,15,Caddo,2000,12121,11677,444,3.7
40,17,Canadian,2000,46479,45408,1071,2.3
40,19,Carter,2000,20849,20084,765,3.7
40,21,Cherokee,2000,18784,18201,583,3.1
40,23,Choctaw,2000,6052,5770,282,4.7
40,25,Cimarron,2000,1597,1562,35,2.2
40,27,Cleveland,2000,111103,108611,2492,2.2
40,29,Coal,2000,2487,2383,104,4.2
40,31,Comanche,2000,43170,41644,1526,3.5
40,33,Cotton,2000,2856,2767,89,3.1
40,35,Craig,2000,6909,6668,241,3.5
40,37,Creek,2000,31863,30862,1001,3.1
40,39,Custer,2000,13219,12900,319,2.4
40,41,Delaware,2000,15941,15377,564,3.5
40,43,Dewey,2000,2269,2209,60,2.6
40,45,Ellis,2000,2103,2049,54,2.6
40,47,Garfield,2000,28021,27255,766,2.7
40,49,Garvin,2000,12457,12038,419,3.4
40,51,Grady,2000,21930,21305,625,2.8
40,53,Grant,2000,2561,2499,62,2.4
40,55,Greer,2000,2261,2173,88,3.9
40,57,Harmon,2000,1432,1393,39,2.7
40,59,Harper,2000,1911,1871,40,2.1
40,61,Haskell,2000,5083,4865,218,4.3
40,63,Hughes,2000,5536,5256,280,5.1
40,65,Jackson,2000,11869,11521,348,2.9
40,67,Jefferson,2000,2827,2728,99,3.5
40,69,Johnston,2000,4520,4361,159,3.5
40,71,Kay,2000,21958,21039,919,4.2
40,73,Kingfisher,2000,7158,7004,154,2.2
40,75,Kiowa,2000,4585,4460,125,2.7
40,77,Latimer,2000,4416,4213,203,4.6
40,79,Le Flore,2000,20664,19804,860,4.2
40,81,Lincoln,2000,14844,14419,425,2.9
40,83,Logan,2000,16955,16539,416,2.5
40,85,Love,2000,4201,4055,146,3.5
40,87,McClain,2000,13807,13463,344,2.5
40,89,McCurtain,2000,14795,14106,689,4.7
40,91,McIntosh,2000,7905,7553,352,4.5
40,93,Major,2000,3991,3900,91,2.3
40,95,Marshall,2000,5699,5493,206,3.6
40,97,Mayes,2000,17949,17367,582,3.2
40,99,Murray,2000,6000,5795,205,3.4
40,101,Muskogee,2000,28854,27766,1088,3.8
40,103,Noble,2000,5724,5595,129,2.3
40,105,Nowata,2000,4850,4688,162,3.3
40,107,Okfuskee,2000,4522,4351,171,3.8
40,109,Oklahoma,2000,325715,316568,9147,2.8
40,111,Okmulgee,2000,17049,16308,741,4.3
40,113,Osage,2000,20773,20131,642,3.1
40,115,Ottawa,2000,15553,14861,692,4.4
40,117,Pawnee,2000,7900,7615,285,3.6
40,119,Payne,2000,36095,35224,871,2.4
40,121,Pittsburg,2000,17636,16869,767,4.3
40,123,Pontotoc,2000,16654,16121,533,3.2
40,125,Pottawatomie,2000,30107,29169,938,3.1
40,127,Pushmataha,2000,4641,4445,196,4.2
40,129,Roger Mills,2000,1825,1782,43,2.4
40,131,Rogers,2000,36023,35082,941,2.6
40,133,Seminole,2000,10390,9956,434,4.2
40,135,Sequoyah,2000,17141,16418,723,4.2
40,137,Stephens,2000,19239,18611,628,3.3
40,139,Texas,2000,10573,10303,270,2.6
40,141,Tillman,2000,3790,3671,119,3.1
40,143,Tulsa,2000,295876,287780,8096,2.7
40,145,Wagoner,2000,29386,28649,737,2.5
40,147,Washington,2000,22784,22100,684,3.0
40,149,Washita,2000,5544,5401,143,2.6
40,151,Woods,2000,4556,4444,112,2.5
40,153,Woodward,2000,9162,8895,267,2.9
41,1,Baker,2000,7278,6755,523,7.2
41,3,Benton,2000,41260,39643,1617,3.9
41,5,Clackamas,2000,187855,180132,7723,4.1
41,7,Clatsop,2000,17931,17023,908,5.1
41,9,Columbia,2000,22501,21246,1255,5.6
41,11,Coos,2000,27326,25283,2043,7.5
41,13,Crook,2000,8745,8104,641,7.3
41,15,Curry,2000,8804,8179,625,7.1
41,17,Deschutes,2000,61855,58500,3355,5.4
41,19,Douglas,2000,46166,42731,3435,7.4
41,21,Gilliam,2000,1008,958,50,5.0
41,23,Grant,2000,3786,3418,368,9.7
41,25,Harney,2000,3863,3533,330,8.5
41,27,Hood River,2000,11470,10705,765,6.7
41,29,Jackson,2000,90649,85499,5150,5.7
41,31,Jefferson,2000,8779,8306,473,5.4
41,33,Josephine,2000,31368,29143,2225,7.1
41,35,Klamath,2000,29723,27502,2221,7.5
41,37,Lake,2000,3378,3094,284,8.4
41,39,Lane,2000,169860,160594,9266,5.5
41,41,Lincoln,2000,21190,19810,1380,6.5
41,43,Linn,2000,51355,47927,3428,6.7
41,45,Malheur,2000,13061,12056,1005,7.7
41,47,Marion,2000,144715,136630,8085,5.6
41,49,Morrow,2000,5471,5045,426,7.8
41,51,Multnomah,2000,379811,361811,18000,4.7
41,53,Polk,2000,33205,31593,1612,4.9
41,55,Sherman,2000,888,832,56,6.3
41,57,Tillamook,2000,11551,10942,609,5.3
41,59,Umatilla,2000,35921,33698,2223,6.2
41,61,Union,2000,11991,11319,672,5.6
41,63,Wallowa,2000,3502,3236,266,7.6
41,65,Wasco,2000,12561,11780,781,6.2
41,67,Washington,2000,258489,248325,10164,3.9
41,69,Wheeler,2000,722,669,53,7.3
41,71,Yamhill,2000,43804,41605,2199,5.0
42,1,Adams,2000,49584,47990,1594,3.2
42,3,Allegheny,2000,638004,611790,26214,4.1
42,5,Armstrong,2000,33255,31339,1916,5.8
42,7,Beaver,2000,89142,85268,3874,4.3
42,9,Bedford,2000,24686,23309,1377,5.6
42,11,Berks,2000,195243,187486,7757,4.0
42,13,Blair,2000,62581,59626,2955,4.7
42,15,Bradford,2000,30340,29230,1110,3.7
42,17,Bucks,2000,330127,318735,11392,3.5
42,19,Butler,2000,89386,85677,3709,4.1
42,21,Cambria,2000,66881,62742,4139,6.2
42,23,Cameron,2000,2794,2607,187,6.7
42,25,Carbon,2000,29091,27577,1514,5.2
42,27,Centre,2000,68635,66237,2398,3.5
42,29,Chester,2000,236560,229273,7287,3.1
42,31,Clarion,2000,19417,18420,997,5.1
42,33,Clearfield,2000,39503,37258,2245,5.7
42,35,Clinton,2000,18263,17308,955,5.2
42,37,Columbia,2000,32060,30361,1699,5.3
42,39,Crawford,2000,42891,40765,2126,5.0
42,41,Cumberland,2000,114152,110516,3636,3.2
42,43,Dauphin,2000,131699,127022,4677,3.6
42,45,Delaware,2000,277943,267379,10564,3.8
42,47,Elk,2000,18256,17357,899,4.9
42,49,Erie,2000,140728,134304,6424,4.6
42,51,Fayette,2000,64760,61038,3722,5.7
42,53,Forest,2000,2019,1875,144,7.1
42,55,Franklin,2000,67723,65159,2564,3.8
42,57,Fulton,2000,7280,6997,283,3.9
42,59,Greene,2000,16742,15745,997,6.0
42,61,Huntingdon,2000,20875,19597,1278,6.1
42,63,Indiana,2000,41108,38698,2410,5.9
42,65,Jefferson,2000,21564,20409,1155,5.4
42,67,Juniata,2000,11522,11034,488,4.2
42,69,Lackawanna,2000,104006,99266,4740,4.6
42,71,Lancaster,2000,251341,244179,7162,2.8
42,73,Lawrence,2000,44790,42559,2231,5.0
42,75,Lebanon,2000,64347,62287,2060,3.2
42,77,Lehigh,2000,162991,156968,6023,3.7
42,79,Luzerne,2000,156007,147885,8122,5.2
42,81,Lycoming,2000,59444,56845,2599,4.4
42,83,McKean,2000,21928,20867,1061,4.8
42,85,Mercer,2000,56822,53961,2861,5.0
42,87,Mifflin,2000,22240,21275,965,4.3
42,89,Monroe,2000,69470,66529,2941,4.2
42,91,Montgomery,2000,410015,396950,13065,3.2
42,93,Montour,2000,8627,8323,304,3.5
42,95,Northampton,2000,138615,133331,5284,3.8
42,97,Northumberland,2000,45570,43482,2088,4.6
42,99,Perry,2000,23371,22492,879,3.8
42,101,Philadelphia/city,2000,637148,601393,35755,5.6
42,103,Pike,2000,21249,20434,815,3.8
42,105,Potter,2000,8518,8130,388,4.6
42,107,Schuylkill,2000,70196,66034,4162,5.9
42,109,Snyder,2000,19073,18376,697,3.7
42,111,Somerset,2000,38179,36146,2033,5.3
42,113,Sullivan,2000,2989,2843,146,4.9
42,115,Susquehanna,2000,20427,19617,810,4.0
42,117,Tioga,2000,20062,19164,898,4.5
42,119,Union,2000,17340,16661,679,3.9
42,121,Venango,2000,26869,25486,1383,5.1
42,123,Warren,2000,22197,21356,841,3.8
42,125,Washington,2000,98715,94115,4600,4.7
42,127,Wayne,2000,22708,21667,1041,4.6
42,129,Westmoreland,2000,182234,173662,8572,4.7
42,131,Wyoming,2000,13855,13182,673,4.9
42,133,York,2000,209589,202556,7033,3.4
44,1,Bristol,2000,26802,25856,946,3.5
44,3,Kent,2000,92683,89182,3501,3.8
44,5,Newport,2000,44913,43295,1618,3.6
44,7,Providence,2000,309119,295719,13400,4.3
44,9,Washington,2000,69001,66763,2238,3.2
45,1,Abbeville,2000,12424,11954,470,3.8
45,3,Aiken,2000,68980,66313,2667,3.9
45,5,Allendale,2000,3696,3502,194,5.2
45,7,Anderson,2000,83376,80750,2626,3.1
45,9,Bamberg,2000,6470,6135,335,5.2
45,11,Barnwell,2000,10192,9676,516,5.1
45,13,Beaufort,2000,50915,49293,1622,3.2
45,15,Berkeley,2000,65545,63384,2161,3.3
45,17,Calhoun,2000,7069,6799,270,3.8
45,19,Charleston,2000,152462,147417,5045,3.3
45,21,Cherokee,2000,25448,24363,1085,4.3
45,23,Chester,2000,16261,15418,843,5.2
45,25,Chesterfield,2000,19190,18290,900,4.7
45,27,Clarendon,2000,13000,12288,712,5.5
45,29,Colleton,2000,15881,15268,613,3.9
45,31,Darlington,2000,31389,29838,1551,4.9
45,33,Dillon,2000,13600,12665,935,6.9
45,35,Dorchester,2000,47075,45627,1448,3.1
45,37,Edgefield,2000,10335,9953,382,3.7
45,39,Fairfield,2000,11026,10471,555,5.0
45,41,Florence,2000,60111,57607,2504,4.2
45,43,Georgetown,2000,25788,24370,1418,5.5
45,45,Greenville,2000,202757,197309,5448,2.7
45,47,Greenwood,2000,32488,31077,1411,4.3
45,49,Hampton,2000,8292,7929,363,4.4
45,51,Horry,2000,105227,101372,3855,3.7
45,53,Jasper,2000,9164,8831,333,3.6
45,55,Kershaw,2000,27012,25987,1025,3.8
45,57,Lancaster,2000,29999,28882,1117,3.7
45,59,Laurens,2000,33788,32661,1127,3.3
45,61,Lee,2000,8250,7776,474,5.7
45,63,Lexington,2000,117907,114679,3228,2.7
45,65,McCormick,2000,3732,3492,240,6.4
45,67,Marion,2000,15441,13978,1463,9.5
45,69,Marlboro,2000,12232,11390,842,6.9
45,71,Newberry,2000,17232,16495,737,4.3
45,73,Oconee,2000,32230,31081,1149,3.6
45,75,Orangeburg,2000,40579,38190,2389,5.9
45,77,Pickens,2000,57389,55617,1772,3.1
45,79,Richland,2000,161139,155793,5346,3.3
45,81,Saluda,2000,9354,9008,346,3.7
45,83,Spartanburg,2000,129284,124595,4689,3.6
45,85,Sumter,2000,44638,42704,1934,4.3
45,87,Union,2000,14093,13358,735,5.2
45,89,Williamsburg,2000,15090,13928,1162,7.7
45,91,York,2000,87934,85047,2887,3.3
46,3,Aurora,2000,1581,1545,36,2.3
46,5,Beadle,2000,9096,8867,229,2.5
46,7,Bennett,2000,1338,1289,49,3.7
46,9,Bon Homme,2000,3323,3234,89,2.7
46,11,Brookings,2000,17603,17236,367,2.1
46,13,Brown,2000,20471,19993,478,2.3
46,15,Brule,2000,2717,2649,68,2.5
46,17,Buffalo,2000,512,463,49,9.6
46,19,Butte,2000,4781,4648,133,2.8
46,21,Campbell,2000,929,878,51,5.5
46,23,Charles Mix,2000,4012,3898,114,2.8
46,25,Clark,2000,2135,2055,80,3.7
46,27,Clay,2000,7380,7222,158,2.1
46,29,Codington,2000,15510,15122,388,2.5
46,31,Corson,2000,1386,1307,79,5.7
46,33,Custer,2000,4169,4044,125,3.0
46,35,Davison,2000,10318,10080,238,2.3
46,37,Day,2000,3040,2914,126,4.1
46,39,Deuel,2000,2512,2432,80,3.2
46,41,Dewey,2000,2269,2060,209,9.2
46,43,Douglas,2000,1736,1697,39,2.2
46,45,Edmunds,2000,2137,2087,50,2.3
46,47,Fall River,2000,3537,3402,135,3.8
46,49,Faulk,2000,1284,1252,32,2.5
46,51,Grant,2000,4147,4017,130,3.1
46,53,Gregory,2000,2431,2357,74,3.0
46,55,Haakon,2000,1263,1240,23,1.8
46,57,Hamlin,2000,2786,2714,72,2.6
46,59,Hand,2000,2042,2000,42,2.1
46,61,Hanson,2000,1588,1554,34,2.1
46,63,Harding,2000,763,743,20,2.6
46,65,Hughes,2000,9631,9438,193,2.0
46,67,Hutchinson,2000,3972,3867,105,2.6
46,69,Hyde,2000,853,831,22,2.6
46,71,Jackson,2000,1156,1106,50,4.3
46,73,Jerauld,2000,1234,1204,30,2.4
46,75,Jones,2000,760,744,16,2.1
46,77,Kingsbury,2000,3037,2958,79,2.6
46,79,Lake,2000,6547,6385,162,2.5
46,81,Lawrence,2000,11535,11205,330,2.9
46,83,Lincoln,2000,14499,14248,251,1.7
46,85,Lyman,2000,1929,1850,79,4.1
46,87,McCook,2000,2983,2917,66,2.2
46,89,McPherson,2000,1328,1290,38,2.9
46,91,Marshall,2000,2226,2143,83,3.7
46,93,Meade,2000,12258,11963,295,2.4
46,95,Mellette,2000,857,824,33,3.9
46,97,Miner,2000,1497,1457,40,2.7
46,99,Minnehaha,2000,88926,87154,1772,2.0
46,101,Moody,2000,3722,3581,141,3.8
46,102,Oglala Lakota,2000,2849,2600,249,8.7
46,103,Pennington,2000,48821,47683,1138,2.3
46,105,Perkins,2000,1787,1741,46,2.6
46,107,Potter,2000,1457,1416,41,2.8
46,109,Roberts,2000,4617,4437,180,3.9
46,111,Sanborn,2000,1482,1446,36,2.4
46,115,Spink,2000,3533,3423,110,3.1
46,117,Stanley,2000,1851,1816,35,1.9
46,119,Sully,2000,913,892,21,2.3
46,121,Todd,2000,2970,2834,136,4.6
46,123,Tripp,2000,3303,3213,90,2.7
46,125,Turner,2000,4780,4672,108,2.3
46,127,Union,2000,7295,7113,182,2.5
46,129,Walworth,2000,2887,2788,99,3.4
46,135,Yankton,2000,11453,11193,260,2.3
46,137,Ziebach,2000,755,696,59,7.8
47,1,Anderson,2000,33787,32403,1384,4.1
47,3,Bedford,2000,19597,18714,883,4.5
47,5,Benton,2000,7318,6784,534,7.3
47,7,Bledsoe,2000,5104,4901,203,4.0
47,9,Blount,2000,53929,52049,1880,3.5
47,11,Bradley,2000,45320,43733,1587,3.5
47,13,Campbell,2000,16049,15094,955,6.0
47,15,Cannon,2000,6359,6137,222,3.5
47,17,Carroll,2000,14217,13120,1097,7.7
47,19,Carter,2000,27618,26314,1304,4.7
47,21,Cheatham,2000,19514,18982,532,2.7
47,23,Chester,2000,7619,7313,306,4.0
47,25,Claiborne,2000,12590,11971,619,4.9
47,27,Clay,2000,3696,3458,238,6.4
47,29,Cocke,2000,15564,14581,983,6.3
47,31,Coffee,2000,23515,22592,923,3.9
47,33,Crockett,2000,6823,6507,316,4.6
47,35,Cumberland,2000,20366,19372,994,4.9
47,37,Davidson,2000,309163,299571,9592,3.1
47,39,Decatur,2000,5672,5373,299,5.3
47,41,DeKalb,2000,8590,8192,398,4.6
47,43,Dickson,2000,22120,21339,781,3.5
47,45,Dyer,2000,17995,17083,912,5.1
47,47,Fayette,2000,13976,13356,620,4.4
47,49,Fentress,2000,6854,6353,501,7.3
47,51,Franklin,2000,18718,18001,717,3.8
47,53,Gibson,2000,23210,21991,1219,5.3
47,55,Giles,2000,14888,14249,639,4.3
47,57,Grainger,2000,9682,9251,431,4.5
47,59,Greene,2000,31596,29782,1814,5.7
47,61,Grundy,2000,5660,5384,276,4.9
47,63,Hamblen,2000,29524,28363,1161,3.9
47,65,Hamilton,2000,159432,154254,5178,3.2
47,67,Hancock,2000,2650,2517,133,5.0
47,69,Hardeman,2000,11025,10468,557,5.1
47,71,Hardin,2000,11630,11017,613,5.3
47,73,Hawkins,2000,24494,23480,1014,4.1
47,75,Haywood,2000,9269,8758,511,5.5
47,77,Henderson,2000,12826,12199,627,4.9
47,79,Henry,2000,14757,14047,710,4.8
47,81,Hickman,2000,9787,9393,394,4.0
47,83,Houston,2000,3673,3461,212,5.8
47,85,Humphreys,2000,8882,8445,437,4.9
47,87,Jackson,2000,5062,4748,314,6.2
47,89,Jefferson,2000,22414,21467,947,4.2
47,91,Johnson,2000,6914,6459,455,6.6
47,93,Knox,2000,200887,194771,6116,3.0
47,95,Lake,2000,2546,2390,156,6.1
47,97,Lauderdale,2000,11201,10634,567,5.1
47,99,Lawrence,2000,18967,17225,1742,9.2
47,101,Lewis,2000,5266,4982,284,5.4
47,103,Lincoln,2000,15769,15216,553,3.5
47,105,Loudon,2000,19462,18781,681,3.5
47,107,McMinn,2000,23534,22489,1045,4.4
47,109,McNairy,2000,11729,11218,511,4.4
47,111,Macon,2000,10186,9811,375,3.7
47,113,Madison,2000,46664,44969,1695,3.6
47,115,Marion,2000,13039,12463,576,4.4
47,117,Marshall,2000,13954,13463,491,3.5
47,119,Maury,2000,36764,35479,1285,3.5
47,121,Meigs,2000,4869,4621,248,5.1
47,123,Monroe,2000,17383,16461,922,5.3
47,125,Montgomery,2000,59351,57149,2202,3.7
47,127,Moore,2000,2912,2823,89,3.1
47,129,Morgan,2000,8000,7597,403,5.0
47,131,Obion,2000,16261,15573,688,4.2
47,133,Overton,2000,9602,9094,508,5.3
47,135,Perry,2000,3484,3305,179,5.1
47,137,Pickett,2000,2267,2153,114,5.0
47,139,Polk,2000,7480,7150,330,4.4
47,141,Putnam,2000,31760,30386,1374,4.3
47,143,Rhea,2000,13313,12698,615,4.6
47,145,Roane,2000,24702,23661,1041,4.2
47,147,Robertson,2000,29566,28535,1031,3.5
47,149,Rutherford,2000,102559,99471,3088,3.0
47,151,Scott,2000,8622,8178,444,5.1
47,153,Sequatchie,2000,5327,5125,202,3.8
47,155,Sevier,2000,39506,37579,1927,4.9
47,157,Shelby,2000,438974,422267,16707,3.8
47,159,Smith,2000,8898,8519,379,4.3
47,161,Stewart,2000,5500,5237,263,4.8
47,163,Sullivan,2000,72772,70113,2659,3.7
47,165,Sumner,2000,70403,68165,2238,3.2
47,167,Tipton,2000,25111,24195,916,3.6
47,169,Trousdale,2000,3549,3430,119,3.4
47,171,Unicoi,2000,8279,7720,559,6.8
47,173,Union,2000,8064,7758,306,3.8
47,175,Van Buren,2000,2656,2535,121,4.6
47,177,Warren,2000,19415,18629,786,4.0
47,179,Washington,2000,54930,52775,2155,3.9
47,181,Wayne,2000,6695,6151,544,8.1
47,183,Weakley,2000,16795,15973,822,4.9
47,185,White,2000,10929,10434,495,4.5
47,187,Williamson,2000,69927,68208,1719,2.5
47,189,Wilson,2000,49752,48203,1549,3.1
48,1,Anderson,2000,19659,18449,1210,6.2
48,3,Andrews,2000,5637,5356,281,5.0
48,5,Angelina,2000,38040,36192,1848,4.9
48,7,Aransas,2000,9755,9170,585,6.0
48,9,Archer,2000,4876,4718,158,3.2
48,11,Armstrong,2000,1091,1056,35,3.2
48,13,Atascosa,2000,17262,16542,720,4.2
48,15,Austin,2000,12034,11555,479,4.0
48,17,Bailey,2000,3199,3050,149,4.7
48,19,Bandera,2000,8721,8399,322,3.7
48,21,Bastrop,2000,29761,28733,1028,3.5
48,23,Baylor,2000,1851,1764,87,4.7
48,25,Bee,2000,11343,10667,676,6.0
48,27,Bell,2000,101569,97263,4306,4.2
48,29,Bexar,2000,663505,636325,27180,4.1
48,31,Blanco,2000,4482,4338,144,3.2
48,33,Borden,2000,423,396,27,6.4
48,35,Bosque,2000,8078,7737,341,4.2
48,37,Bowie,2000,40554,38533,2021,5.0
48,39,Brazoria,2000,120292,114285,6007,5.0
48,41,Brazos,2000,78807,75859,2948,3.7
48,43,Brewster,2000,4566,4386,180,3.9
48,45,Briscoe,2000,912,879,33,3.6
48,47,Brooks,2000,2895,2696,199,6.9
48,49,Brown,2000,17705,16904,801,4.5
48,51,Burleson,2000,7734,7421,313,4.0
48,53,Burnet,2000,17217,16601,616,3.6
48,55,Caldwell,2000,15126,14500,626,4.1
48,57,Calhoun,2000,9367,8924,443,4.7
48,59,Callahan,2000,6222,5979,243,3.9
48,61,Cameron,2000,127525,118520,9005,7.1
48,63,Camp,2000,5228,4954,274,5.2
48,65,Carson,2000,3361,3250,111,3.3
48,67,Cass,2000,13566,12759,807,5.9
48,69,Castro,2000,3998,3850,148,3.7
48,71,Chambers,2000,13129,12565,564,4.3
48,73,Cherokee,2000,20965,19983,982,4.7
48,75,Childress,2000,2988,2846,142,4.8
48,77,Clay,2000,5966,5750,216,3.6
48,79,Cochran,2000,1594,1499,95,6.0
48,81,Coke,2000,1666,1594,72,4.3
48,83,Coleman,2000,4226,4021,205,4.9
48,85,Collin,2000,300355,291758,8597,2.9
48,87,Collingsworth,2000,1535,1477,58,3.8
48,89,Colorado,2000,9942,9562,380,3.8
48,91,Comal,2000,40475,39032,1443,3.6
48,93,Comanche,2000,6696,6430,266,4.0
48,95,Concho,2000,1439,1357,82,5.7
48,97,Cooke,2000,18698,18006,692,3.7
48,99,Coryell,2000,24002,22707,1295,5.4
48,101,Cottle,2000,952,910,42,4.4
48,103,Crane,2000,1615,1527,88,5.4
48,105,Crockett,2000,2048,1970,78,3.8
48,107,Crosby,2000,2986,2848,138,4.6
48,109,Culberson,2000,1495,1409,86,5.8
48,111,Dallam,2000,3289,3178,111,3.4
48,113,Dallas,2000,1188994,1142550,46444,3.9
48,115,Dawson,2000,5859,5546,313,5.3
48,117,Deaf Smith,2000,8260,7857,403,4.9
48,119,Delta,2000,2573,2441,132,5.1
48,121,Denton,2000,267994,260369,7625,2.8
48,123,DeWitt,2000,9001,8609,392,4.4
48,125,Dickens,2000,1138,1078,60,5.3
48,127,Dimmit,2000,3872,3532,340,8.8
48,129,Donley,2000,1872,1794,78,4.2
48,131,Duval,2000,5024,4667,357,7.1
48,133,Eastland,2000,8607,8190,417,4.8
48,135,Ector,2000,56713,53629,3084,5.4
48,137,Edwards,2000,956,914,42,4.4
48,139,Ellis,2000,60264,58090,2174,3.6
48,141,El Paso,2000,275899,257068,18831,6.8
48,143,Erath,2000,16619,16007,612,3.7
48,145,Falls,2000,7212,6817,395,5.5
48,147,Fannin,2000,13970,13287,683,4.9
48,149,Fayette,2000,11456,11058,398,3.5
48,151,Fisher,2000,2161,2076,85,3.9
48,153,Floyd,2000,3484,3314,170,4.9
48,155,Foard,2000,795,765,30,3.8
48,157,Fort Bend,2000,185916,179215,6701,3.6
48,159,Franklin,2000,4441,4251,190,4.3
48,161,Freestone,2000,7915,7507,408,5.2
48,163,Frio,2000,6179,5798,381,6.2
48,165,Gaines,2000,6256,5983,273,4.4
48,167,Galveston,2000,128233,121919,6314,4.9
48,169,Garza,2000,2125,2031,94,4.4
48,171,Gillespie,2000,10551,10137,414,3.9
48,173,Glasscock,2000,729,707,22,3.0
48,175,Goliad,2000,3341,3212,129,3.9
48,177,Gonzales,2000,9128,8807,321,3.5
48,179,Gray,2000,10007,9499,508,5.1
48,181,Grayson,2000,56479,54172,2307,4.1
48,183,Gregg,2000,55343,52305,3038,5.5
48,185,Grimes,2000,9986,9443,543,5.4
48,187,Guadalupe,2000,45459,43889,1570,3.5
48,189,Hale,2000,16982,16209,773,4.6
48,191,Hall,2000,1722,1630,92,5.3
48,193,Hamilton,2000,4057,3902,155,3.8
48,195,Hansford,2000,2831,2746,85,3.0
48,197,Hardeman,2000,2458,2367,91,3.7
48,199,Hardin,2000,23252,21941,1311,5.6
48,201,Harris,2000,1728274,1653126,75148,4.3
48,203,Harrison,2000,29463,27984,1479,5.0
48,205,Hartley,2000,2434,2356,78,3.2
48,207,Haskell,2000,2907,2782,125,4.3
48,209,Hays,2000,56772,54920,1852,3.3
48,211,Hemphill,2000,1846,1792,54,2.9
48,213,Henderson,2000,32942,31542,1400,4.2
48,215,Hidalgo,2000,211851,192259,19592,9.2
48,217,Hill,2000,15265,14560,705,4.6
48,219,Hockley,2000,10934,10484,450,4.1
48,221,Hood,2000,20350,19534,816,4.0
48,223,Hopkins,2000,16419,15750,669,4.1
48,225,Houston,2000,9095,8621,474,5.2
48,227,Howard,2000,13627,12924,703,5.2
48,229,Hudspeth,2000,1320,1260,60,4.5
48,231,Hunt,2000,38948,37288,1660,4.3
48,233,Hutchinson,2000,11039,10504,535,4.8
48,235,Irion,2000,945,915,30,3.2
48,237,Jack,2000,3801,3638,163,4.3
48,239,Jackson,2000,6821,6565,256,3.8
48,241,Jasper,2000,15391,14272,1119,7.3
48,243,Jeff Davis,2000,1166,1121,45,3.9
48,245,Jefferson,2000,113079,105643,7436,6.6
48,247,Jim Hogg,2000,2188,2055,133,6.1
48,249,Jim Wells,2000,16717,15707,1010,6.0
48,251,Johnson,2000,66572,64024,2548,3.8
48,253,Jones,2000,7699,7299,400,5.2
48,255,Karnes,2000,5391,5100,291,5.4
48,257,Kaufman,2000,37678,36134,1544,4.1
48,259,Kendall,2000,12122,11711,411,3.4
48,261,Kenedy,2000,207,200,7,3.4
48,263,Kent,2000,445,428,17,3.8
48,265,Kerr,2000,19306,18563,743,3.8
48,267,Kimble,2000,2263,2183,80,3.5
48,269,King,2000,212,205,7,3.3
48,271,Kinney,2000,1212,1120,92,7.6
48,273,Kleberg,2000,13919,13209,710,5.1
48,275,Knox,2000,1863,1775,88,4.7
48,277,Lamar,2000,23115,21962,1153,5.0
48,279,Lamb,2000,6933,6585,348,5.0
48,281,Lampasas,2000,8653,8318,335,3.9
48,283,La Salle,2000,2208,2050,158,7.2
48,285,Lavaca,2000,9625,9319,306,3.2
48,287,Lee,2000,8243,7948,295,3.6
48,289,Leon,2000,7044,6680,364,5.2
48,291,Liberty,2000,30307,28502,1805,6.0
48,293,Limestone,2000,9593,9133,460,4.8
48,295,Lipscomb,2000,1488,1437,51,3.4
48,297,Live Oak,2000,4860,4638,222,4.6
48,299,Llano,2000,7382,7069,313,4.2
48,301,Loving,2000,49,45,4,8.2
48,303,Lubbock,2000,128321,123707,4614,3.6
48,305,Lynn,2000,2998,2874,124,4.1
48,307,McCulloch,2000,3701,3503,198,5.3
48,309,McLennan,2000,104060,99696,4364,4.2
48,311,McMullen,2000,400,384,16,4.0
48,313,Madison,2000,4859,4619,240,4.9
48,315,Marion,2000,4662,4361,301,6.5
48,317,Martin,2000,2140,2054,86,4.0
48,319,Mason,2000,2025,1965,60,3.0
48,321,Matagorda,2000,17345,16180,1165,6.7
48,323,Maverick,2000,16559,14053,2506,15.1
48,325,Medina,2000,18002,17280,722,4.0
48,327,Menard,2000,1172,1130,42,3.6
48,329,Midland,2000,58350,55882,2468,4.2
48,331,Milam,2000,11626,11182,444,3.8
48,333,Mills,2000,2466,2377,89,3.6
48,335,Mitchell,2000,3440,3247,193,5.6
48,337,Montague,2000,9259,8813,446,4.8
48,339,Montgomery,2000,152995,147345,5650,3.7
48,341,Moore,2000,9714,9392,322,3.3
48,343,Morris,2000,5960,5576,384,6.4
48,345,Motley,2000,706,681,25,3.5
48,347,Nacogdoches,2000,29144,27859,1285,4.4
48,349,Navarro,2000,21158,20090,1068,5.0
48,351,Newton,2000,6122,5631,491,8.0
48,353,Nolan,2000,7358,6998,360,4.9
48,355,Nueces,2000,148327,140456,7871,5.3
48,357,Ochiltree,2000,4781,4631,150,3.1
48,359,Oldham,2000,1156,1118,38,3.3
48,361,Orange,2000,40762,37910,2852,7.0
48,363,Palo Pinto,2000,13376,12814,562,4.2
48,365,Panola,2000,10424,9830,594,5.7
48,367,Parker,2000,46413,44736,1677,3.6
48,369,Parmer,2000,4505,4350,155,3.4
48,371,Pecos,2000,7011,6653,358,5.1
48,373,Polk,2000,15928,14982,946,5.9
48,375,Potter,2000,53100,50221,2879,5.4
48,377,Presidio,2000,3200,2663,537,16.8
48,379,Rains,2000,4371,4198,173,4.0
48,381,Randall,2000,60419,58882,1537,2.5
48,383,Reagan,2000,1628,1571,57,3.5
48,385,Real,2000,1392,1330,62,4.5
48,387,Red River,2000,6801,6465,336,4.9
48,389,Reeves,2000,5056,4606,450,8.9
48,391,Refugio,2000,3700,3541,159,4.3
48,393,Roberts,2000,514,501,13,2.5
48,395,Robertson,2000,6979,6653,326,4.7
48,397,Rockwall,2000,24345,23604,741,3.0
48,399,Runnels,2000,5297,5043,254,4.8
48,401,Rusk,2000,21126,20068,1058,5.0
48,403,Sabine,2000,3781,3458,323,8.5
48,405,San Augustine,2000,3756,3556,200,5.3
48,407,San Jacinto,2000,9413,8967,446,4.7
48,409,San Patricio,2000,27532,25892,1640,6.0
48,411,San Saba,2000,2812,2692,120,4.3
48,413,Schleicher,2000,1510,1453,57,3.8
48,415,Scurry,2000,7247,6894,353,4.9
48,417,Shackelford,2000,1648,1591,57,3.5
48,419,Shelby,2000,11383,10782,601,5.3
48,421,Sherman,2000,1630,1585,45,2.8
48,423,Smith,2000,86596,82737,3859,4.5
48,425,Somervell,2000,3469,3324,145,4.2
48,427,Starr,2000,17804,14797,3007,16.9
48,429,Stephens,2000,4382,4192,190,4.3
48,431,Sterling,2000,730,706,24,3.3
48,433,Stonewall,2000,823,787,36,4.4
48,435,Sutton,2000,2160,2076,84,3.9
48,437,Swisher,2000,3892,3734,158,4.1
48,439,Tarrant,2000,795728,767060,28668,3.6
48,441,Taylor,2000,61504,58977,2527,4.1
48,443,Terrell,2000,514,494,20,3.9
48,445,Terry,2000,5620,5341,279,5.0
48,447,Throckmorton,2000,978,944,34,3.5
48,449,Titus,2000,12792,12222,570,4.5
48,451,Tom Green,2000,50819,48808,2011,4.0
48,453,Travis,2000,492505,477474,15031,3.1
48,455,Trinity,2000,5774,5463,311,5.4
48,457,Tyler,2000,7945,7404,541,6.8
48,459,Upshur,2000,16546,15727,819,4.9
48,461,Upton,2000,1513,1439,74,4.9
48,463,Uvalde,2000,11412,10752,660,5.8
48,465,Val Verde,2000,17380,16276,1104,6.4
48,467,Van Zandt,2000,22639,21729,910,4.0
48,469,Victoria,2000,43207,41581,1626,3.8
48,471,Walker,2000,25176,23989,1187,4.7
48,473,Waller,2000,15353,14667,686,4.5
48,475,Ward,2000,4462,4180,282,6.3
48,477,Washington,2000,15119,14549,570,3.8
48,479,Webb,2000,71112,66729,4383,6.2
48,481,Wharton,2000,20235,19354,881,4.4
48,483,Wheeler,2000,2712,2604,108,4.0
48,485,Wichita,2000,61088,58227,2861,4.7
48,487,Wilbarger,2000,7242,6966,276,3.8
48,489,Willacy,2000,7308,6577,731,10.0
48,491,Williamson,2000,145384,141340,4044,2.8
48,493,Wilson,2000,15549,14975,574,3.7
48,495,Winkler,2000,2939,2769,170,5.8
48,497,Wise,2000,25372,24485,887,3.5
48,499,Wood,2000,16307,15473,834,5.1
48,501,Yoakum,2000,3323,3145,178,5.4
48,503,Young,2000,8857,8409,448,5.1
48,505,Zapata,2000,3993,3668,325,8.1
48,507,Zavala,2000,3726,3257,469,12.6
49,1,Beaver,2000,2705,2612,93,3.4
49,3,Box Elder,2000,20099,19358,741,3.7
49,5,Cache,2000,48265,46928,1337,2.8
49,7,Carbon,2000,9281,8762,519,5.6
49,9,Daggett,2000,463,445,18,3.9
49,11,Davis,2000,120243,116517,3726,3.1
49,13,Duchesne,2000,6132,5831,301,4.9
49,15,Emery,2000,4731,4505,226,4.8
49,17,Garfield,2000,2486,2317,169,6.8
49,19,Grand,2000,4649,4344,305,6.6
49,21,Iron,2000,16910,16363,547,3.2
49,23,Juab,2000,3755,3622,133,3.5
49,25,Kane,2000,3030,2915,115,3.8
49,27,Millard,2000,5193,5015,178,3.4
49,29,Morgan,2000,3420,3303,117,3.4
49,31,Piute,2000,627,599,28,4.5
49,33,Rich,2000,1046,1015,31,3.0
49,35,Salt Lake,2000,486723,471418,15305,3.1
49,37,San Juan,2000,4727,4351,376,8.0
49,39,Sanpete,2000,9689,9264,425,4.4
49,41,Sevier,2000,8343,8021,322,3.9
49,43,Summit,2000,18274,17642,632,3.5
49,45,Tooele,2000,20277,19535,742,3.7
49,47,Uintah,2000,11407,10926,481,4.2
49,49,Utah,2000,181262,175965,5297,2.9
49,51,Wasatch,2000,7787,7515,272,3.5
49,53,Washington,2000,39385,38008,1377,3.5
49,55,Wayne,2000,1319,1259,60,4.5
49,57,Weber,2000,100632,96396,4236,4.2
50,1,Addison,2000,19728,19207,521,2.6
50,3,Bennington,2000,19835,19247,588,3.0
50,5,Caledonia,2000,15413,14892,521,3.4
50,7,Chittenden,2000,84777,82836,1941,2.3
50,9,Essex,2000,3250,3119,131,4.0
50,11,Franklin,2000,24406,23679,727,3.0
50,13,Grand Isle,2000,3767,3619,148,3.9
50,15,Lamoille,2000,13294,12867,427,3.2
50,17,Orange,2000,15462,15082,380,2.5
50,19,Orleans,2000,12885,12314,571,4.4
50,21,Rutland,2000,33431,32373,1058,3.2
50,23,Washington,2000,32677,31784,893,2.7
50,25,Windham,2000,24265,23579,686,2.8
50,27,Windsor,2000,30843,30066,777,2.5
51,1,Accomack,2000,18130,17592,538,3.0
51,3,Albemarle,2000,43572,42829,743,1.7
51,5,Alleghany,2000,7733,7500,233,3.0
51,7,Amelia,2000,5867,5750,117,2.0
51,9,Amherst,2000,15414,15089,325,2.1
51,11,Appomattox,2000,6768,6602,166,2.5
51,13,Arlington,2000,119360,117502,1858,1.6
51,15,Augusta,2000,34604,33935,669,1.9
51,17,Bath,2000,2738,2665,73,2.7
51,19,Bedford,2000,34731,34053,678,2.0
51,21,Bland,2000,2933,2781,152,5.2
51,23,Botetourt,2000,16476,16185,291,1.8
51,25,Brunswick,2000,6851,6612,239,3.5
51,27,Buchanan,2000,8735,8226,509,5.8
51,29,Buckingham,2000,6145,5950,195,3.2
51,31,Campbell,2000,26513,25904,609,2.3
51,33,Caroline,2000,11001,10763,238,2.2
51,35,Carroll,2000,14818,14222,596,4.0
51,36,Charles City,2000,3616,3527,89,2.5
51,37,Charlotte,2000,5519,5346,173,3.1
51,41,Chesterfield,2000,142337,139808,2529,1.8
51,43,Clarke,2000,6910,6801,109,1.6
51,45,Craig,2000,2504,2444,60,2.4
51,47,Culpeper,2000,16933,16611,322,1.9
51,49,Cumberland,2000,4238,4144,94,2.2
51,51,Dickenson,2000,5364,5054,310,5.8
51,53,Dinwiddie,2000,12039,11789,250,2.1
51,57,Essex,2000,5152,5015,137,2.7
51,59,Fairfax,2000,550845,541926,8919,1.6
51,61,Fauquier,2000,30225,29761,464,1.5
51,63,Floyd,2000,6976,6720,256,3.7
51,65,Fluvanna,2000,10228,10028,200,2.0
51,67,Franklin,2000,24381,23656,725,3.0
51,69,Frederick,2000,32928,32262,666,2.0
51,71,Giles,2000,7800,7471,329,4.2
51,73,Gloucester,2000,17598,17260,338,1.9
51,75,Goochland,2000,8918,8763,155,1.7
51,77,Grayson,2000,8089,7682,407,5.0
51,79,Greene,2000,8401,8248,153,1.8
51,81,Greensville,2000,4012,3878,134,3.3
51,83,Halifax,2000,16205,15398,807,5.0
51,85,Hanover,2000,47497,46717,780,1.6
51,87,Henrico,2000,145590,142967,2623,1.8
51,89,Henry,2000,28860,27459,1401,4.9
51,91,Highland,2000,1172,1138,34,2.9
51,93,Isle of Wight,2000,14911,14590,321,2.2
51,95,James City,2000,23298,22842,456,2.0
51,97,King and Queen,2000,3162,3081,81,2.6
51,99,King George,2000,8409,8247,162,1.9
51,101,King William,2000,7031,6899,132,1.9
51,103,Lancaster,2000,4850,4568,282,5.8
51,105,Lee,2000,8828,8459,369,4.2
51,107,Loudoun,2000,100096,98687,1409,1.4
51,109,Louisa,2000,12888,12584,304,2.4
51,111,Lunenburg,2000,5374,5189,185,3.4
51,113,Madison,2000,6561,6446,115,1.8
51,115,Mathews,2000,4260,4167,93,2.2
51,117,Mecklenburg,2000,14247,13772,475,3.3
51,119,Middlesex,2000,4546,4451,95,2.1
51,121,Montgomery,2000,40828,39802,1026,2.5
51,125,Nelson,2000,7034,6872,162,2.3
51,127,New Kent,2000,7301,7168,133,1.8
51,131,Northampton,2000,5605,5456,149,2.7
51,133,Northumberland,2000,5441,5194,247,4.5
51,135,Nottoway,2000,6173,5994,179,2.9
51,137,Orange,2000,12740,12480,260,2.0
51,139,Page,2000,11789,11480,309,2.6
51,141,Patrick,2000,9509,9197,312,3.3
51,143,Pittsylvania,2000,31960,30908,1052,3.3
51,145,Powhatan,2000,11253,11050,203,1.8
51,147,Prince Edward,2000,8134,7863,271,3.3
51,149,Prince George,2000,13225,12889,336,2.5
51,153,Prince William,2000,153649,150951,2698,1.8
51,155,Pulaski,2000,17401,16615,786,4.5
51,157,Rappahannock,2000,3754,3685,69,1.8
51,159,Richmond,2000,3426,3278,148,4.3
51,161,Roanoke,2000,46019,45225,794,1.7
51,163,Rockbridge,2000,10676,10447,229,2.1
51,165,Rockingham,2000,36131,35524,607,1.7
51,167,Russell,2000,11863,11253,610,5.1
51,169,Scott,2000,9770,9398,372,3.8
51,171,Shenandoah,2000,18517,18188,329,1.8
51,173,Smyth,2000,15861,15178,683,4.3
51,175,Southampton,2000,7489,7284,205,2.7
51,177,Spotsylvania,2000,48534,47711,823,1.7
51,179,Stafford,2000,48435,47622,813,1.7
51,181,Surry,2000,3397,3299,98,2.9
51,183,Sussex,2000,4531,4366,165,3.6
51,185,Tazewell,2000,18996,18030,966,5.1
51,187,Warren,2000,16587,16252,335,2.0
51,191,Washington,2000,25139,24251,888,3.5
51,193,Westmoreland,2000,7687,7415,272,3.5
51,195,Wise,2000,16152,15474,678,4.2
51,197,Wythe,2000,14161,13552,609,4.3
51,199,York,2000,26865,26344,521,1.9
51,510,Alexandria city,2000,80962,79532,1430,1.8
51,520,Bristol city,2000,7513,7277,236,3.1
51,530,Buena Vista city,2000,3227,3154,73,2.3
51,540,Charlottesville city,2000,19379,18811,568,2.9
51,550,Chesapeake city,2000,97978,95758,2220,2.3
51,570,Colonial Heights city,2000,8619,8426,193,2.2
51,580,Covington city,2000,2901,2787,114,3.9
51,590,Danville city,2000,21387,20457,930,4.3
51,595,Emporia city,2000,2366,2293,73,3.1
51,600,Fairfax city,2000,12510,12342,168,1.3
51,610,Falls Church city,2000,6158,6059,99,1.6
51,620,Franklin city,2000,3569,3458,111,3.1
51,630,Fredericksburg city,2000,10326,10090,236,2.3
51,640,Galax city,2000,3305,3191,114,3.4
51,650,Hampton city,2000,64343,62615,1728,2.7
51,660,Harrisonburg city,2000,19661,19215,446,2.3
51,670,Hopewell city,2000,9873,9594,279,2.8
51,678,Lexington city,2000,2243,2164,79,3.5
51,680,Lynchburg city,2000,30789,30048,741,2.4
51,683,Manassas city,2000,19279,18958,321,1.7
51,685,Manassas Park city,2000,5791,5711,80,1.4
51,690,Martinsville city,2000,6743,6213,530,7.9
51,700,Newport News city,2000,82896,80748,2148,2.6
51,710,Norfolk city,2000,92998,89973,3025,3.3
51,720,Norton city,2000,1488,1427,61,4.1
51,730,Petersburg city,2000,13918,13446,472,3.4
51,735,Poquoson city,2000,5834,5727,107,1.8
51,740,Portsmouth city,2000,42953,41505,1448,3.4
51,750,Radford city,2000,7470,7230,240,3.2
51,760,Richmond city,2000,95433,92929,2504,2.6
51,770,Roanoke city,2000,46712,45574,1138,2.4
51,775,Salem city,2000,12978,12730,248,1.9
51,790,Staunton city,2000,11647,11398,249,2.1
51,800,Suffolk city,2000,29329,28599,730,2.5
51,810,Virginia Beach city,2000,205933,201387,4546,2.2
51,820,Waynesboro city,2000,9151,8916,235,2.6
51,830,Williamsburg city,2000,4607,4406,201,4.4
51,840,Winchester city,2000,12915,12630,285,2.2
53,1,Adams,2000,8174,7513,661,8.1
53,3,Asotin,2000,9797,9266,531,5.4
53,5,Benton,2000,77185,73084,4101,5.3
53,7,Chelan,2000,37064,34489,2575,6.9
53,9,Clallam,2000,26239,24301,1938,7.4
53,11,Clark,2000,181951,172641,9310,5.1
53,13,Columbia,2000,1808,1654,154,8.5
53,15,Cowlitz,2000,43829,40840,2989,6.8
53,17,Douglas,2000,18331,17131,1200,6.5
53,19,Ferry,2000,3026,2720,306,10.1
53,21,Franklin,2000,23323,21528,1795,7.7
53,23,Garfield,2000,1050,997,53,5.0
53,25,Grant,2000,36191,33182,3009,8.3
53,27,Grays Harbor,2000,29708,27377,2331,7.8
53,29,Island,2000,29396,27817,1579,5.4
53,31,Jefferson,2000,11837,11151,686,5.8
53,33,King,2000,993205,955128,38077,3.8
53,35,Kitsap,2000,107531,101704,5827,5.4
53,37,Kittitas,2000,17511,16479,1032,5.9
53,39,Klickitat,2000,9429,8667,762,8.1
53,41,Lewis,2000,30235,27858,2377,7.9
53,43,Lincoln,2000,4679,4441,238,5.1
53,45,Mason,2000,21270,19818,1452,6.8
53,47,Okanogan,2000,20881,19044,1837,8.8
53,49,Pacific,2000,8712,8052,660,7.6
53,51,Pend Oreille,2000,4681,4299,382,8.2
53,53,Pierce,2000,344926,326380,18546,5.4
53,55,San Juan,2000,7596,7272,324,4.3
53,57,Skagit,2000,52713,49424,3289,6.2
53,59,Skamania,2000,4883,4563,320,6.6
53,61,Snohomish,2000,325634,311764,13870,4.3
53,63,Spokane,2000,214313,202380,11933,5.6
53,65,Stevens,2000,17786,16401,1385,7.8
53,67,Thurston,2000,109801,104402,5399,4.9
53,69,Wahkiakum,2000,1682,1561,121,7.2
53,71,Walla Walla,2000,27558,25874,1684,6.1
53,73,Whatcom,2000,89315,84382,4933,5.5
53,75,Whitman,2000,19533,18750,783,4.0
53,77,Yakima,2000,114901,105491,9410,8.2
54,1,Barbour,2000,6587,6056,531,8.1
54,3,Berkeley,2000,39111,37671,1440,3.7
54,5,Boone,2000,9692,9023,669,6.9
54,7,Braxton,2000,5783,5350,433,7.5
54,9,Brooke,2000,11662,11116,546,4.7
54,11,Cabell,2000,44248,42089,2159,4.9
54,13,Calhoun,2000,2901,2596,305,10.5
54,15,Clay,2000,3601,3291,310,8.6
54,17,Doddridge,2000,2874,2703,171,5.9
54,19,Fayette,2000,18284,16957,1327,7.3
54,21,Gilmer,2000,2753,2549,204,7.4
54,23,Grant,2000,5406,5113,293,5.4
54,25,Greenbrier,2000,14944,13947,997,6.7
54,27,Hampshire,2000,9232,8925,307,3.3
54,29,Hancock,2000,15503,14782,721,4.7
54,31,Hardy,2000,6600,6343,257,3.9
54,33,Harrison,2000,30962,29149,1813,5.9
54,35,Jackson,2000,12577,11820,757,6.0
54,37,Jefferson,2000,23057,22264,793,3.4
54,39,Kanawha,2000,96101,91267,4834,5.0
54,41,Lewis,2000,7374,6936,438,5.9
54,43,Lincoln,2000,8039,7439,600,7.5
54,45,Logan,2000,13571,12534,1037,7.6
54,47,McDowell,2000,7010,6275,735,10.5
54,49,Marion,2000,25690,24176,1514,5.9
54,51,Marshall,2000,15701,14785,916,5.8
54,53,Mason,2000,10455,9597,858,8.2
54,55,Mercer,2000,25345,24033,1312,5.2
54,57,Mineral,2000,12823,12114,709,5.5
54,59,Mingo,2000,8972,8258,714,8.0
54,61,Monongalia,2000,40732,38932,1800,4.4
54,63,Monroe,2000,5758,5470,288,5.0
54,65,Morgan,2000,7196,6909,287,4.0
54,67,Nicholas,2000,10939,10180,759,6.9
54,69,Ohio,2000,22182,21172,1010,4.6
54,71,Pendleton,2000,3921,3606,315,8.0
54,73,Pleasants,2000,3285,3091,194,5.9
54,75,Pocahontas,2000,3988,3716,272,6.8
54,77,Preston,2000,13228,12480,748,5.7
54,79,Putnam,2000,25890,24623,1267,4.9
54,81,Raleigh,2000,32321,30302,2019,6.2
54,83,Randolph,2000,12683,11905,778,6.1
54,85,Ritchie,2000,4555,4264,291,6.4
54,87,Roane,2000,6135,5573,562,9.2
54,89,Summers,2000,4769,4412,357,7.5
54,91,Taylor,2000,6890,6506,384,5.6
54,93,Tucker,2000,3289,3077,212,6.4
54,95,Tyler,2000,3795,3565,230,6.1
54,97,Upshur,2000,10254,9629,625,6.1
54,99,Wayne,2000,17466,16533,933,5.3
54,101,Webster,2000,3221,2982,239,7.4
54,103,Wetzel,2000,7033,6460,573,8.1
54,105,Wirt,2000,2532,2351,181,7.1
54,107,Wood,2000,41661,39723,1938,4.7
54,109,Wyoming,2000,8507,7841,666,7.8
55,1,Adams,2000,8892,8502,390,4.4
55,3,Ashland,2000,8904,8434,470,5.3
55,5,Barron,2000,24959,23987,972,3.9
55,7,Bayfield,2000,7715,7309,406,5.3
55,9,Brown,2000,131182,127485,3697,2.8
55,11,Buffalo,2000,7868,7585,283,3.6
55,13,Burnett,2000,7788,7490,298,3.8
55,15,Calumet,2000,24108,23464,644,2.7
55,17,Chippewa,2000,29979,28730,1249,4.2
55,19,Clark,2000,17534,16789,745,4.2
55,21,Columbia,2000,29829,28768,1061,3.6
55,23,Crawford,2000,9138,8808,330,3.6
55,25,Dane,2000,265510,259409,6101,2.3
55,27,Dodge,2000,47494,45999,1495,3.1
55,29,Door,2000,16460,15817,643,3.9
55,31,Douglas,2000,22758,21786,972,4.3
55,33,Dunn,2000,22491,21733,758,3.4
55,35,Eau Claire,2000,53197,51512,1685,3.2
55,37,Florence,2000,2621,2514,107,4.1
55,39,Fond du Lac,2000,55774,54102,1672,3.0
55,41,Forest,2000,4643,4381,262,5.6
55,43,Grant,2000,27467,26566,901,3.3
55,45,Green,2000,20055,19428,627,3.1
55,47,Green Lake,2000,10737,10317,420,3.9
55,49,Iowa,2000,13649,13267,382,2.8
55,51,Iron,2000,3269,3047,222,6.8
55,53,Jackson,2000,9810,9365,445,4.5
55,55,Jefferson,2000,43287,42041,1246,2.9
55,57,Juneau,2000,12815,12185,630,4.9
55,59,Kenosha,2000,80882,77651,3231,4.0
55,61,Kewaunee,2000,11613,11306,307,2.6
55,63,La Crosse,2000,61384,59438,1946,3.2
55,65,Lafayette,2000,9185,8917,268,2.9
55,67,Langlade,2000,10798,10306,492,4.6
55,69,Lincoln,2000,16154,15489,665,4.1
55,71,Manitowoc,2000,47025,45514,1511,3.2
55,73,Marathon,2000,72096,69750,2346,3.3
55,75,Marinette,2000,22489,21510,979,4.4
55,77,Marquette,2000,7521,7130,391,5.2
55,78,Menominee,2000,1640,1496,144,8.8
55,79,Milwaukee,2000,476716,456488,20228,4.2
55,81,Monroe,2000,21647,20856,791,3.7
55,83,Oconto,2000,19425,18745,680,3.5
55,85,Oneida,2000,19741,18779,962,4.9
55,87,Outagamie,2000,93237,90549,2688,2.9
55,89,Ozaukee,2000,47531,46354,1177,2.5
55,91,Pepin,2000,3919,3783,136,3.5
55,93,Pierce,2000,22827,22251,576,2.5
55,95,Polk,2000,22727,21973,754,3.3
55,97,Portage,2000,38696,37367,1329,3.4
55,99,Price,2000,8379,7959,420,5.0
55,101,Racine,2000,99510,95639,3871,3.9
55,103,Richland,2000,9621,9291,330,3.4
55,105,Rock,2000,82624,79202,3422,4.1
55,107,Rusk,2000,7912,7505,407,5.1
55,109,St. Croix,2000,37918,37016,902,2.4
55,111,Sauk,2000,33222,32242,980,2.9
55,113,Sawyer,2000,8433,7991,442,5.2
55,115,Shawano,2000,22057,21269,788,3.6
55,117,Sheboygan,2000,64388,62790,1598,2.5
55,119,Taylor,2000,10985,10577,408,3.7
55,121,Trempealeau,2000,15428,14823,605,3.9
55,123,Vernon,2000,14365,13835,530,3.7
55,125,Vilas,2000,10969,10428,541,4.9
55,127,Walworth,2000,53984,52434,1550,2.9
55,129,Washburn,2000,8006,7602,404,5.0
55,131,Washington,2000,69852,67919,1933,2.8
55,133,Waukesha,2000,210606,204958,5648,2.7
55,135,Waupaca,2000,27822,26899,923,3.3
55,137,Waushara,2000,11801,11313,488,4.1
55,139,Winnebago,2000,89669,87231,2438,2.7
55,141,Wood,2000,40907,39344,1563,3.8
56,1,Albany,2000,18220,17621,599,3.3
56,3,Big Horn,2000,5293,5031,262,4.9
56,5,Campbell,2000,19823,19227,596,3.0
56,7,Carbon,2000,8058,7728,330,4.1
56,9,Converse,2000,6554,6301,253,3.9
56,11,Crook,2000,3158,3045,113,3.6
56,13,Fremont,2000,17581,16686,895,5.1
56,15,Goshen,2000,6222,6000,222,3.6
56,17,Hot Springs,2000,2632,2538,94,3.6
56,19,Johnson,2000,3559,3429,130,3.7
56,21,Laramie,2000,40059,38587,1472,3.7
56,23,Lincoln,2000,7324,7045,279,3.8
56,25,Natrona,2000,36373,34978,1395,3.8
56,27,Niobrara,2000,1230,1186,44,3.6
56,29,Park,2000,14315,13749,566,4.0
56,31,Platte,2000,4335,4163,172,4.0
56,33,Sheridan,2000,14688,14114,574,3.9
56,35,Sublette,2000,3545,3442,103,2.9
56,37,Sweetwater,2000,20623,19822,801,3.9
56,39,Teton,2000,14126,13791,335,2.4
56,41,Uinta,2000,10414,10004,410,3.9
56,43,Washakie,2000,4287,4093,194,4.5
56,45,Weston,2000,3284,3147,137,4.2
72,1,Adjuntas Municipio,2000,5197,4548,649,12.5
72,3,Aguada Municipio,2000,14028,12188,1840,13.1
72,5,Aguadilla Municipio,2000,20277,17598,2679,13.2
72,7,Aguas Buenas Municipio,2000,8768,7891,877,10.0
72,9,Aibonito Municipio,2000,7668,6770,898,11.7
72,11,Anasco Municipio,2000,9713,8498,1215,12.5
72,13,Arecibo Municipio,2000,32680,29028,3652,11.2
72,15,Arroyo Municipio,2000,5035,4301,734,14.6
72,17,Barceloneta Municipio,2000,7022,6124,898,12.8
72,19,Barranquitas Municipio,2000,7330,6530,800,10.9
72,21,Bayamon Municipio,2000,83450,77126,6324,7.6
72,23,Cabo Rojo Municipio,2000,17597,15901,1696,9.6
72,25,Caguas Municipio,2000,52880,47987,4893,9.3
72,27,Camuy Municipio,2000,11750,10514,1236,10.5
72,29,Canovanas Municipio,2000,13360,11761,1599,12.0
72,31,Carolina Municipio,2000,76669,70619,6050,7.9
72,33,Catano Municipio,2000,8773,7953,820,9.3
72,35,Cayey Municipio,2000,15671,13891,1780,11.4
72,37,Ceiba Municipio,2000,5789,5168,621,10.7
72,39,Ciales Municipio,2000,4962,4257,705,14.2
72,41,Cidra Municipio,2000,13989,12524,1465,10.5
72,43,Coamo Municipio,2000,10773,9527,1246,11.6
72,45,Comerio Municipio,2000,4846,4263,583,12.0
72,47,Corozal Municipio,2000,9933,8946,987,9.9
72,49,Culebra Municipio,2000,780,734,46,5.9
72,51,Dorado Municipio,2000,11977,11008,969,8.1
72,53,Fajardo Municipio,2000,14323,12628,1695,11.8
72,54,Florida Municipio,2000,3397,2971,426,12.5
72,55,Guanica Municipio,2000,5865,4940,925,15.8
72,57,Guayama Municipio,2000,12684,11062,1622,12.8
72,59,Guayanilla Municipio,2000,6332,5343,989,15.6
72,61,Guaynabo Municipio,2000,43406,41009,2397,5.5
72,63,Gurabo Municipio,2000,13384,12198,1186,8.9
72,65,Hatillo Municipio,2000,11753,10436,1317,11.2
72,67,Hormigueros Municipio,2000,6449,5766,683,10.6
72,69,Humacao Municipio,2000,19994,17546,2448,12.2
72,71,Isabela Municipio,2000,14270,12269,2001,14.0
72,73,Jayuya Municipio,2000,4593,4018,575,12.5
72,75,Juana Diaz Municipio,2000,14686,12838,1848,12.6
72,77,Juncos Municipio,2000,11738,10458,1280,10.9
72,79,Lajas Municipio,2000,8059,7020,1039,12.9
72,81,Lares Municipio,2000,10221,9048,1173,11.5
72,83,Las Marias Municipio,2000,3578,3080,498,13.9
72,85,Las Piedras Municipio,2000,11388,10003,1385,12.2
72,87,Loiza Municipio,2000,8410,7431,979,11.6
72,89,Luquillo Municipio,2000,6676,5820,856,12.8
72,91,Manati Municipio,2000,13737,11901,1836,13.4
72,93,Maricao Municipio,2000,2144,1882,262,12.2
72,95,Maunabo Municipio,2000,3520,3015,505,14.3
72,97,Mayaguez Municipio,2000,32155,28187,3968,12.3
72,99,Moca Municipio,2000,13164,11454,1710,13.0
72,101,Morovis Municipio,2000,8446,7353,1093,12.9
72,103,Naguabo Municipio,2000,7154,6286,868,12.1
72,105,Naranjito Municipio,2000,8383,7603,780,9.3
72,107,Orocovis Municipio,2000,5197,4493,704,13.5
72,109,Patillas Municipio,2000,5342,4566,776,14.5
72,111,Penuelas Municipio,2000,7684,6579,1105,14.4
72,113,Ponce Municipio,2000,58896,52076,6820,11.6
72,115,Quebradillas Municipio,2000,8037,7091,946,11.8
72,117,Rincon Municipio,2000,4846,4216,630,13.0
72,119,Rio Grande Municipio,2000,16937,14993,1944,11.5
72,121,Sabana Grande Municipio,2000,8374,7355,1019,12.2
72,123,Salinas Municipio,2000,8287,7141,1146,13.8
72,125,San German Municipio,2000,12325,10677,1648,13.4
72,127,San Juan Municipio,2000,173897,161065,12832,7.4
72,129,San Lorenzo Municipio,2000,13334,11885,1449,10.9
72,131,San Sebastian Municipio,2000,13947,11977,1970,14.1
72,133,Santa Isabel Municipio,2000,7744,6837,907,11.7
72,135,Toa Alta Municipio,2000,23986,22331,1655,6.9
72,137,Toa Baja Municipio,2000,35005,32425,2580,7.4
72,139,Trujillo Alto Municipio,2000,31171,29065,2106,6.8
72,141,Utuado Municipio,2000,9217,8079,1138,12.3
72,143,Vega Alta Municipio,2000,11786,10712,1074,9.1
72,145,Vega Baja Municipio,2000,19805,17607,2198,11.1
72,147,Vieques Municipio,2000,2441,2120,321,13.2
72,149,Villalba Municipio,2000,7636,6648,988,12.9
72,151,Yabucoa Municipio,2000,10613,9005,1608,15.2
72,153,Yauco Municipio,2000,14664,12871,1793,12.2
1,1,Autauga,2001,22081,21166,915,4.1
1,3,Baldwin,2001,69569,66545,3024,4.3
1,5,Barbour,2001,11324,10468,856,7.6
1,7,Bibb,2001,9134,8513,621,6.8
1,9,Blount,2001,25450,24521,929,3.7
1,11,Bullock,2001,3937,3543,394,10.0
1,13,Butler,2001,9060,8372,688,7.6
1,15,Calhoun,2001,51889,49001,2888,5.6
1,17,Chambers,2001,17526,16568,958,5.5
1,19,Cherokee,2001,11406,10881,525,4.6
1,21,Chilton,2001,19580,18631,949,4.8
1,23,Choctaw,2001,5907,5481,426,7.2
1,25,Clarke,2001,11094,9998,1096,9.9
1,27,Clay,2001,6405,6012,393,6.1
1,29,Cleburne,2001,6964,6594,370,5.3
1,31,Coffee,2001,19397,18179,1218,6.3
1,33,Colbert,2001,25768,23982,1786,6.9
1,35,Conecuh,2001,5307,4916,391,7.4
1,37,Coosa,2001,5333,4969,364,6.8
1,39,Covington,2001,16954,15866,1088,6.4
1,41,Crenshaw,2001,6038,5671,367,6.1
1,43,Cullman,2001,38206,36421,1785,4.7
1,45,Dale,2001,20248,19112,1136,5.6
1,47,Dallas,2001,17596,15965,1631,9.3
1,49,DeKalb,2001,32429,30852,1577,4.9
1,51,Elmore,2001,31655,30297,1358,4.3
1,53,Escambia,2001,15632,14663,969,6.2
1,55,Etowah,2001,47060,43918,3142,6.7
1,57,Fayette,2001,8195,7672,523,6.4
1,59,Franklin,2001,14056,12971,1085,7.7
1,61,Geneva,2001,12126,11336,790,6.5
1,63,Greene,2001,3516,3262,254,7.2
1,65,Hale,2001,7063,6547,516,7.3
1,67,Henry,2001,7587,7174,413,5.4
1,69,Houston,2001,45013,43058,1955,4.3
1,71,Jackson,2001,27183,25391,1792,6.6
1,73,Jefferson,2001,327780,313445,14335,4.4
1,75,Lamar,2001,7267,6676,591,8.1
1,77,Lauderdale,2001,43083,40237,2846,6.6
1,79,Lawrence,2001,16621,15622,999,6.0
1,81,Lee,2001,58555,56125,2430,4.1
1,83,Limestone,2001,33450,31976,1474,4.4
1,85,Lowndes,2001,5043,4675,368,7.3
1,87,Macon,2001,8959,8433,526,5.9
1,89,Madison,2001,150541,144676,5865,3.9
1,91,Marengo,2001,8948,8409,539,6.0
1,93,Marion,2001,12997,11855,1142,8.8
1,95,Marshall,2001,40140,37895,2245,5.6
1,97,Mobile,2001,184868,174354,10514,5.7
1,99,Monroe,2001,9957,9229,728,7.3
1,101,Montgomery,2001,105566,100729,4837,4.6
1,103,Morgan,2001,56580,53654,2926,5.2
1,105,Perry,2001,3899,3466,433,11.1
1,107,Pickens,2001,8498,7774,724,8.5
1,109,Pike,2001,13605,12873,732,5.4
1,111,Randolph,2001,9989,9356,633,6.3
1,113,Russell,2001,21589,20384,1205,5.6
1,115,St. Clair,2001,31855,30507,1348,4.2
1,117,Shelby,2001,84572,82074,2498,3.0
1,119,Sumter,2001,5155,4715,440,8.5
1,121,Talladega,2001,36049,33666,2383,6.6
1,123,Tallapoosa,2001,19371,18213,1158,6.0
1,125,Tuscaloosa,2001,81828,78363,3465,4.2
1,127,Walker,2001,31419,29513,1906,6.1
1,129,Washington,2001,7489,6812,677,9.0
1,131,Wilcox,2001,3859,3466,393,10.2
1,133,Winston,2001,10810,9783,1027,9.5
2,13,Aleutians East Borough,2001,1011,928,83,8.2
2,16,Aleutians West Census Area,2001,2639,2485,154,5.8
2,20,Anchorage Borough/municipality,2001,142100,135100,7000,4.9
2,50,Bethel Census Area,2001,6319,5701,618,9.8
2,60,Bristol Bay Borough,2001,948,897,51,5.4
2,68,Denali Borough,2001,1450,1357,93,6.4
2,70,Dillingham Census Area,2001,1914,1761,153,8.0
2,90,Fairbanks North Star Borough,2001,41459,38999,2460,5.9
2,100,Haines Borough,2001,1249,1127,122,9.8
2,110,Juneau Borough/city,2001,18007,17169,838,4.7
2,122,Kenai Peninsula Borough,2001,24348,22371,1977,8.1
2,130,Ketchikan Gateway Borough,2001,8141,7601,540,6.6
2,150,Kodiak Island Borough,2001,6449,5882,567,8.8
2,158,Kusilvak Census Area,2001,2342,1983,359,15.3
2,164,Lake and Peninsula Borough,2001,965,905,60,6.2
2,170,Matanuska-Susitna Borough,2001,29888,27784,2104,7.0
2,180,Nome Census Area,2001,3693,3337,356,9.6
2,185,North Slope Borough,2001,3713,3438,275,7.4
2,188,Northwest Arctic Borough,2001,3025,2729,296,9.8
2,201,Prince of Wales-Outer Ketchikan Census Area,2001,2359,2002,357,15.1
2,220,Sitka Borough/city,2001,4477,4266,211,4.7
2,232,Skagway-Hoonah-Angoon Census Area,2001,1840,1626,214,11.6
2,240,Southeast Fairbanks Census Area,2001,2126,1853,273,12.8
2,261,Valdez-Cordova Census Area,2001,5081,4644,437,8.6
2,280,Wrangell-Petersburg Census Area,2001,3038,2731,307,10.1
2,282,Yakutat Borough/city,2001,330,301,29,8.8
2,290,Yukon-Koyukuk Census Area,2001,2742,2445,297,10.8
4,1,Apache,2001,19240,17428,1812,9.4
4,3,Cochise,2001,50457,48011,2446,4.8
4,5,Coconino,2001,63780,60792,2988,4.7
4,7,Gila,2001,20473,19288,1185,5.8
4,9,Graham,2001,11946,11199,747,6.3
4,11,Greenlee,2001,3832,3558,274,7.2
4,12,La Paz,2001,7048,6579,469,6.7
4,13,Maricopa,2001,1661301,1592148,69153,4.2
4,15,Mohave,2001,73059,69556,3503,4.8
4,17,Navajo,2001,35243,32567,2676,7.6
4,19,Pima,2001,416341,398250,18091,4.3
4,21,Pinal,2001,72150,68271,3879,5.4
4,23,Santa Cruz,2001,15061,13745,1316,8.7
4,25,Yavapai,2001,78358,74881,3477,4.4
4,27,Yuma,2001,65374,54543,10831,16.6
5,1,Arkansas,2001,10312,9845,467,4.5
5,3,Ashley,2001,10335,9584,751,7.3
5,5,Baxter,2001,16110,15253,857,5.3
5,7,Benton,2001,80257,77935,2322,2.9
5,9,Boone,2001,16104,15290,814,5.1
5,11,Bradley,2001,5286,4916,370,7.0
5,13,Calhoun,2001,2526,2387,139,5.5
5,15,Carroll,2001,12965,12449,516,4.0
5,17,Chicot,2001,5406,4943,463,8.6
5,19,Clark,2001,11280,10770,510,4.5
5,21,Clay,2001,7809,7275,534,6.8
5,23,Cleburne,2001,10778,10282,496,4.6
5,25,Cleveland,2001,3927,3710,217,5.5
5,27,Columbia,2001,11104,10543,561,5.1
5,29,Conway,2001,9394,8945,449,4.8
5,31,Craighead,2001,42047,40147,1900,4.5
5,33,Crawford,2001,25009,24002,1007,4.0
5,35,Crittenden,2001,21606,20509,1097,5.1
5,37,Cross,2001,8548,8061,487,5.7
5,39,Dallas,2001,3796,3541,255,6.7
5,41,Desha,2001,6245,5720,525,8.4
5,43,Drew,2001,8475,7768,707,8.3
5,45,Faulkner,2001,46366,44334,2032,4.4
5,47,Franklin,2001,8087,7788,299,3.7
5,49,Fulton,2001,4939,4695,244,4.9
5,51,Garland,2001,38038,36261,1777,4.7
5,53,Grant,2001,8183,7772,411,5.0
5,55,Greene,2001,17507,16311,1196,6.8
5,57,Hempstead,2001,10971,10473,498,4.5
5,59,Hot Spring,2001,14181,13462,719,5.1
5,61,Howard,2001,6444,6113,331,5.1
5,63,Independence,2001,17028,16119,909,5.3
5,65,Izard,2001,5085,4796,289,5.7
5,67,Jackson,2001,7701,7137,564,7.3
5,69,Jefferson,2001,35731,33348,2383,6.7
5,71,Johnson,2001,10150,9681,469,4.6
5,73,Lafayette,2001,3447,3275,172,5.0
5,75,Lawrence,2001,7816,7314,502,6.4
5,77,Lee,2001,3822,3482,340,8.9
5,79,Lincoln,2001,5047,4695,352,7.0
5,81,Little River,2001,6379,6124,255,4.0
5,83,Logan,2001,9793,9311,482,4.9
5,85,Lonoke,2001,26696,25701,995,3.7
5,87,Madison,2001,7062,6828,234,3.3
5,89,Marion,2001,6568,6214,354,5.4
5,91,Miller,2001,18107,17306,801,4.4
5,93,Mississippi,2001,22188,19789,2399,10.8
5,95,Monroe,2001,4016,3770,246,6.1
5,97,Montgomery,2001,4096,3910,186,4.5
5,99,Nevada,2001,4544,4332,212,4.7
5,101,Newton,2001,3645,3453,192,5.3
5,103,Ouachita,2001,12379,11494,885,7.1
5,105,Perry,2001,4805,4554,251,5.2
5,107,Phillips,2001,9443,8733,710,7.5
5,109,Pike,2001,5378,5135,243,4.5
5,111,Poinsett,2001,11381,10578,803,7.1
5,113,Polk,2001,8992,8578,414,4.6
5,115,Pope,2001,26697,25555,1142,4.3
5,117,Prairie,2001,4382,4187,195,4.5
5,119,Pulaski,2001,183356,175727,7629,4.2
5,121,Randolph,2001,8202,7633,569,6.9
5,123,St. Francis,2001,10780,9966,814,7.6
5,125,Saline,2001,42909,41373,1536,3.6
5,127,Scott,2001,4806,4613,193,4.0
5,129,Searcy,2001,3245,3084,161,5.0
5,131,Sebastian,2001,56607,54415,2192,3.9
5,133,Sevier,2001,7333,7030,303,4.1
5,135,Sharp,2001,6516,6125,391,6.0
5,137,Stone,2001,4497,4252,245,5.4
5,139,Union,2001,20298,19287,1011,5.0
5,141,Van Buren,2001,6797,6386,411,6.0
5,143,Washington,2001,85287,82757,2530,3.0
5,145,White,2001,30685,29094,1591,5.2
5,147,Woodruff,2001,3868,3625,243,6.3
5,149,Yell,2001,9832,9471,361,3.7
6,1,Alameda,2001,776398,739045,37353,4.8
6,3,Alpine,2001,573,531,42,7.3
6,5,Amador,2001,16105,15285,820,5.1
6,7,Butte,2001,94972,88683,6289,6.6
6,9,Calaveras,2001,18994,17950,1044,5.5
6,11,Colusa,2001,9110,7938,1172,12.9
6,13,Contra Costa,2001,507353,486677,20676,4.1
6,15,Del Norte,2001,10196,9375,821,8.1
6,17,El Dorado,2001,83837,80212,3625,4.3
6,19,Fresno,2001,388896,347192,41704,10.7
6,21,Glenn,2001,11211,10224,987,8.8
6,23,Humboldt,2001,60287,56654,3633,6.0
6,25,Imperial,2001,55481,46598,8883,16.0
6,27,Inyo,2001,9012,8601,411,4.6
6,29,Kern,2001,297252,271657,25595,8.6
6,31,Kings,2001,50116,44732,5384,10.7
6,33,Lake,2001,24728,22979,1749,7.1
6,35,Lassen,2001,11645,10788,857,7.4
6,37,Los Angeles,2001,4729827,4458721,271106,5.7
6,39,Madera,2001,53826,48652,5174,9.6
6,41,Marin,2001,139733,134793,4940,3.5
6,43,Mariposa,2001,8461,7973,488,5.8
6,45,Mendocino,2001,44550,41891,2659,6.0
6,47,Merced,2001,91609,82259,9350,10.2
6,49,Modoc,2001,3899,3627,272,7.0
6,51,Mono,2001,7594,7237,357,4.7
6,53,Monterey,2001,204306,188278,16028,7.8
6,55,Napa,2001,70252,67688,2564,3.6
6,57,Nevada,2001,46820,44754,2066,4.4
6,59,Orange,2001,1509124,1449080,60044,4.0
6,61,Placer,2001,138727,133127,5600,4.0
6,63,Plumas,2001,9932,9175,757,7.6
6,65,Riverside,2001,709270,670047,39223,5.5
6,67,Sacramento,2001,623012,594647,28365,4.6
6,69,San Benito,2001,27391,25642,1749,6.4
6,71,San Bernardino,2001,761198,722382,38816,5.1
6,73,San Diego,2001,1405911,1346728,59183,4.2
6,75,San Francisco/city,2001,468227,444257,23970,5.1
6,77,San Joaquin,2001,265617,245660,19957,7.5
6,79,San Luis Obispo,2001,125832,120737,5095,4.0
6,81,San Mateo,2001,391776,376734,15042,3.8
6,83,Santa Barbara,2001,202492,193513,8979,4.4
6,85,Santa Clara,2001,937026,889216,47810,5.1
6,87,Santa Cruz,2001,149951,141324,8627,5.8
6,89,Shasta,2001,77447,72507,4940,6.4
6,91,Sierra,2001,1665,1539,126,7.6
6,93,Siskiyou,2001,18928,17394,1534,8.1
6,95,Solano,2001,196649,187540,9109,4.6
6,97,Sonoma,2001,257175,247664,9511,3.7
6,99,Stanislaus,2001,213760,195808,17952,8.4
6,101,Sutter,2001,38365,34604,3761,9.8
6,103,Tehama,2001,24511,22898,1613,6.6
6,105,Trinity,2001,5381,4878,503,9.3
6,107,Tulare,2001,174960,154854,20106,11.5
6,109,Tuolumne,2001,23899,22491,1408,5.9
6,111,Ventura,2001,398264,378833,19431,4.9
6,113,Yolo,2001,88097,83561,4536,5.1
6,115,Yuba,2001,24800,22676,2124,8.6
8,1,Adams,2001,187740,180168,7572,4.0
8,3,Alamosa,2001,7754,7427,327,4.2
8,5,Arapahoe,2001,282682,272307,10375,3.7
8,7,Archuleta,2001,5320,5110,210,3.9
8,9,Baca,2001,2449,2376,73,3.0
8,11,Bent,2001,2513,2404,109,4.3
8,13,Boulder,2001,162701,156696,6005,3.7
8,14,Broomfield/city,2001,22398,21583,815,3.6
8,15,Chaffee,2001,7522,7222,300,4.0
8,17,Cheyenne,2001,1284,1254,30,2.3
8,19,Clear Creek,2001,5948,5748,200,3.4
8,21,Conejos,2001,3603,3379,224,6.2
8,23,Costilla,2001,1313,1204,109,8.3
8,25,Crowley,2001,1535,1446,89,5.8
8,27,Custer,2001,1795,1721,74,4.1
8,29,Delta,2001,13350,12799,551,4.1
8,31,Denver/city,2001,302872,289446,13426,4.4
8,33,Dolores,2001,939,891,48,5.1
8,35,Douglas,2001,113522,109857,3665,3.2
8,37,Eagle,2001,26151,25343,808,3.1
8,39,Elbert,2001,11977,11592,385,3.2
8,41,El Paso,2001,269256,257911,11345,4.2
8,43,Fremont,2001,18281,17361,920,5.0
8,45,Garfield,2001,25632,24815,817,3.2
8,47,Gilpin,2001,3242,3129,113,3.5
8,49,Grand,2001,8051,7812,239,3.0
8,51,Gunnison,2001,8349,8076,273,3.3
8,53,Hinsdale,2001,651,629,22,3.4
8,55,Huerfano,2001,3203,3000,203,6.3
8,57,Jackson,2001,1039,1003,36,3.5
8,59,Jefferson,2001,304872,294351,10521,3.5
8,61,Kiowa,2001,938,912,26,2.8
8,63,Kit Carson,2001,4315,4209,106,2.5
8,65,Lake,2001,3999,3840,159,4.0
8,67,La Plata,2001,25087,24282,805,3.2
8,69,Larimer,2001,150059,145241,4818,3.2
8,71,Las Animas,2001,7164,6838,326,4.6
8,73,Lincoln,2001,2907,2820,87,3.0
8,75,Logan,2001,10746,10408,338,3.1
8,77,Mesa,2001,60414,58095,2319,3.8
8,79,Mineral,2001,429,413,16,3.7
8,81,Moffat,2001,7313,7028,285,3.9
8,83,Montezuma,2001,11885,11364,521,4.4
8,85,Montrose,2001,16954,16212,742,4.4
8,87,Morgan,2001,13338,12913,425,3.2
8,89,Otero,2001,9086,8665,421,4.6
8,91,Ouray,2001,2340,2271,69,2.9
8,93,Park,2001,8729,8426,303,3.5
8,95,Phillips,2001,2381,2315,66,2.8
8,97,Pitkin,2001,10218,9850,368,3.6
8,99,Prowers,2001,7226,6996,230,3.2
8,101,Pueblo,2001,64248,60924,3324,5.2
8,103,Rio Blanco,2001,3490,3396,94,2.7
8,105,Rio Grande,2001,6215,5881,334,5.4
8,107,Routt,2001,13300,12918,382,2.9
8,109,Saguache,2001,3046,2863,183,6.0
8,111,San Juan,2001,516,481,35,6.8
8,113,San Miguel,2001,4933,4745,188,3.8
8,115,Sedgwick,2001,1548,1504,44,2.8
8,117,Summit,2001,16171,15692,479,3.0
8,119,Teller,2001,12018,11546,472,3.9
8,121,Washington,2001,2829,2753,76,2.7
8,123,Weld,2001,98243,94841,3402,3.5
8,125,Yuma,2001,5989,5854,135,2.3
9,1,Fairfield,2001,446698,434326,12372,2.8
9,3,Hartford,2001,431101,417678,13423,3.1
9,5,Litchfield,2001,99596,96909,2687,2.7
9,7,Middlesex,2001,86124,84000,2124,2.5
9,9,New Haven,2001,415883,402795,13088,3.1
9,11,New London,2001,134930,131488,3442,2.6
9,13,Tolland,2001,76609,74917,1692,2.2
9,15,Windham,2001,58258,56483,1775,3.0
10,1,Kent,2001,64891,62457,2434,3.8
10,3,New Castle,2001,275178,265546,9632,3.5
10,5,Sussex,2001,81495,78514,2981,3.7
11,1,District of Colu,2001,311232,291080,20152,6.5
12,1,Alachua,2001,119195,115074,4121,3.5
12,3,Baker,2001,10557,10129,428,4.1
12,5,Bay,2001,73037,69334,3703,5.1
12,7,Bradford,2001,10860,10385,475,4.4
12,9,Brevard,2001,238184,227816,10368,4.4
12,11,Broward,2001,891817,851866,39951,4.5
12,13,Calhoun,2001,5275,5012,263,5.0
12,15,Charlotte,2001,56470,54012,2458,4.4
12,17,Citrus,2001,44859,42331,2528,5.6
12,19,Clay,2001,76142,73253,2889,3.8
12,21,Collier,2001,124949,119857,5092,4.1
12,23,Columbia,2001,26022,24620,1402,5.4
12,27,DeSoto,2001,13492,12831,661,4.9
12,29,Dixie,2001,5297,5006,291,5.5
12,31,Duval,2001,414843,397354,17489,4.2
12,33,Escambia,2001,132337,125878,6459,4.9
12,35,Flagler,2001,22283,21264,1019,4.6
12,37,Franklin,2001,4625,4431,194,4.2
12,39,Gadsden,2001,20389,19419,970,4.8
12,41,Gilchrist,2001,6622,6336,286,4.3
12,43,Glades,2001,4349,4100,249,5.7
12,45,Gulf,2001,5366,5060,306,5.7
12,47,Hamilton,2001,4411,4080,331,7.5
12,49,Hardee,2001,10820,10078,742,6.9
12,51,Hendry,2001,17168,15879,1289,7.5
12,53,Hernando,2001,50804,48160,2644,5.2
12,55,Highlands,2001,34685,32904,1781,5.1
12,57,Hillsborough,2001,542598,520197,22401,4.1
12,59,Holmes,2001,7790,7322,468,6.0
12,61,Indian River,2001,53035,49955,3080,5.8
12,63,Jackson,2001,19738,18774,964,4.9
12,65,Jefferson,2001,6351,6072,279,4.4
12,67,Lafayette,2001,2676,2536,140,5.2
12,69,Lake,2001,97871,93542,4329,4.4
12,71,Lee,2001,220981,212798,8183,3.7
12,73,Leon,2001,135255,130490,4765,3.5
12,75,Levy,2001,14706,13961,745,5.1
12,77,Liberty,2001,2719,2591,128,4.7
12,79,Madison,2001,7448,7079,369,5.0
12,81,Manatee,2001,126519,121422,5097,4.0
12,83,Marion,2001,110461,105008,5453,4.9
12,85,Martin,2001,58806,55895,2911,5.0
12,86,Miami-Dade,2001,1075145,1026885,48260,4.5
12,87,Monroe,2001,46920,45331,1589,3.4
12,89,Nassau,2001,30885,29654,1231,4.0
12,91,Okaloosa,2001,83491,80165,3326,4.0
12,93,Okeechobee,2001,15742,14777,965,6.1
12,95,Orange,2001,512064,490776,21288,4.2
12,97,Osceola,2001,94135,90013,4122,4.4
12,99,Palm Beach,2001,571046,542569,28477,5.0
12,101,Pasco,2001,155978,148768,7210,4.6
12,103,Pinellas,2001,473931,453527,20404,4.3
12,105,Polk,2001,238703,226747,11956,5.0
12,107,Putnam,2001,29259,27687,1572,5.4
12,109,St. Johns,2001,69450,66913,2537,3.7
12,111,St. Lucie,2001,91684,85960,5724,6.2
12,113,Santa Rosa,2001,56013,53483,2530,4.5
12,115,Sarasota,2001,151705,145811,5894,3.9
12,117,Seminole,2001,215618,207076,8542,4.0
12,119,Sumter,2001,17562,16615,947,5.4
12,121,Suwannee,2001,15649,14877,772,4.9
12,123,Taylor,2001,8334,7784,550,6.6
12,125,Union,2001,4784,4546,238,5.0
12,127,Volusia,2001,216856,207656,9200,4.2
12,129,Wakulla,2001,12376,11936,440,3.6
12,131,Walton,2001,20868,20074,794,3.8
12,133,Washington,2001,8888,8395,493,5.5
13,1,Appling,2001,8390,7812,578,6.9
13,3,Atkinson,2001,3324,3119,205,6.2
13,5,Bacon,2001,4486,4239,247,5.5
13,7,Baker,2001,1722,1637,85,4.9
13,9,Baldwin,2001,18798,17945,853,4.5
13,11,Banks,2001,7793,7512,281,3.6
13,13,Barrow,2001,25893,24864,1029,4.0
13,15,Bartow,2001,41443,39615,1828,4.4
13,17,Ben Hill,2001,7830,7422,408,5.2
13,19,Berrien,2001,7921,7590,331,4.2
13,21,Bibb,2001,69165,66073,3092,4.5
13,23,Bleckley,2001,5064,4795,269,5.3
13,25,Brantley,2001,6808,6480,328,4.8
13,27,Brooks,2001,7557,7197,360,4.8
13,29,Bryan,2001,11885,11512,373,3.1
13,31,Bulloch,2001,27445,26236,1209,4.4
13,33,Burke,2001,9345,8767,578,6.2
13,35,Butts,2001,9185,8771,414,4.5
13,37,Calhoun,2001,2361,2204,157,6.6
13,39,Camden,2001,17853,17174,679,3.8
13,43,Candler,2001,3902,3715,187,4.8
13,45,Carroll,2001,46112,43920,2192,4.8
13,47,Catoosa,2001,30171,29266,905,3.0
13,49,Charlton,2001,3937,3767,170,4.3
13,51,Chatham,2001,111464,107406,4058,3.6
13,53,Chattahoochee,2001,2601,2404,197,7.6
13,55,Chattooga,2001,11175,10633,542,4.9
13,57,Cherokee,2001,85646,83163,2483,2.9
13,59,Clarke,2001,54547,52465,2082,3.8
13,61,Clay,2001,1314,1236,78,5.9
13,63,Clayton,2001,129259,124008,5251,4.1
13,65,Clinch,2001,2425,2248,177,7.3
13,67,Cobb,2001,362891,350654,12237,3.4
13,69,Coffee,2001,16630,15718,912,5.5
13,71,Colquitt,2001,18754,17685,1069,5.7
13,73,Columbia,2001,47795,46335,1460,3.1
13,75,Cook,2001,7140,6783,357,5.0
13,77,Coweta,2001,49791,48031,1760,3.5
13,79,Crawford,2001,5811,5561,250,4.3
13,81,Crisp,2001,9389,8882,507,5.4
13,83,Dade,2001,7832,7552,280,3.6
13,85,Dawson,2001,9212,8921,291,3.2
13,87,Decatur,2001,11941,11287,654,5.5
13,89,DeKalb,2001,377958,362407,15551,4.1
13,91,Dodge,2001,8340,7886,454,5.4
13,93,Dooly,2001,4791,4530,261,5.4
13,95,Dougherty,2001,40301,38064,2237,5.6
13,97,Douglas,2001,52030,50313,1717,3.3
13,99,Early,2001,5450,5184,266,4.9
13,101,Echols,2001,1897,1825,72,3.8
13,103,Effingham,2001,19725,19094,631,3.2
13,105,Elbert,2001,9780,9226,554,5.7
13,107,Emanuel,2001,9600,9014,586,6.1
13,109,Evans,2001,4683,4489,194,4.1
13,111,Fannin,2001,9189,8780,409,4.5
13,113,Fayette,2001,49996,48568,1428,2.9
13,115,Floyd,2001,45143,43092,2051,4.5
13,117,Forsyth,2001,61040,59271,1769,2.9
13,119,Franklin,2001,9875,9341,534,5.4
13,121,Fulton,2001,439049,420681,18368,4.2
13,123,Gilmer,2001,11457,11042,415,3.6
13,125,Glascock,2001,1169,1116,53,4.5
13,127,Glynn,2001,34730,33430,1300,3.7
13,129,Gordon,2001,23763,22505,1258,5.3
13,131,Grady,2001,11037,10557,480,4.3
13,133,Greene,2001,6234,5802,432,6.9
13,135,Gwinnett,2001,356212,344204,12008,3.4
13,137,Habersham,2001,18408,17596,812,4.4
13,139,Hall,2001,74354,71720,2634,3.5
13,141,Hancock,2001,3309,2996,313,9.5
13,143,Haralson,2001,12502,11940,562,4.5
13,145,Harris,2001,12998,12539,459,3.5
13,147,Hart,2001,11147,10491,656,5.9
13,149,Heard,2001,5105,4848,257,5.0
13,151,Henry,2001,71040,68872,2168,3.1
13,153,Houston,2001,54759,52892,1867,3.4
13,155,Irwin,2001,4415,4171,244,5.5
13,157,Jackson,2001,21356,20430,926,4.3
13,159,Jasper,2001,5795,5588,207,3.6
13,161,Jeff Davis,2001,5635,5208,427,7.6
13,163,Jefferson,2001,6633,6087,546,8.2
13,165,Jenkins,2001,3541,3319,222,6.3
13,167,Johnson,2001,3375,3168,207,6.1
13,169,Jones,2001,11782,11359,423,3.6
13,171,Lamar,2001,8123,7723,400,4.9
13,173,Lanier,2001,3270,3130,140,4.3
13,175,Laurens,2001,21323,20359,964,4.5
13,177,Lee,2001,13687,13214,473,3.5
13,179,Liberty,2001,19769,18782,987,5.0
13,181,Lincoln,2001,3457,3166,291,8.4
13,183,Long,2001,4523,4376,147,3.3
13,185,Lowndes,2001,43450,41774,1676,3.9
13,187,Lumpkin,2001,10927,10559,368,3.4
13,189,McDuffie,2001,9977,9385,592,5.9
13,191,McIntosh,2001,4870,4663,207,4.3
13,193,Macon,2001,5303,4942,361,6.8
13,195,Madison,2001,14021,13461,560,4.0
13,197,Marion,2001,3304,3122,182,5.5
13,199,Meriwether,2001,10022,9483,539,5.4
13,201,Miller,2001,3214,3081,133,4.1
13,205,Mitchell,2001,9785,9259,526,5.4
13,207,Monroe,2001,11280,10851,429,3.8
13,209,Montgomery,2001,3866,3608,258,6.7
13,211,Morgan,2001,8213,7937,276,3.4
13,213,Murray,2001,19660,18818,842,4.3
13,215,Muscogee,2001,82195,78040,4155,5.1
13,217,Newton,2001,33875,32631,1244,3.7
13,219,Oconee,2001,14518,14120,398,2.7
13,221,Oglethorpe,2001,6761,6492,269,4.0
13,223,Paulding,2001,47998,46579,1419,3.0
13,225,Peach,2001,10652,10157,495,4.6
13,227,Pickens,2001,12865,12436,429,3.3
13,229,Pierce,2001,7449,7120,329,4.4
13,231,Pike,2001,6969,6693,276,4.0
13,233,Polk,2001,18253,17362,891,4.9
13,235,Pulaski,2001,4261,3988,273,6.4
13,237,Putnam,2001,8965,8609,356,4.0
13,239,Quitman,2001,1034,955,79,7.6
13,241,Rabun,2001,7053,6776,277,3.9
13,243,Randolph,2001,2886,2650,236,8.2
13,245,Richmond,2001,86438,82177,4261,4.9
13,247,Rockdale,2001,36828,35544,1284,3.5
13,249,Schley,2001,1679,1597,82,4.9
13,251,Screven,2001,6387,5943,444,7.0
13,253,Seminole,2001,3976,3766,210,5.3
13,255,Spalding,2001,27984,26630,1354,4.8
13,257,Stephens,2001,13390,12703,687,5.1
13,259,Stewart,2001,1971,1825,146,7.4
13,261,Sumter,2001,14824,13972,852,5.7
13,263,Talbot,2001,2819,2640,179,6.3
13,265,Taliaferro,2001,800,727,73,9.1
13,267,Tattnall,2001,8459,8027,432,5.1
13,269,Taylor,2001,3301,3099,202,6.1
13,271,Telfair,2001,4039,3565,474,11.7
13,273,Terrell,2001,4549,4260,289,6.4
13,275,Thomas,2001,20276,19415,861,4.2
13,277,Tift,2001,18631,17772,859,4.6
13,279,Toombs,2001,11683,10922,761,6.5
13,281,Towns,2001,4419,4252,167,3.8
13,283,Treutlen,2001,2598,2422,176,6.8
13,285,Troup,2001,30746,29375,1371,4.5
13,287,Turner,2001,4867,4559,308,6.3
13,289,Twiggs,2001,4569,4319,250,5.5
13,291,Union,2001,8318,8009,309,3.7
13,293,Upson,2001,12264,11201,1063,8.7
13,295,Walker,2001,30684,29356,1328,4.3
13,297,Walton,2001,33381,32165,1216,3.6
13,299,Ware,2001,14797,13995,802,5.4
13,301,Warren,2001,2621,2401,220,8.4
13,303,Washington,2001,8258,7828,430,5.2
13,305,Wayne,2001,10914,10345,569,5.2
13,307,Webster,2001,1015,963,52,5.1
13,309,Wheeler,2001,2265,2096,169,7.5
13,311,White,2001,10878,10482,396,3.6
13,313,Whitfield,2001,43324,41363,1961,4.5
13,315,Wilcox,2001,3311,3132,179,5.4
13,317,Wilkes,2001,4786,4385,401,8.4
13,319,Wilkinson,2001,4375,4168,207,4.7
13,321,Worth,2001,10104,9588,516,5.1
15,1,Hawaii,2001,75348,71541,3807,5.1
15,3,Honolulu/city,2001,429814,411939,17875,4.2
15,7,Kauai,2001,30101,28552,1549,5.1
15,9,Maui,2001,72294,69347,2947,4.1
16,1,Ada,2001,175821,169047,6774,3.9
16,3,Adams,2001,1955,1735,220,11.3
16,5,Bannock,2001,37916,36036,1880,5.0
16,7,Bear Lake,2001,2973,2834,139,4.7
16,9,Benewah,2001,4039,3615,424,10.5
16,11,Bingham,2001,19980,19033,947,4.7
16,13,Blaine,2001,12440,12015,425,3.4
16,15,Boise,2001,3468,3327,141,4.1
16,17,Bonner,2001,18093,16655,1438,7.9
16,19,Bonneville,2001,42706,41164,1542,3.6
16,21,Boundary,2001,4046,3665,381,9.4
16,23,Butte,2001,1461,1397,64,4.4
16,25,Camas,2001,563,542,21,3.7
16,27,Canyon,2001,69126,65545,3581,5.2
16,29,Caribou,2001,3434,3249,185,5.4
16,31,Cassia,2001,10345,9844,501,4.8
16,33,Clark,2001,560,530,30,5.4
16,35,Clearwater,2001,3570,3043,527,14.8
16,37,Custer,2001,2694,2526,168,6.2
16,39,Elmore,2001,10970,10343,627,5.7
16,41,Franklin,2001,5450,5239,211,3.9
16,43,Fremont,2001,5880,5607,273,4.6
16,45,Gem,2001,7233,6734,499,6.9
16,47,Gooding,2001,7113,6833,280,3.9
16,49,Idaho,2001,7022,6410,612,8.7
16,51,Jefferson,2001,9218,8854,364,3.9
16,53,Jerome,2001,9324,8936,388,4.2
16,55,Kootenai,2001,59438,55239,4199,7.1
16,57,Latah,2001,17425,16659,766,4.4
16,59,Lemhi,2001,3891,3599,292,7.5
16,61,Lewis,2001,1710,1588,122,7.1
16,63,Lincoln,2001,2231,2140,91,4.1
16,65,Madison,2001,13172,12750,422,3.2
16,67,Minidoka,2001,9878,9316,562,5.7
16,69,Nez Perce,2001,19623,18559,1064,5.4
16,71,Oneida,2001,2003,1930,73,3.6
16,73,Owyhee,2001,4879,4675,204,4.2
16,75,Payette,2001,9934,9142,792,8.0
16,77,Power,2001,3533,3327,206,5.8
16,79,Shoshone,2001,5761,5045,716,12.4
16,81,Teton,2001,3836,3735,101,2.6
16,83,Twin Falls,2001,34445,32978,1467,4.3
16,85,Valley,2001,4040,3728,312,7.7
16,87,Washington,2001,5082,4746,336,6.6
17,1,Adams,2001,35753,34208,1545,4.3
17,3,Alexander,2001,3499,3219,280,8.0
17,5,Bond,2001,8192,7792,400,4.9
17,7,Boone,2001,22153,20779,1374,6.2
17,9,Brown,2001,2993,2897,96,3.2
17,11,Bureau,2001,18720,17776,944,5.0
17,13,Calhoun,2001,2497,2347,150,6.0
17,15,Carroll,2001,8527,7944,583,6.8
17,17,Cass,2001,7137,6817,320,4.5
17,19,Champaign,2001,99468,95862,3606,3.6
17,21,Christian,2001,17041,16134,907,5.3
17,23,Clark,2001,8784,8280,504,5.7
17,25,Clay,2001,6980,6522,458,6.6
17,27,Clinton,2001,18203,17417,786,4.3
17,29,Coles,2001,27927,26570,1357,4.9
17,31,Cook,2001,2713801,2546175,167626,6.2
17,33,Crawford,2001,9625,9049,576,6.0
17,35,Cumberland,2001,5858,5510,348,5.9
17,37,DeKalb,2001,51352,49074,2278,4.4
17,39,De Witt,2001,8745,8306,439,5.0
17,41,Douglas,2001,10509,10061,448,4.3
17,43,DuPage,2001,530308,506616,23692,4.5
17,45,Edgar,2001,9892,9393,499,5.0
17,47,Edwards,2001,3571,3396,175,4.9
17,49,Effingham,2001,17863,17006,857,4.8
17,51,Fayette,2001,10059,9405,654,6.5
17,53,Ford,2001,7342,7017,325,4.4
17,55,Franklin,2001,17072,15761,1311,7.7
17,57,Fulton,2001,17403,16354,1049,6.0
17,59,Gallatin,2001,2746,2582,164,6.0
17,61,Greene,2001,6938,6554,384,5.5
17,63,Grundy,2001,21218,19912,1306,6.2
17,65,Hamilton,2001,4012,3784,228,5.7
17,67,Hancock,2001,10750,10114,636,5.9
17,69,Hardin,2001,1917,1785,132,6.9
17,71,Henderson,2001,4236,4035,201,4.7
17,73,Henry,2001,26784,25428,1356,5.1
17,75,Iroquois,2001,16332,15451,881,5.4
17,77,Jackson,2001,30571,29268,1303,4.3
17,79,Jasper,2001,5335,5052,283,5.3
17,81,Jefferson,2001,19413,18309,1104,5.7
17,83,Jersey,2001,11044,10490,554,5.0
17,85,Jo Daviess,2001,12780,12142,638,5.0
17,87,Johnson,2001,4944,4659,285,5.8
17,89,Kane,2001,228646,216760,11886,5.2
17,91,Kankakee,2001,52028,49345,2683,5.2
17,93,Kendall,2001,33748,32282,1466,4.3
17,95,Knox,2001,27167,25647,1520,5.6
17,97,Lake,2001,337428,322976,14452,4.3
17,99,LaSalle,2001,55998,52756,3242,5.8
17,101,Lawrence,2001,8112,7665,447,5.5
17,103,Lee,2001,17565,16708,857,4.9
17,105,Livingston,2001,19405,18556,849,4.4
17,107,Logan,2001,14466,13840,626,4.3
17,109,McDonough,2001,16558,15818,740,4.5
17,111,McHenry,2001,155069,147673,7396,4.8
17,113,McLean,2001,85930,83122,2808,3.3
17,115,Macon,2001,53901,50613,3288,6.1
17,117,Macoupin,2001,24160,22900,1260,5.2
17,119,Madison,2001,131833,125421,6412,4.9
17,121,Marion,2001,19955,18296,1659,8.3
17,123,Marshall,2001,6876,6544,332,4.8
17,125,Mason,2001,7990,7494,496,6.2
17,127,Massac,2001,7155,6776,379,5.3
17,129,Menard,2001,6985,6704,281,4.0
17,131,Mercer,2001,8691,8212,479,5.5
17,133,Monroe,2001,15637,15053,584,3.7
17,135,Montgomery,2001,13808,12953,855,6.2
17,137,Morgan,2001,18139,17320,819,4.5
17,139,Moultrie,2001,7437,7093,344,4.6
17,141,Ogle,2001,26131,24799,1332,5.1
17,143,Peoria,2001,90217,85717,4500,5.0
17,145,Perry,2001,10324,9660,664,6.4
17,147,Piatt,2001,9018,8674,344,3.8
17,149,Pike,2001,8555,8080,475,5.6
17,151,Pope,2001,1992,1858,134,6.7
17,153,Pulaski,2001,3030,2798,232,7.7
17,155,Putnam,2001,3109,2932,177,5.7
17,157,Randolph,2001,15464,14682,782,5.1
17,159,Richland,2001,7539,7078,461,6.1
17,161,Rock Island,2001,76312,72788,3524,4.6
17,163,St. Clair,2001,117918,111704,6214,5.3
17,165,Saline,2001,11521,10794,727,6.3
17,167,Sangamon,2001,104824,100750,4074,3.9
17,169,Schuyler,2001,4131,3950,181,4.4
17,171,Scott,2001,2880,2735,145,5.0
17,173,Shelby,2001,11625,10986,639,5.5
17,175,Stark,2001,2878,2682,196,6.8
17,177,Stephenson,2001,25549,24081,1468,5.7
17,179,Tazewell,2001,66640,63593,3047,4.6
17,181,Union,2001,8174,7694,480,5.9
17,183,Vermilion,2001,37840,35355,2485,6.6
17,185,Wabash,2001,6851,6491,360,5.3
17,187,Warren,2001,9688,9238,450,4.6
17,189,Washington,2001,8601,8247,354,4.1
17,191,Wayne,2001,8442,7960,482,5.7
17,193,White,2001,7686,7298,388,5.0
17,195,Whiteside,2001,30383,28504,1879,6.2
17,197,Will,2001,289939,275028,14911,5.1
17,199,Williamson,2001,29824,28146,1678,5.6
17,201,Winnebago,2001,143365,135013,8352,5.8
17,203,Woodford,2001,18668,18004,664,3.6
18,1,Adams,2001,15678,14902,776,4.9
18,3,Allen,2001,175312,168035,7277,4.2
18,5,Bartholomew,2001,36398,34914,1484,4.1
18,7,Benton,2001,4831,4663,168,3.5
18,9,Blackford,2001,7077,6681,396,5.6
18,11,Boone,2001,24746,24048,698,2.8
18,13,Brown,2001,8005,7688,317,4.0
18,15,Carroll,2001,10731,10272,459,4.3
18,17,Cass,2001,20500,19483,1017,5.0
18,19,Clark,2001,52172,49856,2316,4.4
18,21,Clay,2001,12975,12259,716,5.5
18,23,Clinton,2001,16570,15898,672,4.1
18,25,Crawford,2001,5246,4955,291,5.5
18,27,Daviess,2001,13915,13380,535,3.8
18,29,Dearborn,2001,24668,23706,962,3.9
18,31,Decatur,2001,13012,12591,421,3.2
18,33,DeKalb,2001,21522,20451,1071,5.0
18,35,Delaware,2001,59556,56676,2880,4.8
18,37,Dubois,2001,22124,21474,650,2.9
18,39,Elkhart,2001,95433,90954,4479,4.7
18,41,Fayette,2001,12149,11319,830,6.8
18,43,Floyd,2001,37837,36303,1534,4.1
18,45,Fountain,2001,8607,8214,393,4.6
18,47,Franklin,2001,11367,10860,507,4.5
18,49,Fulton,2001,10436,9831,605,5.8
18,51,Gibson,2001,17068,16385,683,4.0
18,53,Grant,2001,34880,32795,2085,6.0
18,55,Greene,2001,16327,15380,947,5.8
18,57,Hamilton,2001,107363,104726,2637,2.5
18,59,Hancock,2001,31090,30165,925,3.0
18,61,Harrison,2001,18688,17911,777,4.2
18,63,Hendricks,2001,60142,58528,1614,2.7
18,65,Henry,2001,23292,22077,1215,5.2
18,67,Howard,2001,41214,38854,2360,5.7
18,69,Huntington,2001,20631,19695,936,4.5
18,71,Jackson,2001,21949,21038,911,4.2
18,73,Jasper,2001,14942,14222,720,4.8
18,75,Jay,2001,11010,10386,624,5.7
18,77,Jefferson,2001,16282,15585,697,4.3
18,79,Jennings,2001,14047,13375,672,4.8
18,81,Johnson,2001,64912,63099,1813,2.8
18,83,Knox,2001,19448,18715,733,3.8
18,85,Kosciusko,2001,38664,37041,1623,4.2
18,87,LaGrange,2001,16514,15719,795,4.8
18,89,Lake,2001,227161,215961,11200,4.9
18,91,LaPorte,2001,53982,51349,2633,4.9
18,93,Lawrence,2001,23152,21553,1599,6.9
18,95,Madison,2001,63894,60979,2915,4.6
18,97,Marion,2001,459964,442457,17507,3.8
18,99,Marshall,2001,22598,21624,974,4.3
18,101,Martin,2001,5132,4891,241,4.7
18,103,Miami,2001,17537,16614,923,5.3
18,105,Monroe,2001,64748,62307,2441,3.8
18,107,Montgomery,2001,19552,18820,732,3.7
18,109,Morgan,2001,35926,34724,1202,3.3
18,111,Newton,2001,7234,6922,312,4.3
18,113,Noble,2001,23961,22616,1345,5.6
18,115,Ohio,2001,2984,2873,111,3.7
18,117,Orange,2001,9501,8842,659,6.9
18,119,Owen,2001,11113,10604,509,4.6
18,121,Parke,2001,8052,7681,371,4.6
18,123,Perry,2001,9181,8692,489,5.3
18,125,Pike,2001,6310,6064,246,3.9
18,127,Porter,2001,78631,75608,3023,3.8
18,129,Posey,2001,13969,13484,485,3.5
18,131,Pulaski,2001,6783,6462,321,4.7
18,133,Putnam,2001,17296,16643,653,3.8
18,135,Randolph,2001,13766,13033,733,5.3
18,137,Ripley,2001,14001,13513,488,3.5
18,139,Rush,2001,9653,9297,356,3.7
18,141,St. Joseph,2001,133055,126957,6098,4.6
18,143,Scott,2001,11128,10568,560,5.0
18,145,Shelby,2001,23888,23005,883,3.7
18,147,Spencer,2001,10528,10059,469,4.5
18,149,Starke,2001,10686,10052,634,5.9
18,151,Steuben,2001,17515,16586,929,5.3
18,153,Sullivan,2001,9213,8706,507,5.5
18,155,Switzerland,2001,5979,5783,196,3.3
18,157,Tippecanoe,2001,78852,76097,2755,3.5
18,159,Tipton,2001,8567,8147,420,4.9
18,161,Union,2001,3768,3599,169,4.5
18,163,Vanderburgh,2001,91110,87589,3521,3.9
18,165,Vermillion,2001,8076,7646,430,5.3
18,167,Vigo,2001,50551,47978,2573,5.1
18,169,Wabash,2001,18046,17116,930,5.2
18,171,Warren,2001,4558,4408,150,3.3
18,173,Warrick,2001,28934,27927,1007,3.5
18,175,Washington,2001,14107,13336,771,5.5
18,177,Wayne,2001,34650,32852,1798,5.2
18,179,Wells,2001,14783,14203,580,3.9
18,181,White,2001,13367,12722,645,4.8
18,183,Whitley,2001,17221,16439,782,4.5
19,1,Adair,2001,4551,4426,125,2.7
19,3,Adams,2001,2289,2192,97,4.2
19,5,Allamakee,2001,8446,8108,338,4.0
19,7,Appanoose,2001,6472,6137,335,5.2
19,9,Audubon,2001,3533,3419,114,3.2
19,11,Benton,2001,13934,13502,432,3.1
19,13,Black Hawk,2001,69159,66785,2374,3.4
19,15,Boone,2001,14907,14494,413,2.8
19,17,Bremer,2001,13028,12624,404,3.1
19,19,Buchanan,2001,10810,10388,422,3.9
19,21,Buena Vista,2001,10605,10323,282,2.7
19,23,Butler,2001,8243,7883,360,4.4
19,25,Calhoun,2001,5320,5145,175,3.3
19,27,Carroll,2001,12289,11976,313,2.5
19,29,Cass,2001,7884,7572,312,4.0
19,31,Cedar,2001,10661,10359,302,2.8
19,33,Cerro Gordo,2001,24999,24138,861,3.4
19,35,Cherokee,2001,7211,6998,213,3.0
19,37,Chickasaw,2001,6705,6287,418,6.2
19,39,Clarke,2001,4980,4778,202,4.1
19,41,Clay,2001,9763,9457,306,3.1
19,43,Clayton,2001,10393,9911,482,4.6
19,45,Clinton,2001,26378,25204,1174,4.5
19,47,Crawford,2001,8981,8703,278,3.1
19,49,Dallas,2001,24537,23960,577,2.4
19,51,Davis,2001,4326,4150,176,4.1
19,53,Decatur,2001,4447,4296,151,3.4
19,55,Delaware,2001,10621,10238,383,3.6
19,57,Des Moines,2001,22136,21030,1106,5.0
19,59,Dickinson,2001,9474,9162,312,3.3
19,61,Dubuque,2001,47895,45913,1982,4.1
19,63,Emmet,2001,5730,5510,220,3.8
19,65,Fayette,2001,11532,10985,547,4.7
19,67,Floyd,2001,8623,8256,367,4.3
19,69,Franklin,2001,5944,5744,200,3.4
19,71,Fremont,2001,4653,4529,124,2.7
19,73,Greene,2001,4985,4795,190,3.8
19,75,Grundy,2001,6548,6371,177,2.7
19,77,Guthrie,2001,6030,5848,182,3.0
19,79,Hamilton,2001,8761,8487,274,3.1
19,81,Hancock,2001,6345,6181,164,2.6
19,83,Hardin,2001,9855,9508,347,3.5
19,85,Harrison,2001,8062,7770,292,3.6
19,87,Henry,2001,10424,10010,414,4.0
19,89,Howard,2001,5285,5110,175,3.3
19,91,Humboldt,2001,5341,5164,177,3.3
19,93,Ida,2001,4105,3995,110,2.7
19,95,Iowa,2001,8918,8704,214,2.4
19,97,Jackson,2001,11320,10785,535,4.7
19,99,Jasper,2001,20203,19573,630,3.1
19,101,Jefferson,2001,8824,8382,442,5.0
19,103,Johnson,2001,68745,67247,1498,2.2
19,105,Jones,2001,10469,10075,394,3.8
19,107,Keokuk,2001,6073,5830,243,4.0
19,109,Kossuth,2001,9123,8859,264,2.9
19,111,Lee,2001,18351,17165,1186,6.5
19,113,Linn,2001,112423,108895,3528,3.1
19,115,Louisa,2001,6289,6071,218,3.5
19,117,Lucas,2001,4881,4713,168,3.4
19,119,Lyon,2001,6583,6427,156,2.4
19,121,Madison,2001,7687,7426,261,3.4
19,123,Mahaska,2001,11772,11363,409,3.5
19,125,Marion,2001,17713,17125,588,3.3
19,127,Marshall,2001,20861,20194,667,3.2
19,129,Mills,2001,7881,7656,225,2.9
19,131,Mitchell,2001,5668,5502,166,2.9
19,133,Monona,2001,5098,4912,186,3.6
19,135,Monroe,2001,3832,3665,167,4.4
19,137,Montgomery,2001,6086,5802,284,4.7
19,139,Muscatine,2001,22482,21682,800,3.6
19,141,O'Brien,2001,7934,7728,206,2.6
19,143,Osceola,2001,3691,3576,115,3.1
19,145,Page,2001,7702,7314,388,5.0
19,147,Palo Alto,2001,5328,5130,198,3.7
19,149,Plymouth,2001,13856,13456,400,2.9
19,151,Pocahontas,2001,4397,4245,152,3.5
19,153,Polk,2001,218165,211837,6328,2.9
19,155,Pottawattamie,2001,47765,46278,1487,3.1
19,157,Poweshiek,2001,10679,10335,344,3.2
19,159,Ringgold,2001,2677,2593,84,3.1
19,161,Sac,2001,6129,5949,180,2.9
19,163,Scott,2001,85372,81964,3408,4.0
19,165,Shelby,2001,7336,7140,196,2.7
19,167,Sioux,2001,18143,17714,429,2.4
19,169,Story,2001,46337,45364,973,2.1
19,171,Tama,2001,9461,9126,335,3.5
19,173,Taylor,2001,3436,3295,141,4.1
19,175,Union,2001,6633,6385,248,3.7
19,177,Van Buren,2001,4002,3829,173,4.3
19,179,Wapello,2001,18194,17357,837,4.6
19,181,Warren,2001,23742,23127,615,2.6
19,183,Washington,2001,11612,11288,324,2.8
19,185,Wayne,2001,3344,3227,117,3.5
19,187,Webster,2001,20042,19312,730,3.6
19,189,Winnebago,2001,6520,6345,175,2.7
19,191,Winneshiek,2001,12551,12186,365,2.9
19,193,Woodbury,2001,55209,53452,1757,3.2
19,195,Worth,2001,4330,4185,145,3.3
19,197,Wright,2001,7569,7316,253,3.3
20,1,Allen,2001,7272,6828,444,6.1
20,3,Anderson,2001,4075,3860,215,5.3
20,5,Atchison,2001,8093,7677,416,5.1
20,7,Barber,2001,2533,2447,86,3.4
20,9,Barton,2001,14168,13709,459,3.2
20,11,Bourbon,2001,8814,8473,341,3.9
20,13,Brown,2001,5202,4918,284,5.5
20,15,Butler,2001,30631,29412,1219,4.0
20,17,Chase,2001,1559,1501,58,3.7
20,19,Chautauqua,2001,1894,1799,95,5.0
20,21,Cherokee,2001,10594,9986,608,5.7
20,23,Cheyenne,2001,1504,1458,46,3.1
20,25,Clark,2001,1172,1141,31,2.6
20,27,Clay,2001,4477,4292,185,4.1
20,29,Cloud,2001,5210,5018,192,3.7
20,31,Coffey,2001,4624,4385,239,5.2
20,33,Comanche,2001,1009,982,27,2.7
20,35,Cowley,2001,17877,17117,760,4.3
20,37,Crawford,2001,18870,17909,961,5.1
20,39,Decatur,2001,1807,1756,51,2.8
20,41,Dickinson,2001,9919,9524,395,4.0
20,43,Doniphan,2001,4261,3932,329,7.7
20,45,Douglas,2001,58881,56960,1921,3.3
20,47,Edwards,2001,1675,1627,48,2.9
20,49,Elk,2001,1472,1394,78,5.3
20,51,Ellis,2001,15481,15031,450,2.9
20,53,Ellsworth,2001,3119,3011,108,3.5
20,55,Finney,2001,18637,17304,1333,7.2
20,57,Ford,2001,15569,15079,490,3.1
20,59,Franklin,2001,13190,12549,641,4.9
20,61,Geary,2001,11059,10443,616,5.6
20,63,Gove,2001,1515,1475,40,2.6
20,65,Graham,2001,1373,1328,45,3.3
20,67,Grant,2001,3707,3601,106,2.9
20,69,Gray,2001,3022,2943,79,2.6
20,71,Greeley,2001,791,764,27,3.4
20,73,Greenwood,2001,3556,3373,183,5.1
20,75,Hamilton,2001,1261,1224,37,2.9
20,77,Harper,2001,3094,2980,114,3.7
20,79,Harvey,2001,17570,16961,609,3.5
20,81,Haskell,2001,2047,1989,58,2.8
20,83,Hodgeman,2001,939,908,31,3.3
20,85,Jackson,2001,6676,6380,296,4.4
20,87,Jefferson,2001,9830,9425,405,4.1
20,89,Jewell,2001,1826,1773,53,2.9
20,91,Johnson,2001,264035,253986,10049,3.8
20,93,Kearny,2001,1923,1860,63,3.3
20,95,Kingman,2001,4170,4018,152,3.6
20,97,Kiowa,2001,1497,1449,48,3.2
20,99,Labette,2001,10783,10188,595,5.5
20,101,Lane,2001,1117,1077,40,3.6
20,103,Leavenworth,2001,31300,29688,1612,5.2
20,105,Lincoln,2001,1795,1730,65,3.6
20,107,Linn,2001,4729,4441,288,6.1
20,109,Logan,2001,1545,1497,48,3.1
20,111,Lyon,2001,18656,17889,767,4.1
20,113,McPherson,2001,15110,14563,547,3.6
20,115,Marion,2001,6591,6360,231,3.5
20,117,Marshall,2001,5514,5303,211,3.8
20,119,Meade,2001,2117,2055,62,2.9
20,121,Miami,2001,15215,14571,644,4.2
20,123,Mitchell,2001,3281,3162,119,3.6
20,125,Montgomery,2001,16292,15229,1063,6.5
20,127,Morris,2001,2930,2807,123,4.2
20,129,Morton,2001,1673,1626,47,2.8
20,131,Nemaha,2001,4953,4775,178,3.6
20,133,Neosho,2001,8324,7874,450,5.4
20,135,Ness,2001,1726,1677,49,2.8
20,137,Norton,2001,2547,2455,92,3.6
20,139,Osage,2001,8820,8401,419,4.8
20,141,Osborne,2001,2277,2196,81,3.6
20,143,Ottawa,2001,3305,3182,123,3.7
20,145,Pawnee,2001,3459,3354,105,3.0
20,147,Phillips,2001,3031,2940,91,3.0
20,149,Pottawatomie,2001,9338,8972,366,3.9
20,151,Pratt,2001,5015,4871,144,2.9
20,153,Rawlins,2001,1357,1311,46,3.4
20,155,Reno,2001,32003,30556,1447,4.5
20,157,Republic,2001,2889,2790,99,3.4
20,159,Rice,2001,5162,4968,194,3.8
20,161,Riley,2001,30307,29316,991,3.3
20,163,Rooks,2001,2686,2592,94,3.5
20,165,Rush,2001,1675,1615,60,3.6
20,167,Russell,2001,3263,3097,166,5.1
20,169,Saline,2001,29653,28545,1108,3.7
20,171,Scott,2001,2930,2858,72,2.5
20,173,Sedgwick,2001,238784,228946,9838,4.1
20,175,Seward,2001,10201,9822,379,3.7
20,177,Shawnee,2001,91666,87825,3841,4.2
20,179,Sheridan,2001,1450,1413,37,2.6
20,181,Sherman,2001,3747,3631,116,3.1
20,183,Smith,2001,2141,2069,72,3.4
20,185,Stafford,2001,2222,2148,74,3.3
20,187,Stanton,2001,1224,1193,31,2.5
20,189,Stevens,2001,2296,2214,82,3.6
20,191,Sumner,2001,12645,12116,529,4.2
20,193,Thomas,2001,4258,4136,122,2.9
20,195,Trego,2001,1634,1585,49,3.0
20,197,Wabaunsee,2001,3709,3576,133,3.6
20,199,Wallace,2001,913,887,26,2.8
20,201,Washington,2001,3321,3198,123,3.7
20,203,Wichita,2001,1203,1164,39,3.2
20,205,Wilson,2001,4783,4502,281,5.9
20,207,Woodson,2001,1696,1589,107,6.3
20,209,Wyandotte,2001,73785,68270,5515,7.5
21,1,Adair,2001,8710,8293,417,4.8
21,3,Allen,2001,8706,8180,526,6.0
21,5,Anderson,2001,10308,9790,518,5.0
21,7,Ballard,2001,4169,3891,278,6.7
21,9,Barren,2001,19328,18359,969,5.0
21,11,Bath,2001,5036,4662,374,7.4
21,13,Bell,2001,9803,8987,816,8.3
21,15,Boone,2001,50173,48214,1959,3.9
21,17,Bourbon,2001,9925,9468,457,4.6
21,19,Boyd,2001,21475,20083,1392,6.5
21,21,Boyle,2001,13537,12798,739,5.5
21,23,Bracken,2001,4179,3979,200,4.8
21,25,Breathitt,2001,5387,4975,412,7.6
21,27,Breckinridge,2001,8755,8203,552,6.3
21,29,Bullitt,2001,33177,31772,1405,4.2
21,31,Butler,2001,6716,6347,369,5.5
21,33,Caldwell,2001,6262,5940,322,5.1
21,35,Calloway,2001,17280,16377,903,5.2
21,37,Campbell,2001,45961,43941,2020,4.4
21,39,Carlisle,2001,2423,2266,157,6.5
21,41,Carroll,2001,5234,4933,301,5.8
21,43,Carter,2001,12482,11196,1286,10.3
21,45,Casey,2001,7200,6710,490,6.8
21,47,Christian,2001,26428,24653,1775,6.7
21,49,Clark,2001,16946,16045,901,5.3
21,51,Clay,2001,7305,6759,546,7.5
21,53,Clinton,2001,4677,4388,289,6.2
21,55,Crittenden,2001,4397,4063,334,7.6
21,57,Cumberland,2001,3250,3064,186,5.7
21,59,Daviess,2001,46249,43910,2339,5.1
21,61,Edmonson,2001,5015,4710,305,6.1
21,63,Elliott,2001,2550,2326,224,8.8
21,65,Estill,2001,6071,5691,380,6.3
21,67,Fayette,2001,147454,141948,5506,3.7
21,69,Fleming,2001,6674,6340,334,5.0
21,71,Floyd,2001,13904,12975,929,6.7
21,73,Franklin,2001,25096,24160,936,3.7
21,75,Fulton,2001,3201,2996,205,6.4
21,77,Gallatin,2001,3881,3700,181,4.7
21,79,Garrard,2001,7548,7188,360,4.8
21,81,Grant,2001,11732,11138,594,5.1
21,83,Graves,2001,17079,15954,1125,6.6
21,85,Grayson,2001,11516,10651,865,7.5
21,87,Green,2001,5552,5252,300,5.4
21,89,Greenup,2001,15862,14866,996,6.3
21,91,Hancock,2001,4135,3891,244,5.9
21,93,Hardin,2001,43077,40872,2205,5.1
21,95,Harlan,2001,9964,9192,772,7.7
21,97,Harrison,2001,9248,8770,478,5.2
21,99,Hart,2001,7742,7322,420,5.4
21,101,Henderson,2001,23047,21960,1087,4.7
21,103,Henry,2001,7667,7333,334,4.4
21,105,Hickman,2001,2412,2271,141,5.8
21,107,Hopkins,2001,21048,19828,1220,5.8
21,109,Jackson,2001,4885,4486,399,8.2
21,111,Jefferson,2001,354550,337879,16671,4.7
21,113,Jessamine,2001,20610,19822,788,3.8
21,115,Johnson,2001,9247,8683,564,6.1
21,117,Kenton,2001,82008,78504,3504,4.3
21,119,Knott,2001,5646,5261,385,6.8
21,121,Knox,2001,11192,10473,719,6.4
21,123,Larue,2001,6352,6039,313,4.9
21,125,Laurel,2001,25002,23750,1252,5.0
21,127,Lawrence,2001,5537,5080,457,8.3
21,129,Lee,2001,2517,2337,180,7.2
21,131,Leslie,2001,3871,3634,237,6.1
21,133,Letcher,2001,8828,8274,554,6.3
21,135,Lewis,2001,5571,5125,446,8.0
21,137,Lincoln,2001,11105,10428,677,6.1
21,139,Livingston,2001,4949,4631,318,6.4
21,141,Logan,2001,13202,12323,879,6.7
21,143,Lyon,2001,3291,3090,201,6.1
21,145,McCracken,2001,31427,29794,1633,5.2
21,147,McCreary,2001,6356,5749,607,9.6
21,149,McLean,2001,4651,4378,273,5.9
21,151,Madison,2001,37530,35754,1776,4.7
21,153,Magoffin,2001,4480,4032,448,10.0
21,155,Marion,2001,8759,8253,506,5.8
21,157,Marshall,2001,14821,13866,955,6.4
21,159,Martin,2001,3703,3457,246,6.6
21,161,Mason,2001,8467,8072,395,4.7
21,163,Meade,2001,11628,11028,600,5.2
21,165,Menifee,2001,2642,2435,207,7.8
21,167,Mercer,2001,10711,10164,547,5.1
21,169,Metcalfe,2001,4587,4349,238,5.2
21,171,Monroe,2001,5189,4727,462,8.9
21,173,Montgomery,2001,11452,10741,711,6.2
21,175,Morgan,2001,5220,4787,433,8.3
21,177,Muhlenberg,2001,13000,11924,1076,8.3
21,179,Nelson,2001,19515,18504,1011,5.2
21,181,Nicholas,2001,3218,3021,197,6.1
21,183,Ohio,2001,10635,9988,647,6.1
21,185,Oldham,2001,23879,23041,838,3.5
21,187,Owen,2001,5034,4818,216,4.3
21,189,Owsley,2001,1577,1469,108,6.8
21,191,Pendleton,2001,7148,6820,328,4.6
21,193,Perry,2001,10312,9622,690,6.7
21,195,Pike,2001,25111,23686,1425,5.7
21,197,Powell,2001,5887,5471,416,7.1
21,199,Pulaski,2001,26553,24786,1767,6.7
21,201,Robertson,2001,1094,1041,53,4.8
21,203,Rockcastle,2001,7103,6645,458,6.4
21,205,Rowan,2001,11083,10423,660,6.0
21,207,Russell,2001,7742,7257,485,6.3
21,209,Scott,2001,18572,17838,734,4.0
21,211,Shelby,2001,18300,17513,787,4.3
21,213,Simpson,2001,8549,8083,466,5.5
21,215,Spencer,2001,6824,6543,281,4.1
21,217,Taylor,2001,11740,11141,599,5.1
21,219,Todd,2001,5895,5511,384,6.5
21,221,Trigg,2001,5939,5598,341,5.7
21,223,Trimble,2001,4149,3925,224,5.4
21,225,Union,2001,7387,6976,411,5.6
21,227,Warren,2001,49912,47531,2381,4.8
21,229,Washington,2001,5376,5057,319,5.9
21,231,Wayne,2001,8399,7783,616,7.3
21,233,Webster,2001,6692,6382,310,4.6
21,235,Whitley,2001,14542,13668,874,6.0
21,237,Wolfe,2001,2461,2244,217,8.8
21,239,Woodford,2001,13275,12754,521,3.9
22,1,Acadia Parish,2001,23697,22310,1387,5.9
22,3,Allen Parish,2001,8618,7988,630,7.3
22,5,Ascension Parish,2001,38733,36626,2107,5.4
22,7,Assumption Parish,2001,10384,9770,614,5.9
22,9,Avoyelles Parish,2001,15761,14632,1129,7.2
22,11,Beauregard Parish,2001,13970,13107,863,6.2
22,13,Bienville Parish,2001,5907,5426,481,8.1
22,15,Bossier Parish,2001,47212,44776,2436,5.2
22,17,Caddo Parish,2001,114098,107409,6689,5.9
22,19,Calcasieu Parish,2001,85859,81084,4775,5.6
22,21,Caldwell Parish,2001,4335,4005,330,7.6
22,23,Cameron Parish,2001,4456,4228,228,5.1
22,25,Catahoula Parish,2001,4079,3705,374,9.2
22,27,Claiborne Parish,2001,6738,6283,455,6.8
22,29,Concordia Parish,2001,7550,6836,714,9.5
22,31,De Soto Parish,2001,10747,10019,728,6.8
22,33,East Baton Rouge Parish,2001,202875,192462,10413,5.1
22,35,East Carroll Parish,2001,3106,2742,364,11.7
22,37,East Feliciana Parish,2001,8098,7590,508,6.3
22,39,Evangeline Parish,2001,11946,11158,788,6.6
22,41,Franklin Parish,2001,8108,7416,692,8.5
22,43,Grant Parish,2001,7896,7373,523,6.6
22,45,Iberia Parish,2001,30854,29142,1712,5.5
22,47,Iberville Parish,2001,12379,11475,904,7.3
22,49,Jackson Parish,2001,6653,6217,436,6.6
22,51,Jefferson Parish,2001,227806,217126,10680,4.7
22,53,Jefferson Davis Parish,2001,12835,12089,746,5.8
22,55,Lafayette Parish,2001,99530,95432,4098,4.1
22,57,Lafourche Parish,2001,42154,40293,1861,4.4
22,59,LaSalle Parish,2001,5951,5572,379,6.4
22,61,Lincoln Parish,2001,18680,17553,1127,6.0
22,63,Livingston Parish,2001,45202,42713,2489,5.5
22,65,Madison Parish,2001,5081,4602,479,9.4
22,67,Morehouse Parish,2001,12619,11573,1046,8.3
22,69,Natchitoches Parish,2001,16873,15767,1106,6.6
22,71,Orleans Parish,2001,206146,194410,11736,5.7
22,73,Ouachita Parish,2001,70885,67122,3763,5.3
22,75,Plaquemines Parish,2001,10995,10393,602,5.5
22,77,Pointe Coupee Parish,2001,9530,8889,641,6.7
22,79,Rapides Parish,2001,55611,52359,3252,5.8
22,81,Red River Parish,2001,3589,3307,282,7.9
22,83,Richland Parish,2001,8581,7946,635,7.4
22,85,Sabine Parish,2001,9288,8711,577,6.2
22,87,St. Bernard Parish,2001,31626,29857,1769,5.6
22,89,St. Charles Parish,2001,23710,22451,1259,5.3
22,91,St. Helena Parish,2001,3964,3716,248,6.3
22,93,St. James Parish,2001,8765,7974,791,9.0
22,95,St. John the Baptist Parish,2001,20014,18674,1340,6.7
22,97,St. Landry Parish,2001,32856,30639,2217,6.7
22,99,St. Martin Parish,2001,22128,20740,1388,6.3
22,101,St. Mary Parish,2001,22610,21050,1560,6.9
22,103,St. Tammany Parish,2001,97346,92908,4438,4.6
22,105,Tangipahoa Parish,2001,45815,42737,3078,6.7
22,107,Tensas Parish,2001,2251,2059,192,8.5
22,109,Terrebonne Parish,2001,47142,44981,2161,4.6
22,111,Union Parish,2001,10408,9798,610,5.9
22,113,Vermilion Parish,2001,23572,22280,1292,5.5
22,115,Vernon Parish,2001,18486,17298,1188,6.4
22,117,Washington Parish,2001,17050,15851,1199,7.0
22,119,Webster Parish,2001,18355,17064,1291,7.0
22,121,West Baton Rouge Parish,2001,10016,9463,553,5.5
22,123,West Carroll Parish,2001,4865,4341,524,10.8
22,125,West Feliciana Parish,2001,4741,4396,345,7.3
22,127,Winn Parish,2001,6092,5646,446,7.3
23,1,Androscoggin,2001,55148,52999,2149,3.9
23,3,Aroostook,2001,34078,32560,1518,4.5
23,5,Cumberland,2001,149600,145461,4139,2.8
23,7,Franklin,2001,14121,13383,738,5.2
23,9,Hancock,2001,28731,27566,1165,4.1
23,11,Kennebec,2001,60797,58519,2278,3.7
23,13,Knox,2001,20977,20342,635,3.0
23,15,Lincoln,2001,17664,17083,581,3.3
23,17,Oxford,2001,27554,26288,1266,4.6
23,19,Penobscot,2001,75829,72767,3062,4.0
23,21,Piscataquis,2001,7892,7453,439,5.6
23,23,Sagadahoc,2001,18471,17903,568,3.1
23,25,Somerset,2001,24638,23181,1457,5.9
23,27,Waldo,2001,19433,18618,815,4.2
23,29,Washington,2001,15404,14386,1018,6.6
23,31,York,2001,104627,101128,3499,3.3
24,1,Allegany,2001,33122,30951,2171,6.6
24,3,Anne Arundel,2001,270715,261010,9705,3.6
24,5,Baltimore,2001,412080,394321,17759,4.3
24,9,Calvert,2001,41118,39753,1365,3.3
24,11,Caroline,2001,15506,14762,744,4.8
24,13,Carroll,2001,85524,82674,2850,3.3
24,15,Cecil,2001,46265,44384,1881,4.1
24,17,Charles,2001,66188,64003,2185,3.3
24,19,Dorchester,2001,16037,14988,1049,6.5
24,21,Frederick,2001,111805,108130,3675,3.3
24,23,Garrett,2001,14928,14101,827,5.5
24,25,Harford,2001,121721,117040,4681,3.8
24,27,Howard,2001,148152,143489,4663,3.1
24,29,Kent,2001,10385,9944,441,4.2
24,31,Montgomery,2001,491683,475953,15730,3.2
24,33,Prince George's,2001,432168,413286,18882,4.4
24,35,Queen Anne's,2001,23078,22259,819,3.5
24,37,St. Mary's,2001,45544,43957,1587,3.5
24,39,Somerset,2001,10865,10111,754,6.9
24,41,Talbot,2001,18093,17428,665,3.7
24,43,Washington,2001,66984,63905,3079,4.6
24,45,Wicomico,2001,47412,45074,2338,4.9
24,47,Worcester,2001,26988,25159,1829,6.8
24,510,Baltimore city,2001,279925,260764,19161,6.8
25,1,Barnstable,2001,114829,110279,4550,4.0
25,3,Berkshire,2001,70780,68235,2545,3.6
25,5,Bristol,2001,278485,264993,13492,4.8
25,7,Dukes,2001,10106,9804,302,3.0
25,9,Essex,2001,377401,361798,15603,4.1
25,11,Franklin,2001,39039,37809,1230,3.2
25,13,Hampden,2001,220843,211344,9499,4.3
25,15,Hampshire,2001,86096,83713,2383,2.8
25,17,Middlesex,2001,826956,799133,27823,3.4
25,19,Nantucket/town,2001,7085,6966,119,1.7
25,21,Norfolk,2001,358062,346504,11558,3.2
25,23,Plymouth,2001,253288,244251,9037,3.6
25,25,Suffolk,2001,352583,337646,14937,4.2
25,27,Worcester,2001,391332,375880,15452,3.9
26,1,Alcona,2001,4347,3897,450,10.4
26,3,Alger,2001,4448,4164,284,6.4
26,5,Allegan,2001,57869,55314,2555,4.4
26,7,Alpena,2001,15775,14517,1258,8.0
26,9,Antrim,2001,11711,10942,769,6.6
26,11,Arenac,2001,7722,7109,613,7.9
26,13,Baraga,2001,4038,3668,370,9.2
26,15,Barry,2001,30688,29285,1403,4.6
26,17,Bay,2001,56648,53547,3101,5.5
26,19,Benzie,2001,8462,7947,515,6.1
26,21,Berrien,2001,81853,77254,4599,5.6
26,23,Branch,2001,23533,22239,1294,5.5
26,25,Calhoun,2001,71063,67216,3847,5.4
26,27,Cass,2001,27106,25816,1290,4.8
26,29,Charlevoix,2001,13908,13057,851,6.1
26,31,Cheboygan,2001,13074,11796,1278,9.8
26,33,Chippewa,2001,17552,16205,1347,7.7
26,35,Clare,2001,12977,12023,954,7.4
26,37,Clinton,2001,36107,34877,1230,3.4
26,39,Crawford,2001,6782,6395,387,5.7
26,41,Delta,2001,20111,18780,1331,6.6
26,43,Dickinson,2001,14257,13529,728,5.1
26,45,Eaton,2001,58515,56341,2174,3.7
26,47,Emmet,2001,18341,17180,1161,6.3
26,49,Genesee,2001,216956,203496,13460,6.2
26,51,Gladwin,2001,11097,10305,792,7.1
26,53,Gogebic,2001,8023,7434,589,7.3
26,55,Grand Traverse,2001,45923,43690,2233,4.9
26,57,Gratiot,2001,19604,18491,1113,5.7
26,59,Hillsdale,2001,24122,22643,1479,6.1
26,61,Houghton,2001,17135,16072,1063,6.2
26,63,Huron,2001,17468,16161,1307,7.5
26,65,Ingham,2001,155407,149177,6230,4.0
26,67,Ionia,2001,30225,28653,1572,5.2
26,69,Iosco,2001,11150,10088,1062,9.5
26,71,Iron,2001,5772,5388,384,6.7
26,73,Isabella,2001,35436,34020,1416,4.0
26,75,Jackson,2001,80141,75811,4330,5.4
26,77,Kalamazoo,2001,132492,126849,5643,4.3
26,79,Kalkaska,2001,8644,7998,646,7.5
26,81,Kent,2001,322892,307417,15475,4.8
26,83,Keweenaw,2001,1064,977,87,8.2
26,85,Lake,2001,4499,4148,351,7.8
26,87,Lapeer,2001,45667,42853,2814,6.2
26,89,Leelanau,2001,11184,10756,428,3.8
26,91,Lenawee,2001,52424,49554,2870,5.5
26,93,Livingston,2001,90028,86860,3168,3.5
26,95,Luce,2001,2869,2673,196,6.8
26,97,Mackinac,2001,6911,6289,622,9.0
26,99,Macomb,2001,428651,407202,21449,5.0
26,101,Manistee,2001,12106,11307,799,6.6
26,103,Marquette,2001,34650,32697,1953,5.6
26,105,Mason,2001,15525,14052,1473,9.5
26,107,Mecosta,2001,19201,18122,1079,5.6
26,109,Menominee,2001,13436,12675,761,5.7
26,111,Midland,2001,42970,41093,1877,4.4
26,113,Missaukee,2001,6789,6311,478,7.0
26,115,Monroe,2001,77758,74189,3569,4.6
26,117,Montcalm,2001,30427,28507,1920,6.3
26,119,Montmorency,2001,4185,3749,436,10.4
26,121,Muskegon,2001,86110,80760,5350,6.2
26,123,Newaygo,2001,23475,21978,1497,6.4
26,125,Oakland,2001,661894,634603,27291,4.1
26,127,Oceana,2001,13538,12544,994,7.3
26,129,Ogemaw,2001,9748,9008,740,7.6
26,131,Ontonagon,2001,3576,3300,276,7.7
26,133,Osceola,2001,11209,10432,777,6.9
26,135,Oscoda,2001,3898,3547,351,9.0
26,137,Otsego,2001,12415,11661,754,6.1
26,139,Ottawa,2001,135438,129683,5755,4.2
26,141,Presque Isle,2001,6657,6013,644,9.7
26,143,Roscommon,2001,10507,9795,712,6.8
26,145,Saginaw,2001,100211,94272,5939,5.9
26,147,St. Clair,2001,86095,80881,5214,6.1
26,149,St. Joseph,2001,32287,30270,2017,6.2
26,151,Sanilac,2001,22135,20604,1531,6.9
26,153,Schoolcraft,2001,3929,3566,363,9.2
26,155,Shiawassee,2001,36809,34730,2079,5.6
26,157,Tuscola,2001,29260,27283,1977,6.8
26,159,Van Buren,2001,39834,37631,2203,5.5
26,161,Washtenaw,2001,192074,186247,5827,3.0
26,163,Wayne,2001,942915,888695,54220,5.8
26,165,Wexford,2001,15121,13819,1302,8.6
27,1,Aitkin,2001,7335,6871,464,6.3
27,3,Anoka,2001,182182,175765,6417,3.5
27,5,Becker,2001,16280,15429,851,5.2
27,7,Beltrami,2001,20885,19930,955,4.6
27,9,Benton,2001,21286,20370,916,4.3
27,11,Big Stone,2001,2849,2727,122,4.3
27,13,Blue Earth,2001,34462,33438,1024,3.0
27,15,Brown,2001,15574,14945,629,4.0
27,17,Carlton,2001,15951,15042,909,5.7
27,19,Carver,2001,42351,40982,1369,3.2
27,21,Cass,2001,13743,12961,782,5.7
27,23,Chippewa,2001,7438,7077,361,4.9
27,25,Chisago,2001,24119,23038,1081,4.5
27,27,Clay,2001,28384,27447,937,3.3
27,29,Clearwater,2001,4389,3964,425,9.7
27,31,Cook,2001,3221,3072,149,4.6
27,33,Cottonwood,2001,6478,6235,243,3.8
27,35,Crow Wing,2001,29959,28641,1318,4.4
27,37,Dakota,2001,219736,212973,6763,3.1
27,39,Dodge,2001,10491,10134,357,3.4
27,41,Douglas,2001,18699,18024,675,3.6
27,43,Faribault,2001,8536,8173,363,4.3
27,45,Fillmore,2001,12003,11572,431,3.6
27,47,Freeborn,2001,17415,16618,797,4.6
27,49,Goodhue,2001,25779,24909,870,3.4
27,51,Grant,2001,3318,3138,180,5.4
27,53,Hennepin,2001,667654,644557,23097,3.5
27,55,Houston,2001,11135,10651,484,4.3
27,57,Hubbard,2001,9352,8879,473,5.1
27,59,Isanti,2001,18524,17741,783,4.2
27,61,Itasca,2001,22228,20847,1381,6.2
27,63,Jackson,2001,6435,6225,210,3.3
27,65,Kanabec,2001,8046,7537,509,6.3
27,67,Kandiyohi,2001,23243,22422,821,3.5
27,69,Kittson,2001,2650,2513,137,5.2
27,71,Koochiching,2001,7251,6843,408,5.6
27,73,Lac qui Parle,2001,4244,4074,170,4.0
27,75,Lake,2001,6285,5961,324,5.2
27,77,Lake of the Woods,2001,2345,2240,105,4.5
27,79,Le Sueur,2001,15027,14282,745,5.0
27,81,Lincoln,2001,3541,3417,124,3.5
27,83,Lyon,2001,14947,14401,546,3.7
27,85,McLeod,2001,20252,19516,736,3.6
27,87,Mahnomen,2001,2663,2514,149,5.6
27,89,Marshall,2001,5239,4876,363,6.9
27,91,Martin,2001,12009,11542,467,3.9
27,93,Meeker,2001,12591,11986,605,4.8
27,95,Mille Lacs,2001,11962,11320,642,5.4
27,97,Morrison,2001,17175,16258,917,5.3
27,99,Mower,2001,20284,19590,694,3.4
27,101,Murray,2001,5677,5467,210,3.7
27,103,Nicollet,2001,18512,17957,555,3.0
27,105,Nobles,2001,11426,11043,383,3.4
27,107,Norman,2001,3789,3628,161,4.2
27,109,Olmsted,2001,74208,72109,2099,2.8
27,111,Otter Tail,2001,29644,28335,1309,4.4
27,113,Pennington,2001,7878,7482,396,5.0
27,115,Pine,2001,13951,13087,864,6.2
27,117,Pipestone,2001,5573,5386,187,3.4
27,119,Polk,2001,15953,15183,770,4.8
27,121,Pope,2001,6061,5841,220,3.6
27,123,Ramsey,2001,285670,275723,9947,3.5
27,125,Red Lake,2001,2239,2081,158,7.1
27,127,Redwood,2001,8996,8635,361,4.0
27,129,Renville,2001,9257,8794,463,5.0
27,131,Rice,2001,32361,31207,1154,3.6
27,133,Rock,2001,5328,5192,136,2.6
27,135,Roseau,2001,9506,9173,333,3.5
27,137,St. Louis,2001,103452,97545,5907,5.7
27,139,Scott,2001,57953,56027,1926,3.3
27,141,Sherburne,2001,39533,38042,1491,3.8
27,143,Sibley,2001,9015,8667,348,3.9
27,145,Stearns,2001,79690,76683,3007,3.8
27,147,Steele,2001,19678,18931,747,3.8
27,149,Stevens,2001,5766,5570,196,3.4
27,151,Swift,2001,5759,5501,258,4.5
27,153,Todd,2001,12731,12163,568,4.5
27,155,Traverse,2001,1870,1784,86,4.6
27,157,Wabasha,2001,12524,12108,416,3.3
27,159,Wadena,2001,6679,6286,393,5.9
27,161,Waseca,2001,10710,10313,397,3.7
27,163,Washington,2001,120097,116504,3593,3.0
27,165,Watonwan,2001,6122,5910,212,3.5
27,167,Wilkin,2001,3581,3440,141,3.9
27,169,Winona,2001,28873,27815,1058,3.7
27,171,Wright,2001,54147,52091,2056,3.8
27,173,Yellow Medicine,2001,5809,5504,305,5.3
28,1,Adams,2001,14056,13126,930,6.6
28,3,Alcorn,2001,16346,15435,911,5.6
28,5,Amite,2001,5320,5047,273,5.1
28,7,Attala,2001,7997,7432,565,7.1
28,9,Benton,2001,2932,2732,200,6.8
28,11,Bolivar,2001,15870,14760,1110,7.0
28,13,Calhoun,2001,6702,6154,548,8.2
28,15,Carroll,2001,4966,4678,288,5.8
28,17,Chickasaw,2001,8377,7532,845,10.1
28,19,Choctaw,2001,3851,3504,347,9.0
28,21,Claiborne,2001,4137,3812,325,7.9
28,23,Clarke,2001,7500,6811,689,9.2
28,25,Clay,2001,9740,8959,781,8.0
28,27,Coahoma,2001,11502,10663,839,7.3
28,29,Copiah,2001,12311,11608,703,5.7
28,31,Covington,2001,8204,7791,413,5.0
28,33,DeSoto,2001,60857,59155,1702,2.8
28,35,Forrest,2001,34903,33394,1509,4.3
28,37,Franklin,2001,3263,3034,229,7.0
28,39,George,2001,8133,7468,665,8.2
28,41,Greene,2001,4688,4340,348,7.4
28,43,Grenada,2001,10186,9552,634,6.2
28,45,Hancock,2001,19718,18910,808,4.1
28,47,Harrison,2001,90610,86721,3889,4.3
28,49,Hinds,2001,122576,116686,5890,4.8
28,51,Holmes,2001,7181,6287,894,12.4
28,53,Humphreys,2001,4156,3713,443,10.7
28,55,Issaquena,2001,853,755,98,11.5
28,57,Itawamba,2001,10728,10163,565,5.3
28,59,Jackson,2001,60514,57108,3406,5.6
28,61,Jasper,2001,7287,6861,426,5.8
28,63,Jefferson,2001,2970,2621,349,11.8
28,65,Jefferson Davis,2001,5286,4879,407,7.7
28,67,Jones,2001,29050,27749,1301,4.5
28,69,Kemper,2001,4388,4048,340,7.7
28,71,Lafayette,2001,19231,18510,721,3.7
28,73,Lamar,2001,20241,19537,704,3.5
28,75,Lauderdale,2001,33593,31769,1824,5.4
28,77,Lawrence,2001,5472,5066,406,7.4
28,79,Leake,2001,9167,8641,526,5.7
28,81,Lee,2001,38854,36963,1891,4.9
28,83,Leflore,2001,14284,13007,1277,8.9
28,85,Lincoln,2001,14471,13696,775,5.4
28,87,Lowndes,2001,27196,25477,1719,6.3
28,89,Madison,2001,40218,38693,1525,3.8
28,91,Marion,2001,10318,9741,577,5.6
28,93,Marshall,2001,15326,14368,958,6.3
28,95,Monroe,2001,17064,15718,1346,7.9
28,97,Montgomery,2001,5107,4669,438,8.6
28,99,Neshoba,2001,13145,12423,722,5.5
28,101,Newton,2001,9480,8966,514,5.4
28,103,Noxubee,2001,4519,4069,450,10.0
28,105,Oktibbeha,2001,20653,19673,980,4.7
28,107,Panola,2001,14581,13470,1111,7.6
28,109,Pearl River,2001,21296,20365,931,4.4
28,111,Perry,2001,5149,4857,292,5.7
28,113,Pike,2001,15469,14496,973,6.3
28,115,Pontotoc,2001,13380,12670,710,5.3
28,117,Prentiss,2001,12034,11423,611,5.1
28,119,Quitman,2001,3967,3639,328,8.3
28,121,Rankin,2001,65215,63030,2185,3.4
28,123,Scott,2001,12542,11928,614,4.9
28,125,Sharkey,2001,2614,2365,249,9.5
28,127,Simpson,2001,11843,11269,574,4.8
28,129,Smith,2001,7134,6782,352,4.9
28,131,Stone,2001,6750,6431,319,4.7
28,133,Sunflower,2001,10327,9246,1081,10.5
28,135,Tallahatchie,2001,5813,5292,521,9.0
28,137,Tate,2001,11654,11151,503,4.3
28,139,Tippah,2001,9380,8812,568,6.1
28,141,Tishomingo,2001,8547,7917,630,7.4
28,143,Tunica,2001,4072,3831,241,5.9
28,145,Union,2001,12167,11581,586,4.8
28,147,Walthall,2001,6047,5682,365,6.0
28,149,Warren,2001,23621,22519,1102,4.7
28,151,Washington,2001,25041,22785,2256,9.0
28,153,Wayne,2001,8689,8110,579,6.7
28,155,Webster,2001,4347,3957,390,9.0
28,157,Wilkinson,2001,3403,3146,257,7.6
28,159,Winston,2001,8112,7322,790,9.7
28,161,Yalobusha,2001,5589,5234,355,6.4
28,163,Yazoo,2001,10462,9758,704,6.7
29,1,Adair,2001,13776,13197,579,4.2
29,3,Andrew,2001,9100,8710,390,4.3
29,5,Atchison,2001,3570,3453,117,3.3
29,7,Audrain,2001,13140,12584,556,4.2
29,9,Barry,2001,17791,17030,761,4.3
29,11,Barton,2001,6784,6533,251,3.7
29,13,Bates,2001,8110,7726,384,4.7
29,15,Benton,2001,7998,7500,498,6.2
29,17,Bollinger,2001,6287,5924,363,5.8
29,19,Boone,2001,79667,77320,2347,2.9
29,21,Buchanan,2001,43197,41044,2153,5.0
29,23,Butler,2001,20252,19138,1114,5.5
29,25,Caldwell,2001,4427,4230,197,4.4
29,27,Callaway,2001,22356,21512,844,3.8
29,29,Camden,2001,20320,19292,1028,5.1
29,31,Cape Girardeau,2001,39760,38246,1514,3.8
29,33,Carroll,2001,5478,5240,238,4.3
29,35,Carter,2001,2643,2476,167,6.3
29,37,Cass,2001,45519,43819,1700,3.7
29,39,Cedar,2001,6319,6010,309,4.9
29,41,Chariton,2001,4582,4336,246,5.4
29,43,Christian,2001,31812,30553,1259,4.0
29,45,Clark,2001,3546,3336,210,5.9
29,47,Clay,2001,107652,104059,3593,3.3
29,49,Clinton,2001,10034,9649,385,3.8
29,51,Cole,2001,40004,38652,1352,3.4
29,53,Cooper,2001,8461,8063,398,4.7
29,55,Crawford,2001,11565,10970,595,5.1
29,57,Dade,2001,4012,3849,163,4.1
29,59,Dallas,2001,7207,6833,374,5.2
29,61,Daviess,2001,4133,3958,175,4.2
29,63,DeKalb,2001,4996,4755,241,4.8
29,65,Dent,2001,6881,6421,460,6.7
29,67,Douglas,2001,6404,5954,450,7.0
29,69,Dunklin,2001,15249,14317,932,6.1
29,71,Franklin,2001,51560,49076,2484,4.8
29,73,Gasconade,2001,8004,7619,385,4.8
29,75,Gentry,2001,3541,3399,142,4.0
29,77,Greene,2001,132384,127418,4966,3.8
29,79,Grundy,2001,5410,5184,226,4.2
29,81,Harrison,2001,4725,4557,168,3.6
29,83,Henry,2001,11349,10760,589,5.2
29,85,Hickory,2001,3490,3256,234,6.7
29,87,Holt,2001,2813,2699,114,4.1
29,89,Howard,2001,5373,5153,220,4.1
29,91,Howell,2001,19342,18494,848,4.4
29,93,Iron,2001,5114,4778,336,6.6
29,95,Jackson,2001,345828,329360,16468,4.8
29,97,Jasper,2001,54088,51781,2307,4.3
29,99,Jefferson,2001,111800,106899,4901,4.4
29,101,Johnson,2001,24662,23679,983,4.0
29,103,Knox,2001,2336,2235,101,4.3
29,105,Laclede,2001,17040,16095,945,5.5
29,107,Lafayette,2001,17283,16569,714,4.1
29,109,Lawrence,2001,18655,17856,799,4.3
29,111,Lewis,2001,5668,5409,259,4.6
29,113,Lincoln,2001,21518,20542,976,4.5
29,115,Linn,2001,7271,6803,468,6.4
29,117,Livingston,2001,7678,7387,291,3.8
29,119,McDonald,2001,10964,10500,464,4.2
29,121,Macon,2001,8486,7888,598,7.0
29,123,Madison,2001,5702,5356,346,6.1
29,125,Maries,2001,4738,4507,231,4.9
29,127,Marion,2001,15043,14312,731,4.9
29,129,Mercer,2001,2080,2009,71,3.4
29,131,Miller,2001,13008,12304,704,5.4
29,133,Mississippi,2001,6377,5892,485,7.6
29,135,Moniteau,2001,7525,7199,326,4.3
29,137,Monroe,2001,4822,4571,251,5.2
29,139,Montgomery,2001,6500,6189,311,4.8
29,141,Morgan,2001,9729,9158,571,5.9
29,143,New Madrid,2001,9655,9040,615,6.4
29,145,Newton,2001,27466,26105,1361,5.0
29,147,Nodaway,2001,12743,12367,376,3.0
29,149,Oregon,2001,4471,4260,211,4.7
29,151,Osage,2001,7432,7076,356,4.8
29,153,Ozark,2001,4620,4374,246,5.3
29,155,Pemiscot,2001,8442,7830,612,7.2
29,157,Perry,2001,10318,9938,380,3.7
29,159,Pettis,2001,21539,20353,1186,5.5
29,161,Phelps,2001,20534,19690,844,4.1
29,163,Pike,2001,9034,8602,432,4.8
29,165,Platte,2001,45476,44067,1409,3.1
29,167,Polk,2001,13255,12669,586,4.4
29,169,Pulaski,2001,15712,14841,871,5.5
29,171,Putnam,2001,2636,2534,102,3.9
29,173,Ralls,2001,5746,5479,267,4.6
29,175,Randolph,2001,12338,11711,627,5.1
29,177,Ray,2001,11936,11446,490,4.1
29,179,Reynolds,2001,2664,2460,204,7.7
29,181,Ripley,2001,6229,5851,378,6.1
29,183,St. Charles,2001,170966,165051,5915,3.5
29,185,St. Clair,2001,4599,4363,236,5.1
29,186,Ste. Genevieve,2001,9636,9200,436,4.5
29,187,St. Francois,2001,26503,24875,1628,6.1
29,189,St. Louis,2001,554172,532164,22008,4.0
29,195,Saline,2001,12671,12065,606,4.8
29,197,Schuyler,2001,2232,2110,122,5.5
29,199,Scotland,2001,2720,2620,100,3.7
29,201,Scott,2001,20868,19752,1116,5.3
29,203,Shannon,2001,4053,3795,258,6.4
29,205,Shelby,2001,3671,3475,196,5.3
29,207,Stoddard,2001,15380,14504,876,5.7
29,209,Stone,2001,15195,14052,1143,7.5
29,211,Sullivan,2001,4015,3851,164,4.1
29,213,Taney,2001,24429,22429,2000,8.2
29,215,Texas,2001,11371,10720,651,5.7
29,217,Vernon,2001,10738,10345,393,3.7
29,219,Warren,2001,13908,13259,649,4.7
29,221,Washington,2001,9937,9235,702,7.1
29,223,Wayne,2001,5596,5196,400,7.1
29,225,Webster,2001,15524,14818,706,4.5
29,227,Worth,2001,1304,1258,46,3.5
29,229,Wright,2001,8550,8019,531,6.2
29,510,St. Louis city,2001,162702,151735,10967,6.7
30,1,Beaverhead,2001,5154,4976,178,3.5
30,3,Big Horn,2001,5129,4513,616,12.0
30,5,Blaine,2001,2900,2765,135,4.7
30,7,Broadwater,2001,2179,2083,96,4.4
30,9,Carbon,2001,5034,4823,211,4.2
30,11,Carter,2001,727,703,24,3.3
30,13,Cascade,2001,38186,36451,1735,4.5
30,15,Chouteau,2001,2711,2613,98,3.6
30,17,Custer,2001,5823,5584,239,4.1
30,19,Daniels,2001,919,878,41,4.5
30,21,Dawson,2001,4448,4287,161,3.6
30,23,Deer Lodge,2001,4231,3948,283,6.7
30,25,Fallon,2001,1541,1496,45,2.9
30,27,Fergus,2001,6061,5742,319,5.3
30,29,Flathead,2001,39855,37714,2141,5.4
30,31,Gallatin,2001,41427,40013,1414,3.4
30,33,Garfield,2001,677,655,22,3.2
30,35,Glacier,2001,5750,5316,434,7.5
30,37,Golden Valley,2001,491,468,23,4.7
30,39,Granite,2001,1327,1244,83,6.3
30,41,Hill,2001,7869,7524,345,4.4
30,43,Jefferson,2001,5328,5092,236,4.4
30,45,Judith Basin,2001,1156,1109,47,4.1
30,47,Lake,2001,11719,10864,855,7.3
30,49,Lewis and Clark,2001,30827,29577,1250,4.1
30,51,Liberty,2001,881,846,35,4.0
30,53,Lincoln,2001,7669,6998,671,8.7
30,55,McCone,2001,1051,1020,31,2.9
30,57,Madison,2001,3332,3181,151,4.5
30,59,Meagher,2001,948,893,55,5.8
30,61,Mineral,2001,1974,1846,128,6.5
30,63,Missoula,2001,54739,52548,2191,4.0
30,65,Musselshell,2001,2033,1917,116,5.7
30,67,Park,2001,8631,8217,414,4.8
30,69,Petroleum,2001,221,211,10,4.5
30,71,Phillips,2001,2220,2126,94,4.2
30,73,Pondera,2001,2880,2754,126,4.4
30,75,Powder River,2001,940,910,30,3.2
30,77,Powell,2001,2758,2602,156,5.7
30,79,Prairie,2001,593,561,32,5.4
30,81,Ravalli,2001,17177,16301,876,5.1
30,83,Richland,2001,4820,4591,229,4.8
30,85,Roosevelt,2001,4121,3877,244,5.9
30,87,Rosebud,2001,4228,3974,254,6.0
30,89,Sanders,2001,4370,4051,319,7.3
30,91,Sheridan,2001,1907,1829,78,4.1
30,93,Silver Bow,2001,16971,16077,894,5.3
30,95,Stillwater,2001,4624,4449,175,3.8
30,97,Sweet Grass,2001,2035,1973,62,3.0
30,99,Teton,2001,2913,2797,116,4.0
30,101,Toole,2001,2420,2332,88,3.6
30,103,Treasure,2001,439,423,16,3.6
30,105,Valley,2001,3695,3539,156,4.2
30,107,Wheatland,2001,1085,1040,45,4.1
30,109,Wibaux,2001,517,498,19,3.7
30,111,Yellowstone,2001,71695,69047,2648,3.7
31,1,Adams,2001,17004,16482,522,3.1
31,3,Antelope,2001,3852,3731,121,3.1
31,5,Arthur,2001,273,264,9,3.3
31,7,Banner,2001,418,408,10,2.4
31,9,Blaine,2001,313,305,8,2.6
31,11,Boone,2001,3182,3082,100,3.1
31,13,Box Butte,2001,5781,5527,254,4.4
31,15,Boyd,2001,1230,1187,43,3.5
31,17,Brown,2001,1884,1820,64,3.4
31,19,Buffalo,2001,24939,24343,596,2.4
31,21,Burt,2001,4058,3903,155,3.8
31,23,Butler,2001,4680,4527,153,3.3
31,25,Cass,2001,13560,13124,436,3.2
31,27,Cedar,2001,4987,4861,126,2.5
31,29,Chase,2001,2066,2015,51,2.5
31,31,Cherry,2001,3517,3438,79,2.2
31,33,Cheyenne,2001,5882,5738,144,2.4
31,35,Clay,2001,3474,3364,110,3.2
31,37,Colfax,2001,5785,5639,146,2.5
31,39,Cuming,2001,5601,5470,131,2.3
31,41,Custer,2001,6382,6227,155,2.4
31,43,Dakota,2001,10824,10489,335,3.1
31,45,Dawes,2001,4845,4705,140,2.9
31,47,Dawson,2001,12142,11707,435,3.6
31,49,Deuel,2001,1129,1098,31,2.7
31,51,Dixon,2001,3271,3190,81,2.5
31,53,Dodge,2001,19587,18836,751,3.8
31,55,Douglas,2001,258670,249532,9138,3.5
31,57,Dundy,2001,1219,1190,29,2.4
31,59,Fillmore,2001,3424,3321,103,3.0
31,61,Franklin,2001,1824,1769,55,3.0
31,63,Frontier,2001,1785,1744,41,2.3
31,65,Furnas,2001,2559,2490,69,2.7
31,67,Gage,2001,12765,12374,391,3.1
31,69,Garden,2001,1109,1073,36,3.2
31,71,Garfield,2001,1024,996,28,2.7
31,73,Gosper,2001,1087,1054,33,3.0
31,75,Grant,2001,429,418,11,2.6
31,77,Greeley,2001,1385,1343,42,3.0
31,79,Hall,2001,28629,27685,944,3.3
31,81,Hamilton,2001,4924,4799,125,2.5
31,83,Harlan,2001,1945,1893,52,2.7
31,85,Hayes,2001,595,578,17,2.9
31,87,Hitchcock,2001,1508,1454,54,3.6
31,89,Holt,2001,6168,5977,191,3.1
31,91,Hooker,2001,434,418,16,3.7
31,93,Howard,2001,3499,3394,105,3.0
31,95,Jefferson,2001,4293,4098,195,4.5
31,97,Johnson,2001,2610,2531,79,3.0
31,99,Kearney,2001,3738,3650,88,2.4
31,101,Keith,2001,4962,4817,145,2.9
31,103,Keya Paha,2001,440,429,11,2.5
31,105,Kimball,2001,2190,2135,55,2.5
31,107,Knox,2001,4664,4491,173,3.7
31,109,Lancaster,2001,150668,146626,4042,2.7
31,111,Lincoln,2001,19470,18846,624,3.2
31,113,Logan,2001,442,431,11,2.5
31,115,Loup,2001,340,330,10,2.9
31,117,McPherson,2001,290,285,5,1.7
31,119,Madison,2001,19059,18379,680,3.6
31,121,Merrick,2001,4193,4069,124,3.0
31,123,Morrill,2001,2791,2702,89,3.2
31,125,Nance,2001,2058,1986,72,3.5
31,127,Nemaha,2001,3803,3668,135,3.5
31,129,Nuckolls,2001,2471,2399,72,2.9
31,131,Otoe,2001,8321,8039,282,3.4
31,133,Pawnee,2001,1663,1606,57,3.4
31,135,Perkins,2001,1660,1623,37,2.2
31,137,Phelps,2001,5347,5208,139,2.6
31,139,Pierce,2001,4093,3971,122,3.0
31,141,Platte,2001,17341,16731,610,3.5
31,143,Polk,2001,3038,2955,83,2.7
31,145,Red Willow,2001,5999,5841,158,2.6
31,147,Richardson,2001,4677,4456,221,4.7
31,149,Rock,2001,993,962,31,3.1
31,151,Saline,2001,7884,7658,226,2.9
31,153,Sarpy,2001,66997,65235,1762,2.6
31,155,Saunders,2001,11050,10697,353,3.2
31,157,Scotts Bluff,2001,18550,17796,754,4.1
31,159,Seward,2001,9344,9085,259,2.8
31,161,Sheridan,2001,3182,3095,87,2.7
31,163,Sherman,2001,1822,1773,49,2.7
31,165,Sioux,2001,788,772,16,2.0
31,167,Stanton,2001,3431,3338,93,2.7
31,169,Thayer,2001,3021,2922,99,3.3
31,171,Thomas,2001,405,383,22,5.4
31,173,Thurston,2001,2736,2568,168,6.1
31,175,Valley,2001,2359,2285,74,3.1
31,177,Washington,2001,10982,10674,308,2.8
31,179,Wayne,2001,5470,5319,151,2.8
31,181,Webster,2001,2001,1944,57,2.8
31,183,Wheeler,2001,513,501,12,2.3
31,185,York,2001,7579,7373,206,2.7
32,1,Churchill,2001,11958,11215,743,6.2
32,3,Clark,2001,768186,726985,41201,5.4
32,5,Douglas,2001,21886,20876,1010,4.6
32,7,Elko,2001,23790,22642,1148,4.8
32,9,Esmeralda,2001,518,480,38,7.3
32,11,Eureka,2001,779,747,32,4.1
32,13,Humboldt,2001,7604,7184,420,5.5
32,15,Lander,2001,2731,2545,186,6.8
32,17,Lincoln,2001,1769,1674,95,5.4
32,19,Lyon,2001,19228,18128,1100,5.7
32,21,Mineral,2001,2143,1985,158,7.4
32,23,Nye,2001,14547,13421,1126,7.7
32,27,Pershing,2001,2590,2467,123,4.7
32,29,Storey,2001,2034,1958,76,3.7
32,31,Washoe,2001,202796,194018,8778,4.3
32,33,White Pine,2001,3688,3521,167,4.5
32,510,Carson City,2001,27286,25925,1361,5.0
33,1,Belknap,2001,31134,30215,919,3.0
33,3,Carroll,2001,23722,22993,729,3.1
33,5,Cheshire,2001,39851,38665,1186,3.0
33,7,Coos,2001,16920,16047,873,5.2
33,9,Grafton,2001,44649,43457,1192,2.7
33,11,Hillsborough,2001,214452,207012,7440,3.5
33,13,Merrimack,2001,75451,73325,2126,2.8
33,15,Rockingham,2001,162352,155940,6412,3.9
33,17,Strafford,2001,62018,60017,2001,3.2
33,19,Sullivan,2001,21481,20902,579,2.7
34,1,Atlantic,2001,129400,123304,6096,4.7
34,3,Bergen,2001,466059,448746,17313,3.7
34,5,Burlington,2001,222124,214300,7824,3.5
34,7,Camden,2001,252237,241352,10885,4.3
34,9,Cape May,2001,55184,51522,3662,6.6
34,11,Cumberland,2001,65032,60825,4207,6.5
34,13,Essex,2001,365162,345793,19369,5.3
34,15,Gloucester,2001,134955,129640,5315,3.9
34,17,Hudson,2001,296183,279817,16366,5.5
34,19,Hunterdon,2001,68628,66723,1905,2.8
34,21,Mercer,2001,182313,175540,6773,3.7
34,23,Middlesex,2001,405170,389008,16162,4.0
34,25,Monmouth,2001,319877,307890,11987,3.7
34,27,Morris,2001,260752,252323,8429,3.2
34,29,Ocean,2001,235782,226106,9676,4.1
34,31,Passaic,2001,235570,222958,12612,5.4
34,33,Salem,2001,30834,29477,1357,4.4
34,35,Somerset,2001,167528,162140,5388,3.2
34,37,Sussex,2001,80060,77153,2907,3.6
34,39,Union,2001,264869,252783,12086,4.6
34,41,Warren,2001,56647,54695,1952,3.4
35,1,Bernalillo,2001,289914,277715,12199,4.2
35,3,Catron,2001,1502,1409,93,6.2
35,5,Chaves,2001,25658,24208,1450,5.7
35,6,Cibola,2001,10094,9469,625,6.2
35,7,Colfax,2001,6919,6559,360,5.2
35,9,Curry,2001,18828,18014,814,4.3
35,11,De Baca,2001,960,912,48,5.0
35,13,Dona Ana,2001,76531,71848,4683,6.1
35,15,Eddy,2001,23327,22155,1172,5.0
35,17,Grant,2001,12976,12155,821,6.3
35,19,Guadalupe,2001,1662,1531,131,7.9
35,21,Harding,2001,391,374,17,4.3
35,23,Hidalgo,2001,2559,2404,155,6.1
35,25,Lea,2001,23519,22504,1015,4.3
35,27,Lincoln,2001,9699,9286,413,4.3
35,28,Los Alamos,2001,10319,10051,268,2.6
35,29,Luna,2001,10675,8893,1782,16.7
35,31,McKinley,2001,24630,23100,1530,6.2
35,33,Mora,2001,1998,1801,197,9.9
35,35,Otero,2001,24306,22994,1312,5.4
35,37,Quay,2001,4150,3925,225,5.4
35,39,Rio Arriba,2001,19136,17971,1165,6.1
35,41,Roosevelt,2001,8413,8080,333,4.0
35,43,Sandoval,2001,44386,42319,2067,4.7
35,45,San Juan,2001,50317,47599,2718,5.4
35,47,San Miguel,2001,12665,11897,768,6.1
35,49,Santa Fe,2001,70580,68012,2568,3.6
35,51,Sierra,2001,5325,5073,252,4.7
35,53,Socorro,2001,8136,7706,430,5.3
35,55,Taos,2001,15743,14692,1051,6.7
35,57,Torrance,2001,7380,7048,332,4.5
35,59,Union,2001,2030,1959,71,3.5
35,61,Valencia,2001,30359,28891,1468,4.8
36,1,Albany,2001,154790,149607,5183,3.3
36,3,Allegany,2001,23006,21913,1093,4.8
36,5,Bronx,2001,485175,449099,36076,7.4
36,7,Broome,2001,98127,93951,4176,4.3
36,9,Cattaraugus,2001,41038,38970,2068,5.0
36,11,Cayuga,2001,39928,38220,1708,4.3
36,13,Chautauqua,2001,66964,63843,3121,4.7
36,15,Chemung,2001,42385,40285,2100,5.0
36,17,Chenango,2001,24524,23418,1106,4.5
36,19,Clinton,2001,38785,37053,1732,4.5
36,21,Columbia,2001,31133,30042,1091,3.5
36,23,Cortland,2001,24672,23505,1167,4.7
36,25,Delaware,2001,22193,21273,920,4.1
36,27,Dutchess,2001,140089,135259,4830,3.4
36,29,Erie,2001,460435,438908,21527,4.7
36,31,Essex,2001,18578,17730,848,4.6
36,33,Franklin,2001,21847,20539,1308,6.0
36,35,Fulton,2001,26275,25086,1189,4.5
36,37,Genesee,2001,32218,30831,1387,4.3
36,39,Greene,2001,22500,21481,1019,4.5
36,41,Hamilton,2001,2756,2624,132,4.8
36,43,Herkimer,2001,31108,29713,1395,4.5
36,45,Jefferson,2001,44900,42065,2835,6.3
36,47,Kings,2001,1032816,964737,68079,6.6
36,49,Lewis,2001,12499,11735,764,6.1
36,51,Livingston,2001,32698,31271,1427,4.4
36,53,Madison,2001,34988,33406,1582,4.5
36,55,Monroe,2001,373652,358269,15383,4.1
36,57,Montgomery,2001,23619,22438,1181,5.0
36,59,Nassau,2001,671226,646336,24890,3.7
36,61,New York,2001,860114,810548,49566,5.8
36,63,Niagara,2001,108517,102547,5970,5.5
36,65,Oneida,2001,109356,104363,4993,4.6
36,67,Onondaga,2001,229071,219849,9222,4.0
36,69,Ontario,2001,54378,52219,2159,4.0
36,71,Orange,2001,163929,157923,6006,3.7
36,73,Orleans,2001,19934,18908,1026,5.1
36,75,Oswego,2001,58374,55261,3113,5.3
36,77,Otsego,2001,30169,28885,1284,4.3
36,79,Putnam,2001,52527,50854,1673,3.2
36,81,Queens,2001,1055645,998612,57033,5.4
36,83,Rensselaer,2001,80827,77748,3079,3.8
36,85,Richmond,2001,216684,205401,11283,5.2
36,87,Rockland,2001,144418,139311,5107,3.5
36,89,St. Lawrence,2001,48743,45771,2972,6.1
36,91,Saratoga,2001,112205,108445,3760,3.4
36,93,Schenectady,2001,72327,69870,2457,3.4
36,95,Schoharie,2001,15249,14600,649,4.3
36,97,Schuyler,2001,9423,8915,508,5.4
36,99,Seneca,2001,16509,15800,709,4.3
36,101,Steuben,2001,48328,45951,2377,4.9
36,103,Suffolk,2001,737297,709201,28096,3.8
36,105,Sullivan,2001,33278,31764,1514,4.5
36,107,Tioga,2001,26478,25387,1091,4.1
36,109,Tompkins,2001,51262,49532,1730,3.4
36,111,Ulster,2001,88223,84873,3350,3.8
36,113,Warren,2001,33297,31820,1477,4.4
36,115,Washington,2001,30111,28898,1213,4.0
36,117,Wayne,2001,48714,46465,2249,4.6
36,119,Westchester,2001,463890,446337,17553,3.8
36,121,Wyoming,2001,20315,19316,999,4.9
36,123,Yates,2001,12031,11571,460,3.8
37,1,Alamance,2001,69042,65152,3890,5.6
37,3,Alexander,2001,19239,18100,1139,5.9
37,5,Alleghany,2001,5273,4819,454,8.6
37,7,Anson,2001,11293,10326,967,8.6
37,9,Ashe,2001,12668,11648,1020,8.1
37,11,Avery,2001,8053,7609,444,5.5
37,13,Beaufort,2001,20077,18334,1743,8.7
37,15,Bertie,2001,8308,7645,663,8.0
37,17,Bladen,2001,14944,13631,1313,8.8
37,19,Brunswick,2001,36863,34779,2084,5.7
37,21,Buncombe,2001,109403,104672,4731,4.3
37,23,Burke,2001,45528,42514,3014,6.6
37,25,Cabarrus,2001,74861,71187,3674,4.9
37,27,Caldwell,2001,42234,39452,2782,6.6
37,29,Camden,2001,3403,3268,135,4.0
37,31,Carteret,2001,29722,28115,1607,5.4
37,33,Caswell,2001,10878,10143,735,6.8
37,35,Catawba,2001,80861,75684,5177,6.4
37,37,Chatham,2001,28315,27162,1153,4.1
37,39,Cherokee,2001,10260,9361,899,8.8
37,41,Chowan,2001,6428,6073,355,5.5
37,43,Clay,2001,3962,3766,196,4.9
37,45,Cleveland,2001,49941,45284,4657,9.3
37,47,Columbus,2001,23262,21310,1952,8.4
37,49,Craven,2001,38658,36449,2209,5.7
37,51,Cumberland,2001,119447,112127,7320,6.1
37,53,Currituck,2001,9671,9378,293,3.0
37,55,Dare,2001,19128,18049,1079,5.6
37,57,Davidson,2001,80229,75224,5005,6.2
37,59,Davie,2001,18938,17936,1002,5.3
37,61,Duplin,2001,22713,21299,1414,6.2
37,63,Durham,2001,126773,121182,5591,4.4
37,65,Edgecombe,2001,25410,23289,2121,8.3
37,67,Forsyth,2001,164272,156547,7725,4.7
37,69,Franklin,2001,24974,23727,1247,5.0
37,71,Gaston,2001,101946,94167,7779,7.6
37,73,Gates,2001,4664,4458,206,4.4
37,75,Graham,2001,3926,3573,353,9.0
37,77,Granville,2001,23295,21811,1484,6.4
37,79,Greene,2001,8650,8062,588,6.8
37,81,Guilford,2001,236436,224451,11985,5.1
37,83,Halifax,2001,22819,20581,2238,9.8
37,85,Harnett,2001,43009,40329,2680,6.2
37,87,Haywood,2001,26527,25019,1508,5.7
37,89,Henderson,2001,43306,41427,1879,4.3
37,91,Hertford,2001,9764,9058,706,7.2
37,93,Hoke,2001,14836,13837,999,6.7
37,95,Hyde,2001,2759,2557,202,7.3
37,97,Iredell,2001,66361,62485,3876,5.8
37,99,Jackson,2001,19072,18246,826,4.3
37,101,Johnston,2001,65838,63016,2822,4.3
37,103,Jones,2001,4613,4351,262,5.7
37,105,Lee,2001,24883,23353,1530,6.1
37,107,Lenoir,2001,27527,25303,2224,8.1
37,109,Lincoln,2001,35577,33180,2397,6.7
37,111,McDowell,2001,21301,19747,1554,7.3
37,113,Macon,2001,14503,13832,671,4.6
37,115,Madison,2001,9598,9063,535,5.6
37,117,Martin,2001,11734,10908,826,7.0
37,119,Mecklenburg,2001,408459,390394,18065,4.4
37,121,Mitchell,2001,7798,7088,710,9.1
37,123,Montgomery,2001,12754,11878,876,6.9
37,125,Moore,2001,35066,33339,1727,4.9
37,127,Nash,2001,44069,41250,2819,6.4
37,129,New Hanover,2001,89577,85085,4492,5.0
37,131,Northampton,2001,8630,7893,737,8.5
37,133,Onslow,2001,54193,51187,3006,5.5
37,135,Orange,2001,66435,64111,2324,3.5
37,137,Pamlico,2001,5351,5053,298,5.6
37,139,Pasquotank,2001,15446,14662,784,5.1
37,141,Pender,2001,19917,18783,1134,5.7
37,143,Perquimans,2001,4841,4574,267,5.5
37,145,Person,2001,18794,17496,1298,6.9
37,147,Pitt,2001,69734,65627,4107,5.9
37,149,Polk,2001,8776,8396,380,4.3
37,151,Randolph,2001,73485,69399,4086,5.6
37,153,Richmond,2001,21299,19517,1782,8.4
37,155,Robeson,2001,52285,47140,5145,9.8
37,157,Rockingham,2001,46578,43340,3238,7.0
37,159,Rowan,2001,65362,61030,4332,6.6
37,161,Rutherford,2001,30660,28331,2329,7.6
37,163,Sampson,2001,29250,27427,1823,6.2
37,165,Scotland,2001,16063,14552,1511,9.4
37,167,Stanly,2001,29505,27385,2120,7.2
37,169,Stokes,2001,24155,22864,1291,5.3
37,171,Surry,2001,36784,34478,2306,6.3
37,173,Swain,2001,6712,6173,539,8.0
37,175,Transylvania,2001,13350,12667,683,5.1
37,177,Tyrrell,2001,1889,1737,152,8.0
37,179,Union,2001,70841,67927,2914,4.1
37,181,Vance,2001,20222,18367,1855,9.2
37,183,Wake,2001,377396,362208,15188,4.0
37,185,Warren,2001,8153,7448,705,8.6
37,187,Washington,2001,5936,5510,426,7.2
37,189,Watauga,2001,23664,22799,865,3.7
37,191,Wayne,2001,51527,48592,2935,5.7
37,193,Wilkes,2001,33636,31590,2046,6.1
37,195,Wilson,2001,37860,35050,2810,7.4
37,197,Yadkin,2001,19318,18310,1008,5.2
37,199,Yancey,2001,8231,7421,810,9.8
38,1,Adams,2001,1192,1161,31,2.6
38,3,Barnes,2001,5907,5739,168,2.8
38,5,Benson,2001,2595,2447,148,5.7
38,7,Billings,2001,498,487,11,2.2
38,9,Bottineau,2001,3484,3373,111,3.2
38,11,Bowman,2001,1768,1731,37,2.1
38,13,Burke,2001,959,930,29,3.0
38,15,Burleigh,2001,40637,39694,943,2.3
38,17,Cass,2001,76231,74667,1564,2.1
38,19,Cavalier,2001,2298,2227,71,3.1
38,21,Dickey,2001,2983,2912,71,2.4
38,23,Divide,2001,1009,982,27,2.7
38,25,Dunn,2001,1723,1667,56,3.3
38,27,Eddy,2001,1372,1316,56,4.1
38,29,Emmons,2001,1978,1892,86,4.3
38,31,Foster,2001,1848,1795,53,2.9
38,33,Golden Valley,2001,894,873,21,2.3
38,35,Grand Forks,2001,36115,35126,989,2.7
38,37,Grant,2001,1359,1318,41,3.0
38,39,Griggs,2001,1363,1332,31,2.3
38,41,Hettinger,2001,1221,1188,33,2.7
38,43,Kidder,2001,1263,1199,64,5.1
38,45,LaMoure,2001,2265,2197,68,3.0
38,47,Logan,2001,1026,997,29,2.8
38,49,McHenry,2001,2798,2665,133,4.8
38,51,McIntosh,2001,1502,1461,41,2.7
38,53,McKenzie,2001,2682,2610,72,2.7
38,55,McLean,2001,4437,4227,210,4.7
38,57,Mercer,2001,4482,4303,179,4.0
38,59,Morton,2001,13836,13411,425,3.1
38,61,Mountrail,2001,2954,2832,122,4.1
38,63,Nelson,2001,1818,1753,65,3.6
38,65,Oliver,2001,1104,1063,41,3.7
38,67,Pembina,2001,4713,4516,197,4.2
38,69,Pierce,2001,1918,1838,80,4.2
38,71,Ramsey,2001,6262,6066,196,3.1
38,73,Ransom,2001,3043,2973,70,2.3
38,75,Renville,2001,1295,1265,30,2.3
38,77,Richland,2001,9015,8752,263,2.9
38,79,Rolette,2001,5617,5158,459,8.2
38,81,Sargent,2001,2268,2198,70,3.1
38,83,Sheridan,2001,797,756,41,5.1
38,85,Sioux,2001,1310,1247,63,4.8
38,87,Slope,2001,393,384,9,2.3
38,89,Stark,2001,12350,12026,324,2.6
38,91,Steele,2001,1128,1107,21,1.9
38,93,Stutsman,2001,11767,11475,292,2.5
38,95,Towner,2001,1362,1324,38,2.8
38,97,Traill,2001,4257,4133,124,2.9
38,99,Walsh,2001,6361,6156,205,3.2
38,101,Ward,2001,27978,27104,874,3.1
38,103,Wells,2001,2258,2173,85,3.8
38,105,Williams,2001,10833,10582,251,2.3
39,1,Adams,2001,12501,11551,950,7.6
39,3,Allen,2001,51572,48917,2655,5.1
39,5,Ashland,2001,27245,25993,1252,4.6
39,7,Ashtabula,2001,49576,46525,3051,6.2
39,9,Athens,2001,28438,27017,1421,5.0
39,11,Auglaize,2001,24964,23872,1092,4.4
39,13,Belmont,2001,30987,29227,1760,5.7
39,15,Brown,2001,20851,19603,1248,6.0
39,17,Butler,2001,175170,168035,7135,4.1
39,19,Carroll,2001,14313,13609,704,4.9
39,21,Champaign,2001,20693,19740,953,4.6
39,23,Clark,2001,72795,69008,3787,5.2
39,25,Clermont,2001,96659,92654,4005,4.1
39,27,Clinton,2001,21843,21014,829,3.8
39,29,Columbiana,2001,53832,50868,2964,5.5
39,31,Coshocton,2001,17819,16842,977,5.5
39,33,Crawford,2001,23672,22289,1383,5.8
39,35,Cuyahoga,2001,687259,662359,24900,3.6
39,37,Darke,2001,28217,26980,1237,4.4
39,39,Defiance,2001,20915,19888,1027,4.9
39,41,Delaware,2001,67093,65143,1950,2.9
39,43,Erie,2001,42393,40335,2058,4.9
39,45,Fairfield,2001,67226,64829,2397,3.6
39,47,Fayette,2001,15531,14883,648,4.2
39,49,Franklin,2001,599462,578623,20839,3.5
39,51,Fulton,2001,22675,21632,1043,4.6
39,53,Gallia,2001,13363,12507,856,6.4
39,55,Geauga,2001,49317,47947,1370,2.8
39,57,Greene,2001,76403,73362,3041,4.0
39,59,Guernsey,2001,18768,17695,1073,5.7
39,61,Hamilton,2001,425614,408253,17361,4.1
39,63,Hancock,2001,39046,37570,1476,3.8
39,65,Hardin,2001,15564,14803,761,4.9
39,67,Harrison,2001,7385,7018,367,5.0
39,69,Henry,2001,15227,14478,749,4.9
39,71,Highland,2001,19466,18462,1004,5.2
39,73,Hocking,2001,13288,12527,761,5.7
39,75,Holmes,2001,18124,17579,545,3.0
39,77,Huron,2001,30584,28700,1884,6.2
39,79,Jackson,2001,14602,13613,989,6.8
39,81,Jefferson,2001,31795,29876,1919,6.0
39,83,Knox,2001,27972,26784,1188,4.2
39,85,Lake,2001,130122,125848,4274,3.3
39,87,Lawrence,2001,26180,24488,1692,6.5
39,89,Licking,2001,78382,75253,3129,4.0
39,91,Logan,2001,24309,23375,934,3.8
39,93,Lorain,2001,149362,143403,5959,4.0
39,95,Lucas,2001,226892,215319,11573,5.1
39,97,Madison,2001,19403,18673,730,3.8
39,99,Mahoning,2001,118389,111417,6972,5.9
39,101,Marion,2001,32035,30528,1507,4.7
39,103,Medina,2001,86525,83912,2613,3.0
39,105,Meigs,2001,9783,9092,691,7.1
39,107,Mercer,2001,21786,20779,1007,4.6
39,109,Miami,2001,54319,51937,2382,4.4
39,111,Monroe,2001,6026,5636,390,6.5
39,113,Montgomery,2001,278738,265626,13112,4.7
39,115,Morgan,2001,6689,6120,569,8.5
39,117,Morrow,2001,17043,16174,869,5.1
39,119,Muskingum,2001,42185,39705,2480,5.9
39,121,Noble,2001,5740,5407,333,5.8
39,123,Ottawa,2001,21391,20157,1234,5.8
39,125,Paulding,2001,10727,10226,501,4.7
39,127,Perry,2001,16362,15412,950,5.8
39,129,Pickaway,2001,23793,22712,1081,4.5
39,131,Pike,2001,11579,10696,883,7.6
39,133,Portage,2001,84845,81147,3698,4.4
39,135,Preble,2001,21996,21005,991,4.5
39,137,Putnam,2001,17939,17203,736,4.1
39,139,Richland,2001,63153,59793,3360,5.3
39,141,Ross,2001,33489,31644,1845,5.5
39,143,Sandusky,2001,32814,31258,1556,4.7
39,145,Scioto,2001,32433,30165,2268,7.0
39,147,Seneca,2001,31181,29597,1584,5.1
39,149,Shelby,2001,25785,24690,1095,4.2
39,151,Stark,2001,193603,185016,8587,4.4
39,153,Summit,2001,280412,267258,13154,4.7
39,155,Trumbull,2001,106950,100182,6768,6.3
39,157,Tuscarawas,2001,46668,44498,2170,4.6
39,159,Union,2001,22900,22172,728,3.2
39,161,Van Wert,2001,15364,14519,845,5.5
39,163,Vinton,2001,5526,5102,424,7.7
39,165,Warren,2001,86852,83601,3251,3.7
39,167,Washington,2001,31371,29846,1525,4.9
39,169,Wayne,2001,59681,57312,2369,4.0
39,171,Williams,2001,20792,19701,1091,5.2
39,173,Wood,2001,66619,63949,2670,4.0
39,175,Wyandot,2001,12811,12257,554,4.3
40,1,Adair,2001,9152,8777,375,4.1
40,3,Alfalfa,2001,2522,2447,75,3.0
40,5,Atoka,2001,5286,5055,231,4.4
40,7,Beaver,2001,3004,2926,78,2.6
40,9,Beckham,2001,8838,8561,277,3.1
40,11,Blaine,2001,4664,4463,201,4.3
40,13,Bryan,2001,17592,17006,586,3.3
40,15,Caddo,2001,12242,11696,546,4.5
40,17,Canadian,2001,47535,46078,1457,3.1
40,19,Carter,2001,21431,20614,817,3.8
40,21,Cherokee,2001,19062,18413,649,3.4
40,23,Choctaw,2001,6291,5963,328,5.2
40,25,Cimarron,2001,1531,1488,43,2.8
40,27,Cleveland,2001,113948,110416,3532,3.1
40,29,Coal,2001,2513,2380,133,5.3
40,31,Comanche,2001,42448,40815,1633,3.8
40,33,Cotton,2001,2800,2702,98,3.5
40,35,Craig,2001,6757,6495,262,3.9
40,37,Creek,2001,32112,30961,1151,3.6
40,39,Custer,2001,13128,12726,402,3.1
40,41,Delaware,2001,16209,15565,644,4.0
40,43,Dewey,2001,2338,2273,65,2.8
40,45,Ellis,2001,2114,2058,56,2.6
40,47,Garfield,2001,27538,26704,834,3.0
40,49,Garvin,2001,12872,12398,474,3.7
40,51,Grady,2001,22115,21397,718,3.2
40,53,Grant,2001,2488,2419,69,2.8
40,55,Greer,2001,2280,2182,98,4.3
40,57,Harmon,2001,1432,1384,48,3.4
40,59,Harper,2001,1922,1867,55,2.9
40,61,Haskell,2001,5490,5260,230,4.2
40,63,Hughes,2001,5309,5022,287,5.4
40,65,Jackson,2001,11967,11584,383,3.2
40,67,Jefferson,2001,2621,2511,110,4.2
40,69,Johnston,2001,4553,4335,218,4.8
40,71,Kay,2001,22791,21859,932,4.1
40,73,Kingfisher,2001,7271,7095,176,2.4
40,75,Kiowa,2001,4549,4401,148,3.3
40,77,Latimer,2001,4635,4410,225,4.9
40,79,Le Flore,2001,20893,19813,1080,5.2
40,81,Lincoln,2001,14958,14386,572,3.8
40,83,Logan,2001,17314,16823,491,2.8
40,85,Love,2001,4303,4136,167,3.9
40,87,McClain,2001,13948,13446,502,3.6
40,89,McCurtain,2001,15598,14779,819,5.3
40,91,McIntosh,2001,8042,7640,402,5.0
40,93,Major,2001,3834,3729,105,2.7
40,95,Marshall,2001,5668,5435,233,4.1
40,97,Mayes,2001,17834,17094,740,4.1
40,99,Murray,2001,6014,5772,242,4.0
40,101,Muskogee,2001,28890,27664,1226,4.2
40,103,Noble,2001,5520,5306,214,3.9
40,105,Nowata,2001,4822,4617,205,4.3
40,107,Okfuskee,2001,4739,4542,197,4.2
40,109,Oklahoma,2001,330122,317421,12701,3.8
40,111,Okmulgee,2001,17032,16234,798,4.7
40,113,Osage,2001,20959,20251,708,3.4
40,115,Ottawa,2001,15548,14681,867,5.6
40,117,Pawnee,2001,7960,7648,312,3.9
40,119,Payne,2001,34991,34011,980,2.8
40,121,Pittsburg,2001,17904,17130,774,4.3
40,123,Pontotoc,2001,16658,16010,648,3.9
40,125,Pottawatomie,2001,29967,28658,1309,4.4
40,127,Pushmataha,2001,4761,4478,283,5.9
40,129,Roger Mills,2001,1810,1768,42,2.3
40,131,Rogers,2001,36942,35829,1113,3.0
40,133,Seminole,2001,10634,10132,502,4.7
40,135,Sequoyah,2001,17351,16505,846,4.9
40,137,Stephens,2001,19372,18684,688,3.6
40,139,Texas,2001,10591,10304,287,2.7
40,141,Tillman,2001,3690,3540,150,4.1
40,143,Tulsa,2001,297379,287525,9854,3.3
40,145,Wagoner,2001,29952,29070,882,2.9
40,147,Washington,2001,23337,22607,730,3.1
40,149,Washita,2001,5880,5713,167,2.8
40,151,Woods,2001,4522,4402,120,2.7
40,153,Woodward,2001,9543,9266,277,2.9
41,1,Baker,2001,7268,6653,615,8.5
41,3,Benton,2001,41441,39599,1842,4.4
41,5,Clackamas,2001,187462,177688,9774,5.2
41,7,Clatsop,2001,17901,16876,1025,5.7
41,9,Columbia,2001,22652,20917,1735,7.7
41,11,Coos,2001,26462,24240,2222,8.4
41,13,Crook,2001,8695,7964,731,8.4
41,15,Curry,2001,8743,8121,622,7.1
41,17,Deschutes,2001,63115,59065,4050,6.4
41,19,Douglas,2001,46055,42210,3845,8.3
41,21,Gilliam,2001,1014,954,60,5.9
41,23,Grant,2001,3732,3388,344,9.2
41,25,Harney,2001,3668,3216,452,12.3
41,27,Hood River,2001,11631,10748,883,7.6
41,29,Jackson,2001,91742,85757,5985,6.5
41,31,Jefferson,2001,8678,8095,583,6.7
41,33,Josephine,2001,31540,28917,2623,8.3
41,35,Klamath,2001,29651,27116,2535,8.5
41,37,Lake,2001,3417,3100,317,9.3
41,39,Lane,2001,169060,157614,11446,6.8
41,41,Lincoln,2001,21076,19573,1503,7.1
41,43,Linn,2001,51781,47829,3952,7.6
41,45,Malheur,2001,12991,11917,1074,8.3
41,47,Marion,2001,144163,134970,9193,6.4
41,49,Morrow,2001,5518,5098,420,7.6
41,51,Multnomah,2001,378280,354750,23530,6.2
41,53,Polk,2001,33270,31384,1886,5.7
41,55,Sherman,2001,902,811,91,10.1
41,57,Tillamook,2001,11679,10963,716,6.1
41,59,Umatilla,2001,36323,33787,2536,7.0
41,61,Union,2001,12047,11287,760,6.3
41,63,Wallowa,2001,3524,3201,323,9.2
41,65,Wasco,2001,12668,11574,1094,8.6
41,67,Washington,2001,262667,248432,14235,5.4
41,69,Wheeler,2001,705,648,57,8.1
41,71,Yamhill,2001,43561,40903,2658,6.1
42,1,Adams,2001,51106,49133,1973,3.9
42,3,Allegheny,2001,644556,616253,28303,4.4
42,5,Armstrong,2001,33812,31614,2198,6.5
42,7,Beaver,2001,90342,85794,4548,5.0
42,9,Bedford,2001,24240,22525,1715,7.1
42,11,Berks,2001,196986,187633,9353,4.7
42,13,Blair,2001,63816,60222,3594,5.6
42,15,Bradford,2001,31825,30248,1577,5.0
42,17,Bucks,2001,336114,322735,13379,4.0
42,19,Butler,2001,91782,87544,4238,4.6
42,21,Cambria,2001,66701,62282,4419,6.6
42,23,Cameron,2001,2643,2418,225,8.5
42,25,Carbon,2001,29574,27878,1696,5.7
42,27,Centre,2001,70587,67911,2676,3.8
42,29,Chester,2001,242022,233798,8224,3.4
42,31,Clarion,2001,19670,18695,975,5.0
42,33,Clearfield,2001,40311,37528,2783,6.9
42,35,Clinton,2001,18485,17312,1173,6.3
42,37,Columbia,2001,32042,30182,1860,5.8
42,39,Crawford,2001,43035,40317,2718,6.3
42,41,Cumberland,2001,115934,111513,4421,3.8
42,43,Dauphin,2001,133019,127358,5661,4.3
42,45,Delaware,2001,280813,269069,11744,4.2
42,47,Elk,2001,18049,16755,1294,7.2
42,49,Erie,2001,140241,132541,7700,5.5
42,51,Fayette,2001,65391,61318,4073,6.2
42,53,Forest,2001,2229,1946,283,12.7
42,55,Franklin,2001,67956,64847,3109,4.6
42,57,Fulton,2001,7438,6991,447,6.0
42,59,Greene,2001,17067,16094,973,5.7
42,61,Huntingdon,2001,21608,19947,1661,7.7
42,63,Indiana,2001,43052,40772,2280,5.3
42,65,Jefferson,2001,21435,20042,1393,6.5
42,67,Juniata,2001,11718,11171,547,4.7
42,69,Lackawanna,2001,105062,99259,5803,5.5
42,71,Lancaster,2001,255443,246705,8738,3.4
42,73,Lawrence,2001,44346,41864,2482,5.6
42,75,Lebanon,2001,65931,63554,2377,3.6
42,77,Lehigh,2001,166069,158749,7320,4.4
42,79,Luzerne,2001,155938,147158,8780,5.6
42,81,Lycoming,2001,60206,56964,3242,5.4
42,83,McKean,2001,22114,20889,1225,5.5
42,85,Mercer,2001,55799,52827,2972,5.3
42,87,Mifflin,2001,22014,20637,1377,6.3
42,89,Monroe,2001,71396,68009,3387,4.7
42,91,Montgomery,2001,418294,402745,15549,3.7
42,93,Montour,2001,8637,8271,366,4.2
42,95,Northampton,2001,141098,134971,6127,4.3
42,97,Northumberland,2001,45583,43124,2459,5.4
42,99,Perry,2001,23715,22664,1051,4.4
42,101,Philadelphia/city,2001,637221,598203,39018,6.1
42,103,Pike,2001,22271,21203,1068,4.8
42,105,Potter,2001,8994,8551,443,4.9
42,107,Schuylkill,2001,70147,65580,4567,6.5
42,109,Snyder,2001,19098,18295,803,4.2
42,111,Somerset,2001,38225,35985,2240,5.9
42,113,Sullivan,2001,3081,2915,166,5.4
42,115,Susquehanna,2001,21182,19984,1198,5.7
42,117,Tioga,2001,20508,19221,1287,6.3
42,119,Union,2001,17663,16850,813,4.6
42,121,Venango,2001,26587,25192,1395,5.2
42,123,Warren,2001,22576,21528,1048,4.6
42,125,Washington,2001,100733,95573,5160,5.1
42,127,Wayne,2001,22999,21867,1132,4.9
42,129,Westmoreland,2001,185067,175587,9480,5.1
42,131,Wyoming,2001,13991,13263,728,5.2
42,133,York,2001,211323,202249,9074,4.3
44,1,Bristol,2001,26609,25643,966,3.6
44,3,Kent,2001,92447,88679,3768,4.1
44,5,Newport,2001,44257,42584,1673,3.8
44,7,Providence,2001,309256,293939,15317,5.0
44,9,Washington,2001,69094,66688,2406,3.5
45,1,Abbeville,2001,12257,11437,820,6.7
45,3,Aiken,2001,68145,64698,3447,5.1
45,5,Allendale,2001,3616,3392,224,6.2
45,7,Anderson,2001,82821,78323,4498,5.4
45,9,Bamberg,2001,6375,5948,427,6.7
45,11,Barnwell,2001,9933,9231,702,7.1
45,13,Beaufort,2001,51064,49059,2005,3.9
45,15,Berkeley,2001,64441,61570,2871,4.5
45,17,Calhoun,2001,7021,6599,422,6.0
45,19,Charleston,2001,149278,142994,6284,4.2
45,21,Cherokee,2001,25366,23563,1803,7.1
45,23,Chester,2001,16194,14931,1263,7.8
45,25,Chesterfield,2001,18804,17379,1425,7.6
45,27,Clarendon,2001,12632,11663,969,7.7
45,29,Colleton,2001,15678,14875,803,5.1
45,31,Darlington,2001,30690,28725,1965,6.4
45,33,Dillon,2001,12918,11712,1206,9.3
45,35,Dorchester,2001,46791,44838,1953,4.2
45,37,Edgefield,2001,10146,9650,496,4.9
45,39,Fairfield,2001,11129,10179,950,8.5
45,41,Florence,2001,58898,55603,3295,5.6
45,43,Georgetown,2001,26013,24057,1956,7.5
45,45,Greenville,2001,201361,193669,7692,3.8
45,47,Greenwood,2001,32473,30213,2260,7.0
45,49,Hampton,2001,8056,7550,506,6.3
45,51,Horry,2001,102794,97649,5145,5.0
45,53,Jasper,2001,9006,8607,399,4.4
45,55,Kershaw,2001,26806,25401,1405,5.2
45,57,Lancaster,2001,29872,28218,1654,5.5
45,59,Laurens,2001,34033,31788,2245,6.6
45,61,Lee,2001,8117,7534,583,7.2
45,63,Lexington,2001,116699,112474,4225,3.6
45,65,McCormick,2001,3675,3314,361,9.8
45,67,Marion,2001,14513,12706,1807,12.5
45,69,Marlboro,2001,12288,11100,1188,9.7
45,71,Newberry,2001,17098,16014,1084,6.3
45,73,Oconee,2001,32003,30238,1765,5.5
45,75,Orangeburg,2001,39673,36210,3463,8.7
45,77,Pickens,2001,56990,54089,2901,5.1
45,79,Richland,2001,158462,151748,6714,4.2
45,81,Saluda,2001,9190,8702,488,5.3
45,83,Spartanburg,2001,127719,120724,6995,5.5
45,85,Sumter,2001,43304,40424,2880,6.7
45,87,Union,2001,13988,12720,1268,9.1
45,89,Williamsburg,2001,14946,13395,1551,10.4
45,91,York,2001,88686,84336,4350,4.9
46,3,Aurora,2001,1566,1525,41,2.6
46,5,Beadle,2001,9302,9000,302,3.2
46,7,Bennett,2001,1388,1335,53,3.8
46,9,Bon Homme,2001,3335,3223,112,3.4
46,11,Brookings,2001,16997,16544,453,2.7
46,13,Brown,2001,20522,19915,607,3.0
46,15,Brule,2001,2861,2790,71,2.5
46,17,Buffalo,2001,533,488,45,8.4
46,19,Butte,2001,4852,4700,152,3.1
46,21,Campbell,2001,881,840,41,4.7
46,23,Charles Mix,2001,4190,4061,129,3.1
46,25,Clark,2001,2059,1959,100,4.9
46,27,Clay,2001,6955,6764,191,2.7
46,29,Codington,2001,15636,15106,530,3.4
46,31,Corson,2001,1376,1295,81,5.9
46,33,Custer,2001,4315,4174,141,3.3
46,35,Davison,2001,10782,10518,264,2.4
46,37,Day,2001,3056,2901,155,5.1
46,39,Deuel,2001,2534,2435,99,3.9
46,41,Dewey,2001,2441,2223,218,8.9
46,43,Douglas,2001,1711,1668,43,2.5
46,45,Edmunds,2001,2133,2074,59,2.8
46,47,Fall River,2001,3621,3482,139,3.8
46,49,Faulk,2001,1205,1171,34,2.8
46,51,Grant,2001,4177,4024,153,3.7
46,53,Gregory,2001,2421,2339,82,3.4
46,55,Haakon,2001,1234,1207,27,2.2
46,57,Hamlin,2001,2811,2715,96,3.4
46,59,Hand,2001,1973,1923,50,2.5
46,61,Hanson,2001,1739,1695,44,2.5
46,63,Harding,2001,765,745,20,2.6
46,65,Hughes,2001,9811,9590,221,2.3
46,67,Hutchinson,2001,3882,3761,121,3.1
46,69,Hyde,2001,857,835,22,2.6
46,71,Jackson,2001,1186,1132,54,4.6
46,73,Jerauld,2001,1281,1244,37,2.9
46,75,Jones,2001,730,716,14,1.9
46,77,Kingsbury,2001,3056,2962,94,3.1
46,79,Lake,2001,6680,6491,189,2.8
46,81,Lawrence,2001,11550,11188,362,3.1
46,83,Lincoln,2001,15413,15089,324,2.1
46,85,Lyman,2001,1952,1870,82,4.2
46,87,McCook,2001,2990,2901,89,3.0
46,89,McPherson,2001,1287,1244,43,3.3
46,91,Marshall,2001,2096,1986,110,5.2
46,93,Meade,2001,12382,12038,344,2.8
46,95,Mellette,2001,932,895,37,4.0
46,97,Miner,2001,1278,1219,59,4.6
46,99,Minnehaha,2001,89911,87750,2161,2.4
46,101,Moody,2001,3830,3666,164,4.3
46,102,Oglala Lakota,2001,3664,3385,279,7.6
46,103,Pennington,2001,50015,48599,1416,2.8
46,105,Perkins,2001,1784,1734,50,2.8
46,107,Potter,2001,1429,1381,48,3.4
46,109,Roberts,2001,4531,4321,210,4.6
46,111,Sanborn,2001,1499,1455,44,2.9
46,115,Spink,2001,3357,3241,116,3.5
46,117,Stanley,2001,1883,1839,44,2.3
46,119,Sully,2001,907,885,22,2.4
46,121,Todd,2001,3335,3169,166,5.0
46,123,Tripp,2001,3225,3129,96,3.0
46,125,Turner,2001,4729,4599,130,2.7
46,127,Union,2001,7448,7224,224,3.0
46,129,Walworth,2001,2863,2761,102,3.6
46,135,Yankton,2001,11530,11173,357,3.1
46,137,Ziebach,2001,825,762,63,7.6
47,1,Anderson,2001,34372,32807,1565,4.6
47,3,Bedford,2001,19836,18838,998,5.0
47,5,Benton,2001,7090,6592,498,7.0
47,7,Bledsoe,2001,4955,4719,236,4.8
47,9,Blount,2001,55761,53463,2298,4.1
47,11,Bradley,2001,44879,43074,1805,4.0
47,13,Campbell,2001,16200,15214,986,6.1
47,15,Cannon,2001,6373,6120,253,4.0
47,17,Carroll,2001,13872,12871,1001,7.2
47,19,Carter,2001,27617,26282,1335,4.8
47,21,Cheatham,2001,19599,18958,641,3.3
47,23,Chester,2001,7497,7163,334,4.5
47,25,Claiborne,2001,12458,11799,659,5.3
47,27,Clay,2001,3559,3317,242,6.8
47,29,Cocke,2001,15456,14312,1144,7.4
47,31,Coffee,2001,24094,23045,1049,4.4
47,33,Crockett,2001,6711,6340,371,5.5
47,35,Cumberland,2001,20810,19489,1321,6.3
47,37,Davidson,2001,306621,295926,10695,3.5
47,39,Decatur,2001,5512,5132,380,6.9
47,41,DeKalb,2001,8481,8039,442,5.2
47,43,Dickson,2001,22203,21250,953,4.3
47,45,Dyer,2001,17571,16446,1125,6.4
47,47,Fayette,2001,14551,13785,766,5.3
47,49,Fentress,2001,6728,6153,575,8.5
47,51,Franklin,2001,19162,18386,776,4.0
47,53,Gibson,2001,22581,20882,1699,7.5
47,55,Giles,2001,14806,13912,894,6.0
47,57,Grainger,2001,9743,9185,558,5.7
47,59,Greene,2001,30841,28567,2274,7.4
47,61,Grundy,2001,5538,5230,308,5.6
47,63,Hamblen,2001,29876,28145,1731,5.8
47,65,Hamilton,2001,158700,153105,5595,3.5
47,67,Hancock,2001,2551,2374,177,6.9
47,69,Hardeman,2001,10988,10231,757,6.9
47,71,Hardin,2001,11454,10746,708,6.2
47,73,Hawkins,2001,25070,23788,1282,5.1
47,75,Haywood,2001,9345,8681,664,7.1
47,77,Henderson,2001,12536,11697,839,6.7
47,79,Henry,2001,14650,13782,868,5.9
47,81,Hickman,2001,9864,9375,489,5.0
47,83,Houston,2001,3620,3368,252,7.0
47,85,Humphreys,2001,8746,8198,548,6.3
47,87,Jackson,2001,5015,4730,285,5.7
47,89,Jefferson,2001,22497,21333,1164,5.2
47,91,Johnson,2001,6761,6244,517,7.6
47,93,Knox,2001,205581,198963,6618,3.2
47,95,Lake,2001,2573,2408,165,6.4
47,97,Lauderdale,2001,10998,10150,848,7.7
47,99,Lawrence,2001,18601,16906,1695,9.1
47,101,Lewis,2001,5275,4932,343,6.5
47,103,Lincoln,2001,15853,15177,676,4.3
47,105,Loudon,2001,20153,19328,825,4.1
47,107,McMinn,2001,23321,21767,1554,6.7
47,109,McNairy,2001,11964,11279,685,5.7
47,111,Macon,2001,10454,9876,578,5.5
47,113,Madison,2001,45950,43695,2255,4.9
47,115,Marion,2001,13024,12360,664,5.1
47,117,Marshall,2001,13830,13124,706,5.1
47,119,Maury,2001,36572,35094,1478,4.0
47,121,Meigs,2001,4813,4501,312,6.5
47,123,Monroe,2001,17360,16145,1215,7.0
47,125,Montgomery,2001,59841,57262,2579,4.3
47,127,Moore,2001,2995,2887,108,3.6
47,129,Morgan,2001,7722,7259,463,6.0
47,131,Obion,2001,16538,15796,742,4.5
47,133,Overton,2001,9532,8952,580,6.1
47,135,Perry,2001,3354,3123,231,6.9
47,137,Pickett,2001,2140,1954,186,8.7
47,139,Polk,2001,7387,7036,351,4.8
47,141,Putnam,2001,31637,30193,1444,4.6
47,143,Rhea,2001,12823,12123,700,5.5
47,145,Roane,2001,24936,23799,1137,4.6
47,147,Robertson,2001,29998,28749,1249,4.2
47,149,Rutherford,2001,105013,101216,3797,3.6
47,151,Scott,2001,8779,8196,583,6.6
47,153,Sequatchie,2001,5386,5133,253,4.7
47,155,Sevier,2001,40036,37896,2140,5.3
47,157,Shelby,2001,437976,419205,18771,4.3
47,159,Smith,2001,8894,8469,425,4.8
47,161,Stewart,2001,5592,5297,295,5.3
47,163,Sullivan,2001,73169,70138,3031,4.1
47,165,Sumner,2001,71681,68524,3157,4.4
47,167,Tipton,2001,25744,24579,1165,4.5
47,169,Trousdale,2001,3596,3400,196,5.5
47,171,Unicoi,2001,8143,7664,479,5.9
47,173,Union,2001,8392,8042,350,4.2
47,175,Van Buren,2001,2609,2449,160,6.1
47,177,Warren,2001,18771,17561,1210,6.4
47,179,Washington,2001,55232,52652,2580,4.7
47,181,Wayne,2001,6720,6114,606,9.0
47,183,Weakley,2001,17053,16073,980,5.7
47,185,White,2001,10572,9963,609,5.8
47,187,Williamson,2001,71480,69509,1971,2.8
47,189,Wilson,2001,50453,48612,1841,3.6
48,1,Anderson,2001,19907,18719,1188,6.0
48,3,Andrews,2001,5678,5437,241,4.2
48,5,Angelina,2001,38591,36490,2101,5.4
48,7,Aransas,2001,9901,9265,636,6.4
48,9,Archer,2001,5014,4852,162,3.2
48,11,Armstrong,2001,1086,1050,36,3.3
48,13,Atascosa,2001,17732,16914,818,4.6
48,15,Austin,2001,12194,11712,482,4.0
48,17,Bailey,2001,3319,3162,157,4.7
48,19,Bandera,2001,8933,8575,358,4.0
48,21,Bastrop,2001,30544,29133,1411,4.6
48,23,Baylor,2001,1854,1764,90,4.9
48,25,Bee,2001,11359,10674,685,6.0
48,27,Bell,2001,103024,98027,4997,4.9
48,29,Bexar,2001,671347,640299,31048,4.6
48,31,Blanco,2001,4419,4255,164,3.7
48,33,Borden,2001,441,427,14,3.2
48,35,Bosque,2001,8041,7641,400,5.0
48,37,Bowie,2001,40561,38496,2065,5.1
48,39,Brazoria,2001,122430,116299,6131,5.0
48,41,Brazos,2001,79924,76894,3030,3.8
48,43,Brewster,2001,4724,4533,191,4.0
48,45,Briscoe,2001,868,833,35,4.0
48,47,Brooks,2001,3113,2928,185,5.9
48,49,Brown,2001,17879,17036,843,4.7
48,51,Burleson,2001,7941,7630,311,3.9
48,53,Burnet,2001,17970,17213,757,4.2
48,55,Caldwell,2001,15281,14521,760,5.0
48,57,Calhoun,2001,9460,8806,654,6.9
48,59,Callahan,2001,6237,5968,269,4.3
48,61,Cameron,2001,131078,120830,10248,7.8
48,63,Camp,2001,5292,5004,288,5.4
48,65,Carson,2001,3297,3180,117,3.5
48,67,Cass,2001,13458,12586,872,6.5
48,69,Castro,2001,3897,3739,158,4.1
48,71,Chambers,2001,13303,12707,596,4.5
48,73,Cherokee,2001,20779,19731,1048,5.0
48,75,Childress,2001,3078,2927,151,4.9
48,77,Clay,2001,6140,5932,208,3.4
48,79,Cochran,2001,1604,1515,89,5.5
48,81,Coke,2001,1627,1554,73,4.5
48,83,Coleman,2001,4171,3964,207,5.0
48,85,Collin,2001,318524,305308,13216,4.1
48,87,Collingsworth,2001,1641,1580,61,3.7
48,89,Colorado,2001,9876,9454,422,4.3
48,91,Comal,2001,42037,40233,1804,4.3
48,93,Comanche,2001,6797,6521,276,4.1
48,95,Concho,2001,1450,1375,75,5.2
48,97,Cooke,2001,18948,18041,907,4.8
48,99,Coryell,2001,23951,22518,1433,6.0
48,101,Cottle,2001,961,915,46,4.8
48,103,Crane,2001,1485,1412,73,4.9
48,105,Crockett,2001,2041,1970,71,3.5
48,107,Crosby,2001,2988,2840,148,5.0
48,109,Culberson,2001,1547,1474,73,4.7
48,111,Dallam,2001,3310,3208,102,3.1
48,113,Dallas,2001,1193404,1130241,63163,5.3
48,115,Dawson,2001,5976,5658,318,5.3
48,117,Deaf Smith,2001,8235,7859,376,4.6
48,119,Delta,2001,2512,2377,135,5.4
48,121,Denton,2001,277368,267619,9749,3.5
48,123,DeWitt,2001,9256,8839,417,4.5
48,125,Dickens,2001,1102,1048,54,4.9
48,127,Dimmit,2001,3878,3578,300,7.7
48,129,Donley,2001,1881,1799,82,4.4
48,131,Duval,2001,5226,4891,335,6.4
48,133,Eastland,2001,8704,8278,426,4.9
48,135,Ector,2001,57652,54829,2823,4.9
48,137,Edwards,2001,1040,993,47,4.5
48,139,Ellis,2001,60942,58282,2660,4.4
48,141,El Paso,2001,275534,255531,20003,7.3
48,143,Erath,2001,16954,16304,650,3.8
48,145,Falls,2001,7237,6837,400,5.5
48,147,Fannin,2001,13890,12985,905,6.5
48,149,Fayette,2001,11828,11404,424,3.6
48,151,Fisher,2001,2182,2096,86,3.9
48,153,Floyd,2001,3480,3286,194,5.6
48,155,Foard,2001,783,753,30,3.8
48,157,Fort Bend,2001,194327,186778,7549,3.9
48,159,Franklin,2001,4627,4434,193,4.2
48,161,Freestone,2001,8828,8435,393,4.5
48,163,Frio,2001,6235,5829,406,6.5
48,165,Gaines,2001,6315,6030,285,4.5
48,167,Galveston,2001,129890,123145,6745,5.2
48,169,Garza,2001,2330,2243,87,3.7
48,171,Gillespie,2001,10849,10474,375,3.5
48,173,Glasscock,2001,742,720,22,3.0
48,175,Goliad,2001,3324,3185,139,4.2
48,177,Gonzales,2001,9246,8908,338,3.7
48,179,Gray,2001,10150,9703,447,4.4
48,181,Grayson,2001,55980,53017,2963,5.3
48,183,Gregg,2001,55965,52907,3058,5.5
48,185,Grimes,2001,9958,9407,551,5.5
48,187,Guadalupe,2001,46506,44717,1789,3.8
48,189,Hale,2001,17148,16352,796,4.6
48,191,Hall,2001,1742,1648,94,5.4
48,193,Hamilton,2001,4214,4055,159,3.8
48,195,Hansford,2001,2876,2792,84,2.9
48,197,Hardeman,2001,2442,2349,93,3.8
48,199,Hardin,2001,23353,21910,1443,6.2
48,201,Harris,2001,1752447,1670340,82107,4.7
48,203,Harrison,2001,29207,27617,1590,5.4
48,205,Hartley,2001,2456,2377,79,3.2
48,207,Haskell,2001,3119,2996,123,3.9
48,209,Hays,2001,57991,55719,2272,3.9
48,211,Hemphill,2001,1976,1923,53,2.7
48,213,Henderson,2001,33173,31640,1533,4.6
48,215,Hidalgo,2001,219379,198331,21048,9.6
48,217,Hill,2001,15311,14445,866,5.7
48,219,Hockley,2001,11313,10870,443,3.9
48,221,Hood,2001,20604,19656,948,4.6
48,223,Hopkins,2001,16265,15533,732,4.5
48,225,Houston,2001,9553,9049,504,5.3
48,227,Howard,2001,13991,13293,698,5.0
48,229,Hudspeth,2001,1312,1242,70,5.3
48,231,Hunt,2001,38694,36804,1890,4.9
48,233,Hutchinson,2001,11137,10661,476,4.3
48,235,Irion,2001,932,902,30,3.2
48,237,Jack,2001,3791,3627,164,4.3
48,239,Jackson,2001,6870,6564,306,4.5
48,241,Jasper,2001,15552,14222,1330,8.6
48,243,Jeff Davis,2001,1202,1157,45,3.7
48,245,Jefferson,2001,111525,103599,7926,7.1
48,247,Jim Hogg,2001,2205,2100,105,4.8
48,249,Jim Wells,2001,17465,16494,971,5.6
48,251,Johnson,2001,67525,64561,2964,4.4
48,253,Jones,2001,7560,7170,390,5.2
48,255,Karnes,2001,5391,5091,300,5.6
48,257,Kaufman,2001,38751,36781,1970,5.1
48,259,Kendall,2001,12414,11938,476,3.8
48,261,Kenedy,2001,208,201,7,3.4
48,263,Kent,2001,441,427,14,3.2
48,265,Kerr,2001,19498,18665,833,4.3
48,267,Kimble,2001,2292,2217,75,3.3
48,269,King,2001,239,232,7,2.9
48,271,Kinney,2001,1257,1171,86,6.8
48,273,Kleberg,2001,14069,13362,707,5.0
48,275,Knox,2001,1858,1779,79,4.3
48,277,Lamar,2001,22892,21462,1430,6.2
48,279,Lamb,2001,7223,6836,387,5.4
48,281,Lampasas,2001,8853,8468,385,4.3
48,283,La Salle,2001,2217,2066,151,6.8
48,285,Lavaca,2001,9411,9097,314,3.3
48,287,Lee,2001,8316,7975,341,4.1
48,289,Leon,2001,7170,6803,367,5.1
48,291,Liberty,2001,30679,28802,1877,6.1
48,293,Limestone,2001,9859,9393,466,4.7
48,295,Lipscomb,2001,1491,1441,50,3.4
48,297,Live Oak,2001,4960,4738,222,4.5
48,299,Llano,2001,7501,7150,351,4.7
48,301,Loving,2001,48,45,3,6.3
48,303,Lubbock,2001,131373,126565,4808,3.7
48,305,Lynn,2001,3041,2894,147,4.8
48,307,McCulloch,2001,3666,3451,215,5.9
48,309,McLennan,2001,104007,99070,4937,4.7
48,311,McMullen,2001,439,422,17,3.9
48,313,Madison,2001,4945,4689,256,5.2
48,315,Marion,2001,4616,4313,303,6.6
48,317,Martin,2001,2187,2098,89,4.1
48,319,Mason,2001,2105,2044,61,2.9
48,321,Matagorda,2001,17454,16113,1341,7.7
48,323,Maverick,2001,16617,13697,2920,17.6
48,325,Medina,2001,18243,17426,817,4.5
48,327,Menard,2001,1134,1083,51,4.5
48,329,Midland,2001,59839,57588,2251,3.8
48,331,Milam,2001,11778,11249,529,4.5
48,333,Mills,2001,2463,2375,88,3.6
48,335,Mitchell,2001,3451,3253,198,5.7
48,337,Montague,2001,9021,8602,419,4.6
48,339,Montgomery,2001,160158,153864,6294,3.9
48,341,Moore,2001,10072,9736,336,3.3
48,343,Morris,2001,5928,5519,409,6.9
48,345,Motley,2001,679,655,24,3.5
48,347,Nacogdoches,2001,29735,28342,1393,4.7
48,349,Navarro,2001,21177,20026,1151,5.4
48,351,Newton,2001,5960,5371,589,9.9
48,353,Nolan,2001,7223,6855,368,5.1
48,355,Nueces,2001,149295,141399,7896,5.3
48,357,Ochiltree,2001,4939,4788,151,3.1
48,359,Oldham,2001,1170,1134,36,3.1
48,361,Orange,2001,40500,37282,3218,7.9
48,363,Palo Pinto,2001,13296,12674,622,4.7
48,365,Panola,2001,10645,10058,587,5.5
48,367,Parker,2001,46873,45039,1834,3.9
48,369,Parmer,2001,4605,4437,168,3.6
48,371,Pecos,2001,7013,6657,356,5.1
48,373,Polk,2001,16013,15018,995,6.2
48,375,Potter,2001,53044,50183,2861,5.4
48,377,Presidio,2001,3304,2795,509,15.4
48,379,Rains,2001,4466,4242,224,5.0
48,381,Randall,2001,60452,58901,1551,2.6
48,383,Reagan,2001,1666,1611,55,3.3
48,385,Real,2001,1309,1236,73,5.6
48,387,Red River,2001,6698,6149,549,8.2
48,389,Reeves,2001,4992,4626,366,7.3
48,391,Refugio,2001,3639,3474,165,4.5
48,393,Roberts,2001,521,508,13,2.5
48,395,Robertson,2001,7110,6762,348,4.9
48,397,Rockwall,2001,25781,24733,1048,4.1
48,399,Runnels,2001,5208,4973,235,4.5
48,401,Rusk,2001,21329,20233,1096,5.1
48,403,Sabine,2001,3752,3363,389,10.4
48,405,San Augustine,2001,3790,3576,214,5.6
48,407,San Jacinto,2001,9535,9058,477,5.0
48,409,San Patricio,2001,27727,26072,1655,6.0
48,411,San Saba,2001,2871,2745,126,4.4
48,413,Schleicher,2001,1576,1525,51,3.2
48,415,Scurry,2001,7238,6857,381,5.3
48,417,Shackelford,2001,1738,1683,55,3.2
48,419,Shelby,2001,11744,11102,642,5.5
48,421,Sherman,2001,1688,1641,47,2.8
48,423,Smith,2001,87394,83117,4277,4.9
48,425,Somervell,2001,3455,3302,153,4.4
48,427,Starr,2001,18642,15690,2952,15.8
48,429,Stephens,2001,4340,4160,180,4.1
48,431,Sterling,2001,760,733,27,3.6
48,433,Stonewall,2001,854,817,37,4.3
48,435,Sutton,2001,2265,2190,75,3.3
48,437,Swisher,2001,3908,3744,164,4.2
48,439,Tarrant,2001,802804,767345,35459,4.4
48,441,Taylor,2001,61618,58908,2710,4.4
48,443,Terrell,2001,495,470,25,5.1
48,445,Terry,2001,5779,5469,310,5.4
48,447,Throckmorton,2001,989,958,31,3.1
48,449,Titus,2001,13375,12774,601,4.5
48,451,Tom Green,2001,51359,49370,1989,3.9
48,453,Travis,2001,493726,472125,21601,4.4
48,455,Trinity,2001,5641,5310,331,5.9
48,457,Tyler,2001,8118,7528,590,7.3
48,459,Upshur,2001,16817,15942,875,5.2
48,461,Upton,2001,1570,1505,65,4.1
48,463,Uvalde,2001,11365,10630,735,6.5
48,465,Val Verde,2001,17725,16614,1111,6.3
48,467,Van Zandt,2001,23132,22086,1046,4.5
48,469,Victoria,2001,43214,41375,1839,4.3
48,471,Walker,2001,25052,23730,1322,5.3
48,473,Waller,2001,15436,14746,690,4.5
48,475,Ward,2001,4473,4220,253,5.7
48,477,Washington,2001,15186,14632,554,3.6
48,479,Webb,2001,73156,68366,4790,6.5
48,481,Wharton,2001,20391,19451,940,4.6
48,483,Wheeler,2001,2727,2622,105,3.9
48,485,Wichita,2001,62049,59254,2795,4.5
48,487,Wilbarger,2001,7338,7065,273,3.7
48,489,Willacy,2001,7236,6445,791,10.9
48,491,Williamson,2001,153910,147603,6307,4.1
48,493,Wilson,2001,15872,15202,670,4.2
48,495,Winkler,2001,2944,2780,164,5.6
48,497,Wise,2001,25886,24829,1057,4.1
48,499,Wood,2001,16390,15486,904,5.5
48,501,Yoakum,2001,3505,3354,151,4.3
48,503,Young,2001,8755,8323,432,4.9
48,505,Zapata,2001,4156,3854,302,7.3
48,507,Zavala,2001,3750,3252,498,13.3
49,1,Beaver,2001,2972,2859,113,3.8
49,3,Box Elder,2001,20472,19539,933,4.6
49,5,Cache,2001,50039,48335,1704,3.4
49,7,Carbon,2001,9068,8494,574,6.3
49,9,Daggett,2001,470,448,22,4.7
49,11,Davis,2001,121857,116947,4910,4.0
49,13,Duchesne,2001,6759,6408,351,5.2
49,15,Emery,2001,4758,4443,315,6.6
49,17,Garfield,2001,2573,2370,203,7.9
49,19,Grand,2001,4723,4398,325,6.9
49,21,Iron,2001,17228,16457,771,4.5
49,23,Juab,2001,3771,3588,183,4.9
49,25,Kane,2001,3165,3031,134,4.2
49,27,Millard,2001,5644,5415,229,4.1
49,29,Morgan,2001,3460,3327,133,3.8
49,31,Piute,2001,771,727,44,5.7
49,33,Rich,2001,1172,1135,37,3.2
49,35,Salt Lake,2001,492037,470706,21331,4.3
49,37,San Juan,2001,4573,4193,380,8.3
49,39,Sanpete,2001,10055,9523,532,5.3
49,41,Sevier,2001,8566,8175,391,4.6
49,43,Summit,2001,18861,17993,868,4.6
49,45,Tooele,2001,21373,20361,1012,4.7
49,47,Uintah,2001,12198,11660,538,4.4
49,49,Utah,2001,183274,175838,7436,4.1
49,51,Wasatch,2001,7899,7545,354,4.5
49,53,Washington,2001,41978,40265,1713,4.1
49,55,Wayne,2001,1441,1368,73,5.1
49,57,Weber,2001,101717,96499,5218,5.1
50,1,Addison,2001,20490,19865,625,3.1
50,3,Bennington,2001,20076,19317,759,3.8
50,5,Caledonia,2001,15683,15064,619,3.9
50,7,Chittenden,2001,85354,82969,2385,2.8
50,9,Essex,2001,3259,3121,138,4.2
50,11,Franklin,2001,24754,23863,891,3.6
50,13,Grand Isle,2001,3871,3711,160,4.1
50,15,Lamoille,2001,13470,12989,481,3.6
50,17,Orange,2001,15736,15293,443,2.8
50,19,Orleans,2001,13320,12635,685,5.1
50,21,Rutland,2001,34062,32870,1192,3.5
50,23,Washington,2001,32744,31652,1092,3.3
50,25,Windham,2001,24150,23379,771,3.2
50,27,Windsor,2001,31152,30242,910,2.9
51,1,Accomack,2001,18404,17770,634,3.4
51,3,Albemarle,2001,44286,43307,979,2.2
51,5,Alleghany,2001,7821,7487,334,4.3
51,7,Amelia,2001,5937,5783,154,2.6
51,9,Amherst,2001,15224,14657,567,3.7
51,11,Appomattox,2001,6752,6453,299,4.4
51,13,Arlington,2001,119527,116579,2948,2.5
51,15,Augusta,2001,35284,34281,1003,2.8
51,17,Bath,2001,2724,2620,104,3.8
51,19,Bedford,2001,34400,33234,1166,3.4
51,21,Bland,2001,3059,2882,177,5.8
51,23,Botetourt,2001,16732,16276,456,2.7
51,25,Brunswick,2001,6882,6501,381,5.5
51,27,Buchanan,2001,8912,8364,548,6.1
51,29,Buckingham,2001,6223,6004,219,3.5
51,31,Campbell,2001,26219,25077,1142,4.4
51,33,Caroline,2001,11106,10761,345,3.1
51,35,Carroll,2001,14882,13835,1047,7.0
51,36,Charles City,2001,3710,3525,185,5.0
51,37,Charlotte,2001,5497,5255,242,4.4
51,41,Chesterfield,2001,145397,141551,3846,2.6
51,43,Clarke,2001,7087,6925,162,2.3
51,45,Craig,2001,2513,2438,75,3.0
51,47,Culpeper,2001,17402,16938,464,2.7
51,49,Cumberland,2001,4226,4105,121,2.9
51,51,Dickenson,2001,5511,5116,395,7.2
51,53,Dinwiddie,2001,12016,11645,371,3.1
51,57,Essex,2001,5274,5099,175,3.3
51,59,Fairfax,2001,557687,543243,14444,2.6
51,61,Fauquier,2001,31164,30480,684,2.2
51,63,Floyd,2001,6877,6575,302,4.4
51,65,Fluvanna,2001,10669,10398,271,2.5
51,67,Franklin,2001,25014,23981,1033,4.1
51,69,Frederick,2001,33705,32741,964,2.9
51,71,Giles,2001,7943,7482,461,5.8
51,73,Gloucester,2001,18171,17716,455,2.5
51,75,Goochland,2001,9154,8920,234,2.6
51,77,Grayson,2001,7968,7353,615,7.7
51,79,Greene,2001,8641,8439,202,2.3
51,81,Greensville,2001,4110,3916,194,4.7
51,83,Halifax,2001,16788,15535,1253,7.5
51,85,Hanover,2001,48819,47566,1253,2.6
51,87,Henrico,2001,148127,143675,4452,3.0
51,89,Henry,2001,28647,26910,1737,6.1
51,91,Highland,2001,1141,1104,37,3.2
51,93,Isle of Wight,2001,15441,15020,421,2.7
51,95,James City,2001,24337,23706,631,2.6
51,97,King and Queen,2001,3166,3059,107,3.4
51,99,King George,2001,8747,8528,219,2.5
51,101,King William,2001,7235,7018,217,3.0
51,103,Lancaster,2001,4956,4645,311,6.3
51,105,Lee,2001,9086,8625,461,5.1
51,107,Loudoun,2001,109714,106914,2800,2.6
51,109,Louisa,2001,13219,12799,420,3.2
51,111,Lunenburg,2001,5416,5167,249,4.6
51,113,Madison,2001,6810,6655,155,2.3
51,115,Mathews,2001,4369,4236,133,3.0
51,117,Mecklenburg,2001,14222,13375,847,6.0
51,119,Middlesex,2001,4645,4519,126,2.7
51,121,Montgomery,2001,41075,39685,1390,3.4
51,125,Nelson,2001,7141,6901,240,3.4
51,127,New Kent,2001,7558,7326,232,3.1
51,131,Northampton,2001,5687,5473,214,3.8
51,133,Northumberland,2001,5520,5235,285,5.2
51,135,Nottoway,2001,6284,6029,255,4.1
51,137,Orange,2001,12970,12613,357,2.8
51,139,Page,2001,12200,11781,419,3.4
51,141,Patrick,2001,9623,9105,518,5.4
51,143,Pittsylvania,2001,32617,30662,1955,6.0
51,145,Powhatan,2001,11593,11295,298,2.6
51,147,Prince Edward,2001,8258,7904,354,4.3
51,149,Prince George,2001,13634,13147,487,3.6
51,153,Prince William,2001,161154,157096,4058,2.5
51,155,Pulaski,2001,17802,16513,1289,7.2
51,157,Rappahannock,2001,3751,3660,91,2.4
51,159,Richmond,2001,3452,3306,146,4.2
51,161,Roanoke,2001,46628,45459,1169,2.5
51,163,Rockbridge,2001,10913,10585,328,3.0
51,165,Rockingham,2001,36997,36080,917,2.5
51,167,Russell,2001,11945,11165,780,6.5
51,169,Scott,2001,9798,9336,462,4.7
51,171,Shenandoah,2001,18839,18370,469,2.5
51,173,Smyth,2001,15620,14604,1016,6.5
51,175,Southampton,2001,7433,7188,245,3.3
51,177,Spotsylvania,2001,51071,49972,1099,2.2
51,179,Stafford,2001,50879,49728,1151,2.3
51,181,Surry,2001,3467,3350,117,3.4
51,183,Sussex,2001,4485,4269,216,4.8
51,185,Tazewell,2001,19447,18469,978,5.0
51,187,Warren,2001,16848,16366,482,2.9
51,191,Washington,2001,25620,24297,1323,5.2
51,193,Westmoreland,2001,7700,7378,322,4.2
51,195,Wise,2001,16440,15650,790,4.8
51,197,Wythe,2001,14369,13371,998,6.9
51,199,York,2001,28047,27335,712,2.5
51,510,Alexandria city,2001,81870,79602,2268,2.8
51,520,Bristol city,2001,7609,7284,325,4.3
51,530,Buena Vista city,2001,3304,3188,116,3.5
51,540,Charlottesville city,2001,19155,18451,704,3.7
51,550,Chesapeake city,2001,101434,98387,3047,3.0
51,570,Colonial Heights city,2001,8705,8422,283,3.3
51,580,Covington city,2001,2990,2844,146,4.9
51,590,Danville city,2001,21524,19995,1529,7.1
51,595,Emporia city,2001,2415,2311,104,4.3
51,600,Fairfax city,2001,12573,12366,207,1.6
51,610,Falls Church city,2001,6239,6067,172,2.8
51,620,Franklin city,2001,3560,3401,159,4.5
51,630,Fredericksburg city,2001,10611,10224,387,3.6
51,640,Galax city,2001,3197,3001,196,6.1
51,650,Hampton city,2001,65173,62846,2327,3.6
51,660,Harrisonburg city,2001,20050,19481,569,2.8
51,670,Hopewell city,2001,10007,9532,475,4.7
51,678,Lexington city,2001,2324,2230,94,4.0
51,680,Lynchburg city,2001,30114,28837,1277,4.2
51,683,Manassas city,2001,19704,19067,637,3.2
51,685,Manassas Park city,2001,6011,5899,112,1.9
51,690,Martinsville city,2001,6643,6112,531,8.0
51,700,Newport News city,2001,84421,81355,3066,3.6
51,710,Norfolk city,2001,95097,90911,4186,4.4
51,720,Norton city,2001,1529,1458,71,4.6
51,730,Petersburg city,2001,14066,13273,793,5.6
51,735,Poquoson city,2001,5899,5756,143,2.4
51,740,Portsmouth city,2001,43670,41709,1961,4.5
51,750,Radford city,2001,7461,7146,315,4.2
51,760,Richmond city,2001,96538,92433,4105,4.3
51,770,Roanoke city,2001,47269,45563,1706,3.6
51,775,Salem city,2001,13042,12662,380,2.9
51,790,Staunton city,2001,11655,11310,345,3.0
51,800,Suffolk city,2001,31115,30125,990,3.2
51,810,Virginia Beach city,2001,211093,204819,6274,3.0
51,820,Waynesboro city,2001,9381,9026,355,3.8
51,830,Williamsburg city,2001,4689,4416,273,5.8
51,840,Winchester city,2001,13122,12693,429,3.3
53,1,Adams,2001,8242,7525,717,8.7
53,3,Asotin,2001,10018,9461,557,5.6
53,5,Benton,2001,78153,73647,4506,5.8
53,7,Chelan,2001,35527,32636,2891,8.1
53,9,Clallam,2001,26140,24080,2060,7.9
53,11,Clark,2001,183663,171155,12508,6.8
53,13,Columbia,2001,1717,1559,158,9.2
53,15,Cowlitz,2001,42996,38944,4052,9.4
53,17,Douglas,2001,17567,16281,1286,7.3
53,19,Ferry,2001,2910,2581,329,11.3
53,21,Franklin,2001,23721,21816,1905,8.0
53,23,Garfield,2001,1075,1020,55,5.1
53,25,Grant,2001,35882,32668,3214,9.0
53,27,Grays Harbor,2001,28949,26286,2663,9.2
53,29,Island,2001,29343,27554,1789,6.1
53,31,Jefferson,2001,12182,11402,780,6.4
53,33,King,2001,1000772,954971,45801,4.6
53,35,Kitsap,2001,107013,100566,6447,6.0
53,37,Kittitas,2001,17402,16247,1155,6.6
53,39,Klickitat,2001,9346,8294,1052,11.3
53,41,Lewis,2001,29426,26885,2541,8.6
53,43,Lincoln,2001,4616,4349,267,5.8
53,45,Mason,2001,20893,19285,1608,7.7
53,47,Okanogan,2001,19204,17280,1924,10.0
53,49,Pacific,2001,8662,7931,731,8.4
53,51,Pend Oreille,2001,4733,4307,426,9.0
53,53,Pierce,2001,340339,318123,22216,6.5
53,55,San Juan,2001,7589,7222,367,4.8
53,57,Skagit,2001,51994,48276,3718,7.2
53,59,Skamania,2001,4961,4410,551,11.1
53,61,Snohomish,2001,331845,315996,15849,4.8
53,63,Spokane,2001,213903,199770,14133,6.6
53,65,Stevens,2001,17453,15846,1607,9.2
53,67,Thurston,2001,109117,102820,6297,5.8
53,69,Wahkiakum,2001,1607,1474,133,8.3
53,71,Walla Walla,2001,27709,25893,1816,6.6
53,73,Whatcom,2001,88943,83137,5806,6.5
53,75,Whitman,2001,18852,18023,829,4.4
53,77,Yakima,2001,111194,100636,10558,9.5
54,1,Barbour,2001,6657,6191,466,7.0
54,3,Berkeley,2001,39885,38253,1632,4.1
54,5,Boone,2001,9564,9036,528,5.5
54,7,Braxton,2001,5693,5306,387,6.8
54,9,Brooke,2001,11533,10928,605,5.2
54,11,Cabell,2001,43785,41539,2246,5.1
54,13,Calhoun,2001,2849,2542,307,10.8
54,15,Clay,2001,3555,3283,272,7.7
54,17,Doddridge,2001,2884,2716,168,5.8
54,19,Fayette,2001,18187,16991,1196,6.6
54,21,Gilmer,2001,2887,2719,168,5.8
54,23,Grant,2001,5643,5378,265,4.7
54,25,Greenbrier,2001,14919,13997,922,6.2
54,27,Hampshire,2001,9176,8814,362,3.9
54,29,Hancock,2001,15202,14492,710,4.7
54,31,Hardy,2001,6745,6481,264,3.9
54,33,Harrison,2001,30607,28899,1708,5.6
54,35,Jackson,2001,12455,11736,719,5.8
54,37,Jefferson,2001,22911,22115,796,3.5
54,39,Kanawha,2001,95232,90549,4683,4.9
54,41,Lewis,2001,7302,6879,423,5.8
54,43,Lincoln,2001,8039,7469,570,7.1
54,45,Logan,2001,13398,12588,810,6.0
54,47,McDowell,2001,6943,6363,580,8.4
54,49,Marion,2001,25923,24519,1404,5.4
54,51,Marshall,2001,15611,14631,980,6.3
54,53,Mason,2001,10304,9505,799,7.8
54,55,Mercer,2001,25333,24006,1327,5.2
54,57,Mineral,2001,12812,12075,737,5.8
54,59,Mingo,2001,8884,8278,606,6.8
54,61,Monongalia,2001,41244,39572,1672,4.1
54,63,Monroe,2001,5748,5474,274,4.8
54,65,Morgan,2001,7219,6910,309,4.3
54,67,Nicholas,2001,10735,10084,651,6.1
54,69,Ohio,2001,21718,20712,1006,4.6
54,71,Pendleton,2001,3695,3509,186,5.0
54,73,Pleasants,2001,3293,3093,200,6.1
54,75,Pocahontas,2001,3947,3667,280,7.1
54,77,Preston,2001,13335,12615,720,5.4
54,79,Putnam,2001,25820,24655,1165,4.5
54,81,Raleigh,2001,32553,30824,1729,5.3
54,83,Randolph,2001,12708,11933,775,6.1
54,85,Ritchie,2001,4522,4203,319,7.1
54,87,Roane,2001,5932,5318,614,10.4
54,89,Summers,2001,4691,4363,328,7.0
54,91,Taylor,2001,6896,6505,391,5.7
54,93,Tucker,2001,3222,3026,196,6.1
54,95,Tyler,2001,3733,3499,234,6.3
54,97,Upshur,2001,10716,10121,595,5.6
54,99,Wayne,2001,17433,16409,1024,5.9
54,101,Webster,2001,3139,2913,226,7.2
54,103,Wetzel,2001,6776,6198,578,8.5
54,105,Wirt,2001,2519,2345,174,6.9
54,107,Wood,2001,41600,39498,2102,5.1
54,109,Wyoming,2001,8480,7930,550,6.5
55,1,Adams,2001,9093,8632,461,5.1
55,3,Ashland,2001,9129,8592,537,5.9
55,5,Barron,2001,25291,24093,1198,4.7
55,7,Bayfield,2001,7948,7501,447,5.6
55,9,Brown,2001,132306,127088,5218,3.9
55,11,Buffalo,2001,8206,7840,366,4.5
55,13,Burnett,2001,8088,7669,419,5.2
55,15,Calumet,2001,24452,23479,973,4.0
55,17,Chippewa,2001,30645,28966,1679,5.5
55,19,Clark,2001,18004,16967,1037,5.8
55,21,Columbia,2001,30642,29316,1326,4.3
55,23,Crawford,2001,9299,8824,475,5.1
55,25,Dane,2001,272937,265366,7571,2.8
55,27,Dodge,2001,47570,45209,2361,5.0
55,29,Door,2001,17068,16268,800,4.7
55,31,Douglas,2001,22634,21515,1119,4.9
55,33,Dunn,2001,22866,21930,936,4.1
55,35,Eau Claire,2001,53818,51704,2114,3.9
55,37,Florence,2001,2653,2530,123,4.6
55,39,Fond du Lac,2001,56371,54069,2302,4.1
55,41,Forest,2001,4936,4630,306,6.2
55,43,Grant,2001,28236,26956,1280,4.5
55,45,Green,2001,20125,19293,832,4.1
55,47,Green Lake,2001,10960,10383,577,5.3
55,49,Iowa,2001,13958,13468,490,3.5
55,51,Iron,2001,3277,3023,254,7.8
55,53,Jackson,2001,9810,9248,562,5.7
55,55,Jefferson,2001,43157,41449,1708,4.0
55,57,Juneau,2001,13145,12308,837,6.4
55,59,Kenosha,2001,81328,77155,4173,5.1
55,61,Kewaunee,2001,11686,11237,449,3.8
55,63,La Crosse,2001,62151,59832,2319,3.7
55,65,Lafayette,2001,9411,9048,363,3.9
55,67,Langlade,2001,11077,10403,674,6.1
55,69,Lincoln,2001,16272,15455,817,5.0
55,71,Manitowoc,2001,47335,44937,2398,5.1
55,73,Marathon,2001,72919,69957,2962,4.1
55,75,Marinette,2001,22673,21322,1351,6.0
55,77,Marquette,2001,7730,7232,498,6.4
55,78,Menominee,2001,1685,1503,182,10.8
55,79,Milwaukee,2001,473934,448487,25447,5.4
55,81,Monroe,2001,22360,21335,1025,4.6
55,83,Oconto,2001,19815,18760,1055,5.3
55,85,Oneida,2001,19998,18896,1102,5.5
55,87,Outagamie,2001,94106,90304,3802,4.0
55,89,Ozaukee,2001,47714,46091,1623,3.4
55,91,Pepin,2001,3987,3815,172,4.3
55,93,Pierce,2001,22877,22119,758,3.3
55,95,Polk,2001,23376,22164,1212,5.2
55,97,Portage,2001,39032,37394,1638,4.2
55,99,Price,2001,8511,8047,464,5.5
55,101,Racine,2001,99576,94049,5527,5.6
55,103,Richland,2001,9782,9374,408,4.2
55,105,Rock,2001,83335,78765,4570,5.5
55,107,Rusk,2001,7939,7469,470,5.9
55,109,St. Croix,2001,39343,37861,1482,3.8
55,111,Sauk,2001,34277,33025,1252,3.7
55,113,Sawyer,2001,8785,8276,509,5.8
55,115,Shawano,2001,22432,21364,1068,4.8
55,117,Sheboygan,2001,64514,62056,2458,3.8
55,119,Taylor,2001,11122,10578,544,4.9
55,121,Trempealeau,2001,15742,14951,791,5.0
55,123,Vernon,2001,14643,13970,673,4.6
55,125,Vilas,2001,11311,10700,611,5.4
55,127,Walworth,2001,54931,52799,2132,3.9
55,129,Washburn,2001,8197,7711,486,5.9
55,131,Washington,2001,70529,67831,2698,3.8
55,133,Waukesha,2001,211507,203911,7596,3.6
55,135,Waupaca,2001,28148,26860,1288,4.6
55,137,Waushara,2001,12366,11715,651,5.3
55,139,Winnebago,2001,91472,88058,3414,3.7
55,141,Wood,2001,41138,39174,1964,4.8
56,1,Albany,2001,18421,17789,632,3.4
56,3,Big Horn,2001,5307,5057,250,4.7
56,5,Campbell,2001,21307,20740,567,2.7
56,7,Carbon,2001,7936,7590,346,4.4
56,9,Converse,2001,6493,6245,248,3.8
56,11,Crook,2001,3098,2990,108,3.5
56,13,Fremont,2001,18038,17126,912,5.1
56,15,Goshen,2001,6115,5872,243,4.0
56,17,Hot Springs,2001,2622,2514,108,4.1
56,19,Johnson,2001,3512,3376,136,3.9
56,21,Laramie,2001,39883,38267,1616,4.1
56,23,Lincoln,2001,7517,7222,295,3.9
56,25,Natrona,2001,36965,35596,1369,3.7
56,27,Niobrara,2001,1211,1163,48,4.0
56,29,Park,2001,14286,13686,600,4.2
56,31,Platte,2001,4153,3980,173,4.2
56,33,Sheridan,2001,14595,14021,574,3.9
56,35,Sublette,2001,3735,3637,98,2.6
56,37,Sweetwater,2001,20770,19962,808,3.9
56,39,Teton,2001,14184,13812,372,2.6
56,41,Uinta,2001,10739,10339,400,3.7
56,43,Washakie,2001,4206,4024,182,4.3
56,45,Weston,2001,3301,3163,138,4.2
72,1,Adjuntas Municipio,2001,5075,4388,687,13.5
72,3,Aguada Municipio,2001,14102,11934,2168,15.4
72,5,Aguadilla Municipio,2001,20096,17138,2958,14.7
72,7,Aguas Buenas Municipio,2001,8735,7699,1036,11.9
72,9,Aibonito Municipio,2001,7460,6569,891,11.9
72,11,Anasco Municipio,2001,9848,8294,1554,15.8
72,13,Arecibo Municipio,2001,32182,28189,3993,12.4
72,15,Arroyo Municipio,2001,4907,4141,766,15.6
72,17,Barceloneta Municipio,2001,7002,5943,1059,15.1
72,19,Barranquitas Municipio,2001,7177,6366,811,11.3
72,21,Bayamon Municipio,2001,81441,74595,6846,8.4
72,23,Cabo Rojo Municipio,2001,17406,15540,1866,10.7
72,25,Caguas Municipio,2001,51890,46533,5357,10.3
72,27,Camuy Municipio,2001,11795,10310,1485,12.6
72,29,Canovanas Municipio,2001,13306,11502,1804,13.6
72,31,Carolina Municipio,2001,74921,68434,6487,8.7
72,33,Catano Municipio,2001,8458,7551,907,10.7
72,35,Cayey Municipio,2001,15239,13435,1804,11.8
72,37,Ceiba Municipio,2001,5722,5026,696,12.2
72,39,Ciales Municipio,2001,4910,4141,769,15.7
72,41,Cidra Municipio,2001,13768,12268,1500,10.9
72,43,Coamo Municipio,2001,11028,9568,1460,13.2
72,45,Comerio Municipio,2001,4800,4111,689,14.4
72,47,Corozal Municipio,2001,9785,8713,1072,11.0
72,49,Culebra Municipio,2001,785,728,57,7.3
72,51,Dorado Municipio,2001,11764,10714,1050,8.9
72,53,Fajardo Municipio,2001,14374,12329,2045,14.2
72,54,Florida Municipio,2001,3472,2948,524,15.1
72,55,Guanica Municipio,2001,5855,4786,1069,18.3
72,57,Guayama Municipio,2001,12437,10694,1743,14.0
72,59,Guayanilla Municipio,2001,6193,5166,1027,16.6
72,61,Guaynabo Municipio,2001,42516,39836,2680,6.3
72,63,Gurabo Municipio,2001,13474,12004,1470,10.9
72,65,Hatillo Municipio,2001,11629,10216,1413,12.2
72,67,Hormigueros Municipio,2001,6232,5539,693,11.1
72,69,Humacao Municipio,2001,19871,17036,2835,14.3
72,71,Isabela Municipio,2001,14232,11985,2247,15.8
72,73,Jayuya Municipio,2001,4302,3691,611,14.2
72,75,Juana Diaz Municipio,2001,14634,12586,2048,14.0
72,77,Juncos Municipio,2001,11810,10236,1574,13.3
72,79,Lajas Municipio,2001,7969,6822,1147,14.4
72,81,Lares Municipio,2001,10191,8867,1324,13.0
72,83,Las Marias Municipio,2001,3640,3045,595,16.3
72,85,Las Piedras Municipio,2001,11566,9818,1748,15.1
72,87,Loiza Municipio,2001,8277,7234,1043,12.6
72,89,Luquillo Municipio,2001,6857,5678,1179,17.2
72,91,Manati Municipio,2001,13597,11637,1960,14.4
72,93,Maricao Municipio,2001,2023,1691,332,16.4
72,95,Maunabo Municipio,2001,3539,2919,620,17.5
72,97,Mayaguez Municipio,2001,31378,26835,4543,14.5
72,99,Moca Municipio,2001,13192,11239,1953,14.8
72,101,Morovis Municipio,2001,8456,7194,1262,14.9
72,103,Naguabo Municipio,2001,7166,6095,1071,14.9
72,105,Naranjito Municipio,2001,8237,7379,858,10.4
72,107,Orocovis Municipio,2001,5245,4379,866,16.5
72,109,Patillas Municipio,2001,5216,4401,815,15.6
72,111,Penuelas Municipio,2001,7546,6411,1135,15.0
72,113,Ponce Municipio,2001,57713,50578,7135,12.4
72,115,Quebradillas Municipio,2001,8019,6939,1080,13.5
72,117,Rincon Municipio,2001,4898,4138,760,15.5
72,119,Rio Grande Municipio,2001,16765,14635,2130,12.7
72,121,Sabana Grande Municipio,2001,8250,7149,1101,13.3
72,123,Salinas Municipio,2001,8307,7122,1185,14.3
72,125,San German Municipio,2001,12164,10326,1838,15.1
72,127,San Juan Municipio,2001,168986,155453,13533,8.0
72,129,San Lorenzo Municipio,2001,13091,11614,1477,11.3
72,131,San Sebastian Municipio,2001,13845,11701,2144,15.5
72,133,Santa Isabel Municipio,2001,8007,7054,953,11.9
72,135,Toa Alta Municipio,2001,24049,22189,1860,7.7
72,137,Toa Baja Municipio,2001,34245,31440,2805,8.2
72,139,Trujillo Alto Municipio,2001,30780,28537,2243,7.3
72,141,Utuado Municipio,2001,9239,7978,1261,13.6
72,143,Vega Alta Municipio,2001,11720,10421,1299,11.1
72,145,Vega Baja Municipio,2001,19554,17138,2416,12.4
72,147,Vieques Municipio,2001,2323,1999,324,13.9
72,149,Villalba Municipio,2001,7564,6546,1018,13.5
72,151,Yabucoa Municipio,2001,10751,8746,2005,18.6
72,153,Yauco Municipio,2001,14416,12475,1941,13.5
1,1,Autauga,2002,22161,21096,1065,4.8
1,3,Baldwin,2002,69379,65881,3498,5.0
1,5,Barbour,2002,11006,10154,852,7.7
1,7,Bibb,2002,8961,8333,628,7.0
1,9,Blount,2002,25836,24436,1400,5.4
1,11,Bullock,2002,3890,3493,397,10.2
1,13,Butler,2002,9172,8448,724,7.9
1,15,Calhoun,2002,52111,48991,3120,6.0
1,17,Chambers,2002,17211,16056,1155,6.7
1,19,Cherokee,2002,11591,11039,552,4.8
1,21,Chilton,2002,19452,18456,996,5.1
1,23,Choctaw,2002,5749,5239,510,8.9
1,25,Clarke,2002,10752,9775,977,9.1
1,27,Clay,2002,6165,5780,385,6.2
1,29,Cleburne,2002,6794,6454,340,5.0
1,31,Coffee,2002,19359,18354,1005,5.2
1,33,Colbert,2002,25050,22957,2093,8.4
1,35,Conecuh,2002,5179,4754,425,8.2
1,37,Coosa,2002,5198,4712,486,9.3
1,39,Covington,2002,17148,16128,1020,5.9
1,41,Crenshaw,2002,5845,5489,356,6.1
1,43,Cullman,2002,38052,35757,2295,6.0
1,45,Dale,2002,20321,19162,1159,5.7
1,47,Dallas,2002,17190,15224,1966,11.4
1,49,DeKalb,2002,32483,30806,1677,5.2
1,51,Elmore,2002,31773,30247,1526,4.8
1,53,Escambia,2002,14965,13659,1306,8.7
1,55,Etowah,2002,47036,44025,3011,6.4
1,57,Fayette,2002,7906,7230,676,8.6
1,59,Franklin,2002,13732,12190,1542,11.2
1,61,Geneva,2002,11744,11163,581,4.9
1,63,Greene,2002,3534,3234,300,8.5
1,65,Hale,2002,7077,6481,596,8.4
1,67,Henry,2002,7554,7096,458,6.1
1,69,Houston,2002,44887,42753,2134,4.8
1,71,Jackson,2002,26880,24984,1896,7.1
1,73,Jefferson,2002,323104,306259,16845,5.2
1,75,Lamar,2002,6983,6393,590,8.4
1,77,Lauderdale,2002,42102,38470,3632,8.6
1,79,Lawrence,2002,16142,15044,1098,6.8
1,81,Lee,2002,59387,56661,2726,4.6
1,83,Limestone,2002,33230,31448,1782,5.4
1,85,Lowndes,2002,5048,4597,451,8.9
1,87,Macon,2002,8789,8220,569,6.5
1,89,Madison,2002,150356,143433,6923,4.6
1,91,Marengo,2002,9003,8429,574,6.4
1,93,Marion,2002,12687,11576,1111,8.8
1,95,Marshall,2002,40464,38052,2412,6.0
1,97,Mobile,2002,182152,170334,11818,6.5
1,99,Monroe,2002,9739,8914,825,8.5
1,101,Montgomery,2002,104187,98616,5571,5.3
1,103,Morgan,2002,55482,51944,3538,6.4
1,105,Perry,2002,3860,3403,457,11.8
1,107,Pickens,2002,8274,7591,683,8.3
1,109,Pike,2002,13748,12925,823,6.0
1,111,Randolph,2002,9711,9051,660,6.8
1,113,Russell,2002,21521,20008,1513,7.0
1,115,St. Clair,2002,32033,30392,1641,5.1
1,117,Shelby,2002,85927,82879,3048,3.5
1,119,Sumter,2002,5116,4655,461,9.0
1,121,Talladega,2002,37413,34651,2762,7.4
1,123,Tallapoosa,2002,18920,17428,1492,7.9
1,125,Tuscaloosa,2002,81800,77987,3813,4.7
1,127,Walker,2002,30778,28820,1958,6.4
1,129,Washington,2002,7191,6442,749,10.4
1,131,Wilcox,2002,3829,3390,439,11.5
1,133,Winston,2002,10511,9589,922,8.8
2,13,Aleutians East Borough,2002,970,886,84,8.7
2,16,Aleutians West Census Area,2002,2739,2569,170,6.2
2,20,Anchorage Borough/municipality,2002,144205,135942,8263,5.7
2,50,Bethel Census Area,2002,6844,6129,715,10.4
2,60,Bristol Bay Borough,2002,908,847,61,6.7
2,68,Denali Borough,2002,1527,1416,111,7.3
2,70,Dillingham Census Area,2002,1933,1739,194,10.0
2,90,Fairbanks North Star Borough,2002,41915,39192,2723,6.5
2,100,Haines Borough,2002,1279,1134,145,11.3
2,110,Juneau Borough/city,2002,18004,17034,970,5.4
2,122,Kenai Peninsula Borough,2002,24830,22474,2356,9.5
2,130,Ketchikan Gateway Borough,2002,7783,7136,647,8.3
2,150,Kodiak Island Borough,2002,6306,5743,563,8.9
2,158,Kusilvak Census Area,2002,2486,2058,428,17.2
2,164,Lake and Peninsula Borough,2002,919,850,69,7.5
2,170,Matanuska-Susitna Borough,2002,31373,28815,2558,8.2
2,180,Nome Census Area,2002,3862,3481,381,9.9
2,185,North Slope Borough,2002,3771,3449,322,8.5
2,188,Northwest Arctic Borough,2002,3067,2721,346,11.3
2,201,Prince of Wales-Outer Ketchikan Census Area,2002,2354,1991,363,15.4
2,220,Sitka Borough/city,2002,4621,4353,268,5.8
2,232,Skagway-Hoonah-Angoon Census Area,2002,1800,1581,219,12.2
2,240,Southeast Fairbanks Census Area,2002,2268,1958,310,13.7
2,261,Valdez-Cordova Census Area,2002,5205,4697,508,9.8
2,280,Wrangell-Petersburg Census Area,2002,2997,2662,335,11.2
2,282,Yakutat Borough/city,2002,318,289,29,9.1
2,290,Yukon-Koyukuk Census Area,2002,2769,2414,355,12.8
4,1,Apache,2002,20446,18173,2273,11.1
4,3,Cochise,2002,52619,49480,3139,6.0
4,5,Coconino,2002,65848,62206,3642,5.5
4,7,Gila,2002,21042,19449,1593,7.6
4,9,Graham,2002,12123,11183,940,7.8
4,11,Greenlee,2002,3628,3352,276,7.6
4,12,La Paz,2002,7278,6773,505,6.9
4,13,Maricopa,2002,1717779,1620415,97364,5.7
4,15,Mohave,2002,77678,73245,4433,5.7
4,17,Navajo,2002,36955,33771,3184,8.6
4,19,Pima,2002,424352,399866,24486,5.8
4,21,Pinal,2002,75952,70310,5642,7.4
4,23,Santa Cruz,2002,15349,13780,1569,10.2
4,25,Yavapai,2002,83136,78598,4538,5.5
4,27,Yuma,2002,69319,57451,11868,17.1
5,1,Arkansas,2002,10540,9903,637,6.0
5,3,Ashley,2002,10246,9463,783,7.6
5,5,Baxter,2002,16233,15218,1015,6.3
5,7,Benton,2002,85282,82607,2675,3.1
5,9,Boone,2002,16206,15315,891,5.5
5,11,Bradley,2002,5462,5063,399,7.3
5,13,Calhoun,2002,2585,2423,162,6.3
5,15,Carroll,2002,13398,12822,576,4.3
5,17,Chicot,2002,5325,4811,514,9.7
5,19,Clark,2002,11297,10631,666,5.9
5,21,Clay,2002,7779,7210,569,7.3
5,23,Cleburne,2002,10980,10457,523,4.8
5,25,Cleveland,2002,3925,3696,229,5.8
5,27,Columbia,2002,11081,10432,649,5.9
5,29,Conway,2002,9702,9158,544,5.6
5,31,Craighead,2002,42762,40565,2197,5.1
5,33,Crawford,2002,25320,24142,1178,4.7
5,35,Crittenden,2002,21531,20274,1257,5.8
5,37,Cross,2002,8639,8117,522,6.0
5,39,Dallas,2002,3837,3532,305,7.9
5,41,Desha,2002,6316,5770,546,8.6
5,43,Drew,2002,8525,7861,664,7.8
5,45,Faulkner,2002,46898,44565,2333,5.0
5,47,Franklin,2002,8113,7729,384,4.7
5,49,Fulton,2002,4871,4540,331,6.8
5,51,Garland,2002,38595,36390,2205,5.7
5,53,Grant,2002,8120,7699,421,5.2
5,55,Greene,2002,17194,16060,1134,6.6
5,57,Hempstead,2002,11244,10734,510,4.5
5,59,Hot Spring,2002,14188,13294,894,6.3
5,61,Howard,2002,6590,6238,352,5.3
5,63,Independence,2002,16982,16034,948,5.6
5,65,Izard,2002,5211,4840,371,7.1
5,67,Jackson,2002,7791,7197,594,7.6
5,69,Jefferson,2002,35784,33076,2708,7.6
5,71,Johnson,2002,10530,10016,514,4.9
5,73,Lafayette,2002,3472,3299,173,5.0
5,75,Lawrence,2002,7902,7360,542,6.9
5,77,Lee,2002,3742,3406,336,9.0
5,79,Lincoln,2002,5054,4681,373,7.4
5,81,Little River,2002,6539,6258,281,4.3
5,83,Logan,2002,9889,9350,539,5.5
5,85,Lonoke,2002,27115,25952,1163,4.3
5,87,Madison,2002,7210,6960,250,3.5
5,89,Marion,2002,6515,6111,404,6.2
5,91,Miller,2002,18389,17531,858,4.7
5,93,Mississippi,2002,21648,19149,2499,11.5
5,95,Monroe,2002,4035,3748,287,7.1
5,97,Montgomery,2002,4162,3937,225,5.4
5,99,Nevada,2002,4602,4378,224,4.9
5,101,Newton,2002,3623,3424,199,5.5
5,103,Ouachita,2002,12313,11481,832,6.8
5,105,Perry,2002,4825,4541,284,5.9
5,107,Phillips,2002,9378,8608,770,8.2
5,109,Pike,2002,5205,4923,282,5.4
5,111,Poinsett,2002,11340,10517,823,7.3
5,113,Polk,2002,8858,8097,761,8.6
5,115,Pope,2002,26795,25432,1363,5.1
5,117,Prairie,2002,4495,4269,226,5.0
5,119,Pulaski,2002,182993,174184,8809,4.8
5,121,Randolph,2002,8318,7710,608,7.3
5,123,St. Francis,2002,10889,10030,859,7.9
5,125,Saline,2002,43270,41436,1834,4.2
5,127,Scott,2002,4890,4678,212,4.3
5,129,Searcy,2002,3345,3186,159,4.8
5,131,Sebastian,2002,56654,54197,2457,4.3
5,133,Sevier,2002,7401,7086,315,4.3
5,135,Sharp,2002,6445,5969,476,7.4
5,137,Stone,2002,4521,4231,290,6.4
5,139,Union,2002,21433,20249,1184,5.5
5,141,Van Buren,2002,6917,6473,444,6.4
5,143,Washington,2002,89141,86227,2914,3.3
5,145,White,2002,30711,28914,1797,5.9
5,147,Woodruff,2002,4007,3732,275,6.9
5,149,Yell,2002,9848,9412,436,4.4
6,1,Alameda,2002,771356,719228,52128,6.8
6,3,Alpine,2002,563,520,43,7.6
6,5,Amador,2002,16509,15549,960,5.8
6,7,Butte,2002,97098,89857,7241,7.5
6,9,Calaveras,2002,19678,18388,1290,6.6
6,11,Colusa,2002,9405,8094,1311,13.9
6,13,Contra Costa,2002,510793,481390,29403,5.8
6,15,Del Norte,2002,10219,9320,899,8.8
6,17,El Dorado,2002,86134,81591,4543,5.3
6,19,Fresno,2002,401401,354760,46641,11.6
6,21,Glenn,2002,11220,10132,1088,9.7
6,23,Humboldt,2002,60741,56627,4114,6.8
6,25,Imperial,2002,57290,48650,8640,15.1
6,27,Inyo,2002,9202,8700,502,5.5
6,29,Kern,2002,305462,275307,30155,9.9
6,31,Kings,2002,51735,45630,6105,11.8
6,33,Lake,2002,25697,23542,2155,8.4
6,35,Lassen,2002,12194,11245,949,7.8
6,37,Los Angeles,2002,4742509,4418100,324409,6.8
6,39,Madera,2002,55565,49621,5944,10.7
6,41,Marin,2002,134484,127874,6610,4.9
6,43,Mariposa,2002,8715,8149,566,6.5
6,45,Mendocino,2002,45725,42655,3070,6.7
6,47,Merced,2002,95761,85165,10596,11.1
6,49,Modoc,2002,4095,3771,324,7.9
6,51,Mono,2002,7873,7467,406,5.2
6,53,Monterey,2002,207809,189086,18723,9.0
6,55,Napa,2002,71104,67844,3260,4.6
6,57,Nevada,2002,48335,45756,2579,5.3
6,59,Orange,2002,1524180,1447724,76456,5.0
6,61,Placer,2002,146155,138881,7274,5.0
6,63,Plumas,2002,10205,9341,864,8.5
6,65,Riverside,2002,746220,697630,48590,6.5
6,67,Sacramento,2002,641929,605352,36577,5.7
6,69,San Benito,2002,26276,23924,2352,9.0
6,71,San Bernardino,2002,786610,738711,47899,6.1
6,73,San Diego,2002,1442325,1367542,74783,5.2
6,75,San Francisco/city,2002,448084,416744,31340,7.0
6,77,San Joaquin,2002,274194,249716,24478,8.9
6,79,San Luis Obispo,2002,128300,122275,6025,4.7
6,81,San Mateo,2002,377649,356068,21581,5.7
6,83,Santa Barbara,2002,205069,194375,10694,5.2
6,85,Santa Clara,2002,886770,812008,74762,8.4
6,87,Santa Cruz,2002,147449,136471,10978,7.4
6,89,Shasta,2002,81258,75398,5860,7.2
6,91,Sierra,2002,1642,1498,144,8.8
6,93,Siskiyou,2002,18995,17283,1712,9.0
6,95,Solano,2002,202127,190313,11814,5.8
6,97,Sonoma,2002,256601,243465,13136,5.1
6,99,Stanislaus,2002,219146,197793,21353,9.7
6,101,Sutter,2002,39059,34720,4339,11.1
6,103,Tehama,2002,25491,23642,1849,7.3
6,105,Trinity,2002,5391,4842,549,10.2
6,107,Tulare,2002,180596,158842,21754,12.0
6,109,Tuolumne,2002,24749,23093,1656,6.7
6,111,Ventura,2002,405955,382329,23626,5.8
6,113,Yolo,2002,90437,84951,5486,6.1
6,115,Yuba,2002,24999,22523,2476,9.9
8,1,Adams,2002,193647,181517,12130,6.3
8,3,Alamosa,2002,8230,7817,413,5.0
8,5,Arapahoe,2002,285915,269359,16556,5.8
8,7,Archuleta,2002,5677,5366,311,5.5
8,9,Baca,2002,2544,2458,86,3.4
8,11,Bent,2002,2531,2363,168,6.6
8,13,Boulder,2002,164023,154551,9472,5.8
8,14,Broomfield/city,2002,22655,21345,1310,5.8
8,15,Chaffee,2002,7845,7440,405,5.2
8,17,Cheyenne,2002,1347,1305,42,3.1
8,19,Clear Creek,2002,5998,5687,311,5.2
8,21,Conejos,2002,3792,3523,269,7.1
8,23,Costilla,2002,1357,1227,130,9.6
8,25,Crowley,2002,1643,1523,120,7.3
8,27,Custer,2002,2012,1925,87,4.3
8,29,Delta,2002,14298,13556,742,5.2
8,31,Denver/city,2002,300814,280534,20280,6.7
8,33,Dolores,2002,993,913,80,8.1
8,35,Douglas,2002,120985,114512,6473,5.4
8,37,Eagle,2002,26749,25584,1165,4.4
8,39,Elbert,2002,12359,11719,640,5.2
8,41,El Paso,2002,275623,258665,16958,6.2
8,43,Fremont,2002,18757,17495,1262,6.7
8,45,Garfield,2002,26841,25615,1226,4.6
8,47,Gilpin,2002,3251,3086,165,5.1
8,49,Grand,2002,8448,8133,315,3.7
8,51,Gunnison,2002,8566,8203,363,4.2
8,53,Hinsdale,2002,626,603,23,3.7
8,55,Huerfano,2002,3536,3278,258,7.3
8,57,Jackson,2002,1096,1045,51,4.7
8,59,Jefferson,2002,304019,287512,16507,5.4
8,61,Kiowa,2002,961,922,39,4.1
8,63,Kit Carson,2002,4534,4388,146,3.2
8,65,Lake,2002,4021,3781,240,6.0
8,67,La Plata,2002,26407,25341,1066,4.0
8,69,Larimer,2002,154761,147485,7276,4.7
8,71,Las Animas,2002,7842,7442,400,5.1
8,73,Lincoln,2002,3072,2952,120,3.9
8,75,Logan,2002,11227,10804,423,3.8
8,77,Mesa,2002,63939,60768,3171,5.0
8,79,Mineral,2002,434,414,20,4.6
8,81,Moffat,2002,7683,7304,379,4.9
8,83,Montezuma,2002,12465,11772,693,5.6
8,85,Montrose,2002,17879,16896,983,5.5
8,87,Morgan,2002,14070,13482,588,4.2
8,89,Otero,2002,9573,9000,573,6.0
8,91,Ouray,2002,2449,2349,100,4.1
8,93,Park,2002,9081,8602,479,5.3
8,95,Phillips,2002,2522,2441,81,3.2
8,97,Pitkin,2002,10411,9929,482,4.6
8,99,Prowers,2002,7590,7287,303,4.0
8,101,Pueblo,2002,66281,61558,4723,7.1
8,103,Rio Blanco,2002,3698,3583,115,3.1
8,105,Rio Grande,2002,6540,6150,390,6.0
8,107,Routt,2002,14021,13493,528,3.8
8,109,Saguache,2002,3207,2986,221,6.9
8,111,San Juan,2002,571,529,42,7.4
8,113,San Miguel,2002,5055,4799,256,5.1
8,115,Sedgwick,2002,1642,1584,58,3.5
8,117,Summit,2002,16605,15917,688,4.1
8,119,Teller,2002,12307,11575,732,5.9
8,121,Washington,2002,2942,2841,101,3.4
8,123,Weld,2002,102532,97163,5369,5.2
8,125,Yuma,2002,6408,6247,161,2.5
9,1,Fairfield,2002,450349,431586,18763,4.2
9,3,Hartford,2002,434677,413789,20888,4.8
9,5,Litchfield,2002,100990,96759,4231,4.2
9,7,Middlesex,2002,87698,84403,3295,3.8
9,9,New Haven,2002,424277,404183,20094,4.7
9,11,New London,2002,140448,134925,5523,3.9
9,13,Tolland,2002,78213,75496,2717,3.5
9,15,Windham,2002,59413,56647,2766,4.7
10,1,Kent,2002,65730,62977,2753,4.2
10,3,New Castle,2002,268702,256933,11769,4.4
10,5,Sussex,2002,82775,79507,3268,3.9
11,1,District of Colu,2002,308760,287196,21564,7.0
12,1,Alachua,2002,117889,113695,4194,3.6
12,3,Baker,2002,10426,9985,441,4.2
12,5,Bay,2002,73772,69972,3800,5.2
12,7,Bradford,2002,10928,10498,430,3.9
12,9,Brevard,2002,236938,224703,12235,5.2
12,11,Broward,2002,894419,847008,47411,5.3
12,13,Calhoun,2002,5349,5099,250,4.7
12,15,Charlotte,2002,59365,56333,3032,5.1
12,17,Citrus,2002,46008,43237,2771,6.0
12,19,Clay,2002,76430,73019,3411,4.5
12,21,Collier,2002,129023,123062,5961,4.6
12,23,Columbia,2002,25930,24673,1257,4.8
12,27,DeSoto,2002,13426,12677,749,5.6
12,29,Dixie,2002,5959,5681,278,4.7
12,31,Duval,2002,407214,386757,20457,5.0
12,33,Escambia,2002,129306,123081,6225,4.8
12,35,Flagler,2002,23476,22218,1258,5.4
12,37,Franklin,2002,4879,4662,217,4.4
12,39,Gadsden,2002,19912,18914,998,5.0
12,41,Gilchrist,2002,6702,6407,295,4.4
12,43,Glades,2002,4544,4302,242,5.3
12,45,Gulf,2002,5479,5208,271,4.9
12,47,Hamilton,2002,4342,4102,240,5.5
12,49,Hardee,2002,10926,10212,714,6.5
12,51,Hendry,2002,17180,15872,1308,7.6
12,53,Hernando,2002,51236,48074,3162,6.2
12,55,Highlands,2002,36078,34079,1999,5.5
12,57,Hillsborough,2002,543277,516758,26519,4.9
12,59,Holmes,2002,7625,7230,395,5.2
12,61,Indian River,2002,53626,50094,3532,6.6
12,63,Jackson,2002,20013,19169,844,4.2
12,65,Jefferson,2002,6387,6124,263,4.1
12,67,Lafayette,2002,2751,2631,120,4.4
12,69,Lake,2002,98978,93835,5143,5.2
12,71,Lee,2002,227734,217744,9990,4.4
12,73,Leon,2002,132872,127660,5212,3.9
12,75,Levy,2002,14747,13975,772,5.2
12,77,Liberty,2002,2921,2803,118,4.0
12,79,Madison,2002,7192,6854,338,4.7
12,81,Manatee,2002,132338,126298,6040,4.6
12,83,Marion,2002,111117,105192,5925,5.3
12,85,Martin,2002,59381,56288,3093,5.2
12,86,Miami-Dade,2002,1053110,1008222,44888,4.3
12,87,Monroe,2002,46611,44971,1640,3.5
12,89,Nassau,2002,30470,29132,1338,4.4
12,91,Okaloosa,2002,85470,82163,3307,3.9
12,93,Okeechobee,2002,16054,15056,998,6.2
12,95,Orange,2002,505055,479157,25898,5.1
12,97,Osceola,2002,96361,91250,5111,5.3
12,99,Palm Beach,2002,578208,545924,32284,5.6
12,101,Pasco,2002,158310,149757,8553,5.4
12,103,Pinellas,2002,463893,440302,23591,5.1
12,105,Polk,2002,236806,224401,12405,5.2
12,107,Putnam,2002,29556,27800,1756,5.9
12,109,St. Johns,2002,70114,67306,2808,4.0
12,111,St. Lucie,2002,94097,87935,6162,6.5
12,113,Santa Rosa,2002,57103,54422,2681,4.7
12,115,Sarasota,2002,157272,150353,6919,4.4
12,117,Seminole,2002,212864,202234,10630,5.0
12,119,Sumter,2002,18543,17562,981,5.3
12,121,Suwannee,2002,15968,15238,730,4.6
12,123,Taylor,2002,8499,7989,510,6.0
12,125,Union,2002,4810,4645,165,3.4
12,127,Volusia,2002,219763,208748,11015,5.0
12,129,Wakulla,2002,12677,12188,489,3.9
12,131,Walton,2002,21488,20618,870,4.0
12,133,Washington,2002,8861,8369,492,5.6
13,1,Appling,2002,8234,7563,671,8.1
13,3,Atkinson,2002,3424,3212,212,6.2
13,5,Bacon,2002,4202,3924,278,6.6
13,7,Baker,2002,1693,1604,89,5.3
13,9,Baldwin,2002,19645,18628,1017,5.2
13,11,Banks,2002,8129,7765,364,4.5
13,13,Barrow,2002,26881,25498,1383,5.1
13,15,Bartow,2002,42459,39968,2491,5.9
13,17,Ben Hill,2002,7918,7442,476,6.0
13,19,Berrien,2002,8126,7769,357,4.4
13,21,Bibb,2002,70684,66904,3780,5.3
13,23,Bleckley,2002,5172,4863,309,6.0
13,25,Brantley,2002,7043,6638,405,5.8
13,27,Brooks,2002,7867,7481,386,4.9
13,29,Bryan,2002,12575,12090,485,3.9
13,31,Bulloch,2002,28249,26950,1299,4.6
13,33,Burke,2002,9607,8914,693,7.2
13,35,Butts,2002,9506,8948,558,5.9
13,37,Calhoun,2002,2365,2190,175,7.4
13,39,Camden,2002,18422,17549,873,4.7
13,43,Candler,2002,4050,3851,199,4.9
13,45,Carroll,2002,46893,44257,2636,5.6
13,47,Catoosa,2002,31577,30439,1138,3.6
13,49,Charlton,2002,4105,3890,215,5.2
13,51,Chatham,2002,115213,109960,5253,4.6
13,53,Chattahoochee,2002,2679,2433,246,9.2
13,55,Chattooga,2002,11283,10782,501,4.4
13,57,Cherokee,2002,88906,85044,3862,4.3
13,59,Clarke,2002,55778,53420,2358,4.2
13,61,Clay,2002,1462,1389,73,5.0
13,63,Clayton,2002,131352,123158,8194,6.2
13,65,Clinch,2002,2393,2248,145,6.1
13,67,Cobb,2002,365192,347245,17947,4.9
13,69,Coffee,2002,17111,16128,983,5.7
13,71,Colquitt,2002,18387,17383,1004,5.5
13,73,Columbia,2002,50342,48403,1939,3.9
13,75,Cook,2002,7145,6787,358,5.0
13,77,Coweta,2002,50998,48582,2416,4.7
13,79,Crawford,2002,5945,5641,304,5.1
13,81,Crisp,2002,9538,8936,602,6.3
13,83,Dade,2002,8130,7733,397,4.9
13,85,Dawson,2002,9489,9036,453,4.8
13,87,Decatur,2002,11909,11149,760,6.4
13,89,DeKalb,2002,375467,352783,22684,6.0
13,91,Dodge,2002,8601,8082,519,6.0
13,93,Dooly,2002,4714,4427,287,6.1
13,95,Dougherty,2002,40740,38109,2631,6.5
13,97,Douglas,2002,52999,50368,2631,5.0
13,99,Early,2002,5560,5241,319,5.7
13,101,Echols,2002,1985,1913,72,3.6
13,103,Effingham,2002,21038,20183,855,4.1
13,105,Elbert,2002,10189,9559,630,6.2
13,107,Emanuel,2002,9934,9354,580,5.8
13,109,Evans,2002,4722,4492,230,4.9
13,111,Fannin,2002,9589,9044,545,5.7
13,113,Fayette,2002,50118,48194,1924,3.8
13,115,Floyd,2002,46869,44385,2484,5.3
13,117,Forsyth,2002,64513,61724,2789,4.3
13,119,Franklin,2002,10176,9591,585,5.7
13,121,Fulton,2002,444330,417818,26512,6.0
13,123,Gilmer,2002,12188,11628,560,4.6
13,125,Glascock,2002,1187,1119,68,5.7
13,127,Glynn,2002,35459,33940,1519,4.3
13,129,Gordon,2002,24337,23030,1307,5.4
13,131,Grady,2002,11080,10576,504,4.5
13,133,Greene,2002,6333,5721,612,9.7
13,135,Gwinnett,2002,366337,348270,18067,4.9
13,137,Habersham,2002,18798,17943,855,4.5
13,139,Hall,2002,75862,72433,3429,4.5
13,141,Hancock,2002,3397,3092,305,9.0
13,143,Haralson,2002,12455,11828,627,5.0
13,145,Harris,2002,13497,12969,528,3.9
13,147,Hart,2002,10935,10249,686,6.3
13,149,Heard,2002,5034,4739,295,5.9
13,151,Henry,2002,75276,71927,3349,4.4
13,153,Houston,2002,57021,54702,2319,4.1
13,155,Irwin,2002,4497,4227,270,6.0
13,157,Jackson,2002,22071,20860,1211,5.5
13,159,Jasper,2002,5951,5652,299,5.0
13,161,Jeff Davis,2002,5757,5251,506,8.8
13,163,Jefferson,2002,6776,6134,642,9.5
13,165,Jenkins,2002,3410,3166,244,7.2
13,167,Johnson,2002,3668,3415,253,6.9
13,169,Jones,2002,12289,11745,544,4.4
13,171,Lamar,2002,7943,7418,525,6.6
13,173,Lanier,2002,3439,3283,156,4.5
13,175,Laurens,2002,21437,20231,1206,5.6
13,177,Lee,2002,14290,13738,552,3.9
13,179,Liberty,2002,20456,19194,1262,6.2
13,181,Lincoln,2002,3457,3187,270,7.8
13,183,Long,2002,4720,4513,207,4.4
13,185,Lowndes,2002,46101,44223,1878,4.1
13,187,Lumpkin,2002,11203,10704,499,4.5
13,189,McDuffie,2002,10259,9501,758,7.4
13,191,McIntosh,2002,4896,4635,261,5.3
13,193,Macon,2002,5179,4757,422,8.1
13,195,Madison,2002,14634,13984,650,4.4
13,197,Marion,2002,3294,3128,166,5.0
13,199,Meriwether,2002,9970,9332,638,6.4
13,201,Miller,2002,3376,3216,160,4.7
13,205,Mitchell,2002,9751,9154,597,6.1
13,207,Monroe,2002,11791,11218,573,4.9
13,209,Montgomery,2002,3795,3519,276,7.3
13,211,Morgan,2002,8594,8209,385,4.5
13,213,Murray,2002,20357,19405,952,4.7
13,215,Muscogee,2002,82729,77895,4834,5.8
13,217,Newton,2002,35790,33886,1904,5.3
13,219,Oconee,2002,15154,14658,496,3.3
13,221,Oglethorpe,2002,7049,6734,315,4.5
13,223,Paulding,2002,50298,48122,2176,4.3
13,225,Peach,2002,10930,10326,604,5.5
13,227,Pickens,2002,13233,12648,585,4.4
13,229,Pierce,2002,7571,7190,381,5.0
13,231,Pike,2002,7157,6765,392,5.5
13,233,Polk,2002,19067,17985,1082,5.7
13,235,Pulaski,2002,4152,3901,251,6.0
13,237,Putnam,2002,9264,8818,446,4.8
13,239,Quitman,2002,997,931,66,6.6
13,241,Rabun,2002,7068,6755,313,4.4
13,243,Randolph,2002,2968,2688,280,9.4
13,245,Richmond,2002,88104,82922,5182,5.9
13,247,Rockdale,2002,37089,35185,1904,5.1
13,249,Schley,2002,1681,1596,85,5.1
13,251,Screven,2002,6438,6059,379,5.9
13,253,Seminole,2002,3956,3715,241,6.1
13,255,Spalding,2002,27962,26116,1846,6.6
13,257,Stephens,2002,13781,13031,750,5.4
13,259,Stewart,2002,1973,1844,129,6.5
13,261,Sumter,2002,14732,13771,961,6.5
13,263,Talbot,2002,2901,2727,174,6.0
13,265,Taliaferro,2002,791,696,95,12.0
13,267,Tattnall,2002,8497,8013,484,5.7
13,269,Taylor,2002,3318,3109,209,6.3
13,271,Telfair,2002,4030,3592,438,10.9
13,273,Terrell,2002,4575,4220,355,7.8
13,275,Thomas,2002,21007,20001,1006,4.8
13,277,Tift,2002,18799,17905,894,4.8
13,279,Toombs,2002,11617,10718,899,7.7
13,281,Towns,2002,4746,4549,197,4.2
13,283,Treutlen,2002,2614,2405,209,8.0
13,285,Troup,2002,29430,27704,1726,5.9
13,287,Turner,2002,4733,4400,333,7.0
13,289,Twiggs,2002,4625,4318,307,6.6
13,291,Union,2002,9013,8588,425,4.7
13,293,Upson,2002,11751,10627,1124,9.6
13,295,Walker,2002,31263,29795,1468,4.7
13,297,Walton,2002,34166,32587,1579,4.6
13,299,Ware,2002,14799,13949,850,5.7
13,301,Warren,2002,2571,2282,289,11.2
13,303,Washington,2002,8305,7791,514,6.2
13,305,Wayne,2002,11132,10484,648,5.8
13,307,Webster,2002,1006,953,53,5.3
13,309,Wheeler,2002,2401,2233,168,7.0
13,311,White,2002,11115,10631,484,4.4
13,313,Whitfield,2002,44418,42335,2083,4.7
13,315,Wilcox,2002,3288,3077,211,6.4
13,317,Wilkes,2002,4916,4502,414,8.4
13,319,Wilkinson,2002,4416,4155,261,5.9
13,321,Worth,2002,10068,9521,547,5.4
15,1,Hawaii,2002,75539,72093,3446,4.6
15,3,Honolulu/city,2002,424778,408135,16643,3.9
15,7,Kauai,2002,30015,28705,1310,4.4
15,9,Maui,2002,71455,68683,2772,3.9
16,1,Ada,2002,175987,167561,8426,4.8
16,3,Adams,2002,1879,1650,229,12.2
16,5,Bannock,2002,38765,36445,2320,6.0
16,7,Bear Lake,2002,2890,2739,151,5.2
16,9,Benewah,2002,4035,3575,460,11.4
16,11,Bingham,2002,20313,19364,949,4.7
16,13,Blaine,2002,12933,12403,530,4.1
16,15,Boise,2002,3462,3288,174,5.0
16,17,Bonner,2002,18648,17122,1526,8.2
16,19,Bonneville,2002,43703,42032,1671,3.8
16,21,Boundary,2002,4065,3699,366,9.0
16,23,Butte,2002,1360,1294,66,4.9
16,25,Camas,2002,580,560,20,3.4
16,27,Canyon,2002,70903,66458,4445,6.3
16,29,Caribou,2002,3375,3147,228,6.8
16,31,Cassia,2002,10355,9798,557,5.4
16,33,Clark,2002,505,474,31,6.1
16,35,Clearwater,2002,3505,3024,481,13.7
16,37,Custer,2002,2566,2395,171,6.7
16,39,Elmore,2002,10978,10243,735,6.7
16,41,Franklin,2002,5732,5469,263,4.6
16,43,Fremont,2002,5889,5612,277,4.7
16,45,Gem,2002,7122,6589,533,7.5
16,47,Gooding,2002,7253,6964,289,4.0
16,49,Idaho,2002,7103,6480,623,8.8
16,51,Jefferson,2002,9478,9091,387,4.1
16,53,Jerome,2002,9617,9192,425,4.4
16,55,Kootenai,2002,60454,56050,4404,7.3
16,57,Latah,2002,16665,15882,783,4.7
16,59,Lemhi,2002,3826,3531,295,7.7
16,61,Lewis,2002,1756,1646,110,6.3
16,63,Lincoln,2002,2298,2175,123,5.4
16,65,Madison,2002,13807,13375,432,3.1
16,67,Minidoka,2002,9854,9218,636,6.5
16,69,Nez Perce,2002,19435,18389,1046,5.4
16,71,Oneida,2002,1951,1870,81,4.2
16,73,Owyhee,2002,4755,4537,218,4.6
16,75,Payette,2002,10089,9229,860,8.5
16,77,Power,2002,3570,3339,231,6.5
16,79,Shoshone,2002,5479,4795,684,12.5
16,81,Teton,2002,4029,3891,138,3.4
16,83,Twin Falls,2002,35542,33984,1558,4.4
16,85,Valley,2002,4022,3680,342,8.5
16,87,Washington,2002,5126,4765,361,7.0
17,1,Adams,2002,35806,34203,1603,4.5
17,3,Alexander,2002,3462,3149,313,9.0
17,5,Bond,2002,8237,7788,449,5.5
17,7,Boone,2002,22316,20672,1644,7.4
17,9,Brown,2002,3032,2926,106,3.5
17,11,Bureau,2002,18380,17318,1062,5.8
17,13,Calhoun,2002,2440,2288,152,6.2
17,15,Carroll,2002,8274,7708,566,6.8
17,17,Cass,2002,7193,6846,347,4.8
17,19,Champaign,2002,99314,95300,4014,4.0
17,21,Christian,2002,17161,16149,1012,5.9
17,23,Clark,2002,8555,7989,566,6.6
17,25,Clay,2002,6826,6387,439,6.4
17,27,Clinton,2002,18057,17209,848,4.7
17,29,Coles,2002,27154,25649,1505,5.5
17,31,Cook,2002,2626435,2424560,201875,7.7
17,33,Crawford,2002,9342,8752,590,6.3
17,35,Cumberland,2002,5677,5323,354,6.2
17,37,DeKalb,2002,50823,48183,2640,5.2
17,39,De Witt,2002,8379,7848,531,6.3
17,41,Douglas,2002,10609,10105,504,4.8
17,43,DuPage,2002,516172,486732,29440,5.7
17,45,Edgar,2002,9793,9225,568,5.8
17,47,Edwards,2002,3500,3330,170,4.9
17,49,Effingham,2002,17671,16739,932,5.3
17,51,Fayette,2002,9842,9174,668,6.8
17,53,Ford,2002,7223,6894,329,4.6
17,55,Franklin,2002,16995,15670,1325,7.8
17,57,Fulton,2002,17364,16209,1155,6.7
17,59,Gallatin,2002,2734,2539,195,7.1
17,61,Greene,2002,6989,6582,407,5.8
17,63,Grundy,2002,20804,19228,1576,7.6
17,65,Hamilton,2002,3992,3748,244,6.1
17,67,Hancock,2002,10520,9922,598,5.7
17,69,Hardin,2002,1931,1783,148,7.7
17,71,Henderson,2002,4091,3833,258,6.3
17,73,Henry,2002,26107,24699,1408,5.4
17,75,Iroquois,2002,15842,14927,915,5.8
17,77,Jackson,2002,30586,29131,1455,4.8
17,79,Jasper,2002,5226,4939,287,5.5
17,81,Jefferson,2002,19487,18375,1112,5.7
17,83,Jersey,2002,11055,10455,600,5.4
17,85,Jo Daviess,2002,12572,11974,598,4.8
17,87,Johnson,2002,5008,4724,284,5.7
17,89,Kane,2002,232510,218106,14404,6.2
17,91,Kankakee,2002,51733,48417,3316,6.4
17,93,Kendall,2002,34741,32772,1969,5.7
17,95,Knox,2002,26586,24755,1831,6.9
17,97,Lake,2002,339624,321822,17802,5.2
17,99,LaSalle,2002,55103,51276,3827,6.9
17,101,Lawrence,2002,8240,7806,434,5.3
17,103,Lee,2002,17330,16404,926,5.3
17,105,Livingston,2002,18947,17973,974,5.1
17,107,Logan,2002,14143,13364,779,5.5
17,109,McDonough,2002,16548,15761,787,4.8
17,111,McHenry,2002,154562,145618,8944,5.8
17,113,McLean,2002,86559,83418,3141,3.6
17,115,Macon,2002,52579,48580,3999,7.6
17,117,Macoupin,2002,23925,22575,1350,5.6
17,119,Madison,2002,131005,123904,7101,5.4
17,121,Marion,2002,18762,17187,1575,8.4
17,123,Marshall,2002,6817,6409,408,6.0
17,125,Mason,2002,7898,7350,548,6.9
17,127,Massac,2002,7177,6749,428,6.0
17,129,Menard,2002,6883,6590,293,4.3
17,131,Mercer,2002,8613,8045,568,6.6
17,133,Monroe,2002,15859,15217,642,4.0
17,135,Montgomery,2002,13468,12535,933,6.9
17,137,Morgan,2002,17933,17030,903,5.0
17,139,Moultrie,2002,7365,6980,385,5.2
17,141,Ogle,2002,25726,24183,1543,6.0
17,143,Peoria,2002,88936,83847,5089,5.7
17,145,Perry,2002,10329,9593,736,7.1
17,147,Piatt,2002,8921,8506,415,4.7
17,149,Pike,2002,8545,8069,476,5.6
17,151,Pope,2002,1984,1845,139,7.0
17,153,Pulaski,2002,3034,2804,230,7.6
17,155,Putnam,2002,3115,2872,243,7.8
17,157,Randolph,2002,15414,14578,836,5.4
17,159,Richland,2002,7477,7049,428,5.7
17,161,Rock Island,2002,74886,70901,3985,5.3
17,163,St. Clair,2002,117969,110636,7333,6.2
17,165,Saline,2002,11710,10924,786,6.7
17,167,Sangamon,2002,104299,99593,4706,4.5
17,169,Schuyler,2002,4231,4043,188,4.4
17,171,Scott,2002,2856,2696,160,5.6
17,173,Shelby,2002,11447,10776,671,5.9
17,175,Stark,2002,2798,2593,205,7.3
17,177,Stephenson,2002,25295,23726,1569,6.2
17,179,Tazewell,2002,65546,62167,3379,5.2
17,181,Union,2002,8282,7715,567,6.8
17,183,Vermilion,2002,37328,34629,2699,7.2
17,185,Wabash,2002,6715,6358,357,5.3
17,187,Warren,2002,9452,8930,522,5.5
17,189,Washington,2002,8410,8024,386,4.6
17,191,Wayne,2002,8031,7593,438,5.5
17,193,White,2002,7814,7420,394,5.0
17,195,Whiteside,2002,29337,27444,1893,6.5
17,197,Will,2002,294575,275397,19178,6.5
17,199,Williamson,2002,30416,28702,1714,5.6
17,201,Winnebago,2002,140663,130825,9838,7.0
17,203,Woodford,2002,18472,17729,743,4.0
18,1,Adams,2002,15838,15106,732,4.6
18,3,Allen,2002,176439,167662,8777,5.0
18,5,Bartholomew,2002,35811,34095,1716,4.8
18,7,Benton,2002,4887,4640,247,5.1
18,9,Blackford,2002,6999,6558,441,6.3
18,11,Boone,2002,25408,24441,967,3.8
18,13,Brown,2002,8061,7660,401,5.0
18,15,Carroll,2002,10832,10308,524,4.8
18,17,Cass,2002,20531,19348,1183,5.8
18,19,Clark,2002,52165,49423,2742,5.3
18,21,Clay,2002,13105,12307,798,6.1
18,23,Clinton,2002,16620,15832,788,4.7
18,25,Crawford,2002,5321,4944,377,7.1
18,27,Daviess,2002,14054,13446,608,4.3
18,29,Dearborn,2002,25179,23870,1309,5.2
18,31,Decatur,2002,13388,12876,512,3.8
18,33,DeKalb,2002,21740,20561,1179,5.4
18,35,Delaware,2002,58971,55472,3499,5.9
18,37,Dubois,2002,22040,21214,826,3.7
18,39,Elkhart,2002,94606,90104,4502,4.8
18,41,Fayette,2002,11893,10992,901,7.6
18,43,Floyd,2002,37550,35728,1822,4.9
18,45,Fountain,2002,8488,7980,508,6.0
18,47,Franklin,2002,11612,10947,665,5.7
18,49,Fulton,2002,10409,9771,638,6.1
18,51,Gibson,2002,17220,16462,758,4.4
18,53,Grant,2002,34883,32606,2277,6.5
18,55,Greene,2002,16372,15388,984,6.0
18,57,Hamilton,2002,113098,109400,3698,3.3
18,59,Hancock,2002,31900,30635,1265,4.0
18,61,Harrison,2002,18723,17838,885,4.7
18,63,Hendricks,2002,62893,60520,2373,3.8
18,65,Henry,2002,23295,21844,1451,6.2
18,67,Howard,2002,40747,38378,2369,5.8
18,69,Huntington,2002,20608,19547,1061,5.1
18,71,Jackson,2002,21983,20905,1078,4.9
18,73,Jasper,2002,14998,14144,854,5.7
18,75,Jay,2002,10819,10160,659,6.1
18,77,Jefferson,2002,16682,15845,837,5.0
18,79,Jennings,2002,13496,12632,864,6.4
18,81,Johnson,2002,66501,63904,2597,3.9
18,83,Knox,2002,19656,18791,865,4.4
18,85,Kosciusko,2002,39138,37297,1841,4.7
18,87,LaGrange,2002,16538,15755,783,4.7
18,89,Lake,2002,227710,213011,14699,6.5
18,91,LaPorte,2002,54026,50327,3699,6.8
18,93,Lawrence,2002,23014,21274,1740,7.6
18,95,Madison,2002,63900,60180,3720,5.8
18,97,Marion,2002,460936,436934,24002,5.2
18,99,Marshall,2002,22242,21106,1136,5.1
18,101,Martin,2002,5205,4929,276,5.3
18,103,Miami,2002,17422,16343,1079,6.2
18,105,Monroe,2002,65226,62378,2848,4.4
18,107,Montgomery,2002,19471,18645,826,4.2
18,109,Morgan,2002,36406,34703,1703,4.7
18,111,Newton,2002,7205,6807,398,5.5
18,113,Noble,2002,23658,22304,1354,5.7
18,115,Ohio,2002,3042,2911,131,4.3
18,117,Orange,2002,9334,8606,728,7.8
18,119,Owen,2002,11469,10810,659,5.7
18,121,Parke,2002,8021,7581,440,5.5
18,123,Perry,2002,9411,8920,491,5.2
18,125,Pike,2002,6328,6011,317,5.0
18,127,Porter,2002,79378,75409,3969,5.0
18,129,Posey,2002,14217,13595,622,4.4
18,131,Pulaski,2002,6801,6410,391,5.7
18,133,Putnam,2002,17372,16493,879,5.1
18,135,Randolph,2002,13736,12921,815,5.9
18,137,Ripley,2002,14023,13414,609,4.3
18,139,Rush,2002,9510,9079,431,4.5
18,141,St. Joseph,2002,133263,126127,7136,5.4
18,143,Scott,2002,11062,10382,680,6.1
18,145,Shelby,2002,23810,22669,1141,4.8
18,147,Spencer,2002,10602,10101,501,4.7
18,149,Starke,2002,10627,9836,791,7.4
18,151,Steuben,2002,17166,16059,1107,6.4
18,153,Sullivan,2002,9329,8771,558,6.0
18,155,Switzerland,2002,5724,5452,272,4.8
18,157,Tippecanoe,2002,79868,76436,3432,4.3
18,159,Tipton,2002,8533,8096,437,5.1
18,161,Union,2002,3705,3510,195,5.3
18,163,Vanderburgh,2002,92318,88105,4213,4.6
18,165,Vermillion,2002,8170,7653,517,6.3
18,167,Vigo,2002,51175,48177,2998,5.9
18,169,Wabash,2002,17780,16829,951,5.3
18,171,Warren,2002,4629,4391,238,5.1
18,173,Warrick,2002,29574,28402,1172,4.0
18,175,Washington,2002,14005,13220,785,5.6
18,177,Wayne,2002,34869,32764,2105,6.0
18,179,Wells,2002,14790,14163,627,4.2
18,181,White,2002,12843,11939,904,7.0
18,183,Whitley,2002,17315,16446,869,5.0
19,1,Adair,2002,4426,4265,161,3.6
19,3,Adams,2002,2170,2068,102,4.7
19,5,Allamakee,2002,8355,7975,380,4.5
19,7,Appanoose,2002,6506,6166,340,5.2
19,9,Audubon,2002,3375,3245,130,3.9
19,11,Benton,2002,14338,13727,611,4.3
19,13,Black Hawk,2002,71348,68499,2849,4.0
19,15,Boone,2002,15092,14609,483,3.2
19,17,Bremer,2002,13414,12966,448,3.3
19,19,Buchanan,2002,10829,10342,487,4.5
19,21,Buena Vista,2002,10593,10255,338,3.2
19,23,Butler,2002,8221,7848,373,4.5
19,25,Calhoun,2002,5240,5052,188,3.6
19,27,Carroll,2002,12221,11866,355,2.9
19,29,Cass,2002,7688,7341,347,4.5
19,31,Cedar,2002,10560,10186,374,3.5
19,33,Cerro Gordo,2002,25507,24458,1049,4.1
19,35,Cherokee,2002,6929,6647,282,4.1
19,37,Chickasaw,2002,6465,6117,348,5.4
19,39,Clarke,2002,4993,4730,263,5.3
19,41,Clay,2002,9738,9367,371,3.8
19,43,Clayton,2002,9889,9329,560,5.7
19,45,Clinton,2002,26746,25328,1418,5.3
19,47,Crawford,2002,8896,8556,340,3.8
19,49,Dallas,2002,25913,25159,754,2.9
19,51,Davis,2002,4279,4072,207,4.8
19,53,Decatur,2002,4355,4167,188,4.3
19,55,Delaware,2002,10311,9798,513,5.0
19,57,Des Moines,2002,21872,20571,1301,5.9
19,59,Dickinson,2002,9770,9408,362,3.7
19,61,Dubuque,2002,48605,46658,1947,4.0
19,63,Emmet,2002,6053,5783,270,4.5
19,65,Fayette,2002,11117,10581,536,4.8
19,67,Floyd,2002,8637,8227,410,4.7
19,69,Franklin,2002,5645,5407,238,4.2
19,71,Fremont,2002,4579,4456,123,2.7
19,73,Greene,2002,4985,4797,188,3.8
19,75,Grundy,2002,6827,6609,218,3.2
19,77,Guthrie,2002,6130,5917,213,3.5
19,79,Hamilton,2002,8749,8459,290,3.3
19,81,Hancock,2002,6354,6172,182,2.9
19,83,Hardin,2002,9611,9206,405,4.2
19,85,Harrison,2002,8171,7873,298,3.6
19,87,Henry,2002,10364,9833,531,5.1
19,89,Howard,2002,5225,5011,214,4.1
19,91,Humboldt,2002,5298,5109,189,3.6
19,93,Ida,2002,3988,3857,131,3.3
19,95,Iowa,2002,8918,8614,304,3.4
19,97,Jackson,2002,11551,10950,601,5.2
19,99,Jasper,2002,20466,19621,845,4.1
19,101,Jefferson,2002,8574,8089,485,5.7
19,103,Johnson,2002,72180,70222,1958,2.7
19,105,Jones,2002,10607,10115,492,4.6
19,107,Keokuk,2002,6118,5844,274,4.5
19,109,Kossuth,2002,9001,8680,321,3.6
19,111,Lee,2002,17992,16647,1345,7.5
19,113,Linn,2002,114742,109618,5124,4.5
19,115,Louisa,2002,6306,6016,290,4.6
19,117,Lucas,2002,4845,4628,217,4.5
19,119,Lyon,2002,6474,6259,215,3.3
19,121,Madison,2002,7949,7621,328,4.1
19,123,Mahaska,2002,11573,11058,515,4.5
19,125,Marion,2002,17492,16736,756,4.3
19,127,Marshall,2002,20813,19968,845,4.1
19,129,Mills,2002,8118,7896,222,2.7
19,131,Mitchell,2002,5453,5258,195,3.6
19,133,Monona,2002,5012,4797,215,4.3
19,135,Monroe,2002,3723,3539,184,4.9
19,137,Montgomery,2002,5775,5465,310,5.4
19,139,Muscatine,2002,22456,21545,911,4.1
19,141,O'Brien,2002,7748,7504,244,3.1
19,143,Osceola,2002,3549,3440,109,3.1
19,145,Page,2002,7555,7194,361,4.8
19,147,Palo Alto,2002,5123,4937,186,3.6
19,149,Plymouth,2002,13779,13312,467,3.4
19,151,Pocahontas,2002,4145,3960,185,4.5
19,153,Polk,2002,224845,216602,8243,3.7
19,155,Pottawattamie,2002,49113,47474,1639,3.3
19,157,Poweshiek,2002,10771,10336,435,4.0
19,159,Ringgold,2002,2600,2503,97,3.7
19,161,Sac,2002,5952,5747,205,3.4
19,163,Scott,2002,87009,83001,4008,4.6
19,165,Shelby,2002,7090,6852,238,3.4
19,167,Sioux,2002,17921,17424,497,2.8
19,169,Story,2002,47681,46465,1216,2.6
19,171,Tama,2002,9166,8774,392,4.3
19,173,Taylor,2002,3330,3199,131,3.9
19,175,Union,2002,6484,6162,322,5.0
19,177,Van Buren,2002,3878,3663,215,5.5
19,179,Wapello,2002,18993,17955,1038,5.5
19,181,Warren,2002,24320,23547,773,3.2
19,183,Washington,2002,12133,11736,397,3.3
19,185,Wayne,2002,3304,3166,138,4.2
19,187,Webster,2002,19939,19112,827,4.1
19,189,Winnebago,2002,6301,6105,196,3.1
19,191,Winneshiek,2002,12436,11981,455,3.7
19,193,Woodbury,2002,55716,53586,2130,3.8
19,195,Worth,2002,4441,4257,184,4.1
19,197,Wright,2002,7220,6933,287,4.0
20,1,Allen,2002,6971,6596,375,5.4
20,3,Anderson,2002,4149,3927,222,5.4
20,5,Atchison,2002,8172,7730,442,5.4
20,7,Barber,2002,2531,2442,89,3.5
20,9,Barton,2002,14679,14091,588,4.0
20,11,Bourbon,2002,8283,7882,401,4.8
20,13,Brown,2002,5239,4956,283,5.4
20,15,Butler,2002,31066,29310,1756,5.7
20,17,Chase,2002,1633,1561,72,4.4
20,19,Chautauqua,2002,1941,1836,105,5.4
20,21,Cherokee,2002,10516,9789,727,6.9
20,23,Cheyenne,2002,1541,1491,50,3.2
20,25,Clark,2002,1220,1180,40,3.3
20,27,Clay,2002,4524,4333,191,4.2
20,29,Cloud,2002,5277,5076,201,3.8
20,31,Coffey,2002,4787,4499,288,6.0
20,33,Comanche,2002,1039,1011,28,2.7
20,35,Cowley,2002,18660,17425,1235,6.6
20,37,Crawford,2002,19183,18194,989,5.2
20,39,Decatur,2002,1838,1785,53,2.9
20,41,Dickinson,2002,10080,9654,426,4.2
20,43,Doniphan,2002,4349,3931,418,9.6
20,45,Douglas,2002,59467,57188,2279,3.8
20,47,Edwards,2002,1694,1636,58,3.4
20,49,Elk,2002,1427,1344,83,5.8
20,51,Ellis,2002,16100,15608,492,3.1
20,53,Ellsworth,2002,3133,3007,126,4.0
20,55,Finney,2002,17976,17287,689,3.8
20,57,Ford,2002,16161,15665,496,3.1
20,59,Franklin,2002,13245,12526,719,5.4
20,61,Geary,2002,11012,10343,669,6.1
20,63,Gove,2002,1595,1547,48,3.0
20,65,Graham,2002,1423,1376,47,3.3
20,67,Grant,2002,3739,3615,124,3.3
20,69,Gray,2002,3131,3034,97,3.1
20,71,Greeley,2002,777,753,24,3.1
20,73,Greenwood,2002,3616,3402,214,5.9
20,75,Hamilton,2002,1266,1224,42,3.3
20,77,Harper,2002,3202,3079,123,3.8
20,79,Harvey,2002,17704,16954,750,4.2
20,81,Haskell,2002,2130,2068,62,2.9
20,83,Hodgeman,2002,961,926,35,3.6
20,85,Jackson,2002,6905,6561,344,5.0
20,87,Jefferson,2002,10110,9632,478,4.7
20,89,Jewell,2002,1992,1934,58,2.9
20,91,Johnson,2002,269122,256283,12839,4.8
20,93,Kearny,2002,1937,1873,64,3.3
20,95,Kingman,2002,4214,4012,202,4.8
20,97,Kiowa,2002,1470,1414,56,3.8
20,99,Labette,2002,10845,10192,653,6.0
20,101,Lane,2002,1131,1085,46,4.1
20,103,Leavenworth,2002,31569,29711,1858,5.9
20,105,Lincoln,2002,1882,1802,80,4.3
20,107,Linn,2002,4662,4371,291,6.2
20,109,Logan,2002,1562,1506,56,3.6
20,111,Lyon,2002,19050,18221,829,4.4
20,113,McPherson,2002,15657,15128,529,3.4
20,115,Marion,2002,6583,6328,255,3.9
20,117,Marshall,2002,5698,5472,226,4.0
20,119,Meade,2002,2169,2103,66,3.0
20,121,Miami,2002,15148,14445,703,4.6
20,123,Mitchell,2002,3337,3215,122,3.7
20,125,Montgomery,2002,16313,15226,1087,6.7
20,127,Morris,2002,3087,2967,120,3.9
20,129,Morton,2002,1604,1554,50,3.1
20,131,Nemaha,2002,5108,4928,180,3.5
20,133,Neosho,2002,8458,8044,414,4.9
20,135,Ness,2002,1728,1676,52,3.0
20,137,Norton,2002,2629,2533,96,3.7
20,139,Osage,2002,9048,8584,464,5.1
20,141,Osborne,2002,2274,2201,73,3.2
20,143,Ottawa,2002,3347,3213,134,4.0
20,145,Pawnee,2002,3440,3327,113,3.3
20,147,Phillips,2002,3160,3064,96,3.0
20,149,Pottawatomie,2002,9568,9161,407,4.3
20,151,Pratt,2002,5410,5239,171,3.2
20,153,Rawlins,2002,1357,1308,49,3.6
20,155,Reno,2002,32737,31206,1531,4.7
20,157,Republic,2002,2930,2819,111,3.8
20,159,Rice,2002,5414,5199,215,4.0
20,161,Riley,2002,30757,29689,1068,3.5
20,163,Rooks,2002,2747,2648,99,3.6
20,165,Rush,2002,1697,1634,63,3.7
20,167,Russell,2002,3282,3135,147,4.5
20,169,Saline,2002,29893,28675,1218,4.1
20,171,Scott,2002,2950,2874,76,2.6
20,173,Sedgwick,2002,242548,228209,14339,5.9
20,175,Seward,2002,10329,9915,414,4.0
20,177,Shawnee,2002,93569,89264,4305,4.6
20,179,Sheridan,2002,1473,1428,45,3.1
20,181,Sherman,2002,3760,3647,113,3.0
20,183,Smith,2002,2267,2200,67,3.0
20,185,Stafford,2002,2201,2106,95,4.3
20,187,Stanton,2002,1154,1120,34,2.9
20,189,Stevens,2002,2389,2305,84,3.5
20,191,Sumner,2002,12775,11864,911,7.1
20,193,Thomas,2002,4191,4056,135,3.2
20,195,Trego,2002,1674,1619,55,3.3
20,197,Wabaunsee,2002,3749,3607,142,3.8
20,199,Wallace,2002,943,918,25,2.7
20,201,Washington,2002,3330,3208,122,3.7
20,203,Wichita,2002,1234,1194,40,3.2
20,205,Wilson,2002,4839,4609,230,4.8
20,207,Woodson,2002,1718,1611,107,6.2
20,209,Wyandotte,2002,73779,66815,6964,9.4
21,1,Adair,2002,8669,8193,476,5.5
21,3,Allen,2002,8650,8100,550,6.4
21,5,Anderson,2002,10209,9696,513,5.0
21,7,Ballard,2002,4102,3805,297,7.2
21,9,Barren,2002,19204,18286,918,4.8
21,11,Bath,2002,4992,4617,375,7.5
21,13,Bell,2002,9529,8695,834,8.8
21,15,Boone,2002,51448,49306,2142,4.2
21,17,Bourbon,2002,9778,9238,540,5.5
21,19,Boyd,2002,21868,20471,1397,6.4
21,21,Boyle,2002,13290,12438,852,6.4
21,23,Bracken,2002,4180,3965,215,5.1
21,25,Breathitt,2002,5390,4956,434,8.1
21,27,Breckinridge,2002,8870,8268,602,6.8
21,29,Bullitt,2002,33241,31492,1749,5.3
21,31,Butler,2002,6496,5964,532,8.2
21,33,Caldwell,2002,6314,5986,328,5.2
21,35,Calloway,2002,16708,15500,1208,7.2
21,37,Campbell,2002,45206,43211,1995,4.4
21,39,Carlisle,2002,2369,2208,161,6.8
21,41,Carroll,2002,5161,4781,380,7.4
21,43,Carter,2002,12703,11519,1184,9.3
21,45,Casey,2002,7258,6769,489,6.7
21,47,Christian,2002,26076,24506,1570,6.0
21,49,Clark,2002,16675,15732,943,5.7
21,51,Clay,2002,7183,6417,766,10.7
21,53,Clinton,2002,4690,4279,411,8.8
21,55,Crittenden,2002,4217,3974,243,5.8
21,57,Cumberland,2002,3217,3033,184,5.7
21,59,Daviess,2002,45655,43103,2552,5.6
21,61,Edmonson,2002,5088,4723,365,7.2
21,63,Elliott,2002,2637,2409,228,8.6
21,65,Estill,2002,6026,5632,394,6.5
21,67,Fayette,2002,145088,138831,6257,4.3
21,69,Fleming,2002,6702,6329,373,5.6
21,71,Floyd,2002,14204,13181,1023,7.2
21,73,Franklin,2002,24993,23909,1084,4.3
21,75,Fulton,2002,3162,2940,222,7.0
21,77,Gallatin,2002,3819,3599,220,5.8
21,79,Garrard,2002,7385,6975,410,5.6
21,81,Grant,2002,11851,11197,654,5.5
21,83,Graves,2002,16944,15743,1201,7.1
21,85,Grayson,2002,11597,10644,953,8.2
21,87,Green,2002,5563,5263,300,5.4
21,89,Greenup,2002,16061,15064,997,6.2
21,91,Hancock,2002,4076,3822,254,6.2
21,93,Hardin,2002,43589,41038,2551,5.9
21,95,Harlan,2002,10181,9265,916,9.0
21,97,Harrison,2002,9122,8608,514,5.6
21,99,Hart,2002,7802,7378,424,5.4
21,101,Henderson,2002,23130,21879,1251,5.4
21,103,Henry,2002,7515,7181,334,4.4
21,105,Hickman,2002,2341,2182,159,6.8
21,107,Hopkins,2002,21375,20157,1218,5.7
21,109,Jackson,2002,4855,4476,379,7.8
21,111,Jefferson,2002,348958,329022,19936,5.7
21,113,Jessamine,2002,20685,19792,893,4.3
21,115,Johnson,2002,9496,8897,599,6.3
21,117,Kenton,2002,80909,77361,3548,4.4
21,119,Knott,2002,5826,5425,401,6.9
21,121,Knox,2002,11441,10629,812,7.1
21,123,Larue,2002,6427,6075,352,5.5
21,125,Laurel,2002,24914,23424,1490,6.0
21,127,Lawrence,2002,5677,5222,455,8.0
21,129,Lee,2002,2618,2417,201,7.7
21,131,Leslie,2002,3834,3504,330,8.6
21,133,Letcher,2002,8844,8100,744,8.4
21,135,Lewis,2002,5415,4991,424,7.8
21,137,Lincoln,2002,11011,10236,775,7.0
21,139,Livingston,2002,4881,4557,324,6.6
21,141,Logan,2002,12750,11893,857,6.7
21,143,Lyon,2002,3391,3161,230,6.8
21,145,McCracken,2002,31137,29251,1886,6.1
21,147,McCreary,2002,6090,5502,588,9.7
21,149,McLean,2002,4631,4331,300,6.5
21,151,Madison,2002,37901,35892,2009,5.3
21,153,Magoffin,2002,4521,4003,518,11.5
21,155,Marion,2002,8956,8493,463,5.2
21,157,Marshall,2002,14590,13479,1111,7.6
21,159,Martin,2002,3819,3542,277,7.3
21,161,Mason,2002,8433,7989,444,5.3
21,163,Meade,2002,11599,10912,687,5.9
21,165,Menifee,2002,2621,2405,216,8.2
21,167,Mercer,2002,10537,9952,585,5.6
21,169,Metcalfe,2002,4519,4284,235,5.2
21,171,Monroe,2002,5219,4871,348,6.7
21,173,Montgomery,2002,11416,10665,751,6.6
21,175,Morgan,2002,5156,4683,473,9.2
21,177,Muhlenberg,2002,13196,12129,1067,8.1
21,179,Nelson,2002,19445,18277,1168,6.0
21,181,Nicholas,2002,3183,2958,225,7.1
21,183,Ohio,2002,10816,10044,772,7.1
21,185,Oldham,2002,23929,22947,982,4.1
21,187,Owen,2002,5075,4834,241,4.7
21,189,Owsley,2002,1606,1497,109,6.8
21,191,Pendleton,2002,7165,6807,358,5.0
21,193,Perry,2002,10419,9583,836,8.0
21,195,Pike,2002,25041,23316,1725,6.9
21,197,Powell,2002,5733,5325,408,7.1
21,199,Pulaski,2002,26233,24328,1905,7.3
21,201,Robertson,2002,1070,1014,56,5.2
21,203,Rockcastle,2002,7041,6630,411,5.8
21,205,Rowan,2002,11225,10569,656,5.8
21,207,Russell,2002,7689,7090,599,7.8
21,209,Scott,2002,18824,17905,919,4.9
21,211,Shelby,2002,18314,17436,878,4.8
21,213,Simpson,2002,8324,7833,491,5.9
21,215,Spencer,2002,7028,6730,298,4.2
21,217,Taylor,2002,11998,11350,648,5.4
21,219,Todd,2002,5792,5495,297,5.1
21,221,Trigg,2002,6008,5611,397,6.6
21,223,Trimble,2002,4117,3914,203,4.9
21,225,Union,2002,7587,7189,398,5.2
21,227,Warren,2002,50395,47804,2591,5.1
21,229,Washington,2002,5284,4971,313,5.9
21,231,Wayne,2002,8691,8117,574,6.6
21,233,Webster,2002,6717,6368,349,5.2
21,235,Whitley,2002,14586,13544,1042,7.1
21,237,Wolfe,2002,2416,2213,203,8.4
21,239,Woodford,2002,13064,12532,532,4.1
22,1,Acadia Parish,2002,23755,22298,1457,6.1
22,3,Allen Parish,2002,8731,8038,693,7.9
22,5,Ascension Parish,2002,39575,37077,2498,6.3
22,7,Assumption Parish,2002,10519,9864,655,6.2
22,9,Avoyelles Parish,2002,15758,14638,1120,7.1
22,11,Beauregard Parish,2002,13932,13029,903,6.5
22,13,Bienville Parish,2002,5958,5452,506,8.5
22,15,Bossier Parish,2002,46856,44060,2796,6.0
22,17,Caddo Parish,2002,111801,104278,7523,6.7
22,19,Calcasieu Parish,2002,84861,80066,4795,5.7
22,21,Caldwell Parish,2002,4429,4080,349,7.9
22,23,Cameron Parish,2002,4350,4122,228,5.2
22,25,Catahoula Parish,2002,4068,3681,387,9.5
22,27,Claiborne Parish,2002,6758,6292,466,6.9
22,29,Concordia Parish,2002,7524,6784,740,9.8
22,31,De Soto Parish,2002,10748,9848,900,8.4
22,33,East Baton Rouge Parish,2002,200007,189338,10669,5.3
22,35,East Carroll Parish,2002,3089,2726,363,11.8
22,37,East Feliciana Parish,2002,7959,7428,531,6.7
22,39,Evangeline Parish,2002,12023,11164,859,7.1
22,41,Franklin Parish,2002,7977,7174,803,10.1
22,43,Grant Parish,2002,7947,7410,537,6.8
22,45,Iberia Parish,2002,30662,28639,2023,6.6
22,47,Iberville Parish,2002,12211,11229,982,8.0
22,49,Jackson Parish,2002,6570,6153,417,6.3
22,51,Jefferson Parish,2002,224226,212908,11318,5.0
22,53,Jefferson Davis Parish,2002,13086,12343,743,5.7
22,55,Lafayette Parish,2002,98500,94036,4464,4.5
22,57,Lafourche Parish,2002,43033,41052,1981,4.6
22,59,LaSalle Parish,2002,6063,5601,462,7.6
22,61,Lincoln Parish,2002,18636,17436,1200,6.4
22,63,Livingston Parish,2002,46441,43580,2861,6.2
22,65,Madison Parish,2002,5033,4520,513,10.2
22,67,Morehouse Parish,2002,12489,11428,1061,8.5
22,69,Natchitoches Parish,2002,16581,15432,1149,6.9
22,71,Orleans Parish,2002,201179,188815,12364,6.1
22,73,Ouachita Parish,2002,71533,67809,3724,5.2
22,75,Plaquemines Parish,2002,10955,10283,672,6.1
22,77,Pointe Coupee Parish,2002,9376,8735,641,6.8
22,79,Rapides Parish,2002,56083,52735,3348,6.0
22,81,Red River Parish,2002,3647,3352,295,8.1
22,83,Richland Parish,2002,8426,7746,680,8.1
22,85,Sabine Parish,2002,9290,8586,704,7.6
22,87,St. Bernard Parish,2002,31080,29224,1856,6.0
22,89,St. Charles Parish,2002,23607,22302,1305,5.5
22,91,St. Helena Parish,2002,3910,3659,251,6.4
22,93,St. James Parish,2002,8717,7936,781,9.0
22,95,St. John the Baptist Parish,2002,19922,18530,1392,7.0
22,97,St. Landry Parish,2002,33065,30743,2322,7.0
22,99,St. Martin Parish,2002,21898,20439,1459,6.7
22,101,St. Mary Parish,2002,22089,20438,1651,7.5
22,103,St. Tammany Parish,2002,98677,93872,4805,4.9
22,105,Tangipahoa Parish,2002,45609,42486,3123,6.8
22,107,Tensas Parish,2002,2317,2120,197,8.5
22,109,Terrebonne Parish,2002,47975,45701,2274,4.7
22,111,Union Parish,2002,10465,9818,647,6.2
22,113,Vermilion Parish,2002,22906,21392,1514,6.6
22,115,Vernon Parish,2002,18464,17255,1209,6.5
22,117,Washington Parish,2002,16784,15564,1220,7.3
22,119,Webster Parish,2002,18052,16632,1420,7.9
22,121,West Baton Rouge Parish,2002,9927,9345,582,5.9
22,123,West Carroll Parish,2002,4791,4264,527,11.0
22,125,West Feliciana Parish,2002,4678,4337,341,7.3
22,127,Winn Parish,2002,6082,5631,451,7.4
23,1,Androscoggin,2002,55841,53336,2505,4.5
23,3,Aroostook,2002,34198,32385,1813,5.3
23,5,Cumberland,2002,149972,145007,4965,3.3
23,7,Franklin,2002,14282,13536,746,5.2
23,9,Hancock,2002,29007,27725,1282,4.4
23,11,Kennebec,2002,60750,58094,2656,4.4
23,13,Knox,2002,21172,20454,718,3.4
23,15,Lincoln,2002,17638,16991,647,3.7
23,17,Oxford,2002,27563,26013,1550,5.6
23,19,Penobscot,2002,76574,72947,3627,4.7
23,21,Piscataquis,2002,7519,6986,533,7.1
23,23,Sagadahoc,2002,18149,17496,653,3.6
23,25,Somerset,2002,24575,22812,1763,7.2
23,27,Waldo,2002,19408,18448,960,4.9
23,29,Washington,2002,15287,14072,1215,7.9
23,31,York,2002,106605,101998,4607,4.3
24,1,Allegany,2002,33482,31260,2222,6.6
24,3,Anne Arundel,2002,272833,261382,11451,4.2
24,5,Baltimore,2002,414843,394366,20477,4.9
24,9,Calvert,2002,42748,41158,1590,3.7
24,11,Caroline,2002,15881,15102,779,4.9
24,13,Carroll,2002,87796,84411,3385,3.9
24,15,Cecil,2002,47018,44755,2263,4.8
24,17,Charles,2002,67843,65284,2559,3.8
24,19,Dorchester,2002,16394,15250,1144,7.0
24,21,Frederick,2002,115014,110753,4261,3.7
24,23,Garrett,2002,15548,14641,907,5.8
24,25,Harford,2002,124068,118427,5641,4.5
24,27,Howard,2002,150306,144728,5578,3.7
24,29,Kent,2002,10814,10298,516,4.8
24,31,Montgomery,2002,497657,479111,18546,3.7
24,33,Prince George's,2002,438405,415586,22819,5.2
24,35,Queen Anne's,2002,23718,22797,921,3.9
24,37,St. Mary's,2002,47509,45663,1846,3.9
24,39,Somerset,2002,11127,10328,799,7.2
24,41,Talbot,2002,18657,17901,756,4.1
24,43,Washington,2002,67953,64385,3568,5.3
24,45,Wicomico,2002,48478,45972,2506,5.2
24,47,Worcester,2002,28325,26415,1910,6.7
24,510,Baltimore city,2002,275949,255005,20944,7.6
25,1,Barnstable,2002,119141,113592,5549,4.7
25,3,Berkshire,2002,72979,69697,3282,4.5
25,5,Bristol,2002,286593,269250,17343,6.1
25,7,Dukes,2002,10678,10274,404,3.8
25,9,Essex,2002,382879,360521,22358,5.8
25,11,Franklin,2002,40051,38469,1582,3.9
25,13,Hampden,2002,225423,212683,12740,5.7
25,15,Hampshire,2002,87517,84433,3084,3.5
25,17,Middlesex,2002,831159,790241,40918,4.9
25,19,Nantucket/town,2002,7501,7357,144,1.9
25,21,Norfolk,2002,361273,344721,16552,4.6
25,23,Plymouth,2002,257958,245544,12414,4.8
25,25,Suffolk,2002,353069,332391,20678,5.9
25,27,Worcester,2002,400640,378347,22293,5.6
26,1,Alcona,2002,4153,3710,443,10.7
26,3,Alger,2002,4405,4092,313,7.1
26,5,Allegan,2002,55109,52012,3097,5.6
26,7,Alpena,2002,15212,13915,1297,8.5
26,9,Antrim,2002,11628,10799,829,7.1
26,11,Arenac,2002,7519,6844,675,9.0
26,13,Baraga,2002,3845,3474,371,9.6
26,15,Barry,2002,29880,28261,1619,5.4
26,17,Bay,2002,55042,51400,3642,6.6
26,19,Benzie,2002,8426,7847,579,6.9
26,21,Berrien,2002,78998,74059,4939,6.3
26,23,Branch,2002,22837,21460,1377,6.0
26,25,Calhoun,2002,70119,65891,4228,6.0
26,27,Cass,2002,26194,24924,1270,4.8
26,29,Charlevoix,2002,13721,12734,987,7.2
26,31,Cheboygan,2002,12598,11287,1311,10.4
26,33,Chippewa,2002,17028,15669,1359,8.0
26,35,Clare,2002,12776,11746,1030,8.1
26,37,Clinton,2002,35868,34465,1403,3.9
26,39,Crawford,2002,6636,6178,458,6.9
26,41,Delta,2002,19737,18280,1457,7.4
26,43,Dickinson,2002,14115,13261,854,6.1
26,45,Eaton,2002,57579,55205,2374,4.1
26,47,Emmet,2002,18442,17125,1317,7.1
26,49,Genesee,2002,210560,195078,15482,7.4
26,51,Gladwin,2002,10989,10090,899,8.2
26,53,Gogebic,2002,7857,7247,610,7.8
26,55,Grand Traverse,2002,45610,43044,2566,5.6
26,57,Gratiot,2002,19353,18176,1177,6.1
26,59,Hillsdale,2002,23124,21688,1436,6.2
26,61,Houghton,2002,16894,15737,1157,6.8
26,63,Huron,2002,16896,15423,1473,8.7
26,65,Ingham,2002,152275,145195,7080,4.6
26,67,Ionia,2002,29695,27829,1866,6.3
26,69,Iosco,2002,10736,9661,1075,10.0
26,71,Iron,2002,5696,5290,406,7.1
26,73,Isabella,2002,35011,33481,1530,4.4
26,75,Jackson,2002,78105,72939,5166,6.6
26,77,Kalamazoo,2002,129818,123694,6124,4.7
26,79,Kalkaska,2002,8487,7834,653,7.7
26,81,Kent,2002,314738,295623,19115,6.1
26,83,Keweenaw,2002,1029,937,92,8.9
26,85,Lake,2002,4467,4087,380,8.5
26,87,Lapeer,2002,45600,42228,3372,7.4
26,89,Leelanau,2002,11001,10475,526,4.8
26,91,Lenawee,2002,50675,47520,3155,6.2
26,93,Livingston,2002,91099,87092,4007,4.4
26,95,Luce,2002,2897,2684,213,7.4
26,97,Mackinac,2002,6629,6010,619,9.3
26,99,Macomb,2002,425117,399658,25459,6.0
26,101,Manistee,2002,11928,11026,902,7.6
26,103,Marquette,2002,33697,31380,2317,6.9
26,105,Mason,2002,15373,13660,1713,11.1
26,107,Mecosta,2002,19106,17946,1160,6.1
26,109,Menominee,2002,13102,12289,813,6.2
26,111,Midland,2002,41816,39548,2268,5.4
26,113,Missaukee,2002,6724,6234,490,7.3
26,115,Monroe,2002,76866,72885,3981,5.2
26,117,Montcalm,2002,29278,27093,2185,7.5
26,119,Montmorency,2002,4243,3789,454,10.7
26,121,Muskegon,2002,85689,78958,6731,7.9
26,123,Newaygo,2002,22855,21041,1814,7.9
26,125,Oakland,2002,650669,617419,33250,5.1
26,127,Oceana,2002,13436,12284,1152,8.6
26,129,Ogemaw,2002,9675,8873,802,8.3
26,131,Ontonagon,2002,3504,3242,262,7.5
26,133,Osceola,2002,10959,10198,761,6.9
26,135,Oscoda,2002,3769,3358,411,10.9
26,137,Otsego,2002,12242,11343,899,7.3
26,139,Ottawa,2002,130785,123728,7057,5.4
26,141,Presque Isle,2002,6470,5797,673,10.4
26,143,Roscommon,2002,10464,9653,811,7.8
26,145,Saginaw,2002,97837,90879,6958,7.1
26,147,St. Clair,2002,85461,79262,6199,7.3
26,149,St. Joseph,2002,30557,28585,1972,6.5
26,151,Sanilac,2002,21638,19890,1748,8.1
26,153,Schoolcraft,2002,3840,3456,384,10.0
26,155,Shiawassee,2002,35602,33285,2317,6.5
26,157,Tuscola,2002,28898,26605,2293,7.9
26,159,Van Buren,2002,39225,36794,2431,6.2
26,161,Washtenaw,2002,185363,178692,6671,3.6
26,163,Wayne,2002,922824,857261,65563,7.1
26,165,Wexford,2002,14611,13478,1133,7.8
27,1,Aitkin,2002,7509,7021,488,6.5
27,3,Anoka,2002,184469,176395,8074,4.4
27,5,Becker,2002,16448,15557,891,5.4
27,7,Beltrami,2002,21426,20394,1032,4.8
27,9,Benton,2002,21700,20614,1086,5.0
27,11,Big Stone,2002,2893,2771,122,4.2
27,13,Blue Earth,2002,35253,34009,1244,3.5
27,15,Brown,2002,15451,14748,703,4.5
27,17,Carlton,2002,16398,15390,1008,6.1
27,19,Carver,2002,43817,42054,1763,4.0
27,21,Cass,2002,14051,13207,844,6.0
27,23,Chippewa,2002,7445,7100,345,4.6
27,25,Chisago,2002,25002,23675,1327,5.3
27,27,Clay,2002,28982,27967,1015,3.5
27,29,Clearwater,2002,4322,3876,446,10.3
27,31,Cook,2002,3197,3044,153,4.8
27,33,Cottonwood,2002,6488,6219,269,4.1
27,35,Crow Wing,2002,31091,29471,1620,5.2
27,37,Dakota,2002,222109,213424,8685,3.9
27,39,Dodge,2002,10787,10364,423,3.9
27,41,Douglas,2002,19420,18709,711,3.7
27,43,Faribault,2002,8882,8505,377,4.2
27,45,Fillmore,2002,11946,11447,499,4.2
27,47,Freeborn,2002,17261,16424,837,4.8
27,49,Goodhue,2002,25785,24641,1144,4.4
27,51,Grant,2002,3329,3124,205,6.2
27,53,Hennepin,2002,664613,635533,29080,4.4
27,55,Houston,2002,11262,10721,541,4.8
27,57,Hubbard,2002,9800,9292,508,5.2
27,59,Isanti,2002,19202,18211,991,5.2
27,61,Itasca,2002,22727,21321,1406,6.2
27,63,Jackson,2002,6538,6301,237,3.6
27,65,Kanabec,2002,8024,7437,587,7.3
27,67,Kandiyohi,2002,23500,22546,954,4.1
27,69,Kittson,2002,2636,2482,154,5.8
27,71,Koochiching,2002,7284,6849,435,6.0
27,73,Lac qui Parle,2002,4194,4039,155,3.7
27,75,Lake,2002,6143,5849,294,4.8
27,77,Lake of the Woods,2002,2366,2257,109,4.6
27,79,Le Sueur,2002,15106,14217,889,5.9
27,81,Lincoln,2002,3441,3314,127,3.7
27,83,Lyon,2002,14576,14012,564,3.9
27,85,McLeod,2002,20254,19392,862,4.3
27,87,Mahnomen,2002,2783,2620,163,5.9
27,89,Marshall,2002,5299,4892,407,7.7
27,91,Martin,2002,12123,11643,480,4.0
27,93,Meeker,2002,12681,12032,649,5.1
27,95,Mille Lacs,2002,12061,11296,765,6.3
27,97,Morrison,2002,17401,16411,990,5.7
27,99,Mower,2002,20509,19699,810,3.9
27,101,Murray,2002,5526,5317,209,3.8
27,103,Nicollet,2002,18952,18282,670,3.5
27,105,Nobles,2002,11338,10966,372,3.3
27,107,Norman,2002,3785,3605,180,4.8
27,109,Olmsted,2002,76264,73349,2915,3.8
27,111,Otter Tail,2002,29925,28430,1495,5.0
27,113,Pennington,2002,7939,7478,461,5.8
27,115,Pine,2002,14618,13683,935,6.4
27,117,Pipestone,2002,5508,5333,175,3.2
27,119,Polk,2002,16307,15399,908,5.6
27,121,Pope,2002,6081,5847,234,3.8
27,123,Ramsey,2002,283420,271130,12290,4.3
27,125,Red Lake,2002,2223,2038,185,8.3
27,127,Redwood,2002,8876,8521,355,4.0
27,129,Renville,2002,9112,8670,442,4.9
27,131,Rice,2002,33114,31635,1479,4.5
27,133,Rock,2002,5383,5220,163,3.0
27,135,Roseau,2002,9890,9373,517,5.2
27,137,St. Louis,2002,103748,97926,5822,5.6
27,139,Scott,2002,61455,58945,2510,4.1
27,141,Sherburne,2002,41718,39750,1968,4.7
27,143,Sibley,2002,9082,8687,395,4.3
27,145,Stearns,2002,80118,76637,3481,4.3
27,147,Steele,2002,19625,18752,873,4.4
27,149,Stevens,2002,5821,5608,213,3.7
27,151,Swift,2002,5644,5371,273,4.8
27,153,Todd,2002,12910,12284,626,4.8
27,155,Traverse,2002,1940,1857,83,4.3
27,157,Wabasha,2002,12631,12155,476,3.8
27,159,Wadena,2002,6706,6297,409,6.1
27,161,Waseca,2002,10725,10233,492,4.6
27,163,Washington,2002,121517,116878,4639,3.8
27,165,Watonwan,2002,6087,5845,242,4.0
27,167,Wilkin,2002,3779,3634,145,3.8
27,169,Winona,2002,28849,27682,1167,4.0
27,171,Wright,2002,56696,53963,2733,4.8
27,173,Yellow Medicine,2002,5717,5449,268,4.7
28,1,Adams,2002,13934,12940,994,7.1
28,3,Alcorn,2002,16020,14790,1230,7.7
28,5,Amite,2002,5251,4906,345,6.6
28,7,Attala,2002,8790,8166,624,7.1
28,9,Benton,2002,2995,2669,326,10.9
28,11,Bolivar,2002,15881,14351,1530,9.6
28,13,Calhoun,2002,6598,6106,492,7.5
28,15,Carroll,2002,5038,4696,342,6.8
28,17,Chickasaw,2002,8036,7275,761,9.5
28,19,Choctaw,2002,3674,3242,432,11.8
28,21,Claiborne,2002,4095,3706,389,9.5
28,23,Clarke,2002,7657,6632,1025,13.4
28,25,Clay,2002,9552,8691,861,9.0
28,27,Coahoma,2002,11579,10591,988,8.5
28,29,Copiah,2002,12141,11306,835,6.9
28,31,Covington,2002,8419,7938,481,5.7
28,33,DeSoto,2002,62302,60090,2212,3.6
28,35,Forrest,2002,34896,32981,1915,5.5
28,37,Franklin,2002,3289,3020,269,8.2
28,39,George,2002,8216,7482,734,8.9
28,41,Greene,2002,4850,4422,428,8.8
28,43,Grenada,2002,9887,9241,646,6.5
28,45,Hancock,2002,19843,18808,1035,5.2
28,47,Harrison,2002,89820,85139,4681,5.2
28,49,Hinds,2002,120302,113588,6714,5.6
28,51,Holmes,2002,6914,6120,794,11.5
28,53,Humphreys,2002,4463,4028,435,9.7
28,55,Issaquena,2002,837,743,94,11.2
28,57,Itawamba,2002,10549,9919,630,6.0
28,59,Jackson,2002,59725,55757,3968,6.6
28,61,Jasper,2002,7215,6651,564,7.8
28,63,Jefferson,2002,2928,2584,344,11.7
28,65,Jefferson Davis,2002,5245,4850,395,7.5
28,67,Jones,2002,28529,27006,1523,5.3
28,69,Kemper,2002,4286,3892,394,9.2
28,71,Lafayette,2002,20039,19090,949,4.7
28,73,Lamar,2002,20575,19689,886,4.3
28,75,Lauderdale,2002,33071,30970,2101,6.4
28,77,Lawrence,2002,5296,4932,364,6.9
28,79,Leake,2002,10019,9415,604,6.0
28,81,Lee,2002,38376,36140,2236,5.8
28,83,Leflore,2002,14366,13008,1358,9.5
28,85,Lincoln,2002,14246,13259,987,6.9
28,87,Lowndes,2002,26231,24127,2104,8.0
28,89,Madison,2002,40341,38462,1879,4.7
28,91,Marion,2002,10276,9684,592,5.8
28,93,Marshall,2002,15226,14041,1185,7.8
28,95,Monroe,2002,16691,15361,1330,8.0
28,97,Montgomery,2002,4973,4430,543,10.9
28,99,Neshoba,2002,14315,13404,911,6.4
28,101,Newton,2002,9700,9065,635,6.5
28,103,Noxubee,2002,4545,4123,422,9.3
28,105,Oktibbeha,2002,20116,19007,1109,5.5
28,107,Panola,2002,14522,13348,1174,8.1
28,109,Pearl River,2002,21403,20272,1131,5.3
28,111,Perry,2002,5161,4797,364,7.1
28,113,Pike,2002,15236,14123,1113,7.3
28,115,Pontotoc,2002,13101,12377,724,5.5
28,117,Prentiss,2002,12046,11326,720,6.0
28,119,Quitman,2002,4062,3728,334,8.2
28,121,Rankin,2002,65600,62920,2680,4.1
28,123,Scott,2002,12544,11789,755,6.0
28,125,Sharkey,2002,2633,2375,258,9.8
28,127,Simpson,2002,11757,11115,642,5.5
28,129,Smith,2002,7270,6896,374,5.1
28,131,Stone,2002,6651,6287,364,5.5
28,133,Sunflower,2002,11623,10433,1190,10.2
28,135,Tallahatchie,2002,5737,5214,523,9.1
28,137,Tate,2002,11464,10852,612,5.3
28,139,Tippah,2002,9242,8564,678,7.3
28,141,Tishomingo,2002,8659,7833,826,9.5
28,143,Tunica,2002,4133,3848,285,6.9
28,145,Union,2002,11852,11106,746,6.3
28,147,Walthall,2002,5944,5507,437,7.4
28,149,Warren,2002,23337,21923,1414,6.1
28,151,Washington,2002,24669,22171,2498,10.1
28,153,Wayne,2002,8575,7829,746,8.7
28,155,Webster,2002,3782,3185,597,15.8
28,157,Wilkinson,2002,3377,3085,292,8.6
28,159,Winston,2002,7946,7188,758,9.5
28,161,Yalobusha,2002,5594,5216,378,6.8
28,163,Yazoo,2002,10720,9960,760,7.1
29,1,Adair,2002,13297,12727,570,4.3
29,3,Andrew,2002,9134,8692,442,4.8
29,5,Atchison,2002,3368,3240,128,3.8
29,7,Audrain,2002,12373,11705,668,5.4
29,9,Barry,2002,17347,16527,820,4.7
29,11,Barton,2002,6726,6437,289,4.3
29,13,Bates,2002,8063,7594,469,5.8
29,15,Benton,2002,8041,7521,520,6.5
29,17,Bollinger,2002,6246,5854,392,6.3
29,19,Boone,2002,81399,78631,2768,3.4
29,21,Buchanan,2002,43247,40777,2470,5.7
29,23,Butler,2002,20427,19320,1107,5.4
29,25,Caldwell,2002,4377,4143,234,5.3
29,27,Callaway,2002,22225,21252,973,4.4
29,29,Camden,2002,20172,19014,1158,5.7
29,31,Cape Girardeau,2002,39526,37885,1641,4.2
29,33,Carroll,2002,5153,4878,275,5.3
29,35,Carter,2002,2790,2605,185,6.6
29,37,Cass,2002,45936,43844,2092,4.6
29,39,Cedar,2002,6143,5781,362,5.9
29,41,Chariton,2002,4347,4078,269,6.2
29,43,Christian,2002,33072,31496,1576,4.8
29,45,Clark,2002,3699,3465,234,6.3
29,47,Clay,2002,107559,102973,4586,4.3
29,49,Clinton,2002,9995,9484,511,5.1
29,51,Cole,2002,39339,37831,1508,3.8
29,53,Cooper,2002,8787,8376,411,4.7
29,55,Crawford,2002,11735,11050,685,5.8
29,57,Dade,2002,3851,3665,186,4.8
29,59,Dallas,2002,7250,6828,422,5.8
29,61,Daviess,2002,3984,3791,193,4.8
29,63,DeKalb,2002,5038,4738,300,6.0
29,65,Dent,2002,6682,6270,412,6.2
29,67,Douglas,2002,5995,5488,507,8.5
29,69,Dunklin,2002,14893,13873,1020,6.8
29,71,Franklin,2002,51996,49165,2831,5.4
29,73,Gasconade,2002,7770,7337,433,5.6
29,75,Gentry,2002,3373,3208,165,4.9
29,77,Greene,2002,133282,127336,5946,4.5
29,79,Grundy,2002,5137,4873,264,5.1
29,81,Harrison,2002,4458,4238,220,4.9
29,83,Henry,2002,11008,10376,632,5.7
29,85,Hickory,2002,3352,3122,230,6.9
29,87,Holt,2002,2710,2588,122,4.5
29,89,Howard,2002,5363,5124,239,4.5
29,91,Howell,2002,19083,18146,937,4.9
29,93,Iron,2002,5038,4636,402,8.0
29,95,Jackson,2002,342397,321880,20517,6.0
29,97,Jasper,2002,53422,50658,2764,5.2
29,99,Jefferson,2002,112987,107171,5816,5.1
29,101,Johnson,2002,24721,23599,1122,4.5
29,103,Knox,2002,2150,2055,95,4.4
29,105,Laclede,2002,16801,15847,954,5.7
29,107,Lafayette,2002,16996,16147,849,5.0
29,109,Lawrence,2002,18325,17444,881,4.8
29,111,Lewis,2002,5719,5439,280,4.9
29,113,Lincoln,2002,22319,21125,1194,5.3
29,115,Linn,2002,7116,6620,496,7.0
29,117,Livingston,2002,7503,7176,327,4.4
29,119,McDonald,2002,11475,10900,575,5.0
29,121,Macon,2002,8243,7786,457,5.5
29,123,Madison,2002,5738,5337,401,7.0
29,125,Maries,2002,4775,4521,254,5.3
29,127,Marion,2002,14652,13871,781,5.3
29,129,Mercer,2002,1824,1736,88,4.8
29,131,Miller,2002,12769,11952,817,6.4
29,133,Mississippi,2002,5975,5523,452,7.6
29,135,Moniteau,2002,7455,7084,371,5.0
29,137,Monroe,2002,4542,4294,248,5.5
29,139,Montgomery,2002,6443,6108,335,5.2
29,141,Morgan,2002,9459,8836,623,6.6
29,143,New Madrid,2002,8963,8259,704,7.9
29,145,Newton,2002,27049,25478,1571,5.8
29,147,Nodaway,2002,12066,11650,416,3.4
29,149,Oregon,2002,4300,4067,233,5.4
29,151,Osage,2002,7282,6899,383,5.3
29,153,Ozark,2002,4456,4184,272,6.1
29,155,Pemiscot,2002,8334,7638,696,8.4
29,157,Perry,2002,9982,9580,402,4.0
29,159,Pettis,2002,20814,19581,1233,5.9
29,161,Phelps,2002,21441,20527,914,4.3
29,163,Pike,2002,8971,8514,457,5.1
29,165,Platte,2002,45831,43907,1924,4.2
29,167,Polk,2002,13372,12708,664,5.0
29,169,Pulaski,2002,16589,15713,876,5.3
29,171,Putnam,2002,2432,2321,111,4.6
29,173,Ralls,2002,5635,5343,292,5.2
29,175,Randolph,2002,12785,12115,670,5.2
29,177,Ray,2002,11821,11254,567,4.8
29,179,Reynolds,2002,2536,2330,206,8.1
29,181,Ripley,2002,6071,5689,382,6.3
29,183,St. Charles,2002,175352,168111,7241,4.1
29,185,St. Clair,2002,4501,4236,265,5.9
29,186,Ste. Genevieve,2002,9463,8974,489,5.2
29,187,St. Francois,2002,26719,24917,1802,6.7
29,189,St. Louis,2002,552722,525987,26735,4.8
29,195,Saline,2002,11867,11195,672,5.7
29,197,Schuyler,2002,2181,2059,122,5.6
29,199,Scotland,2002,2498,2387,111,4.4
29,201,Scott,2002,20708,19571,1137,5.5
29,203,Shannon,2002,4011,3743,268,6.7
29,205,Shelby,2002,3229,3053,176,5.5
29,207,Stoddard,2002,15269,14352,917,6.0
29,209,Stone,2002,15369,14073,1296,8.4
29,211,Sullivan,2002,3659,3476,183,5.0
29,213,Taney,2002,24543,22352,2191,8.9
29,215,Texas,2002,10798,10106,692,6.4
29,217,Vernon,2002,10447,9928,519,5.0
29,219,Warren,2002,14277,13532,745,5.2
29,221,Washington,2002,10059,9215,844,8.4
29,223,Wayne,2002,5696,5261,435,7.6
29,225,Webster,2002,15850,14974,876,5.5
29,227,Worth,2002,1202,1151,51,4.2
29,229,Wright,2002,8159,7610,549,6.7
29,510,St. Louis city,2002,163205,150254,12951,7.9
30,1,Beaverhead,2002,5126,4931,195,3.8
30,3,Big Horn,2002,4908,4373,535,10.9
30,5,Blaine,2002,2764,2626,138,5.0
30,7,Broadwater,2002,2209,2118,91,4.1
30,9,Carbon,2002,5188,4989,199,3.8
30,11,Carter,2002,657,635,22,3.3
30,13,Cascade,2002,37988,36334,1654,4.4
30,15,Chouteau,2002,2463,2375,88,3.6
30,17,Custer,2002,5706,5486,220,3.9
30,19,Daniels,2002,878,839,39,4.4
30,21,Dawson,2002,4312,4162,150,3.5
30,23,Deer Lodge,2002,4238,3978,260,6.1
30,25,Fallon,2002,1565,1513,52,3.3
30,27,Fergus,2002,5848,5569,279,4.8
30,29,Flathead,2002,39908,37812,2096,5.3
30,31,Gallatin,2002,41939,40482,1457,3.5
30,33,Garfield,2002,621,598,23,3.7
30,35,Glacier,2002,5566,5178,388,7.0
30,37,Golden Valley,2002,435,413,22,5.1
30,39,Granite,2002,1286,1210,76,5.9
30,41,Hill,2002,7831,7502,329,4.2
30,43,Jefferson,2002,5337,5103,234,4.4
30,45,Judith Basin,2002,1073,1019,54,5.0
30,47,Lake,2002,11496,10715,781,6.8
30,49,Lewis and Clark,2002,30437,29201,1236,4.1
30,51,Liberty,2002,831,797,34,4.1
30,53,Lincoln,2002,7545,6850,695,9.2
30,55,McCone,2002,992,965,27,2.7
30,57,Madison,2002,3311,3158,153,4.6
30,59,Meagher,2002,885,834,51,5.8
30,61,Mineral,2002,1900,1768,132,6.9
30,63,Missoula,2002,55888,53661,2227,4.0
30,65,Musselshell,2002,2055,1925,130,6.3
30,67,Park,2002,8623,8222,401,4.7
30,69,Petroleum,2002,197,186,11,5.6
30,71,Phillips,2002,2102,2007,95,4.5
30,73,Pondera,2002,2747,2620,127,4.6
30,75,Powder River,2002,885,852,33,3.7
30,77,Powell,2002,2755,2580,175,6.4
30,79,Prairie,2002,564,535,29,5.1
30,81,Ravalli,2002,17468,16542,926,5.3
30,83,Richland,2002,4777,4533,244,5.1
30,85,Roosevelt,2002,4066,3824,242,6.0
30,87,Rosebud,2002,4001,3766,235,5.9
30,89,Sanders,2002,4398,4074,324,7.4
30,91,Sheridan,2002,1827,1752,75,4.1
30,93,Silver Bow,2002,16989,16105,884,5.2
30,95,Stillwater,2002,4473,4287,186,4.2
30,97,Sweet Grass,2002,2132,2065,67,3.1
30,99,Teton,2002,2897,2784,113,3.9
30,101,Toole,2002,2341,2256,85,3.6
30,103,Treasure,2002,398,382,16,4.0
30,105,Valley,2002,3676,3524,152,4.1
30,107,Wheatland,2002,1007,955,52,5.2
30,109,Wibaux,2002,503,483,20,4.0
30,111,Yellowstone,2002,74402,71672,2730,3.7
31,1,Adams,2002,16939,16329,610,3.6
31,3,Antelope,2002,3910,3788,122,3.1
31,5,Arthur,2002,242,231,11,4.5
31,7,Banner,2002,397,386,11,2.8
31,9,Blaine,2002,289,279,10,3.5
31,11,Boone,2002,3245,3146,99,3.1
31,13,Box Butte,2002,5694,5423,271,4.8
31,15,Boyd,2002,1260,1216,44,3.5
31,17,Brown,2002,1895,1829,66,3.5
31,19,Buffalo,2002,26064,25394,670,2.6
31,21,Burt,2002,4049,3854,195,4.8
31,23,Butler,2002,4638,4448,190,4.1
31,25,Cass,2002,13677,13182,495,3.6
31,27,Cedar,2002,5062,4930,132,2.6
31,29,Chase,2002,2090,2037,53,2.5
31,31,Cherry,2002,3549,3450,99,2.8
31,33,Cheyenne,2002,4857,4699,158,3.3
31,35,Clay,2002,3422,3294,128,3.7
31,37,Colfax,2002,5944,5770,174,2.9
31,39,Cuming,2002,5540,5397,143,2.6
31,41,Custer,2002,6457,6287,170,2.6
31,43,Dakota,2002,10735,10265,470,4.4
31,45,Dawes,2002,5020,4871,149,3.0
31,47,Dawson,2002,12311,11829,482,3.9
31,49,Deuel,2002,1120,1090,30,2.7
31,51,Dixon,2002,3193,3096,97,3.0
31,53,Dodge,2002,19498,18637,861,4.4
31,55,Douglas,2002,261436,250087,11349,4.3
31,57,Dundy,2002,1227,1181,46,3.7
31,59,Fillmore,2002,3435,3315,120,3.5
31,61,Franklin,2002,1886,1818,68,3.6
31,63,Frontier,2002,1801,1758,43,2.4
31,65,Furnas,2002,2564,2481,83,3.2
31,67,Gage,2002,12931,12446,485,3.8
31,69,Garden,2002,1109,1071,38,3.4
31,71,Garfield,2002,1049,1019,30,2.9
31,73,Gosper,2002,1097,1064,33,3.0
31,75,Grant,2002,414,403,11,2.7
31,77,Greeley,2002,1413,1363,50,3.5
31,79,Hall,2002,28871,27735,1136,3.9
31,81,Hamilton,2002,5267,5108,159,3.0
31,83,Harlan,2002,1899,1842,57,3.0
31,85,Hayes,2002,579,561,18,3.1
31,87,Hitchcock,2002,1504,1456,48,3.2
31,89,Holt,2002,6199,6017,182,2.9
31,91,Hooker,2002,415,401,14,3.4
31,93,Howard,2002,3519,3392,127,3.6
31,95,Jefferson,2002,4342,4145,197,4.5
31,97,Johnson,2002,2882,2797,85,2.9
31,99,Kearney,2002,3851,3744,107,2.8
31,101,Keith,2002,5041,4878,163,3.2
31,103,Keya Paha,2002,442,425,17,3.8
31,105,Kimball,2002,2107,2052,55,2.6
31,107,Knox,2002,4779,4616,163,3.4
31,109,Lancaster,2002,151168,146304,4864,3.2
31,111,Lincoln,2002,19844,19185,659,3.3
31,113,Logan,2002,441,430,11,2.5
31,115,Loup,2002,334,322,12,3.6
31,117,McPherson,2002,304,299,5,1.6
31,119,Madison,2002,19122,18367,755,3.9
31,121,Merrick,2002,4224,4066,158,3.7
31,123,Morrill,2002,2835,2717,118,4.2
31,125,Nance,2002,2076,1984,92,4.4
31,127,Nemaha,2002,3645,3486,159,4.4
31,129,Nuckolls,2002,2473,2399,74,3.0
31,131,Otoe,2002,8534,8204,330,3.9
31,133,Pawnee,2002,1637,1577,60,3.7
31,135,Perkins,2002,1698,1656,42,2.5
31,137,Phelps,2002,5356,5201,155,2.9
31,139,Pierce,2002,4046,3900,146,3.6
31,141,Platte,2002,17163,16420,743,4.3
31,143,Polk,2002,3041,2945,96,3.2
31,145,Red Willow,2002,6059,5877,182,3.0
31,147,Richardson,2002,4549,4285,264,5.8
31,149,Rock,2002,1024,996,28,2.7
31,151,Saline,2002,8104,7862,242,3.0
31,153,Sarpy,2002,68551,66418,2133,3.1
31,155,Saunders,2002,10985,10588,397,3.6
31,157,Scotts Bluff,2002,18762,17928,834,4.4
31,159,Seward,2002,9214,8938,276,3.0
31,161,Sheridan,2002,3236,3148,88,2.7
31,163,Sherman,2002,1872,1816,56,3.0
31,165,Sioux,2002,787,767,20,2.5
31,167,Stanton,2002,3477,3370,107,3.1
31,169,Thayer,2002,2970,2868,102,3.4
31,171,Thomas,2002,412,395,17,4.1
31,173,Thurston,2002,2815,2616,199,7.1
31,175,Valley,2002,2536,2464,72,2.8
31,177,Washington,2002,11035,10715,320,2.9
31,179,Wayne,2002,5458,5301,157,2.9
31,181,Webster,2002,2025,1953,72,3.6
31,183,Wheeler,2002,503,492,11,2.2
31,185,York,2002,7467,7243,224,3.0
32,1,Churchill,2002,12413,11779,634,5.1
32,3,Clark,2002,785955,739460,46495,5.9
32,5,Douglas,2002,22026,20915,1111,5.0
32,7,Elko,2002,23467,22383,1084,4.6
32,9,Esmeralda,2002,491,456,35,7.1
32,11,Eureka,2002,774,738,36,4.7
32,13,Humboldt,2002,7462,7048,414,5.5
32,15,Lander,2002,2637,2473,164,6.2
32,17,Lincoln,2002,1794,1706,88,4.9
32,19,Lyon,2002,19951,18794,1157,5.8
32,21,Mineral,2002,2191,2060,131,6.0
32,23,Nye,2002,15064,13950,1114,7.4
32,27,Pershing,2002,2622,2496,126,4.8
32,29,Storey,2002,1979,1901,78,3.9
32,31,Washoe,2002,203926,193836,10090,4.9
32,33,White Pine,2002,3853,3695,158,4.1
32,510,Carson City,2002,27492,25910,1582,5.8
33,1,Belknap,2002,31585,30354,1231,3.9
33,3,Carroll,2002,24180,23310,870,3.6
33,5,Cheshire,2002,40234,38810,1424,3.5
33,7,Coos,2002,16742,15629,1113,6.6
33,9,Grafton,2002,45322,43982,1340,3.0
33,11,Hillsborough,2002,216151,205738,10413,4.8
33,13,Merrimack,2002,76827,74180,2647,3.4
33,15,Rockingham,2002,164758,155687,9071,5.5
33,17,Strafford,2002,63350,60574,2776,4.4
33,19,Sullivan,2002,21405,20721,684,3.2
34,1,Atlantic,2002,131075,123252,7823,6.0
34,3,Bergen,2002,463621,440301,23320,5.0
34,5,Burlington,2002,228489,217473,11016,4.8
34,7,Camden,2002,256945,241922,15023,5.8
34,9,Cape May,2002,55319,50933,4386,7.9
34,11,Cumberland,2002,66353,61356,4997,7.5
34,13,Essex,2002,369189,342618,26571,7.2
34,15,Gloucester,2002,138951,131691,7260,5.2
34,17,Hudson,2002,294442,271984,22458,7.6
34,19,Hunterdon,2002,69771,66902,2869,4.1
34,21,Mercer,2002,185649,175884,9765,5.3
34,23,Middlesex,2002,411276,388269,23007,5.6
34,25,Monmouth,2002,323831,306835,16996,5.2
34,27,Morris,2002,263966,251885,12081,4.6
34,29,Ocean,2002,242055,228882,13173,5.4
34,31,Passaic,2002,235449,218931,16518,7.0
34,33,Salem,2002,31009,29206,1803,5.8
34,35,Somerset,2002,170680,162597,8083,4.7
34,37,Sussex,2002,81438,77444,3994,4.9
34,39,Union,2002,268090,251144,16946,6.3
34,41,Warren,2002,57678,54881,2797,4.8
35,1,Bernalillo,2002,291698,277448,14250,4.9
35,3,Catron,2002,1413,1326,87,6.2
35,5,Chaves,2002,25509,23864,1645,6.4
35,6,Cibola,2002,10772,10087,685,6.4
35,7,Colfax,2002,6892,6522,370,5.4
35,9,Curry,2002,19250,18343,907,4.7
35,11,De Baca,2002,877,833,44,5.0
35,13,Dona Ana,2002,78692,73817,4875,6.2
35,15,Eddy,2002,23760,22380,1380,5.8
35,17,Grant,2002,12629,11389,1240,9.8
35,19,Guadalupe,2002,1694,1564,130,7.7
35,21,Harding,2002,418,401,17,4.1
35,23,Hidalgo,2002,2370,2265,105,4.4
35,25,Lea,2002,23177,21938,1239,5.3
35,27,Lincoln,2002,10223,9812,411,4.0
35,28,Los Alamos,2002,10831,10577,254,2.3
35,29,Luna,2002,11064,9415,1649,14.9
35,31,McKinley,2002,25235,23693,1542,6.1
35,33,Mora,2002,2048,1839,209,10.2
35,35,Otero,2002,24643,23256,1387,5.6
35,37,Quay,2002,3982,3766,216,5.4
35,39,Rio Arriba,2002,19596,18326,1270,6.5
35,41,Roosevelt,2002,9010,8638,372,4.1
35,43,Sandoval,2002,45518,42830,2688,5.9
35,45,San Juan,2002,50784,47686,3098,6.1
35,47,San Miguel,2002,13262,12446,816,6.2
35,49,Santa Fe,2002,71363,68592,2771,3.9
35,51,Sierra,2002,5322,5038,284,5.3
35,53,Socorro,2002,8466,8042,424,5.0
35,55,Taos,2002,16786,15680,1106,6.6
35,57,Torrance,2002,7249,6893,356,4.9
35,59,Union,2002,1990,1918,72,3.6
35,61,Valencia,2002,30329,28652,1677,5.5
36,1,Albany,2002,157688,151424,6264,4.0
36,3,Allegany,2002,23453,22175,1278,5.4
36,5,Bronx,2002,499390,450718,48672,9.7
36,7,Broome,2002,98808,93018,5790,5.9
36,9,Cattaraugus,2002,41762,39397,2365,5.7
36,11,Cayuga,2002,41233,39230,2003,4.9
36,13,Chautauqua,2002,67447,63654,3793,5.6
36,15,Chemung,2002,42285,39545,2740,6.5
36,17,Chenango,2002,24623,23241,1382,5.6
36,19,Clinton,2002,39665,37522,2143,5.4
36,21,Columbia,2002,31297,29945,1352,4.3
36,23,Cortland,2002,24634,23156,1478,6.0
36,25,Delaware,2002,23069,21961,1108,4.8
36,27,Dutchess,2002,143264,137191,6073,4.2
36,29,Erie,2002,470243,444593,25650,5.5
36,31,Essex,2002,18783,17806,977,5.2
36,33,Franklin,2002,22278,20909,1369,6.1
36,35,Fulton,2002,26917,25565,1352,5.0
36,37,Genesee,2002,33105,31338,1767,5.3
36,39,Greene,2002,23734,22559,1175,5.0
36,41,Hamilton,2002,2916,2768,148,5.1
36,43,Herkimer,2002,31441,29733,1708,5.4
36,45,Jefferson,2002,45899,42775,3124,6.8
36,47,Kings,2002,1052453,961354,91099,8.7
36,49,Lewis,2002,12631,11832,799,6.3
36,51,Livingston,2002,32841,30951,1890,5.8
36,53,Madison,2002,35423,33539,1884,5.3
36,55,Monroe,2002,375834,355608,20226,5.4
36,57,Montgomery,2002,24012,22630,1382,5.8
36,59,Nassau,2002,681745,649939,31806,4.7
36,61,New York,2002,875468,808754,66714,7.6
36,63,Niagara,2002,111209,104108,7101,6.4
36,65,Oneida,2002,111006,105078,5928,5.3
36,67,Onondaga,2002,231880,220418,11462,4.9
36,69,Ontario,2002,55040,52177,2863,5.2
36,71,Orange,2002,169025,161622,7403,4.4
36,73,Orleans,2002,19945,18669,1276,6.4
36,75,Oswego,2002,59324,55482,3842,6.5
36,77,Otsego,2002,31283,29804,1479,4.7
36,79,Putnam,2002,53814,51658,2156,4.0
36,81,Queens,2002,1071287,994972,76315,7.1
36,83,Rensselaer,2002,82211,78434,3777,4.6
36,85,Richmond,2002,222017,206586,15431,7.0
36,87,Rockland,2002,147197,140702,6495,4.4
36,89,St. Lawrence,2002,49848,46527,3321,6.7
36,91,Saratoga,2002,115212,110739,4473,3.9
36,93,Schenectady,2002,73835,70747,3088,4.2
36,95,Schoharie,2002,15568,14679,889,5.7
36,97,Schuyler,2002,9648,8969,679,7.0
36,99,Seneca,2002,17069,16136,933,5.5
36,101,Steuben,2002,47128,43747,3381,7.2
36,103,Suffolk,2002,754090,718442,35648,4.7
36,105,Sullivan,2002,34329,32598,1731,5.0
36,107,Tioga,2002,26735,25253,1482,5.5
36,109,Tompkins,2002,52573,50407,2166,4.1
36,111,Ulster,2002,90793,86753,4040,4.4
36,113,Warren,2002,33757,32060,1697,5.0
36,115,Washington,2002,30424,29009,1415,4.7
36,117,Wayne,2002,49113,46000,3113,6.3
36,119,Westchester,2002,471279,449680,21599,4.6
36,121,Wyoming,2002,21212,19986,1226,5.8
36,123,Yates,2002,12585,11966,619,4.9
37,1,Alamance,2002,69518,64296,5222,7.5
37,3,Alexander,2002,18777,17397,1380,7.3
37,5,Alleghany,2002,4890,4427,463,9.5
37,7,Anson,2002,11130,10065,1065,9.6
37,9,Ashe,2002,12699,11586,1113,8.8
37,11,Avery,2002,7659,7134,525,6.9
37,13,Beaufort,2002,19766,17899,1867,9.4
37,15,Bertie,2002,8195,7504,691,8.4
37,17,Bladen,2002,14852,13356,1496,10.1
37,19,Brunswick,2002,37756,35027,2729,7.2
37,21,Buncombe,2002,110944,105071,5873,5.3
37,23,Burke,2002,43856,40273,3583,8.2
37,25,Cabarrus,2002,75491,71119,4372,5.8
37,27,Caldwell,2002,41126,37710,3416,8.3
37,29,Camden,2002,3549,3383,166,4.7
37,31,Carteret,2002,30177,28316,1861,6.2
37,33,Caswell,2002,10978,10054,924,8.4
37,35,Catawba,2002,79288,72376,6912,8.7
37,37,Chatham,2002,29127,27505,1622,5.6
37,39,Cherokee,2002,10053,8977,1076,10.7
37,41,Chowan,2002,6376,5975,401,6.3
37,43,Clay,2002,4082,3836,246,6.0
37,45,Cleveland,2002,49074,43893,5181,10.6
37,47,Columbus,2002,22946,20811,2135,9.3
37,49,Craven,2002,38814,36358,2456,6.3
37,51,Cumberland,2002,120833,112247,8586,7.1
37,53,Currituck,2002,10015,9704,311,3.1
37,55,Dare,2002,20869,19663,1206,5.8
37,57,Davidson,2002,79534,74041,5493,6.9
37,59,Davie,2002,19145,17995,1150,6.0
37,61,Duplin,2002,23049,21265,1784,7.7
37,63,Durham,2002,128080,120219,7861,6.1
37,65,Edgecombe,2002,25338,22460,2878,11.4
37,67,Forsyth,2002,166062,156164,9898,6.0
37,69,Franklin,2002,25167,23453,1714,6.8
37,71,Gaston,2002,100273,92225,8048,8.0
37,73,Gates,2002,4693,4478,215,4.6
37,75,Graham,2002,3855,3462,393,10.2
37,77,Granville,2002,24155,22320,1835,7.6
37,79,Greene,2002,8567,7914,653,7.6
37,81,Guilford,2002,238284,222581,15703,6.6
37,83,Halifax,2002,22582,20166,2416,10.7
37,85,Harnett,2002,43255,39898,3357,7.8
37,87,Haywood,2002,26873,25066,1807,6.7
37,89,Henderson,2002,44227,41822,2405,5.4
37,91,Hertford,2002,9492,8783,709,7.5
37,93,Hoke,2002,15501,14259,1242,8.0
37,95,Hyde,2002,2742,2529,213,7.8
37,97,Iredell,2002,67221,62572,4649,6.9
37,99,Jackson,2002,19032,18051,981,5.2
37,101,Johnston,2002,66565,62661,3904,5.9
37,103,Jones,2002,4687,4353,334,7.1
37,105,Lee,2002,25179,23178,2001,7.9
37,107,Lenoir,2002,26967,24573,2394,8.9
37,109,Lincoln,2002,35610,32965,2645,7.4
37,111,McDowell,2002,21573,19727,1846,8.6
37,113,Macon,2002,15075,14231,844,5.6
37,115,Madison,2002,9650,9047,603,6.2
37,117,Martin,2002,11954,11143,811,6.8
37,119,Mecklenburg,2002,413695,388524,25171,6.1
37,121,Mitchell,2002,7766,6959,807,10.4
37,123,Montgomery,2002,12757,11680,1077,8.4
37,125,Moore,2002,35109,32752,2357,6.7
37,127,Nash,2002,43978,40351,3627,8.2
37,129,New Hanover,2002,90204,84282,5922,6.6
37,131,Northampton,2002,8557,7724,833,9.7
37,133,Onslow,2002,53797,50156,3641,6.8
37,135,Orange,2002,65162,62226,2936,4.5
37,137,Pamlico,2002,5439,5115,324,6.0
37,139,Pasquotank,2002,15767,14857,910,5.8
37,141,Pender,2002,20369,18741,1628,8.0
37,143,Perquimans,2002,4865,4581,284,5.8
37,145,Person,2002,18810,17326,1484,7.9
37,147,Pitt,2002,69099,64358,4741,6.9
37,149,Polk,2002,8682,8208,474,5.5
37,151,Randolph,2002,73933,69018,4915,6.6
37,153,Richmond,2002,20642,18371,2271,11.0
37,155,Robeson,2002,52416,47110,5306,10.1
37,157,Rockingham,2002,46764,42875,3889,8.3
37,159,Rowan,2002,65944,61574,4370,6.6
37,161,Rutherford,2002,30800,27800,3000,9.7
37,163,Sampson,2002,29487,27400,2087,7.1
37,165,Scotland,2002,15974,14343,1631,10.2
37,167,Stanly,2002,29361,27161,2200,7.5
37,169,Stokes,2002,24082,22563,1519,6.3
37,171,Surry,2002,36286,33326,2960,8.2
37,173,Swain,2002,6648,6055,593,8.9
37,175,Transylvania,2002,13252,12248,1004,7.6
37,177,Tyrrell,2002,2026,1848,178,8.8
37,179,Union,2002,73948,69874,4074,5.5
37,181,Vance,2002,20135,18034,2101,10.4
37,183,Wake,2002,379880,357422,22458,5.9
37,185,Warren,2002,7988,7236,752,9.4
37,187,Washington,2002,6025,5523,502,8.3
37,189,Watauga,2002,22299,21251,1048,4.7
37,191,Wayne,2002,50896,47510,3386,6.7
37,193,Wilkes,2002,33462,30542,2920,8.7
37,195,Wilson,2002,38227,35180,3047,8.0
37,197,Yadkin,2002,19491,18296,1195,6.1
37,199,Yancey,2002,8040,7262,778,9.7
38,1,Adams,2002,1236,1197,39,3.2
38,3,Barnes,2002,6029,5840,189,3.1
38,5,Benson,2002,2678,2533,145,5.4
38,7,Billings,2002,507,494,13,2.6
38,9,Bottineau,2002,3605,3456,149,4.1
38,11,Bowman,2002,1717,1679,38,2.2
38,13,Burke,2002,1018,984,34,3.3
38,15,Burleigh,2002,40977,39805,1172,2.9
38,17,Cass,2002,76453,74489,1964,2.6
38,19,Cavalier,2002,2251,2171,80,3.6
38,21,Dickey,2002,2896,2818,78,2.7
38,23,Divide,2002,1038,1005,33,3.2
38,25,Dunn,2002,1758,1693,65,3.7
38,27,Eddy,2002,1375,1309,66,4.8
38,29,Emmons,2002,2024,1920,104,5.1
38,31,Foster,2002,1844,1784,60,3.3
38,33,Golden Valley,2002,906,883,23,2.5
38,35,Grand Forks,2002,35976,34787,1189,3.3
38,37,Grant,2002,1327,1281,46,3.5
38,39,Griggs,2002,1328,1287,41,3.1
38,41,Hettinger,2002,1251,1207,44,3.5
38,43,Kidder,2002,1253,1186,67,5.3
38,45,LaMoure,2002,2275,2202,73,3.2
38,47,Logan,2002,971,939,32,3.3
38,49,McHenry,2002,2789,2627,162,5.8
38,51,McIntosh,2002,1496,1452,44,2.9
38,53,McKenzie,2002,2666,2570,96,3.6
38,55,McLean,2002,4616,4379,237,5.1
38,57,Mercer,2002,4623,4425,198,4.3
38,59,Morton,2002,13811,13326,485,3.5
38,61,Mountrail,2002,2929,2781,148,5.1
38,63,Nelson,2002,1699,1630,69,4.1
38,65,Oliver,2002,1080,1035,45,4.2
38,67,Pembina,2002,4206,3969,237,5.6
38,69,Pierce,2002,1945,1858,87,4.5
38,71,Ramsey,2002,6133,5912,221,3.6
38,73,Ransom,2002,2999,2921,78,2.6
38,75,Renville,2002,1305,1269,36,2.8
38,77,Richland,2002,9288,8984,304,3.3
38,79,Rolette,2002,5478,4869,609,11.1
38,81,Sargent,2002,2124,2056,68,3.2
38,83,Sheridan,2002,717,675,42,5.9
38,85,Sioux,2002,1349,1284,65,4.8
38,87,Slope,2002,460,451,9,2.0
38,89,Stark,2002,12694,12293,401,3.2
38,91,Steele,2002,1159,1134,25,2.2
38,93,Stutsman,2002,11673,11310,363,3.1
38,95,Towner,2002,1351,1304,47,3.5
38,97,Traill,2002,4137,3985,152,3.7
38,99,Walsh,2002,6094,5851,243,4.0
38,101,Ward,2002,27728,26748,980,3.5
38,103,Wells,2002,2296,2198,98,4.3
38,105,Williams,2002,10936,10613,323,3.0
39,1,Adams,2002,12538,11296,1242,9.9
39,3,Allen,2002,51799,48391,3408,6.6
39,5,Ashland,2002,27096,25353,1743,6.4
39,7,Ashtabula,2002,50425,46595,3830,7.6
39,9,Athens,2002,28804,26986,1818,6.3
39,11,Auglaize,2002,24864,23372,1492,6.0
39,13,Belmont,2002,31597,29365,2232,7.1
39,15,Brown,2002,21164,19651,1513,7.1
39,17,Butler,2002,177123,167480,9643,5.4
39,19,Carroll,2002,14341,13355,986,6.9
39,21,Champaign,2002,20472,19165,1307,6.4
39,23,Clark,2002,71824,66646,5178,7.2
39,25,Clermont,2002,98329,92823,5506,5.6
39,27,Clinton,2002,21579,20463,1116,5.2
39,29,Columbiana,2002,53669,49879,3790,7.1
39,31,Coshocton,2002,17692,16510,1182,6.7
39,33,Crawford,2002,22982,21274,1708,7.4
39,35,Cuyahoga,2002,683799,649554,34245,5.0
39,37,Darke,2002,28278,26477,1801,6.4
39,39,Defiance,2002,20667,19433,1234,6.0
39,41,Delaware,2002,71258,68247,3011,4.2
39,43,Erie,2002,42983,40461,2522,5.9
39,45,Fairfield,2002,68703,65061,3642,5.3
39,47,Fayette,2002,15331,14437,894,5.8
39,49,Franklin,2002,599741,568762,30979,5.2
39,51,Fulton,2002,22511,21145,1366,6.1
39,53,Gallia,2002,13943,12906,1037,7.4
39,55,Geauga,2002,49675,47829,1846,3.7
39,57,Greene,2002,76393,72392,4001,5.2
39,59,Guernsey,2002,19494,18172,1322,6.8
39,61,Hamilton,2002,423119,399588,23531,5.6
39,63,Hancock,2002,39080,37272,1808,4.6
39,65,Hardin,2002,15493,14556,937,6.0
39,67,Harrison,2002,7430,6907,523,7.0
39,69,Henry,2002,15464,14504,960,6.2
39,71,Highland,2002,19869,18644,1225,6.2
39,73,Hocking,2002,13485,12624,861,6.4
39,75,Holmes,2002,18150,17436,714,3.9
39,77,Huron,2002,30298,28063,2235,7.4
39,79,Jackson,2002,14861,13674,1187,8.0
39,81,Jefferson,2002,31966,29740,2226,7.0
39,83,Knox,2002,28278,26711,1567,5.5
39,85,Lake,2002,130884,125005,5879,4.5
39,87,Lawrence,2002,26791,24965,1826,6.8
39,89,Licking,2002,78565,74393,4172,5.3
39,91,Logan,2002,24267,22913,1354,5.6
39,93,Lorain,2002,150176,142679,7497,5.0
39,95,Lucas,2002,225330,209410,15920,7.1
39,97,Madison,2002,19400,18378,1022,5.3
39,99,Mahoning,2002,117928,109323,8605,7.3
39,101,Marion,2002,32089,30201,1888,5.9
39,103,Medina,2002,88425,84846,3579,4.0
39,105,Meigs,2002,9459,8586,873,9.2
39,107,Mercer,2002,21938,20768,1170,5.3
39,109,Miami,2002,54153,51032,3121,5.8
39,111,Monroe,2002,6069,5583,486,8.0
39,113,Montgomery,2002,276008,258969,17039,6.2
39,115,Morgan,2002,6606,6001,605,9.2
39,117,Morrow,2002,17010,16058,952,5.6
39,119,Muskingum,2002,41838,38945,2893,6.9
39,121,Noble,2002,5767,5336,431,7.5
39,123,Ottawa,2002,21254,19667,1587,7.5
39,125,Paulding,2002,10618,10017,601,5.7
39,127,Perry,2002,16619,15443,1176,7.1
39,129,Pickaway,2002,23424,21950,1474,6.3
39,131,Pike,2002,11331,10236,1095,9.7
39,133,Portage,2002,84867,80086,4781,5.6
39,135,Preble,2002,21997,20623,1374,6.2
39,137,Putnam,2002,17911,17053,858,4.8
39,139,Richland,2002,63500,59099,4401,6.9
39,141,Ross,2002,33923,31578,2345,6.9
39,143,Sandusky,2002,32973,30971,2002,6.1
39,145,Scioto,2002,33034,30270,2764,8.4
39,147,Seneca,2002,30367,28239,2128,7.0
39,149,Shelby,2002,26217,24773,1444,5.5
39,151,Stark,2002,191973,180279,11694,6.1
39,153,Summit,2002,280511,263162,17349,6.2
39,155,Trumbull,2002,106236,98673,7563,7.1
39,157,Tuscarawas,2002,46315,43583,2732,5.9
39,159,Union,2002,22983,21980,1003,4.4
39,161,Van Wert,2002,15114,14208,906,6.0
39,163,Vinton,2002,5773,5265,508,8.8
39,165,Warren,2002,90697,86324,4373,4.8
39,167,Washington,2002,32071,30164,1907,5.9
39,169,Wayne,2002,59635,56594,3041,5.1
39,171,Williams,2002,20135,18827,1308,6.5
39,173,Wood,2002,65911,62324,3587,5.4
39,175,Wyandot,2002,12839,12116,723,5.6
40,1,Adair,2002,9183,8742,441,4.8
40,3,Alfalfa,2002,2505,2420,85,3.4
40,5,Atoka,2002,5406,5143,263,4.9
40,7,Beaver,2002,2944,2846,98,3.3
40,9,Beckham,2002,8927,8559,368,4.1
40,11,Blaine,2002,4659,4445,214,4.6
40,13,Bryan,2002,17939,17271,668,3.7
40,15,Caddo,2002,12283,11712,571,4.6
40,17,Canadian,2002,48366,46360,2006,4.1
40,19,Carter,2002,21798,20776,1022,4.7
40,21,Cherokee,2002,19772,18997,775,3.9
40,23,Choctaw,2002,6521,6119,402,6.2
40,25,Cimarron,2002,1472,1419,53,3.6
40,27,Cleveland,2002,115035,110895,4140,3.6
40,29,Coal,2002,2493,2335,158,6.3
40,31,Comanche,2002,44088,42316,1772,4.0
40,33,Cotton,2002,2801,2682,119,4.2
40,35,Craig,2002,6645,6311,334,5.0
40,37,Creek,2002,32453,30738,1715,5.3
40,39,Custer,2002,12919,12481,438,3.4
40,41,Delaware,2002,16565,15771,794,4.8
40,43,Dewey,2002,2347,2262,85,3.6
40,45,Ellis,2002,2097,2027,70,3.3
40,47,Garfield,2002,27666,26707,959,3.5
40,49,Garvin,2002,12963,12363,600,4.6
40,51,Grady,2002,22525,21631,894,4.0
40,53,Grant,2002,2558,2471,87,3.4
40,55,Greer,2002,2266,2152,114,5.0
40,57,Harmon,2002,1420,1362,58,4.1
40,59,Harper,2002,1917,1855,62,3.2
40,61,Haskell,2002,5591,5293,298,5.3
40,63,Hughes,2002,5294,4923,371,7.0
40,65,Jackson,2002,12099,11672,427,3.5
40,67,Jefferson,2002,2491,2346,145,5.8
40,69,Johnston,2002,4507,4301,206,4.6
40,71,Kay,2002,22932,21651,1281,5.6
40,73,Kingfisher,2002,7269,7039,230,3.2
40,75,Kiowa,2002,4563,4394,169,3.7
40,77,Latimer,2002,4075,3790,285,7.0
40,79,Le Flore,2002,21171,19912,1259,5.9
40,81,Lincoln,2002,15033,14309,724,4.8
40,83,Logan,2002,17386,16798,588,3.4
40,85,Love,2002,4360,4173,187,4.3
40,87,McClain,2002,14015,13414,601,4.3
40,89,McCurtain,2002,14915,13943,972,6.5
40,91,McIntosh,2002,8080,7581,499,6.2
40,93,Major,2002,3768,3646,122,3.2
40,95,Marshall,2002,5777,5508,269,4.7
40,97,Mayes,2002,16811,15671,1140,6.8
40,99,Murray,2002,5988,5699,289,4.8
40,101,Muskogee,2002,30013,28471,1542,5.1
40,103,Noble,2002,5375,5137,238,4.4
40,105,Nowata,2002,4909,4635,274,5.6
40,107,Okfuskee,2002,4812,4542,270,5.6
40,109,Oklahoma,2002,333096,317680,15416,4.6
40,111,Okmulgee,2002,16984,16007,977,5.8
40,113,Osage,2002,21058,20002,1056,5.0
40,115,Ottawa,2002,15079,14044,1035,6.9
40,117,Pawnee,2002,7956,7523,433,5.4
40,119,Payne,2002,34791,33609,1182,3.4
40,121,Pittsburg,2002,18524,17424,1100,5.9
40,123,Pontotoc,2002,16824,16032,792,4.7
40,125,Pottawatomie,2002,29955,28504,1451,4.8
40,127,Pushmataha,2002,4750,4422,328,6.9
40,129,Roger Mills,2002,1827,1770,57,3.1
40,131,Rogers,2002,37900,36233,1667,4.4
40,133,Seminole,2002,10596,9885,711,6.7
40,135,Sequoyah,2002,17667,16607,1060,6.0
40,137,Stephens,2002,19429,18503,926,4.8
40,139,Texas,2002,10337,10003,334,3.2
40,141,Tillman,2002,3803,3648,155,4.1
40,143,Tulsa,2002,299244,285000,14244,4.8
40,145,Wagoner,2002,30687,29420,1267,4.1
40,147,Washington,2002,23179,22193,986,4.3
40,149,Washita,2002,5772,5569,203,3.5
40,151,Woods,2002,4629,4260,369,8.0
40,153,Woodward,2002,9485,9101,384,4.0
41,1,Baker,2002,7356,6695,661,9.0
41,3,Benton,2002,41979,39774,2205,5.3
41,5,Clackamas,2002,188769,175830,12939,6.9
41,7,Clatsop,2002,18078,16838,1240,6.9
41,9,Columbia,2002,22952,20809,2143,9.3
41,11,Coos,2002,27395,25000,2395,8.7
41,13,Crook,2002,8767,7961,806,9.2
41,15,Curry,2002,8810,8107,703,8.0
41,17,Deschutes,2002,65422,60402,5020,7.7
41,19,Douglas,2002,46987,42864,4123,8.8
41,21,Gilliam,2002,1060,991,69,6.5
41,23,Grant,2002,3742,3393,349,9.3
41,25,Harney,2002,3594,3251,343,9.5
41,27,Hood River,2002,12028,11049,979,8.1
41,29,Jackson,2002,93337,86443,6894,7.4
41,31,Jefferson,2002,8776,8184,592,6.7
41,33,Josephine,2002,32372,29554,2818,8.7
41,35,Klamath,2002,29648,27013,2635,8.9
41,37,Lake,2002,3513,3205,308,8.8
41,39,Lane,2002,171915,159794,12121,7.1
41,41,Lincoln,2002,21410,19694,1716,8.0
41,43,Linn,2002,52410,47720,4690,8.9
41,45,Malheur,2002,12959,11808,1151,8.9
41,47,Marion,2002,146552,136002,10550,7.2
41,49,Morrow,2002,5786,5352,434,7.5
41,51,Multnomah,2002,377527,347455,30072,8.0
41,53,Polk,2002,33615,31514,2101,6.3
41,55,Sherman,2002,917,825,92,10.0
41,57,Tillamook,2002,12043,11243,800,6.6
41,59,Umatilla,2002,37587,34712,2875,7.6
41,61,Union,2002,12326,11534,792,6.4
41,63,Wallowa,2002,3665,3355,310,8.5
41,65,Wasco,2002,12702,11562,1140,9.0
41,67,Washington,2002,264009,245954,18055,6.8
41,69,Wheeler,2002,727,671,56,7.7
41,71,Yamhill,2002,43521,40339,3182,7.3
42,1,Adams,2002,52215,50057,2158,4.1
42,3,Allegheny,2002,643701,609582,34119,5.3
42,5,Armstrong,2002,33581,31348,2233,6.6
42,7,Beaver,2002,90413,84949,5464,6.0
42,9,Bedford,2002,24794,22943,1851,7.5
42,11,Berks,2002,197993,186339,11654,5.9
42,13,Blair,2002,64486,60694,3792,5.9
42,15,Bradford,2002,32776,31065,1711,5.2
42,17,Bucks,2002,338904,322692,16212,4.8
42,19,Butler,2002,93027,88069,4958,5.3
42,21,Cambria,2002,66185,61523,4662,7.0
42,23,Cameron,2002,2592,2387,205,7.9
42,25,Carbon,2002,29763,27745,2018,6.8
42,27,Centre,2002,72008,68974,3034,4.2
42,29,Chester,2002,245764,235824,9940,4.0
42,31,Clarion,2002,19923,18899,1024,5.1
42,33,Clearfield,2002,41220,38239,2981,7.2
42,35,Clinton,2002,19156,17703,1453,7.6
42,37,Columbia,2002,32696,30653,2043,6.2
42,39,Crawford,2002,43349,40356,2993,6.9
42,41,Cumberland,2002,118094,113157,4937,4.2
42,43,Dauphin,2002,134908,128364,6544,4.9
42,45,Delaware,2002,281021,266993,14028,5.0
42,47,Elk,2002,17618,16444,1174,6.7
42,49,Erie,2002,140735,131377,9358,6.6
42,51,Fayette,2002,65350,60743,4607,7.0
42,53,Forest,2002,2272,1963,309,13.6
42,55,Franklin,2002,69180,65943,3237,4.7
42,57,Fulton,2002,7339,6861,478,6.5
42,59,Greene,2002,17274,16207,1067,6.2
42,61,Huntingdon,2002,21971,20138,1833,8.3
42,63,Indiana,2002,43683,41034,2649,6.1
42,65,Jefferson,2002,21872,20527,1345,6.1
42,67,Juniata,2002,12097,11492,605,5.0
42,69,Lackawanna,2002,104062,97794,6268,6.0
42,71,Lancaster,2002,260217,250092,10125,3.9
42,73,Lawrence,2002,44278,41534,2744,6.2
42,75,Lebanon,2002,66925,64123,2802,4.2
42,77,Lehigh,2002,167177,157833,9344,5.6
42,79,Luzerne,2002,155202,145184,10018,6.5
42,81,Lycoming,2002,59566,55899,3667,6.2
42,83,McKean,2002,22045,20736,1309,5.9
42,85,Mercer,2002,55516,52395,3121,5.6
42,87,Mifflin,2002,22437,20765,1672,7.5
42,89,Monroe,2002,73720,69505,4215,5.7
42,91,Montgomery,2002,421803,402507,19296,4.6
42,93,Montour,2002,8749,8321,428,4.9
42,95,Northampton,2002,142722,135215,7507,5.3
42,97,Northumberland,2002,45711,42720,2991,6.5
42,99,Perry,2002,23999,22816,1183,4.9
42,101,Philadelphia/city,2002,634720,588544,46176,7.3
42,103,Pike,2002,23088,21804,1284,5.6
42,105,Potter,2002,9334,8807,527,5.6
42,107,Schuylkill,2002,70012,65196,4816,6.9
42,109,Snyder,2002,19606,18669,937,4.8
42,111,Somerset,2002,38403,35818,2585,6.7
42,113,Sullivan,2002,3193,3006,187,5.9
42,115,Susquehanna,2002,21751,20406,1345,6.2
42,117,Tioga,2002,20782,19449,1333,6.4
42,119,Union,2002,17825,16832,993,5.6
42,121,Venango,2002,26221,24712,1509,5.8
42,123,Warren,2002,22534,21240,1294,5.7
42,125,Washington,2002,101173,95151,6022,6.0
42,127,Wayne,2002,23862,22649,1213,5.1
42,129,Westmoreland,2002,184912,174222,10690,5.8
42,131,Wyoming,2002,13918,13088,830,6.0
42,133,York,2002,211123,200990,10133,4.8
44,1,Bristol,2002,27359,26168,1191,4.4
44,3,Kent,2002,93556,89105,4451,4.8
44,5,Newport,2002,44619,42631,1988,4.5
44,7,Providence,2002,314066,296540,17526,5.6
44,9,Washington,2002,70644,67757,2887,4.1
45,1,Abbeville,2002,11854,10847,1007,8.5
45,3,Aiken,2002,69295,65511,3784,5.5
45,5,Allendale,2002,3509,3236,273,7.8
45,7,Anderson,2002,82114,76497,5617,6.8
45,9,Bamberg,2002,6347,5875,472,7.4
45,11,Barnwell,2002,9709,8870,839,8.6
45,13,Beaufort,2002,53632,51199,2433,4.5
45,15,Berkeley,2002,65520,62359,3161,4.8
45,17,Calhoun,2002,6974,6490,484,6.9
45,19,Charleston,2002,153609,145882,7727,5.0
45,21,Cherokee,2002,24381,22208,2173,8.9
45,23,Chester,2002,15768,14069,1699,10.8
45,25,Chesterfield,2002,18520,16954,1566,8.5
45,27,Clarendon,2002,12659,11602,1057,8.3
45,29,Colleton,2002,15928,14886,1042,6.5
45,31,Darlington,2002,30894,28564,2330,7.5
45,33,Dillon,2002,12978,11852,1126,8.7
45,35,Dorchester,2002,48572,46297,2275,4.7
45,37,Edgefield,2002,10280,9726,554,5.4
45,39,Fairfield,2002,11183,10153,1030,9.2
45,41,Florence,2002,59663,55420,4243,7.1
45,43,Georgetown,2002,26276,23932,2344,8.9
45,45,Greenville,2002,199449,188951,10498,5.3
45,47,Greenwood,2002,31768,28696,3072,9.7
45,49,Hampton,2002,8162,7508,654,8.0
45,51,Horry,2002,106122,100179,5943,5.6
45,53,Jasper,2002,9338,8824,514,5.5
45,55,Kershaw,2002,27037,25259,1778,6.6
45,57,Lancaster,2002,29635,27528,2107,7.1
45,59,Laurens,2002,33401,30645,2756,8.3
45,61,Lee,2002,8115,7459,656,8.1
45,63,Lexington,2002,117617,112583,5034,4.3
45,65,McCormick,2002,3648,3217,431,11.8
45,67,Marion,2002,14056,12390,1666,11.9
45,69,Marlboro,2002,12166,10851,1315,10.8
45,71,Newberry,2002,17062,15707,1355,7.9
45,73,Oconee,2002,31697,29393,2304,7.3
45,75,Orangeburg,2002,40032,36235,3797,9.5
45,77,Pickens,2002,55684,52094,3590,6.4
45,79,Richland,2002,160178,151961,8217,5.1
45,81,Saluda,2002,9152,8576,576,6.3
45,83,Spartanburg,2002,128118,118819,9299,7.3
45,85,Sumter,2002,42988,39626,3362,7.8
45,87,Union,2002,13674,12127,1547,11.3
45,89,Williamsburg,2002,14944,13205,1739,11.6
45,91,York,2002,90848,84479,6369,7.0
46,3,Aurora,2002,1511,1457,54,3.6
46,5,Beadle,2002,9123,8767,356,3.9
46,7,Bennett,2002,1422,1362,60,4.2
46,9,Bon Homme,2002,3384,3270,114,3.4
46,11,Brookings,2002,16970,16491,479,2.8
46,13,Brown,2002,20203,19572,631,3.1
46,15,Brule,2002,2870,2797,73,2.5
46,17,Buffalo,2002,540,497,43,8.0
46,19,Butte,2002,4973,4818,155,3.1
46,21,Campbell,2002,910,879,31,3.4
46,23,Charles Mix,2002,4328,4197,131,3.0
46,25,Clark,2002,1944,1838,106,5.5
46,27,Clay,2002,6987,6768,219,3.1
46,29,Codington,2002,15413,14832,581,3.8
46,31,Corson,2002,1420,1341,79,5.6
46,33,Custer,2002,4519,4368,151,3.3
46,35,Davison,2002,10756,10461,295,2.7
46,37,Day,2002,3066,2904,162,5.3
46,39,Deuel,2002,2555,2455,100,3.9
46,41,Dewey,2002,2556,2351,205,8.0
46,43,Douglas,2002,1762,1714,48,2.7
46,45,Edmunds,2002,2096,2027,69,3.3
46,47,Fall River,2002,3698,3554,144,3.9
46,49,Faulk,2002,1178,1144,34,2.9
46,51,Grant,2002,4240,4086,154,3.6
46,53,Gregory,2002,2499,2413,86,3.4
46,55,Haakon,2002,1256,1228,28,2.2
46,57,Hamlin,2002,2787,2690,97,3.5
46,59,Hand,2002,1957,1899,58,3.0
46,61,Hanson,2002,1771,1724,47,2.7
46,63,Harding,2002,793,773,20,2.5
46,65,Hughes,2002,9815,9586,229,2.3
46,67,Hutchinson,2002,3886,3749,137,3.5
46,69,Hyde,2002,806,783,23,2.9
46,71,Jackson,2002,1218,1159,59,4.8
46,73,Jerauld,2002,1232,1193,39,3.2
46,75,Jones,2002,765,751,14,1.8
46,77,Kingsbury,2002,3127,3025,102,3.3
46,79,Lake,2002,6740,6523,217,3.2
46,81,Lawrence,2002,12311,11961,350,2.8
46,83,Lincoln,2002,16288,15919,369,2.3
46,85,Lyman,2002,2001,1913,88,4.4
46,87,McCook,2002,2973,2876,97,3.3
46,89,McPherson,2002,1298,1256,42,3.2
46,91,Marshall,2002,2028,1908,120,5.9
46,93,Meade,2002,12516,12152,364,2.9
46,95,Mellette,2002,920,878,42,4.6
46,97,Miner,2002,1202,1141,61,5.1
46,99,Minnehaha,2002,90776,88275,2501,2.8
46,101,Moody,2002,3838,3663,175,4.6
46,102,Oglala Lakota,2002,3776,3497,279,7.4
46,103,Pennington,2002,50558,49028,1530,3.0
46,105,Perkins,2002,1810,1754,56,3.1
46,107,Potter,2002,1421,1374,47,3.3
46,109,Roberts,2002,4509,4286,223,4.9
46,111,Sanborn,2002,1547,1504,43,2.8
46,115,Spink,2002,3361,3242,119,3.5
46,117,Stanley,2002,1847,1804,43,2.3
46,119,Sully,2002,975,955,20,2.1
46,121,Todd,2002,3319,3134,185,5.6
46,123,Tripp,2002,3186,3059,127,4.0
46,125,Turner,2002,4628,4495,133,2.9
46,127,Union,2002,7404,7116,288,3.9
46,129,Walworth,2002,2751,2644,107,3.9
46,135,Yankton,2002,11615,11253,362,3.1
46,137,Ziebach,2002,872,817,55,6.3
47,1,Anderson,2002,35066,33451,1615,4.6
47,3,Bedford,2002,20187,19108,1079,5.3
47,5,Benton,2002,7050,6544,506,7.2
47,7,Bledsoe,2002,5146,4854,292,5.7
47,9,Blount,2002,57585,55178,2407,4.2
47,11,Bradley,2002,45355,43184,2171,4.8
47,13,Campbell,2002,16469,15408,1061,6.4
47,15,Cannon,2002,6372,6082,290,4.6
47,17,Carroll,2002,13984,12731,1253,9.0
47,19,Carter,2002,28020,26233,1787,6.4
47,21,Cheatham,2002,19817,19042,775,3.9
47,23,Chester,2002,7629,7157,472,6.2
47,25,Claiborne,2002,12826,12125,701,5.5
47,27,Clay,2002,3785,3518,267,7.1
47,29,Cocke,2002,15630,14475,1155,7.4
47,31,Coffee,2002,25074,23865,1209,4.8
47,33,Crockett,2002,7019,6528,491,7.0
47,35,Cumberland,2002,22316,20973,1343,6.0
47,37,Davidson,2002,305055,292121,12934,4.2
47,39,Decatur,2002,5535,5096,439,7.9
47,41,DeKalb,2002,9185,8730,455,5.0
47,43,Dickson,2002,22376,21310,1066,4.8
47,45,Dyer,2002,17422,16235,1187,6.8
47,47,Fayette,2002,14937,14045,892,6.0
47,49,Fentress,2002,7024,6505,519,7.4
47,51,Franklin,2002,19936,18996,940,4.7
47,53,Gibson,2002,22245,20550,1695,7.6
47,55,Giles,2002,14651,13570,1081,7.4
47,57,Grainger,2002,10052,9312,740,7.4
47,59,Greene,2002,31348,29320,2028,6.5
47,61,Grundy,2002,5750,5378,372,6.5
47,63,Hamblen,2002,29719,28003,1716,5.8
47,65,Hamilton,2002,159801,153031,6770,4.2
47,67,Hancock,2002,2610,2411,199,7.6
47,69,Hardeman,2002,11291,10462,829,7.3
47,71,Hardin,2002,11664,10808,856,7.3
47,73,Hawkins,2002,25384,23967,1417,5.6
47,75,Haywood,2002,9632,8867,765,7.9
47,77,Henderson,2002,12729,11724,1005,7.9
47,79,Henry,2002,14744,13789,955,6.5
47,81,Hickman,2002,10081,9493,588,5.8
47,83,Houston,2002,3730,3462,268,7.2
47,85,Humphreys,2002,8896,8322,574,6.5
47,87,Jackson,2002,5130,4784,346,6.7
47,89,Jefferson,2002,23143,21707,1436,6.2
47,91,Johnson,2002,7001,6421,580,8.3
47,93,Knox,2002,212042,204526,7516,3.5
47,95,Lake,2002,2753,2570,183,6.6
47,97,Lauderdale,2002,10673,9809,864,8.1
47,99,Lawrence,2002,18711,17118,1593,8.5
47,101,Lewis,2002,5390,5015,375,7.0
47,103,Lincoln,2002,16274,15556,718,4.4
47,105,Loudon,2002,21040,20044,996,4.7
47,107,McMinn,2002,23720,21968,1752,7.4
47,109,McNairy,2002,12258,11486,772,6.3
47,111,Macon,2002,10335,9774,561,5.4
47,113,Madison,2002,46287,43620,2667,5.8
47,115,Marion,2002,13127,12318,809,6.2
47,117,Marshall,2002,14098,13368,730,5.2
47,119,Maury,2002,37121,35379,1742,4.7
47,121,Meigs,2002,4889,4510,379,7.8
47,123,Monroe,2002,17522,16157,1365,7.8
47,125,Montgomery,2002,61559,58458,3101,5.0
47,127,Moore,2002,3130,3021,109,3.5
47,129,Morgan,2002,8212,7459,753,9.2
47,131,Obion,2002,16922,16098,824,4.9
47,133,Overton,2002,9668,9064,604,6.2
47,135,Perry,2002,3246,3016,230,7.1
47,137,Pickett,2002,2083,1889,194,9.3
47,139,Polk,2002,7385,6964,421,5.7
47,141,Putnam,2002,32704,30970,1734,5.3
47,143,Rhea,2002,13023,12287,736,5.7
47,145,Roane,2002,25685,24322,1363,5.3
47,147,Robertson,2002,30557,29068,1489,4.9
47,149,Rutherford,2002,107961,103581,4380,4.1
47,151,Scott,2002,8614,7714,900,10.4
47,153,Sequatchie,2002,5504,5235,269,4.9
47,155,Sevier,2002,41395,39020,2375,5.7
47,157,Shelby,2002,439007,416197,22810,5.2
47,159,Smith,2002,8932,8488,444,5.0
47,161,Stewart,2002,5806,5442,364,6.3
47,163,Sullivan,2002,73943,70178,3765,5.1
47,165,Sumner,2002,72460,69245,3215,4.4
47,167,Tipton,2002,26007,24597,1410,5.4
47,169,Trousdale,2002,3562,3383,179,5.0
47,171,Unicoi,2002,8240,7689,551,6.7
47,173,Union,2002,8674,8275,399,4.6
47,175,Van Buren,2002,2544,2372,172,6.8
47,177,Warren,2002,19554,18307,1247,6.4
47,179,Washington,2002,56337,53371,2966,5.3
47,181,Wayne,2002,6832,6239,593,8.7
47,183,Weakley,2002,17172,16122,1050,6.1
47,185,White,2002,10624,9935,689,6.5
47,187,Williamson,2002,73555,71068,2487,3.4
47,189,Wilson,2002,51421,49263,2158,4.2
48,1,Anderson,2002,20023,18524,1499,7.5
48,3,Andrews,2002,5861,5540,321,5.5
48,5,Angelina,2002,39281,36711,2570,6.5
48,7,Aransas,2002,10236,9519,717,7.0
48,9,Archer,2002,5119,4915,204,4.0
48,11,Armstrong,2002,1083,1034,49,4.5
48,13,Atascosa,2002,18359,17265,1094,6.0
48,15,Austin,2002,12390,11739,651,5.3
48,17,Bailey,2002,3360,3177,183,5.4
48,19,Bandera,2002,9289,8818,471,5.1
48,21,Bastrop,2002,31597,29610,1987,6.3
48,23,Baylor,2002,1869,1755,114,6.1
48,25,Bee,2002,11435,10619,816,7.1
48,27,Bell,2002,106998,100761,6237,5.8
48,29,Bexar,2002,687958,648189,39769,5.8
48,31,Blanco,2002,4505,4288,217,4.8
48,33,Borden,2002,438,421,17,3.9
48,35,Bosque,2002,8045,7540,505,6.3
48,37,Bowie,2002,41504,38997,2507,6.0
48,39,Brazoria,2002,126316,118300,8016,6.3
48,41,Brazos,2002,82494,78917,3577,4.3
48,43,Brewster,2002,4840,4608,232,4.8
48,45,Briscoe,2002,853,810,43,5.0
48,47,Brooks,2002,3197,2954,243,7.6
48,49,Brown,2002,18185,17121,1064,5.9
48,51,Burleson,2002,8191,7762,429,5.2
48,53,Burnet,2002,19161,18140,1021,5.3
48,55,Caldwell,2002,15608,14560,1048,6.7
48,57,Calhoun,2002,9295,8584,711,7.6
48,59,Callahan,2002,6503,6179,324,5.0
48,61,Cameron,2002,138254,125842,12412,9.0
48,63,Camp,2002,5511,5146,365,6.6
48,65,Carson,2002,3470,3311,159,4.6
48,67,Cass,2002,13733,12627,1106,8.1
48,69,Castro,2002,3689,3512,177,4.8
48,71,Chambers,2002,13476,12775,701,5.2
48,73,Cherokee,2002,20997,19778,1219,5.8
48,75,Childress,2002,3156,2971,185,5.9
48,77,Clay,2002,6334,6040,294,4.6
48,79,Cochran,2002,1573,1464,109,6.9
48,81,Coke,2002,1605,1516,89,5.5
48,83,Coleman,2002,4348,4062,286,6.6
48,85,Collin,2002,330971,310862,20109,6.1
48,87,Collingsworth,2002,1658,1587,71,4.3
48,89,Colorado,2002,10032,9528,504,5.0
48,91,Comal,2002,43933,41441,2492,5.7
48,93,Comanche,2002,6922,6605,317,4.6
48,95,Concho,2002,1391,1308,83,6.0
48,97,Cooke,2002,18272,17212,1060,5.8
48,99,Coryell,2002,24464,22780,1684,6.9
48,101,Cottle,2002,936,887,49,5.2
48,103,Crane,2002,1571,1456,115,7.3
48,105,Crockett,2002,2108,2014,94,4.5
48,107,Crosby,2002,2954,2791,163,5.5
48,109,Culberson,2002,1606,1510,96,6.0
48,111,Dallam,2002,3324,3200,124,3.7
48,113,Dallas,2002,1180312,1093371,86941,7.4
48,115,Dawson,2002,5421,5038,383,7.1
48,117,Deaf Smith,2002,8020,7549,471,5.9
48,119,Delta,2002,2477,2321,156,6.3
48,121,Denton,2002,285463,271288,14175,5.0
48,123,DeWitt,2002,9262,8732,530,5.7
48,125,Dickens,2002,1156,1093,63,5.4
48,127,Dimmit,2002,4025,3655,370,9.2
48,129,Donley,2002,1927,1833,94,4.9
48,131,Duval,2002,5068,4603,465,9.2
48,133,Eastland,2002,8730,8214,516,5.9
48,135,Ector,2002,59502,55610,3892,6.5
48,137,Edwards,2002,1072,1017,55,5.1
48,139,Ellis,2002,61699,58144,3555,5.8
48,141,El Paso,2002,283212,260151,23061,8.1
48,143,Erath,2002,17114,16320,794,4.6
48,145,Falls,2002,7350,6901,449,6.1
48,147,Fannin,2002,14015,12923,1092,7.8
48,149,Fayette,2002,12077,11541,536,4.4
48,151,Fisher,2002,2135,2017,118,5.5
48,153,Floyd,2002,3474,3246,228,6.6
48,155,Foard,2002,768,725,43,5.6
48,157,Fort Bend,2002,205785,195163,10622,5.2
48,159,Franklin,2002,4958,4720,238,4.8
48,161,Freestone,2002,9184,8658,526,5.7
48,163,Frio,2002,6293,5807,486,7.7
48,165,Gaines,2002,6423,6111,312,4.9
48,167,Galveston,2002,132938,124311,8627,6.5
48,169,Garza,2002,2214,2095,119,5.4
48,171,Gillespie,2002,11249,10790,459,4.1
48,173,Glasscock,2002,691,665,26,3.8
48,175,Goliad,2002,3337,3164,173,5.2
48,177,Gonzales,2002,9514,9043,471,5.0
48,179,Gray,2002,10143,9526,617,6.1
48,181,Grayson,2002,56462,52719,3743,6.6
48,183,Gregg,2002,56768,52795,3973,7.0
48,185,Grimes,2002,9963,9202,761,7.6
48,187,Guadalupe,2002,48010,45491,2519,5.2
48,189,Hale,2002,16903,15952,951,5.6
48,191,Hall,2002,1687,1583,104,6.2
48,193,Hamilton,2002,4306,4118,188,4.4
48,195,Hansford,2002,2758,2659,99,3.6
48,197,Hardeman,2002,2381,2252,129,5.4
48,199,Hardin,2002,24019,22267,1752,7.3
48,201,Harris,2002,1789438,1679950,109488,6.1
48,203,Harrison,2002,29975,27991,1984,6.6
48,205,Hartley,2002,2324,2238,86,3.7
48,207,Haskell,2002,2937,2786,151,5.1
48,209,Hays,2002,61021,57699,3322,5.4
48,211,Hemphill,2002,2120,2053,67,3.2
48,213,Henderson,2002,33724,31774,1950,5.8
48,215,Hidalgo,2002,230937,206838,24099,10.4
48,217,Hill,2002,15355,14329,1026,6.7
48,219,Hockley,2002,11097,10534,563,5.1
48,221,Hood,2002,21727,20475,1252,5.8
48,223,Hopkins,2002,16593,15701,892,5.4
48,225,Houston,2002,9283,8674,609,6.6
48,227,Howard,2002,14225,13329,896,6.3
48,229,Hudspeth,2002,1290,1192,98,7.6
48,231,Hunt,2002,38667,36253,2414,6.2
48,233,Hutchinson,2002,11086,10357,729,6.6
48,235,Irion,2002,957,923,34,3.6
48,237,Jack,2002,4094,3897,197,4.8
48,239,Jackson,2002,6720,6323,397,5.9
48,241,Jasper,2002,15887,14411,1476,9.3
48,243,Jeff Davis,2002,1275,1217,58,4.5
48,245,Jefferson,2002,112599,103814,8785,7.8
48,247,Jim Hogg,2002,2369,2221,148,6.2
48,249,Jim Wells,2002,18022,16739,1283,7.1
48,251,Johnson,2002,68717,64585,4132,6.0
48,253,Jones,2002,7840,7352,488,6.2
48,255,Karnes,2002,5451,5073,378,6.9
48,257,Kaufman,2002,39554,36627,2927,7.4
48,259,Kendall,2002,12848,12220,628,4.9
48,261,Kenedy,2002,215,205,10,4.7
48,263,Kent,2002,440,422,18,4.1
48,265,Kerr,2002,19945,18922,1023,5.1
48,267,Kimble,2002,2225,2133,92,4.1
48,269,King,2002,247,240,7,2.8
48,271,Kinney,2002,1341,1234,107,8.0
48,273,Kleberg,2002,14508,13596,912,6.3
48,275,Knox,2002,1863,1768,95,5.1
48,277,Lamar,2002,23453,21835,1618,6.9
48,279,Lamb,2002,7163,6772,391,5.5
48,281,Lampasas,2002,9313,8832,481,5.2
48,283,La Salle,2002,2255,2066,189,8.4
48,285,Lavaca,2002,9475,9080,395,4.2
48,287,Lee,2002,8518,8091,427,5.0
48,289,Leon,2002,7317,6818,499,6.8
48,291,Liberty,2002,31697,29103,2594,8.2
48,293,Limestone,2002,10126,9555,571,5.6
48,295,Lipscomb,2002,1480,1417,63,4.3
48,297,Live Oak,2002,4943,4678,265,5.4
48,299,Llano,2002,7723,7280,443,5.7
48,301,Loving,2002,48,45,3,6.3
48,303,Lubbock,2002,132813,127023,5790,4.4
48,305,Lynn,2002,3018,2869,149,4.9
48,307,McCulloch,2002,3635,3433,202,5.6
48,309,McLennan,2002,106174,100170,6004,5.7
48,311,McMullen,2002,434,415,19,4.4
48,313,Madison,2002,4999,4701,298,6.0
48,315,Marion,2002,4711,4363,348,7.4
48,317,Martin,2002,2218,2115,103,4.6
48,319,Mason,2002,2236,2157,79,3.5
48,321,Matagorda,2002,17106,15538,1568,9.2
48,323,Maverick,2002,17282,13902,3380,19.6
48,325,Medina,2002,18588,17607,981,5.3
48,327,Menard,2002,1134,1077,57,5.0
48,329,Midland,2002,61174,58231,2943,4.8
48,331,Milam,2002,11878,11155,723,6.1
48,333,Mills,2002,2519,2409,110,4.4
48,335,Mitchell,2002,3427,3176,251,7.3
48,337,Montague,2002,9160,8616,544,5.9
48,339,Montgomery,2002,168068,159520,8548,5.1
48,341,Moore,2002,10193,9781,412,4.0
48,343,Morris,2002,5993,5422,571,9.5
48,345,Motley,2002,683,655,28,4.1
48,347,Nacogdoches,2002,30116,28461,1655,5.5
48,349,Navarro,2002,21865,20372,1493,6.8
48,351,Newton,2002,6053,5345,708,11.7
48,353,Nolan,2002,7380,6975,405,5.5
48,355,Nueces,2002,151878,142655,9223,6.1
48,357,Ochiltree,2002,4710,4523,187,4.0
48,359,Oldham,2002,1181,1135,46,3.9
48,361,Orange,2002,40893,37399,3494,8.5
48,363,Palo Pinto,2002,13188,12388,800,6.1
48,365,Panola,2002,10841,10105,736,6.8
48,367,Parker,2002,47644,45142,2502,5.3
48,369,Parmer,2002,4649,4461,188,4.0
48,371,Pecos,2002,7168,6713,455,6.3
48,373,Polk,2002,16532,15245,1287,7.8
48,375,Potter,2002,54787,51309,3478,6.3
48,377,Presidio,2002,3415,2879,536,15.7
48,379,Rains,2002,4481,4183,298,6.7
48,381,Randall,2002,61946,60096,1850,3.0
48,383,Reagan,2002,1606,1538,68,4.2
48,385,Real,2002,1334,1245,89,6.7
48,387,Red River,2002,6444,5932,512,7.9
48,389,Reeves,2002,5045,4338,707,14.0
48,391,Refugio,2002,3674,3486,188,5.1
48,393,Roberts,2002,523,506,17,3.3
48,395,Robertson,2002,7237,6829,408,5.6
48,397,Rockwall,2002,27248,25714,1534,5.6
48,399,Runnels,2002,5175,4924,251,4.9
48,401,Rusk,2002,21369,19971,1398,6.5
48,403,Sabine,2002,3756,3275,481,12.8
48,405,San Augustine,2002,3823,3551,272,7.1
48,407,San Jacinto,2002,9719,9105,614,6.3
48,409,San Patricio,2002,28197,26285,1912,6.8
48,411,San Saba,2002,2762,2628,134,4.9
48,413,Schleicher,2002,1429,1361,68,4.8
48,415,Scurry,2002,7033,6596,437,6.2
48,417,Shackelford,2002,1867,1791,76,4.1
48,419,Shelby,2002,11973,11156,817,6.8
48,421,Sherman,2002,1708,1650,58,3.4
48,423,Smith,2002,89874,84849,5025,5.6
48,425,Somervell,2002,3639,3434,205,5.6
48,427,Starr,2002,19924,16612,3312,16.6
48,429,Stephens,2002,4338,4059,279,6.4
48,431,Sterling,2002,840,808,32,3.8
48,433,Stonewall,2002,848,812,36,4.2
48,435,Sutton,2002,2381,2290,91,3.8
48,437,Swisher,2002,3915,3728,187,4.8
48,439,Tarrant,2002,814977,765817,49160,6.0
48,441,Taylor,2002,63316,60195,3121,4.9
48,443,Terrell,2002,494,465,29,5.9
48,445,Terry,2002,5580,5254,326,5.8
48,447,Throckmorton,2002,999,957,42,4.2
48,449,Titus,2002,13942,13176,766,5.5
48,451,Tom Green,2002,52152,49660,2492,4.8
48,453,Travis,2002,489839,460757,29082,5.9
48,455,Trinity,2002,5704,5307,397,7.0
48,457,Tyler,2002,8401,7637,764,9.1
48,459,Upshur,2002,17217,16127,1090,6.3
48,461,Upton,2002,1528,1444,84,5.5
48,463,Uvalde,2002,11687,10828,859,7.4
48,465,Val Verde,2002,18852,17508,1344,7.1
48,467,Van Zandt,2002,24192,22784,1408,5.8
48,469,Victoria,2002,43380,40969,2411,5.6
48,471,Walker,2002,25553,24070,1483,5.8
48,473,Waller,2002,15823,14891,932,5.9
48,475,Ward,2002,4395,4060,335,7.6
48,477,Washington,2002,15535,14829,706,4.5
48,479,Webb,2002,77972,72325,5647,7.2
48,481,Wharton,2002,20626,19434,1192,5.8
48,483,Wheeler,2002,2758,2632,126,4.6
48,485,Wichita,2002,62778,59079,3699,5.9
48,487,Wilbarger,2002,7422,7077,345,4.6
48,489,Willacy,2002,7273,6359,914,12.6
48,491,Williamson,2002,159569,150616,8953,5.6
48,493,Wilson,2002,16393,15536,857,5.2
48,495,Winkler,2002,2993,2733,260,8.7
48,497,Wise,2002,26348,24931,1417,5.4
48,499,Wood,2002,16932,15849,1083,6.4
48,501,Yoakum,2002,3287,3110,177,5.4
48,503,Young,2002,8904,8384,520,5.8
48,505,Zapata,2002,4458,4070,388,8.7
48,507,Zavala,2002,3926,3360,566,14.4
49,1,Beaver,2002,3080,2940,140,4.5
49,3,Box Elder,2002,20991,19836,1155,5.5
49,5,Cache,2002,52324,50174,2150,4.1
49,7,Carbon,2002,9395,8751,644,6.9
49,9,Daggett,2002,506,482,24,4.7
49,11,Davis,2002,124350,118218,6132,4.9
49,13,Duchesne,2002,6980,6520,460,6.6
49,15,Emery,2002,4771,4437,334,7.0
49,17,Garfield,2002,2579,2343,236,9.2
49,19,Grand,2002,4778,4424,354,7.4
49,21,Iron,2002,17657,16746,911,5.2
49,23,Juab,2002,3674,3406,268,7.3
49,25,Kane,2002,2970,2815,155,5.2
49,27,Millard,2002,6137,5863,274,4.5
49,29,Morgan,2002,3534,3349,185,5.2
49,31,Piute,2002,746,700,46,6.2
49,33,Rich,2002,1251,1202,49,3.9
49,35,Salt Lake,2002,493006,464326,28680,5.8
49,37,San Juan,2002,4753,4353,400,8.4
49,39,Sanpete,2002,10154,9503,651,6.4
49,41,Sevier,2002,8819,8328,491,5.6
49,43,Summit,2002,19354,18116,1238,6.4
49,45,Tooele,2002,22219,20841,1378,6.2
49,47,Uintah,2002,12563,11821,742,5.9
49,49,Utah,2002,185274,174697,10577,5.7
49,51,Wasatch,2002,8190,7684,506,6.2
49,53,Washington,2002,44532,42241,2291,5.1
49,55,Wayne,2002,1431,1341,90,6.3
49,57,Weber,2002,103423,97128,6295,6.1
50,1,Addison,2002,20767,20054,713,3.4
50,3,Bennington,2002,20169,19265,904,4.5
50,5,Caledonia,2002,15952,15195,757,4.7
50,7,Chittenden,2002,86159,83255,2904,3.4
50,9,Essex,2002,3285,3110,175,5.3
50,11,Franklin,2002,25108,24089,1019,4.1
50,13,Grand Isle,2002,3984,3797,187,4.7
50,15,Lamoille,2002,13814,13256,558,4.0
50,17,Orange,2002,16140,15561,579,3.6
50,19,Orleans,2002,13558,12764,794,5.9
50,21,Rutland,2002,34545,33194,1351,3.9
50,23,Washington,2002,33472,32117,1355,4.0
50,25,Windham,2002,24718,23920,798,3.2
50,27,Windsor,2002,31562,30497,1065,3.4
51,1,Accomack,2002,19082,18258,824,4.3
51,3,Albemarle,2002,44460,43012,1448,3.3
51,5,Alleghany,2002,8058,7615,443,5.5
51,7,Amelia,2002,6017,5776,241,4.0
51,9,Amherst,2002,15260,14393,867,5.7
51,11,Appomattox,2002,6735,6337,398,5.9
51,13,Arlington,2002,121489,117725,3764,3.1
51,15,Augusta,2002,35635,34336,1299,3.6
51,17,Bath,2002,2813,2684,129,4.6
51,19,Bedford,2002,34862,33179,1683,4.8
51,21,Bland,2002,3028,2861,167,5.5
51,23,Botetourt,2002,17174,16523,651,3.8
51,25,Brunswick,2002,6856,6402,454,6.6
51,27,Buchanan,2002,9023,8360,663,7.3
51,29,Buckingham,2002,6251,6000,251,4.0
51,31,Campbell,2002,26500,24924,1576,5.9
51,33,Caroline,2002,11326,10821,505,4.5
51,35,Carroll,2002,14848,13829,1019,6.9
51,36,Charles City,2002,3740,3537,203,5.4
51,37,Charlotte,2002,5568,5137,431,7.7
51,41,Chesterfield,2002,147974,142724,5250,3.5
51,43,Clarke,2002,7089,6866,223,3.1
51,45,Craig,2002,2543,2436,107,4.2
51,47,Culpeper,2002,17615,16923,692,3.9
51,49,Cumberland,2002,4251,4089,162,3.8
51,51,Dickenson,2002,5677,5216,461,8.1
51,53,Dinwiddie,2002,12116,11613,503,4.2
51,57,Essex,2002,5354,5108,246,4.6
51,59,Fairfax,2002,554614,535121,19493,3.5
51,61,Fauquier,2002,31927,30904,1023,3.2
51,63,Floyd,2002,6788,6479,309,4.6
51,65,Fluvanna,2002,11269,10893,376,3.3
51,67,Franklin,2002,25600,24216,1384,5.4
51,69,Frederick,2002,34686,33437,1249,3.6
51,71,Giles,2002,8049,7545,504,6.3
51,73,Gloucester,2002,18648,18035,613,3.3
51,75,Goochland,2002,9363,9036,327,3.5
51,77,Grayson,2002,8044,7378,666,8.3
51,79,Greene,2002,8926,8598,328,3.7
51,81,Greensville,2002,4028,3835,193,4.8
51,83,Halifax,2002,16855,15064,1791,10.6
51,85,Hanover,2002,50257,48543,1714,3.4
51,87,Henrico,2002,148815,143132,5683,3.8
51,89,Henry,2002,28401,25429,2972,10.5
51,91,Highland,2002,1126,1080,46,4.1
51,93,Isle of Wight,2002,15897,15322,575,3.6
51,95,James City,2002,25466,24594,872,3.4
51,97,King and Queen,2002,3154,3010,144,4.6
51,99,King George,2002,8841,8553,288,3.3
51,101,King William,2002,7368,7089,279,3.8
51,103,Lancaster,2002,5191,4846,345,6.6
51,105,Lee,2002,9542,8975,567,5.9
51,107,Loudoun,2002,116775,112248,4527,3.9
51,109,Louisa,2002,13651,13032,619,4.5
51,111,Lunenburg,2002,5488,5169,319,5.8
51,113,Madison,2002,7012,6699,313,4.5
51,115,Mathews,2002,4440,4256,184,4.1
51,117,Mecklenburg,2002,14169,12671,1498,10.6
51,119,Middlesex,2002,4753,4590,163,3.4
51,121,Montgomery,2002,41493,39771,1722,4.2
51,125,Nelson,2002,7125,6856,269,3.8
51,127,New Kent,2002,7743,7451,292,3.8
51,131,Northampton,2002,5899,5587,312,5.3
51,133,Northumberland,2002,5600,5253,347,6.2
51,135,Nottoway,2002,6374,6083,291,4.6
51,137,Orange,2002,13335,12713,622,4.7
51,139,Page,2002,12346,11558,788,6.4
51,141,Patrick,2002,9650,8807,843,8.7
51,143,Pittsylvania,2002,32988,30583,2405,7.3
51,145,Powhatan,2002,12151,11755,396,3.3
51,147,Prince Edward,2002,8299,7794,505,6.1
51,149,Prince George,2002,14162,13595,567,4.0
51,153,Prince William,2002,166678,160770,5908,3.5
51,155,Pulaski,2002,17643,16484,1159,6.6
51,157,Rappahannock,2002,3740,3608,132,3.5
51,159,Richmond,2002,3522,3314,208,5.9
51,161,Roanoke,2002,47272,45675,1597,3.4
51,163,Rockbridge,2002,11065,10665,400,3.6
51,165,Rockingham,2002,37774,36405,1369,3.6
51,167,Russell,2002,12191,11391,800,6.6
51,169,Scott,2002,9854,9310,544,5.5
51,171,Shenandoah,2002,19116,18496,620,3.2
51,173,Smyth,2002,15551,14251,1300,8.4
51,175,Southampton,2002,7462,7138,324,4.3
51,177,Spotsylvania,2002,53483,51878,1605,3.0
51,179,Stafford,2002,53365,51693,1672,3.1
51,181,Surry,2002,3571,3404,167,4.7
51,183,Sussex,2002,4402,4138,264,6.0
51,185,Tazewell,2002,20182,18973,1209,6.0
51,187,Warren,2002,17141,16432,709,4.1
51,191,Washington,2002,26039,24398,1641,6.3
51,193,Westmoreland,2002,7905,7515,390,4.9
51,195,Wise,2002,16987,15946,1041,6.1
51,197,Wythe,2002,14395,13458,937,6.5
51,199,York,2002,29010,28082,928,3.2
51,510,Alexandria city,2002,83414,80439,2975,3.6
51,520,Bristol city,2002,7601,7209,392,5.2
51,530,Buena Vista city,2002,3344,3186,158,4.7
51,540,Charlottesville city,2002,19710,18916,794,4.0
51,550,Chesapeake city,2002,103693,99720,3973,3.8
51,570,Colonial Heights city,2002,8800,8405,395,4.5
51,580,Covington city,2002,3079,2879,200,6.5
51,590,Danville city,2002,21797,19849,1948,8.9
51,595,Emporia city,2002,2408,2280,128,5.3
51,600,Fairfax city,2002,12372,12090,282,2.3
51,610,Falls Church city,2002,6223,6004,219,3.5
51,620,Franklin city,2002,3547,3370,177,5.0
51,630,Fredericksburg city,2002,10754,10147,607,5.6
51,640,Galax city,2002,3284,3011,273,8.3
51,650,Hampton city,2002,66100,62770,3330,5.0
51,660,Harrisonburg city,2002,20454,19670,784,3.8
51,670,Hopewell city,2002,10151,9500,651,6.4
51,678,Lexington city,2002,2372,2234,138,5.8
51,680,Lynchburg city,2002,30453,28595,1858,6.1
51,683,Manassas city,2002,19933,19039,894,4.5
51,685,Manassas Park city,2002,6033,5860,173,2.9
51,690,Martinsville city,2002,6551,5699,852,13.0
51,700,Newport News city,2002,85558,81494,4064,4.7
51,710,Norfolk city,2002,98452,93193,5259,5.3
51,720,Norton city,2002,1587,1506,81,5.1
51,730,Petersburg city,2002,14141,13046,1095,7.7
51,735,Poquoson city,2002,5996,5824,172,2.9
51,740,Portsmouth city,2002,44054,41633,2421,5.5
51,750,Radford city,2002,7387,6986,401,5.4
51,760,Richmond city,2002,96686,90937,5749,5.9
51,770,Roanoke city,2002,47293,44856,2437,5.2
51,775,Salem city,2002,13279,12749,530,4.0
51,790,Staunton city,2002,11790,11318,472,4.0
51,800,Suffolk city,2002,33118,31636,1482,4.5
51,810,Virginia Beach city,2002,214542,206610,7932,3.7
51,820,Waynesboro city,2002,9595,9122,473,4.9
51,830,Williamsburg city,2002,4657,4306,351,7.5
51,840,Winchester city,2002,13293,12747,546,4.1
53,1,Adams,2002,8231,7495,736,8.9
53,3,Asotin,2002,10257,9558,699,6.8
53,5,Benton,2002,80659,75697,4962,6.2
53,7,Chelan,2002,35918,32858,3060,8.5
53,9,Clallam,2002,26673,24397,2276,8.5
53,11,Clark,2002,186784,169891,16893,9.0
53,13,Columbia,2002,1681,1512,169,10.1
53,15,Cowlitz,2002,42653,38172,4481,10.5
53,17,Douglas,2002,17834,16507,1327,7.4
53,19,Ferry,2002,2971,2660,311,10.5
53,21,Franklin,2002,24733,22642,2091,8.5
53,23,Garfield,2002,1069,1003,66,6.2
53,25,Grant,2002,36349,32951,3398,9.3
53,27,Grays Harbor,2002,29189,26476,2713,9.3
53,29,Island,2002,30403,28202,2201,7.2
53,31,Jefferson,2002,12456,11500,956,7.7
53,33,King,2002,986493,930117,56376,5.7
53,35,Kitsap,2002,111325,103957,7368,6.6
53,37,Kittitas,2002,18052,16767,1285,7.1
53,39,Klickitat,2002,9567,8494,1073,11.2
53,41,Lewis,2002,29721,27011,2710,9.1
53,43,Lincoln,2002,4633,4318,315,6.8
53,45,Mason,2002,21806,20012,1794,8.2
53,47,Okanogan,2002,18786,16920,1866,9.9
53,49,Pacific,2002,8716,7925,791,9.1
53,51,Pend Oreille,2002,4696,4247,449,9.6
53,53,Pierce,2002,346286,318864,27422,7.9
53,55,San Juan,2002,7625,7185,440,5.8
53,57,Skagit,2002,52559,48286,4273,8.1
53,59,Skamania,2002,4754,4288,466,9.8
53,61,Snohomish,2002,333258,311322,21936,6.6
53,63,Spokane,2002,212414,196386,16028,7.5
53,65,Stevens,2002,17531,15800,1731,9.9
53,67,Thurston,2002,111957,104838,7119,6.4
53,69,Wahkiakum,2002,1559,1404,155,9.9
53,71,Walla Walla,2002,28356,26426,1930,6.8
53,73,Whatcom,2002,91601,85377,6224,6.8
53,75,Whitman,2002,19163,18253,910,4.7
53,77,Yakima,2002,112284,101610,10674,9.5
54,1,Barbour,2002,6788,6251,537,7.9
54,3,Berkeley,2002,40517,38437,2080,5.1
54,5,Boone,2002,9797,8985,812,8.3
54,7,Braxton,2002,5917,5427,490,8.3
54,9,Brooke,2002,11475,10734,741,6.5
54,11,Cabell,2002,43952,41425,2527,5.7
54,13,Calhoun,2002,2919,2572,347,11.9
54,15,Clay,2002,3683,3276,407,11.1
54,17,Doddridge,2002,2914,2704,210,7.2
54,19,Fayette,2002,18448,16978,1470,8.0
54,21,Gilmer,2002,2948,2728,220,7.5
54,23,Grant,2002,5384,5009,375,7.0
54,25,Greenbrier,2002,15109,14011,1098,7.3
54,27,Hampshire,2002,9085,8619,466,5.1
54,29,Hancock,2002,15086,14212,874,5.8
54,31,Hardy,2002,6951,6638,313,4.5
54,33,Harrison,2002,30738,28759,1979,6.4
54,35,Jackson,2002,12239,11379,860,7.0
54,37,Jefferson,2002,23167,22175,992,4.3
54,39,Kanawha,2002,94156,88715,5441,5.8
54,41,Lewis,2002,7356,6824,532,7.2
54,43,Lincoln,2002,8160,7427,733,9.0
54,45,Logan,2002,13297,12215,1082,8.1
54,47,McDowell,2002,7032,6288,744,10.6
54,49,Marion,2002,25557,23875,1682,6.6
54,51,Marshall,2002,15383,14264,1119,7.3
54,53,Mason,2002,10554,9589,965,9.1
54,55,Mercer,2002,25462,23909,1553,6.1
54,57,Mineral,2002,12916,11984,932,7.2
54,59,Mingo,2002,8733,7913,820,9.4
54,61,Monongalia,2002,41599,39609,1990,4.8
54,63,Monroe,2002,5827,5509,318,5.5
54,65,Morgan,2002,7093,6751,342,4.8
54,67,Nicholas,2002,10737,9893,844,7.9
54,69,Ohio,2002,21388,20184,1204,5.6
54,71,Pendleton,2002,3780,3590,190,5.0
54,73,Pleasants,2002,3335,3082,253,7.6
54,75,Pocahontas,2002,3993,3692,301,7.5
54,77,Preston,2002,13633,12711,922,6.8
54,79,Putnam,2002,26046,24633,1413,5.4
54,81,Raleigh,2002,32326,30270,2056,6.4
54,83,Randolph,2002,12705,11784,921,7.2
54,85,Ritchie,2002,4546,4192,354,7.8
54,87,Roane,2002,5704,5148,556,9.7
54,89,Summers,2002,4790,4411,379,7.9
54,91,Taylor,2002,6930,6489,441,6.4
54,93,Tucker,2002,3264,2986,278,8.5
54,95,Tyler,2002,3787,3507,280,7.4
54,97,Upshur,2002,10678,9936,742,6.9
54,99,Wayne,2002,17510,16303,1207,6.9
54,101,Webster,2002,3273,3033,240,7.3
54,103,Wetzel,2002,6816,6216,600,8.8
54,105,Wirt,2002,2544,2323,221,8.7
54,107,Wood,2002,41938,39356,2582,6.2
54,109,Wyoming,2002,8749,8114,635,7.3
55,1,Adams,2002,9173,8642,531,5.8
55,3,Ashland,2002,9240,8562,678,7.3
55,5,Barron,2002,25401,24035,1366,5.4
55,7,Bayfield,2002,8000,7494,506,6.3
55,9,Brown,2002,133527,126826,6701,5.0
55,11,Buffalo,2002,8208,7802,406,4.9
55,13,Burnett,2002,8169,7693,476,5.8
55,15,Calumet,2002,24780,23530,1250,5.0
55,17,Chippewa,2002,30903,28917,1986,6.4
55,19,Clark,2002,17852,16794,1058,5.9
55,21,Columbia,2002,30772,29197,1575,5.1
55,23,Crawford,2002,9272,8760,512,5.5
55,25,Dane,2002,276599,267211,9388,3.4
55,27,Dodge,2002,46482,43913,2569,5.5
55,29,Door,2002,17173,16287,886,5.2
55,31,Douglas,2002,22758,21408,1350,5.9
55,33,Dunn,2002,23196,22099,1097,4.7
55,35,Eau Claire,2002,53876,51435,2441,4.5
55,37,Florence,2002,2732,2561,171,6.3
55,39,Fond du Lac,2002,56863,54064,2799,4.9
55,41,Forest,2002,4935,4588,347,7.0
55,43,Grant,2002,28084,26735,1349,4.8
55,45,Green,2002,20068,19069,999,5.0
55,47,Green Lake,2002,10875,10178,697,6.4
55,49,Iowa,2002,14010,13435,575,4.1
55,51,Iron,2002,3351,3048,303,9.0
55,53,Jackson,2002,9863,9268,595,6.0
55,55,Jefferson,2002,42501,40470,2031,4.8
55,57,Juneau,2002,13023,12075,948,7.3
55,59,Kenosha,2002,81259,76397,4862,6.0
55,61,Kewaunee,2002,11783,11187,596,5.1
55,63,La Crosse,2002,62262,59554,2708,4.3
55,65,Lafayette,2002,9309,8833,476,5.1
55,67,Langlade,2002,11238,10489,749,6.7
55,69,Lincoln,2002,16202,15216,986,6.1
55,71,Manitowoc,2002,46166,43371,2795,6.1
55,73,Marathon,2002,73203,69737,3466,4.7
55,75,Marinette,2002,22807,21279,1528,6.7
55,77,Marquette,2002,7782,7213,569,7.3
55,78,Menominee,2002,1719,1506,213,12.4
55,79,Milwaukee,2002,466959,436149,30810,6.6
55,81,Monroe,2002,22499,21398,1101,4.9
55,83,Oconto,2002,19935,18693,1242,6.2
55,85,Oneida,2002,20367,19033,1334,6.5
55,87,Outagamie,2002,94349,89292,5057,5.4
55,89,Ozaukee,2002,47408,45339,2069,4.4
55,91,Pepin,2002,4000,3799,201,5.0
55,93,Pierce,2002,22670,21716,954,4.2
55,95,Polk,2002,23446,22002,1444,6.2
55,97,Portage,2002,39544,37598,1946,4.9
55,99,Price,2002,8424,7986,438,5.2
55,101,Racine,2002,99175,92816,6359,6.4
55,103,Richland,2002,9872,9421,451,4.6
55,105,Rock,2002,82318,77295,5023,6.1
55,107,Rusk,2002,7917,7391,526,6.6
55,109,St. Croix,2002,40529,38287,2242,5.5
55,111,Sauk,2002,34088,32565,1523,4.5
55,113,Sawyer,2002,9176,8606,570,6.2
55,115,Shawano,2002,22515,21307,1208,5.4
55,117,Sheboygan,2002,64107,61026,3081,4.8
55,119,Taylor,2002,11182,10590,592,5.3
55,121,Trempealeau,2002,15777,14914,863,5.5
55,123,Vernon,2002,14822,14035,787,5.3
55,125,Vilas,2002,11707,11008,699,6.0
55,127,Walworth,2002,55443,52760,2683,4.8
55,129,Washburn,2002,8110,7556,554,6.8
55,131,Washington,2002,70322,66942,3380,4.8
55,133,Waukesha,2002,211121,201398,9723,4.6
55,135,Waupaca,2002,28221,26722,1499,5.3
55,137,Waushara,2002,12381,11614,767,6.2
55,139,Winnebago,2002,92001,87500,4501,4.9
55,141,Wood,2002,40963,38601,2362,5.8
56,1,Albany,2002,18349,17749,600,3.3
56,3,Big Horn,2002,5162,4891,271,5.2
56,5,Campbell,2002,22079,21427,652,3.0
56,7,Carbon,2002,7785,7437,348,4.5
56,9,Converse,2002,6267,6008,259,4.1
56,11,Crook,2002,3072,2962,110,3.6
56,13,Fremont,2002,18137,17192,945,5.2
56,15,Goshen,2002,5940,5693,247,4.2
56,17,Hot Springs,2002,2523,2407,116,4.6
56,19,Johnson,2002,3574,3435,139,3.9
56,21,Laramie,2002,40803,39119,1684,4.1
56,23,Lincoln,2002,7483,7144,339,4.5
56,25,Natrona,2002,37421,35915,1506,4.0
56,27,Niobrara,2002,1150,1098,52,4.5
56,29,Park,2002,14276,13645,631,4.4
56,31,Platte,2002,4119,3928,191,4.6
56,33,Sheridan,2002,14890,14297,593,4.0
56,35,Sublette,2002,3879,3768,111,2.9
56,37,Sweetwater,2002,20166,19345,821,4.1
56,39,Teton,2002,13786,13374,412,3.0
56,41,Uinta,2002,11082,10615,467,4.2
56,43,Washakie,2002,4156,3948,208,5.0
56,45,Weston,2002,3310,3177,133,4.0
72,1,Adjuntas Municipio,2002,5226,4496,730,14.0
72,3,Aguada Municipio,2002,14574,12388,2186,15.0
72,5,Aguadilla Municipio,2002,20841,17647,3194,15.3
72,7,Aguas Buenas Municipio,2002,9164,7949,1215,13.3
72,9,Aibonito Municipio,2002,7834,6712,1122,14.3
72,11,Anasco Municipio,2002,10245,8588,1657,16.2
72,13,Arecibo Municipio,2002,33347,28829,4518,13.5
72,15,Arroyo Municipio,2002,5319,4410,909,17.1
72,17,Barceloneta Municipio,2002,7230,6092,1138,15.7
72,19,Barranquitas Municipio,2002,7505,6515,990,13.2
72,21,Bayamon Municipio,2002,83557,75836,7721,9.2
72,23,Cabo Rojo Municipio,2002,18111,16084,2027,11.2
72,25,Caguas Municipio,2002,53701,47596,6105,11.4
72,27,Camuy Municipio,2002,12751,10689,2062,16.2
72,29,Canovanas Municipio,2002,13873,11873,2000,14.4
72,31,Carolina Municipio,2002,77334,69980,7354,9.5
72,33,Catano Municipio,2002,8603,7592,1011,11.8
72,35,Cayey Municipio,2002,15810,13707,2103,13.3
72,37,Ceiba Municipio,2002,5782,4943,839,14.5
72,39,Ciales Municipio,2002,5187,4239,948,18.3
72,41,Cidra Municipio,2002,14483,12744,1739,12.0
72,43,Coamo Municipio,2002,11642,10053,1589,13.6
72,45,Comerio Municipio,2002,4994,4165,829,16.6
72,47,Corozal Municipio,2002,10113,8950,1163,11.5
72,49,Culebra Municipio,2002,854,798,56,6.6
72,51,Dorado Municipio,2002,12231,11047,1184,9.7
72,53,Fajardo Municipio,2002,14460,12191,2269,15.7
72,54,Florida Municipio,2002,3727,3127,600,16.1
72,55,Guanica Municipio,2002,6111,4981,1130,18.5
72,57,Guayama Municipio,2002,13714,11448,2266,16.5
72,59,Guayanilla Municipio,2002,6483,5379,1104,17.0
72,61,Guaynabo Municipio,2002,43753,40786,2967,6.8
72,63,Gurabo Municipio,2002,14108,12552,1556,11.0
72,65,Hatillo Municipio,2002,12315,10590,1725,14.0
72,67,Hormigueros Municipio,2002,6445,5701,744,11.5
72,69,Humacao Municipio,2002,20431,17442,2989,14.6
72,71,Isabela Municipio,2002,14683,12433,2250,15.3
72,73,Jayuya Municipio,2002,4635,4024,611,13.2
72,75,Juana Diaz Municipio,2002,15200,13060,2140,14.1
72,77,Juncos Municipio,2002,12266,10652,1614,13.2
72,79,Lajas Municipio,2002,8178,6996,1182,14.5
72,81,Lares Municipio,2002,10875,9221,1654,15.2
72,83,Las Marias Municipio,2002,3782,3215,567,15.0
72,85,Las Piedras Municipio,2002,11899,10228,1671,14.0
72,87,Loiza Municipio,2002,8644,7420,1224,14.2
72,89,Luquillo Municipio,2002,6926,5632,1294,18.7
72,91,Manati Municipio,2002,14244,12040,2204,15.5
72,93,Maricao Municipio,2002,2077,1776,301,14.5
72,95,Maunabo Municipio,2002,3687,2971,716,19.4
72,97,Mayaguez Municipio,2002,32089,27140,4949,15.4
72,99,Moca Municipio,2002,13906,11753,2153,15.5
72,101,Morovis Municipio,2002,8772,7440,1332,15.2
72,103,Naguabo Municipio,2002,7494,6240,1254,16.7
72,105,Naranjito Municipio,2002,8508,7531,977,11.5
72,107,Orocovis Municipio,2002,5391,4493,898,16.7
72,109,Patillas Municipio,2002,5683,4683,1000,17.6
72,111,Penuelas Municipio,2002,8115,6759,1356,16.7
72,113,Ponce Municipio,2002,59299,51749,7550,12.7
72,115,Quebradillas Municipio,2002,8808,7179,1629,18.5
72,117,Rincon Municipio,2002,5073,4319,754,14.9
72,119,Rio Grande Municipio,2002,17392,15117,2275,13.1
72,121,Sabana Grande Municipio,2002,8589,7322,1267,14.8
72,123,Salinas Municipio,2002,8924,7365,1559,17.5
72,125,San German Municipio,2002,12309,10501,1808,14.7
72,127,San Juan Municipio,2002,173005,158038,14967,8.7
72,129,San Lorenzo Municipio,2002,13636,11981,1655,12.1
72,131,San Sebastian Municipio,2002,14740,12137,2603,17.7
72,133,Santa Isabel Municipio,2002,8313,7188,1125,13.5
72,135,Toa Alta Municipio,2002,25633,23467,2166,8.5
72,137,Toa Baja Municipio,2002,35388,32132,3256,9.2
72,139,Trujillo Alto Municipio,2002,32320,29716,2604,8.1
72,141,Utuado Municipio,2002,9713,8152,1561,16.1
72,143,Vega Alta Municipio,2002,12075,10711,1364,11.3
72,145,Vega Baja Municipio,2002,20219,17614,2605,12.9
72,147,Vieques Municipio,2002,2625,2159,466,17.8
72,149,Villalba Municipio,2002,8100,6820,1280,15.8
72,151,Yabucoa Municipio,2002,11187,8961,2226,19.9
72,153,Yauco Municipio,2002,15116,13006,2110,14.0
1,1,Autauga,2003,22695,21557,1138,5.0
1,3,Baldwin,2003,72598,69010,3588,4.9
1,5,Barbour,2003,11019,10241,778,7.1
1,7,Bibb,2003,8871,8346,525,5.9
1,9,Blount,2003,26008,24812,1196,4.6
1,11,Bullock,2003,3992,3556,436,10.9
1,13,Butler,2003,9218,8423,795,8.6
1,15,Calhoun,2003,53026,49892,3134,5.9
1,17,Chambers,2003,16896,15815,1081,6.4
1,19,Cherokee,2003,11977,11392,585,4.9
1,21,Chilton,2003,19557,18581,976,5.0
1,23,Choctaw,2003,5672,5107,565,10.0
1,25,Clarke,2003,10809,9882,927,8.6
1,27,Clay,2003,5946,5516,430,7.2
1,29,Cleburne,2003,6698,6295,403,6.0
1,31,Coffee,2003,20010,18917,1093,5.5
1,33,Colbert,2003,24659,22821,1838,7.5
1,35,Conecuh,2003,5169,4728,441,8.5
1,37,Coosa,2003,5076,4662,414,8.2
1,39,Covington,2003,17389,16182,1207,6.9
1,41,Crenshaw,2003,5943,5541,402,6.8
1,43,Cullman,2003,38430,36205,2225,5.8
1,45,Dale,2003,20628,19543,1085,5.3
1,47,Dallas,2003,16845,14944,1901,11.3
1,49,DeKalb,2003,32347,30498,1849,5.7
1,51,Elmore,2003,32734,31066,1668,5.1
1,53,Escambia,2003,14700,13438,1262,8.6
1,55,Etowah,2003,46572,43543,3029,6.5
1,57,Fayette,2003,8080,7523,557,6.9
1,59,Franklin,2003,13617,12319,1298,9.5
1,61,Geneva,2003,11768,11114,654,5.6
1,63,Greene,2003,3517,3219,298,8.5
1,65,Hale,2003,7114,6513,601,8.4
1,67,Henry,2003,7524,7091,433,5.8
1,69,Houston,2003,45369,43175,2194,4.8
1,71,Jackson,2003,27293,25384,1909,7.0
1,73,Jefferson,2003,322328,304626,17702,5.5
1,75,Lamar,2003,6716,6131,585,8.7
1,77,Lauderdale,2003,41360,38353,3007,7.3
1,79,Lawrence,2003,15848,14793,1055,6.7
1,81,Lee,2003,60840,58001,2839,4.7
1,83,Limestone,2003,34062,32188,1874,5.5
1,85,Lowndes,2003,5040,4577,463,9.2
1,87,Macon,2003,8554,7959,595,7.0
1,89,Madison,2003,154878,147566,7312,4.7
1,91,Marengo,2003,9034,8468,566,6.3
1,93,Marion,2003,13124,12184,940,7.2
1,95,Marshall,2003,40751,38486,2265,5.6
1,97,Mobile,2003,180945,168440,12505,6.9
1,99,Monroe,2003,9452,8665,787,8.3
1,101,Montgomery,2003,104919,98839,6080,5.8
1,103,Morgan,2003,55442,51834,3608,6.5
1,105,Perry,2003,3857,3447,410,10.6
1,107,Pickens,2003,8169,7508,661,8.1
1,109,Pike,2003,14454,13616,838,5.8
1,111,Randolph,2003,9826,9101,725,7.4
1,113,Russell,2003,21957,20313,1644,7.5
1,115,St. Clair,2003,32422,30742,1680,5.2
1,117,Shelby,2003,88643,85521,3122,3.5
1,119,Sumter,2003,5129,4615,514,10.0
1,121,Talladega,2003,38355,35403,2952,7.7
1,123,Tallapoosa,2003,18527,17250,1277,6.9
1,125,Tuscaloosa,2003,82423,78399,4024,4.9
1,127,Walker,2003,30444,28485,1959,6.4
1,129,Washington,2003,7130,6391,739,10.4
1,131,Wilcox,2003,3831,3360,471,12.3
1,133,Winston,2003,10446,9459,987,9.4
2,13,Aleutians East Borough,2003,1012,915,97,9.6
2,16,Aleutians West Census Area,2003,2940,2755,185,6.3
2,20,Anchorage Borough/municipality,2003,145843,136789,9054,6.2
2,50,Bethel Census Area,2003,7072,6218,854,12.1
2,60,Bristol Bay Borough,2003,971,912,59,6.1
2,68,Denali Borough,2003,1410,1287,123,8.7
2,70,Dillingham Census Area,2003,1926,1714,212,11.0
2,90,Fairbanks North Star Borough,2003,42713,39765,2948,6.9
2,100,Haines Borough,2003,1361,1204,157,11.5
2,110,Juneau Borough/city,2003,18111,17074,1037,5.7
2,122,Kenai Peninsula Borough,2003,25086,22564,2522,10.1
2,130,Ketchikan Gateway Borough,2003,7807,7184,623,8.0
2,150,Kodiak Island Borough,2003,5973,5398,575,9.6
2,158,Kusilvak Census Area,2003,2657,2185,472,17.8
2,164,Lake and Peninsula Borough,2003,944,868,76,8.1
2,170,Matanuska-Susitna Borough,2003,32897,30052,2845,8.6
2,180,Nome Census Area,2003,3921,3501,420,10.7
2,185,North Slope Borough,2003,3709,3332,377,10.2
2,188,Northwest Arctic Borough,2003,2983,2594,389,13.0
2,201,Prince of Wales-Outer Ketchikan Census Area,2003,2453,2100,353,14.4
2,220,Sitka Borough/city,2003,4676,4390,286,6.1
2,232,Skagway-Hoonah-Angoon Census Area,2003,1878,1657,221,11.8
2,240,Southeast Fairbanks Census Area,2003,2509,2189,320,12.8
2,261,Valdez-Cordova Census Area,2003,5384,4847,537,10.0
2,280,Wrangell-Petersburg Census Area,2003,3014,2651,363,12.0
2,282,Yakutat Borough/city,2003,302,269,33,10.9
2,290,Yukon-Koyukuk Census Area,2003,2944,2552,392,13.3
4,1,Apache,2003,20591,18143,2448,11.9
4,3,Cochise,2003,53904,50832,3072,5.7
4,5,Coconino,2003,65564,61798,3766,5.7
4,7,Gila,2003,20985,19453,1532,7.3
4,9,Graham,2003,12138,11286,852,7.0
4,11,Greenlee,2003,3522,3275,247,7.0
4,12,La Paz,2003,7431,6904,527,7.1
4,13,Maricopa,2003,1744428,1653332,91096,5.2
4,15,Mohave,2003,81884,77837,4047,4.9
4,17,Navajo,2003,38157,34857,3300,8.6
4,19,Pima,2003,428187,405261,22926,5.4
4,21,Pinal,2003,78685,73154,5531,7.0
4,23,Santa Cruz,2003,15667,14165,1502,9.6
4,25,Yavapai,2003,84775,80421,4354,5.1
4,27,Yuma,2003,72729,60378,12351,17.0
5,1,Arkansas,2003,10808,10223,585,5.4
5,3,Ashley,2003,10064,9133,931,9.3
5,5,Baxter,2003,16072,15024,1048,6.5
5,7,Benton,2003,88695,85576,3119,3.5
5,9,Boone,2003,16187,15268,919,5.7
5,11,Bradley,2003,5533,5141,392,7.1
5,13,Calhoun,2003,2558,2360,198,7.7
5,15,Carroll,2003,13341,12711,630,4.7
5,17,Chicot,2003,5212,4674,538,10.3
5,19,Clark,2003,11239,10535,704,6.3
5,21,Clay,2003,7550,6953,597,7.9
5,23,Cleburne,2003,10994,10384,610,5.5
5,25,Cleveland,2003,4002,3759,243,6.1
5,27,Columbia,2003,10786,10072,714,6.6
5,29,Conway,2003,9677,9085,592,6.1
5,31,Craighead,2003,43229,40873,2356,5.5
5,33,Crawford,2003,25470,24138,1332,5.2
5,35,Crittenden,2003,21494,20073,1421,6.6
5,37,Cross,2003,8751,8113,638,7.3
5,39,Dallas,2003,3851,3552,299,7.8
5,41,Desha,2003,6208,5664,544,8.8
5,43,Drew,2003,8582,7917,665,7.7
5,45,Faulkner,2003,48178,45611,2567,5.3
5,47,Franklin,2003,8042,7659,383,4.8
5,49,Fulton,2003,5008,4702,306,6.1
5,51,Garland,2003,39538,37058,2480,6.3
5,53,Grant,2003,8167,7720,447,5.5
5,55,Greene,2003,17255,16120,1135,6.6
5,57,Hempstead,2003,11164,10580,584,5.2
5,59,Hot Spring,2003,14332,13396,936,6.5
5,61,Howard,2003,6584,6195,389,5.9
5,63,Independence,2003,17149,16068,1081,6.3
5,65,Izard,2003,5248,4843,405,7.7
5,67,Jackson,2003,7841,7152,689,8.8
5,69,Jefferson,2003,36008,33192,2816,7.8
5,71,Johnson,2003,10741,10167,574,5.3
5,73,Lafayette,2003,3398,3200,198,5.8
5,75,Lawrence,2003,7781,7133,648,8.3
5,77,Lee,2003,3689,3270,419,11.4
5,79,Lincoln,2003,5114,4708,406,7.9
5,81,Little River,2003,6455,6147,308,4.8
5,83,Logan,2003,10024,9468,556,5.5
5,85,Lonoke,2003,27733,26422,1311,4.7
5,87,Madison,2003,7241,6961,280,3.9
5,89,Marion,2003,6553,6138,415,6.3
5,91,Miller,2003,18385,17474,911,5.0
5,93,Mississippi,2003,20357,17979,2378,11.7
5,95,Monroe,2003,4000,3706,294,7.4
5,97,Montgomery,2003,4286,4051,235,5.5
5,99,Nevada,2003,4533,4309,224,4.9
5,101,Newton,2003,3648,3440,208,5.7
5,103,Ouachita,2003,12181,11236,945,7.8
5,105,Perry,2003,4817,4491,326,6.8
5,107,Phillips,2003,9246,8453,793,8.6
5,109,Pike,2003,5235,4955,280,5.3
5,111,Poinsett,2003,11290,10476,814,7.2
5,113,Polk,2003,8657,8007,650,7.5
5,115,Pope,2003,26784,25277,1507,5.6
5,117,Prairie,2003,4495,4264,231,5.1
5,119,Pulaski,2003,182761,173406,9355,5.1
5,121,Randolph,2003,7897,7160,737,9.3
5,123,St. Francis,2003,10904,9905,999,9.2
5,125,Saline,2003,43790,41699,2091,4.8
5,127,Scott,2003,4748,4523,225,4.7
5,129,Searcy,2003,3402,3217,185,5.4
5,131,Sebastian,2003,56506,53773,2733,4.8
5,133,Sevier,2003,7462,7120,342,4.6
5,135,Sharp,2003,6451,5905,546,8.5
5,137,Stone,2003,4515,4181,334,7.4
5,139,Union,2003,19870,18323,1547,7.8
5,141,Van Buren,2003,6867,6385,482,7.0
5,143,Washington,2003,91258,87837,3421,3.7
5,145,White,2003,31019,29086,1933,6.2
5,147,Woodruff,2003,3802,3443,359,9.4
5,149,Yell,2003,9879,9369,510,5.2
6,1,Alameda,2003,754430,702182,52248,6.9
6,3,Alpine,2003,555,508,47,8.5
6,5,Amador,2003,16388,15367,1021,6.2
6,7,Butte,2003,98313,90781,7532,7.7
6,9,Calaveras,2003,19858,18378,1480,7.5
6,11,Colusa,2003,9445,8077,1368,14.5
6,13,Contra Costa,2003,508389,477075,31314,6.2
6,15,Del Norte,2003,10317,9429,888,8.6
6,17,El Dorado,2003,87454,82538,4916,5.6
6,19,Fresno,2003,404092,356249,47843,11.8
6,21,Glenn,2003,11132,9981,1151,10.3
6,23,Humboldt,2003,60587,56400,4187,6.9
6,25,Imperial,2003,58740,49493,9247,15.7
6,27,Inyo,2003,9095,8566,529,5.8
6,29,Kern,2003,311551,279088,32463,10.4
6,31,Kings,2003,53163,46744,6419,12.1
6,33,Lake,2003,25867,23481,2386,9.2
6,35,Lassen,2003,12316,11361,955,7.8
6,37,Los Angeles,2003,4733044,4401817,331227,7.0
6,39,Madera,2003,59012,52859,6153,10.4
6,41,Marin,2003,130611,124145,6466,5.0
6,43,Mariposa,2003,8416,7830,586,7.0
6,45,Mendocino,2003,44971,41850,3121,6.9
6,47,Merced,2003,96921,85662,11259,11.6
6,49,Modoc,2003,4204,3835,369,8.8
6,51,Mono,2003,8269,7847,422,5.1
6,53,Monterey,2003,208766,189880,18886,9.0
6,55,Napa,2003,70650,67186,3464,4.9
6,57,Nevada,2003,48270,45551,2719,5.6
6,59,Orange,2003,1545325,1470827,74498,4.8
6,61,Placer,2003,152705,144840,7865,5.2
6,63,Plumas,2003,10448,9409,1039,9.9
6,65,Riverside,2003,775987,724882,51105,6.6
6,67,Sacramento,2003,652106,613395,38711,5.9
6,69,San Benito,2003,25513,22947,2566,10.1
6,71,San Bernardino,2003,802215,751490,50725,6.3
6,73,San Diego,2003,1457231,1380708,76523,5.3
6,75,San Francisco/city,2003,429313,400129,29184,6.8
6,77,San Joaquin,2003,278974,253132,25842,9.3
6,79,San Luis Obispo,2003,127885,121801,6084,4.8
6,81,San Mateo,2003,366838,345243,21595,5.9
6,83,Santa Barbara,2003,207823,197220,10603,5.1
6,85,Santa Clara,2003,844000,772994,71006,8.4
6,87,Santa Cruz,2003,144182,132903,11279,7.8
6,89,Shasta,2003,82394,76112,6282,7.6
6,91,Sierra,2003,1637,1482,155,9.5
6,93,Siskiyou,2003,19225,17379,1846,9.6
6,95,Solano,2003,205394,192342,13052,6.4
6,97,Sonoma,2003,252868,238954,13914,5.5
6,99,Stanislaus,2003,221846,199752,22094,10.0
6,101,Sutter,2003,39434,34978,4456,11.3
6,103,Tehama,2003,25618,23631,1987,7.8
6,105,Trinity,2003,5380,4810,570,10.6
6,107,Tulare,2003,181336,158904,22432,12.4
6,109,Tuolumne,2003,25297,23501,1796,7.1
6,111,Ventura,2003,409617,385716,23901,5.8
6,113,Yolo,2003,91284,85403,5881,6.4
6,115,Yuba,2003,25202,22472,2730,10.8
8,1,Adams,2003,200973,186591,14382,7.2
8,3,Alamosa,2003,8204,7725,479,5.8
8,5,Arapahoe,2003,292403,274148,18255,6.2
8,7,Archuleta,2003,5597,5268,329,5.9
8,9,Baca,2003,2376,2287,89,3.7
8,11,Bent,2003,2419,2231,188,7.8
8,13,Boulder,2003,164743,155306,9437,5.7
8,14,Broomfield/city,2003,23749,22232,1517,6.4
8,15,Chaffee,2003,7825,7373,452,5.8
8,17,Cheyenne,2003,1288,1243,45,3.5
8,19,Clear Creek,2003,6022,5683,339,5.6
8,21,Conejos,2003,3766,3499,267,7.1
8,23,Costilla,2003,1336,1198,138,10.3
8,25,Crowley,2003,1607,1467,140,8.7
8,27,Custer,2003,1970,1868,102,5.2
8,29,Delta,2003,14117,13274,843,6.0
8,31,Denver/city,2003,303172,281300,21872,7.2
8,33,Dolores,2003,989,907,82,8.3
8,35,Douglas,2003,128900,122103,6797,5.3
8,37,Eagle,2003,26225,24963,1262,4.8
8,39,Elbert,2003,12591,11895,696,5.5
8,41,El Paso,2003,280427,262914,17513,6.2
8,43,Fremont,2003,18609,17203,1406,7.6
8,45,Garfield,2003,27015,25670,1345,5.0
8,47,Gilpin,2003,3303,3108,195,5.9
8,49,Grand,2003,8428,8073,355,4.2
8,51,Gunnison,2003,8369,7965,404,4.8
8,53,Hinsdale,2003,611,585,26,4.3
8,55,Huerfano,2003,3362,3073,289,8.6
8,57,Jackson,2003,1075,1020,55,5.1
8,59,Jefferson,2003,306160,288155,18005,5.9
8,61,Kiowa,2003,866,821,45,5.2
8,63,Kit Carson,2003,4247,4061,186,4.4
8,65,Lake,2003,3797,3562,235,6.2
8,67,La Plata,2003,26645,25449,1196,4.5
8,69,Larimer,2003,159410,151311,8099,5.1
8,71,Las Animas,2003,7860,7386,474,6.0
8,73,Lincoln,2003,3004,2870,134,4.5
8,75,Logan,2003,10899,10434,465,4.3
8,77,Mesa,2003,66928,63205,3723,5.6
8,79,Mineral,2003,446,423,23,5.2
8,81,Moffat,2003,7558,7117,441,5.8
8,83,Montezuma,2003,12302,11578,724,5.9
8,85,Montrose,2003,18248,17170,1078,5.9
8,87,Morgan,2003,14153,13473,680,4.8
8,89,Otero,2003,9282,8675,607,6.5
8,91,Ouray,2003,2445,2335,110,4.5
8,93,Park,2003,9378,8861,517,5.5
8,95,Phillips,2003,2354,2263,91,3.9
8,97,Pitkin,2003,10208,9673,535,5.2
8,99,Prowers,2003,7232,6868,364,5.0
8,101,Pueblo,2003,68778,63643,5135,7.5
8,103,Rio Blanco,2003,3557,3416,141,4.0
8,105,Rio Grande,2003,6442,6054,388,6.0
8,107,Routt,2003,13729,13104,625,4.6
8,109,Saguache,2003,3050,2839,211,6.9
8,111,San Juan,2003,610,570,40,6.6
8,113,San Miguel,2003,4925,4648,277,5.6
8,115,Sedgwick,2003,1517,1451,66,4.4
8,117,Summit,2003,15903,15135,768,4.8
8,119,Teller,2003,12465,11686,779,6.2
8,121,Washington,2003,2755,2657,98,3.6
8,123,Weld,2003,105788,99566,6222,5.9
8,125,Yuma,2003,5986,5799,187,3.1
9,1,Fairfield,2003,452436,429955,22481,5.0
9,3,Hartford,2003,435455,409068,26387,6.1
9,5,Litchfield,2003,101532,96405,5127,5.0
9,7,Middlesex,2003,88156,83920,4236,4.8
9,9,New Haven,2003,426877,401785,25092,5.9
9,11,New London,2003,142384,135424,6960,4.9
9,13,Tolland,2003,79089,75611,3478,4.4
9,15,Windham,2003,59806,56212,3594,6.0
10,1,Kent,2003,67083,64087,2996,4.5
10,3,New Castle,2003,266305,253960,12345,4.6
10,5,Sussex,2003,82501,79262,3239,3.9
11,1,District of Colu,2003,308454,285997,22457,7.3
12,1,Alachua,2003,118193,114395,3798,3.2
12,3,Baker,2003,10331,9900,431,4.2
12,5,Bay,2003,75239,71768,3471,4.6
12,7,Bradford,2003,11231,10832,399,3.6
12,9,Brevard,2003,239876,228900,10976,4.6
12,11,Broward,2003,896303,853621,42682,4.8
12,13,Calhoun,2003,5288,5062,226,4.3
12,15,Charlotte,2003,59262,56449,2813,4.7
12,17,Citrus,2003,46719,44169,2550,5.5
12,19,Clay,2003,77437,74365,3072,4.0
12,21,Collier,2003,131955,126222,5733,4.3
12,23,Columbia,2003,26384,25290,1094,4.1
12,27,DeSoto,2003,13635,12953,682,5.0
12,29,Dixie,2003,5539,5289,250,4.5
12,31,Duval,2003,403974,384872,19102,4.7
12,33,Escambia,2003,130046,124382,5664,4.4
12,35,Flagler,2003,24670,23439,1231,5.0
12,37,Franklin,2003,4913,4722,191,3.9
12,39,Gadsden,2003,19546,18659,887,4.5
12,41,Gilchrist,2003,6925,6659,266,3.8
12,43,Glades,2003,4452,4235,217,4.9
12,45,Gulf,2003,5789,5549,240,4.1
12,47,Hamilton,2003,4471,4257,214,4.8
12,49,Hardee,2003,10983,10341,642,5.8
12,51,Hendry,2003,16923,15662,1261,7.5
12,53,Hernando,2003,52142,49217,2925,5.6
12,55,Highlands,2003,37544,35691,1853,4.9
12,57,Hillsborough,2003,544950,520508,24442,4.5
12,59,Holmes,2003,7673,7347,326,4.2
12,61,Indian River,2003,55477,52130,3347,6.0
12,63,Jackson,2003,20012,19267,745,3.7
12,65,Jefferson,2003,6456,6210,246,3.8
12,67,Lafayette,2003,2782,2681,101,3.6
12,69,Lake,2003,102676,97988,4688,4.6
12,71,Lee,2003,235628,226074,9554,4.1
12,73,Leon,2003,133006,128248,4758,3.6
12,75,Levy,2003,15099,14388,711,4.7
12,77,Liberty,2003,3004,2905,99,3.3
12,79,Madison,2003,7143,6830,313,4.4
12,81,Manatee,2003,134860,129270,5590,4.1
12,83,Marion,2003,113239,107867,5372,4.7
12,85,Martin,2003,60543,57652,2891,4.8
12,86,Miami-Dade,2003,1065762,1026479,39283,3.7
12,87,Monroe,2003,46394,45035,1359,2.9
12,89,Nassau,2003,30423,29140,1283,4.2
12,91,Okaloosa,2003,88074,85219,2855,3.2
12,93,Okeechobee,2003,16025,15086,939,5.9
12,95,Orange,2003,509073,485942,23131,4.5
12,97,Osceola,2003,101085,96281,4804,4.8
12,99,Palm Beach,2003,579613,550204,29409,5.1
12,101,Pasco,2003,161831,153782,8049,5.0
12,103,Pinellas,2003,456280,435023,21257,4.7
12,105,Polk,2003,237450,225828,11622,4.9
12,107,Putnam,2003,30396,28898,1498,4.9
12,109,St. Johns,2003,72016,69369,2647,3.7
12,111,St. Lucie,2003,97300,91627,5673,5.8
12,113,Santa Rosa,2003,59500,57107,2393,4.0
12,115,Sarasota,2003,159493,153065,6428,4.0
12,117,Seminole,2003,212845,203322,9523,4.5
12,119,Sumter,2003,19303,18421,882,4.6
12,121,Suwannee,2003,15941,15298,643,4.0
12,123,Taylor,2003,8123,7646,477,5.9
12,125,Union,2003,4821,4663,158,3.3
12,127,Volusia,2003,224746,214507,10239,4.6
12,129,Wakulla,2003,13009,12535,474,3.6
12,131,Walton,2003,22576,21828,748,3.3
12,133,Washington,2003,8745,8338,407,4.7
13,1,Appling,2003,8249,7661,588,7.1
13,3,Atkinson,2003,3513,3287,226,6.4
13,5,Bacon,2003,4316,4068,248,5.7
13,7,Baker,2003,1859,1763,96,5.2
13,9,Baldwin,2003,20019,19013,1006,5.0
13,11,Banks,2003,8364,8019,345,4.1
13,13,Barrow,2003,27559,26164,1395,5.1
13,15,Bartow,2003,42913,40491,2422,5.6
13,17,Ben Hill,2003,7807,7251,556,7.1
13,19,Berrien,2003,8495,8184,311,3.7
13,21,Bibb,2003,72297,68561,3736,5.2
13,23,Bleckley,2003,5335,5052,283,5.3
13,25,Brantley,2003,7230,6813,417,5.8
13,27,Brooks,2003,8025,7735,290,3.6
13,29,Bryan,2003,13230,12721,509,3.8
13,31,Bulloch,2003,29239,27925,1314,4.5
13,33,Burke,2003,10032,9148,884,8.8
13,35,Butts,2003,9622,9087,535,5.6
13,37,Calhoun,2003,2467,2296,171,6.9
13,39,Camden,2003,18847,17764,1083,5.7
13,43,Candler,2003,4179,3984,195,4.7
13,45,Carroll,2003,47956,45303,2653,5.5
13,47,Catoosa,2003,32978,31809,1169,3.5
13,49,Charlton,2003,4263,4018,245,5.7
13,51,Chatham,2003,116658,111300,5358,4.6
13,53,Chattahoochee,2003,2767,2526,241,8.7
13,55,Chattooga,2003,11383,10848,535,4.7
13,57,Cherokee,2003,91542,87549,3993,4.4
13,59,Clarke,2003,57356,55057,2299,4.0
13,61,Clay,2003,1543,1470,73,4.7
13,63,Clayton,2003,132472,124115,8357,6.3
13,65,Clinch,2003,2438,2286,152,6.2
13,67,Cobb,2003,362703,345568,17135,4.7
13,69,Coffee,2003,17423,16131,1292,7.4
13,71,Colquitt,2003,18391,17356,1035,5.6
13,73,Columbia,2003,52634,50655,1979,3.8
13,75,Cook,2003,7067,6669,398,5.6
13,77,Coweta,2003,52099,49578,2521,4.8
13,79,Crawford,2003,6123,5812,311,5.1
13,81,Crisp,2003,9575,8991,584,6.1
13,83,Dade,2003,8320,7940,380,4.6
13,85,Dawson,2003,9768,9362,406,4.2
13,87,Decatur,2003,12223,11483,740,6.1
13,89,DeKalb,2003,368804,347334,21470,5.8
13,91,Dodge,2003,8796,8299,497,5.7
13,93,Dooly,2003,4774,4468,306,6.4
13,95,Dougherty,2003,41701,39175,2526,6.1
13,97,Douglas,2003,54030,51296,2734,5.1
13,99,Early,2003,5894,5536,358,6.1
13,101,Echols,2003,2120,2051,69,3.3
13,103,Effingham,2003,22115,21188,927,4.2
13,105,Elbert,2003,10243,9615,628,6.1
13,107,Emanuel,2003,10497,9940,557,5.3
13,109,Evans,2003,4785,4570,215,4.5
13,111,Fannin,2003,9697,9042,655,6.8
13,113,Fayette,2003,50568,48576,1992,3.9
13,115,Floyd,2003,49271,46818,2453,5.0
13,117,Forsyth,2003,67299,64594,2705,4.0
13,119,Franklin,2003,10392,9803,589,5.7
13,121,Fulton,2003,447523,421895,25628,5.7
13,123,Gilmer,2003,12645,12068,577,4.6
13,125,Glascock,2003,1207,1143,64,5.3
13,127,Glynn,2003,36507,34937,1570,4.3
13,129,Gordon,2003,25015,23757,1258,5.0
13,131,Grady,2003,11183,10641,542,4.8
13,133,Greene,2003,6503,6060,443,6.8
13,135,Gwinnett,2003,373330,355696,17634,4.7
13,137,Habersham,2003,19441,18610,831,4.3
13,139,Hall,2003,79665,76245,3420,4.3
13,141,Hancock,2003,3399,3131,268,7.9
13,143,Haralson,2003,12551,11894,657,5.2
13,145,Harris,2003,14387,13824,563,3.9
13,147,Hart,2003,11023,10427,596,5.4
13,149,Heard,2003,4968,4641,327,6.6
13,151,Henry,2003,79493,75812,3681,4.6
13,153,Houston,2003,59241,56901,2340,3.9
13,155,Irwin,2003,4456,4171,285,6.4
13,157,Jackson,2003,22942,21828,1114,4.9
13,159,Jasper,2003,6066,5733,333,5.5
13,161,Jeff Davis,2003,5666,5206,460,8.1
13,163,Jefferson,2003,6965,6358,607,8.7
13,165,Jenkins,2003,3428,3201,227,6.6
13,167,Johnson,2003,3683,3409,274,7.4
13,169,Jones,2003,12931,12385,546,4.2
13,171,Lamar,2003,7777,7336,441,5.7
13,173,Lanier,2003,3651,3513,138,3.8
13,175,Laurens,2003,21709,20328,1381,6.4
13,177,Lee,2003,15253,14695,558,3.7
13,179,Liberty,2003,21008,19840,1168,5.6
13,181,Lincoln,2003,3502,3228,274,7.8
13,183,Long,2003,4940,4746,194,3.9
13,185,Lowndes,2003,48069,46250,1819,3.8
13,187,Lumpkin,2003,11710,11196,514,4.4
13,189,McDuffie,2003,10431,9733,698,6.7
13,191,McIntosh,2003,4954,4723,231,4.7
13,193,Macon,2003,5211,4779,432,8.3
13,195,Madison,2003,15160,14513,647,4.3
13,197,Marion,2003,3410,3206,204,6.0
13,199,Meriwether,2003,9777,9106,671,6.9
13,201,Miller,2003,3517,3332,185,5.3
13,205,Mitchell,2003,9979,9385,594,6.0
13,207,Monroe,2003,12375,11838,537,4.3
13,209,Montgomery,2003,4154,3897,257,6.2
13,211,Morgan,2003,8603,8212,391,4.5
13,213,Murray,2003,20617,19707,910,4.4
13,215,Muscogee,2003,83749,78972,4777,5.7
13,217,Newton,2003,37646,35533,2113,5.6
13,219,Oconee,2003,15925,15438,487,3.1
13,221,Oglethorpe,2003,7314,6995,319,4.4
13,223,Paulding,2003,52502,50179,2323,4.4
13,225,Peach,2003,11336,10633,703,6.2
13,227,Pickens,2003,13702,13062,640,4.7
13,229,Pierce,2003,7936,7568,368,4.6
13,231,Pike,2003,7265,6864,401,5.5
13,233,Polk,2003,19713,18723,990,5.0
13,235,Pulaski,2003,4302,4101,201,4.7
13,237,Putnam,2003,9134,8699,435,4.8
13,239,Quitman,2003,976,922,54,5.5
13,241,Rabun,2003,7462,7167,295,4.0
13,243,Randolph,2003,2989,2751,238,8.0
13,245,Richmond,2003,89309,84104,5205,5.8
13,247,Rockdale,2003,37476,35497,1979,5.3
13,249,Schley,2003,1736,1632,104,6.0
13,251,Screven,2003,6644,6253,391,5.9
13,253,Seminole,2003,4065,3831,234,5.8
13,255,Spalding,2003,27889,26009,1880,6.7
13,257,Stephens,2003,13453,12604,849,6.3
13,259,Stewart,2003,2063,1903,160,7.8
13,261,Sumter,2003,14822,13942,880,5.9
13,263,Talbot,2003,2974,2788,186,6.3
13,265,Taliaferro,2003,767,705,62,8.1
13,267,Tattnall,2003,8589,8133,456,5.3
13,269,Taylor,2003,3321,3107,214,6.4
13,271,Telfair,2003,4179,3799,380,9.1
13,273,Terrell,2003,4672,4408,264,5.7
13,275,Thomas,2003,21306,20320,986,4.6
13,277,Tift,2003,19138,18243,895,4.7
13,279,Toombs,2003,12330,11525,805,6.5
13,281,Towns,2003,5146,4944,202,3.9
13,283,Treutlen,2003,2669,2473,196,7.3
13,285,Troup,2003,30212,28470,1742,5.8
13,287,Turner,2003,4917,4583,334,6.8
13,289,Twiggs,2003,4698,4433,265,5.6
13,291,Union,2003,9516,9085,431,4.5
13,293,Upson,2003,11594,10813,781,6.7
13,295,Walker,2003,31966,30503,1463,4.6
13,297,Walton,2003,34797,33204,1593,4.6
13,299,Ware,2003,15294,14450,844,5.5
13,301,Warren,2003,2540,2272,268,10.6
13,303,Washington,2003,8361,7823,538,6.4
13,305,Wayne,2003,11401,10765,636,5.6
13,307,Webster,2003,1066,1007,59,5.5
13,309,Wheeler,2003,2394,2237,157,6.6
13,311,White,2003,11445,10979,466,4.1
13,313,Whitfield,2003,44429,42446,1983,4.5
13,315,Wilcox,2003,3304,3077,227,6.9
13,317,Wilkes,2003,4731,4350,381,8.1
13,319,Wilkinson,2003,4470,4209,261,5.8
13,321,Worth,2003,10368,9823,545,5.3
15,1,Hawaii,2003,76828,73236,3592,4.7
15,3,Honolulu/city,2003,425054,408980,16074,3.8
15,7,Kauai,2003,30684,29453,1231,4.0
15,9,Maui,2003,71372,68684,2688,3.8
16,1,Ada,2003,177508,168962,8546,4.8
16,3,Adams,2003,1869,1639,230,12.3
16,5,Bannock,2003,39548,37469,2079,5.3
16,7,Bear Lake,2003,2902,2738,164,5.7
16,9,Benewah,2003,3969,3534,435,11.0
16,11,Bingham,2003,20256,19310,946,4.7
16,13,Blaine,2003,12707,12154,553,4.4
16,15,Boise,2003,3538,3343,195,5.5
16,17,Bonner,2003,18574,17138,1436,7.7
16,19,Bonneville,2003,45825,44127,1698,3.7
16,21,Boundary,2003,4213,3834,379,9.0
16,23,Butte,2003,1318,1234,84,6.4
16,25,Camas,2003,566,536,30,5.3
16,27,Canyon,2003,73435,68752,4683,6.4
16,29,Caribou,2003,3413,3181,232,6.8
16,31,Cassia,2003,9904,9299,605,6.1
16,33,Clark,2003,538,508,30,5.6
16,35,Clearwater,2003,3302,2909,393,11.9
16,37,Custer,2003,2537,2376,161,6.3
16,39,Elmore,2003,10724,10046,678,6.3
16,41,Franklin,2003,5815,5563,252,4.3
16,43,Fremont,2003,5723,5430,293,5.1
16,45,Gem,2003,7061,6613,448,6.3
16,47,Gooding,2003,7421,7112,309,4.2
16,49,Idaho,2003,6873,6256,617,9.0
16,51,Jefferson,2003,9929,9546,383,3.9
16,53,Jerome,2003,9550,9104,446,4.7
16,55,Kootenai,2003,61718,57576,4142,6.7
16,57,Latah,2003,16139,15388,751,4.7
16,59,Lemhi,2003,3843,3551,292,7.6
16,61,Lewis,2003,1677,1603,74,4.4
16,63,Lincoln,2003,2275,2145,130,5.7
16,65,Madison,2003,13456,13046,410,3.0
16,67,Minidoka,2003,9423,8709,714,7.6
16,69,Nez Perce,2003,19241,18198,1043,5.4
16,71,Oneida,2003,1966,1888,78,4.0
16,73,Owyhee,2003,4702,4567,135,2.9
16,75,Payette,2003,10491,9562,929,8.9
16,77,Power,2003,3667,3411,256,7.0
16,79,Shoshone,2003,5504,4817,687,12.5
16,81,Teton,2003,4179,4027,152,3.6
16,83,Twin Falls,2003,35636,34039,1597,4.5
16,85,Valley,2003,4022,3689,333,8.3
16,87,Washington,2003,4747,4371,376,7.9
17,1,Adams,2003,35400,33517,1883,5.3
17,3,Alexander,2003,3486,3116,370,10.6
17,5,Bond,2003,8241,7735,506,6.1
17,7,Boone,2003,22758,20944,1814,8.0
17,9,Brown,2003,3061,2928,133,4.3
17,11,Bureau,2003,18210,16909,1301,7.1
17,13,Calhoun,2003,2497,2318,179,7.2
17,15,Carroll,2003,8232,7571,661,8.0
17,17,Cass,2003,7175,6765,410,5.7
17,19,Champaign,2003,99151,94735,4416,4.5
17,21,Christian,2003,16860,15728,1132,6.7
17,23,Clark,2003,8410,7814,596,7.1
17,25,Clay,2003,6904,6414,490,7.1
17,27,Clinton,2003,18162,17131,1031,5.7
17,29,Coles,2003,26880,25328,1552,5.8
17,31,Cook,2003,2584180,2391953,192227,7.4
17,33,Crawford,2003,9068,8407,661,7.3
17,35,Cumberland,2003,5623,5243,380,6.8
17,37,DeKalb,2003,51490,48555,2935,5.7
17,39,De Witt,2003,8170,7638,532,6.5
17,41,Douglas,2003,10453,9904,549,5.3
17,43,DuPage,2003,511958,483457,28501,5.6
17,45,Edgar,2003,9997,9396,601,6.0
17,47,Edwards,2003,3478,3305,173,5.0
17,49,Effingham,2003,17527,16497,1030,5.9
17,51,Fayette,2003,9885,9118,767,7.8
17,53,Ford,2003,7158,6787,371,5.2
17,55,Franklin,2003,17156,15652,1504,8.8
17,57,Fulton,2003,17216,15875,1341,7.8
17,59,Gallatin,2003,2699,2464,235,8.7
17,61,Greene,2003,6970,6552,418,6.0
17,63,Grundy,2003,21150,19451,1699,8.0
17,65,Hamilton,2003,3932,3656,276,7.0
17,67,Hancock,2003,10217,9502,715,7.0
17,69,Hardin,2003,1906,1739,167,8.8
17,71,Henderson,2003,4013,3721,292,7.3
17,73,Henry,2003,26285,24716,1569,6.0
17,75,Iroquois,2003,15838,14891,947,6.0
17,77,Jackson,2003,30746,29092,1654,5.4
17,79,Jasper,2003,5121,4774,347,6.8
17,81,Jefferson,2003,19236,18044,1192,6.2
17,83,Jersey,2003,11037,10395,642,5.8
17,85,Jo Daviess,2003,12401,11712,689,5.6
17,87,Johnson,2003,4961,4622,339,6.8
17,89,Kane,2003,239617,223628,15989,6.7
17,91,Kankakee,2003,51443,47693,3750,7.3
17,93,Kendall,2003,37357,35207,2150,5.8
17,95,Knox,2003,25989,23977,2012,7.7
17,97,Lake,2003,342660,322982,19678,5.7
17,99,LaSalle,2003,54327,50122,4205,7.7
17,101,Lawrence,2003,8199,7704,495,6.0
17,103,Lee,2003,17234,16161,1073,6.2
17,105,Livingston,2003,18675,17598,1077,5.8
17,107,Logan,2003,13316,12422,894,6.7
17,109,McDonough,2003,16216,15270,946,5.8
17,111,McHenry,2003,158468,149028,9440,6.0
17,113,McLean,2003,85758,82271,3487,4.1
17,115,Macon,2003,51718,47768,3950,7.6
17,117,Macoupin,2003,23919,22345,1574,6.6
17,119,Madison,2003,131702,123607,8095,6.1
17,121,Marion,2003,18394,16703,1691,9.2
17,123,Marshall,2003,6725,6340,385,5.7
17,125,Mason,2003,7659,7037,622,8.1
17,127,Massac,2003,7137,6690,447,6.3
17,129,Menard,2003,6710,6391,319,4.8
17,131,Mercer,2003,8574,7969,605,7.1
17,133,Monroe,2003,16151,15406,745,4.6
17,135,Montgomery,2003,13243,12093,1150,8.7
17,137,Morgan,2003,17927,16884,1043,5.8
17,139,Moultrie,2003,7257,6856,401,5.5
17,141,Ogle,2003,25633,23868,1765,6.9
17,143,Peoria,2003,88133,82457,5676,6.4
17,145,Perry,2003,10384,9566,818,7.9
17,147,Piatt,2003,8917,8473,444,5.0
17,149,Pike,2003,8410,7904,506,6.0
17,151,Pope,2003,1916,1758,158,8.2
17,153,Pulaski,2003,3003,2720,283,9.4
17,155,Putnam,2003,3028,2806,222,7.3
17,157,Randolph,2003,15200,14276,924,6.1
17,159,Richland,2003,7266,6759,507,7.0
17,161,Rock Island,2003,74733,70258,4475,6.0
17,163,St. Clair,2003,118179,109851,8328,7.0
17,165,Saline,2003,12023,11108,915,7.6
17,167,Sangamon,2003,101802,96311,5491,5.4
17,169,Schuyler,2003,4133,3902,231,5.6
17,171,Scott,2003,2852,2676,176,6.2
17,173,Shelby,2003,11126,10420,706,6.3
17,175,Stark,2003,2744,2535,209,7.6
17,177,Stephenson,2003,24767,23017,1750,7.1
17,179,Tazewell,2003,65050,61269,3781,5.8
17,181,Union,2003,8235,7588,647,7.9
17,183,Vermilion,2003,37436,34439,2997,8.0
17,185,Wabash,2003,6537,6142,395,6.0
17,187,Warren,2003,9242,8658,584,6.3
17,189,Washington,2003,8351,7913,438,5.2
17,191,Wayne,2003,7906,7411,495,6.3
17,193,White,2003,7813,7374,439,5.6
17,195,Whiteside,2003,28990,26938,2052,7.1
17,197,Will,2003,305605,285302,20303,6.6
17,199,Williamson,2003,31088,28970,2118,6.8
17,201,Winnebago,2003,139815,128573,11242,8.0
17,203,Woodford,2003,18542,17680,862,4.6
18,1,Adams,2003,16075,15388,687,4.3
18,3,Allen,2003,178834,169451,9383,5.2
18,5,Bartholomew,2003,35642,33954,1688,4.7
18,7,Benton,2003,4686,4433,253,5.4
18,9,Blackford,2003,6905,6399,506,7.3
18,11,Boone,2003,26119,25074,1045,4.0
18,13,Brown,2003,8109,7702,407,5.0
18,15,Carroll,2003,10617,9976,641,6.0
18,17,Cass,2003,20010,18768,1242,6.2
18,19,Clark,2003,52877,50293,2584,4.9
18,21,Clay,2003,13002,12255,747,5.7
18,23,Clinton,2003,16840,15961,879,5.2
18,25,Crawford,2003,5342,4979,363,6.8
18,27,Daviess,2003,14339,13758,581,4.1
18,29,Dearborn,2003,25851,24525,1326,5.1
18,31,Decatur,2003,12509,11941,568,4.5
18,33,DeKalb,2003,22014,20774,1240,5.6
18,35,Delaware,2003,58945,55281,3664,6.2
18,37,Dubois,2003,22441,21635,806,3.6
18,39,Elkhart,2003,96130,91638,4492,4.7
18,41,Fayette,2003,11620,10697,923,7.9
18,43,Floyd,2003,37465,35739,1726,4.6
18,45,Fountain,2003,8400,7925,475,5.7
18,47,Franklin,2003,11874,11193,681,5.7
18,49,Fulton,2003,10361,9730,631,6.1
18,51,Gibson,2003,17361,16560,801,4.6
18,53,Grant,2003,34759,32172,2587,7.4
18,55,Greene,2003,16563,15525,1038,6.3
18,57,Hamilton,2003,121055,117099,3956,3.3
18,59,Hancock,2003,32814,31478,1336,4.1
18,61,Harrison,2003,19038,18109,929,4.9
18,63,Hendricks,2003,65455,62768,2687,4.1
18,65,Henry,2003,23489,22098,1391,5.9
18,67,Howard,2003,40093,37373,2720,6.8
18,69,Huntington,2003,20654,19544,1110,5.4
18,71,Jackson,2003,21950,20913,1037,4.7
18,73,Jasper,2003,15078,14230,848,5.6
18,75,Jay,2003,10718,9928,790,7.4
18,77,Jefferson,2003,16819,16019,800,4.8
18,79,Jennings,2003,13905,13025,880,6.3
18,81,Johnson,2003,67893,65184,2709,4.0
18,83,Knox,2003,19608,18748,860,4.4
18,85,Kosciusko,2003,39619,37898,1721,4.3
18,87,LaGrange,2003,16529,15796,733,4.4
18,89,Lake,2003,225574,211841,13733,6.1
18,91,LaPorte,2003,53768,50146,3622,6.7
18,93,Lawrence,2003,22675,21078,1597,7.0
18,95,Madison,2003,64447,60614,3833,5.9
18,97,Marion,2003,463692,439015,24677,5.3
18,99,Marshall,2003,22193,20998,1195,5.4
18,101,Martin,2003,5378,5111,267,5.0
18,103,Miami,2003,17386,16125,1261,7.3
18,105,Monroe,2003,65587,62833,2754,4.2
18,107,Montgomery,2003,19576,18744,832,4.3
18,109,Morgan,2003,36948,35185,1763,4.8
18,111,Newton,2003,7156,6776,380,5.3
18,113,Noble,2003,23724,22269,1455,6.1
18,115,Ohio,2003,3087,2937,150,4.9
18,117,Orange,2003,9185,8465,720,7.8
18,119,Owen,2003,11687,11040,647,5.5
18,121,Parke,2003,8038,7578,460,5.7
18,123,Perry,2003,9613,9093,520,5.4
18,125,Pike,2003,6424,6084,340,5.3
18,127,Porter,2003,79751,75729,4022,5.0
18,129,Posey,2003,14067,13460,607,4.3
18,131,Pulaski,2003,6690,6316,374,5.6
18,133,Putnam,2003,17647,16676,971,5.5
18,135,Randolph,2003,13531,12608,923,6.8
18,137,Ripley,2003,14700,14030,670,4.6
18,139,Rush,2003,9266,8815,451,4.9
18,141,St. Joseph,2003,132277,125293,6984,5.3
18,143,Scott,2003,11075,10364,711,6.4
18,145,Shelby,2003,23792,22659,1133,4.8
18,147,Spencer,2003,10780,10224,556,5.2
18,149,Starke,2003,10527,9767,760,7.2
18,151,Steuben,2003,16989,15900,1089,6.4
18,153,Sullivan,2003,9282,8655,627,6.8
18,155,Switzerland,2003,5740,5488,252,4.4
18,157,Tippecanoe,2003,77470,73854,3616,4.7
18,159,Tipton,2003,8301,7855,446,5.4
18,161,Union,2003,3770,3578,192,5.1
18,163,Vanderburgh,2003,92303,87965,4338,4.7
18,165,Vermillion,2003,8046,7523,523,6.5
18,167,Vigo,2003,50323,47333,2990,5.9
18,169,Wabash,2003,17690,16695,995,5.6
18,171,Warren,2003,4546,4324,222,4.9
18,173,Warrick,2003,30104,28835,1269,4.2
18,175,Washington,2003,14047,13246,801,5.7
18,177,Wayne,2003,34364,32107,2257,6.6
18,179,Wells,2003,14950,14244,706,4.7
18,181,White,2003,12342,11433,909,7.4
18,183,Whitley,2003,17654,16669,985,5.6
19,1,Adair,2003,4288,4115,173,4.0
19,3,Adams,2003,2128,2022,106,5.0
19,5,Allamakee,2003,8069,7625,444,5.5
19,7,Appanoose,2003,6500,6151,349,5.4
19,9,Audubon,2003,3280,3150,130,4.0
19,11,Benton,2003,14089,13424,665,4.7
19,13,Black Hawk,2003,71014,67787,3227,4.5
19,15,Boone,2003,15041,14517,524,3.5
19,17,Bremer,2003,13478,12959,519,3.9
19,19,Buchanan,2003,10875,10386,489,4.5
19,21,Buena Vista,2003,10391,10018,373,3.6
19,23,Butler,2003,8100,7696,404,5.0
19,25,Calhoun,2003,5121,4906,215,4.2
19,27,Carroll,2003,12243,11898,345,2.8
19,29,Cass,2003,7527,7149,378,5.0
19,31,Cedar,2003,10410,10020,390,3.7
19,33,Cerro Gordo,2003,25511,24432,1079,4.2
19,35,Cherokee,2003,6717,6437,280,4.2
19,37,Chickasaw,2003,6277,5898,379,6.0
19,39,Clarke,2003,4863,4473,390,8.0
19,41,Clay,2003,9753,9349,404,4.1
19,43,Clayton,2003,9568,8987,581,6.1
19,45,Clinton,2003,26189,24776,1413,5.4
19,47,Crawford,2003,8761,8427,334,3.8
19,49,Dallas,2003,26507,25636,871,3.3
19,51,Davis,2003,4235,4029,206,4.9
19,53,Decatur,2003,4281,4035,246,5.7
19,55,Delaware,2003,9917,9426,491,5.0
19,57,Des Moines,2003,21306,19896,1410,6.6
19,59,Dickinson,2003,9843,9389,454,4.6
19,61,Dubuque,2003,48857,46770,2087,4.3
19,63,Emmet,2003,5992,5675,317,5.3
19,65,Fayette,2003,10953,10399,554,5.1
19,67,Floyd,2003,8584,8158,426,5.0
19,69,Franklin,2003,5401,5158,243,4.5
19,71,Fremont,2003,4308,4164,144,3.3
19,73,Greene,2003,4995,4802,193,3.9
19,75,Grundy,2003,6814,6556,258,3.8
19,77,Guthrie,2003,6085,5841,244,4.0
19,79,Hamilton,2003,8618,8248,370,4.3
19,81,Hancock,2003,6269,6042,227,3.6
19,83,Hardin,2003,9138,8671,467,5.1
19,85,Harrison,2003,8175,7797,378,4.6
19,87,Henry,2003,10170,9501,669,6.6
19,89,Howard,2003,5050,4830,220,4.4
19,91,Humboldt,2003,5200,4983,217,4.2
19,93,Ida,2003,3867,3719,148,3.8
19,95,Iowa,2003,8632,8312,320,3.7
19,97,Jackson,2003,11204,10528,676,6.0
19,99,Jasper,2003,19690,18691,999,5.1
19,101,Jefferson,2003,8285,7834,451,5.4
19,103,Johnson,2003,72479,70277,2202,3.0
19,105,Jones,2003,10428,9889,539,5.2
19,107,Keokuk,2003,6087,5811,276,4.5
19,109,Kossuth,2003,8798,8411,387,4.4
19,111,Lee,2003,17479,16144,1335,7.6
19,113,Linn,2003,112270,106894,5376,4.8
19,115,Louisa,2003,6275,5986,289,4.6
19,117,Lucas,2003,4835,4582,253,5.2
19,119,Lyon,2003,6281,6059,222,3.5
19,121,Madison,2003,7853,7504,349,4.4
19,123,Mahaska,2003,11305,10761,544,4.8
19,125,Marion,2003,16980,16208,772,4.5
19,127,Marshall,2003,20633,19542,1091,5.3
19,129,Mills,2003,8125,7818,307,3.8
19,131,Mitchell,2003,5364,5166,198,3.7
19,133,Monona,2003,4872,4622,250,5.1
19,135,Monroe,2003,3486,3290,196,5.6
19,137,Montgomery,2003,5683,5401,282,5.0
19,139,Muscatine,2003,22402,21454,948,4.2
19,141,O'Brien,2003,7478,7192,286,3.8
19,143,Osceola,2003,3481,3351,130,3.7
19,145,Page,2003,7556,7197,359,4.8
19,147,Palo Alto,2003,5010,4819,191,3.8
19,149,Plymouth,2003,13784,13267,517,3.8
19,151,Pocahontas,2003,3847,3629,218,5.7
19,153,Polk,2003,222328,213220,9108,4.1
19,155,Pottawattamie,2003,49023,46726,2297,4.7
19,157,Poweshiek,2003,10261,9785,476,4.6
19,159,Ringgold,2003,2546,2428,118,4.6
19,161,Sac,2003,5773,5540,233,4.0
19,163,Scott,2003,85797,81745,4052,4.7
19,165,Shelby,2003,6949,6695,254,3.7
19,167,Sioux,2003,17968,17430,538,3.0
19,169,Story,2003,47007,45682,1325,2.8
19,171,Tama,2003,9011,8292,719,8.0
19,173,Taylor,2003,3295,3149,146,4.4
19,175,Union,2003,6269,5918,351,5.6
19,177,Van Buren,2003,3791,3577,214,5.6
19,179,Wapello,2003,19293,18225,1068,5.5
19,181,Warren,2003,24177,23303,874,3.6
19,183,Washington,2003,12123,11674,449,3.7
19,185,Wayne,2003,3163,3020,143,4.5
19,187,Webster,2003,19587,18670,917,4.7
19,189,Winnebago,2003,6024,5800,224,3.7
19,191,Winneshiek,2003,12266,11748,518,4.2
19,193,Woodbury,2003,54565,52054,2511,4.6
19,195,Worth,2003,4404,4224,180,4.1
19,197,Wright,2003,6955,6639,316,4.5
20,1,Allen,2003,7205,6853,352,4.9
20,3,Anderson,2003,4141,3913,228,5.5
20,5,Atchison,2003,8338,7876,462,5.5
20,7,Barber,2003,2669,2571,98,3.7
20,9,Barton,2003,14562,13916,646,4.4
20,11,Bourbon,2003,8617,8205,412,4.8
20,13,Brown,2003,5501,5249,252,4.6
20,15,Butler,2003,30922,29005,1917,6.2
20,17,Chase,2003,1634,1564,70,4.3
20,19,Chautauqua,2003,1960,1858,102,5.2
20,21,Cherokee,2003,10733,9976,757,7.1
20,23,Cheyenne,2003,1627,1579,48,3.0
20,25,Clark,2003,1256,1215,41,3.3
20,27,Clay,2003,4625,4422,203,4.4
20,29,Cloud,2003,5779,5569,210,3.6
20,31,Coffey,2003,4934,4640,294,6.0
20,33,Comanche,2003,1035,1005,30,2.9
20,35,Cowley,2003,18422,17184,1238,6.7
20,37,Crawford,2003,19388,18302,1086,5.6
20,39,Decatur,2003,1872,1812,60,3.2
20,41,Dickinson,2003,10436,9954,482,4.6
20,43,Doniphan,2003,4421,4101,320,7.2
20,45,Douglas,2003,61478,59077,2401,3.9
20,47,Edwards,2003,1699,1636,63,3.7
20,49,Elk,2003,1446,1358,88,6.1
20,51,Ellis,2003,16904,16373,531,3.1
20,53,Ellsworth,2003,3162,3028,134,4.2
20,55,Finney,2003,18196,17516,680,3.7
20,57,Ford,2003,16657,16081,576,3.5
20,59,Franklin,2003,13547,12786,761,5.6
20,61,Geary,2003,11163,10477,686,6.1
20,63,Gove,2003,1578,1532,46,2.9
20,65,Graham,2003,1445,1398,47,3.3
20,67,Grant,2003,3802,3664,138,3.6
20,69,Gray,2003,3157,3063,94,3.0
20,71,Greeley,2003,789,760,29,3.7
20,73,Greenwood,2003,3635,3422,213,5.9
20,75,Hamilton,2003,1288,1249,39,3.0
20,77,Harper,2003,3267,3127,140,4.3
20,79,Harvey,2003,17619,16712,907,5.1
20,81,Haskell,2003,2120,2059,61,2.9
20,83,Hodgeman,2003,989,950,39,3.9
20,85,Jackson,2003,7043,6609,434,6.2
20,87,Jefferson,2003,10134,9613,521,5.1
20,89,Jewell,2003,2099,2037,62,3.0
20,91,Johnson,2003,278283,263964,14319,5.1
20,93,Kearny,2003,2027,1948,79,3.9
20,95,Kingman,2003,4264,4036,228,5.3
20,97,Kiowa,2003,1632,1579,53,3.2
20,99,Labette,2003,10224,9545,679,6.6
20,101,Lane,2003,1121,1076,45,4.0
20,103,Leavenworth,2003,32232,30240,1992,6.2
20,105,Lincoln,2003,1922,1824,98,5.1
20,107,Linn,2003,4731,4411,320,6.8
20,109,Logan,2003,1596,1545,51,3.2
20,111,Lyon,2003,19530,18656,874,4.5
20,113,McPherson,2003,16147,15538,609,3.8
20,115,Marion,2003,6681,6374,307,4.6
20,117,Marshall,2003,5745,5533,212,3.7
20,119,Meade,2003,2244,2173,71,3.2
20,121,Miami,2003,15492,14694,798,5.2
20,123,Mitchell,2003,3433,3298,135,3.9
20,125,Montgomery,2003,16605,15491,1114,6.7
20,127,Morris,2003,3126,2994,132,4.2
20,129,Morton,2003,1680,1629,51,3.0
20,131,Nemaha,2003,5272,5096,176,3.3
20,133,Neosho,2003,8933,8501,432,4.8
20,135,Ness,2003,1719,1666,53,3.1
20,137,Norton,2003,2653,2547,106,4.0
20,139,Osage,2003,9086,8554,532,5.9
20,141,Osborne,2003,2381,2288,93,3.9
20,143,Ottawa,2003,3361,3212,149,4.4
20,145,Pawnee,2003,3557,3420,137,3.9
20,147,Phillips,2003,3155,3047,108,3.4
20,149,Pottawatomie,2003,9958,9548,410,4.1
20,151,Pratt,2003,5478,5294,184,3.4
20,153,Rawlins,2003,1411,1359,52,3.7
20,155,Reno,2003,32583,30888,1695,5.2
20,157,Republic,2003,2919,2780,139,4.8
20,159,Rice,2003,5268,5043,225,4.3
20,161,Riley,2003,32091,30952,1139,3.5
20,163,Rooks,2003,2739,2588,151,5.5
20,165,Rush,2003,1691,1618,73,4.3
20,167,Russell,2003,3427,3281,146,4.3
20,169,Saline,2003,30008,28629,1379,4.6
20,171,Scott,2003,2911,2826,85,2.9
20,173,Sedgwick,2003,241052,224596,16456,6.8
20,175,Seward,2003,10332,9939,393,3.8
20,177,Shawnee,2003,93778,88852,4926,5.3
20,179,Sheridan,2003,1540,1497,43,2.8
20,181,Sherman,2003,3801,3682,119,3.1
20,183,Smith,2003,2260,2180,80,3.5
20,185,Stafford,2003,2255,2165,90,4.0
20,187,Stanton,2003,1182,1148,34,2.9
20,189,Stevens,2003,2326,2246,80,3.4
20,191,Sumner,2003,12471,11505,966,7.7
20,193,Thomas,2003,4327,4195,132,3.1
20,195,Trego,2003,1721,1663,58,3.4
20,197,Wabaunsee,2003,3768,3610,158,4.2
20,199,Wallace,2003,966,940,26,2.7
20,201,Washington,2003,3437,3307,130,3.8
20,203,Wichita,2003,1307,1262,45,3.4
20,205,Wilson,2003,5029,4762,267,5.3
20,207,Woodson,2003,1727,1615,112,6.5
20,209,Wyandotte,2003,75182,66973,8209,10.9
21,1,Adair,2003,8798,8278,520,5.9
21,3,Allen,2003,8551,7965,586,6.9
21,5,Anderson,2003,10308,9827,481,4.7
21,7,Ballard,2003,4143,3818,325,7.8
21,9,Barren,2003,19460,18442,1018,5.2
21,11,Bath,2003,5092,4690,402,7.9
21,13,Bell,2003,9489,8663,826,8.7
21,15,Boone,2003,53892,51261,2631,4.9
21,17,Bourbon,2003,9749,9184,565,5.8
21,19,Boyd,2003,22780,21185,1595,7.0
21,21,Boyle,2003,13400,12255,1145,8.5
21,23,Bracken,2003,4258,3996,262,6.2
21,25,Breathitt,2003,5491,5015,476,8.7
21,27,Breckinridge,2003,9007,8379,628,7.0
21,29,Bullitt,2003,33793,31883,1910,5.7
21,31,Butler,2003,6210,5607,603,9.7
21,33,Caldwell,2003,6391,6009,382,6.0
21,35,Calloway,2003,16683,15407,1276,7.6
21,37,Campbell,2003,45255,42988,2267,5.0
21,39,Carlisle,2003,2437,2241,196,8.0
21,41,Carroll,2003,5310,4948,362,6.8
21,43,Carter,2003,13101,11931,1170,8.9
21,45,Casey,2003,7330,6834,496,6.8
21,47,Christian,2003,26262,24505,1757,6.7
21,49,Clark,2003,16706,15753,953,5.7
21,51,Clay,2003,7157,6434,723,10.1
21,53,Clinton,2003,4771,4329,442,9.3
21,55,Crittenden,2003,4291,3994,297,6.9
21,57,Cumberland,2003,3214,2978,236,7.3
21,59,Daviess,2003,46259,43461,2798,6.0
21,61,Edmonson,2003,5144,4779,365,7.1
21,63,Elliott,2003,2737,2510,227,8.3
21,65,Estill,2003,6054,5603,451,7.4
21,67,Fayette,2003,145725,139009,6716,4.6
21,69,Fleming,2003,6832,6428,404,5.9
21,71,Floyd,2003,14515,13329,1186,8.2
21,73,Franklin,2003,24990,23841,1149,4.6
21,75,Fulton,2003,3115,2766,349,11.2
21,77,Gallatin,2003,3919,3695,224,5.7
21,79,Garrard,2003,7959,7501,458,5.8
21,81,Grant,2003,12158,11430,728,6.0
21,83,Graves,2003,16782,15534,1248,7.4
21,85,Grayson,2003,11794,10703,1091,9.3
21,87,Green,2003,5656,5295,361,6.4
21,89,Greenup,2003,16826,15662,1164,6.9
21,91,Hancock,2003,4115,3825,290,7.0
21,93,Hardin,2003,45085,42563,2522,5.6
21,95,Harlan,2003,10469,9444,1025,9.8
21,97,Harrison,2003,9194,8662,532,5.8
21,99,Hart,2003,7907,7413,494,6.2
21,101,Henderson,2003,22884,21621,1263,5.5
21,103,Henry,2003,7637,7232,405,5.3
21,105,Hickman,2003,2246,2047,199,8.9
21,107,Hopkins,2003,21725,20284,1441,6.6
21,109,Jackson,2003,4893,4516,377,7.7
21,111,Jefferson,2003,348651,327318,21333,6.1
21,113,Jessamine,2003,20951,19970,981,4.7
21,115,Johnson,2003,9734,9071,663,6.8
21,117,Kenton,2003,81771,77825,3946,4.8
21,119,Knott,2003,6025,5631,394,6.5
21,121,Knox,2003,11645,10754,891,7.7
21,123,Larue,2003,6599,6259,340,5.2
21,125,Laurel,2003,24988,23313,1675,6.7
21,127,Lawrence,2003,5757,5248,509,8.8
21,129,Lee,2003,2653,2414,239,9.0
21,131,Leslie,2003,3737,3375,362,9.7
21,133,Letcher,2003,9021,8104,917,10.2
21,135,Lewis,2003,5615,5174,441,7.9
21,137,Lincoln,2003,11030,10168,862,7.8
21,139,Livingston,2003,4808,4475,333,6.9
21,141,Logan,2003,12612,11818,794,6.3
21,143,Lyon,2003,3216,2945,271,8.4
21,145,McCracken,2003,30861,28888,1973,6.4
21,147,McCreary,2003,5887,5316,571,9.7
21,149,McLean,2003,4664,4310,354,7.6
21,151,Madison,2003,39603,37524,2079,5.2
21,153,Magoffin,2003,4571,4028,543,11.9
21,155,Marion,2003,9401,8868,533,5.7
21,157,Marshall,2003,14475,13378,1097,7.6
21,159,Martin,2003,3930,3605,325,8.3
21,161,Mason,2003,8796,8278,518,5.9
21,163,Meade,2003,11624,10889,735,6.3
21,165,Menifee,2003,2676,2429,247,9.2
21,167,Mercer,2003,10491,9838,653,6.2
21,169,Metcalfe,2003,4533,4288,245,5.4
21,171,Monroe,2003,5301,4919,382,7.2
21,173,Montgomery,2003,11713,10947,766,6.5
21,175,Morgan,2003,5192,4694,498,9.6
21,177,Muhlenberg,2003,13220,12150,1070,8.1
21,179,Nelson,2003,19661,18461,1200,6.1
21,181,Nicholas,2003,3215,3000,215,6.7
21,183,Ohio,2003,11099,10255,844,7.6
21,185,Oldham,2003,24519,23431,1088,4.4
21,187,Owen,2003,5118,4864,254,5.0
21,189,Owsley,2003,1588,1451,137,8.6
21,191,Pendleton,2003,7364,6906,458,6.2
21,193,Perry,2003,10588,9640,948,9.0
21,195,Pike,2003,24301,22381,1920,7.9
21,197,Powell,2003,5688,5171,517,9.1
21,199,Pulaski,2003,26507,24688,1819,6.9
21,201,Robertson,2003,1148,1080,68,5.9
21,203,Rockcastle,2003,7194,6790,404,5.6
21,205,Rowan,2003,12121,11468,653,5.4
21,207,Russell,2003,7828,7244,584,7.5
21,209,Scott,2003,19431,18380,1051,5.4
21,211,Shelby,2003,18760,17787,973,5.2
21,213,Simpson,2003,8615,8130,485,5.6
21,215,Spencer,2003,7373,7035,338,4.6
21,217,Taylor,2003,12161,11459,702,5.8
21,219,Todd,2003,5958,5692,266,4.5
21,221,Trigg,2003,6097,5735,362,5.9
21,223,Trimble,2003,4178,3942,236,5.6
21,225,Union,2003,7572,7098,474,6.3
21,227,Warren,2003,51638,48810,2828,5.5
21,229,Washington,2003,5449,5136,313,5.7
21,231,Wayne,2003,8900,8303,597,6.7
21,233,Webster,2003,6702,6256,446,6.7
21,235,Whitley,2003,14033,12996,1037,7.4
21,237,Wolfe,2003,2375,2144,231,9.7
21,239,Woodford,2003,13017,12492,525,4.0
22,1,Acadia Parish,2003,24015,22413,1602,6.7
22,3,Allen Parish,2003,9003,8234,769,8.5
22,5,Ascension Parish,2003,41022,38289,2733,6.7
22,7,Assumption Parish,2003,10631,9928,703,6.6
22,9,Avoyelles Parish,2003,15832,14500,1332,8.4
22,11,Beauregard Parish,2003,14258,13235,1023,7.2
22,13,Bienville Parish,2003,6017,5497,520,8.6
22,15,Bossier Parish,2003,47468,44507,2961,6.2
22,17,Caddo Parish,2003,111586,103776,7810,7.0
22,19,Calcasieu Parish,2003,86141,80714,5427,6.3
22,21,Caldwell Parish,2003,4409,3983,426,9.7
22,23,Cameron Parish,2003,4341,4106,235,5.4
22,25,Catahoula Parish,2003,4133,3739,394,9.5
22,27,Claiborne Parish,2003,6810,6305,505,7.4
22,29,Concordia Parish,2003,7294,6475,819,11.2
22,31,De Soto Parish,2003,10774,9867,907,8.4
22,33,East Baton Rouge Parish,2003,201372,189698,11674,5.8
22,35,East Carroll Parish,2003,3114,2710,404,13.0
22,37,East Feliciana Parish,2003,7988,7401,587,7.3
22,39,Evangeline Parish,2003,11861,10920,941,7.9
22,41,Franklin Parish,2003,8031,7251,780,9.7
22,43,Grant Parish,2003,8023,7403,620,7.7
22,45,Iberia Parish,2003,30838,28889,1949,6.3
22,47,Iberville Parish,2003,12247,11139,1108,9.0
22,49,Jackson Parish,2003,6549,5993,556,8.5
22,51,Jefferson Parish,2003,223626,212307,11319,5.1
22,53,Jefferson Davis Parish,2003,13543,12768,775,5.7
22,55,Lafayette Parish,2003,98028,93343,4685,4.8
22,57,Lafourche Parish,2003,43714,41630,2084,4.8
22,59,LaSalle Parish,2003,5880,5371,509,8.7
22,61,Lincoln Parish,2003,18298,17055,1243,6.8
22,63,Livingston Parish,2003,48208,44976,3232,6.7
22,65,Madison Parish,2003,4980,4445,535,10.7
22,67,Morehouse Parish,2003,12665,11408,1257,9.9
22,69,Natchitoches Parish,2003,16693,15452,1241,7.4
22,71,Orleans Parish,2003,198396,186235,12161,6.1
22,73,Ouachita Parish,2003,71933,67709,4224,5.9
22,75,Plaquemines Parish,2003,11129,10477,652,5.9
22,77,Pointe Coupee Parish,2003,9416,8711,705,7.5
22,79,Rapides Parish,2003,56133,52570,3563,6.3
22,81,Red River Parish,2003,3657,3312,345,9.4
22,83,Richland Parish,2003,8743,7994,749,8.6
22,85,Sabine Parish,2003,9376,8698,678,7.2
22,87,St. Bernard Parish,2003,30758,28904,1854,6.0
22,89,St. Charles Parish,2003,23634,22330,1304,5.5
22,91,St. Helena Parish,2003,3888,3622,266,6.8
22,93,St. James Parish,2003,8829,7964,865,9.8
22,95,St. John the Baptist Parish,2003,20127,18750,1377,6.8
22,97,St. Landry Parish,2003,33689,31170,2519,7.5
22,99,St. Martin Parish,2003,21607,20323,1284,5.9
22,101,St. Mary Parish,2003,22234,20606,1628,7.3
22,103,St. Tammany Parish,2003,100959,96181,4778,4.7
22,105,Tangipahoa Parish,2003,46876,43576,3300,7.0
22,107,Tensas Parish,2003,2409,2191,218,9.0
22,109,Terrebonne Parish,2003,48650,46273,2377,4.9
22,111,Union Parish,2003,10567,9802,765,7.2
22,113,Vermilion Parish,2003,23097,21580,1517,6.6
22,115,Vernon Parish,2003,18660,17455,1205,6.5
22,117,Washington Parish,2003,16599,15317,1282,7.7
22,119,Webster Parish,2003,18435,16913,1522,8.3
22,121,West Baton Rouge Parish,2003,10039,9340,699,7.0
22,123,West Carroll Parish,2003,4754,4123,631,13.3
22,125,West Feliciana Parish,2003,4716,4355,361,7.7
22,127,Winn Parish,2003,6221,5700,521,8.4
23,1,Androscoggin,2003,56281,53377,2904,5.2
23,3,Aroostook,2003,34516,32341,2175,6.3
23,5,Cumberland,2003,151734,146229,5505,3.6
23,7,Franklin,2003,14316,13449,867,6.1
23,9,Hancock,2003,29306,27791,1515,5.2
23,11,Kennebec,2003,61029,57828,3201,5.2
23,13,Knox,2003,21273,20345,928,4.4
23,15,Lincoln,2003,17821,17051,770,4.3
23,17,Oxford,2003,27715,26050,1665,6.0
23,19,Penobscot,2003,77065,72330,4735,6.1
23,21,Piscataquis,2003,7487,6879,608,8.1
23,23,Sagadahoc,2003,18317,17579,738,4.0
23,25,Somerset,2003,24669,22692,1977,8.0
23,27,Waldo,2003,19748,18608,1140,5.8
23,29,Washington,2003,15419,14042,1377,8.9
23,31,York,2003,108459,103309,5150,4.7
24,1,Allegany,2003,34684,32452,2232,6.4
24,3,Anne Arundel,2003,270760,259619,11141,4.1
24,5,Baltimore,2003,413833,392867,20966,5.1
24,9,Calvert,2003,44352,42685,1667,3.8
24,11,Caroline,2003,15614,14746,868,5.6
24,13,Carroll,2003,88933,85460,3473,3.9
24,15,Cecil,2003,47819,45177,2642,5.5
24,17,Charles,2003,69785,67192,2593,3.7
24,19,Dorchester,2003,16349,15140,1209,7.4
24,21,Frederick,2003,116543,112187,4356,3.7
24,23,Garrett,2003,15572,14697,875,5.6
24,25,Harford,2003,125109,119288,5821,4.7
24,27,Howard,2003,150537,145108,5429,3.6
24,29,Kent,2003,10256,9709,547,5.3
24,31,Montgomery,2003,497712,479960,17752,3.6
24,33,Prince George's,2003,441014,418766,22248,5.0
24,35,Queen Anne's,2003,24206,23216,990,4.1
24,37,St. Mary's,2003,48528,46714,1814,3.7
24,39,Somerset,2003,10997,10221,776,7.1
24,41,Talbot,2003,18577,17712,865,4.7
24,43,Washington,2003,67266,63692,3574,5.3
24,45,Wicomico,2003,48559,46053,2506,5.2
24,47,Worcester,2003,27828,25878,1950,7.0
24,510,Baltimore city,2003,276196,254428,21768,7.9
25,1,Barnstable,2003,122303,115949,6354,5.2
25,3,Berkshire,2003,72927,69265,3662,5.0
25,5,Bristol,2003,287387,268658,18729,6.5
25,7,Dukes,2003,11121,10656,465,4.2
25,9,Essex,2003,380419,356415,24004,6.3
25,11,Franklin,2003,40239,38428,1811,4.5
25,13,Hampden,2003,225597,211011,14586,6.5
25,15,Hampshire,2003,88080,84398,3682,4.2
25,17,Middlesex,2003,820422,777362,43060,5.2
25,19,Nantucket/town,2003,7725,7532,193,2.5
25,21,Norfolk,2003,357678,339606,18072,5.1
25,23,Plymouth,2003,257209,243018,14191,5.5
25,25,Suffolk,2003,345450,323109,22341,6.5
25,27,Worcester,2003,402443,377890,24553,6.1
26,1,Alcona,2003,4195,3698,497,11.8
26,3,Alger,2003,4432,4088,344,7.8
26,5,Allegan,2003,53118,49658,3460,6.5
26,7,Alpena,2003,15211,13836,1375,9.0
26,9,Antrim,2003,11678,10695,983,8.4
26,11,Arenac,2003,7666,6926,740,9.7
26,13,Baraga,2003,3894,3512,382,9.8
26,15,Barry,2003,29721,27961,1760,5.9
26,17,Bay,2003,55541,51398,4143,7.5
26,19,Benzie,2003,8766,8077,689,7.9
26,21,Berrien,2003,78334,72646,5688,7.3
26,23,Branch,2003,22991,21427,1564,6.8
26,25,Calhoun,2003,71377,66352,5025,7.0
26,27,Cass,2003,26000,24694,1306,5.0
26,29,Charlevoix,2003,13781,12669,1112,8.1
26,31,Cheboygan,2003,12745,11469,1276,10.0
26,33,Chippewa,2003,17293,15784,1509,8.7
26,35,Clare,2003,12993,11809,1184,9.1
26,37,Clinton,2003,36340,34645,1695,4.7
26,39,Crawford,2003,6677,6170,507,7.6
26,41,Delta,2003,20014,18354,1660,8.3
26,43,Dickinson,2003,14148,13200,948,6.7
26,45,Eaton,2003,58030,55237,2793,4.8
26,47,Emmet,2003,19057,17611,1446,7.6
26,49,Genesee,2003,209316,192151,17165,8.2
26,51,Gladwin,2003,11167,10121,1046,9.4
26,53,Gogebic,2003,7875,7214,661,8.4
26,55,Grand Traverse,2003,46624,43757,2867,6.1
26,57,Gratiot,2003,19656,18259,1397,7.1
26,59,Hillsdale,2003,22941,21213,1728,7.5
26,61,Houghton,2003,17060,15875,1185,6.9
26,63,Huron,2003,17164,15561,1603,9.3
26,65,Ingham,2003,152130,143631,8499,5.6
26,67,Ionia,2003,29501,27428,2073,7.0
26,69,Iosco,2003,10587,9518,1069,10.1
26,71,Iron,2003,5833,5405,428,7.3
26,73,Isabella,2003,35069,33286,1783,5.1
26,75,Jackson,2003,77461,71342,6119,7.9
26,77,Kalamazoo,2003,130186,123155,7031,5.4
26,79,Kalkaska,2003,8664,7964,700,8.1
26,81,Kent,2003,313728,291111,22617,7.2
26,83,Keweenaw,2003,1050,943,107,10.2
26,85,Lake,2003,4499,4054,445,9.9
26,87,Lapeer,2003,45550,41851,3699,8.1
26,89,Leelanau,2003,11347,10715,632,5.6
26,91,Lenawee,2003,50211,46605,3606,7.2
26,93,Livingston,2003,92253,87597,4656,5.0
26,95,Luce,2003,2891,2670,221,7.6
26,97,Mackinac,2003,6549,5936,613,9.4
26,99,Macomb,2003,425120,396315,28805,6.8
26,101,Manistee,2003,11876,10842,1034,8.7
26,103,Marquette,2003,34130,31902,2228,6.5
26,105,Mason,2003,15306,13615,1691,11.0
26,107,Mecosta,2003,19806,18477,1329,6.7
26,109,Menominee,2003,13310,12496,814,6.1
26,111,Midland,2003,41331,38738,2593,6.3
26,113,Missaukee,2003,6634,6113,521,7.9
26,115,Monroe,2003,77153,72511,4642,6.0
26,117,Montcalm,2003,29309,26998,2311,7.9
26,119,Montmorency,2003,4284,3783,501,11.7
26,121,Muskegon,2003,88151,80326,7825,8.9
26,123,Newaygo,2003,22775,20798,1977,8.7
26,125,Oakland,2003,645129,609109,36020,5.6
26,127,Oceana,2003,13517,12256,1261,9.3
26,129,Ogemaw,2003,9662,8781,881,9.1
26,131,Ontonagon,2003,3512,3238,274,7.8
26,133,Osceola,2003,10842,9978,864,8.0
26,135,Oscoda,2003,3793,3364,429,11.3
26,137,Otsego,2003,12295,11296,999,8.1
26,139,Ottawa,2003,132100,124337,7763,5.9
26,141,Presque Isle,2003,6537,5809,728,11.1
26,143,Roscommon,2003,10679,9766,913,8.5
26,145,Saginaw,2003,99527,90754,8773,8.8
26,147,St. Clair,2003,86120,78870,7250,8.4
26,149,St. Joseph,2003,30558,28369,2189,7.2
26,151,Sanilac,2003,21580,19530,2050,9.5
26,153,Schoolcraft,2003,3909,3486,423,10.8
26,155,Shiawassee,2003,35807,33175,2632,7.4
26,157,Tuscola,2003,29222,26624,2598,8.9
26,159,Van Buren,2003,39475,36720,2755,7.0
26,161,Washtenaw,2003,184641,177155,7486,4.1
26,163,Wayne,2003,920140,840831,79309,8.6
26,165,Wexford,2003,14577,13265,1312,9.0
27,1,Aitkin,2003,7586,7063,523,6.9
27,3,Anoka,2003,187156,178360,8796,4.7
27,5,Becker,2003,16555,15577,978,5.9
27,7,Beltrami,2003,21404,20258,1146,5.4
27,9,Benton,2003,21958,20796,1162,5.3
27,11,Big Stone,2003,2851,2720,131,4.6
27,13,Blue Earth,2003,35397,34030,1367,3.9
27,15,Brown,2003,15331,14511,820,5.3
27,17,Carlton,2003,16686,15645,1041,6.2
27,19,Carver,2003,45559,43632,1927,4.2
27,21,Cass,2003,14228,13246,982,6.9
27,23,Chippewa,2003,7266,6897,369,5.1
27,25,Chisago,2003,26062,24573,1489,5.7
27,27,Clay,2003,29668,28612,1056,3.6
27,29,Clearwater,2003,4050,3602,448,11.1
27,31,Cook,2003,3176,3024,152,4.8
27,33,Cottonwood,2003,6728,6423,305,4.5
27,35,Crow Wing,2003,31642,29856,1786,5.6
27,37,Dakota,2003,225083,215667,9416,4.2
27,39,Dodge,2003,10933,10462,471,4.3
27,41,Douglas,2003,19994,19238,756,3.8
27,43,Faribault,2003,8627,8188,439,5.1
27,45,Fillmore,2003,11816,11238,578,4.9
27,47,Freeborn,2003,16974,16082,892,5.3
27,49,Goodhue,2003,25786,24576,1210,4.7
27,51,Grant,2003,3246,3047,199,6.1
27,53,Hennepin,2003,664774,634435,30339,4.6
27,55,Houston,2003,11221,10633,588,5.2
27,57,Hubbard,2003,9780,9208,572,5.8
27,59,Isanti,2003,20155,19024,1131,5.6
27,61,Itasca,2003,22588,20931,1657,7.3
27,63,Jackson,2003,6548,6282,266,4.1
27,65,Kanabec,2003,7947,7311,636,8.0
27,67,Kandiyohi,2003,23713,22684,1029,4.3
27,69,Kittson,2003,2551,2364,187,7.3
27,71,Koochiching,2003,7233,6770,463,6.4
27,73,Lac qui Parle,2003,4106,3931,175,4.3
27,75,Lake,2003,6107,5824,283,4.6
27,77,Lake of the Woods,2003,2488,2375,113,4.5
27,79,Le Sueur,2003,14881,13954,927,6.2
27,81,Lincoln,2003,3383,3250,133,3.9
27,83,Lyon,2003,14529,13922,607,4.2
27,85,McLeod,2003,20247,19337,910,4.5
27,87,Mahnomen,2003,2734,2591,143,5.2
27,89,Marshall,2003,5270,4842,428,8.1
27,91,Martin,2003,11858,11313,545,4.6
27,93,Meeker,2003,12716,11999,717,5.6
27,95,Mille Lacs,2003,12236,11350,886,7.2
27,97,Morrison,2003,17698,16614,1084,6.1
27,99,Mower,2003,20511,19596,915,4.5
27,101,Murray,2003,5539,5298,241,4.4
27,103,Nicollet,2003,18938,18227,711,3.8
27,105,Nobles,2003,11354,10926,428,3.8
27,107,Norman,2003,3717,3521,196,5.3
27,109,Olmsted,2003,77115,73844,3271,4.2
27,111,Otter Tail,2003,30209,28584,1625,5.4
27,113,Pennington,2003,8045,7564,481,6.0
27,115,Pine,2003,14809,13804,1005,6.8
27,117,Pipestone,2003,5515,5306,209,3.8
27,119,Polk,2003,16670,15829,841,5.0
27,121,Pope,2003,6246,5995,251,4.0
27,123,Ramsey,2003,281429,268122,13307,4.7
27,125,Red Lake,2003,2203,2031,172,7.8
27,127,Redwood,2003,8671,8285,386,4.5
27,129,Renville,2003,9011,8537,474,5.3
27,131,Rice,2003,33302,31729,1573,4.7
27,133,Rock,2003,5274,5094,180,3.4
27,135,Roseau,2003,10256,9520,736,7.2
27,137,St. Louis,2003,103843,97482,6361,6.1
27,139,Scott,2003,64476,61740,2736,4.2
27,141,Sherburne,2003,43591,41399,2192,5.0
27,143,Sibley,2003,9086,8653,433,4.8
27,145,Stearns,2003,80250,76500,3750,4.7
27,147,Steele,2003,19556,18608,948,4.8
27,149,Stevens,2003,5756,5535,221,3.8
27,151,Swift,2003,5530,5260,270,4.9
27,153,Todd,2003,12924,12284,640,5.0
27,155,Traverse,2003,1915,1829,86,4.5
27,157,Wabasha,2003,12689,12145,544,4.3
27,159,Wadena,2003,6724,6288,436,6.5
27,161,Waseca,2003,10741,10242,499,4.6
27,163,Washington,2003,123778,118701,5077,4.1
27,165,Watonwan,2003,6002,5714,288,4.8
27,167,Wilkin,2003,3795,3649,146,3.8
27,169,Winona,2003,28353,27034,1319,4.7
27,171,Wright,2003,59311,56314,2997,5.1
27,173,Yellow Medicine,2003,5719,5403,316,5.5
28,1,Adams,2003,13650,12525,1125,8.2
28,3,Alcorn,2003,15894,14753,1141,7.2
28,5,Amite,2003,5373,4926,447,8.3
28,7,Attala,2003,8505,7860,645,7.6
28,9,Benton,2003,2959,2652,307,10.4
28,11,Bolivar,2003,15791,14563,1228,7.8
28,13,Calhoun,2003,6579,6105,474,7.2
28,15,Carroll,2003,5057,4762,295,5.8
28,17,Chickasaw,2003,7922,7249,673,8.5
28,19,Choctaw,2003,3623,3240,383,10.6
28,21,Claiborne,2003,3970,3561,409,10.3
28,23,Clarke,2003,7323,6662,661,9.0
28,25,Clay,2003,8969,8119,850,9.5
28,27,Coahoma,2003,11640,10696,944,8.1
28,29,Copiah,2003,12328,11575,753,6.1
28,31,Covington,2003,8699,8233,466,5.4
28,33,DeSoto,2003,65740,63384,2356,3.6
28,35,Forrest,2003,35271,33467,1804,5.1
28,37,Franklin,2003,3147,2884,263,8.4
28,39,George,2003,8522,7682,840,9.9
28,41,Greene,2003,4955,4504,451,9.1
28,43,Grenada,2003,9972,9378,594,6.0
28,45,Hancock,2003,20481,19475,1006,4.9
28,47,Harrison,2003,91046,86713,4333,4.8
28,49,Hinds,2003,121786,115265,6521,5.4
28,51,Holmes,2003,6844,6093,751,11.0
28,53,Humphreys,2003,4601,4223,378,8.2
28,55,Issaquena,2003,845,756,89,10.5
28,57,Itawamba,2003,10424,9785,639,6.1
28,59,Jackson,2003,59841,56207,3634,6.1
28,61,Jasper,2003,7182,6665,517,7.2
28,63,Jefferson,2003,2915,2546,369,12.7
28,65,Jefferson Davis,2003,5345,4947,398,7.4
28,67,Jones,2003,28772,27267,1505,5.2
28,69,Kemper,2003,4296,3918,378,8.8
28,71,Lafayette,2003,20313,19211,1102,5.4
28,73,Lamar,2003,20976,20126,850,4.1
28,75,Lauderdale,2003,33630,31388,2242,6.7
28,77,Lawrence,2003,5409,5059,350,6.5
28,79,Leake,2003,9531,8992,539,5.7
28,81,Lee,2003,37834,35620,2214,5.9
28,83,Leflore,2003,14539,13078,1461,10.0
28,85,Lincoln,2003,14442,13568,874,6.1
28,87,Lowndes,2003,25776,23951,1825,7.1
28,89,Madison,2003,41868,40022,1846,4.4
28,91,Marion,2003,10606,9991,615,5.8
28,93,Marshall,2003,15455,14247,1208,7.8
28,95,Monroe,2003,16902,15580,1322,7.8
28,97,Montgomery,2003,4996,4551,445,8.9
28,99,Neshoba,2003,14669,13918,751,5.1
28,101,Newton,2003,9708,9179,529,5.4
28,103,Noxubee,2003,4525,4107,418,9.2
28,105,Oktibbeha,2003,20100,18988,1112,5.5
28,107,Panola,2003,14689,13416,1273,8.7
28,109,Pearl River,2003,21336,20228,1108,5.2
28,111,Perry,2003,5171,4803,368,7.1
28,113,Pike,2003,15140,14180,960,6.3
28,115,Pontotoc,2003,13068,12349,719,5.5
28,117,Prentiss,2003,12118,11378,740,6.1
28,119,Quitman,2003,4164,3824,340,8.2
28,121,Rankin,2003,68298,65575,2723,4.0
28,123,Scott,2003,13085,12394,691,5.3
28,125,Sharkey,2003,2704,2464,240,8.9
28,127,Simpson,2003,11868,11230,638,5.4
28,129,Smith,2003,7363,7017,346,4.7
28,131,Stone,2003,6865,6493,372,5.4
28,133,Sunflower,2003,11483,10448,1035,9.0
28,135,Tallahatchie,2003,6344,5793,551,8.7
28,137,Tate,2003,11726,11034,692,5.9
28,139,Tippah,2003,9241,8524,717,7.8
28,141,Tishomingo,2003,8236,7493,743,9.0
28,143,Tunica,2003,4465,3993,472,10.6
28,145,Union,2003,11729,10982,747,6.4
28,147,Walthall,2003,5864,5464,400,6.8
28,149,Warren,2003,23340,21960,1380,5.9
28,151,Washington,2003,24599,22455,2144,8.7
28,153,Wayne,2003,8637,7959,678,7.8
28,155,Webster,2003,3470,3086,384,11.1
28,157,Wilkinson,2003,3753,3410,343,9.1
28,159,Winston,2003,7839,7230,609,7.8
28,161,Yalobusha,2003,5634,5172,462,8.2
28,163,Yazoo,2003,10810,9986,824,7.6
29,1,Adair,2003,13315,12655,660,5.0
29,3,Andrew,2003,9444,8968,476,5.0
29,5,Atchison,2003,3376,3241,135,4.0
29,7,Audrain,2003,11919,11185,734,6.2
29,9,Barry,2003,17195,16323,872,5.1
29,11,Barton,2003,6609,6281,328,5.0
29,13,Bates,2003,7985,7488,497,6.2
29,15,Benton,2003,8272,7720,552,6.7
29,17,Bollinger,2003,6231,5858,373,6.0
29,19,Boone,2003,82686,79737,2949,3.6
29,21,Buchanan,2003,44040,41473,2567,5.8
29,23,Butler,2003,20670,19492,1178,5.7
29,25,Caldwell,2003,4376,4119,257,5.9
29,27,Callaway,2003,22530,21484,1046,4.6
29,29,Camden,2003,20369,19205,1164,5.7
29,31,Cape Girardeau,2003,39683,37999,1684,4.2
29,33,Carroll,2003,5096,4816,280,5.5
29,35,Carter,2003,2863,2674,189,6.6
29,37,Cass,2003,46445,44019,2426,5.2
29,39,Cedar,2003,6201,5789,412,6.6
29,41,Chariton,2003,4266,4018,248,5.8
29,43,Christian,2003,34306,32609,1697,4.9
29,45,Clark,2003,3634,3369,265,7.3
29,47,Clay,2003,108046,102955,5091,4.7
29,49,Clinton,2003,10129,9582,547,5.4
29,51,Cole,2003,40049,38463,1586,4.0
29,53,Cooper,2003,8723,8311,412,4.7
29,55,Crawford,2003,11706,10944,762,6.5
29,57,Dade,2003,3879,3693,186,4.8
29,59,Dallas,2003,7310,6871,439,6.0
29,61,Daviess,2003,3909,3692,217,5.6
29,63,DeKalb,2003,5159,4836,323,6.3
29,65,Dent,2003,6522,6105,417,6.4
29,67,Douglas,2003,5861,5429,432,7.4
29,69,Dunklin,2003,14846,13719,1127,7.6
29,71,Franklin,2003,51784,48836,2948,5.7
29,73,Gasconade,2003,7652,7175,477,6.2
29,75,Gentry,2003,3339,3188,151,4.5
29,77,Greene,2003,134191,128150,6041,4.5
29,79,Grundy,2003,4970,4664,306,6.2
29,81,Harrison,2003,4373,4146,227,5.2
29,83,Henry,2003,10986,10184,802,7.3
29,85,Hickory,2003,3416,3136,280,8.2
29,87,Holt,2003,2591,2451,140,5.4
29,89,Howard,2003,5337,5113,224,4.2
29,91,Howell,2003,19419,18356,1063,5.5
29,93,Iron,2003,4961,4584,377,7.6
29,95,Jackson,2003,339538,317203,22335,6.6
29,97,Jasper,2003,54456,51541,2915,5.4
29,99,Jefferson,2003,113207,107121,6086,5.4
29,101,Johnson,2003,24798,23622,1176,4.7
29,103,Knox,2003,2138,2041,97,4.5
29,105,Laclede,2003,16695,15298,1397,8.4
29,107,Lafayette,2003,16800,15910,890,5.3
29,109,Lawrence,2003,18463,17553,910,4.9
29,111,Lewis,2003,5589,5276,313,5.6
29,113,Lincoln,2003,23019,21705,1314,5.7
29,115,Linn,2003,7061,6533,528,7.5
29,117,Livingston,2003,7130,6756,374,5.2
29,119,McDonald,2003,11619,11045,574,4.9
29,121,Macon,2003,8278,7841,437,5.3
29,123,Madison,2003,5784,5414,370,6.4
29,125,Maries,2003,4761,4521,240,5.0
29,127,Marion,2003,14538,13698,840,5.8
29,129,Mercer,2003,1744,1642,102,5.8
29,131,Miller,2003,12777,12006,771,6.0
29,133,Mississippi,2003,6171,5721,450,7.3
29,135,Moniteau,2003,7511,7170,341,4.5
29,137,Monroe,2003,4455,4191,264,5.9
29,139,Montgomery,2003,6363,5971,392,6.2
29,141,Morgan,2003,9382,8793,589,6.3
29,143,New Madrid,2003,8784,7930,854,9.7
29,145,Newton,2003,27708,26044,1664,6.0
29,147,Nodaway,2003,12672,12226,446,3.5
29,149,Oregon,2003,4227,3991,236,5.6
29,151,Osage,2003,7439,7066,373,5.0
29,153,Ozark,2003,4471,4205,266,5.9
29,155,Pemiscot,2003,8099,7302,797,9.8
29,157,Perry,2003,10141,9731,410,4.0
29,159,Pettis,2003,20541,19335,1206,5.9
29,161,Phelps,2003,22026,21044,982,4.5
29,163,Pike,2003,8839,8371,468,5.3
29,165,Platte,2003,46142,44118,2024,4.4
29,167,Polk,2003,13602,12877,725,5.3
29,169,Pulaski,2003,17189,16259,930,5.4
29,171,Putnam,2003,2497,2350,147,5.9
29,173,Ralls,2003,5541,5214,327,5.9
29,175,Randolph,2003,12907,12204,703,5.4
29,177,Ray,2003,11841,11173,668,5.6
29,179,Reynolds,2003,2607,2381,226,8.7
29,181,Ripley,2003,6277,5863,414,6.6
29,183,St. Charles,2003,177987,170154,7833,4.4
29,185,St. Clair,2003,4539,4221,318,7.0
29,186,Ste. Genevieve,2003,9524,9031,493,5.2
29,187,St. Francois,2003,27352,25517,1835,6.7
29,189,St. Louis,2003,545377,516346,29031,5.3
29,195,Saline,2003,11972,11330,642,5.4
29,197,Schuyler,2003,2211,2070,141,6.4
29,199,Scotland,2003,2428,2321,107,4.4
29,201,Scott,2003,20728,19547,1181,5.7
29,203,Shannon,2003,4063,3748,315,7.8
29,205,Shelby,2003,3223,3040,183,5.7
29,207,Stoddard,2003,15405,14462,943,6.1
29,209,Stone,2003,15708,14388,1320,8.4
29,211,Sullivan,2003,3309,2967,342,10.3
29,213,Taney,2003,24906,22696,2210,8.9
29,215,Texas,2003,10777,10001,776,7.2
29,217,Vernon,2003,10374,9864,510,4.9
29,219,Warren,2003,14579,13747,832,5.7
29,221,Washington,2003,9963,9131,832,8.4
29,223,Wayne,2003,5730,5295,435,7.6
29,225,Webster,2003,15944,15156,788,4.9
29,227,Worth,2003,1211,1163,48,4.0
29,229,Wright,2003,8011,7503,508,6.3
29,510,St. Louis city,2003,161530,147604,13926,8.6
30,1,Beaverhead,2003,5127,4933,194,3.8
30,3,Big Horn,2003,4914,4344,570,11.6
30,5,Blaine,2003,2742,2611,131,4.8
30,7,Broadwater,2003,2278,2170,108,4.7
30,9,Carbon,2003,5199,4995,204,3.9
30,11,Carter,2003,667,646,21,3.1
30,13,Cascade,2003,38282,36572,1710,4.5
30,15,Chouteau,2003,2500,2415,85,3.4
30,17,Custer,2003,5680,5458,222,3.9
30,19,Daniels,2003,823,786,37,4.5
30,21,Dawson,2003,4288,4140,148,3.5
30,23,Deer Lodge,2003,3864,3613,251,6.5
30,25,Fallon,2003,1542,1494,48,3.1
30,27,Fergus,2003,5748,5457,291,5.1
30,29,Flathead,2003,40485,38081,2404,5.9
30,31,Gallatin,2003,42811,41266,1545,3.6
30,33,Garfield,2003,630,608,22,3.5
30,35,Glacier,2003,5723,5269,454,7.9
30,37,Golden Valley,2003,446,417,29,6.5
30,39,Granite,2003,1284,1210,74,5.8
30,41,Hill,2003,7859,7516,343,4.4
30,43,Jefferson,2003,5414,5180,234,4.3
30,45,Judith Basin,2003,1090,1042,48,4.4
30,47,Lake,2003,11459,10748,711,6.2
30,49,Lewis and Clark,2003,30824,29628,1196,3.9
30,51,Liberty,2003,845,810,35,4.1
30,53,Lincoln,2003,7679,6737,942,12.3
30,55,McCone,2003,991,957,34,3.4
30,57,Madison,2003,3366,3205,161,4.8
30,59,Meagher,2003,912,860,52,5.7
30,61,Mineral,2003,1884,1751,133,7.1
30,63,Missoula,2003,56383,54063,2320,4.1
30,65,Musselshell,2003,2059,1933,126,6.1
30,67,Park,2003,8519,8104,415,4.9
30,69,Petroleum,2003,203,190,13,6.4
30,71,Phillips,2003,2118,2022,96,4.5
30,73,Pondera,2003,2756,2618,138,5.0
30,75,Powder River,2003,887,850,37,4.2
30,77,Powell,2003,2689,2524,165,6.1
30,79,Prairie,2003,538,512,26,4.8
30,81,Ravalli,2003,17796,16754,1042,5.9
30,83,Richland,2003,4643,4431,212,4.6
30,85,Roosevelt,2003,4114,3865,249,6.1
30,87,Rosebud,2003,4298,4060,238,5.5
30,89,Sanders,2003,4534,4201,333,7.3
30,91,Sheridan,2003,1804,1728,76,4.2
30,93,Silver Bow,2003,16939,16062,877,5.2
30,95,Stillwater,2003,4326,4156,170,3.9
30,97,Sweet Grass,2003,2265,2207,58,2.6
30,99,Teton,2003,2932,2815,117,4.0
30,101,Toole,2003,2522,2432,90,3.6
30,103,Treasure,2003,431,415,16,3.7
30,105,Valley,2003,3783,3626,157,4.2
30,107,Wheatland,2003,1014,966,48,4.7
30,109,Wibaux,2003,501,480,21,4.2
30,111,Yellowstone,2003,75101,72322,2779,3.7
31,1,Adams,2003,16841,16151,690,4.1
31,3,Antelope,2003,3996,3865,131,3.3
31,5,Arthur,2003,248,235,13,5.2
31,7,Banner,2003,399,389,10,2.5
31,9,Blaine,2003,296,286,10,3.4
31,11,Boone,2003,3279,3175,104,3.2
31,13,Box Butte,2003,5675,5407,268,4.7
31,15,Boyd,2003,1291,1251,40,3.1
31,17,Brown,2003,1916,1842,74,3.9
31,19,Buffalo,2003,26500,25769,731,2.8
31,21,Burt,2003,4057,3850,207,5.1
31,23,Butler,2003,4704,4503,201,4.3
31,25,Cass,2003,13909,13350,559,4.0
31,27,Cedar,2003,5046,4889,157,3.1
31,29,Chase,2003,2231,2171,60,2.7
31,31,Cherry,2003,3706,3608,98,2.6
31,33,Cheyenne,2003,4960,4798,162,3.3
31,35,Clay,2003,3326,3201,125,3.8
31,37,Colfax,2003,6103,5915,188,3.1
31,39,Cuming,2003,5624,5471,153,2.7
31,41,Custer,2003,6389,6207,182,2.8
31,43,Dakota,2003,10731,10225,506,4.7
31,45,Dawes,2003,4755,4598,157,3.3
31,47,Dawson,2003,12576,12058,518,4.1
31,49,Deuel,2003,1172,1137,35,3.0
31,51,Dixon,2003,3151,3037,114,3.6
31,53,Dodge,2003,19580,18652,928,4.7
31,55,Douglas,2003,263816,251744,12072,4.6
31,57,Dundy,2003,1220,1181,39,3.2
31,59,Fillmore,2003,3461,3332,129,3.7
31,61,Franklin,2003,1977,1914,63,3.2
31,63,Frontier,2003,1819,1768,51,2.8
31,65,Furnas,2003,2569,2483,86,3.3
31,67,Gage,2003,12937,12388,549,4.2
31,69,Garden,2003,1157,1113,44,3.8
31,71,Garfield,2003,1063,1026,37,3.5
31,73,Gosper,2003,1120,1082,38,3.4
31,75,Grant,2003,435,423,12,2.8
31,77,Greeley,2003,1459,1408,51,3.5
31,79,Hall,2003,29507,28214,1293,4.4
31,81,Hamilton,2003,5324,5127,197,3.7
31,83,Harlan,2003,1896,1835,61,3.2
31,85,Hayes,2003,576,555,21,3.6
31,87,Hitchcock,2003,1525,1465,60,3.9
31,89,Holt,2003,6383,6186,197,3.1
31,91,Hooker,2003,419,405,14,3.3
31,93,Howard,2003,3645,3490,155,4.3
31,95,Jefferson,2003,4285,4103,182,4.2
31,97,Johnson,2003,3047,2956,91,3.0
31,99,Kearney,2003,3901,3796,105,2.7
31,101,Keith,2003,5003,4834,169,3.4
31,103,Keya Paha,2003,461,446,15,3.3
31,105,Kimball,2003,2127,2068,59,2.8
31,107,Knox,2003,4988,4816,172,3.4
31,109,Lancaster,2003,154207,148600,5607,3.6
31,111,Lincoln,2003,20520,19796,724,3.5
31,113,Logan,2003,431,419,12,2.8
31,115,Loup,2003,359,345,14,3.9
31,117,McPherson,2003,306,297,9,2.9
31,119,Madison,2003,20490,19668,822,4.0
31,121,Merrick,2003,4282,4108,174,4.1
31,123,Morrill,2003,2840,2729,111,3.9
31,125,Nance,2003,2097,1989,108,5.2
31,127,Nemaha,2003,3573,3421,152,4.3
31,129,Nuckolls,2003,2520,2442,78,3.1
31,131,Otoe,2003,8788,8434,354,4.0
31,133,Pawnee,2003,1675,1607,68,4.1
31,135,Perkins,2003,1669,1626,43,2.6
31,137,Phelps,2003,5396,5231,165,3.1
31,139,Pierce,2003,4338,4186,152,3.5
31,141,Platte,2003,16965,16163,802,4.7
31,143,Polk,2003,3063,2953,110,3.6
31,145,Red Willow,2003,6095,5889,206,3.4
31,147,Richardson,2003,4525,4268,257,5.7
31,149,Rock,2003,1034,995,39,3.8
31,151,Saline,2003,8243,7971,272,3.3
31,153,Sarpy,2003,69854,67623,2231,3.2
31,155,Saunders,2003,11063,10638,425,3.8
31,157,Scotts Bluff,2003,18999,18053,946,5.0
31,159,Seward,2003,9218,8919,299,3.2
31,161,Sheridan,2003,3425,3335,90,2.6
31,163,Sherman,2003,1860,1801,59,3.2
31,165,Sioux,2003,802,778,24,3.0
31,167,Stanton,2003,3765,3642,123,3.3
31,169,Thayer,2003,3023,2929,94,3.1
31,171,Thomas,2003,423,405,18,4.3
31,173,Thurston,2003,2919,2700,219,7.5
31,175,Valley,2003,2608,2520,88,3.4
31,177,Washington,2003,11141,10796,345,3.1
31,179,Wayne,2003,5491,5334,157,2.9
31,181,Webster,2003,2053,1979,74,3.6
31,183,Wheeler,2003,500,486,14,2.8
31,185,York,2003,7907,7644,263,3.3
32,1,Churchill,2003,12196,11618,578,4.7
32,3,Clark,2003,803599,760249,43350,5.4
32,5,Douglas,2003,22133,21015,1118,5.1
32,7,Elko,2003,22859,21801,1058,4.6
32,9,Esmeralda,2003,469,448,21,4.5
32,11,Eureka,2003,707,668,39,5.5
32,13,Humboldt,2003,7426,7054,372,5.0
32,15,Lander,2003,2462,2332,130,5.3
32,17,Lincoln,2003,1600,1513,87,5.4
32,19,Lyon,2003,20006,18870,1136,5.7
32,21,Mineral,2003,2144,2018,126,5.9
32,23,Nye,2003,15023,13893,1130,7.5
32,27,Pershing,2003,2536,2406,130,5.1
32,29,Storey,2003,1996,1926,70,3.5
32,31,Washoe,2003,204198,194788,9410,4.6
32,33,White Pine,2003,3700,3548,152,4.1
32,510,Carson City,2003,27326,25747,1579,5.8
33,1,Belknap,2003,31598,30335,1263,4.0
33,3,Carroll,2003,24442,23551,891,3.6
33,5,Cheshire,2003,40159,38693,1466,3.7
33,7,Coos,2003,16547,15663,884,5.3
33,9,Grafton,2003,45739,44317,1422,3.1
33,11,Hillsborough,2003,220120,209761,10359,4.7
33,13,Merrimack,2003,77470,74642,2828,3.7
33,15,Rockingham,2003,166800,157780,9020,5.4
33,17,Strafford,2003,65020,62362,2658,4.1
33,19,Sullivan,2003,21029,20279,750,3.6
34,1,Atlantic,2003,132206,124003,8203,6.2
34,3,Bergen,2003,463055,439659,23396,5.1
34,5,Burlington,2003,230559,219483,11076,4.8
34,7,Camden,2003,256440,240998,15442,6.0
34,9,Cape May,2003,55690,51220,4470,8.0
34,11,Cumberland,2003,66543,61311,5232,7.9
34,13,Essex,2003,367482,340893,26589,7.2
34,15,Gloucester,2003,140858,133283,7575,5.4
34,17,Hudson,2003,290871,269517,21354,7.3
34,19,Hunterdon,2003,70253,67256,2997,4.3
34,21,Mercer,2003,186747,177133,9614,5.1
34,23,Middlesex,2003,409298,386772,22526,5.5
34,25,Monmouth,2003,322349,304929,17420,5.4
34,27,Morris,2003,264898,252815,12083,4.6
34,29,Ocean,2003,243897,229715,14182,5.8
34,31,Passaic,2003,235648,218458,17190,7.3
34,33,Salem,2003,30289,28475,1814,6.0
34,35,Somerset,2003,170429,162611,7818,4.6
34,37,Sussex,2003,82345,78091,4254,5.2
34,39,Union,2003,266901,250102,16799,6.3
34,41,Warren,2003,57629,54742,2887,5.0
35,1,Bernalillo,2003,293318,277854,15464,5.3
35,3,Catron,2003,1471,1360,111,7.5
35,5,Chaves,2003,25586,23701,1885,7.4
35,6,Cibola,2003,11725,10990,735,6.3
35,7,Colfax,2003,7088,6643,445,6.3
35,9,Curry,2003,19786,18900,886,4.5
35,11,De Baca,2003,896,824,72,8.0
35,13,Dona Ana,2003,81055,75784,5271,6.5
35,15,Eddy,2003,23948,22515,1433,6.0
35,17,Grant,2003,11812,10601,1211,10.3
35,19,Guadalupe,2003,1652,1523,129,7.8
35,21,Harding,2003,432,409,23,5.3
35,23,Hidalgo,2003,2365,2244,121,5.1
35,25,Lea,2003,23716,22466,1250,5.3
35,27,Lincoln,2003,10750,10286,464,4.3
35,28,Los Alamos,2003,11209,10907,302,2.7
35,29,Luna,2003,11998,10079,1919,16.0
35,31,McKinley,2003,26167,24358,1809,6.9
35,33,Mora,2003,2091,1865,226,10.8
35,35,Otero,2003,25202,23666,1536,6.1
35,37,Quay,2003,3931,3671,260,6.6
35,39,Rio Arriba,2003,20054,18710,1344,6.7
35,41,Roosevelt,2003,9281,8910,371,4.0
35,43,Sandoval,2003,46358,43534,2824,6.1
35,45,San Juan,2003,51171,47710,3461,6.8
35,47,San Miguel,2003,13472,12619,853,6.3
35,49,Santa Fe,2003,73112,69944,3168,4.3
35,51,Sierra,2003,5279,4986,293,5.6
35,53,Socorro,2003,8667,8229,438,5.1
35,55,Taos,2003,17069,15821,1248,7.3
35,57,Torrance,2003,7411,6994,417,5.6
35,59,Union,2003,1988,1911,77,3.9
35,61,Valencia,2003,30194,28379,1815,6.0
36,1,Albany,2003,157732,150958,6774,4.3
36,3,Allegany,2003,23390,21846,1544,6.6
36,5,Bronx,2003,500787,448262,52525,10.5
36,7,Broome,2003,96673,90994,5679,5.9
36,9,Cattaraugus,2003,42135,39662,2473,5.9
36,11,Cayuga,2003,41361,39158,2203,5.3
36,13,Chautauqua,2003,66701,62809,3892,5.8
36,15,Chemung,2003,41172,38490,2682,6.5
36,17,Chenango,2003,24207,22784,1423,5.9
36,19,Clinton,2003,39859,37424,2435,6.1
36,21,Columbia,2003,31312,29927,1385,4.4
36,23,Cortland,2003,24363,22915,1448,5.9
36,25,Delaware,2003,22996,21874,1122,4.9
36,27,Dutchess,2003,143587,137600,5987,4.2
36,29,Erie,2003,469867,442607,27260,5.8
36,31,Essex,2003,18337,17361,976,5.3
36,33,Franklin,2003,22389,20883,1506,6.7
36,35,Fulton,2003,26498,24962,1536,5.8
36,37,Genesee,2003,33135,31295,1840,5.6
36,39,Greene,2003,23712,22483,1229,5.2
36,41,Hamilton,2003,2950,2789,161,5.5
36,43,Herkimer,2003,31351,29547,1804,5.8
36,45,Jefferson,2003,45934,42769,3165,6.9
36,47,Kings,2003,1048274,954093,94181,9.0
36,49,Lewis,2003,12430,11621,809,6.5
36,51,Livingston,2003,32647,30660,1987,6.1
36,53,Madison,2003,35498,33496,2002,5.6
36,55,Monroe,2003,373814,353057,20757,5.6
36,57,Montgomery,2003,23996,22440,1556,6.5
36,59,Nassau,2003,680896,648898,31998,4.7
36,61,New York,2003,873048,808166,64882,7.4
36,63,Niagara,2003,111276,103841,7435,6.7
36,65,Oneida,2003,110604,104536,6068,5.5
36,67,Onondaga,2003,231018,219136,11882,5.1
36,69,Ontario,2003,55092,52204,2888,5.2
36,71,Orange,2003,172134,163934,8200,4.8
36,73,Orleans,2003,19914,18513,1401,7.0
36,75,Oswego,2003,59867,55430,4437,7.4
36,77,Otsego,2003,31003,29481,1522,4.9
36,79,Putnam,2003,54327,52112,2215,4.1
36,81,Queens,2003,1061961,984158,77803,7.3
36,83,Rensselaer,2003,82044,78201,3843,4.7
36,85,Richmond,2003,223330,206786,16544,7.4
36,87,Rockland,2003,148295,141277,7018,4.7
36,89,St. Lawrence,2003,49296,45784,3512,7.1
36,91,Saratoga,2003,116191,111520,4671,4.0
36,93,Schenectady,2003,73727,70367,3360,4.6
36,95,Schoharie,2003,15455,14621,834,5.4
36,97,Schuyler,2003,9778,9139,639,6.5
36,99,Seneca,2003,17168,16227,941,5.5
36,101,Steuben,2003,44916,41587,3329,7.4
36,103,Suffolk,2003,760406,723488,36918,4.9
36,105,Sullivan,2003,34368,32545,1823,5.3
36,107,Tioga,2003,26304,24803,1501,5.7
36,109,Tompkins,2003,53241,51117,2124,4.0
36,111,Ulster,2003,91329,87108,4221,4.6
36,113,Warren,2003,34456,32677,1779,5.2
36,115,Washington,2003,30940,29514,1426,4.6
36,117,Wayne,2003,48678,45751,2927,6.0
36,119,Westchester,2003,471683,450228,21455,4.5
36,121,Wyoming,2003,21081,19790,1291,6.1
36,123,Yates,2003,12876,12250,626,4.9
37,1,Alamance,2003,70642,65336,5306,7.5
37,3,Alexander,2003,18715,17325,1390,7.4
37,5,Alleghany,2003,4951,4473,478,9.7
37,7,Anson,2003,11081,9977,1104,10.0
37,9,Ashe,2003,12969,12060,909,7.0
37,11,Avery,2003,8107,7614,493,6.1
37,13,Beaufort,2003,20296,18478,1818,9.0
37,15,Bertie,2003,8552,7896,656,7.7
37,17,Bladen,2003,15176,13844,1332,8.8
37,19,Brunswick,2003,39520,36874,2646,6.7
37,21,Buncombe,2003,114178,108514,5664,5.0
37,23,Burke,2003,43379,39852,3527,8.1
37,25,Cabarrus,2003,78332,72345,5987,7.6
37,27,Caldwell,2003,40931,37301,3630,8.9
37,29,Camden,2003,3904,3737,167,4.3
37,31,Carteret,2003,31507,29755,1752,5.6
37,33,Caswell,2003,10962,9961,1001,9.1
37,35,Catawba,2003,78348,71872,6476,8.3
37,37,Chatham,2003,29687,28091,1596,5.4
37,39,Cherokee,2003,9921,9073,848,8.5
37,41,Chowan,2003,6892,6515,377,5.5
37,43,Clay,2003,4223,4009,214,5.1
37,45,Cleveland,2003,48529,44162,4367,9.0
37,47,Columbus,2003,23672,21722,1950,8.2
37,49,Craven,2003,40362,37950,2412,6.0
37,51,Cumberland,2003,123540,115487,8053,6.5
37,53,Currituck,2003,10793,10431,362,3.4
37,55,Dare,2003,21959,20795,1164,5.3
37,57,Davidson,2003,79967,73959,6008,7.5
37,59,Davie,2003,19498,18255,1243,6.4
37,61,Duplin,2003,24543,22807,1736,7.1
37,63,Durham,2003,127982,120543,7439,5.8
37,65,Edgecombe,2003,25315,22708,2607,10.3
37,67,Forsyth,2003,167425,157709,9716,5.8
37,69,Franklin,2003,25743,24069,1674,6.5
37,71,Gaston,2003,99264,91733,7531,7.6
37,73,Gates,2003,4867,4656,211,4.3
37,75,Graham,2003,3909,3569,340,8.7
37,77,Granville,2003,24534,22547,1987,8.1
37,79,Greene,2003,8960,8333,627,7.0
37,81,Guilford,2003,240400,224979,15421,6.4
37,83,Halifax,2003,23536,21433,2103,8.9
37,85,Harnett,2003,44144,41130,3014,6.8
37,87,Haywood,2003,27349,25835,1514,5.5
37,89,Henderson,2003,45648,43313,2335,5.1
37,91,Hertford,2003,9793,9169,624,6.4
37,93,Hoke,2003,16353,15077,1276,7.8
37,95,Hyde,2003,2870,2647,223,7.8
37,97,Iredell,2003,69804,65076,4728,6.8
37,99,Jackson,2003,19920,18903,1017,5.1
37,101,Johnston,2003,68039,64237,3802,5.6
37,103,Jones,2003,4763,4484,279,5.9
37,105,Lee,2003,25531,23609,1922,7.5
37,107,Lenoir,2003,27384,25259,2125,7.8
37,109,Lincoln,2003,36277,33625,2652,7.3
37,111,McDowell,2003,21847,20193,1654,7.6
37,113,Macon,2003,15501,14700,801,5.2
37,115,Madison,2003,9759,9227,532,5.5
37,117,Martin,2003,12314,11394,920,7.5
37,119,Mecklenburg,2003,420795,395312,25483,6.1
37,121,Mitchell,2003,7770,7133,637,8.2
37,123,Montgomery,2003,12644,11474,1170,9.3
37,125,Moore,2003,35783,33367,2416,6.8
37,127,Nash,2003,44688,41333,3355,7.5
37,129,New Hanover,2003,92677,87183,5494,5.9
37,131,Northampton,2003,8921,8179,742,8.3
37,133,Onslow,2003,54242,50577,3665,6.8
37,135,Orange,2003,64718,61822,2896,4.5
37,137,Pamlico,2003,5609,5286,323,5.8
37,139,Pasquotank,2003,16539,15653,886,5.4
37,141,Pender,2003,20848,19402,1446,6.9
37,143,Perquimans,2003,5044,4776,268,5.3
37,145,Person,2003,18781,17273,1508,8.0
37,147,Pitt,2003,72114,67230,4884,6.8
37,149,Polk,2003,8971,8524,447,5.0
37,151,Randolph,2003,74734,69882,4852,6.5
37,153,Richmond,2003,20619,18508,2111,10.2
37,155,Robeson,2003,52820,48121,4699,8.9
37,157,Rockingham,2003,47328,42946,4382,9.3
37,159,Rowan,2003,68223,62808,5415,7.9
37,161,Rutherford,2003,31746,28909,2837,8.9
37,163,Sampson,2003,31373,29488,1885,6.0
37,165,Scotland,2003,16390,14439,1951,11.9
37,167,Stanly,2003,29942,27677,2265,7.6
37,169,Stokes,2003,24204,22672,1532,6.3
37,171,Surry,2003,36479,33579,2900,7.9
37,173,Swain,2003,6796,6233,563,8.3
37,175,Transylvania,2003,12781,11608,1173,9.2
37,177,Tyrrell,2003,2161,1962,199,9.2
37,179,Union,2003,76864,72689,4175,5.4
37,181,Vance,2003,20136,17881,2255,11.2
37,183,Wake,2003,388096,366611,21485,5.5
37,185,Warren,2003,8259,7543,716,8.7
37,187,Washington,2003,6237,5715,522,8.4
37,189,Watauga,2003,22873,21822,1051,4.6
37,191,Wayne,2003,51944,48615,3329,6.4
37,193,Wilkes,2003,33890,31286,2604,7.7
37,195,Wilson,2003,39298,35957,3341,8.5
37,197,Yadkin,2003,19557,18305,1252,6.4
37,199,Yancey,2003,8147,7548,599,7.4
38,1,Adams,2003,1264,1228,36,2.8
38,3,Barnes,2003,6101,5902,199,3.3
38,5,Benson,2003,2742,2600,142,5.2
38,7,Billings,2003,503,489,14,2.8
38,9,Bottineau,2003,3568,3409,159,4.5
38,11,Bowman,2003,1770,1732,38,2.1
38,13,Burke,2003,1027,995,32,3.1
38,15,Burleigh,2003,42055,40856,1199,2.9
38,17,Cass,2003,78058,75916,2142,2.7
38,19,Cavalier,2003,2254,2176,78,3.5
38,21,Dickey,2003,2864,2780,84,2.9
38,23,Divide,2003,1088,1053,35,3.2
38,25,Dunn,2003,1808,1745,63,3.5
38,27,Eddy,2003,1386,1319,67,4.8
38,29,Emmons,2003,2025,1916,109,5.4
38,31,Foster,2003,1794,1734,60,3.3
38,33,Golden Valley,2003,960,939,21,2.2
38,35,Grand Forks,2003,36483,35321,1162,3.2
38,37,Grant,2003,1322,1271,51,3.9
38,39,Griggs,2003,1372,1334,38,2.8
38,41,Hettinger,2003,1260,1214,46,3.7
38,43,Kidder,2003,1250,1180,70,5.6
38,45,LaMoure,2003,2344,2265,79,3.4
38,47,Logan,2003,984,951,33,3.4
38,49,McHenry,2003,2827,2651,176,6.2
38,51,McIntosh,2003,1519,1473,46,3.0
38,53,McKenzie,2003,2732,2634,98,3.6
38,55,McLean,2003,4533,4282,251,5.5
38,57,Mercer,2003,4722,4512,210,4.4
38,59,Morton,2003,14012,13503,509,3.6
38,61,Mountrail,2003,2997,2846,151,5.0
38,63,Nelson,2003,1763,1695,68,3.9
38,65,Oliver,2003,1199,1154,45,3.8
38,67,Pembina,2003,4292,4015,277,6.5
38,69,Pierce,2003,1977,1878,99,5.0
38,71,Ramsey,2003,6046,5808,238,3.9
38,73,Ransom,2003,2988,2902,86,2.9
38,75,Renville,2003,1301,1264,37,2.8
38,77,Richland,2003,9373,9053,320,3.4
38,79,Rolette,2003,5345,4802,543,10.2
38,81,Sargent,2003,2185,2126,59,2.7
38,83,Sheridan,2003,767,728,39,5.1
38,85,Sioux,2003,1350,1283,67,5.0
38,87,Slope,2003,492,479,13,2.6
38,89,Stark,2003,12923,12517,406,3.1
38,91,Steele,2003,1154,1129,25,2.2
38,93,Stutsman,2003,11539,11141,398,3.4
38,95,Towner,2003,1345,1296,49,3.6
38,97,Traill,2003,4160,4018,142,3.4
38,99,Walsh,2003,6072,5831,241,4.0
38,101,Ward,2003,27921,26891,1030,3.7
38,103,Wells,2003,2300,2196,104,4.5
38,105,Williams,2003,10991,10666,325,3.0
39,1,Adams,2003,12558,11302,1256,10.0
39,3,Allen,2003,52382,48753,3629,6.9
39,5,Ashland,2003,27028,25127,1901,7.0
39,7,Ashtabula,2003,50163,46140,4023,8.0
39,9,Athens,2003,29536,27570,1966,6.7
39,11,Auglaize,2003,25182,23850,1332,5.3
39,13,Belmont,2003,31663,29464,2199,6.9
39,15,Brown,2003,21632,20044,1588,7.3
39,17,Butler,2003,180613,170635,9978,5.5
39,19,Carroll,2003,14381,13238,1143,7.9
39,21,Champaign,2003,20540,19149,1391,6.8
39,23,Clark,2003,71180,65867,5313,7.5
39,25,Clermont,2003,100663,94939,5724,5.7
39,27,Clinton,2003,21868,20602,1266,5.8
39,29,Columbiana,2003,54403,50215,4188,7.7
39,31,Coshocton,2003,17841,16500,1341,7.5
39,33,Crawford,2003,23013,21199,1814,7.9
39,35,Cuyahoga,2003,679752,641853,37899,5.6
39,37,Darke,2003,28677,26754,1923,6.7
39,39,Defiance,2003,20574,19268,1306,6.3
39,41,Delaware,2003,75357,72018,3339,4.4
39,43,Erie,2003,43010,40311,2699,6.3
39,45,Fairfield,2003,70189,66282,3907,5.6
39,47,Fayette,2003,15608,14706,902,5.8
39,49,Franklin,2003,599646,566668,32978,5.5
39,51,Fulton,2003,22615,21087,1528,6.8
39,53,Gallia,2003,14153,12938,1215,8.6
39,55,Geauga,2003,50608,48369,2239,4.4
39,57,Greene,2003,76959,72587,4372,5.7
39,59,Guernsey,2003,19955,18411,1544,7.7
39,61,Hamilton,2003,423281,399591,23690,5.6
39,63,Hancock,2003,38722,36654,2068,5.3
39,65,Hardin,2003,15523,14535,988,6.4
39,67,Harrison,2003,7371,6799,572,7.8
39,69,Henry,2003,15931,14853,1078,6.8
39,71,Highland,2003,20244,18921,1323,6.5
39,73,Hocking,2003,13514,12515,999,7.4
39,75,Holmes,2003,18300,17532,768,4.2
39,77,Huron,2003,30185,27789,2396,7.9
39,79,Jackson,2003,15051,13762,1289,8.6
39,81,Jefferson,2003,32491,30051,2440,7.5
39,83,Knox,2003,28406,26577,1829,6.4
39,85,Lake,2003,131544,124877,6667,5.1
39,87,Lawrence,2003,28079,26167,1912,6.8
39,89,Licking,2003,79820,74863,4957,6.2
39,91,Logan,2003,24370,23026,1344,5.5
39,93,Lorain,2003,152381,143882,8499,5.6
39,95,Lucas,2003,225172,207884,17288,7.7
39,97,Madison,2003,19506,18377,1129,5.8
39,99,Mahoning,2003,118206,109147,9059,7.7
39,101,Marion,2003,31779,29744,2035,6.4
39,103,Medina,2003,90452,86260,4192,4.6
39,105,Meigs,2003,9170,8117,1053,11.5
39,107,Mercer,2003,22134,21087,1047,4.7
39,109,Miami,2003,54412,51080,3332,6.1
39,111,Monroe,2003,6064,5547,517,8.5
39,113,Montgomery,2003,275614,257314,18300,6.6
39,115,Morgan,2003,6514,5845,669,10.3
39,117,Morrow,2003,17339,16231,1108,6.4
39,119,Muskingum,2003,41764,38573,3191,7.6
39,121,Noble,2003,5847,5328,519,8.9
39,123,Ottawa,2003,21445,19655,1790,8.3
39,125,Paulding,2003,10419,9743,676,6.5
39,127,Perry,2003,16611,15258,1353,8.1
39,129,Pickaway,2003,23474,21870,1604,6.8
39,131,Pike,2003,11401,10201,1200,10.5
39,133,Portage,2003,86582,81399,5183,6.0
39,135,Preble,2003,21914,20546,1368,6.2
39,137,Putnam,2003,17978,16796,1182,6.6
39,139,Richland,2003,64001,59251,4750,7.4
39,141,Ross,2003,34291,31603,2688,7.8
39,143,Sandusky,2003,32967,30754,2213,6.7
39,145,Scioto,2003,32541,29628,2913,9.0
39,147,Seneca,2003,30883,28834,2049,6.6
39,149,Shelby,2003,26543,25037,1506,5.7
39,151,Stark,2003,191131,177846,13285,7.0
39,153,Summit,2003,283735,265728,18007,6.3
39,155,Trumbull,2003,106645,98393,8252,7.7
39,157,Tuscarawas,2003,47610,44561,3049,6.4
39,159,Union,2003,23368,22228,1140,4.9
39,161,Van Wert,2003,14702,13782,920,6.3
39,163,Vinton,2003,5610,5079,531,9.5
39,165,Warren,2003,95695,90801,4894,5.1
39,167,Washington,2003,33219,31103,2116,6.4
39,169,Wayne,2003,59999,56849,3150,5.3
39,171,Williams,2003,19792,18406,1386,7.0
39,173,Wood,2003,66137,62216,3921,5.9
39,175,Wyandot,2003,13371,12620,751,5.6
40,1,Adair,2003,9792,9038,754,7.7
40,3,Alfalfa,2003,2566,2466,100,3.9
40,5,Atoka,2003,5652,5258,394,7.0
40,7,Beaver,2003,3018,2904,114,3.8
40,9,Beckham,2003,9247,8909,338,3.7
40,11,Blaine,2003,4789,4560,229,4.8
40,13,Bryan,2003,18040,17226,814,4.5
40,15,Caddo,2003,12484,11830,654,5.2
40,17,Canadian,2003,48489,46261,2228,4.6
40,19,Carter,2003,22845,21771,1074,4.7
40,21,Cherokee,2003,20076,19026,1050,5.2
40,23,Choctaw,2003,6462,5973,489,7.6
40,25,Cimarron,2003,1538,1483,55,3.6
40,27,Cleveland,2003,114999,110299,4700,4.1
40,29,Coal,2003,2482,2186,296,11.9
40,31,Comanche,2003,45168,43271,1897,4.2
40,33,Cotton,2003,3075,2940,135,4.4
40,35,Craig,2003,6684,6316,368,5.5
40,37,Creek,2003,32037,29934,2103,6.6
40,39,Custer,2003,13115,12648,467,3.6
40,41,Delaware,2003,16824,15884,940,5.6
40,43,Dewey,2003,2447,2360,87,3.6
40,45,Ellis,2003,2214,2150,64,2.9
40,47,Garfield,2003,27463,26348,1115,4.1
40,49,Garvin,2003,13156,12524,632,4.8
40,51,Grady,2003,22454,21399,1055,4.7
40,53,Grant,2003,2619,2524,95,3.6
40,55,Greer,2003,2306,2153,153,6.6
40,57,Harmon,2003,1440,1384,56,3.9
40,59,Harper,2003,1985,1916,69,3.5
40,61,Haskell,2003,5617,5255,362,6.4
40,63,Hughes,2003,5364,4870,494,9.2
40,65,Jackson,2003,12641,12180,461,3.6
40,67,Jefferson,2003,2484,2330,154,6.2
40,69,Johnston,2003,4891,4638,253,5.2
40,71,Kay,2003,21966,20512,1454,6.6
40,73,Kingfisher,2003,7397,7156,241,3.3
40,75,Kiowa,2003,4481,4268,213,4.8
40,77,Latimer,2003,4086,3819,267,6.5
40,79,Le Flore,2003,21365,19990,1375,6.4
40,81,Lincoln,2003,14752,13980,772,5.2
40,83,Logan,2003,17509,16770,739,4.2
40,85,Love,2003,4599,4377,222,4.8
40,87,McClain,2003,14049,13394,655,4.7
40,89,McCurtain,2003,14740,13439,1301,8.8
40,91,McIntosh,2003,8246,7636,610,7.4
40,93,Major,2003,3845,3712,133,3.5
40,95,Marshall,2003,5928,5643,285,4.8
40,97,Mayes,2003,16495,15281,1214,7.4
40,99,Murray,2003,6055,5749,306,5.1
40,101,Muskogee,2003,28933,26900,2033,7.0
40,103,Noble,2003,5291,5066,225,4.3
40,105,Nowata,2003,4938,4640,298,6.0
40,107,Okfuskee,2003,4659,4283,376,8.1
40,109,Oklahoma,2003,330770,313004,17766,5.4
40,111,Okmulgee,2003,16878,15599,1279,7.6
40,113,Osage,2003,20691,19444,1247,6.0
40,115,Ottawa,2003,15122,14031,1091,7.2
40,117,Pawnee,2003,7855,7334,521,6.6
40,119,Payne,2003,34831,33433,1398,4.0
40,121,Pittsburg,2003,19495,18277,1218,6.2
40,123,Pontotoc,2003,17904,17024,880,4.9
40,125,Pottawatomie,2003,30104,28410,1694,5.6
40,127,Pushmataha,2003,5236,4859,377,7.2
40,129,Roger Mills,2003,1950,1899,51,2.6
40,131,Rogers,2003,38322,36194,2128,5.6
40,133,Seminole,2003,10601,9676,925,8.7
40,135,Sequoyah,2003,17882,16714,1168,6.5
40,137,Stephens,2003,19641,18667,974,5.0
40,139,Texas,2003,10455,10100,355,3.4
40,141,Tillman,2003,3767,3599,168,4.5
40,143,Tulsa,2003,293993,277182,16811,5.7
40,145,Wagoner,2003,30834,29185,1649,5.3
40,147,Washington,2003,24039,22808,1231,5.1
40,149,Washita,2003,5880,5667,213,3.6
40,151,Woods,2003,4740,4301,439,9.3
40,153,Woodward,2003,9594,9181,413,4.3
41,1,Baker,2003,7320,6636,684,9.3
41,3,Benton,2003,42247,39832,2415,5.7
41,5,Clackamas,2003,188991,174995,13996,7.4
41,7,Clatsop,2003,18458,17095,1363,7.4
41,9,Columbia,2003,23179,20809,2370,10.2
41,11,Coos,2003,27929,25398,2531,9.1
41,13,Crook,2003,8840,7999,841,9.5
41,15,Curry,2003,9248,8481,767,8.3
41,17,Deschutes,2003,68289,63046,5243,7.7
41,19,Douglas,2003,47663,43032,4631,9.7
41,21,Gilliam,2003,1042,972,70,6.7
41,23,Grant,2003,3798,3408,390,10.3
41,25,Harney,2003,3520,3141,379,10.8
41,27,Hood River,2003,12175,11148,1027,8.4
41,29,Jackson,2003,96685,89347,7338,7.6
41,31,Jefferson,2003,8823,8210,613,6.9
41,33,Josephine,2003,33490,30510,2980,8.9
41,35,Klamath,2003,29892,27010,2882,9.6
41,37,Lake,2003,3605,3263,342,9.5
41,39,Lane,2003,172513,158875,13638,7.9
41,41,Lincoln,2003,21695,19773,1922,8.9
41,43,Linn,2003,52504,47281,5223,9.9
41,45,Malheur,2003,13252,11973,1279,9.7
41,47,Marion,2003,148556,136878,11678,7.9
41,49,Morrow,2003,5755,5293,462,8.0
41,51,Multnomah,2003,373670,342527,31143,8.3
41,53,Polk,2003,34285,31973,2312,6.7
41,55,Sherman,2003,946,846,100,10.6
41,57,Tillamook,2003,12078,11197,881,7.3
41,59,Umatilla,2003,37745,34690,3055,8.1
41,61,Union,2003,12317,11425,892,7.2
41,63,Wallowa,2003,3615,3267,348,9.6
41,65,Wasco,2003,12836,11608,1228,9.6
41,67,Washington,2003,264805,245563,19242,7.3
41,69,Wheeler,2003,735,679,56,7.6
41,71,Yamhill,2003,43827,40302,3525,8.0
42,1,Adams,2003,51371,49216,2155,4.2
42,3,Allegheny,2003,636847,601473,35374,5.6
42,5,Armstrong,2003,33309,31037,2272,6.8
42,7,Beaver,2003,89736,84174,5562,6.2
42,9,Bedford,2003,23683,21710,1973,8.3
42,11,Berks,2003,192722,181249,11473,6.0
42,13,Blair,2003,64031,60547,3484,5.4
42,15,Bradford,2003,31426,29746,1680,5.3
42,17,Bucks,2003,336169,320352,15817,4.7
42,19,Butler,2003,93428,88168,5260,5.6
42,21,Cambria,2003,66610,61945,4665,7.0
42,23,Cameron,2003,2602,2408,194,7.5
42,25,Carbon,2003,29825,27631,2194,7.4
42,27,Centre,2003,70593,67508,3085,4.4
42,29,Chester,2003,246928,236739,10189,4.1
42,31,Clarion,2003,19708,18577,1131,5.7
42,33,Clearfield,2003,40921,37958,2963,7.2
42,35,Clinton,2003,18592,17255,1337,7.2
42,37,Columbia,2003,32621,30428,2193,6.7
42,39,Crawford,2003,41568,38711,2857,6.9
42,41,Cumberland,2003,117051,112165,4886,4.2
42,43,Dauphin,2003,132924,126358,6566,4.9
42,45,Delaware,2003,278268,263856,14412,5.2
42,47,Elk,2003,17206,16090,1116,6.5
42,49,Erie,2003,137906,128777,9129,6.6
42,51,Fayette,2003,65087,60085,5002,7.7
42,53,Forest,2003,2231,1910,321,14.4
42,55,Franklin,2003,70500,67445,3055,4.3
42,57,Fulton,2003,7121,6694,427,6.0
42,59,Greene,2003,16905,15765,1140,6.7
42,61,Huntingdon,2003,21205,19570,1635,7.7
42,63,Indiana,2003,43245,40585,2660,6.2
42,65,Jefferson,2003,21758,20395,1363,6.3
42,67,Juniata,2003,12148,11534,614,5.1
42,69,Lackawanna,2003,103647,97526,6121,5.9
42,71,Lancaster,2003,257311,246646,10665,4.1
42,73,Lawrence,2003,43901,41176,2725,6.2
42,75,Lebanon,2003,66730,63873,2857,4.3
42,77,Lehigh,2003,167294,157777,9517,5.7
42,79,Luzerne,2003,155016,144966,10050,6.5
42,81,Lycoming,2003,58885,55331,3554,6.0
42,83,McKean,2003,21553,20235,1318,6.1
42,85,Mercer,2003,55586,52138,3448,6.2
42,87,Mifflin,2003,22052,20557,1495,6.8
42,89,Monroe,2003,74144,69745,4399,5.9
42,91,Montgomery,2003,419628,400447,19181,4.6
42,93,Montour,2003,8601,8195,406,4.7
42,95,Northampton,2003,143562,135600,7962,5.5
42,97,Northumberland,2003,44971,41894,3077,6.8
42,99,Perry,2003,23808,22597,1211,5.1
42,101,Philadelphia/city,2003,623937,576950,46987,7.5
42,103,Pike,2003,24113,22709,1404,5.8
42,105,Potter,2003,8452,7825,627,7.4
42,107,Schuylkill,2003,69324,64403,4921,7.1
42,109,Snyder,2003,19138,18195,943,4.9
42,111,Somerset,2003,38568,35956,2612,6.8
42,113,Sullivan,2003,3042,2857,185,6.1
42,115,Susquehanna,2003,20657,19407,1250,6.1
42,117,Tioga,2003,20283,19010,1273,6.3
42,119,Union,2003,17340,16379,961,5.5
42,121,Venango,2003,26085,24493,1592,6.1
42,123,Warren,2003,21254,19922,1332,6.3
42,125,Washington,2003,101096,94919,6177,6.1
42,127,Wayne,2003,23575,22369,1206,5.1
42,129,Westmoreland,2003,184087,173025,11062,6.0
42,131,Wyoming,2003,14001,13158,843,6.0
42,133,York,2003,210048,199760,10288,4.9
44,1,Bristol,2003,27642,26323,1319,4.8
44,3,Kent,2003,95467,90510,4957,5.2
44,5,Newport,2003,45074,42866,2208,4.9
44,7,Providence,2003,320787,301125,19662,6.1
44,9,Washington,2003,71816,68758,3058,4.3
45,1,Abbeville,2003,11833,10712,1121,9.5
45,3,Aiken,2003,71277,67304,3973,5.6
45,5,Allendale,2003,3419,3107,312,9.1
45,7,Anderson,2003,81961,75688,6273,7.7
45,9,Bamberg,2003,6554,6017,537,8.2
45,11,Barnwell,2003,9623,8657,966,10.0
45,13,Beaufort,2003,56165,53291,2874,5.1
45,15,Berkeley,2003,67921,63971,3950,5.8
45,17,Calhoun,2003,7061,6546,515,7.3
45,19,Charleston,2003,159223,150210,9013,5.7
45,21,Cherokee,2003,24491,22227,2264,9.2
45,23,Chester,2003,15792,13950,1842,11.7
45,25,Chesterfield,2003,18854,16864,1990,10.6
45,27,Clarendon,2003,12842,11657,1185,9.2
45,29,Colleton,2003,16211,14956,1255,7.7
45,31,Darlington,2003,31391,28656,2735,8.7
45,33,Dillon,2003,13294,11962,1332,10.0
45,35,Dorchester,2003,51239,48444,2795,5.5
45,37,Edgefield,2003,10601,10036,565,5.3
45,39,Fairfield,2003,11437,10151,1286,11.2
45,41,Florence,2003,61310,56227,5083,8.3
45,43,Georgetown,2003,27172,24315,2857,10.5
45,45,Greenville,2003,201343,189461,11882,5.9
45,47,Greenwood,2003,32023,28838,3185,9.9
45,49,Hampton,2003,8071,7268,803,9.9
45,51,Horry,2003,112116,105267,6849,6.1
45,53,Jasper,2003,9645,9037,608,6.3
45,55,Kershaw,2003,27595,25717,1878,6.8
45,57,Lancaster,2003,29567,26749,2818,9.5
45,59,Laurens,2003,33125,30463,2662,8.0
45,61,Lee,2003,8324,7576,748,9.0
45,63,Lexington,2003,120899,114987,5912,4.9
45,65,McCormick,2003,3659,3171,488,13.3
45,67,Marion,2003,14389,12417,1972,13.7
45,69,Marlboro,2003,12729,10977,1752,13.8
45,71,Newberry,2003,17815,16398,1417,8.0
45,73,Oconee,2003,32023,29449,2574,8.0
45,75,Orangeburg,2003,40344,36060,4284,10.6
45,77,Pickens,2003,55993,51938,4055,7.2
45,79,Richland,2003,164094,154164,9930,6.1
45,81,Saluda,2003,9181,8564,617,6.7
45,83,Spartanburg,2003,129967,119917,10050,7.7
45,85,Sumter,2003,44917,41313,3604,8.0
45,87,Union,2003,13381,11784,1597,11.9
45,89,Williamsburg,2003,15674,13544,2130,13.6
45,91,York,2003,92947,85595,7352,7.9
46,3,Aurora,2003,1449,1396,53,3.7
46,5,Beadle,2003,9039,8663,376,4.2
46,7,Bennett,2003,1431,1377,54,3.8
46,9,Bon Homme,2003,3411,3293,118,3.5
46,11,Brookings,2003,17473,16955,518,3.0
46,13,Brown,2003,20388,19744,644,3.2
46,15,Brule,2003,2899,2822,77,2.7
46,17,Buffalo,2003,549,507,42,7.7
46,19,Butte,2003,5079,4908,171,3.4
46,21,Campbell,2003,940,896,44,4.7
46,23,Charles Mix,2003,4307,4159,148,3.4
46,25,Clark,2003,1927,1828,99,5.1
46,27,Clay,2003,7128,6913,215,3.0
46,29,Codington,2003,15560,14957,603,3.9
46,31,Corson,2003,1452,1364,88,6.1
46,33,Custer,2003,4618,4445,173,3.7
46,35,Davison,2003,10834,10518,316,2.9
46,37,Day,2003,3098,2914,184,5.9
46,39,Deuel,2003,2613,2508,105,4.0
46,41,Dewey,2003,2681,2458,223,8.3
46,43,Douglas,2003,1809,1761,48,2.7
46,45,Edmunds,2003,2087,2020,67,3.2
46,47,Fall River,2003,3789,3615,174,4.6
46,49,Faulk,2003,1207,1169,38,3.1
46,51,Grant,2003,4323,4149,174,4.0
46,53,Gregory,2003,2578,2497,81,3.1
46,55,Haakon,2003,1264,1234,30,2.4
46,57,Hamlin,2003,2808,2700,108,3.8
46,59,Hand,2003,1956,1898,58,3.0
46,61,Hanson,2003,1836,1778,58,3.2
46,63,Harding,2003,818,794,24,2.9
46,65,Hughes,2003,9748,9491,257,2.6
46,67,Hutchinson,2003,3906,3764,142,3.6
46,69,Hyde,2003,852,825,27,3.2
46,71,Jackson,2003,1270,1202,68,5.4
46,73,Jerauld,2003,1280,1242,38,3.0
46,75,Jones,2003,810,795,15,1.9
46,77,Kingsbury,2003,3125,3012,113,3.6
46,79,Lake,2003,6617,6373,244,3.7
46,81,Lawrence,2003,12463,12058,405,3.2
46,83,Lincoln,2003,17047,16622,425,2.5
46,85,Lyman,2003,2014,1932,82,4.1
46,87,McCook,2003,2952,2856,96,3.3
46,89,McPherson,2003,1270,1209,61,4.8
46,91,Marshall,2003,2110,2003,107,5.1
46,93,Meade,2003,12581,12167,414,3.3
46,95,Mellette,2003,949,901,48,5.1
46,97,Miner,2003,1204,1147,57,4.7
46,99,Minnehaha,2003,91503,88695,2808,3.1
46,101,Moody,2003,3857,3663,194,5.0
46,102,Oglala Lakota,2003,3904,3544,360,9.2
46,103,Pennington,2003,51131,49498,1633,3.2
46,105,Perkins,2003,1791,1734,57,3.2
46,107,Potter,2003,1417,1373,44,3.1
46,109,Roberts,2003,4607,4363,244,5.3
46,111,Sanborn,2003,1560,1516,44,2.8
46,115,Spink,2003,3392,3279,113,3.3
46,117,Stanley,2003,1845,1794,51,2.8
46,119,Sully,2003,1018,996,22,2.2
46,121,Todd,2003,3407,3220,187,5.5
46,123,Tripp,2003,3257,3148,109,3.3
46,125,Turner,2003,4606,4457,149,3.2
46,127,Union,2003,7448,7130,318,4.3
46,129,Walworth,2003,2738,2604,134,4.9
46,135,Yankton,2003,11612,11219,393,3.4
46,137,Ziebach,2003,888,831,57,6.4
47,1,Anderson,2003,34875,33084,1791,5.1
47,3,Bedford,2003,20943,19549,1394,6.7
47,5,Benton,2003,6995,6338,657,9.4
47,7,Bledsoe,2003,5026,4657,369,7.3
47,9,Blount,2003,57810,55249,2561,4.4
47,11,Bradley,2003,45499,43195,2304,5.1
47,13,Campbell,2003,16586,15456,1130,6.8
47,15,Cannon,2003,6371,6058,313,4.9
47,17,Carroll,2003,13893,12627,1266,9.1
47,19,Carter,2003,28733,26951,1782,6.2
47,21,Cheatham,2003,19756,18934,822,4.2
47,23,Chester,2003,7402,6966,436,5.9
47,25,Claiborne,2003,12854,12125,729,5.7
47,27,Clay,2003,3864,3530,334,8.6
47,29,Cocke,2003,15675,14363,1312,8.4
47,31,Coffee,2003,25594,24345,1249,4.9
47,33,Crockett,2003,6994,6378,616,8.8
47,35,Cumberland,2003,22632,21167,1465,6.5
47,37,Davidson,2003,302815,289175,13640,4.5
47,39,Decatur,2003,5522,5076,446,8.1
47,41,DeKalb,2003,9609,9138,471,4.9
47,43,Dickson,2003,22487,21381,1106,4.9
47,45,Dyer,2003,17433,16253,1180,6.8
47,47,Fayette,2003,15275,14358,917,6.0
47,49,Fentress,2003,7128,6574,554,7.8
47,51,Franklin,2003,20350,19327,1023,5.0
47,53,Gibson,2003,21994,20130,1864,8.5
47,55,Giles,2003,14075,12814,1261,9.0
47,57,Grainger,2003,9914,9212,702,7.1
47,59,Greene,2003,32138,29773,2365,7.4
47,61,Grundy,2003,5819,5465,354,6.1
47,63,Hamblen,2003,29212,27457,1755,6.0
47,65,Hamilton,2003,157811,150826,6985,4.4
47,67,Hancock,2003,2647,2468,179,6.8
47,69,Hardeman,2003,11356,10467,889,7.8
47,71,Hardin,2003,11658,10605,1053,9.0
47,73,Hawkins,2003,25734,24061,1673,6.5
47,75,Haywood,2003,9619,8741,878,9.1
47,77,Henderson,2003,13049,12025,1024,7.8
47,79,Henry,2003,14516,13324,1192,8.2
47,81,Hickman,2003,9999,9414,585,5.9
47,83,Houston,2003,3719,3441,278,7.5
47,85,Humphreys,2003,8892,8308,584,6.6
47,87,Jackson,2003,5221,4812,409,7.8
47,89,Jefferson,2003,23043,21647,1396,6.1
47,91,Johnson,2003,6962,6372,590,8.5
47,93,Knox,2003,212509,204342,8167,3.8
47,95,Lake,2003,2763,2569,194,7.0
47,97,Lauderdale,2003,10437,9343,1094,10.5
47,99,Lawrence,2003,18766,17059,1707,9.1
47,101,Lewis,2003,5390,4962,428,7.9
47,103,Lincoln,2003,16075,15244,831,5.2
47,105,Loudon,2003,21160,20162,998,4.7
47,107,McMinn,2003,24007,22260,1747,7.3
47,109,McNairy,2003,12230,11406,824,6.7
47,111,Macon,2003,10460,9746,714,6.8
47,113,Madison,2003,46358,43654,2704,5.8
47,115,Marion,2003,12880,12151,729,5.7
47,117,Marshall,2003,13264,11981,1283,9.7
47,119,Maury,2003,36787,34585,2202,6.0
47,121,Meigs,2003,4831,4455,376,7.8
47,123,Monroe,2003,17771,16408,1363,7.7
47,125,Montgomery,2003,62548,59467,3081,4.9
47,127,Moore,2003,3143,3026,117,3.7
47,129,Morgan,2003,8115,7468,647,8.0
47,131,Obion,2003,16302,15172,1130,6.9
47,133,Overton,2003,9679,9078,601,6.2
47,135,Perry,2003,3206,2990,216,6.7
47,137,Pickett,2003,2019,1845,174,8.6
47,139,Polk,2003,7380,6940,440,6.0
47,141,Putnam,2003,33179,31560,1619,4.9
47,143,Rhea,2003,13191,12420,771,5.8
47,145,Roane,2003,25610,24243,1367,5.3
47,147,Robertson,2003,30794,29240,1554,5.0
47,149,Rutherford,2003,110574,105844,4730,4.3
47,151,Scott,2003,8478,7670,808,9.5
47,153,Sequatchie,2003,5546,5263,283,5.1
47,155,Sevier,2003,43047,40550,2497,5.8
47,157,Shelby,2003,437436,411924,25512,5.8
47,159,Smith,2003,9189,8454,735,8.0
47,161,Stewart,2003,5848,5461,387,6.6
47,163,Sullivan,2003,73962,69847,4115,5.6
47,165,Sumner,2003,72930,69591,3339,4.6
47,167,Tipton,2003,26246,24598,1648,6.3
47,169,Trousdale,2003,3573,3370,203,5.7
47,171,Unicoi,2003,8259,7716,543,6.6
47,173,Union,2003,8702,8272,430,4.9
47,175,Van Buren,2003,2508,2323,185,7.4
47,177,Warren,2003,19684,18563,1121,5.7
47,179,Washington,2003,56668,53784,2884,5.1
47,181,Wayne,2003,6697,6044,653,9.8
47,183,Weakley,2003,16486,15163,1323,8.0
47,185,White,2003,10768,9946,822,7.6
47,187,Williamson,2003,75448,72778,2670,3.5
47,189,Wilson,2003,52173,49802,2371,4.5
48,1,Anderson,2003,20627,18976,1651,8.0
48,3,Andrews,2003,6241,5896,345,5.5
48,5,Angelina,2003,40258,37598,2660,6.6
48,7,Aransas,2003,10737,9938,799,7.4
48,9,Archer,2003,5259,5034,225,4.3
48,11,Armstrong,2003,1093,1041,52,4.8
48,13,Atascosa,2003,18656,17399,1257,6.7
48,15,Austin,2003,12624,11839,785,6.2
48,17,Bailey,2003,3643,3434,209,5.7
48,19,Bandera,2003,9475,8959,516,5.4
48,21,Bastrop,2003,32563,30357,2206,6.8
48,23,Baylor,2003,2028,1906,122,6.0
48,25,Bee,2003,11822,10858,964,8.2
48,27,Bell,2003,108732,101919,6813,6.3
48,29,Bexar,2003,697647,654130,43517,6.2
48,31,Blanco,2003,4686,4456,230,4.9
48,33,Borden,2003,526,503,23,4.4
48,35,Bosque,2003,8277,7721,556,6.7
48,37,Bowie,2003,41872,39119,2753,6.6
48,39,Brazoria,2003,129221,119740,9481,7.3
48,41,Brazos,2003,84824,80749,4075,4.8
48,43,Brewster,2003,5110,4865,245,4.8
48,45,Briscoe,2003,806,755,51,6.3
48,47,Brooks,2003,3298,3028,270,8.2
48,49,Brown,2003,18481,17400,1081,5.8
48,51,Burleson,2003,8462,7955,507,6.0
48,53,Burnet,2003,20178,19048,1130,5.6
48,55,Caldwell,2003,15803,14637,1166,7.4
48,57,Calhoun,2003,9236,8542,694,7.5
48,59,Callahan,2003,6752,6388,364,5.4
48,61,Cameron,2003,142082,128489,13593,9.6
48,63,Camp,2003,5904,5500,404,6.8
48,65,Carson,2003,3500,3333,167,4.8
48,67,Cass,2003,13757,12652,1105,8.0
48,69,Castro,2003,3936,3733,203,5.2
48,71,Chambers,2003,13640,12796,844,6.2
48,73,Cherokee,2003,21797,20504,1293,5.9
48,75,Childress,2003,3297,3099,198,6.0
48,77,Clay,2003,6412,6106,306,4.8
48,79,Cochran,2003,1734,1593,141,8.1
48,81,Coke,2003,1616,1522,94,5.8
48,83,Coleman,2003,4375,4095,280,6.4
48,85,Collin,2003,339354,318887,20467,6.0
48,87,Collingsworth,2003,1712,1627,85,5.0
48,89,Colorado,2003,10360,9789,571,5.5
48,91,Comal,2003,45220,42600,2620,5.8
48,93,Comanche,2003,7079,6710,369,5.2
48,95,Concho,2003,1478,1382,96,6.5
48,97,Cooke,2003,19037,17951,1086,5.7
48,99,Coryell,2003,24702,22883,1819,7.4
48,101,Cottle,2003,984,923,61,6.2
48,103,Crane,2003,1684,1560,124,7.4
48,105,Crockett,2003,2176,2087,89,4.1
48,107,Crosby,2003,2956,2763,193,6.5
48,109,Culberson,2003,1599,1510,89,5.6
48,111,Dallam,2003,3411,3270,141,4.1
48,113,Dallas,2003,1158141,1071905,86236,7.4
48,115,Dawson,2003,5621,5197,424,7.5
48,117,Deaf Smith,2003,8155,7677,478,5.9
48,119,Delta,2003,2418,2257,161,6.7
48,121,Denton,2003,292594,277148,15446,5.3
48,123,DeWitt,2003,9671,9119,552,5.7
48,125,Dickens,2003,1190,1116,74,6.2
48,127,Dimmit,2003,4248,3847,401,9.4
48,129,Donley,2003,1971,1861,110,5.6
48,131,Duval,2003,5279,4837,442,8.4
48,133,Eastland,2003,8645,8084,561,6.5
48,135,Ector,2003,60598,56566,4032,6.7
48,137,Edwards,2003,1140,1091,49,4.3
48,139,Ellis,2003,62985,58961,4024,6.4
48,141,El Paso,2003,288427,263013,25414,8.8
48,143,Erath,2003,17788,16923,865,4.9
48,145,Falls,2003,7628,7090,538,7.1
48,147,Fannin,2003,13949,12906,1043,7.5
48,149,Fayette,2003,12188,11606,582,4.8
48,151,Fisher,2003,2225,2100,125,5.6
48,153,Floyd,2003,3669,3407,262,7.1
48,155,Foard,2003,807,747,60,7.4
48,157,Fort Bend,2003,216109,202842,13267,6.1
48,159,Franklin,2003,4832,4583,249,5.2
48,161,Freestone,2003,9446,8874,572,6.1
48,163,Frio,2003,6617,6097,520,7.9
48,165,Gaines,2003,6834,6496,338,4.9
48,167,Galveston,2003,135174,125471,9703,7.2
48,169,Garza,2003,2306,2170,136,5.9
48,171,Gillespie,2003,11788,11276,512,4.3
48,173,Glasscock,2003,743,712,31,4.2
48,175,Goliad,2003,3375,3184,191,5.7
48,177,Gonzales,2003,10083,9575,508,5.0
48,179,Gray,2003,10325,9699,626,6.1
48,181,Grayson,2003,57042,52992,4050,7.1
48,183,Gregg,2003,57956,53860,4096,7.1
48,185,Grimes,2003,10293,9452,841,8.2
48,187,Guadalupe,2003,48980,46361,2619,5.3
48,189,Hale,2003,17692,16604,1088,6.1
48,191,Hall,2003,1739,1624,115,6.6
48,193,Hamilton,2003,4481,4261,220,4.9
48,195,Hansford,2003,2883,2765,118,4.1
48,197,Hardeman,2003,2374,2221,153,6.4
48,199,Hardin,2003,24471,22565,1906,7.8
48,201,Harris,2003,1805480,1682151,123329,6.8
48,203,Harrison,2003,30638,28592,2046,6.7
48,205,Hartley,2003,2567,2462,105,4.1
48,207,Haskell,2003,3140,2965,175,5.6
48,209,Hays,2003,62836,59163,3673,5.8
48,211,Hemphill,2003,2344,2275,69,2.9
48,213,Henderson,2003,34665,32516,2149,6.2
48,215,Hidalgo,2003,245506,219937,25569,10.4
48,217,Hill,2003,15381,14202,1179,7.7
48,219,Hockley,2003,11697,11075,622,5.3
48,221,Hood,2003,22762,21322,1440,6.3
48,223,Hopkins,2003,16811,15802,1009,6.0
48,225,Houston,2003,9815,9109,706,7.2
48,227,Howard,2003,14219,13303,916,6.4
48,229,Hudspeth,2003,1386,1277,109,7.9
48,231,Hunt,2003,38283,35674,2609,6.8
48,233,Hutchinson,2003,10993,10267,726,6.6
48,235,Irion,2003,972,929,43,4.4
48,237,Jack,2003,4217,3999,218,5.2
48,239,Jackson,2003,6870,6468,402,5.9
48,241,Jasper,2003,16196,14632,1564,9.7
48,243,Jeff Davis,2003,1358,1302,56,4.1
48,245,Jefferson,2003,114111,104282,9829,8.6
48,247,Jim Hogg,2003,2470,2319,151,6.1
48,249,Jim Wells,2003,19191,17848,1343,7.0
48,251,Johnson,2003,69812,65265,4547,6.5
48,253,Jones,2003,8008,7486,522,6.5
48,255,Karnes,2003,5645,5231,414,7.3
48,257,Kaufman,2003,40833,37647,3186,7.8
48,259,Kendall,2003,13347,12641,706,5.3
48,261,Kenedy,2003,230,221,9,3.9
48,263,Kent,2003,513,488,25,4.9
48,265,Kerr,2003,21024,19913,1111,5.3
48,267,Kimble,2003,2300,2195,105,4.6
48,269,King,2003,240,231,9,3.8
48,271,Kinney,2003,1423,1313,110,7.7
48,273,Kleberg,2003,15690,14734,956,6.1
48,275,Knox,2003,2047,1934,113,5.5
48,277,Lamar,2003,24057,22314,1743,7.2
48,279,Lamb,2003,7567,7124,443,5.9
48,281,Lampasas,2003,9515,8992,523,5.5
48,283,La Salle,2003,2365,2181,184,7.8
48,285,Lavaca,2003,10101,9672,429,4.2
48,287,Lee,2003,8739,8265,474,5.4
48,289,Leon,2003,7463,6897,566,7.6
48,291,Liberty,2003,31862,28908,2954,9.3
48,293,Limestone,2003,10405,9774,631,6.1
48,295,Lipscomb,2003,1624,1550,74,4.6
48,297,Live Oak,2003,5214,4919,295,5.7
48,299,Llano,2003,7983,7481,502,6.3
48,301,Loving,2003,50,45,5,10.0
48,303,Lubbock,2003,135461,128883,6578,4.9
48,305,Lynn,2003,3187,3012,175,5.5
48,307,McCulloch,2003,4004,3794,210,5.2
48,309,McLennan,2003,108506,101918,6588,6.1
48,311,McMullen,2003,458,435,23,5.0
48,313,Madison,2003,5193,4852,341,6.6
48,315,Marion,2003,4942,4568,374,7.6
48,317,Martin,2003,2358,2250,108,4.6
48,319,Mason,2003,2314,2228,86,3.7
48,321,Matagorda,2003,17367,15602,1765,10.2
48,323,Maverick,2003,18595,15311,3284,17.7
48,325,Medina,2003,18961,17837,1124,5.9
48,327,Menard,2003,1169,1105,64,5.5
48,329,Midland,2003,62865,59750,3115,5.0
48,331,Milam,2003,12015,11225,790,6.6
48,333,Mills,2003,2715,2598,117,4.3
48,335,Mitchell,2003,3554,3290,264,7.4
48,337,Montague,2003,9532,8942,590,6.2
48,339,Montgomery,2003,175035,165080,9955,5.7
48,341,Moore,2003,10374,9880,494,4.8
48,343,Morris,2003,6114,5575,539,8.8
48,345,Motley,2003,732,703,29,4.0
48,347,Nacogdoches,2003,31014,29178,1836,5.9
48,349,Navarro,2003,21793,20114,1679,7.7
48,351,Newton,2003,6042,5287,755,12.5
48,353,Nolan,2003,7687,7230,457,5.9
48,355,Nueces,2003,155906,145758,10148,6.5
48,357,Ochiltree,2003,5010,4816,194,3.9
48,359,Oldham,2003,1242,1184,58,4.7
48,361,Orange,2003,41595,37686,3909,9.4
48,363,Palo Pinto,2003,13576,12754,822,6.1
48,365,Panola,2003,11112,10341,771,6.9
48,367,Parker,2003,48522,45790,2732,5.6
48,369,Parmer,2003,5023,4815,208,4.1
48,371,Pecos,2003,7370,6914,456,6.2
48,373,Polk,2003,17174,15773,1401,8.2
48,375,Potter,2003,56935,53142,3793,6.7
48,377,Presidio,2003,3621,3054,567,15.7
48,379,Rains,2003,4689,4338,351,7.5
48,381,Randall,2003,63826,61753,2073,3.2
48,383,Reagan,2003,1673,1606,67,4.0
48,385,Real,2003,1384,1296,88,6.4
48,387,Red River,2003,6485,6004,481,7.4
48,389,Reeves,2003,4755,4214,541,11.4
48,391,Refugio,2003,3886,3700,186,4.8
48,393,Roberts,2003,513,494,19,3.7
48,395,Robertson,2003,7389,6928,461,6.2
48,397,Rockwall,2003,28671,26988,1683,5.9
48,399,Runnels,2003,4932,4654,278,5.6
48,401,Rusk,2003,21768,20294,1474,6.8
48,403,Sabine,2003,3787,3290,497,13.1
48,405,San Augustine,2003,3910,3636,274,7.0
48,407,San Jacinto,2003,9928,9244,684,6.9
48,409,San Patricio,2003,28949,26856,2093,7.2
48,411,San Saba,2003,2835,2685,150,5.3
48,413,Schleicher,2003,1518,1455,63,4.2
48,415,Scurry,2003,7258,6820,438,6.0
48,417,Shackelford,2003,1968,1892,76,3.9
48,419,Shelby,2003,12557,11675,882,7.0
48,421,Sherman,2003,1683,1622,61,3.6
48,423,Smith,2003,92282,86777,5505,6.0
48,425,Somervell,2003,3807,3564,243,6.4
48,427,Starr,2003,21139,17763,3376,16.0
48,429,Stephens,2003,4208,3902,306,7.3
48,431,Sterling,2003,947,915,32,3.4
48,433,Stonewall,2003,865,827,38,4.4
48,435,Sutton,2003,2485,2400,85,3.4
48,437,Swisher,2003,4041,3829,212,5.2
48,439,Tarrant,2003,820124,768130,51994,6.3
48,441,Taylor,2003,64803,61439,3364,5.2
48,443,Terrell,2003,498,462,36,7.2
48,445,Terry,2003,5837,5449,388,6.6
48,447,Throckmorton,2003,1026,979,47,4.6
48,449,Titus,2003,14524,13695,829,5.7
48,451,Tom Green,2003,52765,50058,2707,5.1
48,453,Travis,2003,488148,458627,29521,6.0
48,455,Trinity,2003,5975,5542,433,7.2
48,457,Tyler,2003,8730,7910,820,9.4
48,459,Upshur,2003,17675,16520,1155,6.5
48,461,Upton,2003,1546,1463,83,5.4
48,463,Uvalde,2003,12065,11136,929,7.7
48,465,Val Verde,2003,19474,17936,1538,7.9
48,467,Van Zandt,2003,24882,23358,1524,6.1
48,469,Victoria,2003,43431,40913,2518,5.8
48,471,Walker,2003,26032,24315,1717,6.6
48,473,Waller,2003,16078,15013,1065,6.6
48,475,Ward,2003,4404,4074,330,7.5
48,477,Washington,2003,16013,15166,847,5.3
48,479,Webb,2003,81172,75184,5988,7.4
48,481,Wharton,2003,21453,20124,1329,6.2
48,483,Wheeler,2003,2800,2682,118,4.2
48,485,Wichita,2003,63103,59317,3786,6.0
48,487,Wilbarger,2003,7537,7161,376,5.0
48,489,Willacy,2003,7631,6725,906,11.9
48,491,Williamson,2003,164711,155323,9388,5.7
48,493,Wilson,2003,16886,15921,965,5.7
48,495,Winkler,2003,3064,2836,228,7.4
48,497,Wise,2003,26756,25193,1563,5.8
48,499,Wood,2003,17473,16298,1175,6.7
48,501,Yoakum,2003,3399,3213,186,5.5
48,503,Young,2003,8955,8418,537,6.0
48,505,Zapata,2003,4709,4293,416,8.8
48,507,Zavala,2003,4193,3612,581,13.9
49,1,Beaver,2003,2938,2786,152,5.2
49,3,Box Elder,2003,21264,20106,1158,5.4
49,5,Cache,2003,53882,51801,2081,3.9
49,7,Carbon,2003,9333,8624,709,7.6
49,9,Daggett,2003,481,456,25,5.2
49,11,Davis,2003,128150,121690,6460,5.0
49,13,Duchesne,2003,6863,6410,453,6.6
49,15,Emery,2003,4867,4483,384,7.9
49,17,Garfield,2003,2541,2317,224,8.8
49,19,Grand,2003,4880,4520,360,7.4
49,21,Iron,2003,17857,16937,920,5.2
49,23,Juab,2003,3673,3416,257,7.0
49,25,Kane,2003,3103,2931,172,5.5
49,27,Millard,2003,5917,5625,292,4.9
49,29,Morgan,2003,3579,3397,182,5.1
49,31,Piute,2003,801,758,43,5.4
49,33,Rich,2003,1257,1208,49,3.9
49,35,Salt Lake,2003,495070,467084,27986,5.7
49,37,San Juan,2003,4724,4300,424,9.0
49,39,Sanpete,2003,10280,9593,687,6.7
49,41,Sevier,2003,8733,8236,497,5.7
49,43,Summit,2003,19828,18624,1204,6.1
49,45,Tooele,2003,23182,21754,1428,6.2
49,47,Uintah,2003,13061,12323,738,5.7
49,49,Utah,2003,188375,178530,9845,5.2
49,51,Wasatch,2003,8465,7956,509,6.0
49,53,Washington,2003,47437,44945,2492,5.3
49,55,Wayne,2003,1317,1227,90,6.8
49,57,Weber,2003,105393,98754,6639,6.3
50,1,Addison,2003,21057,20223,834,4.0
50,3,Bennington,2003,19976,19010,966,4.8
50,5,Caledonia,2003,16300,15463,837,5.1
50,7,Chittenden,2003,86624,83273,3351,3.9
50,9,Essex,2003,3248,3086,162,5.0
50,11,Franklin,2003,25500,24277,1223,4.8
50,13,Grand Isle,2003,4121,3889,232,5.6
50,15,Lamoille,2003,14029,13343,686,4.9
50,17,Orange,2003,16287,15653,634,3.9
50,19,Orleans,2003,13846,12978,868,6.3
50,21,Rutland,2003,34719,33066,1653,4.8
50,23,Washington,2003,33935,32425,1510,4.4
50,25,Windham,2003,24733,23759,974,3.9
50,27,Windsor,2003,32003,30795,1208,3.8
51,1,Accomack,2003,19326,18437,889,4.6
51,3,Albemarle,2003,44909,43299,1610,3.6
51,5,Alleghany,2003,8025,7634,391,4.9
51,7,Amelia,2003,5983,5736,247,4.1
51,9,Amherst,2003,15236,14437,799,5.2
51,11,Appomattox,2003,6730,6335,395,5.9
51,13,Arlington,2003,120944,117524,3420,2.8
51,15,Augusta,2003,36066,34762,1304,3.6
51,17,Bath,2003,2885,2746,139,4.8
51,19,Bedford,2003,35158,33612,1546,4.4
51,21,Bland,2003,3036,2876,160,5.3
51,23,Botetourt,2003,16867,16232,635,3.8
51,25,Brunswick,2003,6958,6447,511,7.3
51,27,Buchanan,2003,8895,8243,652,7.3
51,29,Buckingham,2003,6459,6162,297,4.6
51,31,Campbell,2003,26314,24931,1383,5.3
51,33,Caroline,2003,11549,11030,519,4.5
51,35,Carroll,2003,14939,14063,876,5.9
51,36,Charles City,2003,3748,3549,199,5.3
51,37,Charlotte,2003,5672,5283,389,6.9
51,41,Chesterfield,2003,150437,144852,5585,3.7
51,43,Clarke,2003,7139,6905,234,3.3
51,45,Craig,2003,2500,2392,108,4.3
51,47,Culpeper,2003,18023,17256,767,4.3
51,49,Cumberland,2003,4297,4114,183,4.3
51,51,Dickenson,2003,5838,5319,519,8.9
51,53,Dinwiddie,2003,12171,11650,521,4.3
51,57,Essex,2003,5344,5040,304,5.7
51,59,Fairfax,2003,550193,532318,17875,3.2
51,61,Fauquier,2003,32522,31455,1067,3.3
51,63,Floyd,2003,7305,6995,310,4.2
51,65,Fluvanna,2003,11719,11295,424,3.6
51,67,Franklin,2003,24969,23798,1171,4.7
51,69,Frederick,2003,36197,34812,1385,3.8
51,71,Giles,2003,8235,7767,468,5.7
51,73,Gloucester,2003,18934,18299,635,3.4
51,75,Goochland,2003,9567,9229,338,3.5
51,77,Grayson,2003,7958,7432,526,6.6
51,79,Greene,2003,9155,8763,392,4.3
51,81,Greensville,2003,4262,4026,236,5.5
51,83,Halifax,2003,16372,14623,1749,10.7
51,85,Hanover,2003,51118,49370,1748,3.4
51,87,Henrico,2003,149953,144081,5872,3.9
51,89,Henry,2003,28226,25257,2969,10.5
51,91,Highland,2003,1188,1135,53,4.5
51,93,Isle of Wight,2003,16326,15711,615,3.8
51,95,James City,2003,26303,25380,923,3.5
51,97,King and Queen,2003,3141,2991,150,4.8
51,99,King George,2003,9056,8747,309,3.4
51,101,King William,2003,7498,7211,287,3.8
51,103,Lancaster,2003,5262,4956,306,5.8
51,105,Lee,2003,9685,9073,612,6.3
51,107,Loudoun,2003,124786,120617,4169,3.3
51,109,Louisa,2003,14006,13380,626,4.5
51,111,Lunenburg,2003,5620,5289,331,5.9
51,113,Madison,2003,7166,6874,292,4.1
51,115,Mathews,2003,4360,4213,147,3.4
51,117,Mecklenburg,2003,13716,12369,1347,9.8
51,119,Middlesex,2003,4860,4680,180,3.7
51,121,Montgomery,2003,42736,41021,1715,4.0
51,125,Nelson,2003,7178,6902,276,3.8
51,127,New Kent,2003,8056,7743,313,3.9
51,131,Northampton,2003,5967,5662,305,5.1
51,133,Northumberland,2003,5663,5329,334,5.9
51,135,Nottoway,2003,6449,6148,301,4.7
51,137,Orange,2003,13794,13213,581,4.2
51,139,Page,2003,11961,11081,880,7.4
51,141,Patrick,2003,9827,9036,791,8.0
51,143,Pittsylvania,2003,32817,30563,2254,6.9
51,145,Powhatan,2003,12524,12107,417,3.3
51,147,Prince Edward,2003,8507,7996,511,6.0
51,149,Prince George,2003,14620,13978,642,4.4
51,153,Prince William,2003,171498,165365,6133,3.6
51,155,Pulaski,2003,18150,16986,1164,6.4
51,157,Rappahannock,2003,3962,3835,127,3.2
51,159,Richmond,2003,3585,3350,235,6.6
51,161,Roanoke,2003,46352,44710,1642,3.5
51,163,Rockbridge,2003,11250,10809,441,3.9
51,165,Rockingham,2003,39168,37857,1311,3.3
51,167,Russell,2003,12356,11551,805,6.5
51,169,Scott,2003,9919,9348,571,5.8
51,171,Shenandoah,2003,19227,18439,788,4.1
51,173,Smyth,2003,15880,14617,1263,8.0
51,175,Southampton,2003,7606,7255,351,4.6
51,177,Spotsylvania,2003,55716,53924,1792,3.2
51,179,Stafford,2003,55593,53774,1819,3.3
51,181,Surry,2003,3568,3396,172,4.8
51,183,Sussex,2003,4503,4175,328,7.3
51,185,Tazewell,2003,20016,18878,1138,5.7
51,187,Warren,2003,17394,16659,735,4.2
51,191,Washington,2003,26126,24637,1489,5.7
51,193,Westmoreland,2003,8105,7694,411,5.1
51,195,Wise,2003,17360,16308,1052,6.1
51,197,Wythe,2003,14811,13989,822,5.5
51,199,York,2003,29290,28314,976,3.3
51,510,Alexandria city,2003,82860,80243,2617,3.2
51,520,Bristol city,2003,7886,7371,515,6.5
51,530,Buena Vista city,2003,3398,3237,161,4.7
51,540,Charlottesville city,2003,19495,18643,852,4.4
51,550,Chesapeake city,2003,105629,101342,4287,4.1
51,570,Colonial Heights city,2003,8799,8382,417,4.7
51,580,Covington city,2003,3082,2904,178,5.8
51,590,Danville city,2003,21916,19742,2174,9.9
51,595,Emporia city,2003,2576,2387,189,7.3
51,600,Fairfax city,2003,12450,12093,357,2.9
51,610,Falls Church city,2003,6108,5899,209,3.4
51,620,Franklin city,2003,3686,3496,190,5.2
51,630,Fredericksburg city,2003,10658,10070,588,5.5
51,640,Galax city,2003,3284,3064,220,6.7
51,650,Hampton city,2003,66080,62675,3405,5.2
51,660,Harrisonburg city,2003,21070,20204,866,4.1
51,670,Hopewell city,2003,10083,9411,672,6.7
51,678,Lexington city,2003,2342,2205,137,5.8
51,680,Lynchburg city,2003,30873,29055,1818,5.9
51,683,Manassas city,2003,19839,19122,717,3.6
51,685,Manassas Park city,2003,5994,5826,168,2.8
51,690,Martinsville city,2003,6371,5666,705,11.1
51,700,Newport News city,2003,86060,81760,4300,5.0
51,710,Norfolk city,2003,97768,92330,5438,5.6
51,720,Norton city,2003,1619,1527,92,5.7
51,730,Petersburg city,2003,14226,12936,1290,9.1
51,735,Poquoson city,2003,6055,5853,202,3.3
51,740,Portsmouth city,2003,43806,41310,2496,5.7
51,750,Radford city,2003,7364,6957,407,5.5
51,760,Richmond city,2003,95596,89782,5814,6.1
51,770,Roanoke city,2003,45872,43372,2500,5.4
51,775,Salem city,2003,12844,12318,526,4.1
51,790,Staunton city,2003,11436,10973,463,4.0
51,800,Suffolk city,2003,34716,33142,1574,4.5
51,810,Virginia Beach city,2003,216338,208017,8321,3.8
51,820,Waynesboro city,2003,9724,9259,465,4.8
51,830,Williamsburg city,2003,4622,4232,390,8.4
51,840,Winchester city,2003,13393,12875,518,3.9
53,1,Adams,2003,8209,7489,720,8.8
53,3,Asotin,2003,9974,9234,740,7.4
53,5,Benton,2003,82587,76912,5675,6.9
53,7,Chelan,2003,36896,33794,3102,8.4
53,9,Clallam,2003,27155,24821,2334,8.6
53,11,Clark,2003,188305,170281,18024,9.6
53,13,Columbia,2003,1667,1508,159,9.5
53,15,Cowlitz,2003,42638,38398,4240,9.9
53,17,Douglas,2003,18456,17043,1413,7.7
53,19,Ferry,2003,2935,2538,397,13.5
53,21,Franklin,2003,26279,23967,2312,8.8
53,23,Garfield,2003,1084,1011,73,6.7
53,25,Grant,2003,36837,33409,3428,9.3
53,27,Grays Harbor,2003,29808,27005,2803,9.4
53,29,Island,2003,30655,28332,2323,7.6
53,31,Jefferson,2003,12874,11919,955,7.4
53,33,King,2003,987986,931009,56977,5.8
53,35,Kitsap,2003,114064,106410,7654,6.7
53,37,Kittitas,2003,18585,17163,1422,7.7
53,39,Klickitat,2003,9457,8335,1122,11.9
53,41,Lewis,2003,30239,27391,2848,9.4
53,43,Lincoln,2003,4702,4372,330,7.0
53,45,Mason,2003,22754,20797,1957,8.6
53,47,Okanogan,2003,19846,17972,1874,9.4
53,49,Pacific,2003,9054,8223,831,9.2
53,51,Pend Oreille,2003,4824,4322,502,10.4
53,53,Pierce,2003,350401,321771,28630,8.2
53,55,San Juan,2003,7862,7409,453,5.8
53,57,Skagit,2003,53539,49178,4361,8.1
53,59,Skamania,2003,4758,4277,481,10.1
53,61,Snohomish,2003,335148,312869,22279,6.6
53,63,Spokane,2003,214669,198479,16190,7.5
53,65,Stevens,2003,17677,15974,1703,9.6
53,67,Thurston,2003,115586,108110,7476,6.5
53,69,Wahkiakum,2003,1588,1432,156,9.8
53,71,Walla Walla,2003,28841,26813,2028,7.0
53,73,Whatcom,2003,94974,88567,6407,6.7
53,75,Whitman,2003,19423,18471,952,4.9
53,77,Yakima,2003,113926,103007,10919,9.6
54,1,Barbour,2003,6722,6195,527,7.8
54,3,Berkeley,2003,40638,38587,2051,5.0
54,5,Boone,2003,9472,8826,646,6.8
54,7,Braxton,2003,5985,5502,483,8.1
54,9,Brooke,2003,11396,10614,782,6.9
54,11,Cabell,2003,44328,41912,2416,5.5
54,13,Calhoun,2003,2940,2575,365,12.4
54,15,Clay,2003,3545,3192,353,10.0
54,17,Doddridge,2003,2892,2707,185,6.4
54,19,Fayette,2003,17962,16529,1433,8.0
54,21,Gilmer,2003,3013,2806,207,6.9
54,23,Grant,2003,5275,4841,434,8.2
54,25,Greenbrier,2003,15042,14007,1035,6.9
54,27,Hampshire,2003,9208,8701,507,5.5
54,29,Hancock,2003,14917,13962,955,6.4
54,31,Hardy,2003,6975,6635,340,4.9
54,33,Harrison,2003,30695,28732,1963,6.4
54,35,Jackson,2003,11877,10824,1053,8.9
54,37,Jefferson,2003,23256,22305,951,4.1
54,39,Kanawha,2003,92070,86697,5373,5.8
54,41,Lewis,2003,7261,6701,560,7.7
54,43,Lincoln,2003,7942,7294,648,8.2
54,45,Logan,2003,12875,11834,1041,8.1
54,47,McDowell,2003,6885,6010,875,12.7
54,49,Marion,2003,25290,23717,1573,6.2
54,51,Marshall,2003,15010,13956,1054,7.0
54,53,Mason,2003,10461,9376,1085,10.4
54,55,Mercer,2003,24970,23264,1706,6.8
54,57,Mineral,2003,13198,12276,922,7.0
54,59,Mingo,2003,8264,7437,827,10.0
54,61,Monongalia,2003,42719,40702,2017,4.7
54,63,Monroe,2003,5791,5482,309,5.3
54,65,Morgan,2003,6907,6563,344,5.0
54,67,Nicholas,2003,10503,9669,834,7.9
54,69,Ohio,2003,20798,19570,1228,5.9
54,71,Pendleton,2003,3861,3670,191,4.9
54,73,Pleasants,2003,3316,3044,272,8.2
54,75,Pocahontas,2003,4049,3754,295,7.3
54,77,Preston,2003,13879,12933,946,6.8
54,79,Putnam,2003,25890,24466,1424,5.5
54,81,Raleigh,2003,31395,29187,2208,7.0
54,83,Randolph,2003,12613,11732,881,7.0
54,85,Ritchie,2003,4502,4119,383,8.5
54,87,Roane,2003,5526,5001,525,9.5
54,89,Summers,2003,4725,4363,362,7.7
54,91,Taylor,2003,6928,6489,439,6.3
54,93,Tucker,2003,3116,2867,249,8.0
54,95,Tyler,2003,3703,3407,296,8.0
54,97,Upshur,2003,10600,9869,731,6.9
54,99,Wayne,2003,17677,16558,1119,6.3
54,101,Webster,2003,3369,3127,242,7.2
54,103,Wetzel,2003,6646,6057,589,8.9
54,105,Wirt,2003,2574,2312,262,10.2
54,107,Wood,2003,42119,39365,2754,6.5
54,109,Wyoming,2003,8276,7578,698,8.4
55,1,Adams,2003,9260,8718,542,5.9
55,3,Ashland,2003,9240,8583,657,7.1
55,5,Barron,2003,25895,24339,1556,6.0
55,7,Bayfield,2003,8063,7537,526,6.5
55,9,Brown,2003,135837,128732,7105,5.2
55,11,Buffalo,2003,8398,7967,431,5.1
55,13,Burnett,2003,8447,7984,463,5.5
55,15,Calumet,2003,25279,24040,1239,4.9
55,17,Chippewa,2003,31732,29731,2001,6.3
55,19,Clark,2003,18411,17291,1120,6.1
55,21,Columbia,2003,31160,29433,1727,5.5
55,23,Crawford,2003,9370,8788,582,6.2
55,25,Dane,2003,279835,269646,10189,3.6
55,27,Dodge,2003,47429,44611,2818,5.9
55,29,Door,2003,16994,15738,1256,7.4
55,31,Douglas,2003,22908,21490,1418,6.2
55,33,Dunn,2003,23982,22768,1214,5.1
55,35,Eau Claire,2003,54673,52084,2589,4.7
55,37,Florence,2003,2677,2504,173,6.5
55,39,Fond du Lac,2003,56867,53836,3031,5.3
55,41,Forest,2003,5087,4726,361,7.1
55,43,Grant,2003,28718,27251,1467,5.1
55,45,Green,2003,20003,18929,1074,5.4
55,47,Green Lake,2003,10871,10120,751,6.9
55,49,Iowa,2003,14076,13467,609,4.3
55,51,Iron,2003,3360,3044,316,9.4
55,53,Jackson,2003,10140,9547,593,5.8
55,55,Jefferson,2003,43211,41004,2207,5.1
55,57,Juneau,2003,13117,12156,961,7.3
55,59,Kenosha,2003,82375,77265,5110,6.2
55,61,Kewaunee,2003,11933,11241,692,5.8
55,63,La Crosse,2003,62194,59374,2820,4.5
55,65,Lafayette,2003,9408,8932,476,5.1
55,67,Langlade,2003,11290,10452,838,7.4
55,69,Lincoln,2003,16259,15216,1043,6.4
55,71,Manitowoc,2003,46325,43142,3183,6.9
55,73,Marathon,2003,74120,70518,3602,4.9
55,75,Marinette,2003,23321,21631,1690,7.2
55,77,Marquette,2003,7988,7345,643,8.0
55,78,Menominee,2003,1713,1525,188,11.0
55,79,Milwaukee,2003,464830,432283,32547,7.0
55,81,Monroe,2003,23295,22132,1163,5.0
55,83,Oconto,2003,20453,19026,1427,7.0
55,85,Oneida,2003,20465,19046,1419,6.9
55,87,Outagamie,2003,95673,90331,5342,5.6
55,89,Ozaukee,2003,47751,45509,2242,4.7
55,91,Pepin,2003,4021,3825,196,4.9
55,93,Pierce,2003,23002,21979,1023,4.4
55,95,Polk,2003,23928,22285,1643,6.9
55,97,Portage,2003,40403,38359,2044,5.1
55,99,Price,2003,8658,8179,479,5.5
55,101,Racine,2003,99758,92776,6982,7.0
55,103,Richland,2003,10196,9719,477,4.7
55,105,Rock,2003,82805,77699,5106,6.2
55,107,Rusk,2003,7859,7349,510,6.5
55,109,St. Croix,2003,42328,39843,2485,5.9
55,111,Sauk,2003,34859,33213,1646,4.7
55,113,Sawyer,2003,9014,8387,627,7.0
55,115,Shawano,2003,22922,21644,1278,5.6
55,117,Sheboygan,2003,64288,61032,3256,5.1
55,119,Taylor,2003,11689,11027,662,5.7
55,121,Trempealeau,2003,15840,14929,911,5.8
55,123,Vernon,2003,15283,14484,799,5.2
55,125,Vilas,2003,11654,10848,806,6.9
55,127,Walworth,2003,56234,53521,2713,4.8
55,129,Washburn,2003,8299,7696,603,7.3
55,131,Washington,2003,71002,67281,3721,5.2
55,133,Waukesha,2003,212431,202187,10244,4.8
55,135,Waupaca,2003,28574,26943,1631,5.7
55,137,Waushara,2003,12713,11880,833,6.6
55,139,Winnebago,2003,91806,86958,4848,5.3
55,141,Wood,2003,41312,38885,2427,5.9
56,1,Albany,2003,18715,18094,621,3.3
56,3,Big Horn,2003,5195,4934,261,5.0
56,5,Campbell,2003,21757,20977,780,3.6
56,7,Carbon,2003,7685,7269,416,5.4
56,9,Converse,2003,6504,6210,294,4.5
56,11,Crook,2003,3119,2987,132,4.2
56,13,Fremont,2003,17834,16830,1004,5.6
56,15,Goshen,2003,5857,5595,262,4.5
56,17,Hot Springs,2003,2379,2279,100,4.2
56,19,Johnson,2003,3641,3479,162,4.4
56,21,Laramie,2003,41731,39863,1868,4.5
56,23,Lincoln,2003,8343,7973,370,4.4
56,25,Natrona,2003,38154,36482,1672,4.4
56,27,Niobrara,2003,1146,1092,54,4.7
56,29,Park,2003,14563,13906,657,4.5
56,31,Platte,2003,4067,3858,209,5.1
56,33,Sheridan,2003,15080,14405,675,4.5
56,35,Sublette,2003,4145,4018,127,3.1
56,37,Sweetwater,2003,20885,20049,836,4.0
56,39,Teton,2003,13664,13181,483,3.5
56,41,Uinta,2003,10944,10449,495,4.5
56,43,Washakie,2003,4220,4031,189,4.5
56,45,Weston,2003,3177,3032,145,4.6
72,1,Adjuntas Municipio,2003,5191,4462,729,14.0
72,3,Aguada Municipio,2003,14664,12604,2060,14.0
72,5,Aguadilla Municipio,2003,20953,17864,3089,14.7
72,7,Aguas Buenas Municipio,2003,9390,8174,1216,12.9
72,9,Aibonito Municipio,2003,7946,6849,1097,13.8
72,11,Anasco Municipio,2003,10299,8707,1592,15.5
72,13,Arecibo Municipio,2003,33789,29417,4372,12.9
72,15,Arroyo Municipio,2003,5455,4479,976,17.9
72,17,Barceloneta Municipio,2003,7351,6226,1125,15.3
72,19,Barranquitas Municipio,2003,7629,6666,963,12.6
72,21,Bayamon Municipio,2003,84691,76993,7698,9.1
72,23,Cabo Rojo Municipio,2003,18770,16735,2035,10.8
72,25,Caguas Municipio,2003,54619,48519,6100,11.2
72,27,Camuy Municipio,2003,12850,11037,1813,14.1
72,29,Canovanas Municipio,2003,14263,12221,2042,14.3
72,31,Carolina Municipio,2003,78644,71297,7347,9.3
72,33,Catano Municipio,2003,8605,7594,1011,11.7
72,35,Cayey Municipio,2003,16012,13935,2077,13.0
72,37,Ceiba Municipio,2003,5905,5041,864,14.6
72,39,Ciales Municipio,2003,5172,4334,838,16.2
72,41,Cidra Municipio,2003,15000,13173,1827,12.2
72,43,Coamo Municipio,2003,11656,9978,1678,14.4
72,45,Comerio Municipio,2003,4932,4216,716,14.5
72,47,Corozal Municipio,2003,10484,9170,1314,12.5
72,49,Culebra Municipio,2003,860,810,50,5.8
72,51,Dorado Municipio,2003,12665,11344,1321,10.4
72,53,Fajardo Municipio,2003,14681,12494,2187,14.9
72,54,Florida Municipio,2003,3873,3290,583,15.1
72,55,Guanica Municipio,2003,6080,4965,1115,18.3
72,57,Guayama Municipio,2003,13939,11673,2266,16.3
72,59,Guayanilla Municipio,2003,6490,5360,1130,17.4
72,61,Guaynabo Municipio,2003,44679,41639,3040,6.8
72,63,Gurabo Municipio,2003,14658,13053,1605,10.9
72,65,Hatillo Municipio,2003,12651,10929,1722,13.6
72,67,Hormigueros Municipio,2003,6518,5755,763,11.7
72,69,Humacao Municipio,2003,21042,17812,3230,15.4
72,71,Isabela Municipio,2003,14864,12650,2214,14.9
72,73,Jayuya Municipio,2003,4952,4310,642,13.0
72,75,Juana Diaz Municipio,2003,15783,13600,2183,13.8
72,77,Juncos Municipio,2003,12679,11009,1670,13.2
72,79,Lajas Municipio,2003,8366,7222,1144,13.7
72,81,Lares Municipio,2003,10905,9402,1503,13.8
72,83,Las Marias Municipio,2003,3965,3422,543,13.7
72,85,Las Piedras Municipio,2003,12347,10601,1746,14.1
72,87,Loiza Municipio,2003,8822,7591,1231,14.0
72,89,Luquillo Municipio,2003,7072,5781,1291,18.3
72,91,Manati Municipio,2003,14588,12403,2185,15.0
72,93,Maricao Municipio,2003,2212,1920,292,13.2
72,95,Maunabo Municipio,2003,3792,3026,766,20.2
72,97,Mayaguez Municipio,2003,31725,27037,4688,14.8
72,99,Moca Municipio,2003,14059,12019,2040,14.5
72,101,Morovis Municipio,2003,8975,7663,1312,14.6
72,103,Naguabo Municipio,2003,7575,6368,1207,15.9
72,105,Naranjito Municipio,2003,8692,7674,1018,11.7
72,107,Orocovis Municipio,2003,5408,4593,815,15.1
72,109,Patillas Municipio,2003,5852,4761,1091,18.6
72,111,Penuelas Municipio,2003,8151,6791,1360,16.7
72,113,Ponce Municipio,2003,60829,53311,7518,12.4
72,115,Quebradillas Municipio,2003,8546,7409,1137,13.3
72,117,Rincon Municipio,2003,5118,4414,704,13.8
72,119,Rio Grande Municipio,2003,17868,15541,2327,13.0
72,121,Sabana Grande Municipio,2003,8822,7569,1253,14.2
72,123,Salinas Municipio,2003,8916,7390,1526,17.1
72,125,San German Municipio,2003,12551,10769,1782,14.2
72,127,San Juan Municipio,2003,175396,160298,15098,8.6
72,129,San Lorenzo Municipio,2003,13993,12328,1665,11.9
72,131,San Sebastian Municipio,2003,14598,12345,2253,15.4
72,133,Santa Isabel Municipio,2003,9027,7862,1165,12.9
72,135,Toa Alta Municipio,2003,26919,24620,2299,8.5
72,137,Toa Baja Municipio,2003,36090,32736,3354,9.3
72,139,Trujillo Alto Municipio,2003,33536,30780,2756,8.2
72,141,Utuado Municipio,2003,9539,8055,1484,15.6
72,143,Vega Alta Municipio,2003,12451,10971,1480,11.9
72,145,Vega Baja Municipio,2003,20789,18031,2758,13.3
72,147,Vieques Municipio,2003,2664,2234,430,16.1
72,149,Villalba Municipio,2003,8393,7134,1259,15.0
72,151,Yabucoa Municipio,2003,11393,9162,2231,19.6
72,153,Yauco Municipio,2003,15161,12974,2187,14.4
1,1,Autauga,2004,23241,22146,1095,4.7
1,3,Baldwin,2004,74843,71061,3782,5.1
1,5,Barbour,2004,10639,9884,755,7.1
1,7,Bibb,2004,8851,8375,476,5.4
1,9,Blount,2004,26237,25149,1088,4.1
1,11,Bullock,2004,3879,3437,442,11.4
1,13,Butler,2004,9090,8240,850,9.4
1,15,Calhoun,2004,54074,51164,2910,5.4
1,17,Chambers,2004,16617,15468,1149,6.9
1,19,Cherokee,2004,12072,11501,571,4.7
1,21,Chilton,2004,19650,18738,912,4.6
1,23,Choctaw,2004,5465,5002,463,8.5
1,25,Clarke,2004,10395,9483,912,8.8
1,27,Clay,2004,5894,5525,369,6.3
1,29,Cleburne,2004,6689,6340,349,5.2
1,31,Coffee,2004,20240,19173,1067,5.3
1,33,Colbert,2004,24766,23030,1736,7.0
1,35,Conecuh,2004,5063,4639,424,8.4
1,37,Coosa,2004,4914,4569,345,7.0
1,39,Covington,2004,17185,16051,1134,6.6
1,41,Crenshaw,2004,5822,5428,394,6.8
1,43,Cullman,2004,38522,36544,1978,5.1
1,45,Dale,2004,20524,19439,1085,5.3
1,47,Dallas,2004,16375,14754,1621,9.9
1,49,DeKalb,2004,32081,30251,1830,5.7
1,51,Elmore,2004,33317,31718,1599,4.8
1,53,Escambia,2004,14313,13243,1070,7.5
1,55,Etowah,2004,47203,44228,2975,6.3
1,57,Fayette,2004,7881,7343,538,6.8
1,59,Franklin,2004,13452,12527,925,6.9
1,61,Geneva,2004,11700,11132,568,4.9
1,63,Greene,2004,3484,3184,300,8.6
1,65,Hale,2004,7052,6528,524,7.4
1,67,Henry,2004,7554,7136,418,5.5
1,69,Houston,2004,45962,43838,2124,4.6
1,71,Jackson,2004,27054,25230,1824,6.7
1,73,Jefferson,2004,320629,303868,16761,5.2
1,75,Lamar,2004,6385,5867,518,8.1
1,77,Lauderdale,2004,41390,38777,2613,6.3
1,79,Lawrence,2004,16003,14992,1011,6.3
1,81,Lee,2004,62567,59815,2752,4.4
1,83,Limestone,2004,34683,32921,1762,5.1
1,85,Lowndes,2004,4965,4511,454,9.1
1,87,Macon,2004,8622,8031,591,6.9
1,89,Madison,2004,157774,150549,7225,4.6
1,91,Marengo,2004,8855,8320,535,6.0
1,93,Marion,2004,13332,12492,840,6.3
1,95,Marshall,2004,41615,39619,1996,4.8
1,97,Mobile,2004,179039,167474,11565,6.5
1,99,Monroe,2004,9712,8994,718,7.4
1,101,Montgomery,2004,104837,98882,5955,5.7
1,103,Morgan,2004,56042,52679,3363,6.0
1,105,Perry,2004,3696,3326,370,10.0
1,107,Pickens,2004,8030,7430,600,7.5
1,109,Pike,2004,15097,14295,802,5.3
1,111,Randolph,2004,10053,9386,667,6.6
1,113,Russell,2004,21371,19989,1382,6.5
1,115,St. Clair,2004,33124,31489,1635,4.9
1,117,Shelby,2004,91642,88582,3060,3.3
1,119,Sumter,2004,4974,4506,468,9.4
1,121,Talladega,2004,38846,36247,2599,6.7
1,123,Tallapoosa,2004,18383,17255,1128,6.1
1,125,Tuscaloosa,2004,83358,79467,3891,4.7
1,127,Walker,2004,30180,28361,1819,6.0
1,129,Washington,2004,6939,6285,654,9.4
1,131,Wilcox,2004,3725,3282,443,11.9
1,133,Winston,2004,10343,9598,745,7.2
2,13,Aleutians East Borough,2004,1115,1019,96,8.6
2,16,Aleutians West Census Area,2004,3077,2878,199,6.5
2,20,Anchorage Borough/municipality,2004,146603,137927,8676,5.9
2,50,Bethel Census Area,2004,7018,6131,887,12.6
2,60,Bristol Bay Borough,2004,1042,976,66,6.3
2,68,Denali Borough,2004,1519,1399,120,7.9
2,70,Dillingham Census Area,2004,2053,1830,223,10.9
2,90,Fairbanks North Star Borough,2004,44147,41305,2842,6.4
2,100,Haines Borough,2004,1412,1272,140,9.9
2,110,Juneau Borough/city,2004,17972,16923,1049,5.8
2,122,Kenai Peninsula Borough,2004,25364,22937,2427,9.6
2,130,Ketchikan Gateway Borough,2004,7893,7303,590,7.5
2,150,Kodiak Island Borough,2004,6185,5640,545,8.8
2,158,Kusilvak Census Area,2004,2505,2000,505,20.2
2,164,Lake and Peninsula Borough,2004,916,826,90,9.8
2,170,Matanuska-Susitna Borough,2004,34539,31660,2879,8.3
2,180,Nome Census Area,2004,3955,3496,459,11.6
2,185,North Slope Borough,2004,3674,3299,375,10.2
2,188,Northwest Arctic Borough,2004,2875,2492,383,13.3
2,201,Prince of Wales-Outer Ketchikan Census Area,2004,2558,2213,345,13.5
2,220,Sitka Borough/city,2004,4589,4300,289,6.3
2,232,Skagway-Hoonah-Angoon Census Area,2004,1766,1533,233,13.2
2,240,Southeast Fairbanks Census Area,2004,2769,2437,332,12.0
2,261,Valdez-Cordova Census Area,2004,5389,4854,535,9.9
2,280,Wrangell-Petersburg Census Area,2004,2923,2562,361,12.4
2,282,Yakutat Borough/city,2004,307,274,33,10.7
2,290,Yukon-Koyukuk Census Area,2004,3305,2910,395,12.0
4,1,Apache,2004,20334,18016,2318,11.4
4,3,Cochise,2004,54516,51827,2689,4.9
4,5,Coconino,2004,66783,63242,3541,5.3
4,7,Gila,2004,20694,19375,1319,6.4
4,9,Graham,2004,12047,11249,798,6.6
4,11,Greenlee,2004,3435,3260,175,5.1
4,12,La Paz,2004,7599,7091,508,6.7
4,13,Maricopa,2004,1784961,1706380,78581,4.4
4,15,Mohave,2004,84407,80703,3704,4.4
4,17,Navajo,2004,37779,34579,3200,8.5
4,19,Pima,2004,437675,417344,20331,4.6
4,21,Pinal,2004,81751,76867,4884,6.0
4,23,Santa Cruz,2004,15564,14093,1471,9.5
4,25,Yavapai,2004,87596,83565,4031,4.6
4,27,Yuma,2004,73482,61978,11504,15.7
5,1,Arkansas,2004,10862,10224,638,5.9
5,3,Ashley,2004,9690,8791,899,9.3
5,5,Baxter,2004,16452,15452,1000,6.1
5,7,Benton,2004,93192,89882,3310,3.6
5,9,Boone,2004,16241,15296,945,5.8
5,11,Bradley,2004,5552,5132,420,7.6
5,13,Calhoun,2004,2590,2417,173,6.7
5,15,Carroll,2004,13376,12736,640,4.8
5,17,Chicot,2004,4916,4386,530,10.8
5,19,Clark,2004,11099,10425,674,6.1
5,21,Clay,2004,7317,6738,579,7.9
5,23,Cleburne,2004,11112,10523,589,5.3
5,25,Cleveland,2004,4156,3883,273,6.6
5,27,Columbia,2004,10796,10103,693,6.4
5,29,Conway,2004,9442,8907,535,5.7
5,31,Craighead,2004,44255,41887,2368,5.4
5,33,Crawford,2004,26261,24934,1327,5.1
5,35,Crittenden,2004,21848,20366,1482,6.8
5,37,Cross,2004,8565,7881,684,8.0
5,39,Dallas,2004,3788,3511,277,7.3
5,41,Desha,2004,6033,5496,537,8.9
5,43,Drew,2004,8643,7969,674,7.8
5,45,Faulkner,2004,49940,47504,2436,4.9
5,47,Franklin,2004,8186,7800,386,4.7
5,49,Fulton,2004,4984,4687,297,6.0
5,51,Garland,2004,40679,38211,2468,6.1
5,53,Grant,2004,8430,7975,455,5.4
5,55,Greene,2004,17841,16765,1076,6.0
5,57,Hempstead,2004,10855,10223,632,5.8
5,59,Hot Spring,2004,14637,13762,875,6.0
5,61,Howard,2004,6375,5998,377,5.9
5,63,Independence,2004,17412,16330,1082,6.2
5,65,Izard,2004,5213,4858,355,6.8
5,67,Jackson,2004,7808,7142,666,8.5
5,69,Jefferson,2004,36537,33720,2817,7.7
5,71,Johnson,2004,10843,10268,575,5.3
5,73,Lafayette,2004,3297,3065,232,7.0
5,75,Lawrence,2004,7558,6961,597,7.9
5,77,Lee,2004,3450,3069,381,11.0
5,79,Lincoln,2004,5157,4766,391,7.6
5,81,Little River,2004,6451,6139,312,4.8
5,83,Logan,2004,9945,9417,528,5.3
5,85,Lonoke,2004,29099,27761,1338,4.6
5,87,Madison,2004,7437,7137,300,4.0
5,89,Marion,2004,6561,6175,386,5.9
5,91,Miller,2004,18873,17966,907,4.8
5,93,Mississippi,2004,19736,17791,1945,9.9
5,95,Monroe,2004,3831,3565,266,6.9
5,97,Montgomery,2004,4231,4006,225,5.3
5,99,Nevada,2004,4376,4117,259,5.9
5,101,Newton,2004,3578,3362,216,6.0
5,103,Ouachita,2004,12316,11488,828,6.7
5,105,Perry,2004,4857,4586,271,5.6
5,107,Phillips,2004,9023,8216,807,8.9
5,109,Pike,2004,5118,4844,274,5.4
5,111,Poinsett,2004,11250,10543,707,6.3
5,113,Polk,2004,8433,7934,499,5.9
5,115,Pope,2004,27511,26061,1450,5.3
5,117,Prairie,2004,4369,4141,228,5.2
5,119,Pulaski,2004,186044,176555,9489,5.1
5,121,Randolph,2004,7721,7094,627,8.1
5,123,St. Francis,2004,10646,9679,967,9.1
5,125,Saline,2004,45332,43272,2060,4.5
5,127,Scott,2004,4583,4351,232,5.1
5,129,Searcy,2004,3335,3147,188,5.6
5,131,Sebastian,2004,57393,54696,2697,4.7
5,133,Sevier,2004,7525,7182,343,4.6
5,135,Sharp,2004,6481,5978,503,7.8
5,137,Stone,2004,4470,4139,331,7.4
5,139,Union,2004,19767,18336,1431,7.2
5,141,Van Buren,2004,6932,6455,477,6.9
5,143,Washington,2004,94439,90887,3552,3.8
5,145,White,2004,31864,29853,2011,6.3
5,147,Woodruff,2004,3493,3149,344,9.8
5,149,Yell,2004,9980,9485,495,5.0
6,1,Alameda,2004,741445,697890,43555,5.9
6,3,Alpine,2004,534,491,43,8.1
6,5,Amador,2004,16903,15925,978,5.8
6,7,Butte,2004,97416,90228,7188,7.4
6,9,Calaveras,2004,19952,18597,1355,6.8
6,11,Colusa,2004,9512,8212,1300,13.7
6,13,Contra Costa,2004,507634,480045,27589,5.4
6,15,Del Norte,2004,10624,9767,857,8.1
6,17,El Dorado,2004,88815,84134,4681,5.3
6,19,Fresno,2004,404256,362032,42224,10.4
6,21,Glenn,2004,11450,10380,1070,9.3
6,23,Humboldt,2004,60389,56467,3922,6.5
6,25,Imperial,2004,59445,49310,10135,17.0
6,27,Inyo,2004,9245,8752,493,5.3
6,29,Kern,2004,314419,283268,31151,9.9
6,31,Kings,2004,53157,47300,5857,11.0
6,33,Lake,2004,25761,23431,2330,9.0
6,35,Lassen,2004,12179,11254,925,7.6
6,37,Los Angeles,2004,4747221,4440564,306657,6.5
6,39,Madera,2004,61095,55497,5598,9.2
6,41,Marin,2004,129117,123406,5711,4.4
6,43,Mariposa,2004,8568,7993,575,6.7
6,45,Mendocino,2004,43851,41034,2817,6.4
6,47,Merced,2004,97619,86953,10666,10.9
6,49,Modoc,2004,4048,3693,355,8.8
6,51,Mono,2004,8284,7865,419,5.1
6,53,Monterey,2004,207192,190014,17178,8.3
6,55,Napa,2004,71150,67772,3378,4.7
6,57,Nevada,2004,48684,46100,2584,5.3
6,59,Orange,2004,1568647,1502003,66644,4.2
6,61,Placer,2004,158479,150890,7589,4.8
6,63,Plumas,2004,10395,9375,1020,9.8
6,65,Riverside,2004,817506,768504,49002,6.0
6,67,Sacramento,2004,658903,621900,37003,5.6
6,69,San Benito,2004,25073,22672,2401,9.6
6,71,San Bernardino,2004,828995,781215,47780,5.8
6,73,San Diego,2004,1478132,1408251,69881,4.7
6,75,San Francisco/city,2004,418405,394208,24197,5.8
6,77,San Joaquin,2004,281364,256769,24595,8.7
6,79,San Luis Obispo,2004,129513,123591,5922,4.6
6,81,San Mateo,2004,361389,343829,17560,4.9
6,83,Santa Barbara,2004,210925,200942,9983,4.7
6,85,Santa Clara,2004,821441,768603,52838,6.4
6,87,Santa Cruz,2004,143438,133367,10071,7.0
6,89,Shasta,2004,82417,76145,6272,7.6
6,91,Sierra,2004,1581,1428,153,9.7
6,93,Siskiyou,2004,18970,17174,1796,9.5
6,95,Solano,2004,206246,194237,12009,5.8
6,97,Sonoma,2004,253923,241347,12576,5.0
6,99,Stanislaus,2004,223641,203006,20635,9.2
6,101,Sutter,2004,40045,35800,4245,10.6
6,103,Tehama,2004,25284,23413,1871,7.4
6,105,Trinity,2004,5237,4662,575,11.0
6,107,Tulare,2004,179756,158913,20843,11.6
6,109,Tuolumne,2004,25545,23776,1769,6.9
6,111,Ventura,2004,412174,390075,22099,5.4
6,113,Yolo,2004,91887,86304,5583,6.1
6,115,Yuba,2004,25232,22784,2448,9.7
8,1,Adams,2004,205757,192416,13341,6.5
8,3,Alamosa,2004,8280,7787,493,6.0
8,5,Arapahoe,2004,296885,280156,16729,5.6
8,7,Archuleta,2004,5800,5479,321,5.5
8,9,Baca,2004,2364,2278,86,3.6
8,11,Bent,2004,2407,2253,154,6.4
8,13,Boulder,2004,167050,158840,8210,4.9
8,14,Broomfield/city,2004,24178,22786,1392,5.8
8,15,Chaffee,2004,8107,7626,481,5.9
8,17,Cheyenne,2004,1332,1291,41,3.1
8,19,Clear Creek,2004,5888,5552,336,5.7
8,21,Conejos,2004,3819,3514,305,8.0
8,23,Costilla,2004,1363,1216,147,10.8
8,25,Crowley,2004,1631,1498,133,8.2
8,27,Custer,2004,2029,1923,106,5.2
8,29,Delta,2004,14644,13845,799,5.5
8,31,Denver/city,2004,304032,284045,19987,6.6
8,33,Dolores,2004,978,913,65,6.6
8,35,Douglas,2004,136903,130546,6357,4.6
8,37,Eagle,2004,27384,26180,1204,4.4
8,39,Elbert,2004,12761,12136,625,4.9
8,41,El Paso,2004,286362,269894,16468,5.8
8,43,Fremont,2004,18946,17651,1295,6.8
8,45,Garfield,2004,28286,27080,1206,4.3
8,47,Gilpin,2004,3319,3137,182,5.5
8,49,Grand,2004,8512,8155,357,4.2
8,51,Gunnison,2004,8738,8372,366,4.2
8,53,Hinsdale,2004,604,584,20,3.3
8,55,Huerfano,2004,3298,3026,272,8.2
8,57,Jackson,2004,1114,1074,40,3.6
8,59,Jefferson,2004,306184,289662,16522,5.4
8,61,Kiowa,2004,903,856,47,5.2
8,63,Kit Carson,2004,4310,4158,152,3.5
8,65,Lake,2004,3901,3679,222,5.7
8,67,La Plata,2004,28308,27139,1169,4.1
8,69,Larimer,2004,164166,156522,7644,4.7
8,71,Las Animas,2004,8002,7564,438,5.5
8,73,Lincoln,2004,3047,2918,129,4.2
8,75,Logan,2004,10775,10306,469,4.4
8,77,Mesa,2004,69539,65746,3793,5.5
8,79,Mineral,2004,471,449,22,4.7
8,81,Moffat,2004,7718,7333,385,5.0
8,83,Montezuma,2004,12621,11919,702,5.6
8,85,Montrose,2004,19155,18130,1025,5.4
8,87,Morgan,2004,14339,13685,654,4.6
8,89,Otero,2004,9345,8770,575,6.2
8,91,Ouray,2004,2683,2575,108,4.0
8,93,Park,2004,9608,9087,521,5.4
8,95,Phillips,2004,2357,2271,86,3.6
8,97,Pitkin,2004,10713,10181,532,5.0
8,99,Prowers,2004,7416,7084,332,4.5
8,101,Pueblo,2004,69342,64168,5174,7.5
8,103,Rio Blanco,2004,3777,3631,146,3.9
8,105,Rio Grande,2004,6571,6168,403,6.1
8,107,Routt,2004,14158,13600,558,3.9
8,109,Saguache,2004,3104,2884,220,7.1
8,111,San Juan,2004,539,506,33,6.1
8,113,San Miguel,2004,5049,4808,241,4.8
8,115,Sedgwick,2004,1584,1532,52,3.3
8,117,Summit,2004,16095,15406,689,4.3
8,119,Teller,2004,12525,11819,706,5.6
8,121,Washington,2004,2802,2689,113,4.0
8,123,Weld,2004,109382,103158,6224,5.7
8,125,Yuma,2004,6136,5935,201,3.3
9,1,Fairfield,2004,448894,428327,20567,4.6
9,3,Hartford,2004,432772,408322,24450,5.6
9,5,Litchfield,2004,101528,96575,4953,4.9
9,7,Middlesex,2004,87863,84054,3809,4.3
9,9,New Haven,2004,425722,402473,23249,5.5
9,11,New London,2004,141696,135100,6596,4.7
9,13,Tolland,2004,79482,76102,3380,4.3
9,15,Windham,2004,59563,56171,3392,5.7
10,1,Kent,2004,69138,66524,2614,3.8
10,3,New Castle,2004,266557,254421,12136,4.6
10,5,Sussex,2004,85397,82046,3351,3.9
11,1,District of Colu,2004,313735,288323,25412,8.1
12,1,Alachua,2004,119434,115973,3461,2.9
12,3,Baker,2004,10520,10172,348,3.3
12,5,Bay,2004,78122,75240,2882,3.7
12,7,Bradford,2004,11494,11123,371,3.2
12,9,Brevard,2004,247146,237869,9277,3.8
12,11,Broward,2004,915950,880496,35454,3.9
12,13,Calhoun,2004,5238,5029,209,4.0
12,15,Charlotte,2004,60863,58148,2715,4.5
12,17,Citrus,2004,47716,45536,2180,4.6
12,19,Clay,2004,80983,78119,2864,3.5
12,21,Collier,2004,137743,132876,4867,3.5
12,23,Columbia,2004,27039,26070,969,3.6
12,27,DeSoto,2004,13328,12689,639,4.8
12,29,Dixie,2004,5017,4800,217,4.3
12,31,Duval,2004,407077,390046,17031,4.2
12,33,Escambia,2004,130745,125536,5209,4.0
12,35,Flagler,2004,27089,25914,1175,4.3
12,37,Franklin,2004,5059,4909,150,3.0
12,39,Gadsden,2004,19801,19022,779,3.9
12,41,Gilchrist,2004,7080,6847,233,3.3
12,43,Glades,2004,4451,4249,202,4.5
12,45,Gulf,2004,5919,5728,191,3.2
12,47,Hamilton,2004,4515,4333,182,4.0
12,49,Hardee,2004,10799,10244,555,5.1
12,51,Hendry,2004,16716,15542,1174,7.0
12,53,Hernando,2004,55215,52579,2636,4.8
12,55,Highlands,2004,37359,35723,1636,4.4
12,57,Hillsborough,2004,564277,543539,20738,3.7
12,59,Holmes,2004,7917,7619,298,3.8
12,61,Indian River,2004,55430,52264,3166,5.7
12,63,Jackson,2004,20707,20015,692,3.3
12,65,Jefferson,2004,6579,6377,202,3.1
12,67,Lafayette,2004,2779,2702,77,2.8
12,69,Lake,2004,109599,105455,4144,3.8
12,71,Lee,2004,249838,241402,8436,3.4
12,73,Leon,2004,132912,128757,4155,3.1
12,75,Levy,2004,15471,14860,611,3.9
12,77,Liberty,2004,3119,3027,92,2.9
12,79,Madison,2004,7116,6801,315,4.4
12,81,Manatee,2004,141406,136480,4926,3.5
12,83,Marion,2004,118625,113984,4641,3.9
12,85,Martin,2004,61579,58991,2588,4.2
12,86,Miami-Dade,2004,1080088,1046521,33567,3.1
12,87,Monroe,2004,45698,44527,1171,2.6
12,89,Nassau,2004,31004,29941,1063,3.4
12,91,Okaloosa,2004,92454,89923,2531,2.7
12,93,Okeechobee,2004,15980,15144,836,5.2
12,95,Orange,2004,526175,506351,19824,3.8
12,97,Osceola,2004,108661,104335,4326,4.0
12,99,Palm Beach,2004,592012,566247,25765,4.4
12,101,Pasco,2004,171972,164630,7342,4.3
12,103,Pinellas,2004,461074,443807,17267,3.7
12,105,Polk,2004,246790,236571,10219,4.1
12,107,Putnam,2004,30434,29075,1359,4.5
12,109,St. Johns,2004,76752,74387,2365,3.1
12,111,St. Lucie,2004,103020,97567,5453,5.3
12,113,Santa Rosa,2004,62652,60369,2283,3.6
12,115,Sarasota,2004,166600,160930,5670,3.4
12,117,Seminole,2004,217182,209457,7725,3.6
12,119,Sumter,2004,20862,20066,796,3.8
12,121,Suwannee,2004,16026,15453,573,3.6
12,123,Taylor,2004,8292,7920,372,4.5
12,125,Union,2004,4858,4711,147,3.0
12,127,Volusia,2004,232228,223277,8951,3.9
12,129,Wakulla,2004,13443,13051,392,2.9
12,131,Walton,2004,24277,23574,703,2.9
12,133,Washington,2004,9012,8670,342,3.8
13,1,Appling,2004,8240,7684,556,6.7
13,3,Atkinson,2004,3604,3305,299,8.3
13,5,Bacon,2004,4316,4072,244,5.7
13,7,Baker,2004,1803,1717,86,4.8
13,9,Baldwin,2004,20209,19174,1035,5.1
13,11,Banks,2004,8804,8467,337,3.8
13,13,Barrow,2004,28796,27403,1393,4.8
13,15,Bartow,2004,43325,40871,2454,5.7
13,17,Ben Hill,2004,7906,7495,411,5.2
13,19,Berrien,2004,8610,8269,341,4.0
13,21,Bibb,2004,72766,68802,3964,5.4
13,23,Bleckley,2004,5124,4798,326,6.4
13,25,Brantley,2004,7352,6957,395,5.4
13,27,Brooks,2004,8074,7769,305,3.8
13,29,Bryan,2004,14359,13809,550,3.8
13,31,Bulloch,2004,29106,27692,1414,4.9
13,33,Burke,2004,10041,9308,733,7.3
13,35,Butts,2004,8879,8350,529,6.0
13,37,Calhoun,2004,2335,2188,147,6.3
13,39,Camden,2004,19122,18201,921,4.8
13,43,Candler,2004,4406,4187,219,5.0
13,45,Carroll,2004,48878,46284,2594,5.3
13,47,Catoosa,2004,33980,32696,1284,3.8
13,49,Charlton,2004,4229,4004,225,5.3
13,51,Chatham,2004,121735,116194,5541,4.6
13,53,Chattahoochee,2004,2777,2511,266,9.6
13,55,Chattooga,2004,10991,10401,590,5.4
13,57,Cherokee,2004,94466,90551,3915,4.1
13,59,Clarke,2004,57996,55464,2532,4.4
13,61,Clay,2004,1450,1367,83,5.7
13,63,Clayton,2004,133128,124776,8352,6.3
13,65,Clinch,2004,2429,2276,153,6.3
13,67,Cobb,2004,363009,345931,17078,4.7
13,69,Coffee,2004,17372,16242,1130,6.5
13,71,Colquitt,2004,18265,17320,945,5.2
13,73,Columbia,2004,55131,52858,2273,4.1
13,75,Cook,2004,6867,6477,390,5.7
13,77,Coweta,2004,53172,50832,2340,4.4
13,79,Crawford,2004,6238,5916,322,5.2
13,81,Crisp,2004,9864,9291,573,5.8
13,83,Dade,2004,8344,7977,367,4.4
13,85,Dawson,2004,9905,9485,420,4.2
13,87,Decatur,2004,11687,10856,831,7.1
13,89,DeKalb,2004,364652,343292,21360,5.9
13,91,Dodge,2004,8543,8081,462,5.4
13,93,Dooly,2004,4570,4279,291,6.4
13,95,Dougherty,2004,41293,38641,2652,6.4
13,97,Douglas,2004,56127,53215,2912,5.2
13,99,Early,2004,5616,5313,303,5.4
13,101,Echols,2004,2189,2117,72,3.3
13,103,Effingham,2004,23778,22817,961,4.0
13,105,Elbert,2004,9973,9379,594,6.0
13,107,Emanuel,2004,10346,9769,577,5.6
13,109,Evans,2004,4748,4541,207,4.4
13,111,Fannin,2004,9759,9237,522,5.3
13,113,Fayette,2004,51197,49147,2050,4.0
13,115,Floyd,2004,49340,46832,2508,5.1
13,117,Forsyth,2004,70365,67744,2621,3.7
13,119,Franklin,2004,10348,9785,563,5.4
13,121,Fulton,2004,450132,425258,24874,5.5
13,123,Gilmer,2004,12818,12247,571,4.5
13,125,Glascock,2004,1197,1135,62,5.2
13,127,Glynn,2004,37543,35909,1634,4.4
13,129,Gordon,2004,25585,24355,1230,4.8
13,131,Grady,2004,11087,10552,535,4.8
13,133,Greene,2004,6412,5992,420,6.6
13,135,Gwinnett,2004,382611,365309,17302,4.5
13,137,Habersham,2004,19380,18592,788,4.1
13,139,Hall,2004,80269,76834,3435,4.3
13,141,Hancock,2004,3341,3100,241,7.2
13,143,Haralson,2004,12656,11958,698,5.5
13,145,Harris,2004,14672,14027,645,4.4
13,147,Hart,2004,11024,10427,597,5.4
13,149,Heard,2004,4893,4611,282,5.8
13,151,Henry,2004,83190,79268,3922,4.7
13,153,Houston,2004,60439,57850,2589,4.3
13,155,Irwin,2004,4406,4182,224,5.1
13,157,Jackson,2004,23962,22849,1113,4.6
13,159,Jasper,2004,6061,5737,324,5.3
13,161,Jeff Davis,2004,5389,4980,409,7.6
13,163,Jefferson,2004,7161,6554,607,8.5
13,165,Jenkins,2004,3303,3084,219,6.6
13,167,Johnson,2004,3737,3517,220,5.9
13,169,Jones,2004,13403,12791,612,4.6
13,171,Lamar,2004,7715,7251,464,6.0
13,173,Lanier,2004,3662,3520,142,3.9
13,175,Laurens,2004,21976,20679,1297,5.9
13,177,Lee,2004,15730,15140,590,3.8
13,179,Liberty,2004,22241,20941,1300,5.8
13,181,Lincoln,2004,3551,3313,238,6.7
13,183,Long,2004,5247,5022,225,4.3
13,185,Lowndes,2004,48816,46981,1835,3.8
13,187,Lumpkin,2004,11855,11317,538,4.5
13,189,McDuffie,2004,10528,9878,650,6.2
13,191,McIntosh,2004,5103,4851,252,4.9
13,193,Macon,2004,5260,4813,447,8.5
13,195,Madison,2004,14966,14304,662,4.4
13,197,Marion,2004,3350,3154,196,5.9
13,199,Meriwether,2004,9720,9036,684,7.0
13,201,Miller,2004,3445,3288,157,4.6
13,205,Mitchell,2004,9901,9282,619,6.3
13,207,Monroe,2004,12455,11887,568,4.6
13,209,Montgomery,2004,4212,3964,248,5.9
13,211,Morgan,2004,8601,8215,386,4.5
13,213,Murray,2004,20726,19837,889,4.3
13,215,Muscogee,2004,83998,78994,5004,6.0
13,217,Newton,2004,39638,37426,2212,5.6
13,219,Oconee,2004,16109,15581,528,3.3
13,221,Oglethorpe,2004,7295,6977,318,4.4
13,223,Paulding,2004,55074,52533,2541,4.6
13,225,Peach,2004,11215,10434,781,7.0
13,227,Pickens,2004,13895,13306,589,4.2
13,229,Pierce,2004,8077,7702,375,4.6
13,231,Pike,2004,7449,7059,390,5.2
13,233,Polk,2004,19709,18674,1035,5.3
13,235,Pulaski,2004,4261,4054,207,4.9
13,237,Putnam,2004,9471,9022,449,4.7
13,239,Quitman,2004,956,892,64,6.7
13,241,Rabun,2004,7512,7212,300,4.0
13,243,Randolph,2004,2827,2610,217,7.7
13,245,Richmond,2004,90411,84721,5690,6.3
13,247,Rockdale,2004,37979,35951,2028,5.3
13,249,Schley,2004,1744,1634,110,6.3
13,251,Screven,2004,6693,6318,375,5.6
13,253,Seminole,2004,3836,3607,229,6.0
13,255,Spalding,2004,27607,25810,1797,6.5
13,257,Stephens,2004,12883,12030,853,6.6
13,259,Stewart,2004,1911,1695,216,11.3
13,261,Sumter,2004,14540,13631,909,6.3
13,263,Talbot,2004,2996,2797,199,6.6
13,265,Taliaferro,2004,719,670,49,6.8
13,267,Tattnall,2004,8553,8062,491,5.7
13,269,Taylor,2004,3216,2985,231,7.2
13,271,Telfair,2004,4160,3825,335,8.1
13,273,Terrell,2004,4636,4346,290,6.3
13,275,Thomas,2004,21332,20306,1026,4.8
13,277,Tift,2004,19073,18162,911,4.8
13,279,Toombs,2004,12466,11677,789,6.3
13,281,Towns,2004,5359,5151,208,3.9
13,283,Treutlen,2004,2687,2508,179,6.7
13,285,Troup,2004,30049,28228,1821,6.1
13,287,Turner,2004,5078,4784,294,5.8
13,289,Twiggs,2004,4679,4410,269,5.7
13,291,Union,2004,9840,9406,434,4.4
13,293,Upson,2004,11761,11002,759,6.5
13,295,Walker,2004,32330,30856,1474,4.6
13,297,Walton,2004,35705,34001,1704,4.8
13,299,Ware,2004,14688,13852,836,5.7
13,301,Warren,2004,2578,2385,193,7.5
13,303,Washington,2004,8239,7756,483,5.9
13,305,Wayne,2004,11545,10844,701,6.1
13,307,Webster,2004,1044,964,80,7.7
13,309,Wheeler,2004,2418,2263,155,6.4
13,311,White,2004,11543,11041,502,4.3
13,313,Whitfield,2004,44694,42664,2030,4.5
13,315,Wilcox,2004,3271,3076,195,6.0
13,317,Wilkes,2004,4565,4204,361,7.9
13,319,Wilkinson,2004,4500,4252,248,5.5
13,321,Worth,2004,10310,9751,559,5.4
15,1,Hawaii,2004,78441,75348,3093,3.9
15,3,Honolulu/city,2004,428584,414890,13694,3.2
15,7,Kauai,2004,31241,30171,1070,3.4
15,9,Maui,2004,73485,71185,2300,3.1
16,1,Ada,2004,178256,171101,7155,4.0
16,3,Adams,2004,1858,1638,220,11.8
16,5,Bannock,2004,39765,37908,1857,4.7
16,7,Bear Lake,2004,3026,2882,144,4.8
16,9,Benewah,2004,3992,3635,357,8.9
16,11,Bingham,2004,20507,19601,906,4.4
16,13,Blaine,2004,13341,12862,479,3.6
16,15,Boise,2004,3557,3377,180,5.1
16,17,Bonner,2004,19376,18198,1178,6.1
16,19,Bonneville,2004,46643,45036,1607,3.4
16,21,Boundary,2004,4304,3999,305,7.1
16,23,Butte,2004,1290,1206,84,6.5
16,25,Camas,2004,574,548,26,4.5
16,27,Canyon,2004,75016,70802,4214,5.6
16,29,Caribou,2004,3282,3060,222,6.8
16,31,Cassia,2004,9878,9291,587,5.9
16,33,Clark,2004,542,503,39,7.2
16,35,Clearwater,2004,3367,3024,343,10.2
16,37,Custer,2004,2564,2413,151,5.9
16,39,Elmore,2004,10701,10134,567,5.3
16,41,Franklin,2004,6046,5806,240,4.0
16,43,Fremont,2004,5890,5623,267,4.5
16,45,Gem,2004,7017,6626,391,5.6
16,47,Gooding,2004,7645,7344,301,3.9
16,49,Idaho,2004,7061,6508,553,7.8
16,51,Jefferson,2004,10130,9744,386,3.8
16,53,Jerome,2004,9760,9321,439,4.5
16,55,Kootenai,2004,63558,59897,3661,5.8
16,57,Latah,2004,17805,17122,683,3.8
16,59,Lemhi,2004,3955,3677,278,7.0
16,61,Lewis,2004,1701,1636,65,3.8
16,63,Lincoln,2004,2320,2192,128,5.5
16,65,Madison,2004,13994,13568,426,3.0
16,67,Minidoka,2004,9436,8700,736,7.8
16,69,Nez Perce,2004,18816,17910,906,4.8
16,71,Oneida,2004,1969,1906,63,3.2
16,73,Owyhee,2004,4618,4491,127,2.8
16,75,Payette,2004,10289,9444,845,8.2
16,77,Power,2004,3741,3510,231,6.2
16,79,Shoshone,2004,5529,4991,538,9.7
16,81,Teton,2004,4228,4096,132,3.1
16,83,Twin Falls,2004,36306,34710,1596,4.4
16,85,Valley,2004,4215,3929,286,6.8
16,87,Washington,2004,5014,4677,337,6.7
17,1,Adams,2004,35765,34174,1591,4.4
17,3,Alexander,2004,3393,3083,310,9.1
17,5,Bond,2004,8335,7834,501,6.0
17,7,Boone,2004,23628,21901,1727,7.3
17,9,Brown,2004,3156,3030,126,4.0
17,11,Bureau,2004,18302,17213,1089,6.0
17,13,Calhoun,2004,2508,2341,167,6.7
17,15,Carroll,2004,8134,7558,576,7.1
17,17,Cass,2004,7445,7070,375,5.0
17,19,Champaign,2004,99466,95125,4341,4.4
17,21,Christian,2004,16920,15884,1036,6.1
17,23,Clark,2004,8522,7982,540,6.3
17,25,Clay,2004,6896,6440,456,6.6
17,27,Clinton,2004,18192,17263,929,5.1
17,29,Coles,2004,26965,25548,1417,5.3
17,31,Cook,2004,2567435,2392296,175139,6.8
17,33,Crawford,2004,9193,8640,553,6.0
17,35,Cumberland,2004,5691,5319,372,6.5
17,37,DeKalb,2004,52533,49823,2710,5.2
17,39,De Witt,2004,8206,7722,484,5.9
17,41,Douglas,2004,10555,10043,512,4.9
17,43,DuPage,2004,513512,487435,26077,5.1
17,45,Edgar,2004,10199,9631,568,5.6
17,47,Edwards,2004,3550,3393,157,4.4
17,49,Effingham,2004,17997,16903,1094,6.1
17,51,Fayette,2004,10064,9298,766,7.6
17,53,Ford,2004,7207,6840,367,5.1
17,55,Franklin,2004,17546,16180,1366,7.8
17,57,Fulton,2004,17297,16158,1139,6.6
17,59,Gallatin,2004,2715,2523,192,7.1
17,61,Greene,2004,6968,6559,409,5.9
17,63,Grundy,2004,22036,20312,1724,7.8
17,65,Hamilton,2004,3965,3729,236,6.0
17,67,Hancock,2004,10012,9408,604,6.0
17,69,Hardin,2004,1879,1720,159,8.5
17,71,Henderson,2004,4028,3764,264,6.6
17,73,Henry,2004,26584,25198,1386,5.2
17,75,Iroquois,2004,16006,15145,861,5.4
17,77,Jackson,2004,31620,30025,1595,5.0
17,79,Jasper,2004,5152,4839,313,6.1
17,81,Jefferson,2004,19490,18353,1137,5.8
17,83,Jersey,2004,11192,10562,630,5.6
17,85,Jo Daviess,2004,12521,11883,638,5.1
17,87,Johnson,2004,5052,4708,344,6.8
17,89,Kane,2004,246972,232510,14462,5.9
17,91,Kankakee,2004,51766,48008,3758,7.3
17,93,Kendall,2004,40508,38338,2170,5.4
17,95,Knox,2004,25762,23791,1971,7.7
17,97,Lake,2004,347103,328927,18176,5.2
17,99,LaSalle,2004,55206,51295,3911,7.1
17,101,Lawrence,2004,8303,7823,480,5.8
17,103,Lee,2004,17588,16597,991,5.6
17,105,Livingston,2004,18519,17546,973,5.3
17,107,Logan,2004,13346,12568,778,5.8
17,109,McDonough,2004,16698,15863,835,5.0
17,111,McHenry,2004,162264,153660,8604,5.3
17,113,McLean,2004,85508,81792,3716,4.3
17,115,Macon,2004,52074,48560,3514,6.7
17,117,Macoupin,2004,23952,22464,1488,6.2
17,119,Madison,2004,132236,124327,7909,6.0
17,121,Marion,2004,17833,16428,1405,7.9
17,123,Marshall,2004,6873,6534,339,4.9
17,125,Mason,2004,7651,7063,588,7.7
17,127,Massac,2004,7224,6793,431,6.0
17,129,Menard,2004,6841,6499,342,5.0
17,131,Mercer,2004,8754,8184,570,6.5
17,133,Monroe,2004,16597,15873,724,4.4
17,135,Montgomery,2004,13228,12185,1043,7.9
17,137,Morgan,2004,17744,16661,1083,6.1
17,139,Moultrie,2004,7668,7290,378,4.9
17,141,Ogle,2004,25897,24322,1575,6.1
17,143,Peoria,2004,89213,84150,5063,5.7
17,145,Perry,2004,10508,9752,756,7.2
17,147,Piatt,2004,8925,8526,399,4.5
17,149,Pike,2004,8467,8011,456,5.4
17,151,Pope,2004,1988,1837,151,7.6
17,153,Pulaski,2004,2913,2659,254,8.7
17,155,Putnam,2004,3054,2857,197,6.5
17,157,Randolph,2004,15228,14376,852,5.6
17,159,Richland,2004,7249,6797,452,6.2
17,161,Rock Island,2004,75710,71799,3911,5.2
17,163,St. Clair,2004,118747,110670,8077,6.8
17,165,Saline,2004,11966,11138,828,6.9
17,167,Sangamon,2004,102734,97473,5261,5.1
17,169,Schuyler,2004,4222,4003,219,5.2
17,171,Scott,2004,2794,2609,185,6.6
17,173,Shelby,2004,11210,10554,656,5.9
17,175,Stark,2004,2760,2582,178,6.4
17,177,Stephenson,2004,24566,22959,1607,6.5
17,179,Tazewell,2004,66371,62868,3503,5.3
17,181,Union,2004,8259,7635,624,7.6
17,183,Vermilion,2004,37510,34568,2942,7.8
17,185,Wabash,2004,6556,6127,429,6.5
17,187,Warren,2004,8962,8443,519,5.8
17,189,Washington,2004,8451,8043,408,4.8
17,191,Wayne,2004,8008,7576,432,5.4
17,193,White,2004,7887,7496,391,5.0
17,195,Whiteside,2004,29259,27440,1819,6.2
17,197,Will,2004,322394,302124,20270,6.3
17,199,Williamson,2004,31628,29586,2042,6.5
17,201,Winnebago,2004,140140,130031,10109,7.2
17,203,Woodford,2004,19112,18305,807,4.2
18,1,Adams,2004,16443,15760,683,4.2
18,3,Allen,2004,176854,167415,9439,5.3
18,5,Bartholomew,2004,36125,34501,1624,4.5
18,7,Benton,2004,4602,4352,250,5.4
18,9,Blackford,2004,6726,6240,486,7.2
18,11,Boone,2004,26498,25441,1057,4.0
18,13,Brown,2004,8021,7580,441,5.5
18,15,Carroll,2004,10424,9817,607,5.8
18,17,Cass,2004,19728,18400,1328,6.7
18,19,Clark,2004,52447,49723,2724,5.2
18,21,Clay,2004,13229,12350,879,6.6
18,23,Clinton,2004,16749,15785,964,5.8
18,25,Crawford,2004,5407,5023,384,7.1
18,27,Daviess,2004,14453,13869,584,4.0
18,29,Dearborn,2004,25994,24584,1410,5.4
18,31,Decatur,2004,12529,11843,686,5.5
18,33,DeKalb,2004,21801,20567,1234,5.7
18,35,Delaware,2004,56928,53344,3584,6.3
18,37,Dubois,2004,21894,21044,850,3.9
18,39,Elkhart,2004,99369,95072,4297,4.3
18,41,Fayette,2004,11224,10312,912,8.1
18,43,Floyd,2004,36946,35089,1857,5.0
18,45,Fountain,2004,8489,8003,486,5.7
18,47,Franklin,2004,11810,11134,676,5.7
18,49,Fulton,2004,10219,9626,593,5.8
18,51,Gibson,2004,17073,16255,818,4.8
18,53,Grant,2004,33701,30786,2915,8.6
18,55,Greene,2004,16516,15514,1002,6.1
18,57,Hamilton,2004,124779,120478,4301,3.4
18,59,Hancock,2004,33160,31818,1342,4.0
18,61,Harrison,2004,19096,18039,1057,5.5
18,63,Hendricks,2004,67162,64529,2633,3.9
18,65,Henry,2004,23372,21697,1675,7.2
18,67,Howard,2004,39253,36567,2686,6.8
18,69,Huntington,2004,20500,19358,1142,5.6
18,71,Jackson,2004,21974,20941,1033,4.7
18,73,Jasper,2004,15045,14166,879,5.8
18,75,Jay,2004,11081,10439,642,5.8
18,77,Jefferson,2004,17064,16238,826,4.8
18,79,Jennings,2004,13973,13133,840,6.0
18,81,Johnson,2004,68550,65571,2979,4.3
18,83,Knox,2004,19111,18202,909,4.8
18,85,Kosciusko,2004,39781,38114,1667,4.2
18,87,LaGrange,2004,16746,16015,731,4.4
18,89,Lake,2004,223420,209075,14345,6.4
18,91,LaPorte,2004,52560,49272,3288,6.3
18,93,Lawrence,2004,22298,20699,1599,7.2
18,95,Madison,2004,63068,59214,3854,6.1
18,97,Marion,2004,458767,433432,25335,5.5
18,99,Marshall,2004,22359,21180,1179,5.3
18,101,Martin,2004,5142,4862,280,5.4
18,103,Miami,2004,17182,16021,1161,6.8
18,105,Monroe,2004,65733,62790,2943,4.5
18,107,Montgomery,2004,19614,18743,871,4.4
18,109,Morgan,2004,36807,35064,1743,4.7
18,111,Newton,2004,6992,6629,363,5.2
18,113,Noble,2004,23460,22066,1394,5.9
18,115,Ohio,2004,3107,2934,173,5.6
18,117,Orange,2004,9086,8399,687,7.6
18,119,Owen,2004,11634,11003,631,5.4
18,121,Parke,2004,8001,7496,505,6.3
18,123,Perry,2004,9665,9125,540,5.6
18,125,Pike,2004,6210,5868,342,5.5
18,127,Porter,2004,79331,75421,3910,4.9
18,129,Posey,2004,13749,13120,629,4.6
18,131,Pulaski,2004,6790,6428,362,5.3
18,133,Putnam,2004,17487,16496,991,5.7
18,135,Randolph,2004,13138,12205,933,7.1
18,137,Ripley,2004,14835,14068,767,5.2
18,139,Rush,2004,9246,8790,456,4.9
18,141,St. Joseph,2004,132541,125599,6942,5.2
18,143,Scott,2004,11216,10562,654,5.8
18,145,Shelby,2004,23639,22466,1173,5.0
18,147,Spencer,2004,10557,9990,567,5.4
18,149,Starke,2004,10484,9744,740,7.1
18,151,Steuben,2004,16981,15975,1006,5.9
18,153,Sullivan,2004,9347,8642,705,7.5
18,155,Switzerland,2004,5701,5435,266,4.7
18,157,Tippecanoe,2004,77688,73954,3734,4.8
18,159,Tipton,2004,8145,7714,431,5.3
18,161,Union,2004,3758,3549,209,5.6
18,163,Vanderburgh,2004,90454,85920,4534,5.0
18,165,Vermillion,2004,8200,7522,678,8.3
18,167,Vigo,2004,50403,46707,3696,7.3
18,169,Wabash,2004,17453,16342,1111,6.4
18,171,Warren,2004,4609,4395,214,4.6
18,173,Warrick,2004,29779,28452,1327,4.5
18,175,Washington,2004,13955,13045,910,6.5
18,177,Wayne,2004,33315,30921,2394,7.2
18,179,Wells,2004,14782,14035,747,5.1
18,181,White,2004,12248,11427,821,6.7
18,183,Whitley,2004,17478,16467,1011,5.8
19,1,Adair,2004,4307,4127,180,4.2
19,3,Adams,2004,2094,1989,105,5.0
19,5,Allamakee,2004,7942,7470,472,5.9
19,7,Appanoose,2004,6459,6104,355,5.5
19,9,Audubon,2004,3349,3209,140,4.2
19,11,Benton,2004,14134,13486,648,4.6
19,13,Black Hawk,2004,70746,67511,3235,4.6
19,15,Boone,2004,15019,14489,530,3.5
19,17,Bremer,2004,13506,12991,515,3.8
19,19,Buchanan,2004,10882,10385,497,4.6
19,21,Buena Vista,2004,10338,9928,410,4.0
19,23,Butler,2004,8088,7714,374,4.6
19,25,Calhoun,2004,5121,4904,217,4.2
19,27,Carroll,2004,12294,11932,362,2.9
19,29,Cass,2004,7442,7080,362,4.9
19,31,Cedar,2004,10375,9957,418,4.0
19,33,Cerro Gordo,2004,25686,24553,1133,4.4
19,35,Cherokee,2004,6559,6271,288,4.4
19,37,Chickasaw,2004,6114,5749,365,6.0
19,39,Clarke,2004,4682,4382,300,6.4
19,41,Clay,2004,9548,9168,380,4.0
19,43,Clayton,2004,9507,8854,653,6.9
19,45,Clinton,2004,26250,24872,1378,5.2
19,47,Crawford,2004,8976,8645,331,3.7
19,49,Dallas,2004,28012,27048,964,3.4
19,51,Davis,2004,4180,3973,207,5.0
19,53,Decatur,2004,4166,3948,218,5.2
19,55,Delaware,2004,9988,9514,474,4.7
19,57,Des Moines,2004,20603,19383,1220,5.9
19,59,Dickinson,2004,10057,9651,406,4.0
19,61,Dubuque,2004,49194,47039,2155,4.4
19,63,Emmet,2004,5855,5591,264,4.5
19,65,Fayette,2004,11004,10423,581,5.3
19,67,Floyd,2004,8775,8344,431,4.9
19,69,Franklin,2004,5501,5243,258,4.7
19,71,Fremont,2004,3927,3769,158,4.0
19,73,Greene,2004,5048,4835,213,4.2
19,75,Grundy,2004,6803,6559,244,3.6
19,77,Guthrie,2004,6092,5834,258,4.2
19,79,Hamilton,2004,8649,8285,364,4.2
19,81,Hancock,2004,6387,6165,222,3.5
19,83,Hardin,2004,8986,8508,478,5.3
19,85,Harrison,2004,8039,7634,405,5.0
19,87,Henry,2004,10328,9708,620,6.0
19,89,Howard,2004,5176,4940,236,4.6
19,91,Humboldt,2004,5150,4939,211,4.1
19,93,Ida,2004,3895,3732,163,4.2
19,95,Iowa,2004,8729,8363,366,4.2
19,97,Jackson,2004,11118,10495,623,5.6
19,99,Jasper,2004,19256,18156,1100,5.7
19,101,Jefferson,2004,8194,7770,424,5.2
19,103,Johnson,2004,72727,70311,2416,3.3
19,105,Jones,2004,10374,9852,522,5.0
19,107,Keokuk,2004,5846,5564,282,4.8
19,109,Kossuth,2004,8784,8402,382,4.3
19,111,Lee,2004,17271,16057,1214,7.0
19,113,Linn,2004,111565,106318,5247,4.7
19,115,Louisa,2004,6221,5935,286,4.6
19,117,Lucas,2004,4901,4634,267,5.4
19,119,Lyon,2004,6223,6020,203,3.3
19,121,Madison,2004,7985,7606,379,4.7
19,123,Mahaska,2004,11509,10998,511,4.4
19,125,Marion,2004,17082,16351,731,4.3
19,127,Marshall,2004,20464,19405,1059,5.2
19,129,Mills,2004,8011,7676,335,4.2
19,131,Mitchell,2004,5331,5125,206,3.9
19,133,Monona,2004,4812,4537,275,5.7
19,135,Monroe,2004,3736,3538,198,5.3
19,137,Montgomery,2004,5630,5393,237,4.2
19,139,Muscatine,2004,22667,21721,946,4.2
19,141,O'Brien,2004,7411,7132,279,3.8
19,143,Osceola,2004,3444,3314,130,3.8
19,145,Page,2004,7745,7418,327,4.2
19,147,Palo Alto,2004,5025,4832,193,3.8
19,149,Plymouth,2004,13666,13135,531,3.9
19,151,Pocahontas,2004,3815,3615,200,5.2
19,153,Polk,2004,224078,214035,10043,4.5
19,155,Pottawattamie,2004,48305,45878,2427,5.0
19,157,Poweshiek,2004,10209,9725,484,4.7
19,159,Ringgold,2004,2489,2362,127,5.1
19,161,Sac,2004,5828,5596,232,4.0
19,163,Scott,2004,86053,81890,4163,4.8
19,165,Shelby,2004,6892,6629,263,3.8
19,167,Sioux,2004,18264,17719,545,3.0
19,169,Story,2004,46633,45246,1387,3.0
19,171,Tama,2004,9501,8891,610,6.4
19,173,Taylor,2004,3251,3111,140,4.3
19,175,Union,2004,6273,5927,346,5.5
19,177,Van Buren,2004,3826,3615,211,5.5
19,179,Wapello,2004,19097,18031,1066,5.6
19,181,Warren,2004,24219,23266,953,3.9
19,183,Washington,2004,12156,11612,544,4.5
19,185,Wayne,2004,3129,2987,142,4.5
19,187,Webster,2004,19374,18446,928,4.8
19,189,Winnebago,2004,5883,5676,207,3.5
19,191,Winneshiek,2004,12419,11889,530,4.3
19,193,Woodbury,2004,53216,50547,2669,5.0
19,195,Worth,2004,4480,4294,186,4.2
19,197,Wright,2004,7090,6763,327,4.6
20,1,Allen,2004,7359,6931,428,5.8
20,3,Anderson,2004,4133,3870,263,6.4
20,5,Atchison,2004,8625,8115,510,5.9
20,7,Barber,2004,2631,2526,105,4.0
20,9,Barton,2004,14677,14017,660,4.5
20,11,Bourbon,2004,8769,8263,506,5.8
20,13,Brown,2004,5587,5304,283,5.1
20,15,Butler,2004,31552,29619,1933,6.1
20,17,Chase,2004,1713,1637,76,4.4
20,19,Chautauqua,2004,2023,1914,109,5.4
20,21,Cherokee,2004,10876,10102,774,7.1
20,23,Cheyenne,2004,1606,1545,61,3.8
20,25,Clark,2004,1228,1182,46,3.7
20,27,Clay,2004,4714,4505,209,4.4
20,29,Cloud,2004,5802,5583,219,3.8
20,31,Coffey,2004,4893,4618,275,5.6
20,33,Comanche,2004,1029,997,32,3.1
20,35,Cowley,2004,18166,17056,1110,6.1
20,37,Crawford,2004,19246,18048,1198,6.2
20,39,Decatur,2004,1803,1738,65,3.6
20,41,Dickinson,2004,10564,10061,503,4.8
20,43,Doniphan,2004,4516,4166,350,7.8
20,45,Douglas,2004,62957,60310,2647,4.2
20,47,Edwards,2004,1690,1627,63,3.7
20,49,Elk,2004,1473,1387,86,5.8
20,51,Ellis,2004,16828,16200,628,3.7
20,53,Ellsworth,2004,3216,3072,144,4.5
20,55,Finney,2004,18171,17404,767,4.2
20,57,Ford,2004,16873,16216,657,3.9
20,59,Franklin,2004,13810,12953,857,6.2
20,61,Geary,2004,11194,10471,723,6.5
20,63,Gove,2004,1528,1478,50,3.3
20,65,Graham,2004,1434,1377,57,4.0
20,67,Grant,2004,3875,3728,147,3.8
20,69,Gray,2004,3200,3103,97,3.0
20,71,Greeley,2004,769,737,32,4.2
20,73,Greenwood,2004,3529,3296,233,6.6
20,75,Hamilton,2004,1272,1227,45,3.5
20,77,Harper,2004,3385,3239,146,4.3
20,79,Harvey,2004,17834,16954,880,4.9
20,81,Haskell,2004,2167,2089,78,3.6
20,83,Hodgeman,2004,961,917,44,4.6
20,85,Jackson,2004,7076,6641,435,6.1
20,87,Jefferson,2004,10238,9643,595,5.8
20,89,Jewell,2004,2051,1980,71,3.5
20,91,Johnson,2004,285233,270916,14317,5.0
20,93,Kearny,2004,1950,1861,89,4.6
20,95,Kingman,2004,4272,4067,205,4.8
20,97,Kiowa,2004,1687,1626,61,3.6
20,99,Labette,2004,10490,9766,724,6.9
20,101,Lane,2004,1081,1034,47,4.3
20,103,Leavenworth,2004,32731,30620,2111,6.4
20,105,Lincoln,2004,1814,1724,90,5.0
20,107,Linn,2004,4811,4442,369,7.7
20,109,Logan,2004,1571,1514,57,3.6
20,111,Lyon,2004,19882,18950,932,4.7
20,113,McPherson,2004,16985,16315,670,3.9
20,115,Marion,2004,6708,6402,306,4.6
20,117,Marshall,2004,5799,5573,226,3.9
20,119,Meade,2004,2206,2123,83,3.8
20,121,Miami,2004,15918,15070,848,5.3
20,123,Mitchell,2004,3497,3360,137,3.9
20,125,Montgomery,2004,17160,15970,1190,6.9
20,127,Morris,2004,2972,2820,152,5.1
20,129,Morton,2004,1684,1629,55,3.3
20,131,Nemaha,2004,5394,5186,208,3.9
20,133,Neosho,2004,8945,8502,443,5.0
20,135,Ness,2004,1732,1674,58,3.3
20,137,Norton,2004,2692,2579,113,4.2
20,139,Osage,2004,9209,8596,613,6.7
20,141,Osborne,2004,2308,2207,101,4.4
20,143,Ottawa,2004,3405,3235,170,5.0
20,145,Pawnee,2004,3705,3565,140,3.8
20,147,Phillips,2004,3228,3102,126,3.9
20,149,Pottawatomie,2004,10476,10004,472,4.5
20,151,Pratt,2004,5463,5268,195,3.6
20,153,Rawlins,2004,1370,1307,63,4.6
20,155,Reno,2004,32758,31017,1741,5.3
20,157,Republic,2004,2856,2718,138,4.8
20,159,Rice,2004,5464,5205,259,4.7
20,161,Riley,2004,33429,32082,1347,4.0
20,163,Rooks,2004,2720,2565,155,5.7
20,165,Rush,2004,1703,1624,79,4.6
20,167,Russell,2004,3444,3273,171,5.0
20,169,Saline,2004,30560,29075,1485,4.9
20,171,Scott,2004,2905,2812,93,3.2
20,173,Sedgwick,2004,242767,227662,15105,6.2
20,175,Seward,2004,10460,10025,435,4.2
20,177,Shawnee,2004,94513,88734,5779,6.1
20,179,Sheridan,2004,1552,1501,51,3.3
20,181,Sherman,2004,3675,3544,131,3.6
20,183,Smith,2004,2330,2237,93,4.0
20,185,Stafford,2004,2225,2126,99,4.4
20,187,Stanton,2004,1160,1121,39,3.4
20,189,Stevens,2004,2409,2306,103,4.3
20,191,Sumner,2004,12333,11553,780,6.3
20,193,Thomas,2004,4310,4162,148,3.4
20,195,Trego,2004,1705,1646,59,3.5
20,197,Wabaunsee,2004,3797,3611,186,4.9
20,199,Wallace,2004,940,910,30,3.2
20,201,Washington,2004,3448,3303,145,4.2
20,203,Wichita,2004,1344,1295,49,3.6
20,205,Wilson,2004,5174,4895,279,5.4
20,207,Woodson,2004,1704,1573,131,7.7
20,209,Wyandotte,2004,73817,66931,6886,9.3
21,1,Adair,2004,8414,7960,454,5.4
21,3,Allen,2004,8535,7973,562,6.6
21,5,Anderson,2004,10424,9971,453,4.3
21,7,Ballard,2004,4129,3841,288,7.0
21,9,Barren,2004,19264,18383,881,4.6
21,11,Bath,2004,4978,4632,346,7.0
21,13,Bell,2004,9494,8820,674,7.1
21,15,Boone,2004,56928,54408,2520,4.4
21,17,Bourbon,2004,9628,9160,468,4.9
21,19,Boyd,2004,22967,21540,1427,6.2
21,21,Boyle,2004,12665,11824,841,6.6
21,23,Bracken,2004,4409,4152,257,5.8
21,25,Breathitt,2004,5498,5092,406,7.4
21,27,Breckinridge,2004,8795,8227,568,6.5
21,29,Bullitt,2004,34676,32922,1754,5.1
21,31,Butler,2004,5787,5372,415,7.2
21,33,Caldwell,2004,6268,5944,324,5.2
21,35,Calloway,2004,17398,16461,937,5.4
21,37,Campbell,2004,45676,43477,2199,4.8
21,39,Carlisle,2004,2326,2152,174,7.5
21,41,Carroll,2004,5510,5214,296,5.4
21,43,Carter,2004,13421,12279,1142,8.5
21,45,Casey,2004,6988,6545,443,6.3
21,47,Christian,2004,26641,25045,1596,6.0
21,49,Clark,2004,16686,15823,863,5.2
21,51,Clay,2004,7088,6542,546,7.7
21,53,Clinton,2004,4660,4339,321,6.9
21,55,Crittenden,2004,3988,3749,239,6.0
21,57,Cumberland,2004,2995,2783,212,7.1
21,59,Daviess,2004,46006,43537,2469,5.4
21,61,Edmonson,2004,5143,4833,310,6.0
21,63,Elliott,2004,2827,2535,292,10.3
21,65,Estill,2004,5984,5534,450,7.5
21,67,Fayette,2004,144215,138235,5980,4.1
21,69,Fleming,2004,6575,6174,401,6.1
21,71,Floyd,2004,14820,13760,1060,7.2
21,73,Franklin,2004,25025,23974,1051,4.2
21,75,Fulton,2004,2982,2708,274,9.2
21,77,Gallatin,2004,3970,3742,228,5.7
21,79,Garrard,2004,7447,7025,422,5.7
21,81,Grant,2004,12443,11768,675,5.4
21,83,Graves,2004,16647,15417,1230,7.4
21,85,Grayson,2004,11601,10769,832,7.2
21,87,Green,2004,5468,5168,300,5.5
21,89,Greenup,2004,17097,16011,1086,6.4
21,91,Hancock,2004,4068,3827,241,5.9
21,93,Hardin,2004,45418,42925,2493,5.5
21,95,Harlan,2004,10218,9440,778,7.6
21,97,Harrison,2004,8824,8316,508,5.8
21,99,Hart,2004,7705,7293,412,5.3
21,101,Henderson,2004,22804,21731,1073,4.7
21,103,Henry,2004,7762,7385,377,4.9
21,105,Hickman,2004,2048,1860,188,9.2
21,107,Hopkins,2004,22434,21205,1229,5.5
21,109,Jackson,2004,4785,4473,312,6.5
21,111,Jefferson,2004,348421,329532,18889,5.4
21,113,Jessamine,2004,21106,20174,932,4.4
21,115,Johnson,2004,9835,9185,650,6.6
21,117,Kenton,2004,83293,79423,3870,4.6
21,119,Knott,2004,6509,6098,411,6.3
21,121,Knox,2004,11714,10937,777,6.6
21,123,Larue,2004,6683,6344,339,5.1
21,125,Laurel,2004,25474,24011,1463,5.7
21,127,Lawrence,2004,5735,5272,463,8.1
21,129,Lee,2004,2658,2453,205,7.7
21,131,Leslie,2004,3559,3261,298,8.4
21,133,Letcher,2004,8900,8260,640,7.2
21,135,Lewis,2004,5623,5152,471,8.4
21,137,Lincoln,2004,10552,9785,767,7.3
21,139,Livingston,2004,4795,4495,300,6.3
21,141,Logan,2004,12195,11493,702,5.8
21,143,Lyon,2004,3206,2979,227,7.1
21,145,McCracken,2004,30759,29076,1683,5.5
21,147,McCreary,2004,6038,5561,477,7.9
21,149,McLean,2004,4628,4322,306,6.6
21,151,Madison,2004,40213,38181,2032,5.1
21,153,Magoffin,2004,4547,3966,581,12.8
21,155,Marion,2004,9081,8618,463,5.1
21,157,Marshall,2004,14257,13299,958,6.7
21,159,Martin,2004,3654,3381,273,7.5
21,161,Mason,2004,8751,8247,504,5.8
21,163,Meade,2004,11950,11228,722,6.0
21,165,Menifee,2004,2604,2418,186,7.1
21,167,Mercer,2004,10157,9619,538,5.3
21,169,Metcalfe,2004,4473,4268,205,4.6
21,171,Monroe,2004,5074,4803,271,5.3
21,173,Montgomery,2004,11578,10815,763,6.6
21,175,Morgan,2004,5096,4646,450,8.8
21,177,Muhlenberg,2004,12985,11995,990,7.6
21,179,Nelson,2004,19956,18912,1044,5.2
21,181,Nicholas,2004,2998,2799,199,6.6
21,183,Ohio,2004,11164,10464,700,6.3
21,185,Oldham,2004,25265,24231,1034,4.1
21,187,Owen,2004,5035,4773,262,5.2
21,189,Owsley,2004,1577,1459,118,7.5
21,191,Pendleton,2004,7413,7046,367,5.0
21,193,Perry,2004,10922,10069,853,7.8
21,195,Pike,2004,24012,22432,1580,6.6
21,197,Powell,2004,5537,5078,459,8.3
21,199,Pulaski,2004,26446,25000,1446,5.5
21,201,Robertson,2004,1091,1027,64,5.9
21,203,Rockcastle,2004,7181,6770,411,5.7
21,205,Rowan,2004,12282,11660,622,5.1
21,207,Russell,2004,7718,7245,473,6.1
21,209,Scott,2004,19687,18791,896,4.6
21,211,Shelby,2004,19298,18436,862,4.5
21,213,Simpson,2004,8635,8214,421,4.9
21,215,Spencer,2004,7693,7330,363,4.7
21,217,Taylor,2004,12269,11638,631,5.1
21,219,Todd,2004,5551,5295,256,4.6
21,221,Trigg,2004,6414,6090,324,5.1
21,223,Trimble,2004,4292,4059,233,5.4
21,225,Union,2004,7255,6860,395,5.4
21,227,Warren,2004,52675,50247,2428,4.6
21,229,Washington,2004,5182,4895,287,5.5
21,231,Wayne,2004,8919,8416,503,5.6
21,233,Webster,2004,6568,6280,288,4.4
21,235,Whitley,2004,14905,14035,870,5.8
21,237,Wolfe,2004,2341,2114,227,9.7
21,239,Woodford,2004,13008,12518,490,3.8
22,1,Acadia Parish,2004,23822,22503,1319,5.5
22,3,Allen Parish,2004,8713,8010,703,8.1
22,5,Ascension Parish,2004,42554,39875,2679,6.3
22,7,Assumption Parish,2004,10433,9583,850,8.1
22,9,Avoyelles Parish,2004,15625,14408,1217,7.8
22,11,Beauregard Parish,2004,13933,13042,891,6.4
22,13,Bienville Parish,2004,6064,5575,489,8.1
22,15,Bossier Parish,2004,48735,46161,2574,5.3
22,17,Caddo Parish,2004,113055,106261,6794,6.0
22,19,Calcasieu Parish,2004,85877,81234,4643,5.4
22,21,Caldwell Parish,2004,4262,3910,352,8.3
22,23,Cameron Parish,2004,4317,4100,217,5.0
22,25,Catahoula Parish,2004,4088,3775,313,7.7
22,27,Claiborne Parish,2004,6880,6434,446,6.5
22,29,Concordia Parish,2004,7182,6480,702,9.8
22,31,De Soto Parish,2004,10965,10168,797,7.3
22,33,East Baton Rouge Parish,2004,203038,191904,11134,5.5
22,35,East Carroll Parish,2004,3012,2613,399,13.2
22,37,East Feliciana Parish,2004,7968,7419,549,6.9
22,39,Evangeline Parish,2004,11711,10938,773,6.6
22,41,Franklin Parish,2004,7724,7041,683,8.8
22,43,Grant Parish,2004,8106,7575,531,6.6
22,45,Iberia Parish,2004,31121,29260,1861,6.0
22,47,Iberville Parish,2004,12207,11144,1063,8.7
22,49,Jackson Parish,2004,6393,5980,413,6.5
22,51,Jefferson Parish,2004,223975,213509,10466,4.7
22,53,Jefferson Davis Parish,2004,13484,12818,666,4.9
22,55,Lafayette Parish,2004,98168,93948,4220,4.3
22,57,Lafourche Parish,2004,43603,41530,2073,4.8
22,59,LaSalle Parish,2004,5671,5327,344,6.1
22,61,Lincoln Parish,2004,18270,17126,1144,6.3
22,63,Livingston Parish,2004,50218,47049,3169,6.3
22,65,Madison Parish,2004,4657,4215,442,9.5
22,67,Morehouse Parish,2004,11847,10682,1165,9.8
22,69,Natchitoches Parish,2004,17182,16109,1073,6.2
22,71,Orleans Parish,2004,195461,184267,11194,5.7
22,73,Ouachita Parish,2004,71308,67426,3882,5.4
22,75,Plaquemines Parish,2004,11504,10893,611,5.3
22,77,Pointe Coupee Parish,2004,9460,8776,684,7.2
22,79,Rapides Parish,2004,56237,53221,3016,5.4
22,81,Red River Parish,2004,3542,3201,341,9.6
22,83,Richland Parish,2004,8422,7750,672,8.0
22,85,Sabine Parish,2004,9254,8705,549,5.9
22,87,St. Bernard Parish,2004,30487,28899,1588,5.2
22,89,St. Charles Parish,2004,23890,22683,1207,5.1
22,91,St. Helena Parish,2004,3906,3654,252,6.5
22,93,St. James Parish,2004,8761,7929,832,9.5
22,95,St. John the Baptist Parish,2004,20444,19088,1356,6.6
22,97,St. Landry Parish,2004,34354,32179,2175,6.3
22,99,St. Martin Parish,2004,21636,20461,1175,5.4
22,101,St. Mary Parish,2004,21702,19883,1819,8.4
22,103,St. Tammany Parish,2004,103681,99363,4318,4.2
22,105,Tangipahoa Parish,2004,47699,44541,3158,6.6
22,107,Tensas Parish,2004,2261,2074,187,8.3
22,109,Terrebonne Parish,2004,48446,46066,2380,4.9
22,111,Union Parish,2004,10352,9702,650,6.3
22,113,Vermilion Parish,2004,22763,21459,1304,5.7
22,115,Vernon Parish,2004,19644,18632,1012,5.2
22,117,Washington Parish,2004,16208,15027,1181,7.3
22,119,Webster Parish,2004,18744,17488,1256,6.7
22,121,West Baton Rouge Parish,2004,10175,9508,667,6.6
22,123,West Carroll Parish,2004,4547,3973,574,12.6
22,125,West Feliciana Parish,2004,4681,4364,317,6.8
22,127,Winn Parish,2004,5995,5604,391,6.5
23,1,Androscoggin,2004,55962,53429,2533,4.5
23,3,Aroostook,2004,34325,32194,2131,6.2
23,5,Cumberland,2004,153447,148284,5163,3.4
23,7,Franklin,2004,14481,13661,820,5.7
23,9,Hancock,2004,29473,27962,1511,5.1
23,11,Kennebec,2004,60986,58033,2953,4.8
23,13,Knox,2004,21390,20614,776,3.6
23,15,Lincoln,2004,18023,17315,708,3.9
23,17,Oxford,2004,27709,26136,1573,5.7
23,19,Penobscot,2004,75966,71765,4201,5.5
23,21,Piscataquis,2004,7330,6826,504,6.9
23,23,Sagadahoc,2004,18520,17834,686,3.7
23,25,Somerset,2004,24370,22567,1803,7.4
23,27,Waldo,2004,19377,18381,996,5.1
23,29,Washington,2004,15045,13898,1147,7.6
23,31,York,2004,109564,105180,4384,4.0
24,1,Allegany,2004,35080,32770,2310,6.6
24,3,Anne Arundel,2004,270631,259765,10866,4.0
24,5,Baltimore,2004,413002,393167,19835,4.8
24,9,Calvert,2004,45078,43409,1669,3.7
24,11,Caroline,2004,15953,15139,814,5.1
24,13,Carroll,2004,89915,86535,3380,3.8
24,15,Cecil,2004,48546,46252,2294,4.7
24,17,Charles,2004,70919,68310,2609,3.7
24,19,Dorchester,2004,17032,15957,1075,6.3
24,21,Frederick,2004,117685,113453,4232,3.6
24,23,Garrett,2004,16207,15348,859,5.3
24,25,Harford,2004,125791,120312,5479,4.4
24,27,Howard,2004,150994,145696,5298,3.5
24,29,Kent,2004,10742,10243,499,4.6
24,31,Montgomery,2004,496761,479611,17150,3.5
24,33,Prince George's,2004,439525,418279,21246,4.8
24,35,Queen Anne's,2004,24425,23480,945,3.9
24,37,St. Mary's,2004,49031,47221,1810,3.7
24,39,Somerset,2004,11305,10515,790,7.0
24,41,Talbot,2004,18663,17835,828,4.4
24,43,Washington,2004,66674,63423,3251,4.9
24,45,Wicomico,2004,50025,47640,2385,4.8
24,47,Worcester,2004,27473,25457,2016,7.3
24,510,Baltimore city,2004,273654,252369,21285,7.8
25,1,Barnstable,2004,123468,117375,6093,4.9
25,3,Berkshire,2004,72567,69203,3364,4.6
25,5,Bristol,2004,287767,270212,17555,6.1
25,7,Dukes,2004,11206,10763,443,4.0
25,9,Essex,2004,377544,356219,21325,5.6
25,11,Franklin,2004,39837,38161,1676,4.2
25,13,Hampden,2004,225518,211852,13666,6.1
25,15,Hampshire,2004,88343,84777,3566,4.0
25,17,Middlesex,2004,813214,777445,35769,4.4
25,19,Nantucket/town,2004,7891,7697,194,2.5
25,21,Norfolk,2004,356420,340503,15917,4.5
25,23,Plymouth,2004,258079,244830,13249,5.1
25,25,Suffolk,2004,337465,318437,19028,5.6
25,27,Worcester,2004,401519,379513,22006,5.5
26,1,Alcona,2004,4187,3738,449,10.7
26,3,Alger,2004,4391,4053,338,7.7
26,5,Allegan,2004,53438,50010,3428,6.4
26,7,Alpena,2004,15243,13985,1258,8.3
26,9,Antrim,2004,12041,11099,942,7.8
26,11,Arenac,2004,7864,7110,754,9.6
26,13,Baraga,2004,4009,3559,450,11.2
26,15,Barry,2004,30332,28626,1706,5.6
26,17,Bay,2004,55938,51856,4082,7.3
26,19,Benzie,2004,8893,8236,657,7.4
26,21,Berrien,2004,78321,72497,5824,7.4
26,23,Branch,2004,22878,21299,1579,6.9
26,25,Calhoun,2004,71803,66958,4845,6.7
26,27,Cass,2004,26866,25642,1224,4.6
26,29,Charlevoix,2004,14186,13119,1067,7.5
26,31,Cheboygan,2004,12888,11693,1195,9.3
26,33,Chippewa,2004,17437,15923,1514,8.7
26,35,Clare,2004,13420,12146,1274,9.5
26,37,Clinton,2004,36919,35014,1905,5.2
26,39,Crawford,2004,6828,6330,498,7.3
26,41,Delta,2004,20288,18719,1569,7.7
26,43,Dickinson,2004,14411,13510,901,6.3
26,45,Eaton,2004,58269,55234,3035,5.2
26,47,Emmet,2004,19824,18268,1556,7.8
26,49,Genesee,2004,211412,194572,16840,8.0
26,51,Gladwin,2004,11128,9993,1135,10.2
26,53,Gogebic,2004,7832,7224,608,7.8
26,55,Grand Traverse,2004,47577,44558,3019,6.3
26,57,Gratiot,2004,20258,18699,1559,7.7
26,59,Hillsdale,2004,22524,20697,1827,8.1
26,61,Houghton,2004,17235,16154,1081,6.3
26,63,Huron,2004,17106,15652,1454,8.5
26,65,Ingham,2004,152807,143476,9331,6.1
26,67,Ionia,2004,30501,28162,2339,7.7
26,69,Iosco,2004,10635,9628,1007,9.5
26,71,Iron,2004,5920,5485,435,7.3
26,73,Isabella,2004,36833,35044,1789,4.9
26,75,Jackson,2004,78060,72350,5710,7.3
26,77,Kalamazoo,2004,131176,123881,7295,5.6
26,79,Kalkaska,2004,8707,8045,662,7.6
26,81,Kent,2004,317932,297330,20602,6.5
26,83,Keweenaw,2004,1065,945,120,11.3
26,85,Lake,2004,4469,4002,467,10.4
26,87,Lapeer,2004,45357,41814,3543,7.8
26,89,Leelanau,2004,11491,10885,606,5.3
26,91,Lenawee,2004,49320,45777,3543,7.2
26,93,Livingston,2004,93530,88863,4667,5.0
26,95,Luce,2004,2866,2656,210,7.3
26,97,Mackinac,2004,6519,5891,628,9.6
26,99,Macomb,2004,424734,395928,28806,6.8
26,101,Manistee,2004,11797,10790,1007,8.5
26,103,Marquette,2004,34668,32599,2069,6.0
26,105,Mason,2004,15178,13787,1391,9.2
26,107,Mecosta,2004,19950,18551,1399,7.0
26,109,Menominee,2004,13368,12610,758,5.7
26,111,Midland,2004,41340,38778,2562,6.2
26,113,Missaukee,2004,6729,6207,522,7.8
26,115,Monroe,2004,77210,72550,4660,6.0
26,117,Montcalm,2004,29635,27348,2287,7.7
26,119,Montmorency,2004,4338,3821,517,11.9
26,121,Muskegon,2004,89530,82815,6715,7.5
26,123,Newaygo,2004,23025,21260,1765,7.7
26,125,Oakland,2004,641359,605118,36241,5.7
26,127,Oceana,2004,13901,12755,1146,8.2
26,129,Ogemaw,2004,9824,8997,827,8.4
26,131,Ontonagon,2004,3570,3303,267,7.5
26,133,Osceola,2004,10467,9585,882,8.4
26,135,Oscoda,2004,3865,3446,419,10.8
26,137,Otsego,2004,12673,11732,941,7.4
26,139,Ottawa,2004,134088,126837,7251,5.4
26,141,Presque Isle,2004,6361,5652,709,11.1
26,143,Roscommon,2004,11255,10317,938,8.3
26,145,Saginaw,2004,98978,90643,8335,8.4
26,147,St. Clair,2004,85417,78750,6667,7.8
26,149,St. Joseph,2004,30955,28962,1993,6.4
26,151,Sanilac,2004,21878,19915,1963,9.0
26,153,Schoolcraft,2004,4023,3592,431,10.7
26,155,Shiawassee,2004,36758,33936,2822,7.7
26,157,Tuscola,2004,29404,26861,2543,8.6
26,159,Van Buren,2004,40280,37456,2824,7.0
26,161,Washtenaw,2004,187690,179790,7900,4.2
26,163,Wayne,2004,914293,835385,78908,8.6
26,165,Wexford,2004,14678,13483,1195,8.1
27,1,Aitkin,2004,7833,7300,533,6.8
27,3,Anoka,2004,189152,180761,8391,4.4
27,5,Becker,2004,16608,15664,944,5.7
27,7,Beltrami,2004,21332,20127,1205,5.6
27,9,Benton,2004,22155,21012,1143,5.2
27,11,Big Stone,2004,2820,2685,135,4.8
27,13,Blue Earth,2004,35139,33797,1342,3.8
27,15,Brown,2004,15126,14400,726,4.8
27,17,Carlton,2004,16938,15879,1059,6.3
27,19,Carver,2004,46819,45005,1814,3.9
27,21,Cass,2004,14421,13403,1018,7.1
27,23,Chippewa,2004,7264,6909,355,4.9
27,25,Chisago,2004,26689,25281,1408,5.3
27,27,Clay,2004,30350,29254,1096,3.6
27,29,Clearwater,2004,4031,3594,437,10.8
27,31,Cook,2004,3233,3081,152,4.7
27,33,Cottonwood,2004,6419,6123,296,4.6
27,35,Crow Wing,2004,31990,30301,1689,5.3
27,37,Dakota,2004,226850,217805,9045,4.0
27,39,Dodge,2004,11174,10698,476,4.3
27,41,Douglas,2004,20150,19388,762,3.8
27,43,Faribault,2004,8305,7840,465,5.6
27,45,Fillmore,2004,11615,11043,572,4.9
27,47,Freeborn,2004,16624,15755,869,5.2
27,49,Goodhue,2004,25525,24311,1214,4.8
27,51,Grant,2004,3170,2986,184,5.8
27,53,Hennepin,2004,660454,631943,28511,4.3
27,55,Houston,2004,11246,10671,575,5.1
27,57,Hubbard,2004,9804,9232,572,5.8
27,59,Isanti,2004,20585,19518,1067,5.2
27,61,Itasca,2004,22625,20979,1646,7.3
27,63,Jackson,2004,6605,6365,240,3.6
27,65,Kanabec,2004,7933,7343,590,7.4
27,67,Kandiyohi,2004,23268,22232,1036,4.5
27,69,Kittson,2004,2701,2524,177,6.6
27,71,Koochiching,2004,7099,6663,436,6.1
27,73,Lac qui Parle,2004,4077,3899,178,4.4
27,75,Lake,2004,6084,5799,285,4.7
27,77,Lake of the Woods,2004,2480,2363,117,4.7
27,79,Le Sueur,2004,14552,13731,821,5.6
27,81,Lincoln,2004,3398,3260,138,4.1
27,83,Lyon,2004,14399,13858,541,3.8
27,85,McLeod,2004,19947,19042,905,4.5
27,87,Mahnomen,2004,2648,2496,152,5.7
27,89,Marshall,2004,5422,5012,410,7.6
27,91,Martin,2004,11505,10954,551,4.8
27,93,Meeker,2004,12442,11760,682,5.5
27,95,Mille Lacs,2004,12183,11319,864,7.1
27,97,Morrison,2004,17511,16507,1004,5.7
27,99,Mower,2004,20423,19527,896,4.4
27,101,Murray,2004,5556,5318,238,4.3
27,103,Nicollet,2004,18856,18180,676,3.6
27,105,Nobles,2004,11241,10813,428,3.8
27,107,Norman,2004,3763,3577,186,4.9
27,109,Olmsted,2004,78200,75122,3078,3.9
27,111,Otter Tail,2004,29939,28400,1539,5.1
27,113,Pennington,2004,8166,7643,523,6.4
27,115,Pine,2004,14838,13853,985,6.6
27,117,Pipestone,2004,5180,4964,216,4.2
27,119,Polk,2004,16708,15841,867,5.2
27,121,Pope,2004,6162,5911,251,4.1
27,123,Ramsey,2004,276963,264297,12666,4.6
27,125,Red Lake,2004,2259,2086,173,7.7
27,127,Redwood,2004,8464,8091,373,4.4
27,129,Renville,2004,8846,8353,493,5.6
27,131,Rice,2004,32529,30999,1530,4.7
27,133,Rock,2004,5080,4910,170,3.3
27,135,Roseau,2004,10174,9720,454,4.5
27,137,St. Louis,2004,102868,96976,5892,5.7
27,139,Scott,2004,67453,64815,2638,3.9
27,141,Sherburne,2004,45229,43016,2213,4.9
27,143,Sibley,2004,8940,8502,438,4.9
27,145,Stearns,2004,80294,76682,3612,4.5
27,147,Steele,2004,19701,18808,893,4.5
27,149,Stevens,2004,5682,5466,216,3.8
27,151,Swift,2004,5441,5171,270,5.0
27,153,Todd,2004,12813,12161,652,5.1
27,155,Traverse,2004,1961,1876,85,4.3
27,157,Wabasha,2004,12726,12177,549,4.3
27,159,Wadena,2004,6699,6273,426,6.4
27,161,Waseca,2004,10658,10179,479,4.5
27,163,Washington,2004,124381,119443,4938,4.0
27,165,Watonwan,2004,5905,5638,267,4.5
27,167,Wilkin,2004,3692,3554,138,3.7
27,169,Winona,2004,28100,26891,1209,4.3
27,171,Wright,2004,61352,58381,2971,4.8
27,173,Yellow Medicine,2004,5544,5264,280,5.1
28,1,Adams,2004,13363,12358,1005,7.5
28,3,Alcorn,2004,15933,14876,1057,6.6
28,5,Amite,2004,5222,4879,343,6.6
28,7,Attala,2004,7853,7235,618,7.9
28,9,Benton,2004,2900,2635,265,9.1
28,11,Bolivar,2004,15639,14357,1282,8.2
28,13,Calhoun,2004,6441,6004,437,6.8
28,15,Carroll,2004,4817,4531,286,5.9
28,17,Chickasaw,2004,7873,7235,638,8.1
28,19,Choctaw,2004,3668,3371,297,8.1
28,21,Claiborne,2004,3872,3470,402,10.4
28,23,Clarke,2004,7283,6729,554,7.6
28,25,Clay,2004,8871,8052,819,9.2
28,27,Coahoma,2004,11262,10246,1016,9.0
28,29,Copiah,2004,12628,11772,856,6.8
28,31,Covington,2004,8899,8411,488,5.5
28,33,DeSoto,2004,68782,66304,2478,3.6
28,35,Forrest,2004,35467,33527,1940,5.5
28,37,Franklin,2004,3088,2845,243,7.9
28,39,George,2004,8515,7755,760,8.9
28,41,Greene,2004,4801,4360,441,9.2
28,43,Grenada,2004,10137,9499,638,6.3
28,45,Hancock,2004,20743,19704,1039,5.0
28,47,Harrison,2004,92456,87809,4647,5.0
28,49,Hinds,2004,124260,117391,6869,5.5
28,51,Holmes,2004,6867,6116,751,10.9
28,53,Humphreys,2004,4398,4014,384,8.7
28,55,Issaquena,2004,803,721,82,10.2
28,57,Itawamba,2004,10494,9882,612,5.8
28,59,Jackson,2004,60198,56716,3482,5.8
28,61,Jasper,2004,7336,6754,582,7.9
28,63,Jefferson,2004,2875,2496,379,13.2
28,65,Jefferson Davis,2004,5375,4961,414,7.7
28,67,Jones,2004,29348,27833,1515,5.2
28,69,Kemper,2004,4285,3920,365,8.5
28,71,Lafayette,2004,20624,19561,1063,5.2
28,73,Lamar,2004,21645,20728,917,4.2
28,75,Lauderdale,2004,33806,31583,2223,6.6
28,77,Lawrence,2004,5276,4918,358,6.8
28,79,Leake,2004,8849,8270,579,6.5
28,81,Lee,2004,38352,36200,2152,5.6
28,83,Leflore,2004,13822,12551,1271,9.2
28,85,Lincoln,2004,14427,13529,898,6.2
28,87,Lowndes,2004,25750,24036,1714,6.7
28,89,Madison,2004,43763,41677,2086,4.8
28,91,Marion,2004,10497,9796,701,6.7
28,93,Marshall,2004,15313,14141,1172,7.7
28,95,Monroe,2004,17247,15946,1301,7.5
28,97,Montgomery,2004,4940,4559,381,7.7
28,99,Neshoba,2004,14693,13851,842,5.7
28,101,Newton,2004,9825,9277,548,5.6
28,103,Noxubee,2004,4487,3948,539,12.0
28,105,Oktibbeha,2004,19945,18824,1121,5.6
28,107,Panola,2004,14729,13393,1336,9.1
28,109,Pearl River,2004,21486,20308,1178,5.5
28,111,Perry,2004,5174,4796,378,7.3
28,113,Pike,2004,15288,14209,1079,7.1
28,115,Pontotoc,2004,13283,12598,685,5.2
28,117,Prentiss,2004,11886,11035,851,7.2
28,119,Quitman,2004,4042,3644,398,9.8
28,121,Rankin,2004,71330,68496,2834,4.0
28,123,Scott,2004,13065,12399,666,5.1
28,125,Sharkey,2004,2652,2371,281,10.6
28,127,Simpson,2004,12008,11391,617,5.1
28,129,Smith,2004,6953,6583,370,5.3
28,131,Stone,2004,6949,6565,384,5.5
28,133,Sunflower,2004,11181,10181,1000,8.9
28,135,Tallahatchie,2004,6498,5888,610,9.4
28,137,Tate,2004,11859,11156,703,5.9
28,139,Tippah,2004,9501,8849,652,6.9
28,141,Tishomingo,2004,8154,7513,641,7.9
28,143,Tunica,2004,4392,4007,385,8.8
28,145,Union,2004,11750,11025,725,6.2
28,147,Walthall,2004,5803,5406,397,6.8
28,149,Warren,2004,23283,21892,1391,6.0
28,151,Washington,2004,24208,21915,2293,9.5
28,153,Wayne,2004,8545,7954,591,6.9
28,155,Webster,2004,3490,3202,288,8.3
28,157,Wilkinson,2004,3696,3378,318,8.6
28,159,Winston,2004,7902,7306,596,7.5
28,161,Yalobusha,2004,5512,5030,482,8.7
28,163,Yazoo,2004,10357,9469,888,8.6
29,1,Adair,2004,13063,12415,648,5.0
29,3,Andrew,2004,9681,9174,507,5.2
29,5,Atchison,2004,3333,3178,155,4.7
29,7,Audrain,2004,11762,11079,683,5.8
29,9,Barry,2004,17147,16259,888,5.2
29,11,Barton,2004,6727,6384,343,5.1
29,13,Bates,2004,7996,7419,577,7.2
29,15,Benton,2004,8512,7962,550,6.5
29,17,Bollinger,2004,6114,5745,369,6.0
29,19,Boone,2004,83107,79880,3227,3.9
29,21,Buchanan,2004,45101,42306,2795,6.2
29,23,Butler,2004,21641,20451,1190,5.5
29,25,Caldwell,2004,4388,4122,266,6.1
29,27,Callaway,2004,22607,21530,1077,4.8
29,29,Camden,2004,20805,19612,1193,5.7
29,31,Cape Girardeau,2004,39551,37733,1818,4.6
29,33,Carroll,2004,5041,4757,284,5.6
29,35,Carter,2004,2947,2747,200,6.8
29,37,Cass,2004,47861,45122,2739,5.7
29,39,Cedar,2004,6427,6023,404,6.3
29,41,Chariton,2004,4305,4053,252,5.9
29,43,Christian,2004,35349,33686,1663,4.7
29,45,Clark,2004,3604,3358,246,6.8
29,47,Clay,2004,109429,103970,5459,5.0
29,49,Clinton,2004,10353,9742,611,5.9
29,51,Cole,2004,40192,38563,1629,4.1
29,53,Cooper,2004,8825,8375,450,5.1
29,55,Crawford,2004,11681,10924,757,6.5
29,57,Dade,2004,3873,3669,204,5.3
29,59,Dallas,2004,7361,6915,446,6.1
29,61,Daviess,2004,4117,3900,217,5.3
29,63,DeKalb,2004,5018,4705,313,6.2
29,65,Dent,2004,6502,6068,434,6.7
29,67,Douglas,2004,6183,5809,374,6.0
29,69,Dunklin,2004,14882,13780,1102,7.4
29,71,Franklin,2004,51970,48851,3119,6.0
29,73,Gasconade,2004,7736,7256,480,6.2
29,75,Gentry,2004,3333,3178,155,4.7
29,77,Greene,2004,134460,128148,6312,4.7
29,79,Grundy,2004,4971,4686,285,5.7
29,81,Harrison,2004,4461,4226,235,5.3
29,83,Henry,2004,10872,10125,747,6.9
29,85,Hickory,2004,3413,3120,293,8.6
29,87,Holt,2004,2603,2471,132,5.1
29,89,Howard,2004,5306,5051,255,4.8
29,91,Howell,2004,19675,18631,1044,5.3
29,93,Iron,2004,5005,4585,420,8.4
29,95,Jackson,2004,338905,314985,23920,7.1
29,97,Jasper,2004,54621,51704,2917,5.3
29,99,Jefferson,2004,114381,107728,6653,5.8
29,101,Johnson,2004,25164,23893,1271,5.1
29,103,Knox,2004,2354,2255,99,4.2
29,105,Laclede,2004,16847,15594,1253,7.4
29,107,Lafayette,2004,16747,15769,978,5.8
29,109,Lawrence,2004,18679,17764,915,4.9
29,111,Lewis,2004,5577,5298,279,5.0
29,113,Lincoln,2004,23587,22184,1403,5.9
29,115,Linn,2004,6945,6427,518,7.5
29,117,Livingston,2004,7193,6819,374,5.2
29,119,McDonald,2004,11662,11061,601,5.2
29,121,Macon,2004,8296,7846,450,5.4
29,123,Madison,2004,5934,5553,381,6.4
29,125,Maries,2004,4721,4480,241,5.1
29,127,Marion,2004,14597,13771,826,5.7
29,129,Mercer,2004,1762,1670,92,5.2
29,131,Miller,2004,12862,12037,825,6.4
29,133,Mississippi,2004,6159,5695,464,7.5
29,135,Moniteau,2004,7571,7208,363,4.8
29,137,Monroe,2004,4573,4297,276,6.0
29,139,Montgomery,2004,6388,5984,404,6.3
29,141,Morgan,2004,9533,8908,625,6.6
29,143,New Madrid,2004,8670,7946,724,8.4
29,145,Newton,2004,27660,26131,1529,5.5
29,147,Nodaway,2004,12624,12142,482,3.8
29,149,Oregon,2004,4268,4027,241,5.6
29,151,Osage,2004,7491,7144,347,4.6
29,153,Ozark,2004,4406,4135,271,6.2
29,155,Pemiscot,2004,7913,7217,696,8.8
29,157,Perry,2004,10378,9953,425,4.1
29,159,Pettis,2004,20700,19482,1218,5.9
29,161,Phelps,2004,22739,21687,1052,4.6
29,163,Pike,2004,8925,8432,493,5.5
29,165,Platte,2004,46711,44523,2188,4.7
29,167,Polk,2004,13583,12852,731,5.4
29,169,Pulaski,2004,17505,16493,1012,5.8
29,171,Putnam,2004,2533,2409,124,4.9
29,173,Ralls,2004,5575,5241,334,6.0
29,175,Randolph,2004,12906,12194,712,5.5
29,177,Ray,2004,11855,11099,756,6.4
29,179,Reynolds,2004,2720,2496,224,8.2
29,181,Ripley,2004,6482,6073,409,6.3
29,183,St. Charles,2004,181213,172932,8281,4.6
29,185,St. Clair,2004,4507,4206,301,6.7
29,186,Ste. Genevieve,2004,9387,8852,535,5.7
29,187,St. Francois,2004,27838,25851,1987,7.1
29,189,St. Louis,2004,539287,508811,30476,5.7
29,195,Saline,2004,11928,11305,623,5.2
29,197,Schuyler,2004,2209,2072,137,6.2
29,199,Scotland,2004,2474,2372,102,4.1
29,201,Scott,2004,20830,19564,1266,6.1
29,203,Shannon,2004,4004,3660,344,8.6
29,205,Shelby,2004,3215,3027,188,5.8
29,207,Stoddard,2004,15905,14945,960,6.0
29,209,Stone,2004,15775,14424,1351,8.6
29,211,Sullivan,2004,3247,3032,215,6.6
29,213,Taney,2004,25016,22712,2304,9.2
29,215,Texas,2004,10887,10123,764,7.0
29,217,Vernon,2004,10315,9761,554,5.4
29,219,Warren,2004,14855,14022,833,5.6
29,221,Washington,2004,9960,9078,882,8.9
29,223,Wayne,2004,5720,5299,421,7.4
29,225,Webster,2004,16222,15398,824,5.1
29,227,Worth,2004,1186,1133,53,4.5
29,229,Wright,2004,8278,7725,553,6.7
29,510,St. Louis city,2004,161678,147154,14524,9.0
30,1,Beaverhead,2004,4985,4803,182,3.7
30,3,Big Horn,2004,5013,4558,455,9.1
30,5,Blaine,2004,2816,2690,126,4.5
30,7,Broadwater,2004,2261,2165,96,4.2
30,9,Carbon,2004,5246,5034,212,4.0
30,11,Carter,2004,706,683,23,3.3
30,13,Cascade,2004,38501,36874,1627,4.2
30,15,Chouteau,2004,2599,2512,87,3.3
30,17,Custer,2004,5701,5467,234,4.1
30,19,Daniels,2004,810,777,33,4.1
30,21,Dawson,2004,4249,4078,171,4.0
30,23,Deer Lodge,2004,3899,3648,251,6.4
30,25,Fallon,2004,1603,1556,47,2.9
30,27,Fergus,2004,5810,5512,298,5.1
30,29,Flathead,2004,41555,39247,2308,5.6
30,31,Gallatin,2004,44559,43022,1537,3.4
30,33,Garfield,2004,657,633,24,3.7
30,35,Glacier,2004,5888,5415,473,8.0
30,37,Golden Valley,2004,489,460,29,5.9
30,39,Granite,2004,1294,1223,71,5.5
30,41,Hill,2004,7970,7616,354,4.4
30,43,Jefferson,2004,5495,5257,238,4.3
30,45,Judith Basin,2004,1097,1051,46,4.2
30,47,Lake,2004,11584,10895,689,5.9
30,49,Lewis and Clark,2004,30800,29591,1209,3.9
30,51,Liberty,2004,877,841,36,4.1
30,53,Lincoln,2004,7676,6913,763,9.9
30,55,McCone,2004,1015,986,29,2.9
30,57,Madison,2004,3583,3435,148,4.1
30,59,Meagher,2004,927,873,54,5.8
30,61,Mineral,2004,1914,1797,117,6.1
30,63,Missoula,2004,56917,54642,2275,4.0
30,65,Musselshell,2004,2099,1974,125,6.0
30,67,Park,2004,8786,8390,396,4.5
30,69,Petroleum,2004,220,208,12,5.5
30,71,Phillips,2004,2150,2054,96,4.5
30,73,Pondera,2004,2689,2543,146,5.4
30,75,Powder River,2004,924,886,38,4.1
30,77,Powell,2004,2670,2505,165,6.2
30,79,Prairie,2004,564,535,29,5.1
30,81,Ravalli,2004,18100,17100,1000,5.5
30,83,Richland,2004,4877,4705,172,3.5
30,85,Roosevelt,2004,4088,3826,262,6.4
30,87,Rosebud,2004,4278,4056,222,5.2
30,89,Sanders,2004,4634,4312,322,6.9
30,91,Sheridan,2004,1788,1719,69,3.9
30,93,Silver Bow,2004,17165,16332,833,4.9
30,95,Stillwater,2004,4486,4321,165,3.7
30,97,Sweet Grass,2004,2633,2574,59,2.2
30,99,Teton,2004,2972,2855,117,3.9
30,101,Toole,2004,2564,2477,87,3.4
30,103,Treasure,2004,415,396,19,4.6
30,105,Valley,2004,3719,3562,157,4.2
30,107,Wheatland,2004,1045,998,47,4.5
30,109,Wibaux,2004,513,494,19,3.7
30,111,Yellowstone,2004,76346,73596,2750,3.6
31,1,Adams,2004,17061,16409,652,3.8
31,3,Antelope,2004,3945,3812,133,3.4
31,5,Arthur,2004,238,228,10,4.2
31,7,Banner,2004,410,396,14,3.4
31,9,Blaine,2004,286,276,10,3.5
31,11,Boone,2004,3230,3126,104,3.2
31,13,Box Butte,2004,5606,5380,226,4.0
31,15,Boyd,2004,1202,1164,38,3.2
31,17,Brown,2004,1923,1858,65,3.4
31,19,Buffalo,2004,26866,26084,782,2.9
31,21,Burt,2004,3973,3766,207,5.2
31,23,Butler,2004,4747,4550,197,4.1
31,25,Cass,2004,14056,13476,580,4.1
31,27,Cedar,2004,5096,4950,146,2.9
31,29,Chase,2004,2194,2130,64,2.9
31,31,Cherry,2004,3754,3663,91,2.4
31,33,Cheyenne,2004,5098,4939,159,3.1
31,35,Clay,2004,3298,3181,117,3.5
31,37,Colfax,2004,5972,5784,188,3.1
31,39,Cuming,2004,5558,5396,162,2.9
31,41,Custer,2004,6243,6051,192,3.1
31,43,Dakota,2004,10618,10143,475,4.5
31,45,Dawes,2004,4768,4613,155,3.3
31,47,Dawson,2004,12575,12042,533,4.2
31,49,Deuel,2004,1082,1050,32,3.0
31,51,Dixon,2004,3122,3012,110,3.5
31,53,Dodge,2004,19867,18947,920,4.6
31,55,Douglas,2004,265610,253662,11948,4.5
31,57,Dundy,2004,1176,1132,44,3.7
31,59,Fillmore,2004,3377,3256,121,3.6
31,61,Franklin,2004,1944,1880,64,3.3
31,63,Frontier,2004,1785,1733,52,2.9
31,65,Furnas,2004,2554,2467,87,3.4
31,67,Gage,2004,12947,12373,574,4.4
31,69,Garden,2004,1087,1046,41,3.8
31,71,Garfield,2004,1079,1043,36,3.3
31,73,Gosper,2004,1106,1064,42,3.8
31,75,Grant,2004,419,408,11,2.6
31,77,Greeley,2004,1449,1394,55,3.8
31,79,Hall,2004,30092,28638,1454,4.8
31,81,Hamilton,2004,5346,5177,169,3.2
31,83,Harlan,2004,1846,1787,59,3.2
31,85,Hayes,2004,556,535,21,3.8
31,87,Hitchcock,2004,1534,1474,60,3.9
31,89,Holt,2004,6299,6108,191,3.0
31,91,Hooker,2004,431,417,14,3.2
31,93,Howard,2004,3696,3543,153,4.1
31,95,Jefferson,2004,4367,4182,185,4.2
31,97,Johnson,2004,3116,3007,109,3.5
31,99,Kearney,2004,3924,3811,113,2.9
31,101,Keith,2004,4860,4699,161,3.3
31,103,Keya Paha,2004,440,426,14,3.2
31,105,Kimball,2004,2177,2113,64,2.9
31,107,Knox,2004,4965,4790,175,3.5
31,109,Lancaster,2004,155676,150248,5428,3.5
31,111,Lincoln,2004,20976,20242,734,3.5
31,113,Logan,2004,440,427,13,3.0
31,115,Loup,2004,349,335,14,4.0
31,117,McPherson,2004,304,299,5,1.6
31,119,Madison,2004,20629,19818,811,3.9
31,121,Merrick,2004,4317,4138,179,4.1
31,123,Morrill,2004,2822,2728,94,3.3
31,125,Nance,2004,2027,1936,91,4.5
31,127,Nemaha,2004,3513,3354,159,4.5
31,129,Nuckolls,2004,2451,2372,79,3.2
31,131,Otoe,2004,8812,8452,360,4.1
31,133,Pawnee,2004,1669,1607,62,3.7
31,135,Perkins,2004,1661,1618,43,2.6
31,137,Phelps,2004,5277,5104,173,3.3
31,139,Pierce,2004,4318,4173,145,3.4
31,141,Platte,2004,16948,16219,729,4.3
31,143,Polk,2004,3054,2948,106,3.5
31,145,Red Willow,2004,6091,5878,213,3.5
31,147,Richardson,2004,4448,4228,220,4.9
31,149,Rock,2004,972,939,33,3.4
31,151,Saline,2004,8272,7994,278,3.4
31,153,Sarpy,2004,71732,69314,2418,3.4
31,155,Saunders,2004,11112,10703,409,3.7
31,157,Scotts Bluff,2004,19334,18492,842,4.4
31,159,Seward,2004,9348,9064,284,3.0
31,161,Sheridan,2004,3298,3203,95,2.9
31,163,Sherman,2004,1902,1836,66,3.5
31,165,Sioux,2004,813,791,22,2.7
31,167,Stanton,2004,3794,3674,120,3.2
31,169,Thayer,2004,3050,2953,97,3.2
31,171,Thomas,2004,427,414,13,3.0
31,173,Thurston,2004,2965,2733,232,7.8
31,175,Valley,2004,2569,2483,86,3.3
31,177,Washington,2004,11135,10772,363,3.3
31,179,Wayne,2004,5546,5378,168,3.0
31,181,Webster,2004,2042,1957,85,4.2
31,183,Wheeler,2004,491,478,13,2.6
31,185,York,2004,8084,7828,256,3.2
32,1,Churchill,2004,12086,11573,513,4.2
32,3,Clark,2004,829804,792490,37314,4.5
32,5,Douglas,2004,22215,21251,964,4.3
32,7,Elko,2004,22936,22052,884,3.9
32,9,Esmeralda,2004,450,426,24,5.3
32,11,Eureka,2004,671,643,28,4.2
32,13,Humboldt,2004,7577,7279,298,3.9
32,15,Lander,2004,2447,2343,104,4.3
32,17,Lincoln,2004,1576,1492,84,5.3
32,19,Lyon,2004,19413,18335,1078,5.6
32,21,Mineral,2004,2125,2010,115,5.4
32,23,Nye,2004,15436,14506,930,6.0
32,27,Pershing,2004,2509,2400,109,4.3
32,29,Storey,2004,2078,2009,69,3.3
32,31,Washoe,2004,206198,197772,8426,4.1
32,33,White Pine,2004,3947,3799,148,3.7
32,510,Carson City,2004,27184,25825,1359,5.0
33,1,Belknap,2004,31641,30529,1112,3.5
33,3,Carroll,2004,24764,23966,798,3.2
33,5,Cheshire,2004,40863,39486,1377,3.4
33,7,Coos,2004,16491,15738,753,4.6
33,9,Grafton,2004,46345,45050,1295,2.8
33,11,Hillsborough,2004,222979,214265,8714,3.9
33,13,Merrimack,2004,77051,74600,2451,3.2
33,15,Rockingham,2004,168220,160424,7796,4.6
33,17,Strafford,2004,65888,63650,2238,3.4
33,19,Sullivan,2004,21252,20563,689,3.2
34,1,Atlantic,2004,134098,126548,7550,5.6
34,3,Bergen,2004,461555,442162,19393,4.2
34,5,Burlington,2004,234329,224641,9688,4.1
34,7,Camden,2004,259114,245520,13594,5.2
34,9,Cape May,2004,57018,53089,3929,6.9
34,11,Cumberland,2004,68310,63777,4533,6.6
34,13,Essex,2004,362548,340071,22477,6.2
34,15,Gloucester,2004,144459,137624,6835,4.7
34,17,Hudson,2004,286664,269065,17599,6.1
34,19,Hunterdon,2004,70295,67878,2417,3.4
34,21,Mercer,2004,188994,180908,8086,4.3
34,23,Middlesex,2004,409445,390703,18742,4.6
34,25,Monmouth,2004,321210,306694,14516,4.5
34,27,Morris,2004,264718,255034,9684,3.7
34,29,Ocean,2004,245350,232930,12420,5.1
34,31,Passaic,2004,233361,218978,14383,6.2
34,33,Salem,2004,30688,29079,1609,5.2
34,35,Somerset,2004,171526,165137,6389,3.7
34,37,Sussex,2004,82303,78705,3598,4.4
34,39,Union,2004,264374,250356,14018,5.3
34,41,Warren,2004,57688,55165,2523,4.4
35,1,Bernalillo,2004,297305,282359,14946,5.0
35,3,Catron,2004,1424,1319,105,7.4
35,5,Chaves,2004,25358,23662,1696,6.7
35,6,Cibola,2004,12164,11458,706,5.8
35,7,Colfax,2004,6908,6507,401,5.8
35,9,Curry,2004,20044,19187,857,4.3
35,11,De Baca,2004,906,843,63,7.0
35,13,Dona Ana,2004,81506,76461,5045,6.2
35,15,Eddy,2004,23876,22554,1322,5.5
35,17,Grant,2004,11714,10727,987,8.4
35,19,Guadalupe,2004,1675,1558,117,7.0
35,21,Harding,2004,383,363,20,5.2
35,23,Hidalgo,2004,2349,2210,139,5.9
35,25,Lea,2004,24196,23037,1159,4.8
35,27,Lincoln,2004,10910,10449,461,4.2
35,28,Los Alamos,2004,11308,11001,307,2.7
35,29,Luna,2004,11888,10033,1855,15.6
35,31,McKinley,2004,26473,24640,1833,6.9
35,33,Mora,2004,2091,1862,229,11.0
35,35,Otero,2004,26323,24974,1349,5.1
35,37,Quay,2004,3909,3670,239,6.1
35,39,Rio Arriba,2004,20470,19131,1339,6.5
35,41,Roosevelt,2004,9355,9008,347,3.7
35,43,Sandoval,2004,47510,44865,2645,5.6
35,45,San Juan,2004,52359,49258,3101,5.9
35,47,San Miguel,2004,13443,12568,875,6.5
35,49,Santa Fe,2004,74056,70879,3177,4.3
35,51,Sierra,2004,5295,4995,300,5.7
35,53,Socorro,2004,8817,8390,427,4.8
35,55,Taos,2004,16968,15736,1232,7.3
35,57,Torrance,2004,7540,7112,428,5.7
35,59,Union,2004,1920,1849,71,3.7
35,61,Valencia,2004,30024,28339,1685,5.6
36,1,Albany,2004,158263,151559,6704,4.2
36,3,Allegany,2004,23524,22000,1524,6.5
36,5,Bronx,2004,504256,458515,45741,9.1
36,7,Broome,2004,96053,90785,5268,5.5
36,9,Cattaraugus,2004,42171,39613,2558,6.1
36,11,Cayuga,2004,41652,39492,2160,5.2
36,13,Chautauqua,2004,66771,63076,3695,5.5
36,15,Chemung,2004,40420,37962,2458,6.1
36,17,Chenango,2004,24032,22683,1349,5.6
36,19,Clinton,2004,39797,37357,2440,6.1
36,21,Columbia,2004,31842,30432,1410,4.4
36,23,Cortland,2004,24019,22513,1506,6.3
36,25,Delaware,2004,23103,22041,1062,4.6
36,27,Dutchess,2004,144998,138753,6245,4.3
36,29,Erie,2004,470981,443783,27198,5.8
36,31,Essex,2004,18592,17563,1029,5.5
36,33,Franklin,2004,22340,20878,1462,6.5
36,35,Fulton,2004,26685,25161,1524,5.7
36,37,Genesee,2004,32987,31132,1855,5.6
36,39,Greene,2004,23250,22003,1247,5.4
36,41,Hamilton,2004,3056,2885,171,5.6
36,43,Herkimer,2004,31339,29557,1782,5.7
36,45,Jefferson,2004,46180,42943,3237,7.0
36,47,Kings,2004,1062594,982666,79928,7.5
36,49,Lewis,2004,12524,11693,831,6.6
36,51,Livingston,2004,32675,30749,1926,5.9
36,53,Madison,2004,35617,33607,2010,5.6
36,55,Monroe,2004,372709,353119,19590,5.3
36,57,Montgomery,2004,24149,22698,1451,6.0
36,59,Nassau,2004,682683,651557,31126,4.6
36,61,New York,2004,888203,834039,54164,6.1
36,63,Niagara,2004,111330,104369,6961,6.3
36,65,Oneida,2004,110303,104516,5787,5.2
36,67,Onondaga,2004,231052,219205,11847,5.1
36,69,Ontario,2004,55425,52632,2793,5.0
36,71,Orange,2004,174733,166427,8306,4.8
36,73,Orleans,2004,19813,18537,1276,6.4
36,75,Oswego,2004,59785,55620,4165,7.0
36,77,Otsego,2004,31333,29792,1541,4.9
36,79,Putnam,2004,55176,52962,2214,4.0
36,81,Queens,2004,1077735,1010578,67157,6.2
36,83,Rensselaer,2004,82863,78997,3866,4.7
36,85,Richmond,2004,227178,212812,14366,6.3
36,87,Rockland,2004,149430,142712,6718,4.5
36,89,St. Lawrence,2004,48945,45481,3464,7.1
36,91,Saratoga,2004,117716,113085,4631,3.9
36,93,Schenectady,2004,74335,70957,3378,4.5
36,95,Schoharie,2004,15595,14729,866,5.6
36,97,Schuyler,2004,9773,9187,586,6.0
36,99,Seneca,2004,17179,16271,908,5.3
36,101,Steuben,2004,44017,41168,2849,6.5
36,103,Suffolk,2004,767042,730779,36263,4.7
36,105,Sullivan,2004,34839,32968,1871,5.4
36,107,Tioga,2004,26077,24700,1377,5.3
36,109,Tompkins,2004,53872,51672,2200,4.1
36,111,Ulster,2004,91155,86667,4488,4.9
36,113,Warren,2004,34911,33180,1731,5.0
36,115,Washington,2004,31717,30203,1514,4.8
36,117,Wayne,2004,48399,45697,2702,5.6
36,119,Westchester,2004,476767,455285,21482,4.5
36,121,Wyoming,2004,20951,19629,1322,6.3
36,123,Yates,2004,13024,12424,600,4.6
37,1,Alamance,2004,69827,65189,4638,6.6
37,3,Alexander,2004,18699,17506,1193,6.4
37,5,Alleghany,2004,4914,4586,328,6.7
37,7,Anson,2004,10985,9983,1002,9.1
37,9,Ashe,2004,12922,12180,742,5.7
37,11,Avery,2004,8131,7692,439,5.4
37,13,Beaufort,2004,20174,18697,1477,7.3
37,15,Bertie,2004,8438,7746,692,8.2
37,17,Bladen,2004,15789,14597,1192,7.5
37,19,Brunswick,2004,40659,38325,2334,5.7
37,21,Buncombe,2004,114238,109017,5221,4.6
37,23,Burke,2004,42615,39589,3026,7.1
37,25,Cabarrus,2004,77429,72349,5080,6.6
37,27,Caldwell,2004,40222,37042,3180,7.9
37,29,Camden,2004,4231,4058,173,4.1
37,31,Carteret,2004,31970,30384,1586,5.0
37,33,Caswell,2004,10794,9888,906,8.4
37,35,Catawba,2004,77874,72472,5402,6.9
37,37,Chatham,2004,30198,28927,1271,4.2
37,39,Cherokee,2004,9988,9352,636,6.4
37,41,Chowan,2004,6962,6619,343,4.9
37,43,Clay,2004,4411,4216,195,4.4
37,45,Cleveland,2004,47639,43871,3768,7.9
37,47,Columbus,2004,23818,22218,1600,6.7
37,49,Craven,2004,40488,38432,2056,5.1
37,51,Cumberland,2004,123879,116884,6995,5.6
37,53,Currituck,2004,11451,11097,354,3.1
37,55,Dare,2004,22519,21401,1118,5.0
37,57,Davidson,2004,78844,73404,5440,6.9
37,59,Davie,2004,19515,18484,1031,5.3
37,61,Duplin,2004,24543,23058,1485,6.1
37,63,Durham,2004,128799,122646,6153,4.8
37,65,Edgecombe,2004,24738,22478,2260,9.1
37,67,Forsyth,2004,167168,158301,8867,5.3
37,69,Franklin,2004,25912,24479,1433,5.5
37,71,Gaston,2004,96905,90345,6560,6.8
37,73,Gates,2004,4915,4704,211,4.3
37,75,Graham,2004,3868,3545,323,8.4
37,77,Granville,2004,24159,22412,1747,7.2
37,79,Greene,2004,9011,8417,594,6.6
37,81,Guilford,2004,239488,225859,13629,5.7
37,83,Halifax,2004,23660,21725,1935,8.2
37,85,Harnett,2004,44628,42080,2548,5.7
37,87,Haywood,2004,27195,25874,1321,4.9
37,89,Henderson,2004,45773,43731,2042,4.5
37,91,Hertford,2004,9734,9126,608,6.2
37,93,Hoke,2004,17034,15974,1060,6.2
37,95,Hyde,2004,2977,2775,202,6.8
37,97,Iredell,2004,71722,67616,4106,5.7
37,99,Jackson,2004,19937,19036,901,4.5
37,101,Johnston,2004,69307,65996,3311,4.8
37,103,Jones,2004,4925,4676,249,5.1
37,105,Lee,2004,25814,24217,1597,6.2
37,107,Lenoir,2004,27524,25792,1732,6.3
37,109,Lincoln,2004,35929,33629,2300,6.4
37,111,McDowell,2004,21756,20248,1508,6.9
37,113,Macon,2004,15509,14739,770,5.0
37,115,Madison,2004,9752,9210,542,5.6
37,117,Martin,2004,12114,11259,855,7.1
37,119,Mecklenburg,2004,420044,397263,22781,5.4
37,121,Mitchell,2004,7610,7055,555,7.3
37,123,Montgomery,2004,12639,11680,959,7.6
37,125,Moore,2004,36044,33913,2131,5.9
37,127,Nash,2004,44599,41589,3010,6.7
37,129,New Hanover,2004,94581,90117,4464,4.7
37,131,Northampton,2004,8915,8248,667,7.5
37,133,Onslow,2004,55768,52550,3218,5.8
37,135,Orange,2004,64567,61934,2633,4.1
37,137,Pamlico,2004,5640,5363,277,4.9
37,139,Pasquotank,2004,17117,16281,836,4.9
37,141,Pender,2004,21206,20096,1110,5.2
37,143,Perquimans,2004,5132,4874,258,5.0
37,145,Person,2004,18639,17328,1311,7.0
37,147,Pitt,2004,72474,68078,4396,6.1
37,149,Polk,2004,9054,8632,422,4.7
37,151,Randolph,2004,74171,70181,3990,5.4
37,153,Richmond,2004,20372,18634,1738,8.5
37,155,Robeson,2004,52283,48308,3975,7.6
37,157,Rockingham,2004,46179,42577,3602,7.8
37,159,Rowan,2004,68531,63237,5294,7.7
37,161,Rutherford,2004,30353,27442,2911,9.6
37,163,Sampson,2004,31612,29981,1631,5.2
37,165,Scotland,2004,15539,13771,1768,11.4
37,167,Stanly,2004,29442,27497,1945,6.6
37,169,Stokes,2004,23984,22637,1347,5.6
37,171,Surry,2004,35772,33479,2293,6.4
37,173,Swain,2004,6704,6189,515,7.7
37,175,Transylvania,2004,12314,11401,913,7.4
37,177,Tyrrell,2004,2197,2038,159,7.2
37,179,Union,2004,79066,75037,4029,5.1
37,181,Vance,2004,19517,17515,2002,10.3
37,183,Wake,2004,393001,374804,18197,4.6
37,185,Warren,2004,8352,7702,650,7.8
37,187,Washington,2004,6163,5710,453,7.4
37,189,Watauga,2004,22834,21841,993,4.3
37,191,Wayne,2004,51435,48542,2893,5.6
37,193,Wilkes,2004,33461,31304,2157,6.4
37,195,Wilson,2004,39041,35666,3375,8.6
37,197,Yadkin,2004,19248,18177,1071,5.6
37,199,Yancey,2004,7951,7401,550,6.9
38,1,Adams,2004,1288,1255,33,2.6
38,3,Barnes,2004,6113,5915,198,3.2
38,5,Benson,2004,2810,2673,137,4.9
38,7,Billings,2004,496,484,12,2.4
38,9,Bottineau,2004,3534,3393,141,4.0
38,11,Bowman,2004,1739,1698,41,2.4
38,13,Burke,2004,1056,1020,36,3.4
38,15,Burleigh,2004,43491,42283,1208,2.8
38,17,Cass,2004,80987,78841,2146,2.6
38,19,Cavalier,2004,2204,2125,79,3.6
38,21,Dickey,2004,2842,2764,78,2.7
38,23,Divide,2004,1021,986,35,3.4
38,25,Dunn,2004,1722,1661,61,3.5
38,27,Eddy,2004,1356,1290,66,4.9
38,29,Emmons,2004,1895,1792,103,5.4
38,31,Foster,2004,1806,1750,56,3.1
38,33,Golden Valley,2004,939,910,29,3.1
38,35,Grand Forks,2004,37518,36374,1144,3.0
38,37,Grant,2004,1281,1235,46,3.6
38,39,Griggs,2004,1375,1341,34,2.5
38,41,Hettinger,2004,1219,1177,42,3.4
38,43,Kidder,2004,1236,1163,73,5.9
38,45,LaMoure,2004,2343,2264,79,3.4
38,47,Logan,2004,965,925,40,4.1
38,49,McHenry,2004,2803,2642,161,5.7
38,51,McIntosh,2004,1494,1452,42,2.8
38,53,McKenzie,2004,2753,2660,93,3.4
38,55,McLean,2004,4621,4367,254,5.5
38,57,Mercer,2004,4762,4551,211,4.4
38,59,Morton,2004,14404,13892,512,3.6
38,61,Mountrail,2004,3109,2947,162,5.2
38,63,Nelson,2004,1771,1705,66,3.7
38,65,Oliver,2004,1252,1206,46,3.7
38,67,Pembina,2004,4196,3861,335,8.0
38,69,Pierce,2004,1989,1896,93,4.7
38,71,Ramsey,2004,6028,5788,240,4.0
38,73,Ransom,2004,3122,3031,91,2.9
38,75,Renville,2004,1298,1263,35,2.7
38,77,Richland,2004,9289,8982,307,3.3
38,79,Rolette,2004,5292,4799,493,9.3
38,81,Sargent,2004,2356,2288,68,2.9
38,83,Sheridan,2004,765,718,47,6.1
38,85,Sioux,2004,1353,1263,90,6.7
38,87,Slope,2004,449,435,14,3.1
38,89,Stark,2004,13093,12684,409,3.1
38,91,Steele,2004,1218,1190,28,2.3
38,93,Stutsman,2004,11725,11351,374,3.2
38,95,Towner,2004,1349,1292,57,4.2
38,97,Traill,2004,4223,4066,157,3.7
38,99,Walsh,2004,5953,5679,274,4.6
38,101,Ward,2004,28292,27309,983,3.5
38,103,Wells,2004,2317,2209,108,4.7
38,105,Williams,2004,11147,10853,294,2.6
39,1,Adams,2004,12799,11550,1249,9.8
39,3,Allen,2004,52228,48683,3545,6.8
39,5,Ashland,2004,27053,25089,1964,7.3
39,7,Ashtabula,2004,49994,46206,3788,7.6
39,9,Athens,2004,29595,27563,2032,6.9
39,11,Auglaize,2004,25219,23888,1331,5.3
39,13,Belmont,2004,31984,29711,2273,7.1
39,15,Brown,2004,21738,20165,1573,7.2
39,17,Butler,2004,182503,172257,10246,5.6
39,19,Carroll,2004,14203,13114,1089,7.7
39,21,Champaign,2004,20642,19342,1300,6.3
39,23,Clark,2004,70629,65713,4916,7.0
39,25,Clermont,2004,102213,96390,5823,5.7
39,27,Clinton,2004,21877,20504,1373,6.3
39,29,Columbiana,2004,53394,49319,4075,7.6
39,31,Coshocton,2004,17645,16002,1643,9.3
39,33,Crawford,2004,22933,21124,1809,7.9
39,35,Cuyahoga,2004,669675,632531,37144,5.5
39,37,Darke,2004,28068,26309,1759,6.3
39,39,Defiance,2004,20537,19236,1301,6.3
39,41,Delaware,2004,78870,75324,3546,4.5
39,43,Erie,2004,42612,39750,2862,6.7
39,45,Fairfield,2004,71576,67434,4142,5.8
39,47,Fayette,2004,15937,14995,942,5.9
39,49,Franklin,2004,597189,563540,33649,5.6
39,51,Fulton,2004,22785,21287,1498,6.6
39,53,Gallia,2004,14155,12965,1190,8.4
39,55,Geauga,2004,50499,48318,2181,4.3
39,57,Greene,2004,76887,72375,4512,5.9
39,59,Guernsey,2004,19870,18233,1637,8.2
39,61,Hamilton,2004,419482,395170,24312,5.8
39,63,Hancock,2004,39338,37216,2122,5.4
39,65,Hardin,2004,15772,14723,1049,6.7
39,67,Harrison,2004,7419,6869,550,7.4
39,69,Henry,2004,15959,14913,1046,6.6
39,71,Highland,2004,20410,19072,1338,6.6
39,73,Hocking,2004,13690,12587,1103,8.1
39,75,Holmes,2004,18919,18107,812,4.3
39,77,Huron,2004,29850,27426,2424,8.1
39,79,Jackson,2004,15182,13851,1331,8.8
39,81,Jefferson,2004,32025,29347,2678,8.4
39,83,Knox,2004,29109,27328,1781,6.1
39,85,Lake,2004,131109,124771,6338,4.8
39,87,Lawrence,2004,28184,26324,1860,6.6
39,89,Licking,2004,80368,75353,5015,6.2
39,91,Logan,2004,24294,22903,1391,5.7
39,93,Lorain,2004,151998,144033,7965,5.2
39,95,Lucas,2004,223792,206655,17137,7.7
39,97,Madison,2004,19593,18392,1201,6.1
39,99,Mahoning,2004,119144,109889,9255,7.8
39,101,Marion,2004,31905,29727,2178,6.8
39,103,Medina,2004,91517,87396,4121,4.5
39,105,Meigs,2004,9019,8012,1007,11.2
39,107,Mercer,2004,22892,21818,1074,4.7
39,109,Miami,2004,54102,50869,3233,6.0
39,111,Monroe,2004,6061,5378,683,11.3
39,113,Montgomery,2004,272066,253555,18511,6.8
39,115,Morgan,2004,6338,5648,690,10.9
39,117,Morrow,2004,17483,16367,1116,6.4
39,119,Muskingum,2004,40935,37394,3541,8.7
39,121,Noble,2004,5756,5241,515,8.9
39,123,Ottawa,2004,21550,19736,1814,8.4
39,125,Paulding,2004,10379,9757,622,6.0
39,127,Perry,2004,16601,15070,1531,9.2
39,129,Pickaway,2004,23555,21770,1785,7.6
39,131,Pike,2004,10937,9769,1168,10.7
39,133,Portage,2004,87428,82146,5282,6.0
39,135,Preble,2004,21697,20308,1389,6.4
39,137,Putnam,2004,17539,16323,1216,6.9
39,139,Richland,2004,62988,58275,4713,7.5
39,141,Ross,2004,34584,31798,2786,8.1
39,143,Sandusky,2004,33304,31076,2228,6.7
39,145,Scioto,2004,32763,29729,3034,9.3
39,147,Seneca,2004,31218,29026,2192,7.0
39,149,Shelby,2004,26906,25498,1408,5.2
39,151,Stark,2004,189591,176538,13053,6.9
39,153,Summit,2004,285467,267421,18046,6.3
39,155,Trumbull,2004,105086,96814,8272,7.9
39,157,Tuscarawas,2004,46965,44003,2962,6.3
39,159,Union,2004,23802,22560,1242,5.2
39,161,Van Wert,2004,14962,14113,849,5.7
39,163,Vinton,2004,5418,4931,487,9.0
39,165,Warren,2004,99428,94337,5091,5.1
39,167,Washington,2004,32954,30795,2159,6.6
39,169,Wayne,2004,60016,56686,3330,5.5
39,171,Williams,2004,19605,18322,1283,6.5
39,173,Wood,2004,66712,62692,4020,6.0
39,175,Wyandot,2004,13251,12477,774,5.8
40,1,Adair,2004,9892,9301,591,6.0
40,3,Alfalfa,2004,2496,2403,93,3.7
40,5,Atoka,2004,5491,5158,333,6.1
40,7,Beaver,2004,2961,2863,98,3.3
40,9,Beckham,2004,9409,9115,294,3.1
40,11,Blaine,2004,4724,4511,213,4.5
40,13,Bryan,2004,18560,17838,722,3.9
40,15,Caddo,2004,12179,11517,662,5.4
40,17,Canadian,2004,49890,47964,1926,3.9
40,19,Carter,2004,23193,22135,1058,4.6
40,21,Cherokee,2004,20743,19820,923,4.4
40,23,Choctaw,2004,6344,5910,434,6.8
40,25,Cimarron,2004,1440,1398,42,2.9
40,27,Cleveland,2004,116634,112393,4241,3.6
40,29,Coal,2004,2263,2035,228,10.1
40,31,Comanche,2004,45760,43854,1906,4.2
40,33,Cotton,2004,3241,3116,125,3.9
40,35,Craig,2004,6621,6311,310,4.7
40,37,Creek,2004,31765,30001,1764,5.6
40,39,Custer,2004,13404,12982,422,3.1
40,41,Delaware,2004,17073,16226,847,5.0
40,43,Dewey,2004,2417,2343,74,3.1
40,45,Ellis,2004,2168,2110,58,2.7
40,47,Garfield,2004,27867,26881,986,3.5
40,49,Garvin,2004,13226,12690,536,4.1
40,51,Grady,2004,22989,21983,1006,4.4
40,53,Grant,2004,2517,2431,86,3.4
40,55,Greer,2004,2211,2076,135,6.1
40,57,Harmon,2004,1428,1380,48,3.4
40,59,Harper,2004,1841,1787,54,2.9
40,61,Haskell,2004,5234,4956,278,5.3
40,63,Hughes,2004,5297,4858,439,8.3
40,65,Jackson,2004,12518,12055,463,3.7
40,67,Jefferson,2004,2417,2280,137,5.7
40,69,Johnston,2004,4612,4353,259,5.6
40,71,Kay,2004,22004,20703,1301,5.9
40,73,Kingfisher,2004,7550,7316,234,3.1
40,75,Kiowa,2004,4300,4108,192,4.5
40,77,Latimer,2004,4155,3923,232,5.6
40,79,Le Flore,2004,21231,20089,1142,5.4
40,81,Lincoln,2004,14829,14120,709,4.8
40,83,Logan,2004,18027,17339,688,3.8
40,85,Love,2004,4747,4470,277,5.8
40,87,McClain,2004,14326,13721,605,4.2
40,89,McCurtain,2004,14670,13592,1078,7.3
40,91,McIntosh,2004,8472,7919,553,6.5
40,93,Major,2004,3726,3611,115,3.1
40,95,Marshall,2004,6101,5813,288,4.7
40,97,Mayes,2004,16388,15435,953,5.8
40,99,Murray,2004,6505,6223,282,4.3
40,101,Muskogee,2004,28678,26751,1927,6.7
40,103,Noble,2004,5256,5056,200,3.8
40,105,Nowata,2004,4887,4616,271,5.5
40,107,Okfuskee,2004,4571,4188,383,8.4
40,109,Oklahoma,2004,332420,316905,15515,4.7
40,111,Okmulgee,2004,16806,15648,1158,6.9
40,113,Osage,2004,20539,19483,1056,5.1
40,115,Ottawa,2004,15508,14631,877,5.7
40,117,Pawnee,2004,7763,7326,437,5.6
40,119,Payne,2004,34506,33215,1291,3.7
40,121,Pittsburg,2004,19708,18652,1056,5.4
40,123,Pontotoc,2004,17729,16727,1002,5.7
40,125,Pottawatomie,2004,30421,28800,1621,5.3
40,127,Pushmataha,2004,5015,4704,311,6.2
40,129,Roger Mills,2004,1879,1830,49,2.6
40,131,Rogers,2004,38868,37166,1702,4.4
40,133,Seminole,2004,10208,9233,975,9.6
40,135,Sequoyah,2004,18003,16941,1062,5.9
40,137,Stephens,2004,19435,18573,862,4.4
40,139,Texas,2004,10059,9732,327,3.3
40,141,Tillman,2004,3619,3456,163,4.5
40,143,Tulsa,2004,291265,277674,13591,4.7
40,145,Wagoner,2004,31232,29809,1423,4.6
40,147,Washington,2004,24127,22962,1165,4.8
40,149,Washita,2004,5823,5635,188,3.2
40,151,Woods,2004,4613,4297,316,6.9
40,153,Woodward,2004,9717,9372,345,3.6
41,1,Baker,2004,7254,6607,647,8.9
41,3,Benton,2004,42274,39959,2315,5.5
41,5,Clackamas,2004,189750,177001,12749,6.7
41,7,Clatsop,2004,18798,17506,1292,6.9
41,9,Columbia,2004,23155,21041,2114,9.1
41,11,Coos,2004,28518,25937,2581,9.1
41,13,Crook,2004,9058,8299,759,8.4
41,15,Curry,2004,9547,8826,721,7.6
41,17,Deschutes,2004,71437,66542,4895,6.9
41,19,Douglas,2004,47594,43147,4447,9.3
41,21,Gilliam,2004,1050,985,65,6.2
41,23,Grant,2004,3818,3440,378,9.9
41,25,Harney,2004,3430,3103,327,9.5
41,27,Hood River,2004,12324,11408,916,7.4
41,29,Jackson,2004,98203,91138,7065,7.2
41,31,Jefferson,2004,8970,8400,570,6.4
41,33,Josephine,2004,34066,31223,2843,8.3
41,35,Klamath,2004,29864,27051,2813,9.4
41,37,Lake,2004,3568,3217,351,9.8
41,39,Lane,2004,172876,160223,12653,7.3
41,41,Lincoln,2004,22149,20343,1806,8.2
41,43,Linn,2004,51913,47144,4769,9.2
41,45,Malheur,2004,13049,11756,1293,9.9
41,47,Marion,2004,148720,137411,11309,7.6
41,49,Morrow,2004,5643,5181,462,8.2
41,51,Multnomah,2004,365272,337936,27336,7.5
41,53,Polk,2004,34910,32586,2324,6.7
41,55,Sherman,2004,891,809,82,9.2
41,57,Tillamook,2004,12234,11364,870,7.1
41,59,Umatilla,2004,37038,34046,2992,8.1
41,61,Union,2004,12116,11229,887,7.3
41,63,Wallowa,2004,3563,3242,321,9.0
41,65,Wasco,2004,12875,11758,1117,8.7
41,67,Washington,2004,264946,248412,16534,6.2
41,69,Wheeler,2004,672,619,53,7.9
41,71,Yamhill,2004,43867,40673,3194,7.3
42,1,Adams,2004,52735,50649,2086,4.0
42,3,Allegheny,2004,633883,600577,33306,5.3
42,5,Armstrong,2004,33480,31149,2331,7.0
42,7,Beaver,2004,89544,84433,5111,5.7
42,9,Bedford,2004,24013,22179,1834,7.6
42,11,Berks,2004,195670,185475,10195,5.2
42,13,Blair,2004,64994,61527,3467,5.3
42,15,Bradford,2004,32210,30563,1647,5.1
42,17,Bucks,2004,338178,322769,15409,4.6
42,19,Butler,2004,94491,89288,5203,5.5
42,21,Cambria,2004,66989,62421,4568,6.8
42,23,Cameron,2004,2646,2461,185,7.0
42,25,Carbon,2004,29835,27937,1898,6.4
42,27,Centre,2004,71843,68646,3197,4.4
42,29,Chester,2004,250457,241142,9315,3.7
42,31,Clarion,2004,20357,19213,1144,5.6
42,33,Clearfield,2004,41216,38404,2812,6.8
42,35,Clinton,2004,18861,17627,1234,6.5
42,37,Columbia,2004,33567,31372,2195,6.5
42,39,Crawford,2004,42240,39522,2718,6.4
42,41,Cumberland,2004,118428,113863,4565,3.9
42,43,Dauphin,2004,133571,127249,6322,4.7
42,45,Delaware,2004,277952,264045,13907,5.0
42,47,Elk,2004,17533,16575,958,5.5
42,49,Erie,2004,139463,130992,8471,6.1
42,51,Fayette,2004,65733,60776,4957,7.5
42,53,Forest,2004,2258,2032,226,10.0
42,55,Franklin,2004,74075,71351,2724,3.7
42,57,Fulton,2004,7567,7201,366,4.8
42,59,Greene,2004,17138,16025,1113,6.5
42,61,Huntingdon,2004,21686,20201,1485,6.8
42,63,Indiana,2004,44404,41677,2727,6.1
42,65,Jefferson,2004,22120,20785,1335,6.0
42,67,Juniata,2004,12952,12367,585,4.5
42,69,Lackawanna,2004,104670,98490,6180,5.9
42,71,Lancaster,2004,264382,254274,10108,3.8
42,73,Lawrence,2004,44106,41373,2733,6.2
42,75,Lebanon,2004,68882,66142,2740,4.0
42,77,Lehigh,2004,168546,159637,8909,5.3
42,79,Luzerne,2004,156554,146230,10324,6.6
42,81,Lycoming,2004,59952,56354,3598,6.0
42,83,McKean,2004,21754,20470,1284,5.9
42,85,Mercer,2004,55179,51701,3478,6.3
42,87,Mifflin,2004,22767,21279,1488,6.5
42,89,Monroe,2004,76387,72013,4374,5.7
42,91,Montgomery,2004,419536,402092,17444,4.2
42,93,Montour,2004,8821,8369,452,5.1
42,95,Northampton,2004,145707,137942,7765,5.3
42,97,Northumberland,2004,46303,43356,2947,6.4
42,99,Perry,2004,24066,22901,1165,4.8
42,101,Philadelphia/city,2004,619762,574928,44834,7.2
42,103,Pike,2004,24924,23455,1469,5.9
42,105,Potter,2004,8550,7988,562,6.6
42,107,Schuylkill,2004,69951,65229,4722,6.8
42,109,Snyder,2004,19841,18935,906,4.6
42,111,Somerset,2004,39135,36664,2471,6.3
42,113,Sullivan,2004,3113,2926,187,6.0
42,115,Susquehanna,2004,21529,20331,1198,5.6
42,117,Tioga,2004,21174,19957,1217,5.7
42,119,Union,2004,17778,16820,958,5.4
42,121,Venango,2004,26404,24815,1589,6.0
42,123,Warren,2004,21282,20092,1190,5.6
42,125,Washington,2004,101628,95847,5781,5.7
42,127,Wayne,2004,24024,22793,1231,5.1
42,129,Westmoreland,2004,184893,174002,10891,5.9
42,131,Wyoming,2004,14197,13335,862,6.1
42,133,York,2004,214949,205379,9570,4.5
44,1,Bristol,2004,27749,26499,1250,4.5
44,3,Kent,2004,94518,89796,4722,5.0
44,5,Newport,2004,44228,42148,2080,4.7
44,7,Providence,2004,317672,299593,18079,5.7
44,9,Washington,2004,71514,68453,3061,4.3
45,1,Abbeville,2004,12011,10941,1070,8.9
45,3,Aiken,2004,73852,69286,4566,6.2
45,5,Allendale,2004,3305,2958,347,10.5
45,7,Anderson,2004,83819,77295,6524,7.8
45,9,Bamberg,2004,6459,5947,512,7.9
45,11,Barnwell,2004,9507,8528,979,10.3
45,13,Beaufort,2004,59227,56023,3204,5.4
45,15,Berkeley,2004,70254,66010,4244,6.0
45,17,Calhoun,2004,7093,6580,513,7.2
45,19,Charleston,2004,165236,155501,9735,5.9
45,21,Cherokee,2004,25274,22842,2432,9.6
45,23,Chester,2004,15761,14075,1686,10.7
45,25,Chesterfield,2004,18398,16402,1996,10.8
45,27,Clarendon,2004,12730,11495,1235,9.7
45,29,Colleton,2004,16397,15101,1296,7.9
45,31,Darlington,2004,30927,28154,2773,9.0
45,33,Dillon,2004,13026,11649,1377,10.6
45,35,Dorchester,2004,53587,50620,2967,5.5
45,37,Edgefield,2004,10971,10272,699,6.4
45,39,Fairfield,2004,11371,10385,986,8.7
45,41,Florence,2004,61570,55948,5622,9.1
45,43,Georgetown,2004,28126,25215,2911,10.3
45,45,Greenville,2004,207309,194025,13284,6.4
45,47,Greenwood,2004,32550,29458,3092,9.5
45,49,Hampton,2004,7780,6989,791,10.2
45,51,Horry,2004,116848,109303,7545,6.5
45,53,Jasper,2004,9981,9385,596,6.0
45,55,Kershaw,2004,28245,26338,1907,6.8
45,57,Lancaster,2004,29902,27024,2878,9.6
45,59,Laurens,2004,33287,30709,2578,7.7
45,61,Lee,2004,8288,7503,785,9.5
45,63,Lexington,2004,124750,118084,6666,5.3
45,65,McCormick,2004,3504,3083,421,12.0
45,67,Marion,2004,14356,12256,2100,14.6
45,69,Marlboro,2004,12590,10824,1766,14.0
45,71,Newberry,2004,17562,16159,1403,8.0
45,73,Oconee,2004,31901,29320,2581,8.1
45,75,Orangeburg,2004,40037,35939,4098,10.2
45,77,Pickens,2004,57026,52827,4199,7.4
45,79,Richland,2004,168459,157410,11049,6.6
45,81,Saluda,2004,9296,8545,751,8.1
45,83,Spartanburg,2004,132221,121334,10887,8.2
45,85,Sumter,2004,45978,42069,3909,8.5
45,87,Union,2004,13148,11424,1724,13.1
45,89,Williamsburg,2004,15298,13306,1992,13.0
45,91,York,2004,94645,87178,7467,7.9
46,3,Aurora,2004,1436,1383,53,3.7
46,5,Beadle,2004,8878,8541,337,3.8
46,7,Bennett,2004,1426,1370,56,3.9
46,9,Bon Homme,2004,3345,3229,116,3.5
46,11,Brookings,2004,18006,17487,519,2.9
46,13,Brown,2004,20625,19990,635,3.1
46,15,Brule,2004,2878,2799,79,2.7
46,17,Buffalo,2004,566,505,61,10.8
46,19,Butte,2004,5130,4950,180,3.5
46,21,Campbell,2004,923,888,35,3.8
46,23,Charles Mix,2004,4247,4077,170,4.0
46,25,Clark,2004,1911,1829,82,4.3
46,27,Clay,2004,7307,7074,233,3.2
46,29,Codington,2004,15707,15159,548,3.5
46,31,Corson,2004,1446,1357,89,6.2
46,33,Custer,2004,4701,4519,182,3.9
46,35,Davison,2004,10881,10558,323,3.0
46,37,Day,2004,3046,2857,189,6.2
46,39,Deuel,2004,2635,2520,115,4.4
46,41,Dewey,2004,2720,2491,229,8.4
46,43,Douglas,2004,1817,1763,54,3.0
46,45,Edmunds,2004,2070,1999,71,3.4
46,47,Fall River,2004,3825,3665,160,4.2
46,49,Faulk,2004,1176,1139,37,3.1
46,51,Grant,2004,4178,3996,182,4.4
46,53,Gregory,2004,2514,2429,85,3.4
46,55,Haakon,2004,1238,1206,32,2.6
46,57,Hamlin,2004,2856,2748,108,3.8
46,59,Hand,2004,1934,1875,59,3.1
46,61,Hanson,2004,1954,1893,61,3.1
46,63,Harding,2004,808,783,25,3.1
46,65,Hughes,2004,9827,9550,277,2.8
46,67,Hutchinson,2004,3858,3718,140,3.6
46,69,Hyde,2004,830,801,29,3.5
46,71,Jackson,2004,1270,1197,73,5.7
46,73,Jerauld,2004,1378,1336,42,3.0
46,75,Jones,2004,769,750,19,2.5
46,77,Kingsbury,2004,3124,3003,121,3.9
46,79,Lake,2004,6621,6385,236,3.6
46,81,Lawrence,2004,12538,12111,427,3.4
46,83,Lincoln,2004,18296,17795,501,2.7
46,85,Lyman,2004,2031,1936,95,4.7
46,87,McCook,2004,2957,2859,98,3.3
46,89,McPherson,2004,1251,1195,56,4.5
46,91,Marshall,2004,2101,1998,103,4.9
46,93,Meade,2004,12700,12255,445,3.5
46,95,Mellette,2004,920,866,54,5.9
46,97,Miner,2004,1217,1163,54,4.4
46,99,Minnehaha,2004,92563,89414,3149,3.4
46,101,Moody,2004,3834,3640,194,5.1
46,102,Oglala Lakota,2004,3879,3533,346,8.9
46,103,Pennington,2004,51983,50232,1751,3.4
46,105,Perkins,2004,1767,1702,65,3.7
46,107,Potter,2004,1381,1332,49,3.5
46,109,Roberts,2004,4702,4461,241,5.1
46,111,Sanborn,2004,1558,1507,51,3.3
46,115,Spink,2004,3465,3342,123,3.5
46,117,Stanley,2004,1897,1846,51,2.7
46,119,Sully,2004,1018,994,24,2.4
46,121,Todd,2004,3422,3222,200,5.8
46,123,Tripp,2004,3117,3010,107,3.4
46,125,Turner,2004,4588,4418,170,3.7
46,127,Union,2004,7472,7134,338,4.5
46,129,Walworth,2004,2744,2602,142,5.2
46,135,Yankton,2004,11758,11363,395,3.4
46,137,Ziebach,2004,936,871,65,6.9
47,1,Anderson,2004,34669,32990,1679,4.8
47,3,Bedford,2004,21020,19898,1122,5.3
47,5,Benton,2004,6841,6271,570,8.3
47,7,Bledsoe,2004,4775,4420,355,7.4
47,9,Blount,2004,58452,55991,2461,4.2
47,11,Bradley,2004,46089,43798,2291,5.0
47,13,Campbell,2004,16868,15869,999,5.9
47,15,Cannon,2004,6351,6057,294,4.6
47,17,Carroll,2004,13763,12648,1115,8.1
47,19,Carter,2004,28913,27218,1695,5.9
47,21,Cheatham,2004,20055,19154,901,4.5
47,23,Chester,2004,7485,7063,422,5.6
47,25,Claiborne,2004,12684,11991,693,5.5
47,27,Clay,2004,3629,3300,329,9.1
47,29,Cocke,2004,15485,14254,1231,7.9
47,31,Coffee,2004,25333,24134,1199,4.7
47,33,Crockett,2004,6635,6121,514,7.7
47,35,Cumberland,2004,21882,20503,1379,6.3
47,37,Davidson,2004,301955,288420,13535,4.5
47,39,Decatur,2004,5465,5070,395,7.2
47,41,DeKalb,2004,9699,9214,485,5.0
47,43,Dickson,2004,22592,21431,1161,5.1
47,45,Dyer,2004,17729,16678,1051,5.9
47,47,Fayette,2004,15557,14586,971,6.2
47,49,Fentress,2004,7229,6755,474,6.6
47,51,Franklin,2004,20178,19127,1051,5.2
47,53,Gibson,2004,21496,19767,1729,8.0
47,55,Giles,2004,13429,12460,969,7.2
47,57,Grainger,2004,9951,9357,594,6.0
47,59,Greene,2004,32265,29804,2461,7.6
47,61,Grundy,2004,5766,5415,351,6.1
47,63,Hamblen,2004,29281,27688,1593,5.4
47,65,Hamilton,2004,156768,149742,7026,4.5
47,67,Hancock,2004,2431,2195,236,9.7
47,69,Hardeman,2004,11202,10299,903,8.1
47,71,Hardin,2004,11362,10515,847,7.5
47,73,Hawkins,2004,25229,23703,1526,6.0
47,75,Haywood,2004,9367,8575,792,8.5
47,77,Henderson,2004,13271,12370,901,6.8
47,79,Henry,2004,14287,13150,1137,8.0
47,81,Hickman,2004,10121,9506,615,6.1
47,83,Houston,2004,3770,3481,289,7.7
47,85,Humphreys,2004,8830,8204,626,7.1
47,87,Jackson,2004,5206,4855,351,6.7
47,89,Jefferson,2004,23345,21920,1425,6.1
47,91,Johnson,2004,6913,6378,535,7.7
47,93,Knox,2004,213535,205216,8319,3.9
47,95,Lake,2004,2611,2436,175,6.7
47,97,Lauderdale,2004,9958,8979,979,9.8
47,99,Lawrence,2004,18017,16460,1557,8.6
47,101,Lewis,2004,5227,4865,362,6.9
47,103,Lincoln,2004,15960,15134,826,5.2
47,105,Loudon,2004,21340,20388,952,4.5
47,107,McMinn,2004,23678,22136,1542,6.5
47,109,McNairy,2004,12215,11485,730,6.0
47,111,Macon,2004,10392,9829,563,5.4
47,113,Madison,2004,46274,43727,2547,5.5
47,115,Marion,2004,12792,11996,796,6.2
47,117,Marshall,2004,12746,11857,889,7.0
47,119,Maury,2004,36029,34089,1940,5.4
47,121,Meigs,2004,4812,4463,349,7.3
47,123,Monroe,2004,18051,16896,1155,6.4
47,125,Montgomery,2004,64091,61064,3027,4.7
47,127,Moore,2004,3143,3006,137,4.4
47,129,Morgan,2004,8119,7501,618,7.6
47,131,Obion,2004,15741,14742,999,6.3
47,133,Overton,2004,9873,9325,548,5.6
47,135,Perry,2004,3183,2972,211,6.6
47,137,Pickett,2004,1928,1763,165,8.6
47,139,Polk,2004,7273,6865,408,5.6
47,141,Putnam,2004,33937,32406,1531,4.5
47,143,Rhea,2004,13289,12452,837,6.3
47,145,Roane,2004,25145,23710,1435,5.7
47,147,Robertson,2004,31023,29543,1480,4.8
47,149,Rutherford,2004,113748,109101,4647,4.1
47,151,Scott,2004,8389,7780,609,7.3
47,153,Sequatchie,2004,5644,5344,300,5.3
47,155,Sevier,2004,44010,41312,2698,6.1
47,157,Shelby,2004,429443,403712,25731,6.0
47,159,Smith,2004,9042,8441,601,6.6
47,161,Stewart,2004,5871,5484,387,6.6
47,163,Sullivan,2004,72056,68078,3978,5.5
47,165,Sumner,2004,73921,70669,3252,4.4
47,167,Tipton,2004,25908,24294,1614,6.2
47,169,Trousdale,2004,3576,3373,203,5.7
47,171,Unicoi,2004,8261,7746,515,6.2
47,173,Union,2004,8699,8260,439,5.0
47,175,Van Buren,2004,2478,2322,156,6.3
47,177,Warren,2004,19257,18257,1000,5.2
47,179,Washington,2004,57482,54627,2855,5.0
47,181,Wayne,2004,6592,6031,561,8.5
47,183,Weakley,2004,15668,14522,1146,7.3
47,185,White,2004,10827,10186,641,5.9
47,187,Williamson,2004,77890,75081,2809,3.6
47,189,Wilson,2004,53038,50650,2388,4.5
48,1,Anderson,2004,20601,19161,1440,7.0
48,3,Andrews,2004,6203,5909,294,4.7
48,5,Angelina,2004,40181,37559,2622,6.5
48,7,Aransas,2004,11003,10091,912,8.3
48,9,Archer,2004,5321,5121,200,3.8
48,11,Armstrong,2004,1120,1076,44,3.9
48,13,Atascosa,2004,18820,17729,1091,5.8
48,15,Austin,2004,12674,11997,677,5.3
48,17,Bailey,2004,3495,3302,193,5.5
48,19,Bandera,2004,9545,9059,486,5.1
48,21,Bastrop,2004,33118,31188,1930,5.8
48,23,Baylor,2004,2009,1900,109,5.4
48,25,Bee,2004,11432,10548,884,7.7
48,27,Bell,2004,110997,105141,5856,5.3
48,29,Bexar,2004,704238,663788,40450,5.7
48,31,Blanco,2004,4812,4599,213,4.4
48,33,Borden,2004,510,490,20,3.9
48,35,Bosque,2004,8421,7940,481,5.7
48,37,Bowie,2004,42035,39491,2544,6.1
48,39,Brazoria,2004,131348,122257,9091,6.9
48,41,Brazos,2004,85888,82152,3736,4.3
48,43,Brewster,2004,5411,5177,234,4.3
48,45,Briscoe,2004,751,706,45,6.0
48,47,Brooks,2004,3251,3007,244,7.5
48,49,Brown,2004,18360,17344,1016,5.5
48,51,Burleson,2004,8580,8124,456,5.3
48,53,Burnet,2004,20620,19603,1017,4.9
48,55,Caldwell,2004,16038,15004,1034,6.4
48,57,Calhoun,2004,9260,8594,666,7.2
48,59,Callahan,2004,6858,6538,320,4.7
48,61,Cameron,2004,141769,129379,12390,8.7
48,63,Camp,2004,5487,5158,329,6.0
48,65,Carson,2004,3500,3354,146,4.2
48,67,Cass,2004,13712,12746,966,7.0
48,69,Castro,2004,3685,3500,185,5.0
48,71,Chambers,2004,13778,12974,804,5.8
48,73,Cherokee,2004,21077,19908,1169,5.5
48,75,Childress,2004,3208,3023,185,5.8
48,77,Clay,2004,6361,6108,253,4.0
48,79,Cochran,2004,1603,1494,109,6.8
48,81,Coke,2004,1499,1409,90,6.0
48,83,Coleman,2004,4281,4042,239,5.6
48,85,Collin,2004,351885,334191,17694,5.0
48,87,Collingsworth,2004,1655,1571,84,5.1
48,89,Colorado,2004,10298,9768,530,5.1
48,91,Comal,2004,46914,44448,2466,5.3
48,93,Comanche,2004,6802,6462,340,5.0
48,95,Concho,2004,1396,1310,86,6.2
48,97,Cooke,2004,19345,18378,967,5.0
48,99,Coryell,2004,24901,23296,1605,6.4
48,101,Cottle,2004,910,860,50,5.5
48,103,Crane,2004,1586,1490,96,6.1
48,105,Crockett,2004,2090,2010,80,3.8
48,107,Crosby,2004,2915,2740,175,6.0
48,109,Culberson,2004,1545,1463,82,5.3
48,111,Dallam,2004,3272,3147,125,3.8
48,113,Dallas,2004,1147957,1072270,75687,6.6
48,115,Dawson,2004,5500,5108,392,7.1
48,117,Deaf Smith,2004,8068,7641,427,5.3
48,119,Delta,2004,2475,2301,174,7.0
48,121,Denton,2004,301028,287213,13815,4.6
48,123,DeWitt,2004,9379,8859,520,5.5
48,125,Dickens,2004,1143,1073,70,6.1
48,127,Dimmit,2004,3995,3635,360,9.0
48,129,Donley,2004,1933,1826,107,5.5
48,131,Duval,2004,5276,4913,363,6.9
48,133,Eastland,2004,8558,8072,486,5.7
48,135,Ector,2004,61327,57788,3539,5.8
48,137,Edwards,2004,1104,1059,45,4.1
48,139,Ellis,2004,64194,60549,3645,5.7
48,141,El Paso,2004,288764,266900,21864,7.6
48,143,Erath,2004,17534,16748,786,4.5
48,145,Falls,2004,7531,7061,470,6.2
48,147,Fannin,2004,13939,12968,971,7.0
48,149,Fayette,2004,12095,11593,502,4.2
48,151,Fisher,2004,2114,2007,107,5.1
48,153,Floyd,2004,3489,3261,228,6.5
48,155,Foard,2004,737,692,45,6.1
48,157,Fort Bend,2004,224594,212180,12414,5.5
48,159,Franklin,2004,5165,4928,237,4.6
48,161,Freestone,2004,9796,9325,471,4.8
48,163,Frio,2004,6493,6036,457,7.0
48,165,Gaines,2004,6621,6287,334,5.0
48,167,Galveston,2004,136390,127069,9321,6.8
48,169,Garza,2004,2326,2201,125,5.4
48,171,Gillespie,2004,12192,11733,459,3.8
48,173,Glasscock,2004,679,653,26,3.8
48,175,Goliad,2004,3345,3157,188,5.6
48,177,Gonzales,2004,9799,9344,455,4.6
48,179,Gray,2004,10410,9874,536,5.1
48,181,Grayson,2004,56929,53419,3510,6.2
48,183,Gregg,2004,59982,56465,3517,5.9
48,185,Grimes,2004,10302,9579,723,7.0
48,187,Guadalupe,2004,49926,47484,2442,4.9
48,189,Hale,2004,17310,16279,1031,6.0
48,191,Hall,2004,1660,1551,109,6.6
48,193,Hamilton,2004,4278,4082,196,4.6
48,195,Hansford,2004,2692,2591,101,3.8
48,197,Hardeman,2004,2272,2156,116,5.1
48,199,Hardin,2004,24379,22571,1808,7.4
48,201,Harris,2004,1806294,1693444,112850,6.2
48,203,Harrison,2004,31272,29482,1790,5.7
48,205,Hartley,2004,2421,2329,92,3.8
48,207,Haskell,2004,3204,3063,141,4.4
48,209,Hays,2004,64439,61120,3319,5.2
48,211,Hemphill,2004,2329,2254,75,3.2
48,213,Henderson,2004,34989,32833,2156,6.2
48,215,Hidalgo,2004,254517,231371,23146,9.1
48,217,Hill,2004,15380,14371,1009,6.6
48,219,Hockley,2004,11291,10742,549,4.9
48,221,Hood,2004,22549,21202,1347,6.0
48,223,Hopkins,2004,17074,16172,902,5.3
48,225,Houston,2004,9394,8750,644,6.9
48,227,Howard,2004,13737,12946,791,5.8
48,229,Hudspeth,2004,1355,1265,90,6.6
48,231,Hunt,2004,38380,36072,2308,6.0
48,233,Hutchinson,2004,10533,9868,665,6.3
48,235,Irion,2004,950,908,42,4.4
48,237,Jack,2004,3914,3719,195,5.0
48,239,Jackson,2004,6712,6321,391,5.8
48,241,Jasper,2004,15795,14385,1410,8.9
48,243,Jeff Davis,2004,1312,1262,50,3.8
48,245,Jefferson,2004,111937,102803,9134,8.2
48,247,Jim Hogg,2004,2564,2437,127,5.0
48,249,Jim Wells,2004,19695,18429,1266,6.4
48,251,Johnson,2004,71258,67054,4204,5.9
48,253,Jones,2004,7936,7467,469,5.9
48,255,Karnes,2004,5617,5232,385,6.9
48,257,Kaufman,2004,41798,39005,2793,6.7
48,259,Kendall,2004,13690,13053,637,4.7
48,261,Kenedy,2004,239,229,10,4.2
48,263,Kent,2004,485,463,22,4.5
48,265,Kerr,2004,21597,20576,1021,4.7
48,267,Kimble,2004,2239,2142,97,4.3
48,269,King,2004,214,207,7,3.3
48,271,Kinney,2004,1471,1375,96,6.5
48,273,Kleberg,2004,15982,15086,896,5.6
48,275,Knox,2004,1946,1843,103,5.3
48,277,Lamar,2004,23453,21942,1511,6.4
48,279,Lamb,2004,7474,7047,427,5.7
48,281,Lampasas,2004,10346,9876,470,4.5
48,283,La Salle,2004,2344,2188,156,6.7
48,285,Lavaca,2004,10215,9847,368,3.6
48,287,Lee,2004,8743,8338,405,4.6
48,289,Leon,2004,7709,7225,484,6.3
48,291,Liberty,2004,31861,29049,2812,8.8
48,293,Limestone,2004,10502,9941,561,5.3
48,295,Lipscomb,2004,1730,1668,62,3.6
48,297,Live Oak,2004,5089,4829,260,5.1
48,299,Llano,2004,7940,7479,461,5.8
48,301,Loving,2004,58,54,4,6.9
48,303,Lubbock,2004,136753,130583,6170,4.5
48,305,Lynn,2004,2992,2819,173,5.8
48,307,McCulloch,2004,3866,3624,242,6.3
48,309,McLennan,2004,110024,104120,5904,5.4
48,311,McMullen,2004,432,411,21,4.9
48,313,Madison,2004,5038,4729,309,6.1
48,315,Marion,2004,4886,4579,307,6.3
48,317,Martin,2004,2232,2122,110,4.9
48,319,Mason,2004,2281,2200,81,3.6
48,321,Matagorda,2004,17016,15412,1604,9.4
48,323,Maverick,2004,18684,15905,2779,14.9
48,325,Medina,2004,19163,18096,1067,5.6
48,327,Menard,2004,1146,1081,65,5.7
48,329,Midland,2004,63983,61187,2796,4.4
48,331,Milam,2004,11845,11149,696,5.9
48,333,Mills,2004,2694,2582,112,4.2
48,335,Mitchell,2004,3446,3202,244,7.1
48,337,Montague,2004,9631,9128,503,5.2
48,339,Montgomery,2004,181906,172322,9584,5.3
48,341,Moore,2004,10353,9910,443,4.3
48,343,Morris,2004,5995,5544,451,7.5
48,345,Motley,2004,703,670,33,4.7
48,347,Nacogdoches,2004,31610,29899,1711,5.4
48,349,Navarro,2004,21424,20008,1416,6.6
48,351,Newton,2004,5901,5270,631,10.7
48,353,Nolan,2004,7589,7180,409,5.4
48,355,Nueces,2004,156449,146950,9499,6.1
48,357,Ochiltree,2004,4927,4755,172,3.5
48,359,Oldham,2004,1158,1112,46,4.0
48,361,Orange,2004,40862,37276,3586,8.8
48,363,Palo Pinto,2004,13633,12900,733,5.4
48,365,Panola,2004,11323,10679,644,5.7
48,367,Parker,2004,49567,46997,2570,5.2
48,369,Parmer,2004,4850,4630,220,4.5
48,371,Pecos,2004,7118,6693,425,6.0
48,373,Polk,2004,17321,16074,1247,7.2
48,375,Potter,2004,57221,54054,3167,5.5
48,377,Presidio,2004,3517,3015,502,14.3
48,379,Rains,2004,4887,4580,307,6.3
48,381,Randall,2004,65386,63287,2099,3.2
48,383,Reagan,2004,1924,1862,62,3.2
48,385,Real,2004,1388,1315,73,5.3
48,387,Red River,2004,6450,6019,431,6.7
48,389,Reeves,2004,4389,4011,378,8.6
48,391,Refugio,2004,3932,3721,211,5.4
48,393,Roberts,2004,536,515,21,3.9
48,395,Robertson,2004,7457,7054,403,5.4
48,397,Rockwall,2004,30258,28666,1592,5.3
48,399,Runnels,2004,4845,4602,243,5.0
48,401,Rusk,2004,22504,21218,1286,5.7
48,403,Sabine,2004,3768,3341,427,11.3
48,405,San Augustine,2004,3808,3539,269,7.1
48,407,San Jacinto,2004,10080,9426,654,6.5
48,409,San Patricio,2004,29432,27173,2259,7.7
48,411,San Saba,2004,2763,2617,146,5.3
48,413,Schleicher,2004,1441,1386,55,3.8
48,415,Scurry,2004,7216,6824,392,5.4
48,417,Shackelford,2004,2058,1993,65,3.2
48,419,Shelby,2004,12182,11429,753,6.2
48,421,Sherman,2004,1581,1524,57,3.6
48,423,Smith,2004,94415,89369,5046,5.3
48,425,Somervell,2004,3724,3519,205,5.5
48,427,Starr,2004,21372,18281,3091,14.5
48,429,Stephens,2004,4234,4020,214,5.1
48,431,Sterling,2004,882,853,29,3.3
48,433,Stonewall,2004,853,815,38,4.5
48,435,Sutton,2004,2589,2513,76,2.9
48,437,Swisher,2004,3884,3671,213,5.5
48,439,Tarrant,2004,829995,783748,46247,5.6
48,441,Taylor,2004,64809,61840,2969,4.6
48,443,Terrell,2004,417,392,25,6.0
48,445,Terry,2004,5709,5348,361,6.3
48,447,Throckmorton,2004,978,940,38,3.9
48,449,Titus,2004,14790,14046,744,5.0
48,451,Tom Green,2004,52119,49646,2473,4.7
48,453,Travis,2004,492827,467441,25386,5.2
48,455,Trinity,2004,5980,5562,418,7.0
48,457,Tyler,2004,8530,7840,690,8.1
48,459,Upshur,2004,18392,17339,1053,5.7
48,461,Upton,2004,1563,1489,74,4.7
48,463,Uvalde,2004,12096,11242,854,7.1
48,465,Val Verde,2004,19672,18267,1405,7.1
48,467,Van Zandt,2004,24983,23617,1366,5.5
48,469,Victoria,2004,43321,41043,2278,5.3
48,471,Walker,2004,26146,24574,1572,6.0
48,473,Waller,2004,15901,14904,997,6.3
48,475,Ward,2004,4387,4102,285,6.5
48,477,Washington,2004,15894,15089,805,5.1
48,479,Webb,2004,83160,77567,5593,6.7
48,481,Wharton,2004,21410,20192,1218,5.7
48,483,Wheeler,2004,2796,2689,107,3.8
48,485,Wichita,2004,62717,59460,3257,5.2
48,487,Wilbarger,2004,7410,7087,323,4.4
48,489,Willacy,2004,7395,6556,839,11.3
48,491,Williamson,2004,170900,162878,8022,4.7
48,493,Wilson,2004,17308,16429,879,5.1
48,495,Winkler,2004,3075,2886,189,6.1
48,497,Wise,2004,27116,25706,1410,5.2
48,499,Wood,2004,17442,16372,1070,6.1
48,501,Yoakum,2004,3312,3143,169,5.1
48,503,Young,2004,9015,8548,467,5.2
48,505,Zapata,2004,4890,4532,358,7.3
48,507,Zavala,2004,4019,3515,504,12.5
49,1,Beaver,2004,3044,2907,137,4.5
49,3,Box Elder,2004,22042,20927,1115,5.1
49,5,Cache,2004,56195,54141,2054,3.7
49,7,Carbon,2004,9310,8694,616,6.6
49,9,Daggett,2004,499,472,27,5.4
49,11,Davis,2004,132467,126262,6205,4.7
49,13,Duchesne,2004,7281,6871,410,5.6
49,15,Emery,2004,5122,4771,351,6.9
49,17,Garfield,2004,2657,2448,209,7.9
49,19,Grand,2004,4828,4472,356,7.4
49,21,Iron,2004,18773,17906,867,4.6
49,23,Juab,2004,3829,3584,245,6.4
49,25,Kane,2004,3248,3066,182,5.6
49,27,Millard,2004,6144,5847,297,4.8
49,29,Morgan,2004,3684,3506,178,4.8
49,31,Piute,2004,869,831,38,4.4
49,33,Rich,2004,1338,1293,45,3.4
49,35,Salt Lake,2004,500918,475670,25248,5.0
49,37,San Juan,2004,4856,4409,447,9.2
49,39,Sanpete,2004,10476,9820,656,6.3
49,41,Sevier,2004,9236,8756,480,5.2
49,43,Summit,2004,20474,19405,1069,5.2
49,45,Tooele,2004,23979,22663,1316,5.5
49,47,Uintah,2004,13809,13107,702,5.1
49,49,Utah,2004,197178,187745,9433,4.8
49,51,Wasatch,2004,8793,8314,479,5.4
49,53,Washington,2004,52113,49582,2531,4.9
49,55,Wayne,2004,1355,1265,90,6.6
49,57,Weber,2004,107224,101314,5910,5.5
50,1,Addison,2004,20976,20245,731,3.5
50,3,Bennington,2004,19757,18970,787,4.0
50,5,Caledonia,2004,16365,15673,692,4.2
50,7,Chittenden,2004,86961,84189,2772,3.2
50,9,Essex,2004,3239,3109,130,4.0
50,11,Franklin,2004,25708,24671,1037,4.0
50,13,Grand Isle,2004,4183,3986,197,4.7
50,15,Lamoille,2004,14307,13718,589,4.1
50,17,Orange,2004,16146,15594,552,3.4
50,19,Orleans,2004,13959,13245,714,5.1
50,21,Rutland,2004,35079,33658,1421,4.1
50,23,Washington,2004,33866,32583,1283,3.8
50,25,Windham,2004,24699,23836,863,3.5
50,27,Windsor,2004,32105,31071,1034,3.2
51,1,Accomack,2004,19173,18201,972,5.1
51,3,Albemarle,2004,45848,44300,1548,3.4
51,5,Alleghany,2004,7501,7119,382,5.1
51,7,Amelia,2004,6116,5878,238,3.9
51,9,Amherst,2004,15118,14368,750,5.0
51,11,Appomattox,2004,6724,6391,333,5.0
51,13,Arlington,2004,122491,119233,3258,2.7
51,15,Augusta,2004,35485,34286,1199,3.4
51,17,Bath,2004,2811,2700,111,3.9
51,19,Bedford,2004,35494,34005,1489,4.2
51,21,Bland,2004,2967,2820,147,5.0
51,23,Botetourt,2004,16735,16131,604,3.6
51,25,Brunswick,2004,6780,6299,481,7.1
51,27,Buchanan,2004,8371,7851,520,6.2
51,29,Buckingham,2004,6702,6391,311,4.6
51,31,Campbell,2004,26135,24890,1245,4.8
51,33,Caroline,2004,12010,11488,522,4.3
51,35,Carroll,2004,14551,13763,788,5.4
51,36,Charles City,2004,3766,3559,207,5.5
51,37,Charlotte,2004,5548,5186,362,6.5
51,41,Chesterfield,2004,154346,148759,5587,3.6
51,43,Clarke,2004,7420,7190,230,3.1
51,45,Craig,2004,2483,2377,106,4.3
51,47,Culpeper,2004,18027,17333,694,3.8
51,49,Cumberland,2004,4332,4145,187,4.3
51,51,Dickenson,2004,5597,5218,379,6.8
51,53,Dinwiddie,2004,12344,11824,520,4.2
51,57,Essex,2004,5370,5120,250,4.7
51,59,Fairfax,2004,556712,540103,16609,3.0
51,61,Fauquier,2004,33773,32747,1026,3.0
51,63,Floyd,2004,6920,6613,307,4.4
51,65,Fluvanna,2004,12096,11689,407,3.4
51,67,Franklin,2004,24810,23753,1057,4.3
51,69,Frederick,2004,37108,35883,1225,3.3
51,71,Giles,2004,8204,7752,452,5.5
51,73,Gloucester,2004,19170,18526,644,3.4
51,75,Goochland,2004,9924,9565,359,3.6
51,77,Grayson,2004,7580,7181,399,5.3
51,79,Greene,2004,9289,8973,316,3.4
51,81,Greensville,2004,3958,3681,277,7.0
51,83,Halifax,2004,15627,14321,1306,8.4
51,85,Hanover,2004,52458,50695,1763,3.4
51,87,Henrico,2004,153116,147283,5833,3.8
51,89,Henry,2004,26383,23711,2672,10.1
51,91,Highland,2004,1194,1149,45,3.8
51,93,Isle of Wight,2004,16688,16061,627,3.8
51,95,James City,2004,27437,26431,1006,3.7
51,97,King and Queen,2004,3222,3088,134,4.2
51,99,King George,2004,9193,8880,313,3.4
51,101,King William,2004,7641,7358,283,3.7
51,103,Lancaster,2004,5135,4820,315,6.1
51,105,Lee,2004,9358,8792,566,6.0
51,107,Loudoun,2004,135719,131803,3916,2.9
51,109,Louisa,2004,14422,13826,596,4.1
51,111,Lunenburg,2004,5451,5159,292,5.4
51,113,Madison,2004,7036,6805,231,3.3
51,115,Mathews,2004,4319,4176,143,3.3
51,117,Mecklenburg,2004,13111,12148,963,7.3
51,119,Middlesex,2004,4883,4702,181,3.7
51,121,Montgomery,2004,42609,40899,1710,4.0
51,125,Nelson,2004,7256,6970,286,3.9
51,127,New Kent,2004,8412,8098,314,3.7
51,131,Northampton,2004,5937,5634,303,5.1
51,133,Northumberland,2004,5964,5638,326,5.5
51,135,Nottoway,2004,6300,5996,304,4.8
51,137,Orange,2004,14160,13641,519,3.7
51,139,Page,2004,11405,10720,685,6.0
51,141,Patrick,2004,9096,8336,760,8.4
51,143,Pittsylvania,2004,31846,29680,2166,6.8
51,145,Powhatan,2004,12995,12582,413,3.2
51,147,Prince Edward,2004,8344,7833,511,6.1
51,149,Prince George,2004,14777,14188,589,4.0
51,153,Prince William,2004,180024,174296,5728,3.2
51,155,Pulaski,2004,18162,16996,1166,6.4
51,157,Rappahannock,2004,4066,3950,116,2.9
51,159,Richmond,2004,3485,3286,199,5.7
51,161,Roanoke,2004,45914,44282,1632,3.6
51,163,Rockbridge,2004,10935,10544,391,3.6
51,165,Rockingham,2004,39830,38505,1325,3.3
51,167,Russell,2004,11597,10864,733,6.3
51,169,Scott,2004,9779,9182,597,6.1
51,171,Shenandoah,2004,19109,18420,689,3.6
51,173,Smyth,2004,15469,14596,873,5.6
51,175,Southampton,2004,7461,7115,346,4.6
51,177,Spotsylvania,2004,58378,56557,1821,3.1
51,179,Stafford,2004,58730,56928,1802,3.1
51,181,Surry,2004,3556,3394,162,4.6
51,183,Sussex,2004,4439,4151,288,6.5
51,185,Tazewell,2004,19381,18387,994,5.1
51,187,Warren,2004,17789,17136,653,3.7
51,191,Washington,2004,25730,24380,1350,5.2
51,193,Westmoreland,2004,7881,7482,399,5.1
51,195,Wise,2004,16940,15979,961,5.7
51,197,Wythe,2004,14569,13810,759,5.2
51,199,York,2004,29636,28653,983,3.3
51,510,Alexandria city,2004,84143,81660,2483,3.0
51,520,Bristol city,2004,7766,7246,520,6.7
51,530,Buena Vista city,2004,3371,3221,150,4.4
51,540,Charlottesville city,2004,19688,18812,876,4.4
51,550,Chesapeake city,2004,108122,103773,4349,4.0
51,570,Colonial Heights city,2004,8946,8554,392,4.4
51,580,Covington city,2004,2883,2708,175,6.1
51,590,Danville city,2004,21030,18904,2126,10.1
51,595,Emporia city,2004,2485,2291,194,7.8
51,600,Fairfax city,2004,12567,12197,370,2.9
51,610,Falls Church city,2004,6187,5966,221,3.6
51,620,Franklin city,2004,3664,3465,199,5.4
51,630,Fredericksburg city,2004,11110,10526,584,5.3
51,640,Galax city,2004,3158,2966,192,6.1
51,650,Hampton city,2004,65799,62415,3384,5.1
51,660,Harrisonburg city,2004,21192,20292,900,4.2
51,670,Hopewell city,2004,10080,9470,610,6.1
51,678,Lexington city,2004,2290,2152,138,6.0
51,680,Lynchburg city,2004,30770,29065,1705,5.5
51,683,Manassas city,2004,20238,19556,682,3.4
51,685,Manassas Park city,2004,6334,6144,190,3.0
51,690,Martinsville city,2004,6091,5290,801,13.2
51,700,Newport News city,2004,86231,82004,4227,4.9
51,710,Norfolk city,2004,97575,92109,5466,5.6
51,720,Norton city,2004,1546,1454,92,6.0
51,730,Petersburg city,2004,14058,12877,1181,8.4
51,735,Poquoson city,2004,6012,5814,198,3.3
51,740,Portsmouth city,2004,43970,41363,2607,5.9
51,750,Radford city,2004,7279,6864,415,5.7
51,760,Richmond city,2004,95520,89625,5895,6.2
51,770,Roanoke city,2004,44934,42699,2235,5.0
51,775,Salem city,2004,12540,12072,468,3.7
51,790,Staunton city,2004,11034,10623,411,3.7
51,800,Suffolk city,2004,36172,34539,1633,4.5
51,810,Virginia Beach city,2004,217760,209514,8246,3.8
51,820,Waynesboro city,2004,9558,9160,398,4.2
51,830,Williamsburg city,2004,4637,4253,384,8.3
51,840,Winchester city,2004,13660,13175,485,3.6
53,1,Adams,2004,8141,7477,664,8.2
53,3,Asotin,2004,10141,9463,678,6.7
53,5,Benton,2004,84143,78933,5210,6.2
53,7,Chelan,2004,38326,35569,2757,7.2
53,9,Clallam,2004,28128,26040,2088,7.4
53,11,Clark,2004,194933,179881,15052,7.7
53,13,Columbia,2004,1640,1501,139,8.5
53,15,Cowlitz,2004,42625,38873,3752,8.8
53,17,Douglas,2004,19308,18036,1272,6.6
53,19,Ferry,2004,2979,2649,330,11.1
53,21,Franklin,2004,27856,25689,2167,7.8
53,23,Garfield,2004,1083,1020,63,5.8
53,25,Grant,2004,37299,34117,3182,8.5
53,27,Grays Harbor,2004,30808,28152,2656,8.6
53,29,Island,2004,31399,29160,2239,7.1
53,31,Jefferson,2004,13361,12497,864,6.5
53,33,King,2004,992385,943570,48815,4.9
53,35,Kitsap,2004,118044,110958,7086,6.0
53,37,Kittitas,2004,18756,17416,1340,7.1
53,39,Klickitat,2004,9440,8537,903,9.6
53,41,Lewis,2004,30660,28017,2643,8.6
53,43,Lincoln,2004,4791,4461,330,6.9
53,45,Mason,2004,23542,21729,1813,7.7
53,47,Okanogan,2004,20244,18577,1667,8.2
53,49,Pacific,2004,9236,8510,726,7.9
53,51,Pend Oreille,2004,4995,4535,460,9.2
53,53,Pierce,2004,359400,333300,26100,7.3
53,55,San Juan,2004,8197,7790,407,5.0
53,57,Skagit,2004,54932,50970,3962,7.2
53,59,Skamania,2004,4924,4490,434,8.8
53,61,Snohomish,2004,337182,318578,18604,5.5
53,63,Spokane,2004,218355,203487,14868,6.8
53,65,Stevens,2004,17967,16434,1533,8.5
53,67,Thurston,2004,118829,111719,7110,6.0
53,69,Wahkiakum,2004,1601,1471,130,8.1
53,71,Walla Walla,2004,29118,27245,1873,6.4
53,73,Whatcom,2004,98862,92855,6007,6.1
53,75,Whitman,2004,20028,19102,926,4.6
53,77,Yakima,2004,115734,105509,10225,8.8
54,1,Barbour,2004,6579,6122,457,6.9
54,3,Berkeley,2004,41945,39991,1954,4.7
54,5,Boone,2004,9354,8850,504,5.4
54,7,Braxton,2004,5880,5502,378,6.4
54,9,Brooke,2004,11266,10368,898,8.0
54,11,Cabell,2004,44301,42018,2283,5.2
54,13,Calhoun,2004,2836,2553,283,10.0
54,15,Clay,2004,3521,3237,284,8.1
54,17,Doddridge,2004,2833,2680,153,5.4
54,19,Fayette,2004,17814,16629,1185,6.7
54,21,Gilmer,2004,2995,2841,154,5.1
54,23,Grant,2004,4913,4558,355,7.2
54,25,Greenbrier,2004,14994,14056,938,6.3
54,27,Hampshire,2004,9337,8871,466,5.0
54,29,Hancock,2004,14845,13625,1220,8.2
54,31,Hardy,2004,6860,6560,300,4.4
54,33,Harrison,2004,30593,28843,1750,5.7
54,35,Jackson,2004,11680,10891,789,6.8
54,37,Jefferson,2004,23659,22794,865,3.7
54,39,Kanawha,2004,91564,86830,4734,5.2
54,41,Lewis,2004,7190,6778,412,5.7
54,43,Lincoln,2004,7875,7342,533,6.8
54,45,Logan,2004,12779,12008,771,6.0
54,47,McDowell,2004,6479,5793,686,10.6
54,49,Marion,2004,25276,23917,1359,5.4
54,51,Marshall,2004,15059,14065,994,6.6
54,53,Mason,2004,10242,9356,886,8.7
54,55,Mercer,2004,24121,22649,1472,6.1
54,57,Mineral,2004,13323,12483,840,6.3
54,59,Mingo,2004,8009,7427,582,7.3
54,61,Monongalia,2004,43431,41640,1791,4.1
54,63,Monroe,2004,5801,5533,268,4.6
54,65,Morgan,2004,6901,6586,315,4.6
54,67,Nicholas,2004,10396,9793,603,5.8
54,69,Ohio,2004,20891,19741,1150,5.5
54,71,Pendleton,2004,3771,3617,154,4.1
54,73,Pleasants,2004,3250,3036,214,6.6
54,75,Pocahontas,2004,3867,3609,258,6.7
54,77,Preston,2004,14039,13227,812,5.8
54,79,Putnam,2004,26259,24935,1324,5.0
54,81,Raleigh,2004,31635,29820,1815,5.7
54,83,Randolph,2004,12637,11886,751,5.9
54,85,Ritchie,2004,4490,4169,321,7.1
54,87,Roane,2004,5461,5002,459,8.4
54,89,Summers,2004,4739,4416,323,6.8
54,91,Taylor,2004,6857,6495,362,5.3
54,93,Tucker,2004,3093,2874,219,7.1
54,95,Tyler,2004,3614,3330,284,7.9
54,97,Upshur,2004,10568,9948,620,5.9
54,99,Wayne,2004,17686,16670,1016,5.7
54,101,Webster,2004,3376,3171,205,6.1
54,103,Wetzel,2004,6669,6046,623,9.3
54,105,Wirt,2004,2509,2319,190,7.6
54,107,Wood,2004,41421,38985,2436,5.9
54,109,Wyoming,2004,8052,7508,544,6.8
55,1,Adams,2004,9481,8833,648,6.8
55,3,Ashland,2004,9286,8736,550,5.9
55,5,Barron,2004,25622,24209,1413,5.5
55,7,Bayfield,2004,8225,7705,520,6.3
55,9,Brown,2004,137010,130674,6336,4.6
55,11,Buffalo,2004,8102,7746,356,4.4
55,13,Burnett,2004,8436,7966,470,5.6
55,15,Calumet,2004,25154,24131,1023,4.1
55,17,Chippewa,2004,32124,30322,1802,5.6
55,19,Clark,2004,17723,16733,990,5.6
55,21,Columbia,2004,31422,29959,1463,4.7
55,23,Crawford,2004,9435,8934,501,5.3
55,25,Dane,2004,283277,274216,9061,3.2
55,27,Dodge,2004,47041,44559,2482,5.3
55,29,Door,2004,16753,15741,1012,6.0
55,31,Douglas,2004,22890,21566,1324,5.8
55,33,Dunn,2004,23964,22867,1097,4.6
55,35,Eau Claire,2004,53914,51586,2328,4.3
55,37,Florence,2004,2642,2475,167,6.3
55,39,Fond du Lac,2004,56514,53875,2639,4.7
55,41,Forest,2004,5016,4703,313,6.2
55,43,Grant,2004,27421,26177,1244,4.5
55,45,Green,2004,19618,18742,876,4.5
55,47,Green Lake,2004,10623,10008,615,5.8
55,49,Iowa,2004,14146,13584,562,4.0
55,51,Iron,2004,3305,3009,296,9.0
55,53,Jackson,2004,9899,9354,545,5.5
55,55,Jefferson,2004,43319,41170,2149,5.0
55,57,Juneau,2004,13149,12318,831,6.3
55,59,Kenosha,2004,82456,77694,4762,5.8
55,61,Kewaunee,2004,11919,11386,533,4.5
55,63,La Crosse,2004,62304,59776,2528,4.1
55,65,Lafayette,2004,9025,8631,394,4.4
55,67,Langlade,2004,10898,10187,711,6.5
55,69,Lincoln,2004,15995,15099,896,5.6
55,71,Manitowoc,2004,45794,43069,2725,6.0
55,73,Marathon,2004,73466,70295,3171,4.3
55,75,Marinette,2004,22881,21405,1476,6.5
55,77,Marquette,2004,7917,7398,519,6.6
55,78,Menominee,2004,1661,1478,183,11.0
55,79,Milwaukee,2004,458517,429919,28598,6.2
55,81,Monroe,2004,23208,22239,969,4.2
55,83,Oconto,2004,20605,19307,1298,6.3
55,85,Oneida,2004,20641,19402,1239,6.0
55,87,Outagamie,2004,95125,90561,4564,4.8
55,89,Ozaukee,2004,47681,45940,1741,3.7
55,91,Pepin,2004,3949,3748,201,5.1
55,93,Pierce,2004,23184,22224,960,4.1
55,95,Polk,2004,23658,22366,1292,5.5
55,97,Portage,2004,40533,38558,1975,4.9
55,99,Price,2004,8593,8189,404,4.7
55,101,Racine,2004,99727,93779,5948,6.0
55,103,Richland,2004,10051,9584,467,4.6
55,105,Rock,2004,83112,78484,4628,5.6
55,107,Rusk,2004,7863,7366,497,6.3
55,109,St. Croix,2004,43486,41374,2112,4.9
55,111,Sauk,2004,34341,32822,1519,4.4
55,113,Sawyer,2004,9224,8668,556,6.0
55,115,Shawano,2004,22410,21274,1136,5.1
55,117,Sheboygan,2004,64088,61254,2834,4.4
55,119,Taylor,2004,11401,10801,600,5.3
55,121,Trempealeau,2004,15807,15052,755,4.8
55,123,Vernon,2004,14762,14069,693,4.7
55,125,Vilas,2004,11845,11096,749,6.3
55,127,Walworth,2004,56268,53815,2453,4.4
55,129,Washburn,2004,8241,7729,512,6.2
55,131,Washington,2004,71551,68364,3187,4.5
55,133,Waukesha,2004,212367,203448,8919,4.2
55,135,Waupaca,2004,28232,26758,1474,5.2
55,137,Waushara,2004,12554,11808,746,5.9
55,139,Winnebago,2004,91470,87262,4208,4.6
55,141,Wood,2004,40299,37997,2302,5.7
56,1,Albany,2004,19824,19239,585,3.0
56,3,Big Horn,2004,5312,5064,248,4.7
56,5,Campbell,2004,21918,21251,667,3.0
56,7,Carbon,2004,7604,7270,334,4.4
56,9,Converse,2004,6538,6279,259,4.0
56,11,Crook,2004,3211,3088,123,3.8
56,13,Fremont,2004,17694,16795,899,5.1
56,15,Goshen,2004,5791,5540,251,4.3
56,17,Hot Springs,2004,2356,2264,92,3.9
56,19,Johnson,2004,3711,3576,135,3.6
56,21,Laramie,2004,41570,39717,1853,4.5
56,23,Lincoln,2004,8018,7702,316,3.9
56,25,Natrona,2004,38886,37457,1429,3.7
56,27,Niobrara,2004,1131,1088,43,3.8
56,29,Park,2004,14519,13927,592,4.1
56,31,Platte,2004,4100,3893,207,5.0
56,33,Sheridan,2004,15034,14451,583,3.9
56,35,Sublette,2004,4492,4384,108,2.4
56,37,Sweetwater,2004,21321,20623,698,3.3
56,39,Teton,2004,13709,13284,425,3.1
56,41,Uinta,2004,10639,10234,405,3.8
56,43,Washakie,2004,4220,4050,170,4.0
56,45,Weston,2004,3137,3012,125,4.0
72,1,Adjuntas Municipio,2004,5261,4618,643,12.2
72,3,Aguada Municipio,2004,15212,13280,1932,12.7
72,5,Aguadilla Municipio,2004,21451,18723,2728,12.7
72,7,Aguas Buenas Municipio,2004,9391,8297,1094,11.6
72,9,Aibonito Municipio,2004,7896,6905,991,12.6
72,11,Anasco Municipio,2004,10510,9151,1359,12.9
72,13,Arecibo Municipio,2004,33495,29641,3854,11.5
72,15,Arroyo Municipio,2004,5411,4497,914,16.9
72,17,Barceloneta Municipio,2004,7208,6275,933,12.9
72,19,Barranquitas Municipio,2004,7600,6746,854,11.2
72,21,Bayamon Municipio,2004,83842,77189,6653,7.9
72,23,Cabo Rojo Municipio,2004,19577,17833,1744,8.9
72,25,Caguas Municipio,2004,54214,48827,5387,9.9
72,27,Camuy Municipio,2004,12611,11252,1359,10.8
72,29,Canovanas Municipio,2004,14339,12417,1922,13.4
72,31,Carolina Municipio,2004,78165,71718,6447,8.2
72,33,Catano Municipio,2004,8345,7489,856,10.3
72,35,Cayey Municipio,2004,15894,13982,1912,12.0
72,37,Ceiba Municipio,2004,5902,5032,870,14.7
72,39,Ciales Municipio,2004,5195,4379,816,15.7
72,41,Cidra Municipio,2004,15103,13427,1676,11.1
72,43,Coamo Municipio,2004,11120,9541,1579,14.2
72,45,Comerio Municipio,2004,4874,4214,660,13.5
72,47,Corozal Municipio,2004,10444,9279,1165,11.2
72,49,Culebra Municipio,2004,897,851,46,5.1
72,51,Dorado Municipio,2004,12632,11500,1132,9.0
72,53,Fajardo Municipio,2004,14575,12541,2034,14.0
72,54,Florida Municipio,2004,3960,3413,547,13.8
72,55,Guanica Municipio,2004,6129,5161,968,15.8
72,57,Guayama Municipio,2004,13973,11787,2186,15.6
72,59,Guayanilla Municipio,2004,6546,5558,988,15.1
72,61,Guaynabo Municipio,2004,44594,41978,2616,5.9
72,63,Gurabo Municipio,2004,14841,13399,1442,9.7
72,65,Hatillo Municipio,2004,12579,11126,1453,11.6
72,67,Hormigueros Municipio,2004,6420,5746,674,10.5
72,69,Humacao Municipio,2004,21000,17966,3034,14.4
72,71,Isabela Municipio,2004,15209,13305,1904,12.5
72,73,Jayuya Municipio,2004,5018,4470,548,10.9
72,75,Juana Diaz Municipio,2004,16122,14276,1846,11.5
72,77,Juncos Municipio,2004,12770,11234,1536,12.0
72,79,Lajas Municipio,2004,8709,7617,1092,12.5
72,81,Lares Municipio,2004,11229,9930,1299,11.6
72,83,Las Marias Municipio,2004,4022,3557,465,11.6
72,85,Las Piedras Municipio,2004,12455,10853,1602,12.9
72,87,Loiza Municipio,2004,8835,7661,1174,13.3
72,89,Luquillo Municipio,2004,6848,5813,1035,15.1
72,91,Manati Municipio,2004,14611,12612,1999,13.7
72,93,Maricao Municipio,2004,2268,2019,249,11.0
72,95,Maunabo Municipio,2004,3673,3037,636,17.3
72,97,Mayaguez Municipio,2004,30540,26611,3929,12.9
72,99,Moca Municipio,2004,14466,12709,1757,12.1
72,101,Morovis Municipio,2004,9012,7788,1224,13.6
72,103,Naguabo Municipio,2004,7618,6420,1198,15.7
72,105,Naranjito Municipio,2004,8598,7717,881,10.2
72,107,Orocovis Municipio,2004,5346,4640,706,13.2
72,109,Patillas Municipio,2004,5806,4790,1016,17.5
72,111,Penuelas Municipio,2004,8277,7108,1169,14.1
72,113,Ponce Municipio,2004,61939,55368,6571,10.6
72,115,Quebradillas Municipio,2004,8496,7542,954,11.2
72,117,Rincon Municipio,2004,5331,4669,662,12.4
72,119,Rio Grande Municipio,2004,17742,15778,1964,11.1
72,121,Sabana Grande Municipio,2004,9199,8009,1190,12.9
72,123,Salinas Municipio,2004,9704,8275,1429,14.7
72,125,San German Municipio,2004,12977,11306,1671,12.9
72,127,San Juan Municipio,2004,173652,160465,13187,7.6
72,129,San Lorenzo Municipio,2004,14106,12528,1578,11.2
72,131,San Sebastian Municipio,2004,14967,13000,1967,13.1
72,133,Santa Isabel Municipio,2004,8667,7631,1036,12.0
72,135,Toa Alta Municipio,2004,27535,25495,2040,7.4
72,137,Toa Baja Municipio,2004,35808,32924,2884,8.1
72,139,Trujillo Alto Municipio,2004,33815,31459,2356,7.0
72,141,Utuado Municipio,2004,9697,8378,1319,13.6
72,143,Vega Alta Municipio,2004,12377,11090,1287,10.4
72,145,Vega Baja Municipio,2004,20607,18218,2389,11.6
72,147,Vieques Municipio,2004,2554,2237,317,12.4
72,149,Villalba Municipio,2004,8622,7522,1100,12.8
72,151,Yabucoa Municipio,2004,11170,9244,1926,17.2
72,153,Yauco Municipio,2004,15446,13493,1953,12.6
1,1,Autauga,2005,23887,22986,901,3.8
1,3,Baldwin,2005,76608,73581,3027,4.0
1,5,Barbour,2005,10730,10114,616,5.7
1,7,Bibb,2005,8837,8444,393,4.4
1,9,Blount,2005,26378,25434,944,3.6
1,11,Bullock,2005,3734,3383,351,9.4
1,13,Butler,2005,9113,8528,585,6.4
1,15,Calhoun,2005,53812,51409,2403,4.5
1,17,Chambers,2005,16308,15379,929,5.7
1,19,Cherokee,2005,12012,11493,519,4.3
1,21,Chilton,2005,19623,18859,764,3.9
1,23,Choctaw,2005,5285,4940,345,6.5
1,25,Clarke,2005,10098,9457,641,6.3
1,27,Clay,2005,5934,5642,292,4.9
1,29,Cleburne,2005,6642,6382,260,3.9
1,31,Coffee,2005,20052,19277,775,3.9
1,33,Colbert,2005,24892,23557,1335,5.4
1,35,Conecuh,2005,5173,4855,318,6.1
1,37,Coosa,2005,4879,4635,244,5.0
1,39,Covington,2005,16888,16131,757,4.5
1,41,Crenshaw,2005,6169,5869,300,4.9
1,43,Cullman,2005,38393,36863,1530,4.0
1,45,Dale,2005,20116,19227,889,4.4
1,47,Dallas,2005,15956,14603,1353,8.5
1,49,DeKalb,2005,31156,29582,1574,5.1
1,51,Elmore,2005,34361,33084,1277,3.7
1,53,Escambia,2005,14289,13500,789,5.5
1,55,Etowah,2005,46638,44443,2195,4.7
1,57,Fayette,2005,7865,7516,349,4.4
1,59,Franklin,2005,13752,13030,722,5.3
1,61,Geneva,2005,11598,11149,449,3.9
1,63,Greene,2005,3447,3218,229,6.6
1,65,Hale,2005,7033,6654,379,5.4
1,67,Henry,2005,7449,7130,319,4.3
1,69,Houston,2005,45983,44236,1747,3.8
1,71,Jackson,2005,26705,25371,1334,5.0
1,73,Jefferson,2005,316522,302586,13936,4.4
1,75,Lamar,2005,6115,5775,340,5.6
1,77,Lauderdale,2005,41949,39816,2133,5.1
1,79,Lawrence,2005,15934,15053,881,5.5
1,81,Lee,2005,63367,61025,2342,3.7
1,83,Limestone,2005,35029,33486,1543,4.4
1,85,Lowndes,2005,4937,4544,393,8.0
1,87,Macon,2005,8680,8173,507,5.8
1,89,Madison,2005,158361,152734,5627,3.6
1,91,Marengo,2005,8580,8092,488,5.7
1,93,Marion,2005,13500,12900,600,4.4
1,95,Marshall,2005,41846,40225,1621,3.9
1,97,Mobile,2005,179899,171056,8843,4.9
1,99,Monroe,2005,9560,8976,584,6.1
1,101,Montgomery,2005,104869,100113,4756,4.5
1,103,Morgan,2005,55553,53069,2484,4.5
1,105,Perry,2005,3526,3208,318,9.0
1,107,Pickens,2005,7938,7510,428,5.4
1,109,Pike,2005,14974,14369,605,4.0
1,111,Randolph,2005,9794,9197,597,6.1
1,113,Russell,2005,21440,20158,1282,6.0
1,115,St. Clair,2005,33663,32335,1328,3.9
1,117,Shelby,2005,94460,91578,2882,3.1
1,119,Sumter,2005,4850,4501,349,7.2
1,121,Talladega,2005,39578,37693,1885,4.8
1,123,Tallapoosa,2005,18538,17709,829,4.5
1,125,Tuscaloosa,2005,84590,81456,3134,3.7
1,127,Walker,2005,29693,28391,1302,4.4
1,129,Washington,2005,6868,6444,424,6.2
1,131,Wilcox,2005,3615,3283,332,9.2
1,133,Winston,2005,10338,9819,519,5.0
2,13,Aleutians East Borough,2005,1075,972,103,9.6
2,16,Aleutians West Census Area,2005,3139,2958,181,5.8
2,20,Anchorage Borough/municipality,2005,148840,140606,8234,5.5
2,50,Bethel Census Area,2005,7084,6172,912,12.9
2,60,Bristol Bay Borough,2005,969,912,57,5.9
2,68,Denali Borough,2005,1587,1483,104,6.6
2,70,Dillingham Census Area,2005,2060,1839,221,10.7
2,90,Fairbanks North Star Borough,2005,45190,42534,2656,5.9
2,100,Haines Borough,2005,1471,1338,133,9.0
2,110,Juneau Borough/city,2005,18326,17341,985,5.4
2,122,Kenai Peninsula Borough,2005,25294,23065,2229,8.8
2,130,Ketchikan Gateway Borough,2005,7956,7417,539,6.8
2,150,Kodiak Island Borough,2005,6050,5546,504,8.3
2,158,Kusilvak Census Area,2005,2542,2008,534,21.0
2,164,Lake and Peninsula Borough,2005,1038,962,76,7.3
2,170,Matanuska-Susitna Borough,2005,36688,33871,2817,7.7
2,180,Nome Census Area,2005,3976,3480,496,12.5
2,185,North Slope Borough,2005,3716,3379,337,9.1
2,188,Northwest Arctic Borough,2005,3059,2694,365,11.9
2,201,Prince of Wales-Outer Ketchikan Census Area,2005,2566,2228,338,13.2
2,220,Sitka Borough/city,2005,4738,4473,265,5.6
2,232,Skagway-Hoonah-Angoon Census Area,2005,1845,1598,247,13.4
2,240,Southeast Fairbanks Census Area,2005,3307,2958,349,10.6
2,261,Valdez-Cordova Census Area,2005,5259,4756,503,9.6
2,280,Wrangell-Petersburg Census Area,2005,2927,2630,297,10.1
2,282,Yakutat Borough/city,2005,320,286,34,10.6
2,290,Yukon-Koyukuk Census Area,2005,3136,2767,369,11.8
4,1,Apache,2005,19906,17826,2080,10.4
4,3,Cochise,2005,55374,52724,2650,4.8
4,5,Coconino,2005,67390,64094,3296,4.9
4,7,Gila,2005,20517,19309,1208,5.9
4,9,Graham,2005,12172,11444,728,6.0
4,11,Greenlee,2005,3467,3300,167,4.8
4,12,La Paz,2005,7646,7130,516,6.7
4,13,Maricopa,2005,1842737,1768406,74331,4.0
4,15,Mohave,2005,88439,84670,3769,4.3
4,17,Navajo,2005,37402,34402,3000,8.0
4,19,Pima,2005,438417,418851,19566,4.5
4,21,Pinal,2005,86792,81960,4832,5.6
4,23,Santa Cruz,2005,15930,14560,1370,8.6
4,25,Yavapai,2005,90782,86786,3996,4.4
4,27,Yuma,2005,75545,63556,11989,15.9
5,1,Arkansas,2005,11222,10428,794,7.1
5,3,Ashley,2005,9562,8763,799,8.4
5,5,Baxter,2005,17061,16104,957,5.6
5,7,Benton,2005,99292,96059,3233,3.3
5,9,Boone,2005,16579,15728,851,5.1
5,11,Bradley,2005,5458,5027,431,7.9
5,13,Calhoun,2005,2662,2479,183,6.9
5,15,Carroll,2005,13422,12809,613,4.6
5,17,Chicot,2005,4849,4362,487,10.0
5,19,Clark,2005,10953,10280,673,6.1
5,21,Clay,2005,7030,6438,592,8.4
5,23,Cleburne,2005,11529,10961,568,4.9
5,25,Cleveland,2005,4236,3987,249,5.9
5,27,Columbia,2005,10991,10289,702,6.4
5,29,Conway,2005,9573,9079,494,5.2
5,31,Craighead,2005,44677,42537,2140,4.8
5,33,Crawford,2005,27191,26001,1190,4.4
5,35,Crittenden,2005,22317,20849,1468,6.6
5,37,Cross,2005,8427,7784,643,7.6
5,39,Dallas,2005,3833,3563,270,7.0
5,41,Desha,2005,6036,5510,526,8.7
5,43,Drew,2005,8604,7871,733,8.5
5,45,Faulkner,2005,51553,49245,2308,4.5
5,47,Franklin,2005,8444,8080,364,4.3
5,49,Fulton,2005,5051,4781,270,5.3
5,51,Garland,2005,41566,39198,2368,5.7
5,53,Grant,2005,8585,8165,420,4.9
5,55,Greene,2005,18603,17516,1087,5.8
5,57,Hempstead,2005,10811,10184,627,5.8
5,59,Hot Spring,2005,15023,14226,797,5.3
5,61,Howard,2005,6197,5851,346,5.6
5,63,Independence,2005,17699,16615,1084,6.1
5,65,Izard,2005,5207,4872,335,6.4
5,67,Jackson,2005,7728,7082,646,8.4
5,69,Jefferson,2005,36714,33914,2800,7.6
5,71,Johnson,2005,10892,10358,534,4.9
5,73,Lafayette,2005,3191,2952,239,7.5
5,75,Lawrence,2005,7451,6892,559,7.5
5,77,Lee,2005,3381,3023,358,10.6
5,79,Lincoln,2005,5205,4810,395,7.6
5,81,Little River,2005,6471,6166,305,4.7
5,83,Logan,2005,9985,9491,494,4.9
5,85,Lonoke,2005,30512,29143,1369,4.5
5,87,Madison,2005,7764,7474,290,3.7
5,89,Marion,2005,6741,6391,350,5.2
5,91,Miller,2005,19547,18604,943,4.8
5,93,Mississippi,2005,20023,18286,1737,8.7
5,95,Monroe,2005,3830,3574,256,6.7
5,97,Montgomery,2005,4304,4091,213,4.9
5,99,Nevada,2005,4357,4104,253,5.8
5,101,Newton,2005,3565,3383,182,5.1
5,103,Ouachita,2005,12479,11597,882,7.1
5,105,Perry,2005,4921,4668,253,5.1
5,107,Phillips,2005,8760,7959,801,9.1
5,109,Pike,2005,5110,4862,248,4.9
5,111,Poinsett,2005,11380,10623,757,6.7
5,113,Polk,2005,8622,8187,435,5.0
5,115,Pope,2005,29303,27983,1320,4.5
5,117,Prairie,2005,4273,4016,257,6.0
5,119,Pulaski,2005,188891,179725,9166,4.9
5,121,Randolph,2005,7801,7188,613,7.9
5,123,St. Francis,2005,10711,9791,920,8.6
5,125,Saline,2005,46911,44872,2039,4.3
5,127,Scott,2005,4647,4435,212,4.6
5,129,Searcy,2005,3391,3221,170,5.0
5,131,Sebastian,2005,59129,56589,2540,4.3
5,133,Sevier,2005,7586,7262,324,4.3
5,135,Sharp,2005,6507,6036,471,7.2
5,137,Stone,2005,4473,4181,292,6.5
5,139,Union,2005,19953,18575,1378,6.9
5,141,Van Buren,2005,6955,6524,431,6.2
5,143,Washington,2005,99971,96587,3384,3.4
5,145,White,2005,32218,30172,2046,6.4
5,147,Woodruff,2005,3432,3116,316,9.2
5,149,Yell,2005,10562,10117,445,4.2
6,1,Alameda,2005,734383,696983,37400,5.1
6,3,Alpine,2005,526,484,42,8.0
6,5,Amador,2005,17201,16241,960,5.6
6,7,Butte,2005,98326,91703,6623,6.7
6,9,Calaveras,2005,20532,19253,1279,6.2
6,11,Colusa,2005,9881,8629,1252,12.7
6,13,Contra Costa,2005,509956,485332,24624,4.8
6,15,Del Norte,2005,10737,9942,795,7.4
6,17,El Dorado,2005,91067,86721,4346,4.8
6,19,Fresno,2005,407216,370692,36524,9.0
6,21,Glenn,2005,11537,10568,969,8.4
6,23,Humboldt,2005,59534,55907,3627,6.1
6,25,Imperial,2005,60583,50934,9649,15.9
6,27,Inyo,2005,9283,8830,453,4.9
6,29,Kern,2005,326802,299495,27307,8.4
6,31,Kings,2005,53848,48771,5077,9.4
6,33,Lake,2005,25988,23933,2055,7.9
6,35,Lassen,2005,12249,11268,981,8.0
6,37,Los Angeles,2005,4787286,4532874,254412,5.3
6,39,Madera,2005,61892,57032,4860,7.9
6,41,Marin,2005,129120,124128,4992,3.9
6,43,Mariposa,2005,8791,8233,558,6.3
6,45,Mendocino,2005,43849,41337,2512,5.7
6,47,Merced,2005,98752,88905,9847,10.0
6,49,Modoc,2005,4002,3684,318,7.9
6,51,Mono,2005,8342,7939,403,4.8
6,53,Monterey,2005,206604,191585,15019,7.3
6,55,Napa,2005,71341,68233,3108,4.4
6,57,Nevada,2005,49247,46897,2350,4.8
6,59,Orange,2005,1586227,1527005,59222,3.7
6,61,Placer,2005,164281,157225,7056,4.3
6,63,Plumas,2005,10134,9281,853,8.4
6,65,Riverside,2005,852711,807102,45609,5.3
6,67,Sacramento,2005,664444,631679,32765,4.9
6,69,San Benito,2005,24503,22532,1971,8.0
6,71,San Bernardino,2005,851617,807388,44229,5.2
6,73,San Diego,2005,1490071,1426095,63976,4.3
6,75,San Francisco/city,2005,413409,392855,20554,5.0
6,77,San Joaquin,2005,283627,261361,22266,7.9
6,79,San Luis Obispo,2005,131505,125914,5591,4.3
6,81,San Mateo,2005,360365,345111,15254,4.2
6,83,Santa Barbara,2005,213243,204015,9228,4.3
6,85,Santa Clara,2005,815499,772259,43240,5.3
6,87,Santa Cruz,2005,143018,134065,8953,6.3
6,89,Shasta,2005,81760,75847,5913,7.2
6,91,Sierra,2005,1581,1450,131,8.3
6,93,Siskiyou,2005,18650,16974,1676,9.0
6,95,Solano,2005,208522,197396,11126,5.3
6,97,Sonoma,2005,253459,242272,11187,4.4
6,99,Stanislaus,2005,226659,207643,19016,8.4
6,101,Sutter,2005,40005,36155,3850,9.6
6,103,Tehama,2005,25203,23477,1726,6.8
6,105,Trinity,2005,5171,4643,528,10.2
6,107,Tulare,2005,183327,166064,17263,9.4
6,109,Tuolumne,2005,25988,24319,1669,6.4
6,111,Ventura,2005,416025,396331,19694,4.7
6,113,Yolo,2005,92375,87261,5114,5.5
6,115,Yuba,2005,25687,23374,2313,9.0
8,1,Adams,2005,210632,198527,12105,5.7
8,3,Alamosa,2005,8165,7716,449,5.5
8,5,Arapahoe,2005,299727,284458,15269,5.1
8,7,Archuleta,2005,6003,5692,311,5.2
8,9,Baca,2005,2275,2187,88,3.9
8,11,Bent,2005,2387,2237,150,6.3
8,13,Boulder,2005,168583,161119,7464,4.4
8,14,Broomfield/city,2005,24586,23391,1195,4.9
8,15,Chaffee,2005,8206,7766,440,5.4
8,17,Cheyenne,2005,1354,1312,42,3.1
8,19,Clear Creek,2005,5856,5579,277,4.7
8,21,Conejos,2005,3790,3494,296,7.8
8,23,Costilla,2005,1351,1214,137,10.1
8,25,Crowley,2005,1610,1482,128,8.0
8,27,Custer,2005,2021,1925,96,4.8
8,29,Delta,2005,15306,14534,772,5.0
8,31,Denver/city,2005,303022,285717,17305,5.7
8,33,Dolores,2005,981,913,68,6.9
8,35,Douglas,2005,143367,137397,5970,4.2
8,37,Eagle,2005,28499,27404,1095,3.8
8,39,Elbert,2005,12938,12345,593,4.6
8,41,El Paso,2005,290271,274863,15408,5.3
8,43,Fremont,2005,19314,18119,1195,6.2
8,45,Garfield,2005,29888,28766,1122,3.8
8,47,Gilpin,2005,3349,3187,162,4.8
8,49,Grand,2005,8414,8070,344,4.1
8,51,Gunnison,2005,9037,8680,357,4.0
8,53,Hinsdale,2005,598,581,17,2.8
8,55,Huerfano,2005,3268,3013,255,7.8
8,57,Jackson,2005,1138,1093,45,4.0
8,59,Jefferson,2005,305519,290445,15074,4.9
8,61,Kiowa,2005,879,843,36,4.1
8,63,Kit Carson,2005,4354,4205,149,3.4
8,65,Lake,2005,3937,3742,195,5.0
8,67,La Plata,2005,29858,28719,1139,3.8
8,69,Larimer,2005,166484,159153,7331,4.4
8,71,Las Animas,2005,8148,7735,413,5.1
8,73,Lincoln,2005,3036,2911,125,4.1
8,75,Logan,2005,10648,10219,429,4.0
8,77,Mesa,2005,71044,67545,3499,4.9
8,79,Mineral,2005,460,437,23,5.0
8,81,Moffat,2005,7858,7506,352,4.5
8,83,Montezuma,2005,12902,12223,679,5.3
8,85,Montrose,2005,19805,18867,938,4.7
8,87,Morgan,2005,14328,13714,614,4.3
8,89,Otero,2005,9355,8755,600,6.4
8,91,Ouray,2005,2943,2841,102,3.5
8,93,Park,2005,9669,9212,457,4.7
8,95,Phillips,2005,2285,2205,80,3.5
8,97,Pitkin,2005,11119,10671,448,4.0
8,99,Prowers,2005,7461,7106,355,4.8
8,101,Pueblo,2005,69563,64792,4771,6.9
8,103,Rio Blanco,2005,3992,3851,141,3.5
8,105,Rio Grande,2005,6541,6158,383,5.9
8,107,Routt,2005,14563,14025,538,3.7
8,109,Saguache,2005,3084,2852,232,7.5
8,111,San Juan,2005,510,473,37,7.3
8,113,San Miguel,2005,5228,5004,224,4.3
8,115,Sedgwick,2005,1621,1571,50,3.1
8,117,Summit,2005,16316,15694,622,3.8
8,119,Teller,2005,12639,12010,629,5.0
8,121,Washington,2005,2763,2657,106,3.8
8,123,Weld,2005,111458,105323,6135,5.5
8,125,Yuma,2005,6080,5888,192,3.2
9,1,Fairfield,2005,451156,431609,19547,4.3
9,3,Hartford,2005,437213,414347,22866,5.2
9,5,Litchfield,2005,102041,97426,4615,4.5
9,7,Middlesex,2005,89164,85412,3752,4.2
9,9,New Haven,2005,429293,406718,22575,5.3
9,11,New London,2005,143925,137544,6381,4.4
9,13,Tolland,2005,80703,77354,3349,4.1
9,15,Windham,2005,60809,57528,3281,5.4
10,1,Kent,2005,72143,69289,2854,4.0
10,3,New Castle,2005,270827,257751,13076,4.8
10,5,Sussex,2005,90407,86789,3618,4.0
11,1,District of Colu,2005,318130,295907,22223,7.0
12,1,Alachua,2005,122826,120035,2791,2.3
12,3,Baker,2005,11039,10761,278,2.5
12,5,Bay,2005,81803,79548,2255,2.8
12,7,Bradford,2005,11633,11344,289,2.5
12,9,Brevard,2005,258490,251204,7286,2.8
12,11,Broward,2005,950331,923158,27173,2.9
12,13,Calhoun,2005,5207,5055,152,2.9
12,15,Charlotte,2005,65537,63490,2047,3.1
12,17,Citrus,2005,50865,49173,1692,3.3
12,19,Clay,2005,86034,83740,2294,2.7
12,21,Collier,2005,144103,140216,3887,2.7
12,23,Columbia,2005,28539,27783,756,2.6
12,27,DeSoto,2005,13425,12949,476,3.5
12,29,Dixie,2005,5507,5344,163,3.0
12,31,Duval,2005,418048,405061,12987,3.1
12,33,Escambia,2005,134594,130559,4035,3.0
12,35,Flagler,2005,29705,28695,1010,3.4
12,37,Franklin,2005,5097,4954,143,2.8
12,39,Gadsden,2005,20323,19710,613,3.0
12,41,Gilchrist,2005,7441,7258,183,2.5
12,43,Glades,2005,4251,4089,162,3.8
12,45,Gulf,2005,6277,6115,162,2.6
12,47,Hamilton,2005,4577,4433,144,3.1
12,49,Hardee,2005,11263,10844,419,3.7
12,51,Hendry,2005,17094,16103,991,5.8
12,53,Hernando,2005,56497,54344,2153,3.8
12,55,Highlands,2005,39628,38327,1301,3.3
12,57,Hillsborough,2005,565819,549313,16506,2.9
12,59,Holmes,2005,8304,8071,233,2.8
12,61,Indian River,2005,58884,56691,2193,3.7
12,63,Jackson,2005,20905,20332,573,2.7
12,65,Jefferson,2005,6770,6605,165,2.4
12,67,Lafayette,2005,2781,2716,65,2.3
12,69,Lake,2005,117411,113953,3458,2.9
12,71,Lee,2005,270977,264219,6758,2.5
12,73,Leon,2005,136832,133491,3341,2.4
12,75,Levy,2005,16449,15963,486,3.0
12,77,Liberty,2005,3279,3207,72,2.2
12,79,Madison,2005,7364,7097,267,3.6
12,81,Manatee,2005,143590,139725,3865,2.7
12,83,Marion,2005,126859,123126,3733,2.9
12,85,Martin,2005,64118,62142,1976,3.1
12,86,Miami-Dade,2005,1133105,1106002,27103,2.4
12,87,Monroe,2005,45249,44299,950,2.1
12,89,Nassau,2005,32499,31661,838,2.6
12,91,Okaloosa,2005,96029,93935,2094,2.2
12,93,Okeechobee,2005,17043,16401,642,3.8
12,95,Orange,2005,549848,534473,15375,2.8
12,97,Osceola,2005,115535,112105,3430,3.0
12,99,Palm Beach,2005,599387,579306,20081,3.4
12,101,Pasco,2005,176082,170032,6050,3.4
12,103,Pinellas,2005,449841,436165,13676,3.0
12,105,Polk,2005,255976,247909,8067,3.2
12,107,Putnam,2005,31067,30022,1045,3.4
12,109,St. Johns,2005,82994,81028,1966,2.4
12,111,St. Lucie,2005,111799,107613,4186,3.7
12,113,Santa Rosa,2005,66950,65064,1886,2.8
12,115,Sarasota,2005,168124,163661,4463,2.7
12,117,Seminole,2005,225480,219600,5880,2.6
12,119,Sumter,2005,25379,24709,670,2.6
12,121,Suwannee,2005,16513,16046,467,2.8
12,123,Taylor,2005,8739,8464,275,3.1
12,125,Union,2005,5015,4898,117,2.3
12,127,Volusia,2005,242819,235845,6974,2.9
12,129,Wakulla,2005,14321,14011,310,2.2
12,131,Walton,2005,27792,27200,592,2.1
12,133,Washington,2005,9220,8955,265,2.9
13,1,Appling,2005,8974,8404,570,6.4
13,3,Atkinson,2005,3513,3311,202,5.8
13,5,Bacon,2005,4738,4469,269,5.7
13,7,Baker,2005,1796,1695,101,5.6
13,9,Baldwin,2005,20271,19081,1190,5.9
13,11,Banks,2005,9178,8793,385,4.2
13,13,Barrow,2005,30571,29017,1554,5.1
13,15,Bartow,2005,44737,41986,2751,6.1
13,17,Ben Hill,2005,8113,7627,486,6.0
13,19,Berrien,2005,8848,8454,394,4.5
13,21,Bibb,2005,73053,68574,4479,6.1
13,23,Bleckley,2005,5103,4697,406,8.0
13,25,Brantley,2005,7578,7139,439,5.8
13,27,Brooks,2005,8304,7923,381,4.6
13,29,Bryan,2005,15304,14656,648,4.2
13,31,Bulloch,2005,30316,28803,1513,5.0
13,33,Burke,2005,10120,9304,816,8.1
13,35,Butts,2005,9134,8540,594,6.5
13,37,Calhoun,2005,2334,2156,178,7.6
13,39,Camden,2005,20470,19443,1027,5.0
13,43,Candler,2005,4503,4272,231,5.1
13,45,Carroll,2005,50817,47814,3003,5.9
13,47,Catoosa,2005,34881,33257,1624,4.7
13,49,Charlton,2005,4392,4143,249,5.7
13,51,Chatham,2005,124826,118711,6115,4.9
13,53,Chattahoochee,2005,2673,2372,301,11.3
13,55,Chattooga,2005,11083,10437,646,5.8
13,57,Cherokee,2005,99913,95459,4454,4.5
13,59,Clarke,2005,59182,56350,2832,4.8
13,61,Clay,2005,1388,1308,80,5.8
13,63,Clayton,2005,136606,126622,9984,7.3
13,65,Clinch,2005,2508,2343,165,6.6
13,67,Cobb,2005,370100,351000,19100,5.2
13,69,Coffee,2005,17387,16315,1072,6.2
13,71,Colquitt,2005,19303,18240,1063,5.5
13,73,Columbia,2005,56945,54136,2809,4.9
13,75,Cook,2005,7029,6582,447,6.4
13,77,Coweta,2005,55950,53040,2910,5.2
13,79,Crawford,2005,6288,5892,396,6.3
13,81,Crisp,2005,10143,9431,712,7.0
13,83,Dade,2005,8452,8018,434,5.1
13,85,Dawson,2005,10306,9835,471,4.6
13,87,Decatur,2005,12175,11376,799,6.6
13,89,DeKalb,2005,369408,345356,24052,6.5
13,91,Dodge,2005,9130,8566,564,6.2
13,93,Dooly,2005,4868,4543,325,6.7
13,95,Dougherty,2005,41350,38578,2772,6.7
13,97,Douglas,2005,59662,56070,3592,6.0
13,99,Early,2005,5633,5298,335,5.9
13,101,Echols,2005,2317,2234,83,3.6
13,103,Effingham,2005,25650,24565,1085,4.2
13,105,Elbert,2005,9989,9262,727,7.3
13,107,Emanuel,2005,10681,10048,633,5.9
13,109,Evans,2005,4870,4604,266,5.5
13,111,Fannin,2005,10092,9539,553,5.5
13,113,Fayette,2005,53279,50659,2620,4.9
13,115,Floyd,2005,50264,47487,2777,5.5
13,117,Forsyth,2005,75197,72124,3073,4.1
13,119,Franklin,2005,10418,9784,634,6.1
13,121,Fulton,2005,458643,430141,28502,6.2
13,123,Gilmer,2005,13440,12761,679,5.1
13,125,Glascock,2005,1192,1109,83,7.0
13,127,Glynn,2005,38994,37126,1868,4.8
13,129,Gordon,2005,26717,25334,1383,5.2
13,131,Grady,2005,11633,11057,576,5.0
13,133,Greene,2005,6665,6149,516,7.7
13,135,Gwinnett,2005,399152,378949,20203,5.1
13,137,Habersham,2005,19763,18833,930,4.7
13,139,Hall,2005,82964,79009,3955,4.8
13,141,Hancock,2005,3316,3027,289,8.7
13,143,Haralson,2005,12868,12124,744,5.8
13,145,Harris,2005,15308,14619,689,4.5
13,147,Hart,2005,10976,10163,813,7.4
13,149,Heard,2005,4950,4647,303,6.1
13,151,Henry,2005,88818,83764,5054,5.7
13,153,Houston,2005,62732,59518,3214,5.1
13,155,Irwin,2005,4636,4351,285,6.1
13,157,Jackson,2005,25450,24168,1282,5.0
13,159,Jasper,2005,6246,5907,339,5.4
13,161,Jeff Davis,2005,5480,5068,412,7.5
13,163,Jefferson,2005,6916,6291,625,9.0
13,165,Jenkins,2005,3512,3289,223,6.3
13,167,Johnson,2005,3724,3480,244,6.6
13,169,Jones,2005,13694,12986,708,5.2
13,171,Lamar,2005,7789,7279,510,6.5
13,173,Lanier,2005,3815,3653,162,4.2
13,175,Laurens,2005,22114,20821,1293,5.8
13,177,Lee,2005,16430,15731,699,4.3
13,179,Liberty,2005,22982,21538,1444,6.3
13,181,Lincoln,2005,3629,3353,276,7.6
13,183,Long,2005,5759,5511,248,4.3
13,185,Lowndes,2005,50499,48335,2164,4.3
13,187,Lumpkin,2005,12195,11573,622,5.1
13,189,McDuffie,2005,10675,9883,792,7.4
13,191,McIntosh,2005,5244,4945,299,5.7
13,193,Macon,2005,5435,4924,511,9.4
13,195,Madison,2005,15499,14765,734,4.7
13,197,Marion,2005,3419,3225,194,5.7
13,199,Meriwether,2005,9853,9093,760,7.7
13,201,Miller,2005,3606,3461,145,4.0
13,205,Mitchell,2005,10158,9548,610,6.0
13,207,Monroe,2005,12719,12033,686,5.4
13,209,Montgomery,2005,4268,4002,266,6.2
13,211,Morgan,2005,8951,8508,443,4.9
13,213,Murray,2005,21024,19990,1034,4.9
13,215,Muscogee,2005,84965,79397,5568,6.6
13,217,Newton,2005,42495,39785,2710,6.4
13,219,Oconee,2005,17132,16495,637,3.7
13,221,Oglethorpe,2005,7572,7203,369,4.9
13,223,Paulding,2005,58689,55727,2962,5.0
13,225,Peach,2005,11394,10579,815,7.2
13,227,Pickens,2005,14257,13623,634,4.4
13,229,Pierce,2005,8345,7922,423,5.1
13,231,Pike,2005,7729,7261,468,6.1
13,233,Polk,2005,20477,19369,1108,5.4
13,235,Pulaski,2005,4380,4115,265,6.1
13,237,Putnam,2005,10101,9517,584,5.8
13,239,Quitman,2005,989,923,66,6.7
13,241,Rabun,2005,7827,7436,391,5.0
13,243,Randolph,2005,2738,2516,222,8.1
13,245,Richmond,2005,90124,83555,6569,7.3
13,247,Rockdale,2005,39202,36764,2438,6.2
13,249,Schley,2005,1776,1648,128,7.2
13,251,Screven,2005,6956,6547,409,5.9
13,253,Seminole,2005,3993,3750,243,6.1
13,255,Spalding,2005,28249,26058,2191,7.8
13,257,Stephens,2005,13015,12203,812,6.2
13,259,Stewart,2005,1961,1768,193,9.8
13,261,Sumter,2005,14420,13366,1054,7.3
13,263,Talbot,2005,2985,2759,226,7.6
13,265,Taliaferro,2005,715,658,57,8.0
13,267,Tattnall,2005,8862,8260,602,6.8
13,269,Taylor,2005,3247,2978,269,8.3
13,271,Telfair,2005,4613,4241,372,8.1
13,273,Terrell,2005,4603,4266,337,7.3
13,275,Thomas,2005,22950,21850,1100,4.8
13,277,Tift,2005,19732,18639,1093,5.5
13,279,Toombs,2005,12886,12017,869,6.7
13,281,Towns,2005,5676,5438,238,4.2
13,283,Treutlen,2005,2724,2508,216,7.9
13,285,Troup,2005,30299,28095,2204,7.3
13,287,Turner,2005,4954,4604,350,7.1
13,289,Twiggs,2005,4665,4323,342,7.3
13,291,Union,2005,10215,9749,466,4.6
13,293,Upson,2005,12091,11220,871,7.2
13,295,Walker,2005,32905,31165,1740,5.3
13,297,Walton,2005,37660,35724,1936,5.1
13,299,Ware,2005,14822,13941,881,5.9
13,301,Warren,2005,2624,2338,286,10.9
13,303,Washington,2005,8322,7734,588,7.1
13,305,Wayne,2005,11826,11045,781,6.6
13,307,Webster,2005,1124,1047,77,6.9
13,309,Wheeler,2005,2583,2407,176,6.8
13,311,White,2005,12024,11450,574,4.8
13,313,Whitfield,2005,45621,43275,2346,5.1
13,315,Wilcox,2005,3250,3016,234,7.2
13,317,Wilkes,2005,4619,4281,338,7.3
13,319,Wilkinson,2005,4443,4163,280,6.3
13,321,Worth,2005,10381,9772,609,5.9
15,1,Hawaii,2005,80582,77841,2741,3.4
15,3,Honolulu/city,2005,438294,426242,12052,2.7
15,7,Kauai,2005,31825,30936,889,2.8
15,9,Maui,2005,74829,72834,1995,2.7
16,1,Ada,2005,186803,180684,6119,3.3
16,3,Adams,2005,1903,1752,151,7.9
16,5,Bannock,2005,40476,38934,1542,3.8
16,7,Bear Lake,2005,3050,2927,123,4.0
16,9,Benewah,2005,4035,3728,307,7.6
16,11,Bingham,2005,21012,20240,772,3.7
16,13,Blaine,2005,14044,13652,392,2.8
16,15,Boise,2005,3677,3512,165,4.5
16,17,Bonner,2005,20432,19396,1036,5.1
16,19,Bonneville,2005,48926,47474,1452,3.0
16,21,Boundary,2005,4231,3898,333,7.9
16,23,Butte,2005,1394,1335,59,4.2
16,25,Camas,2005,622,598,24,3.9
16,27,Canyon,2005,78643,75190,3453,4.4
16,29,Caribou,2005,3302,3130,172,5.2
16,31,Cassia,2005,10047,9590,457,4.5
16,33,Clark,2005,545,518,27,5.0
16,35,Clearwater,2005,3349,3040,309,9.2
16,37,Custer,2005,2599,2470,129,5.0
16,39,Elmore,2005,10901,10407,494,4.5
16,41,Franklin,2005,6208,6012,196,3.2
16,43,Fremont,2005,6083,5849,234,3.8
16,45,Gem,2005,7224,6882,342,4.7
16,47,Gooding,2005,8129,7886,243,3.0
16,49,Idaho,2005,7119,6649,470,6.6
16,51,Jefferson,2005,10745,10396,349,3.2
16,53,Jerome,2005,9926,9564,362,3.6
16,55,Kootenai,2005,67054,64069,2985,4.5
16,57,Latah,2005,17916,17292,624,3.5
16,59,Lemhi,2005,4066,3825,241,5.9
16,61,Lewis,2005,1740,1680,60,3.4
16,63,Lincoln,2005,2417,2311,106,4.4
16,65,Madison,2005,14956,14553,403,2.7
16,67,Minidoka,2005,9457,8921,536,5.7
16,69,Nez Perce,2005,19316,18481,835,4.3
16,71,Oneida,2005,2144,2090,54,2.5
16,73,Owyhee,2005,4713,4598,115,2.4
16,75,Payette,2005,10391,9676,715,6.9
16,77,Power,2005,3787,3612,175,4.6
16,79,Shoshone,2005,5681,5243,438,7.7
16,81,Teton,2005,4511,4379,132,2.9
16,83,Twin Falls,2005,37040,35698,1342,3.6
16,85,Valley,2005,4678,4457,221,4.7
16,87,Washington,2005,5069,4803,266,5.2
17,1,Adams,2005,37948,36546,1402,3.7
17,3,Alexander,2005,3339,3053,286,8.6
17,5,Bond,2005,8511,8056,455,5.3
17,7,Boone,2005,24661,23041,1620,6.6
17,9,Brown,2005,3328,3204,124,3.7
17,11,Bureau,2005,18932,18011,921,4.9
17,13,Calhoun,2005,2567,2412,155,6.0
17,15,Carroll,2005,8415,7951,464,5.5
17,17,Cass,2005,7644,7289,355,4.6
17,19,Champaign,2005,101747,97615,4132,4.1
17,21,Christian,2005,17069,16095,974,5.7
17,23,Clark,2005,8563,8097,466,5.4
17,25,Clay,2005,6900,6484,416,6.0
17,27,Clinton,2005,18621,17762,859,4.6
17,29,Coles,2005,26513,25287,1226,4.6
17,31,Cook,2005,2545528,2380292,165236,6.5
17,33,Crawford,2005,9346,8806,540,5.8
17,35,Cumberland,2005,5553,5268,285,5.1
17,37,DeKalb,2005,53781,51079,2702,5.0
17,39,De Witt,2005,8432,7985,447,5.3
17,41,Douglas,2005,10542,10057,485,4.6
17,43,DuPage,2005,512054,487654,24400,4.8
17,45,Edgar,2005,10345,9802,543,5.2
17,47,Edwards,2005,3440,3280,160,4.7
17,49,Effingham,2005,17843,16882,961,5.4
17,51,Fayette,2005,10192,9541,651,6.4
17,53,Ford,2005,7306,6961,345,4.7
17,55,Franklin,2005,17640,16402,1238,7.0
17,57,Fulton,2005,17671,16628,1043,5.9
17,59,Gallatin,2005,2662,2496,166,6.2
17,61,Greene,2005,7287,6898,389,5.3
17,63,Grundy,2005,23281,21611,1670,7.2
17,65,Hamilton,2005,4114,3891,223,5.4
17,67,Hancock,2005,10003,9506,497,5.0
17,69,Hardin,2005,1768,1630,138,7.8
17,71,Henderson,2005,4091,3856,235,5.7
17,73,Henry,2005,27475,26247,1228,4.5
17,75,Iroquois,2005,16617,15847,770,4.6
17,77,Jackson,2005,31671,30238,1433,4.5
17,79,Jasper,2005,5221,4912,309,5.9
17,81,Jefferson,2005,20457,19418,1039,5.1
17,83,Jersey,2005,11533,10925,608,5.3
17,85,Jo Daviess,2005,13054,12514,540,4.1
17,87,Johnson,2005,5124,4817,307,6.0
17,89,Kane,2005,250981,237220,13761,5.5
17,91,Kankakee,2005,52984,49651,3333,6.3
17,93,Kendall,2005,44152,41904,2248,5.1
17,95,Knox,2005,25488,23659,1829,7.2
17,97,Lake,2005,357699,341339,16360,4.6
17,99,LaSalle,2005,57053,53630,3423,6.0
17,101,Lawrence,2005,8410,7982,428,5.1
17,103,Lee,2005,18101,17201,900,5.0
17,105,Livingston,2005,18505,17604,901,4.9
17,107,Logan,2005,13391,12657,734,5.5
17,109,McDonough,2005,16601,15841,760,4.6
17,111,McHenry,2005,166167,157573,8594,5.2
17,113,McLean,2005,87704,84166,3538,4.0
17,115,Macon,2005,53151,49963,3188,6.0
17,117,Macoupin,2005,24530,23140,1390,5.7
17,119,Madison,2005,135717,128384,7333,5.4
17,121,Marion,2005,18068,16942,1126,6.2
17,123,Marshall,2005,7159,6850,309,4.3
17,125,Mason,2005,7639,7141,498,6.5
17,127,Massac,2005,7431,7032,399,5.4
17,129,Menard,2005,7025,6719,306,4.4
17,131,Mercer,2005,8965,8481,484,5.4
17,133,Monroe,2005,17358,16630,728,4.2
17,135,Montgomery,2005,13518,12592,926,6.9
17,137,Morgan,2005,17731,16762,969,5.5
17,139,Moultrie,2005,8071,7747,324,4.0
17,141,Ogle,2005,26618,25221,1397,5.2
17,143,Peoria,2005,92643,88137,4506,4.9
17,145,Perry,2005,10432,9743,689,6.6
17,147,Piatt,2005,9175,8816,359,3.9
17,149,Pike,2005,8753,8334,419,4.8
17,151,Pope,2005,1984,1861,123,6.2
17,153,Pulaski,2005,2948,2718,230,7.8
17,155,Putnam,2005,3146,2975,171,5.4
17,157,Randolph,2005,15210,14398,812,5.3
17,159,Richland,2005,7358,6950,408,5.5
17,161,Rock Island,2005,78402,74855,3547,4.5
17,163,St. Clair,2005,121871,114323,7548,6.2
17,165,Saline,2005,12473,11745,728,5.8
17,167,Sangamon,2005,105766,101041,4725,4.5
17,169,Schuyler,2005,4360,4157,203,4.7
17,171,Scott,2005,2809,2637,172,6.1
17,173,Shelby,2005,11281,10698,583,5.2
17,175,Stark,2005,2850,2694,156,5.5
17,177,Stephenson,2005,25234,23933,1301,5.2
17,179,Tazewell,2005,69429,66288,3141,4.5
17,181,Union,2005,8308,7751,557,6.7
17,183,Vermilion,2005,38045,35679,2366,6.2
17,185,Wabash,2005,6622,6251,371,5.6
17,187,Warren,2005,8886,8402,484,5.4
17,189,Washington,2005,8645,8271,374,4.3
17,191,Wayne,2005,8201,7796,405,4.9
17,193,White,2005,7969,7583,386,4.8
17,195,Whiteside,2005,29988,28297,1691,5.6
17,197,Will,2005,333936,314320,19616,5.9
17,199,Williamson,2005,33565,31799,1766,5.3
17,201,Winnebago,2005,141325,132449,8876,6.3
17,203,Woodford,2005,20161,19416,745,3.7
18,1,Adams,2005,16539,15752,787,4.8
18,3,Allen,2005,178730,169422,9308,5.2
18,5,Bartholomew,2005,37353,35568,1785,4.8
18,7,Benton,2005,4595,4356,239,5.2
18,9,Blackford,2005,6809,6329,480,7.0
18,11,Boone,2005,27155,26048,1107,4.1
18,13,Brown,2005,7993,7546,447,5.6
18,15,Carroll,2005,10505,9965,540,5.1
18,17,Cass,2005,19254,18157,1097,5.7
18,19,Clark,2005,53319,50558,2761,5.2
18,21,Clay,2005,13298,12376,922,6.9
18,23,Clinton,2005,16989,16038,951,5.6
18,25,Crawford,2005,5424,5013,411,7.6
18,27,Daviess,2005,14871,14265,606,4.1
18,29,Dearborn,2005,26401,24910,1491,5.6
18,31,Decatur,2005,12683,12048,635,5.0
18,33,DeKalb,2005,21888,20527,1361,6.2
18,35,Delaware,2005,56047,52250,3797,6.8
18,37,Dubois,2005,22384,21518,866,3.9
18,39,Elkhart,2005,101824,97166,4658,4.6
18,41,Fayette,2005,11434,10523,911,8.0
18,43,Floyd,2005,37449,35519,1930,5.2
18,45,Fountain,2005,8794,8322,472,5.4
18,47,Franklin,2005,12039,11276,763,6.3
18,49,Fulton,2005,10453,9897,556,5.3
18,51,Gibson,2005,17290,16443,847,4.9
18,53,Grant,2005,33286,30507,2779,8.3
18,55,Greene,2005,16717,15617,1100,6.6
18,57,Hamilton,2005,130624,126091,4533,3.5
18,59,Hancock,2005,34397,32934,1463,4.3
18,61,Harrison,2005,19607,18379,1228,6.3
18,63,Hendricks,2005,69376,66589,2787,4.0
18,65,Henry,2005,23019,21468,1551,6.7
18,67,Howard,2005,39128,36598,2530,6.5
18,69,Huntington,2005,20601,19452,1149,5.6
18,71,Jackson,2005,22172,21108,1064,4.8
18,73,Jasper,2005,15208,14352,856,5.6
18,75,Jay,2005,11627,11007,620,5.3
18,77,Jefferson,2005,17376,16455,921,5.3
18,79,Jennings,2005,13972,13042,930,6.7
18,81,Johnson,2005,69988,66969,3019,4.3
18,83,Knox,2005,19239,18261,978,5.1
18,85,Kosciusko,2005,41299,39530,1769,4.3
18,87,LaGrange,2005,17324,16479,845,4.9
18,89,Lake,2005,225163,211406,13757,6.1
18,91,LaPorte,2005,53013,49838,3175,6.0
18,93,Lawrence,2005,22418,20695,1723,7.7
18,95,Madison,2005,63136,59021,4115,6.5
18,97,Marion,2005,459020,433830,25190,5.5
18,99,Marshall,2005,22715,21538,1177,5.2
18,101,Martin,2005,5155,4878,277,5.4
18,103,Miami,2005,17357,16288,1069,6.2
18,105,Monroe,2005,66619,63436,3183,4.8
18,107,Montgomery,2005,19862,18942,920,4.6
18,109,Morgan,2005,37171,35343,1828,4.9
18,111,Newton,2005,7075,6698,377,5.3
18,113,Noble,2005,23761,22315,1446,6.1
18,115,Ohio,2005,3149,2984,165,5.2
18,117,Orange,2005,9301,8620,681,7.3
18,119,Owen,2005,11752,11023,729,6.2
18,121,Parke,2005,8103,7586,517,6.4
18,123,Perry,2005,9720,9157,563,5.8
18,125,Pike,2005,6232,5888,344,5.5
18,127,Porter,2005,81029,77208,3821,4.7
18,129,Posey,2005,13857,13187,670,4.8
18,131,Pulaski,2005,7068,6718,350,5.0
18,133,Putnam,2005,17784,16611,1173,6.6
18,135,Randolph,2005,13084,12128,956,7.3
18,137,Ripley,2005,14862,14083,779,5.2
18,139,Rush,2005,9548,9103,445,4.7
18,141,St. Joseph,2005,134026,126965,7061,5.3
18,143,Scott,2005,11381,10680,701,6.2
18,145,Shelby,2005,23654,22482,1172,5.0
18,147,Spencer,2005,10714,10109,605,5.6
18,149,Starke,2005,10624,9887,737,6.9
18,151,Steuben,2005,16993,15936,1057,6.2
18,153,Sullivan,2005,9281,8597,684,7.4
18,155,Switzerland,2005,5762,5492,270,4.7
18,157,Tippecanoe,2005,79307,75507,3800,4.8
18,159,Tipton,2005,8069,7612,457,5.7
18,161,Union,2005,3870,3656,214,5.5
18,163,Vanderburgh,2005,91358,86629,4729,5.2
18,165,Vermillion,2005,8120,7525,595,7.3
18,167,Vigo,2005,49839,46491,3348,6.7
18,169,Wabash,2005,17697,16542,1155,6.5
18,171,Warren,2005,4775,4563,212,4.4
18,173,Warrick,2005,30574,29163,1411,4.6
18,175,Washington,2005,13997,13141,856,6.1
18,177,Wayne,2005,32985,30668,2317,7.0
18,179,Wells,2005,14849,14143,706,4.8
18,181,White,2005,12249,11549,700,5.7
18,183,Whitley,2005,17663,16773,890,5.0
19,1,Adair,2005,4396,4219,177,4.0
19,3,Adams,2005,1995,1890,105,5.3
19,5,Allamakee,2005,7990,7570,420,5.3
19,7,Appanoose,2005,6467,6129,338,5.2
19,9,Audubon,2005,3352,3198,154,4.6
19,11,Benton,2005,14420,13734,686,4.8
19,13,Black Hawk,2005,71450,68330,3120,4.4
19,15,Boone,2005,15361,14827,534,3.5
19,17,Bremer,2005,13720,13214,506,3.7
19,19,Buchanan,2005,11157,10645,512,4.6
19,21,Buena Vista,2005,10276,9881,395,3.8
19,23,Butler,2005,8099,7709,390,4.8
19,25,Calhoun,2005,5148,4942,206,4.0
19,27,Carroll,2005,12259,11890,369,3.0
19,29,Cass,2005,7622,7269,353,4.6
19,31,Cedar,2005,10574,10175,399,3.8
19,33,Cerro Gordo,2005,26091,24946,1145,4.4
19,35,Cherokee,2005,6568,6260,308,4.7
19,37,Chickasaw,2005,6231,5901,330,5.3
19,39,Clarke,2005,4639,4398,241,5.2
19,41,Clay,2005,9483,9105,378,4.0
19,43,Clayton,2005,9489,8870,619,6.5
19,45,Clinton,2005,26806,25527,1279,4.8
19,47,Crawford,2005,9166,8813,353,3.9
19,49,Dallas,2005,29414,28414,1000,3.4
19,51,Davis,2005,4121,3900,221,5.4
19,53,Decatur,2005,4189,3984,205,4.9
19,55,Delaware,2005,10435,9974,461,4.4
19,57,Des Moines,2005,20848,19711,1137,5.5
19,59,Dickinson,2005,10156,9718,438,4.3
19,61,Dubuque,2005,50756,48547,2209,4.4
19,63,Emmet,2005,5939,5676,263,4.4
19,65,Fayette,2005,11071,10513,558,5.0
19,67,Floyd,2005,8807,8362,445,5.1
19,69,Franklin,2005,5714,5445,269,4.7
19,71,Fremont,2005,3944,3786,158,4.0
19,73,Greene,2005,5052,4819,233,4.6
19,75,Grundy,2005,6870,6610,260,3.8
19,77,Guthrie,2005,6111,5855,256,4.2
19,79,Hamilton,2005,8665,8327,338,3.9
19,81,Hancock,2005,6328,6039,289,4.6
19,83,Hardin,2005,8937,8512,425,4.8
19,85,Harrison,2005,8060,7681,379,4.7
19,87,Henry,2005,10483,9961,522,5.0
19,89,Howard,2005,5192,4963,229,4.4
19,91,Humboldt,2005,5187,4994,193,3.7
19,93,Ida,2005,3920,3763,157,4.0
19,95,Iowa,2005,8812,8422,390,4.4
19,97,Jackson,2005,11176,10582,594,5.3
19,99,Jasper,2005,18632,17532,1100,5.9
19,101,Jefferson,2005,8280,7894,386,4.7
19,103,Johnson,2005,73754,71422,2332,3.2
19,105,Jones,2005,10416,9917,499,4.8
19,107,Keokuk,2005,5810,5533,277,4.8
19,109,Kossuth,2005,8876,8520,356,4.0
19,111,Lee,2005,17390,16244,1146,6.6
19,113,Linn,2005,113162,108290,4872,4.3
19,115,Louisa,2005,6254,5978,276,4.4
19,117,Lucas,2005,4834,4583,251,5.2
19,119,Lyon,2005,6447,6257,190,2.9
19,121,Madison,2005,8135,7763,372,4.6
19,123,Mahaska,2005,11638,11137,501,4.3
19,125,Marion,2005,17585,16886,699,4.0
19,127,Marshall,2005,20468,19485,983,4.8
19,129,Mills,2005,8171,7837,334,4.1
19,131,Mitchell,2005,5343,5114,229,4.3
19,133,Monona,2005,4709,4439,270,5.7
19,135,Monroe,2005,3870,3674,196,5.1
19,137,Montgomery,2005,5849,5593,256,4.4
19,139,Muscatine,2005,23365,22455,910,3.9
19,141,O'Brien,2005,7593,7304,289,3.8
19,143,Osceola,2005,3436,3299,137,4.0
19,145,Page,2005,8111,7798,313,3.9
19,147,Palo Alto,2005,5096,4893,203,4.0
19,149,Plymouth,2005,14075,13580,495,3.5
19,151,Pocahontas,2005,3860,3698,162,4.2
19,153,Polk,2005,227802,218633,9169,4.0
19,155,Pottawattamie,2005,48623,46225,2398,4.9
19,157,Poweshiek,2005,10264,9790,474,4.6
19,159,Ringgold,2005,2426,2315,111,4.6
19,161,Sac,2005,5753,5526,227,3.9
19,163,Scott,2005,88070,84142,3928,4.5
19,165,Shelby,2005,7063,6800,263,3.7
19,167,Sioux,2005,18823,18273,550,2.9
19,169,Story,2005,46883,45452,1431,3.1
19,171,Tama,2005,8973,8473,500,5.6
19,173,Taylor,2005,3363,3234,129,3.8
19,175,Union,2005,6334,6019,315,5.0
19,177,Van Buren,2005,3809,3612,197,5.2
19,179,Wapello,2005,19139,18090,1049,5.5
19,181,Warren,2005,24580,23674,906,3.7
19,183,Washington,2005,12241,11779,462,3.8
19,185,Wayne,2005,3164,3017,147,4.6
19,187,Webster,2005,19690,18842,848,4.3
19,189,Winnebago,2005,5949,5676,273,4.6
19,191,Winneshiek,2005,12423,11900,523,4.2
19,193,Woodbury,2005,53290,50697,2593,4.9
19,195,Worth,2005,4607,4394,213,4.6
19,197,Wright,2005,7148,6842,306,4.3
20,1,Allen,2005,7162,6774,388,5.4
20,3,Anderson,2005,4020,3780,240,6.0
20,5,Atchison,2005,8637,8158,479,5.5
20,7,Barber,2005,2589,2493,96,3.7
20,9,Barton,2005,14721,14124,597,4.1
20,11,Bourbon,2005,8639,8200,439,5.1
20,13,Brown,2005,5573,5303,270,4.8
20,15,Butler,2005,31890,30117,1773,5.6
20,17,Chase,2005,1681,1611,70,4.2
20,19,Chautauqua,2005,1955,1851,104,5.3
20,21,Cherokee,2005,10847,10140,707,6.5
20,23,Cheyenne,2005,1532,1463,69,4.5
20,25,Clark,2005,1175,1134,41,3.5
20,27,Clay,2005,4849,4649,200,4.1
20,29,Cloud,2005,5659,5443,216,3.8
20,31,Coffey,2005,5130,4841,289,5.6
20,33,Comanche,2005,1070,1038,32,3.0
20,35,Cowley,2005,17672,16690,982,5.6
20,37,Crawford,2005,19350,18230,1120,5.8
20,39,Decatur,2005,1691,1633,58,3.4
20,41,Dickinson,2005,10493,10017,476,4.5
20,43,Doniphan,2005,4416,4136,280,6.3
20,45,Douglas,2005,62881,60357,2524,4.0
20,47,Edwards,2005,1779,1718,61,3.4
20,49,Elk,2005,1446,1365,81,5.6
20,51,Ellis,2005,16556,15991,565,3.4
20,53,Ellsworth,2005,3382,3248,134,4.0
20,55,Finney,2005,17972,17222,750,4.2
20,57,Ford,2005,16595,15993,602,3.6
20,59,Franklin,2005,13803,13011,792,5.7
20,61,Geary,2005,11093,10429,664,6.0
20,63,Gove,2005,1509,1463,46,3.0
20,65,Graham,2005,1405,1354,51,3.6
20,67,Grant,2005,3768,3632,136,3.6
20,69,Gray,2005,3140,3044,96,3.1
20,71,Greeley,2005,739,708,31,4.2
20,73,Greenwood,2005,3596,3404,192,5.3
20,75,Hamilton,2005,1239,1198,41,3.3
20,77,Harper,2005,3404,3278,126,3.7
20,79,Harvey,2005,17945,17131,814,4.5
20,81,Haskell,2005,2135,2068,67,3.1
20,83,Hodgeman,2005,960,922,38,4.0
20,85,Jackson,2005,7123,6708,415,5.8
20,87,Jefferson,2005,10098,9571,527,5.2
20,89,Jewell,2005,1964,1901,63,3.2
20,91,Johnson,2005,289591,276214,13377,4.6
20,93,Kearny,2005,2009,1923,86,4.3
20,95,Kingman,2005,4311,4128,183,4.2
20,97,Kiowa,2005,1607,1551,56,3.5
20,99,Labette,2005,10397,9718,679,6.5
20,101,Lane,2005,1059,1021,38,3.6
20,103,Leavenworth,2005,32953,30905,2048,6.2
20,105,Lincoln,2005,1796,1719,77,4.3
20,107,Linn,2005,4875,4518,357,7.3
20,109,Logan,2005,1545,1489,56,3.6
20,111,Lyon,2005,19416,18522,894,4.6
20,113,McPherson,2005,17001,16354,647,3.8
20,115,Marion,2005,6747,6462,285,4.2
20,117,Marshall,2005,5890,5669,221,3.8
20,119,Meade,2005,2141,2062,79,3.7
20,121,Miami,2005,16258,15418,840,5.2
20,123,Mitchell,2005,3423,3293,130,3.8
20,125,Montgomery,2005,16818,15826,992,5.9
20,127,Morris,2005,2900,2753,147,5.1
20,129,Morton,2005,1700,1640,60,3.5
20,131,Nemaha,2005,5396,5197,199,3.7
20,133,Neosho,2005,8747,8302,445,5.1
20,135,Ness,2005,1693,1637,56,3.3
20,137,Norton,2005,2713,2613,100,3.7
20,139,Osage,2005,9081,8514,567,6.2
20,141,Osborne,2005,2288,2199,89,3.9
20,143,Ottawa,2005,3352,3198,154,4.6
20,145,Pawnee,2005,3847,3700,147,3.8
20,147,Phillips,2005,3064,2951,113,3.7
20,149,Pottawatomie,2005,10761,10318,443,4.1
20,151,Pratt,2005,5467,5270,197,3.6
20,153,Rawlins,2005,1332,1279,53,4.0
20,155,Reno,2005,32413,30788,1625,5.0
20,157,Republic,2005,2742,2630,112,4.1
20,159,Rice,2005,5450,5198,252,4.6
20,161,Riley,2005,33829,32551,1278,3.8
20,163,Rooks,2005,2659,2546,113,4.2
20,165,Rush,2005,1652,1585,67,4.1
20,167,Russell,2005,3449,3287,162,4.7
20,169,Saline,2005,30210,28872,1338,4.4
20,171,Scott,2005,2811,2715,96,3.4
20,173,Sedgwick,2005,243805,230356,13449,5.5
20,175,Seward,2005,10404,9990,414,4.0
20,177,Shawnee,2005,92903,87777,5126,5.5
20,179,Sheridan,2005,1513,1469,44,2.9
20,181,Sherman,2005,3588,3465,123,3.4
20,183,Smith,2005,2245,2162,83,3.7
20,185,Stafford,2005,2212,2125,87,3.9
20,187,Stanton,2005,1130,1096,34,3.0
20,189,Stevens,2005,2392,2294,98,4.1
20,191,Sumner,2005,12215,11489,726,5.9
20,193,Thomas,2005,4310,4173,137,3.2
20,195,Trego,2005,1714,1656,58,3.4
20,197,Wabaunsee,2005,3757,3585,172,4.6
20,199,Wallace,2005,924,896,28,3.0
20,201,Washington,2005,3393,3262,131,3.9
20,203,Wichita,2005,1298,1252,46,3.5
20,205,Wilson,2005,5372,5130,242,4.5
20,207,Woodson,2005,1675,1568,107,6.4
20,209,Wyandotte,2005,73246,66838,6408,8.7
21,1,Adair,2005,8640,8159,481,5.6
21,3,Allen,2005,8551,7999,552,6.5
21,5,Anderson,2005,10574,10070,504,4.8
21,7,Ballard,2005,4163,3880,283,6.8
21,9,Barren,2005,19287,18250,1037,5.4
21,11,Bath,2005,4993,4587,406,8.1
21,13,Bell,2005,9388,8693,695,7.4
21,15,Boone,2005,59651,56807,2844,4.8
21,17,Bourbon,2005,9770,9240,530,5.4
21,19,Boyd,2005,22896,21549,1347,5.9
21,21,Boyle,2005,12660,11826,834,6.6
21,23,Bracken,2005,4404,4126,278,6.3
21,25,Breathitt,2005,5540,5130,410,7.4
21,27,Breckinridge,2005,8883,8264,619,7.0
21,29,Bullitt,2005,35727,33701,2026,5.7
21,31,Butler,2005,5696,5292,404,7.1
21,33,Caldwell,2005,6369,5996,373,5.9
21,35,Calloway,2005,17526,16552,974,5.6
21,37,Campbell,2005,45762,43309,2453,5.4
21,39,Carlisle,2005,2312,2144,168,7.3
21,41,Carroll,2005,5597,5287,310,5.5
21,43,Carter,2005,13572,12456,1116,8.2
21,45,Casey,2005,7047,6621,426,6.0
21,47,Christian,2005,26357,24526,1831,6.9
21,49,Clark,2005,16992,16068,924,5.4
21,51,Clay,2005,7125,6523,602,8.4
21,53,Clinton,2005,4524,4235,289,6.4
21,55,Crittenden,2005,3985,3748,237,5.9
21,57,Cumberland,2005,2950,2717,233,7.9
21,59,Daviess,2005,46155,43476,2679,5.8
21,61,Edmonson,2005,5386,5005,381,7.1
21,63,Elliott,2005,2993,2706,287,9.6
21,65,Estill,2005,6015,5588,427,7.1
21,67,Fayette,2005,145783,139299,6484,4.4
21,69,Fleming,2005,6602,6205,397,6.0
21,71,Floyd,2005,14921,13875,1046,7.0
21,73,Franklin,2005,25010,23854,1156,4.6
21,75,Fulton,2005,2846,2637,209,7.3
21,77,Gallatin,2005,4037,3800,237,5.9
21,79,Garrard,2005,7492,7030,462,6.2
21,81,Grant,2005,12542,11858,684,5.5
21,83,Graves,2005,16266,14653,1613,9.9
21,85,Grayson,2005,11451,10469,982,8.6
21,87,Green,2005,5562,5221,341,6.1
21,89,Greenup,2005,17132,16044,1088,6.4
21,91,Hancock,2005,4137,3880,257,6.2
21,93,Hardin,2005,46030,43356,2674,5.8
21,95,Harlan,2005,10012,9229,783,7.8
21,97,Harrison,2005,8845,8326,519,5.9
21,99,Hart,2005,7783,7281,502,6.4
21,101,Henderson,2005,23076,21836,1240,5.4
21,103,Henry,2005,7871,7423,448,5.7
21,105,Hickman,2005,2041,1883,158,7.7
21,107,Hopkins,2005,22644,21321,1323,5.8
21,109,Jackson,2005,4749,4394,355,7.5
21,111,Jefferson,2005,350311,329603,20708,5.9
21,113,Jessamine,2005,21801,20782,1019,4.7
21,115,Johnson,2005,9673,9023,650,6.7
21,117,Kenton,2005,83676,79483,4193,5.0
21,119,Knott,2005,6639,6183,456,6.9
21,121,Knox,2005,12044,11279,765,6.4
21,123,Larue,2005,6855,6426,429,6.3
21,125,Laurel,2005,25848,24412,1436,5.6
21,127,Lawrence,2005,5785,5322,463,8.0
21,129,Lee,2005,2680,2477,203,7.6
21,131,Leslie,2005,3570,3281,289,8.1
21,133,Letcher,2005,8999,8351,648,7.2
21,135,Lewis,2005,5553,5032,521,9.4
21,137,Lincoln,2005,10609,9883,726,6.8
21,139,Livingston,2005,4814,4536,278,5.8
21,141,Logan,2005,12256,11474,782,6.4
21,143,Lyon,2005,3204,2970,234,7.3
21,145,McCracken,2005,31062,29266,1796,5.8
21,147,McCreary,2005,5990,5473,517,8.6
21,149,McLean,2005,4623,4292,331,7.2
21,151,Madison,2005,41336,39316,2020,4.9
21,153,Magoffin,2005,4459,3942,517,11.6
21,155,Marion,2005,9302,8771,531,5.7
21,157,Marshall,2005,14369,13438,931,6.5
21,159,Martin,2005,3657,3377,280,7.7
21,161,Mason,2005,8697,8153,544,6.3
21,163,Meade,2005,12129,11281,848,7.0
21,165,Menifee,2005,2589,2379,210,8.1
21,167,Mercer,2005,10424,9825,599,5.7
21,169,Metcalfe,2005,4459,4209,250,5.6
21,171,Monroe,2005,5018,4700,318,6.3
21,173,Montgomery,2005,11664,10861,803,6.9
21,175,Morgan,2005,4988,4511,477,9.6
21,177,Muhlenberg,2005,12774,11683,1091,8.5
21,179,Nelson,2005,20497,19206,1291,6.3
21,181,Nicholas,2005,2987,2705,282,9.4
21,183,Ohio,2005,11543,10791,752,6.5
21,185,Oldham,2005,26123,24879,1244,4.8
21,187,Owen,2005,5112,4816,296,5.8
21,189,Owsley,2005,1549,1430,119,7.7
21,191,Pendleton,2005,7464,7042,422,5.7
21,193,Perry,2005,11254,10455,799,7.1
21,195,Pike,2005,24623,23092,1531,6.2
21,197,Powell,2005,5480,5060,420,7.7
21,199,Pulaski,2005,26675,25083,1592,6.0
21,201,Robertson,2005,1075,1000,75,7.0
21,203,Rockcastle,2005,7363,6838,525,7.1
21,205,Rowan,2005,12088,11395,693,5.7
21,207,Russell,2005,7832,7318,514,6.6
21,209,Scott,2005,20548,19555,993,4.8
21,211,Shelby,2005,19979,18949,1030,5.2
21,213,Simpson,2005,8776,8288,488,5.6
21,215,Spencer,2005,8157,7722,435,5.3
21,217,Taylor,2005,12839,12167,672,5.2
21,219,Todd,2005,5313,4967,346,6.5
21,221,Trigg,2005,6443,6021,422,6.5
21,223,Trimble,2005,4340,4064,276,6.4
21,225,Union,2005,7163,6738,425,5.9
21,227,Warren,2005,55044,52341,2703,4.9
21,229,Washington,2005,5128,4821,307,6.0
21,231,Wayne,2005,8675,8146,529,6.1
21,233,Webster,2005,6644,6312,332,5.0
21,235,Whitley,2005,15296,14385,911,6.0
21,237,Wolfe,2005,2297,2068,229,10.0
21,239,Woodford,2005,13247,12698,549,4.1
22,1,Acadia Parish,2005,25526,23981,1545,6.1
22,3,Allen Parish,2005,8741,7890,851,9.7
22,5,Ascension Parish,2005,46027,43030,2997,6.5
22,7,Assumption Parish,2005,10086,9094,992,9.8
22,9,Avoyelles Parish,2005,16128,14800,1328,8.2
22,11,Beauregard Parish,2005,14387,13304,1083,7.5
22,13,Bienville Parish,2005,6288,5836,452,7.2
22,15,Bossier Parish,2005,51697,48923,2774,5.4
22,17,Caddo Parish,2005,117949,110860,7089,6.0
22,19,Calcasieu Parish,2005,91531,84559,6972,7.6
22,21,Caldwell Parish,2005,4341,4029,312,7.2
22,23,Cameron Parish,2005,4482,4221,261,5.8
22,25,Catahoula Parish,2005,4172,3826,346,8.3
22,27,Claiborne Parish,2005,6955,6517,438,6.3
22,29,Concordia Parish,2005,7391,6609,782,10.6
22,31,De Soto Parish,2005,11453,10677,776,6.8
22,33,East Baton Rouge Parish,2005,213920,199055,14865,6.9
22,35,East Carroll Parish,2005,2933,2548,385,13.1
22,37,East Feliciana Parish,2005,8235,7680,555,6.7
22,39,Evangeline Parish,2005,12199,11321,878,7.2
22,41,Franklin Parish,2005,7842,7136,706,9.0
22,43,Grant Parish,2005,8588,8053,535,6.2
22,45,Iberia Parish,2005,32814,30628,2186,6.7
22,47,Iberville Parish,2005,12656,11528,1128,8.9
22,49,Jackson Parish,2005,6435,6056,379,5.9
22,53,Jefferson Davis Parish,2005,14369,13473,896,6.2
22,55,Lafayette Parish,2005,104618,99139,5479,5.2
22,57,Lafourche Parish,2005,45594,42860,2734,6.0
22,59,LaSalle Parish,2005,5816,5507,309,5.3
22,61,Lincoln Parish,2005,18685,17415,1270,6.8
22,63,Livingston Parish,2005,53562,50411,3151,5.9
22,65,Madison Parish,2005,4697,4271,426,9.1
22,67,Morehouse Parish,2005,11746,10689,1057,9.0
22,69,Natchitoches Parish,2005,17922,16693,1229,6.9
22,73,Ouachita Parish,2005,72697,68303,4394,6.0
22,77,Pointe Coupee Parish,2005,9961,9080,881,8.8
22,79,Rapides Parish,2005,59452,55828,3624,6.1
22,81,Red River Parish,2005,3351,3060,291,8.7
22,83,Richland Parish,2005,8586,7932,654,7.6
22,85,Sabine Parish,2005,9494,8919,575,6.1
22,91,St. Helena Parish,2005,4399,3774,625,14.2
22,93,St. James Parish,2005,9060,8101,959,10.6
22,97,St. Landry Parish,2005,37192,34532,2660,7.2
22,99,St. Martin Parish,2005,22783,21423,1360,6.0
22,101,St. Mary Parish,2005,22513,20545,1968,8.7
22,105,Tangipahoa Parish,2005,50856,45914,4942,9.7
22,107,Tensas Parish,2005,2314,1994,320,13.8
22,109,Terrebonne Parish,2005,51263,47887,3376,6.6
22,111,Union Parish,2005,10492,9850,642,6.1
22,113,Vermilion Parish,2005,23482,22076,1406,6.0
22,115,Vernon Parish,2005,21157,19921,1236,5.8
22,117,Washington Parish,2005,16386,14713,1673,10.2
22,119,Webster Parish,2005,19528,18297,1231,6.3
22,121,West Baton Rouge Parish,2005,10500,9766,734,7.0
22,123,West Carroll Parish,2005,4743,4232,511,10.8
22,125,West Feliciana Parish,2005,4954,4555,399,8.1
22,127,Winn Parish,2005,6266,5870,396,6.3
23,1,Androscoggin,2005,56879,54052,2827,5.0
23,3,Aroostook,2005,35152,32810,2342,6.7
23,5,Cumberland,2005,155196,149512,5684,3.7
23,7,Franklin,2005,14602,13753,849,5.8
23,9,Hancock,2005,29804,28144,1660,5.6
23,11,Kennebec,2005,62051,58918,3133,5.0
23,13,Knox,2005,21316,20414,902,4.2
23,15,Lincoln,2005,18210,17390,820,4.5
23,17,Oxford,2005,28051,26415,1636,5.8
23,19,Penobscot,2005,77083,73137,3946,5.1
23,21,Piscataquis,2005,7500,6946,554,7.4
23,23,Sagadahoc,2005,18484,17671,813,4.4
23,25,Somerset,2005,24717,22821,1896,7.7
23,27,Waldo,2005,19466,18410,1056,5.4
23,29,Washington,2005,15306,13998,1308,8.5
23,31,York,2005,111477,106792,4685,4.2
24,1,Allegany,2005,35464,33124,2340,6.6
24,3,Anne Arundel,2005,274969,264459,10510,3.8
24,5,Baltimore,2005,420317,400813,19504,4.6
24,9,Calvert,2005,46095,44389,1706,3.7
24,11,Caroline,2005,16213,15444,769,4.7
24,13,Carroll,2005,92055,88743,3312,3.6
24,15,Cecil,2005,49854,47365,2489,5.0
24,17,Charles,2005,72832,70131,2701,3.7
24,19,Dorchester,2005,17059,16055,1004,5.9
24,21,Frederick,2005,120530,116423,4107,3.4
24,23,Garrett,2005,16569,15705,864,5.2
24,25,Harford,2005,129479,123937,5542,4.3
24,27,Howard,2005,154398,149217,5181,3.4
24,29,Kent,2005,10945,10448,497,4.5
24,31,Montgomery,2005,505167,488059,17108,3.4
24,33,Prince George's,2005,443531,422016,21515,4.9
24,35,Queen Anne's,2005,25083,24129,954,3.8
24,37,St. Mary's,2005,49243,47354,1889,3.8
24,39,Somerset,2005,11483,10731,752,6.5
24,41,Talbot,2005,18964,18161,803,4.2
24,43,Washington,2005,67975,64735,3240,4.8
24,45,Wicomico,2005,51832,49447,2385,4.6
24,47,Worcester,2005,27847,25854,1993,7.2
24,510,Baltimore city,2005,273675,253221,20454,7.5
25,1,Barnstable,2005,122197,116230,5967,4.9
25,3,Berkshire,2005,72700,69557,3143,4.3
25,5,Bristol,2005,287919,270854,17065,5.9
25,7,Dukes,2005,10984,10556,428,3.9
25,9,Essex,2005,375910,356332,19578,5.2
25,11,Franklin,2005,39596,37910,1686,4.3
25,13,Hampden,2005,224231,211282,12949,5.8
25,15,Hampshire,2005,87867,84341,3526,4.0
25,17,Middlesex,2005,810496,777801,32695,4.0
25,19,Nantucket/town,2005,8146,7949,197,2.4
25,21,Norfolk,2005,356058,341410,14648,4.1
25,23,Plymouth,2005,258525,246047,12478,4.8
25,25,Suffolk,2005,332203,314651,17552,5.3
25,27,Worcester,2005,398712,378038,20674,5.2
26,1,Alcona,2005,4301,3855,446,10.4
26,3,Alger,2005,4389,4056,333,7.6
26,5,Allegan,2005,55106,51646,3460,6.3
26,7,Alpena,2005,15119,13981,1138,7.5
26,9,Antrim,2005,12119,11183,936,7.7
26,11,Arenac,2005,7833,7101,732,9.3
26,13,Baraga,2005,4137,3673,464,11.2
26,15,Barry,2005,30938,29350,1588,5.1
26,17,Bay,2005,55635,51700,3935,7.1
26,19,Benzie,2005,9147,8434,713,7.8
26,21,Berrien,2005,79181,73721,5460,6.9
26,23,Branch,2005,22752,21137,1615,7.1
26,25,Calhoun,2005,71824,67043,4781,6.7
26,27,Cass,2005,27699,26299,1400,5.1
26,29,Charlevoix,2005,14381,13317,1064,7.4
26,31,Cheboygan,2005,13240,12039,1201,9.1
26,33,Chippewa,2005,17561,16052,1509,8.6
26,35,Clare,2005,13499,12191,1308,9.7
26,37,Clinton,2005,37321,35335,1986,5.3
26,39,Crawford,2005,6810,6324,486,7.1
26,41,Delta,2005,20328,18852,1476,7.3
26,43,Dickinson,2005,14495,13661,834,5.8
26,45,Eaton,2005,58741,55510,3231,5.5
26,47,Emmet,2005,20181,18582,1599,7.9
26,49,Genesee,2005,212975,196252,16723,7.9
26,51,Gladwin,2005,10915,9793,1122,10.3
26,53,Gogebic,2005,7767,7157,610,7.9
26,55,Grand Traverse,2005,48416,45538,2878,5.9
26,57,Gratiot,2005,20336,18647,1689,8.3
26,59,Hillsdale,2005,22384,20682,1702,7.6
26,61,Houghton,2005,17596,16452,1144,6.5
26,63,Huron,2005,17083,15777,1306,7.6
26,65,Ingham,2005,152383,142662,9721,6.4
26,67,Ionia,2005,30966,28707,2259,7.3
26,69,Iosco,2005,10972,9970,1002,9.1
26,71,Iron,2005,5882,5447,435,7.4
26,73,Isabella,2005,38046,36161,1885,5.0
26,75,Jackson,2005,78418,73074,5344,6.8
26,77,Kalamazoo,2005,132774,125846,6928,5.2
26,79,Kalkaska,2005,8786,8124,662,7.5
26,81,Kent,2005,322124,303395,18729,5.8
26,83,Keweenaw,2005,1066,953,113,10.6
26,85,Lake,2005,4393,3937,456,10.4
26,87,Lapeer,2005,45430,41974,3456,7.6
26,89,Leelanau,2005,11593,10995,598,5.2
26,91,Lenawee,2005,49804,46271,3533,7.1
26,93,Livingston,2005,95356,90368,4988,5.2
26,95,Luce,2005,2838,2620,218,7.7
26,97,Mackinac,2005,6516,5857,659,10.1
26,99,Macomb,2005,424613,396313,28300,6.7
26,101,Manistee,2005,12173,11207,966,7.9
26,103,Marquette,2005,35619,33550,2069,5.8
26,105,Mason,2005,15224,14036,1188,7.8
26,107,Mecosta,2005,20217,18739,1478,7.3
26,109,Menominee,2005,13313,12605,708,5.3
26,111,Midland,2005,41968,39498,2470,5.9
26,113,Missaukee,2005,6730,6228,502,7.5
26,115,Monroe,2005,77968,73159,4809,6.2
26,117,Montcalm,2005,29508,26943,2565,8.7
26,119,Montmorency,2005,4306,3787,519,12.1
26,121,Muskegon,2005,90179,83893,6286,7.0
26,123,Newaygo,2005,23456,21705,1751,7.5
26,125,Oakland,2005,637354,602050,35304,5.5
26,127,Oceana,2005,14411,13243,1168,8.1
26,129,Ogemaw,2005,9897,9142,755,7.6
26,131,Ontonagon,2005,3583,3319,264,7.4
26,133,Osceola,2005,10257,9476,781,7.6
26,135,Oscoda,2005,3961,3543,418,10.6
26,137,Otsego,2005,12975,12062,913,7.0
26,139,Ottawa,2005,136429,129323,7106,5.2
26,141,Presque Isle,2005,6229,5529,700,11.2
26,143,Roscommon,2005,11219,10270,949,8.5
26,145,Saginaw,2005,98498,90681,7817,7.9
26,147,St. Clair,2005,85052,78420,6632,7.8
26,149,St. Joseph,2005,30986,28997,1989,6.4
26,151,Sanilac,2005,22217,20407,1810,8.1
26,153,Schoolcraft,2005,4074,3639,435,10.7
26,155,Shiawassee,2005,36788,33877,2911,7.9
26,157,Tuscola,2005,29299,26916,2383,8.1
26,159,Van Buren,2005,40931,38064,2867,7.0
26,161,Washtenaw,2005,190220,181785,8435,4.4
26,163,Wayne,2005,903631,827954,75677,8.4
26,165,Wexford,2005,14773,13646,1127,7.6
27,1,Aitkin,2005,7746,7275,471,6.1
27,3,Anoka,2005,189771,182367,7404,3.9
27,5,Becker,2005,16652,15750,902,5.4
27,7,Beltrami,2005,21197,20060,1137,5.4
27,9,Benton,2005,22174,21126,1048,4.7
27,11,Big Stone,2005,2761,2633,128,4.6
27,13,Blue Earth,2005,35490,34292,1198,3.4
27,15,Brown,2005,14829,14186,643,4.3
27,17,Carlton,2005,17031,16034,997,5.9
27,19,Carver,2005,48084,46430,1654,3.4
27,21,Cass,2005,14447,13548,899,6.2
27,23,Chippewa,2005,7173,6874,299,4.2
27,25,Chisago,2005,27059,25753,1306,4.8
27,27,Clay,2005,30862,29787,1075,3.5
27,29,Clearwater,2005,3873,3478,395,10.2
27,31,Cook,2005,3241,3099,142,4.4
27,33,Cottonwood,2005,6314,6037,277,4.4
27,35,Crow Wing,2005,32097,30513,1584,4.9
27,37,Dakota,2005,228016,219730,8286,3.6
27,39,Dodge,2005,11176,10740,436,3.9
27,41,Douglas,2005,20035,19265,770,3.8
27,43,Faribault,2005,8053,7661,392,4.9
27,45,Fillmore,2005,11278,10796,482,4.3
27,47,Freeborn,2005,16251,15483,768,4.7
27,49,Goodhue,2005,24732,23625,1107,4.5
27,51,Grant,2005,3054,2880,174,5.7
27,53,Hennepin,2005,652799,628521,24278,3.7
27,55,Houston,2005,11087,10579,508,4.6
27,57,Hubbard,2005,9661,9130,531,5.5
27,59,Isanti,2005,21055,20027,1028,4.9
27,61,Itasca,2005,22433,21089,1344,6.0
27,63,Jackson,2005,6672,6443,229,3.4
27,65,Kanabec,2005,7783,7255,528,6.8
27,67,Kandiyohi,2005,23224,22250,974,4.2
27,69,Kittson,2005,2575,2439,136,5.3
27,71,Koochiching,2005,6957,6529,428,6.2
27,73,Lac qui Parle,2005,4100,3938,162,4.0
27,75,Lake,2005,6091,5828,263,4.3
27,77,Lake of the Woods,2005,2448,2338,110,4.5
27,79,Le Sueur,2005,14194,13414,780,5.5
27,81,Lincoln,2005,3396,3271,125,3.7
27,83,Lyon,2005,14623,14137,486,3.3
27,85,McLeod,2005,20048,19220,828,4.1
27,87,Mahnomen,2005,2554,2412,142,5.6
27,89,Marshall,2005,5293,4914,379,7.2
27,91,Martin,2005,11246,10775,471,4.2
27,93,Meeker,2005,12358,11723,635,5.1
27,95,Mille Lacs,2005,11982,11172,810,6.8
27,97,Morrison,2005,17380,16423,957,5.5
27,99,Mower,2005,20341,19557,784,3.9
27,101,Murray,2005,5397,5176,221,4.1
27,103,Nicollet,2005,18849,18240,609,3.2
27,105,Nobles,2005,11097,10728,369,3.3
27,107,Norman,2005,3620,3450,170,4.7
27,109,Olmsted,2005,78316,75575,2741,3.5
27,111,Otter Tail,2005,29564,28120,1444,4.9
27,113,Pennington,2005,8199,7741,458,5.6
27,115,Pine,2005,13675,12767,908,6.6
27,117,Pipestone,2005,5051,4866,185,3.7
27,119,Polk,2005,16907,16138,769,4.5
27,121,Pope,2005,6096,5858,238,3.9
27,123,Ramsey,2005,271460,260727,10733,4.0
27,125,Red Lake,2005,2237,2082,155,6.9
27,127,Redwood,2005,8204,7883,321,3.9
27,129,Renville,2005,8442,8024,418,5.0
27,131,Rice,2005,31552,30117,1435,4.5
27,133,Rock,2005,5185,5026,159,3.1
27,135,Roseau,2005,10190,9671,519,5.1
27,137,St. Louis,2005,101405,96259,5146,5.1
27,139,Scott,2005,69843,67337,2506,3.6
27,141,Sherburne,2005,46549,44508,2041,4.4
27,143,Sibley,2005,8878,8503,375,4.2
27,145,Stearns,2005,80674,77156,3518,4.4
27,147,Steele,2005,19676,18856,820,4.2
27,149,Stevens,2005,5530,5328,202,3.7
27,151,Swift,2005,5284,5041,243,4.6
27,153,Todd,2005,12455,11818,637,5.1
27,155,Traverse,2005,1849,1779,70,3.8
27,157,Wabasha,2005,12598,12079,519,4.1
27,159,Wadena,2005,6428,5992,436,6.8
27,161,Waseca,2005,10451,9989,462,4.4
27,163,Washington,2005,125631,121199,4432,3.5
27,165,Watonwan,2005,5751,5511,240,4.2
27,167,Wilkin,2005,3604,3471,133,3.7
27,169,Winona,2005,28272,27237,1035,3.7
27,171,Wright,2005,62782,60081,2701,4.3
27,173,Yellow Medicine,2005,5514,5280,234,4.2
28,1,Adams,2005,13409,12172,1237,9.2
28,3,Alcorn,2005,15991,14855,1136,7.1
28,5,Amite,2005,5268,4824,444,8.4
28,7,Attala,2005,7662,7026,636,8.3
28,9,Benton,2005,2990,2688,302,10.1
28,11,Bolivar,2005,15531,14089,1442,9.3
28,13,Calhoun,2005,6326,5871,455,7.2
28,15,Carroll,2005,4813,4475,338,7.0
28,17,Chickasaw,2005,7775,7054,721,9.3
28,19,Choctaw,2005,3611,3332,279,7.7
28,21,Claiborne,2005,3764,3317,447,11.9
28,23,Clarke,2005,7217,6661,556,7.7
28,25,Clay,2005,8554,7637,917,10.7
28,27,Coahoma,2005,11134,9967,1167,10.5
28,29,Copiah,2005,12495,11480,1015,8.1
28,31,Covington,2005,8796,8195,601,6.8
28,33,DeSoto,2005,71457,68464,2993,4.2
28,35,Forrest,2005,35650,33383,2267,6.4
28,37,Franklin,2005,3121,2845,276,8.8
28,39,George,2005,8571,7795,776,9.1
28,41,Greene,2005,4775,4325,450,9.4
28,43,Grenada,2005,10190,9432,758,7.4
28,45,Hancock,2005,20995,18734,2261,10.8
28,47,Harrison,2005,92581,82608,9973,10.8
28,49,Hinds,2005,122098,114075,8023,6.6
28,51,Holmes,2005,7055,6214,841,11.9
28,53,Humphreys,2005,4303,3869,434,10.1
28,55,Issaquena,2005,766,676,90,11.7
28,57,Itawamba,2005,10534,9847,687,6.5
28,59,Jackson,2005,62187,55992,6195,10.0
28,61,Jasper,2005,7415,6828,587,7.9
28,63,Jefferson,2005,2818,2396,422,15.0
28,65,Jefferson Davis,2005,5434,4938,496,9.1
28,67,Jones,2005,30093,28331,1762,5.9
28,69,Kemper,2005,4240,3841,399,9.4
28,71,Lafayette,2005,21321,20205,1116,5.2
28,73,Lamar,2005,22320,21114,1206,5.4
28,75,Lauderdale,2005,33619,31211,2408,7.2
28,77,Lawrence,2005,5132,4706,426,8.3
28,79,Leake,2005,8561,7927,634,7.4
28,81,Lee,2005,38543,36101,2442,6.3
28,83,Leflore,2005,13883,12525,1358,9.8
28,85,Lincoln,2005,14559,13471,1088,7.5
28,87,Lowndes,2005,25508,23566,1942,7.6
28,89,Madison,2005,44041,41743,2298,5.2
28,91,Marion,2005,10330,9468,862,8.3
28,93,Marshall,2005,15352,14025,1327,8.6
28,95,Monroe,2005,17200,15797,1403,8.2
28,97,Montgomery,2005,4821,4430,391,8.1
28,99,Neshoba,2005,14765,13872,893,6.0
28,101,Newton,2005,9742,9124,618,6.3
28,103,Noxubee,2005,4204,3683,521,12.4
28,105,Oktibbeha,2005,20206,18968,1238,6.1
28,107,Panola,2005,14798,13501,1297,8.8
28,109,Pearl River,2005,21359,19381,1978,9.3
28,111,Perry,2005,5134,4706,428,8.3
28,113,Pike,2005,15529,14147,1382,8.9
28,115,Pontotoc,2005,13369,12563,806,6.0
28,117,Prentiss,2005,11431,10541,890,7.8
28,119,Quitman,2005,3954,3584,370,9.4
28,121,Rankin,2005,71663,68374,3289,4.6
28,123,Scott,2005,13267,12520,747,5.6
28,125,Sharkey,2005,2563,2278,285,11.1
28,127,Simpson,2005,11967,11234,733,6.1
28,129,Smith,2005,6848,6428,420,6.1
28,131,Stone,2005,6831,6300,531,7.8
28,133,Sunflower,2005,11194,10048,1146,10.2
28,135,Tallahatchie,2005,6430,5842,588,9.1
28,137,Tate,2005,11890,11107,783,6.6
28,139,Tippah,2005,9570,8907,663,6.9
28,141,Tishomingo,2005,8104,7399,705,8.7
28,143,Tunica,2005,4501,4042,459,10.2
28,145,Union,2005,11916,11142,774,6.5
28,147,Walthall,2005,5895,5354,541,9.2
28,149,Warren,2005,23038,21429,1609,7.0
28,151,Washington,2005,23181,20578,2603,11.2
28,153,Wayne,2005,8570,7918,652,7.6
28,155,Webster,2005,3548,3261,287,8.1
28,157,Wilkinson,2005,3727,3264,463,12.4
28,159,Winston,2005,7987,7382,605,7.6
28,161,Yalobusha,2005,5276,4808,468,8.9
28,163,Yazoo,2005,10148,9157,991,9.8
29,1,Adair,2005,13397,12828,569,4.2
29,3,Andrew,2005,9810,9300,510,5.2
29,5,Atchison,2005,3182,3032,150,4.7
29,7,Audrain,2005,12132,11503,629,5.2
29,9,Barry,2005,17415,16548,867,5.0
29,11,Barton,2005,6460,6132,328,5.1
29,13,Bates,2005,7941,7434,507,6.4
29,15,Benton,2005,8466,7943,523,6.2
29,17,Bollinger,2005,5860,5495,365,6.2
29,19,Boone,2005,85768,82695,3073,3.6
29,21,Buchanan,2005,45570,42898,2672,5.9
29,23,Butler,2005,22247,21091,1156,5.2
29,25,Caldwell,2005,4409,4144,265,6.0
29,27,Callaway,2005,22609,21536,1073,4.7
29,29,Camden,2005,22219,21074,1145,5.2
29,31,Cape Girardeau,2005,38053,36340,1713,4.5
29,33,Carroll,2005,5088,4814,274,5.4
29,35,Carter,2005,2960,2775,185,6.3
29,37,Cass,2005,48748,46242,2506,5.1
29,39,Cedar,2005,6394,6015,379,5.9
29,41,Chariton,2005,4223,3989,234,5.5
29,43,Christian,2005,37356,35754,1602,4.3
29,45,Clark,2005,3584,3371,213,5.9
29,47,Clay,2005,111269,106096,5173,4.6
29,49,Clinton,2005,10335,9769,566,5.5
29,51,Cole,2005,40168,38522,1646,4.1
29,53,Cooper,2005,9069,8637,432,4.8
29,55,Crawford,2005,11842,11122,720,6.1
29,57,Dade,2005,3743,3536,207,5.5
29,59,Dallas,2005,7453,7046,407,5.5
29,61,Daviess,2005,4025,3828,197,4.9
29,63,DeKalb,2005,5065,4766,299,5.9
29,65,Dent,2005,6550,6138,412,6.3
29,67,Douglas,2005,5996,5626,370,6.2
29,69,Dunklin,2005,14617,13552,1065,7.3
29,71,Franklin,2005,52526,49480,3046,5.8
29,73,Gasconade,2005,7903,7461,442,5.6
29,75,Gentry,2005,3334,3185,149,4.5
29,77,Greene,2005,137104,131320,5784,4.2
29,79,Grundy,2005,4923,4667,256,5.2
29,81,Harrison,2005,4627,4383,244,5.3
29,83,Henry,2005,10815,10154,661,6.1
29,85,Hickory,2005,3412,3146,266,7.8
29,87,Holt,2005,2632,2512,120,4.6
29,89,Howard,2005,5413,5167,246,4.5
29,91,Howell,2005,19939,18995,944,4.7
29,93,Iron,2005,5010,4658,352,7.0
29,95,Jackson,2005,336489,314867,21622,6.4
29,97,Jasper,2005,54596,51943,2653,4.9
29,99,Jefferson,2005,115903,109591,6312,5.4
29,101,Johnson,2005,25837,24648,1189,4.6
29,103,Knox,2005,2441,2346,95,3.9
29,105,Laclede,2005,17134,16194,940,5.5
29,107,Lafayette,2005,16720,15798,922,5.5
29,109,Lawrence,2005,18864,17989,875,4.6
29,111,Lewis,2005,5765,5502,263,4.6
29,113,Lincoln,2005,24545,23199,1346,5.5
29,115,Linn,2005,6729,6186,543,8.1
29,117,Livingston,2005,7341,6990,351,4.8
29,119,McDonald,2005,11911,11400,511,4.3
29,121,Macon,2005,8307,7896,411,4.9
29,123,Madison,2005,6020,5641,379,6.3
29,125,Maries,2005,4810,4585,225,4.7
29,127,Marion,2005,14554,13799,755,5.2
29,129,Mercer,2005,1811,1732,79,4.4
29,131,Miller,2005,13342,12578,764,5.7
29,133,Mississippi,2005,5839,5416,423,7.2
29,135,Moniteau,2005,7568,7184,384,5.1
29,137,Monroe,2005,4516,4267,249,5.5
29,139,Montgomery,2005,6269,5908,361,5.8
29,141,Morgan,2005,9566,8949,617,6.4
29,143,New Madrid,2005,8640,8045,595,6.9
29,145,Newton,2005,27760,26355,1405,5.1
29,147,Nodaway,2005,12519,12052,467,3.7
29,149,Oregon,2005,4303,4072,231,5.4
29,151,Osage,2005,7506,7152,354,4.7
29,153,Ozark,2005,4472,4228,244,5.5
29,155,Pemiscot,2005,8054,7441,613,7.6
29,157,Perry,2005,10440,10019,421,4.0
29,159,Pettis,2005,20772,19615,1157,5.6
29,161,Phelps,2005,22352,21345,1007,4.5
29,163,Pike,2005,8941,8466,475,5.3
29,165,Platte,2005,47336,45205,2131,4.5
29,167,Polk,2005,13971,13288,683,4.9
29,169,Pulaski,2005,18157,17192,965,5.3
29,171,Putnam,2005,2556,2434,122,4.8
29,173,Ralls,2005,5603,5293,310,5.5
29,175,Randolph,2005,13098,12429,669,5.1
29,177,Ray,2005,11795,11148,647,5.5
29,179,Reynolds,2005,2593,2390,203,7.8
29,181,Ripley,2005,6605,6210,395,6.0
29,183,St. Charles,2005,186350,178412,7938,4.3
29,185,St. Clair,2005,4329,4071,258,6.0
29,186,Ste. Genevieve,2005,9539,9027,512,5.4
29,187,St. Francois,2005,28050,26178,1872,6.7
29,189,St. Louis,2005,536168,508302,27866,5.2
29,195,Saline,2005,12056,11456,600,5.0
29,197,Schuyler,2005,2287,2151,136,5.9
29,199,Scotland,2005,2461,2364,97,3.9
29,201,Scott,2005,20426,19256,1170,5.7
29,203,Shannon,2005,3814,3532,282,7.4
29,205,Shelby,2005,3207,3039,168,5.2
29,207,Stoddard,2005,15980,15055,925,5.8
29,209,Stone,2005,15871,14597,1274,8.0
29,211,Sullivan,2005,3230,3049,181,5.6
29,213,Taney,2005,25568,23318,2250,8.8
29,215,Texas,2005,10754,10061,693,6.4
29,217,Vernon,2005,10149,9657,492,4.8
29,219,Warren,2005,15356,14527,829,5.4
29,221,Washington,2005,10015,9137,878,8.8
29,223,Wayne,2005,5804,5413,391,6.7
29,225,Webster,2005,16714,15926,788,4.7
29,227,Worth,2005,1144,1098,46,4.0
29,229,Wright,2005,8200,7679,521,6.4
29,510,St. Louis city,2005,157619,144788,12831,8.1
30,1,Beaverhead,2005,4953,4785,168,3.4
30,3,Big Horn,2005,5216,4769,447,8.6
30,5,Blaine,2005,2829,2709,120,4.2
30,7,Broadwater,2005,2311,2223,88,3.8
30,9,Carbon,2005,5383,5191,192,3.6
30,11,Carter,2005,678,653,25,3.7
30,13,Cascade,2005,38909,37344,1565,4.0
30,15,Chouteau,2005,2629,2538,91,3.5
30,17,Custer,2005,5613,5402,211,3.8
30,19,Daniels,2005,780,752,28,3.6
30,21,Dawson,2005,4186,4040,146,3.5
30,23,Deer Lodge,2005,3843,3619,224,5.8
30,25,Fallon,2005,1644,1601,43,2.6
30,27,Fergus,2005,5810,5527,283,4.9
30,29,Flathead,2005,42778,40801,1977,4.6
30,31,Gallatin,2005,46635,45252,1383,3.0
30,33,Garfield,2005,642,617,25,3.9
30,35,Glacier,2005,5846,5417,429,7.3
30,37,Golden Valley,2005,537,512,25,4.7
30,39,Granite,2005,1230,1161,69,5.6
30,41,Hill,2005,7846,7513,333,4.2
30,43,Jefferson,2005,5593,5371,222,4.0
30,45,Judith Basin,2005,1070,1022,48,4.5
30,47,Lake,2005,11550,10919,631,5.5
30,49,Lewis and Clark,2005,30821,29666,1155,3.7
30,51,Liberty,2005,871,832,39,4.5
30,53,Lincoln,2005,7734,7094,640,8.3
30,55,McCone,2005,1014,980,34,3.4
30,57,Madison,2005,3825,3693,132,3.5
30,59,Meagher,2005,941,898,43,4.6
30,61,Mineral,2005,1944,1833,111,5.7
30,63,Missoula,2005,57854,55715,2139,3.7
30,65,Musselshell,2005,2084,1975,109,5.2
30,67,Park,2005,9002,8646,356,4.0
30,69,Petroleum,2005,226,215,11,4.9
30,71,Phillips,2005,2073,1988,85,4.1
30,73,Pondera,2005,2719,2588,131,4.8
30,75,Powder River,2005,916,882,34,3.7
30,77,Powell,2005,2661,2501,160,6.0
30,79,Prairie,2005,552,526,26,4.7
30,81,Ravalli,2005,18405,17504,901,4.9
30,83,Richland,2005,5078,4911,167,3.3
30,85,Roosevelt,2005,4000,3745,255,6.4
30,87,Rosebud,2005,4028,3800,228,5.7
30,89,Sanders,2005,4542,4245,297,6.5
30,91,Sheridan,2005,1764,1702,62,3.5
30,93,Silver Bow,2005,17238,16509,729,4.2
30,95,Stillwater,2005,4384,4240,144,3.3
30,97,Sweet Grass,2005,2745,2689,56,2.0
30,99,Teton,2005,3004,2900,104,3.5
30,101,Toole,2005,2534,2453,81,3.2
30,103,Treasure,2005,407,391,16,3.9
30,105,Valley,2005,3625,3482,143,3.9
30,107,Wheatland,2005,1022,981,41,4.0
30,109,Wibaux,2005,493,476,17,3.4
30,111,Yellowstone,2005,78536,75934,2602,3.3
31,1,Adams,2005,17024,16449,575,3.4
31,3,Antelope,2005,3858,3729,129,3.3
31,5,Arthur,2005,257,247,10,3.9
31,7,Banner,2005,388,377,11,2.8
31,9,Blaine,2005,285,274,11,3.9
31,11,Boone,2005,3165,3058,107,3.4
31,13,Box Butte,2005,5613,5392,221,3.9
31,15,Boyd,2005,1134,1093,41,3.6
31,17,Brown,2005,1923,1861,62,3.2
31,19,Buffalo,2005,27029,26283,746,2.8
31,21,Burt,2005,3873,3683,190,4.9
31,23,Butler,2005,4694,4524,170,3.6
31,25,Cass,2005,14013,13440,573,4.1
31,27,Cedar,2005,4988,4853,135,2.7
31,29,Chase,2005,2139,2080,59,2.8
31,31,Cherry,2005,3693,3606,87,2.4
31,33,Cheyenne,2005,5276,5126,150,2.8
31,35,Clay,2005,3242,3123,119,3.7
31,37,Colfax,2005,5847,5684,163,2.8
31,39,Cuming,2005,5351,5191,160,3.0
31,41,Custer,2005,6226,6048,178,2.9
31,43,Dakota,2005,10527,10032,495,4.7
31,45,Dawes,2005,4756,4604,152,3.2
31,47,Dawson,2005,12291,11758,533,4.3
31,49,Deuel,2005,1090,1056,34,3.1
31,51,Dixon,2005,3144,3021,123,3.9
31,53,Dodge,2005,19674,18817,857,4.4
31,55,Douglas,2005,266012,254198,11814,4.4
31,57,Dundy,2005,1110,1065,45,4.1
31,59,Fillmore,2005,3355,3249,106,3.2
31,61,Franklin,2005,1893,1829,64,3.4
31,63,Frontier,2005,1784,1740,44,2.5
31,65,Furnas,2005,2546,2453,93,3.7
31,67,Gage,2005,12830,12265,565,4.4
31,69,Garden,2005,1056,1025,31,2.9
31,71,Garfield,2005,1068,1036,32,3.0
31,73,Gosper,2005,1057,1021,36,3.4
31,75,Grant,2005,424,413,11,2.6
31,77,Greeley,2005,1386,1336,50,3.6
31,79,Hall,2005,30122,28977,1145,3.8
31,81,Hamilton,2005,5438,5292,146,2.7
31,83,Harlan,2005,1793,1736,57,3.2
31,85,Hayes,2005,514,496,18,3.5
31,87,Hitchcock,2005,1488,1433,55,3.7
31,89,Holt,2005,6217,6028,189,3.0
31,91,Hooker,2005,450,436,14,3.1
31,93,Howard,2005,3687,3556,131,3.6
31,95,Jefferson,2005,4363,4196,167,3.8
31,97,Johnson,2005,3139,3027,112,3.6
31,99,Kearney,2005,3891,3781,110,2.8
31,101,Keith,2005,4782,4628,154,3.2
31,103,Keya Paha,2005,434,420,14,3.2
31,105,Kimball,2005,2137,2075,62,2.9
31,107,Knox,2005,4886,4720,166,3.4
31,109,Lancaster,2005,155978,150505,5473,3.5
31,111,Lincoln,2005,21072,20346,726,3.4
31,113,Logan,2005,447,436,11,2.5
31,115,Loup,2005,339,324,15,4.4
31,117,McPherson,2005,291,285,6,2.1
31,119,Madison,2005,20296,19483,813,4.0
31,121,Merrick,2005,4289,4133,156,3.6
31,123,Morrill,2005,2813,2726,87,3.1
31,125,Nance,2005,2025,1948,77,3.8
31,127,Nemaha,2005,3563,3404,159,4.5
31,129,Nuckolls,2005,2415,2336,79,3.3
31,131,Otoe,2005,8781,8435,346,3.9
31,133,Pawnee,2005,1632,1574,58,3.6
31,135,Perkins,2005,1587,1547,40,2.5
31,137,Phelps,2005,5229,5082,147,2.8
31,139,Pierce,2005,4265,4116,149,3.5
31,141,Platte,2005,17128,16500,628,3.7
31,143,Polk,2005,3049,2951,98,3.2
31,145,Red Willow,2005,6016,5809,207,3.4
31,147,Richardson,2005,4389,4192,197,4.5
31,149,Rock,2005,936,909,27,2.9
31,151,Saline,2005,8321,8044,277,3.3
31,153,Sarpy,2005,72957,70497,2460,3.4
31,155,Saunders,2005,11151,10716,435,3.9
31,157,Scotts Bluff,2005,19077,18284,793,4.2
31,159,Seward,2005,9249,8960,289,3.1
31,161,Sheridan,2005,3224,3137,87,2.7
31,163,Sherman,2005,1910,1838,72,3.8
31,165,Sioux,2005,772,750,22,2.8
31,167,Stanton,2005,3739,3624,115,3.1
31,169,Thayer,2005,2984,2894,90,3.0
31,171,Thomas,2005,413,399,14,3.4
31,173,Thurston,2005,3000,2768,232,7.7
31,175,Valley,2005,2510,2423,87,3.5
31,177,Washington,2005,11166,10798,368,3.3
31,179,Wayne,2005,5473,5309,164,3.0
31,181,Webster,2005,2010,1938,72,3.6
31,183,Wheeler,2005,472,459,13,2.8
31,185,York,2005,8436,8200,236,2.8
32,1,Churchill,2005,12468,11978,490,3.9
32,3,Clark,2005,872522,836675,35847,4.1
32,5,Douglas,2005,22081,21083,998,4.5
32,7,Elko,2005,23614,22772,842,3.6
32,9,Esmeralda,2005,460,438,22,4.8
32,11,Eureka,2005,674,652,22,3.3
32,13,Humboldt,2005,7821,7537,284,3.6
32,15,Lander,2005,2712,2613,99,3.7
32,17,Lincoln,2005,1569,1490,79,5.0
32,19,Lyon,2005,20435,19273,1162,5.7
32,21,Mineral,2005,2096,1976,120,5.7
32,23,Nye,2005,16377,15467,910,5.6
32,27,Pershing,2005,2430,2313,117,4.8
32,29,Storey,2005,2274,2176,98,4.3
32,31,Washoe,2005,209290,200942,8348,4.0
32,33,White Pine,2005,4322,4152,170,3.9
32,510,Carson City,2005,27307,26053,1254,4.6
33,1,Belknap,2005,31929,30840,1089,3.4
33,3,Carroll,2005,24961,24099,862,3.5
33,5,Cheshire,2005,41907,40546,1361,3.2
33,7,Coos,2005,16669,15972,697,4.2
33,9,Grafton,2005,46784,45430,1354,2.9
33,11,Hillsborough,2005,226270,217875,8395,3.7
33,13,Merrimack,2005,78148,75635,2513,3.2
33,15,Rockingham,2005,170959,163753,7206,4.2
33,17,Strafford,2005,66533,64239,2294,3.4
33,19,Sullivan,2005,21946,21285,661,3.0
34,1,Atlantic,2005,136168,128943,7225,5.3
34,3,Bergen,2005,465404,448149,17255,3.7
34,5,Burlington,2005,237705,228613,9092,3.8
34,7,Camden,2005,262461,249972,12489,4.8
34,9,Cape May,2005,57631,53860,3771,6.5
34,11,Cumberland,2005,69003,64624,4379,6.3
34,13,Essex,2005,360409,340299,20110,5.6
34,15,Gloucester,2005,147948,141518,6430,4.3
34,17,Hudson,2005,287171,271634,15537,5.4
34,19,Hunterdon,2005,71042,68837,2205,3.1
34,21,Mercer,2005,193540,186026,7514,3.9
34,23,Middlesex,2005,414326,396968,17358,4.2
34,25,Monmouth,2005,322851,309736,13115,4.1
34,27,Morris,2005,266789,258144,8645,3.2
34,29,Ocean,2005,248642,237140,11502,4.6
34,31,Passaic,2005,234588,221797,12791,5.5
34,33,Salem,2005,31202,29697,1505,4.8
34,35,Somerset,2005,174391,168477,5914,3.4
34,37,Sussex,2005,82904,79680,3224,3.9
34,39,Union,2005,264616,252068,12548,4.7
34,41,Warren,2005,58514,56216,2298,3.9
35,1,Bernalillo,2005,301683,287222,14461,4.8
35,3,Catron,2005,1423,1327,96,6.7
35,5,Chaves,2005,25773,24258,1515,5.9
35,6,Cibola,2005,12058,11373,685,5.7
35,7,Colfax,2005,6734,6373,361,5.4
35,9,Curry,2005,20450,19583,867,4.2
35,11,De Baca,2005,823,775,48,5.8
35,13,Dona Ana,2005,83973,79142,4831,5.8
35,15,Eddy,2005,24258,23116,1142,4.7
35,17,Grant,2005,11841,11121,720,6.1
35,19,Guadalupe,2005,1708,1579,129,7.6
35,21,Harding,2005,374,358,16,4.3
35,23,Hidalgo,2005,2418,2295,123,5.1
35,25,Lea,2005,25433,24365,1068,4.2
35,27,Lincoln,2005,10664,10179,485,4.5
35,28,Los Alamos,2005,11364,11051,313,2.8
35,29,Luna,2005,12420,10783,1637,13.2
35,31,McKinley,2005,26602,24798,1804,6.8
35,33,Mora,2005,2043,1809,234,11.5
35,35,Otero,2005,26459,25131,1328,5.0
35,37,Quay,2005,3900,3689,211,5.4
35,39,Rio Arriba,2005,20631,19367,1264,6.1
35,41,Roosevelt,2005,9333,8971,362,3.9
35,43,Sandoval,2005,49509,46869,2640,5.3
35,45,San Juan,2005,53743,50820,2923,5.4
35,47,San Miguel,2005,13202,12371,831,6.3
35,49,Santa Fe,2005,75674,72504,3170,4.2
35,51,Sierra,2005,5379,5085,294,5.5
35,53,Socorro,2005,9234,8815,419,4.5
35,55,Taos,2005,17198,16029,1169,6.8
35,57,Torrance,2005,7506,7085,421,5.6
35,59,Union,2005,1900,1830,70,3.7
35,61,Valencia,2005,30296,28650,1646,5.4
36,1,Albany,2005,159158,152920,6238,3.9
36,3,Allegany,2005,23520,22147,1373,5.8
36,5,Bronx,2005,506727,469271,37456,7.4
36,7,Broome,2005,96232,91515,4717,4.9
36,9,Cattaraugus,2005,42100,39827,2273,5.4
36,11,Cayuga,2005,41843,39804,2039,4.9
36,13,Chautauqua,2005,67109,63878,3231,4.8
36,15,Chemung,2005,40572,38409,2163,5.3
36,17,Chenango,2005,24277,23074,1203,5.0
36,19,Clinton,2005,39995,37885,2110,5.3
36,21,Columbia,2005,31983,30746,1237,3.9
36,23,Cortland,2005,23924,22625,1299,5.4
36,25,Delaware,2005,23512,22474,1038,4.4
36,27,Dutchess,2005,146915,141149,5766,3.9
36,29,Erie,2005,471986,447446,24540,5.2
36,31,Essex,2005,18729,17724,1005,5.4
36,33,Franklin,2005,22538,21214,1324,5.9
36,35,Fulton,2005,26955,25451,1504,5.6
36,37,Genesee,2005,33085,31489,1596,4.8
36,39,Greene,2005,23740,22590,1150,4.8
36,41,Hamilton,2005,3166,2993,173,5.5
36,43,Herkimer,2005,31654,29982,1672,5.3
36,45,Jefferson,2005,47080,44184,2896,6.2
36,47,Kings,2005,1069846,1004675,65171,6.1
36,49,Lewis,2005,12723,11962,761,6.0
36,51,Livingston,2005,32854,31218,1636,5.0
36,53,Madison,2005,36089,34227,1862,5.2
36,55,Monroe,2005,376131,359008,17123,4.6
36,57,Montgomery,2005,24673,23354,1319,5.3
36,59,Nassau,2005,689225,661345,27880,4.0
36,61,New York,2005,902418,857939,44479,4.9
36,63,Niagara,2005,111654,105435,6219,5.6
36,65,Oneida,2005,111166,105858,5308,4.8
36,67,Onondaga,2005,233547,223026,10521,4.5
36,69,Ontario,2005,56792,54232,2560,4.5
36,71,Orange,2005,177486,169965,7521,4.2
36,73,Orleans,2005,19949,18824,1125,5.6
36,75,Oswego,2005,60210,56465,3745,6.2
36,77,Otsego,2005,31923,30483,1440,4.5
36,79,Putnam,2005,56031,53941,2090,3.7
36,81,Queens,2005,1089621,1033838,55783,5.1
36,83,Rensselaer,2005,83762,80248,3514,4.2
36,85,Richmond,2005,231368,219483,11885,5.1
36,87,Rockland,2005,151127,145097,6030,4.0
36,89,St. Lawrence,2005,49138,46153,2985,6.1
36,91,Saratoga,2005,119905,115513,4392,3.7
36,93,Schenectady,2005,75359,72205,3154,4.2
36,95,Schoharie,2005,15847,15044,803,5.1
36,97,Schuyler,2005,9876,9335,541,5.5
36,99,Seneca,2005,17327,16519,808,4.7
36,101,Steuben,2005,44571,42040,2531,5.7
36,103,Suffolk,2005,777197,744496,32701,4.2
36,105,Sullivan,2005,35137,33428,1709,4.9
36,107,Tioga,2005,26295,25050,1245,4.7
36,109,Tompkins,2005,54567,52614,1953,3.6
36,111,Ulster,2005,91759,87759,4000,4.4
36,113,Warren,2005,35450,33825,1625,4.6
36,115,Washington,2005,32123,30683,1440,4.5
36,117,Wayne,2005,48959,46552,2407,4.9
36,119,Westchester,2005,482182,462826,19356,4.0
36,121,Wyoming,2005,21419,20291,1128,5.3
36,123,Yates,2005,12988,12427,561,4.3
37,1,Alamance,2005,69250,64805,4445,6.4
37,3,Alexander,2005,18368,17305,1063,5.8
37,5,Alleghany,2005,4910,4619,291,5.9
37,7,Anson,2005,10656,9811,845,7.9
37,9,Ashe,2005,12857,12069,788,6.1
37,11,Avery,2005,8020,7561,459,5.7
37,13,Beaufort,2005,20362,18969,1393,6.8
37,15,Bertie,2005,8844,8173,671,7.6
37,17,Bladen,2005,15576,14352,1224,7.9
37,19,Brunswick,2005,43130,40826,2304,5.3
37,21,Buncombe,2005,115887,110493,5394,4.7
37,23,Burke,2005,41767,38946,2821,6.8
37,25,Cabarrus,2005,77678,73848,3830,4.9
37,27,Caldwell,2005,40060,36579,3481,8.7
37,29,Camden,2005,4401,4210,191,4.3
37,31,Carteret,2005,32469,30862,1607,4.9
37,33,Caswell,2005,10679,9795,884,8.3
37,35,Catawba,2005,77477,72357,5120,6.6
37,37,Chatham,2005,30955,29622,1333,4.3
37,39,Cherokee,2005,10503,9830,673,6.4
37,41,Chowan,2005,7024,6656,368,5.2
37,43,Clay,2005,4532,4328,204,4.5
37,45,Cleveland,2005,47833,44281,3552,7.4
37,47,Columbus,2005,23883,22255,1628,6.8
37,49,Craven,2005,41075,39014,2061,5.0
37,51,Cumberland,2005,128097,120696,7401,5.8
37,53,Currituck,2005,12133,11738,395,3.3
37,55,Dare,2005,22670,21536,1134,5.0
37,57,Davidson,2005,78921,73872,5049,6.4
37,59,Davie,2005,19956,19053,903,4.5
37,61,Duplin,2005,23845,22309,1536,6.4
37,63,Durham,2005,130799,124730,6069,4.6
37,65,Edgecombe,2005,24456,22260,2196,9.0
37,67,Forsyth,2005,169250,160752,8498,5.0
37,69,Franklin,2005,26166,24836,1330,5.1
37,71,Gaston,2005,96839,90541,6298,6.5
37,73,Gates,2005,4950,4733,217,4.4
37,75,Graham,2005,4073,3772,301,7.4
37,77,Granville,2005,23939,22396,1543,6.4
37,79,Greene,2005,9004,8413,591,6.6
37,81,Guilford,2005,242328,229183,13145,5.4
37,83,Halifax,2005,23870,22044,1826,7.6
37,85,Harnett,2005,45642,43061,2581,5.7
37,87,Haywood,2005,27307,26000,1307,4.8
37,89,Henderson,2005,46566,44478,2088,4.5
37,91,Hertford,2005,9884,9264,620,6.3
37,93,Hoke,2005,18544,17400,1144,6.2
37,95,Hyde,2005,2929,2744,185,6.3
37,97,Iredell,2005,72906,68985,3921,5.4
37,99,Jackson,2005,20641,19743,898,4.4
37,101,Johnston,2005,71349,67950,3399,4.8
37,103,Jones,2005,4970,4711,259,5.2
37,105,Lee,2005,26162,24610,1552,5.9
37,107,Lenoir,2005,27908,26181,1727,6.2
37,109,Lincoln,2005,36486,34301,2185,6.0
37,111,McDowell,2005,21314,19702,1612,7.6
37,113,Macon,2005,15729,14939,790,5.0
37,115,Madison,2005,9836,9296,540,5.5
37,117,Martin,2005,12103,11349,754,6.2
37,119,Mecklenburg,2005,429543,406762,22781,5.3
37,121,Mitchell,2005,7836,7222,614,7.8
37,123,Montgomery,2005,12449,11544,905,7.3
37,125,Moore,2005,36003,34043,1960,5.4
37,127,Nash,2005,44532,41671,2861,6.4
37,129,New Hanover,2005,98520,94185,4335,4.4
37,131,Northampton,2005,9017,8373,644,7.1
37,133,Onslow,2005,56406,53193,3213,5.7
37,135,Orange,2005,65463,62838,2625,4.0
37,137,Pamlico,2005,5728,5452,276,4.8
37,139,Pasquotank,2005,17359,16475,884,5.1
37,141,Pender,2005,22066,20935,1131,5.1
37,143,Perquimans,2005,5178,4913,265,5.1
37,145,Person,2005,18886,17598,1288,6.8
37,147,Pitt,2005,74052,69474,4578,6.2
37,149,Polk,2005,9163,8754,409,4.5
37,151,Randolph,2005,75205,71376,3829,5.1
37,153,Richmond,2005,20308,18644,1664,8.2
37,155,Robeson,2005,52780,48951,3829,7.3
37,157,Rockingham,2005,46064,42822,3242,7.0
37,159,Rowan,2005,68302,64372,3930,5.8
37,161,Rutherford,2005,29761,27022,2739,9.2
37,163,Sampson,2005,31421,29784,1637,5.2
37,165,Scotland,2005,15234,13660,1574,10.3
37,167,Stanly,2005,29692,27984,1708,5.8
37,169,Stokes,2005,24114,22826,1288,5.3
37,171,Surry,2005,35187,32984,2203,6.3
37,173,Swain,2005,6926,6417,509,7.3
37,175,Transylvania,2005,12450,11746,704,5.7
37,177,Tyrrell,2005,2204,2032,172,7.8
37,179,Union,2005,82852,78898,3954,4.8
37,181,Vance,2005,19159,17410,1749,9.1
37,183,Wake,2005,406455,388671,17784,4.4
37,185,Warren,2005,8084,7475,609,7.5
37,187,Washington,2005,6160,5724,436,7.1
37,189,Watauga,2005,23318,22329,989,4.2
37,191,Wayne,2005,51507,48627,2880,5.6
37,193,Wilkes,2005,33101,31098,2003,6.1
37,195,Wilson,2005,39356,36017,3339,8.5
37,197,Yadkin,2005,19293,18342,951,4.9
37,199,Yancey,2005,7938,7331,607,7.6
38,1,Adams,2005,1315,1273,42,3.2
38,3,Barnes,2005,6060,5856,204,3.4
38,5,Benson,2005,2799,2646,153,5.5
38,7,Billings,2005,506,492,14,2.8
38,9,Bottineau,2005,3520,3380,140,4.0
38,11,Bowman,2005,1736,1696,40,2.3
38,13,Burke,2005,1026,999,27,2.6
38,15,Burleigh,2005,44396,43168,1228,2.8
38,17,Cass,2005,82438,80276,2162,2.6
38,19,Cavalier,2005,2150,2073,77,3.6
38,21,Dickey,2005,2970,2890,80,2.7
38,23,Divide,2005,982,951,31,3.2
38,25,Dunn,2005,1734,1677,57,3.3
38,27,Eddy,2005,1344,1271,73,5.4
38,29,Emmons,2005,1858,1763,95,5.1
38,31,Foster,2005,1780,1727,53,3.0
38,33,Golden Valley,2005,914,885,29,3.2
38,35,Grand Forks,2005,38180,36997,1183,3.1
38,37,Grant,2005,1257,1208,49,3.9
38,39,Griggs,2005,1388,1349,39,2.8
38,41,Hettinger,2005,1193,1150,43,3.6
38,43,Kidder,2005,1224,1165,59,4.8
38,45,LaMoure,2005,2266,2193,73,3.2
38,47,Logan,2005,936,902,34,3.6
38,49,McHenry,2005,2788,2635,153,5.5
38,51,McIntosh,2005,1465,1424,41,2.8
38,53,McKenzie,2005,2698,2601,97,3.6
38,55,McLean,2005,4625,4403,222,4.8
38,57,Mercer,2005,4586,4384,202,4.4
38,59,Morton,2005,14561,14054,507,3.5
38,61,Mountrail,2005,2996,2823,173,5.8
38,63,Nelson,2005,1699,1630,69,4.1
38,65,Oliver,2005,1099,1048,51,4.6
38,67,Pembina,2005,4163,3898,265,6.4
38,69,Pierce,2005,1955,1867,88,4.5
38,71,Ramsey,2005,6026,5800,226,3.8
38,73,Ransom,2005,3101,3006,95,3.1
38,75,Renville,2005,1303,1264,39,3.0
38,77,Richland,2005,9068,8769,299,3.3
38,79,Rolette,2005,5215,4740,475,9.1
38,81,Sargent,2005,2438,2374,64,2.6
38,83,Sheridan,2005,747,705,42,5.6
38,85,Sioux,2005,1339,1250,89,6.6
38,87,Slope,2005,528,516,12,2.3
38,89,Stark,2005,13459,13074,385,2.9
38,91,Steele,2005,1154,1124,30,2.6
38,93,Stutsman,2005,11701,11339,362,3.1
38,95,Towner,2005,1270,1209,61,4.8
38,97,Traill,2005,4245,4089,156,3.7
38,99,Walsh,2005,5907,5631,276,4.7
38,101,Ward,2005,28337,27376,961,3.4
38,103,Wells,2005,2203,2101,102,4.6
38,105,Williams,2005,11737,11475,262,2.2
39,1,Adams,2005,13092,11976,1116,8.5
39,3,Allen,2005,52542,49254,3288,6.3
39,5,Ashland,2005,27053,25302,1751,6.5
39,7,Ashtabula,2005,50439,46719,3720,7.4
39,9,Athens,2005,29938,27960,1978,6.6
39,11,Auglaize,2005,26155,24946,1209,4.6
39,13,Belmont,2005,32394,30245,2149,6.6
39,15,Brown,2005,21979,20437,1542,7.0
39,17,Butler,2005,185919,175809,10110,5.4
39,19,Carroll,2005,14107,13135,972,6.9
39,21,Champaign,2005,20783,19574,1209,5.8
39,23,Clark,2005,70310,65749,4561,6.5
39,25,Clermont,2005,104250,98479,5771,5.5
39,27,Clinton,2005,22617,21347,1270,5.6
39,29,Columbiana,2005,53471,49583,3888,7.3
39,31,Coshocton,2005,18054,16529,1525,8.4
39,33,Crawford,2005,22776,21225,1551,6.8
39,35,Cuyahoga,2005,658262,622848,35414,5.4
39,37,Darke,2005,28257,26566,1691,6.0
39,39,Defiance,2005,20515,19235,1280,6.2
39,41,Delaware,2005,83250,79568,3682,4.4
39,43,Erie,2005,42711,39931,2780,6.5
39,45,Fairfield,2005,72942,68917,4025,5.5
39,47,Fayette,2005,15889,14949,940,5.9
39,49,Franklin,2005,599419,567214,32205,5.4
39,51,Fulton,2005,23080,21631,1449,6.3
39,53,Gallia,2005,14069,13027,1042,7.4
39,55,Geauga,2005,50639,48447,2192,4.3
39,57,Greene,2005,77133,72705,4428,5.7
39,59,Guernsey,2005,19974,18497,1477,7.4
39,61,Hamilton,2005,418640,394963,23677,5.7
39,63,Hancock,2005,40114,38075,2039,5.1
39,65,Hardin,2005,16198,15216,982,6.1
39,67,Harrison,2005,7508,7007,501,6.7
39,69,Henry,2005,15843,14837,1006,6.3
39,71,Highland,2005,20908,19640,1268,6.1
39,73,Hocking,2005,13807,12741,1066,7.7
39,75,Holmes,2005,19806,18994,812,4.1
39,77,Huron,2005,30178,27802,2376,7.9
39,79,Jackson,2005,15815,14619,1196,7.6
39,81,Jefferson,2005,31649,29202,2447,7.7
39,83,Knox,2005,30171,28428,1743,5.8
39,85,Lake,2005,130362,124355,6007,4.6
39,87,Lawrence,2005,28596,26816,1780,6.2
39,89,Licking,2005,81453,76611,4842,5.9
39,91,Logan,2005,24594,23279,1315,5.3
39,93,Lorain,2005,152610,144640,7970,5.2
39,95,Lucas,2005,223998,208347,15651,7.0
39,97,Madison,2005,19767,18587,1180,6.0
39,99,Mahoning,2005,119574,111088,8486,7.1
39,101,Marion,2005,32094,30062,2032,6.3
39,103,Medina,2005,92208,88166,4042,4.4
39,105,Meigs,2005,9041,8126,915,10.1
39,107,Mercer,2005,23731,22752,979,4.1
39,109,Miami,2005,54684,51522,3162,5.8
39,111,Monroe,2005,5467,4725,742,13.6
39,113,Montgomery,2005,271386,253722,17664,6.5
39,115,Morgan,2005,6194,5562,632,10.2
39,117,Morrow,2005,17684,16543,1141,6.5
39,119,Muskingum,2005,40092,36662,3430,8.6
39,121,Noble,2005,5888,5394,494,8.4
39,123,Ottawa,2005,21790,20072,1718,7.9
39,125,Paulding,2005,10717,10131,586,5.5
39,127,Perry,2005,16601,15203,1398,8.4
39,129,Pickaway,2005,23981,22262,1719,7.2
39,131,Pike,2005,10709,9601,1108,10.3
39,133,Portage,2005,89192,84045,5147,5.8
39,135,Preble,2005,21708,20403,1305,6.0
39,137,Putnam,2005,17689,16733,956,5.4
39,139,Richland,2005,62567,58343,4224,6.8
39,141,Ross,2005,34664,32075,2589,7.5
39,143,Sandusky,2005,33260,31141,2119,6.4
39,145,Scioto,2005,32106,29259,2847,8.9
39,147,Seneca,2005,31293,29346,1947,6.2
39,149,Shelby,2005,27494,26162,1332,4.8
39,151,Stark,2005,189781,177284,12497,6.6
39,153,Summit,2005,290152,272895,17257,5.9
39,155,Trumbull,2005,105318,97971,7347,7.0
39,157,Tuscarawas,2005,47220,44458,2762,5.8
39,159,Union,2005,24406,23156,1250,5.1
39,161,Van Wert,2005,15058,14260,798,5.3
39,163,Vinton,2005,5618,5144,474,8.4
39,165,Warren,2005,103650,98552,5098,4.9
39,167,Washington,2005,32513,30518,1995,6.1
39,169,Wayne,2005,60929,57829,3100,5.1
39,171,Williams,2005,19536,18309,1227,6.3
39,173,Wood,2005,67679,63775,3904,5.8
39,175,Wyandot,2005,12993,12218,775,6.0
40,1,Adair,2005,9976,9510,466,4.7
40,3,Alfalfa,2005,2332,2233,99,4.2
40,5,Atoka,2005,5571,5286,285,5.1
40,7,Beaver,2005,2901,2809,92,3.2
40,9,Beckham,2005,9692,9400,292,3.0
40,11,Blaine,2005,4841,4612,229,4.7
40,13,Bryan,2005,19434,18713,721,3.7
40,15,Caddo,2005,12115,11453,662,5.5
40,17,Canadian,2005,51371,49545,1826,3.6
40,19,Carter,2005,23632,22623,1009,4.3
40,21,Cherokee,2005,20830,19936,894,4.3
40,23,Choctaw,2005,6487,6131,356,5.5
40,25,Cimarron,2005,1325,1280,45,3.4
40,27,Cleveland,2005,118744,114347,4397,3.7
40,29,Coal,2005,2224,2072,152,6.8
40,31,Comanche,2005,45434,43442,1992,4.4
40,33,Cotton,2005,3313,3193,120,3.6
40,35,Craig,2005,6662,6371,291,4.4
40,37,Creek,2005,32163,30395,1768,5.5
40,39,Custer,2005,13515,13093,422,3.1
40,41,Delaware,2005,17258,16470,788,4.6
40,43,Dewey,2005,2376,2298,78,3.3
40,45,Ellis,2005,2139,2077,62,2.9
40,47,Garfield,2005,28413,27424,989,3.5
40,49,Garvin,2005,13222,12698,524,4.0
40,51,Grady,2005,23530,22493,1037,4.4
40,53,Grant,2005,2431,2344,87,3.6
40,55,Greer,2005,2088,1973,115,5.5
40,57,Harmon,2005,1364,1313,51,3.7
40,59,Harper,2005,1823,1770,53,2.9
40,61,Haskell,2005,5273,5040,233,4.4
40,63,Hughes,2005,5146,4785,361,7.0
40,65,Jackson,2005,12270,11806,464,3.8
40,67,Jefferson,2005,2253,2139,114,5.1
40,69,Johnston,2005,4868,4647,221,4.5
40,71,Kay,2005,20991,19840,1151,5.5
40,73,Kingfisher,2005,7672,7431,241,3.1
40,75,Kiowa,2005,4067,3884,183,4.5
40,77,Latimer,2005,4035,3814,221,5.5
40,79,Le Flore,2005,21392,20330,1062,5.0
40,81,Lincoln,2005,14825,14132,693,4.7
40,83,Logan,2005,18217,17524,693,3.8
40,85,Love,2005,4768,4570,198,4.2
40,87,McClain,2005,14789,14188,601,4.1
40,89,McCurtain,2005,13995,13094,901,6.4
40,91,McIntosh,2005,8424,7946,478,5.7
40,93,Major,2005,3673,3556,117,3.2
40,95,Marshall,2005,6132,5842,290,4.7
40,97,Mayes,2005,16631,15832,799,4.8
40,99,Murray,2005,7025,6766,259,3.7
40,101,Muskogee,2005,29312,27616,1696,5.8
40,103,Noble,2005,5420,5216,204,3.8
40,105,Nowata,2005,4876,4630,246,5.0
40,107,Okfuskee,2005,4495,4183,312,6.9
40,109,Oklahoma,2005,334435,319359,15076,4.5
40,111,Okmulgee,2005,16864,15827,1037,6.1
40,113,Osage,2005,20842,19870,972,4.7
40,115,Ottawa,2005,16037,15251,786,4.9
40,117,Pawnee,2005,7824,7446,378,4.8
40,119,Payne,2005,35170,33820,1350,3.8
40,121,Pittsburg,2005,20262,19295,967,4.8
40,123,Pontotoc,2005,18729,17939,790,4.2
40,125,Pottawatomie,2005,30946,29353,1593,5.1
40,127,Pushmataha,2005,5318,5058,260,4.9
40,129,Roger Mills,2005,1837,1787,50,2.7
40,131,Rogers,2005,39996,38442,1554,3.9
40,133,Seminole,2005,10095,9411,684,6.8
40,135,Sequoyah,2005,18107,17147,960,5.3
40,137,Stephens,2005,20089,19306,783,3.9
40,139,Texas,2005,9388,9055,333,3.5
40,141,Tillman,2005,3493,3329,164,4.7
40,143,Tulsa,2005,294584,282768,11816,4.0
40,145,Wagoner,2005,32115,30841,1274,4.0
40,147,Washington,2005,24965,23963,1002,4.0
40,149,Washita,2005,5807,5617,190,3.3
40,151,Woods,2005,4408,4113,295,6.7
40,153,Woodward,2005,10232,9898,334,3.3
41,1,Baker,2005,7124,6596,528,7.4
41,3,Benton,2005,41993,39936,2057,4.9
41,5,Clackamas,2005,190499,180005,10494,5.5
41,7,Clatsop,2005,19156,18053,1103,5.8
41,9,Columbia,2005,23249,21541,1708,7.3
41,11,Coos,2005,28579,26419,2160,7.6
41,13,Crook,2005,9321,8670,651,7.0
41,15,Curry,2005,9599,8932,667,6.9
41,17,Deschutes,2005,74657,70365,4292,5.7
41,19,Douglas,2005,46874,43019,3855,8.2
41,21,Gilliam,2005,992,935,57,5.7
41,23,Grant,2005,3631,3278,353,9.7
41,25,Harney,2005,3403,3105,298,8.8
41,27,Hood River,2005,12274,11497,777,6.3
41,29,Jackson,2005,98895,92767,6128,6.2
41,31,Jefferson,2005,9077,8534,543,6.0
41,33,Josephine,2005,34358,31864,2494,7.3
41,35,Klamath,2005,30096,27792,2304,7.7
41,37,Lake,2005,3554,3252,302,8.5
41,39,Lane,2005,173895,163206,10689,6.1
41,41,Lincoln,2005,21968,20444,1524,6.9
41,43,Linn,2005,52034,48126,3908,7.5
41,45,Malheur,2005,12591,11496,1095,8.7
41,47,Marion,2005,148077,138461,9616,6.5
41,49,Morrow,2005,5463,5049,414,7.6
41,51,Multnomah,2005,360967,339048,21919,6.1
41,53,Polk,2005,35616,33612,2004,5.6
41,55,Sherman,2005,884,824,60,6.8
41,57,Tillamook,2005,12282,11523,759,6.2
41,59,Umatilla,2005,36266,33402,2864,7.9
41,61,Union,2005,11757,10954,803,6.8
41,63,Wallowa,2005,3533,3269,264,7.5
41,65,Wasco,2005,12678,11783,895,7.1
41,67,Washington,2005,268780,254903,13877,5.2
41,69,Wheeler,2005,665,623,42,6.3
41,71,Yamhill,2005,44114,41431,2683,6.1
42,1,Adams,2005,54536,52546,1990,3.6
42,3,Allegheny,2005,628578,597220,31358,5.0
42,5,Armstrong,2005,32930,30923,2007,6.1
42,7,Beaver,2005,89412,84400,5012,5.6
42,9,Bedford,2005,23400,21725,1675,7.2
42,11,Berks,2005,198879,189121,9758,4.9
42,13,Blair,2005,64841,61470,3371,5.2
42,15,Bradford,2005,32205,30584,1621,5.0
42,17,Bucks,2005,341553,327346,14207,4.2
42,19,Butler,2005,94927,90334,4593,4.8
42,21,Cambria,2005,67182,63042,4140,6.2
42,23,Cameron,2005,2619,2435,184,7.0
42,25,Carbon,2005,30251,28436,1815,6.0
42,27,Centre,2005,72444,69530,2914,4.0
42,29,Chester,2005,256501,247099,9402,3.7
42,31,Clarion,2005,20844,19816,1028,4.9
42,33,Clearfield,2005,40770,38380,2390,5.9
42,35,Clinton,2005,18985,17824,1161,6.1
42,37,Columbia,2005,34065,32063,2002,5.9
42,39,Crawford,2005,42892,40416,2476,5.8
42,41,Cumberland,2005,119902,115396,4506,3.8
42,43,Dauphin,2005,134054,128305,5749,4.3
42,45,Delaware,2005,279480,266596,12884,4.6
42,47,Elk,2005,17598,16720,878,5.0
42,49,Erie,2005,140726,133117,7609,5.4
42,51,Fayette,2005,65286,60716,4570,7.0
42,53,Forest,2005,2279,2074,205,9.0
42,55,Franklin,2005,76995,74337,2658,3.5
42,57,Fulton,2005,8202,7850,352,4.3
42,59,Greene,2005,17263,16177,1086,6.3
42,61,Huntingdon,2005,22139,20799,1340,6.1
42,63,Indiana,2005,45241,42786,2455,5.4
42,65,Jefferson,2005,22596,21371,1225,5.4
42,67,Juniata,2005,13190,12629,561,4.3
42,69,Lackawanna,2005,105413,99831,5582,5.3
42,71,Lancaster,2005,267780,257946,9834,3.7
42,73,Lawrence,2005,43968,41358,2610,5.9
42,75,Lebanon,2005,70170,67636,2534,3.6
42,77,Lehigh,2005,170903,162454,8449,4.9
42,79,Luzerne,2005,157573,148415,9158,5.8
42,81,Lycoming,2005,59348,56113,3235,5.5
42,83,McKean,2005,21791,20597,1194,5.5
42,85,Mercer,2005,55714,52210,3504,6.3
42,87,Mifflin,2005,23076,21726,1350,5.9
42,89,Monroe,2005,78067,73719,4348,5.6
42,91,Montgomery,2005,422901,406399,16502,3.9
42,93,Montour,2005,8971,8572,399,4.4
42,95,Northampton,2005,147883,140474,7409,5.0
42,97,Northumberland,2005,47196,44569,2627,5.6
42,99,Perry,2005,24123,23098,1025,4.2
42,101,Philadelphia/city,2005,617714,576068,41646,6.7
42,103,Pike,2005,25861,24335,1526,5.9
42,105,Potter,2005,8640,8088,552,6.4
42,107,Schuylkill,2005,70641,66474,4167,5.9
42,109,Snyder,2005,20294,19406,888,4.4
42,111,Somerset,2005,39495,37129,2366,6.0
42,113,Sullivan,2005,3117,2932,185,5.9
42,115,Susquehanna,2005,21576,20500,1076,5.0
42,117,Tioga,2005,20997,19766,1231,5.9
42,119,Union,2005,17941,16976,965,5.4
42,121,Venango,2005,26663,25208,1455,5.5
42,123,Warren,2005,21180,20116,1064,5.0
42,125,Washington,2005,102362,96720,5642,5.5
42,127,Wayne,2005,24818,23616,1202,4.8
42,129,Westmoreland,2005,184337,174520,9817,5.3
42,131,Wyoming,2005,14277,13535,742,5.2
42,133,York,2005,219091,209801,9290,4.2
44,1,Bristol,2005,28137,26906,1231,4.4
44,3,Kent,2005,96078,91382,4696,4.9
44,5,Newport,2005,44444,42367,2077,4.7
44,7,Providence,2005,321997,304150,17847,5.5
44,9,Washington,2005,72786,69732,3054,4.2
45,1,Abbeville,2005,12092,11081,1011,8.4
45,3,Aiken,2005,74295,69559,4736,6.4
45,5,Allendale,2005,3305,2926,379,11.5
45,7,Anderson,2005,84093,77374,6719,8.0
45,9,Bamberg,2005,6581,5967,614,9.3
45,11,Barnwell,2005,9417,8497,920,9.8
45,13,Beaufort,2005,61538,58283,3255,5.3
45,15,Berkeley,2005,71621,67485,4136,5.8
45,17,Calhoun,2005,7103,6540,563,7.9
45,19,Charleston,2005,167312,157443,9869,5.9
45,21,Cherokee,2005,24957,22825,2132,8.5
45,23,Chester,2005,15950,14365,1585,9.9
45,25,Chesterfield,2005,18149,16298,1851,10.2
45,27,Clarendon,2005,12791,11450,1341,10.5
45,29,Colleton,2005,16423,15149,1274,7.8
45,31,Darlington,2005,30679,27792,2887,9.4
45,33,Dillon,2005,13594,12206,1388,10.2
45,35,Dorchester,2005,56728,53472,3256,5.7
45,37,Edgefield,2005,11186,10315,871,7.8
45,39,Fairfield,2005,11342,10381,961,8.5
45,41,Florence,2005,62003,56029,5974,9.6
45,43,Georgetown,2005,28843,26151,2692,9.3
45,45,Greenville,2005,209852,197311,12541,6.0
45,47,Greenwood,2005,32636,29438,3198,9.8
45,49,Hampton,2005,7792,7091,701,9.0
45,51,Horry,2005,121398,113804,7594,6.3
45,53,Jasper,2005,10104,9538,566,5.6
45,55,Kershaw,2005,29025,26963,2062,7.1
45,57,Lancaster,2005,29807,27106,2701,9.1
45,59,Laurens,2005,33239,30828,2411,7.3
45,61,Lee,2005,8333,7480,853,10.2
45,63,Lexington,2005,127543,120771,6772,5.3
45,65,McCormick,2005,3569,3139,430,12.0
45,67,Marion,2005,13887,11845,2042,14.7
45,69,Marlboro,2005,12616,11068,1548,12.3
45,71,Newberry,2005,17695,16357,1338,7.6
45,73,Oconee,2005,31871,28889,2982,9.4
45,75,Orangeburg,2005,40712,36476,4236,10.4
45,77,Pickens,2005,57299,53243,4056,7.1
45,79,Richland,2005,171133,160083,11050,6.5
45,81,Saluda,2005,9281,8612,669,7.2
45,83,Spartanburg,2005,131944,121258,10686,8.1
45,85,Sumter,2005,46576,42292,4284,9.2
45,87,Union,2005,12735,11246,1489,11.7
45,89,Williamsburg,2005,15663,13774,1889,12.1
45,91,York,2005,96404,89446,6958,7.2
46,3,Aurora,2005,1371,1319,52,3.8
46,5,Beadle,2005,8860,8498,362,4.1
46,7,Bennett,2005,1429,1347,82,5.7
46,9,Bon Homme,2005,3344,3222,122,3.6
46,11,Brookings,2005,18247,17717,530,2.9
46,13,Brown,2005,20793,20156,637,3.1
46,15,Brule,2005,2855,2766,89,3.1
46,17,Buffalo,2005,567,485,82,14.5
46,19,Butte,2005,5137,4966,171,3.3
46,21,Campbell,2005,889,857,32,3.6
46,23,Charles Mix,2005,4159,3987,172,4.1
46,25,Clark,2005,1862,1777,85,4.6
46,27,Clay,2005,7319,7084,235,3.2
46,29,Codington,2005,15845,15304,541,3.4
46,31,Corson,2005,1423,1327,96,6.7
46,33,Custer,2005,4786,4613,173,3.6
46,35,Davison,2005,11009,10674,335,3.0
46,37,Day,2005,3002,2832,170,5.7
46,39,Deuel,2005,2656,2550,106,4.0
46,41,Dewey,2005,2646,2403,243,9.2
46,43,Douglas,2005,1780,1725,55,3.1
46,45,Edmunds,2005,2090,2026,64,3.1
46,47,Fall River,2005,3866,3719,147,3.8
46,49,Faulk,2005,1172,1131,41,3.5
46,51,Grant,2005,4119,3945,174,4.2
46,53,Gregory,2005,2480,2391,89,3.6
46,55,Haakon,2005,1192,1155,37,3.1
46,57,Hamlin,2005,2922,2812,110,3.8
46,59,Hand,2005,1912,1855,57,3.0
46,61,Hanson,2005,2015,1950,65,3.2
46,63,Harding,2005,808,782,26,3.2
46,65,Hughes,2005,10144,9851,293,2.9
46,67,Hutchinson,2005,3813,3670,143,3.8
46,69,Hyde,2005,774,743,31,4.0
46,71,Jackson,2005,1286,1209,77,6.0
46,73,Jerauld,2005,1319,1276,43,3.3
46,75,Jones,2005,729,709,20,2.7
46,77,Kingsbury,2005,3085,2972,113,3.7
46,79,Lake,2005,6670,6435,235,3.5
46,81,Lawrence,2005,12830,12403,427,3.3
46,83,Lincoln,2005,19258,18727,531,2.8
46,85,Lyman,2005,2002,1903,99,4.9
46,87,McCook,2005,2954,2859,95,3.2
46,89,McPherson,2005,1220,1171,49,4.0
46,91,Marshall,2005,2113,2018,95,4.5
46,93,Meade,2005,12701,12255,446,3.5
46,95,Mellette,2005,904,855,49,5.4
46,97,Miner,2005,1208,1153,55,4.6
46,99,Minnehaha,2005,93536,90518,3018,3.2
46,101,Moody,2005,3890,3712,178,4.6
46,102,Oglala Lakota,2005,3930,3529,401,10.2
46,103,Pennington,2005,52441,50672,1769,3.4
46,105,Perkins,2005,1731,1665,66,3.8
46,107,Potter,2005,1363,1315,48,3.5
46,109,Roberts,2005,4788,4560,228,4.8
46,111,Sanborn,2005,1591,1539,52,3.3
46,115,Spink,2005,3484,3355,129,3.7
46,117,Stanley,2005,1933,1885,48,2.5
46,119,Sully,2005,1016,988,28,2.8
46,121,Todd,2005,3461,3269,192,5.5
46,123,Tripp,2005,3096,2992,104,3.4
46,125,Turner,2005,4502,4344,158,3.5
46,127,Union,2005,7523,7239,284,3.8
46,129,Walworth,2005,2707,2579,128,4.7
46,135,Yankton,2005,11909,11515,394,3.3
46,137,Ziebach,2005,903,835,68,7.5
47,1,Anderson,2005,34414,32651,1763,5.1
47,3,Bedford,2005,21371,20218,1153,5.4
47,5,Benton,2005,6716,6164,552,8.2
47,7,Bledsoe,2005,4594,4235,359,7.8
47,9,Blount,2005,58884,56136,2748,4.7
47,11,Bradley,2005,46142,43731,2411,5.2
47,13,Campbell,2005,16636,15651,985,5.9
47,15,Cannon,2005,6365,6031,334,5.2
47,17,Carroll,2005,13517,12495,1022,7.6
47,19,Carter,2005,28676,27035,1641,5.7
47,21,Cheatham,2005,20186,19307,879,4.4
47,23,Chester,2005,7516,7069,447,5.9
47,25,Claiborne,2005,12885,12167,718,5.6
47,27,Clay,2005,3543,3134,409,11.5
47,29,Cocke,2005,15711,14505,1206,7.7
47,31,Coffee,2005,25157,23771,1386,5.5
47,33,Crockett,2005,6375,5879,496,7.8
47,35,Cumberland,2005,22177,20709,1468,6.6
47,37,Davidson,2005,301279,287714,13565,4.5
47,39,Decatur,2005,5383,4965,418,7.8
47,41,DeKalb,2005,9678,9118,560,5.8
47,43,Dickson,2005,22621,21503,1118,4.9
47,45,Dyer,2005,17189,16141,1048,6.1
47,47,Fayette,2005,15919,14846,1073,6.7
47,49,Fentress,2005,7012,6519,493,7.0
47,51,Franklin,2005,19785,18694,1091,5.5
47,53,Gibson,2005,20592,18851,1741,8.5
47,55,Giles,2005,13244,12279,965,7.3
47,57,Grainger,2005,10020,9425,595,5.9
47,59,Greene,2005,31893,29180,2713,8.5
47,61,Grundy,2005,5744,5313,431,7.5
47,63,Hamblen,2005,29339,27635,1704,5.8
47,65,Hamilton,2005,156303,148943,7360,4.7
47,67,Hancock,2005,2392,2177,215,9.0
47,69,Hardeman,2005,11008,10070,938,8.5
47,71,Hardin,2005,11151,10341,810,7.3
47,73,Hawkins,2005,25290,23731,1559,6.2
47,75,Haywood,2005,9094,8342,752,8.3
47,77,Henderson,2005,12587,11657,930,7.4
47,79,Henry,2005,13995,12950,1045,7.5
47,81,Hickman,2005,10100,9477,623,6.2
47,83,Houston,2005,3755,3438,317,8.4
47,85,Humphreys,2005,8803,8131,672,7.6
47,87,Jackson,2005,5145,4705,440,8.6
47,89,Jefferson,2005,23454,22073,1381,5.9
47,91,Johnson,2005,6927,6361,566,8.2
47,93,Knox,2005,213289,204363,8926,4.2
47,95,Lake,2005,2562,2352,210,8.2
47,97,Lauderdale,2005,9576,8744,832,8.7
47,99,Lawrence,2005,17242,15510,1732,10.0
47,101,Lewis,2005,5100,4620,480,9.4
47,103,Lincoln,2005,16366,15592,774,4.7
47,105,Loudon,2005,21606,20603,1003,4.6
47,107,McMinn,2005,23716,22279,1437,6.1
47,109,McNairy,2005,12169,11443,726,6.0
47,111,Macon,2005,10428,9837,591,5.7
47,113,Madison,2005,46301,43729,2572,5.6
47,115,Marion,2005,12691,11913,778,6.1
47,117,Marshall,2005,12354,11559,795,6.4
47,119,Maury,2005,35574,33446,2128,6.0
47,121,Meigs,2005,4740,4396,344,7.3
47,123,Monroe,2005,18423,17309,1114,6.0
47,125,Montgomery,2005,65023,61824,3199,4.9
47,127,Moore,2005,3081,2939,142,4.6
47,129,Morgan,2005,8099,7495,604,7.5
47,131,Obion,2005,15325,14407,918,6.0
47,133,Overton,2005,9684,9123,561,5.8
47,135,Perry,2005,3248,3015,233,7.2
47,137,Pickett,2005,1834,1678,156,8.5
47,139,Polk,2005,7204,6779,425,5.9
47,141,Putnam,2005,33648,31969,1679,5.0
47,143,Rhea,2005,13112,12230,882,6.7
47,145,Roane,2005,25532,24051,1481,5.8
47,147,Robertson,2005,31404,29886,1518,4.8
47,149,Rutherford,2005,117495,112619,4876,4.1
47,151,Scott,2005,8417,7838,579,6.9
47,153,Sequatchie,2005,5779,5451,328,5.7
47,155,Sevier,2005,44860,42161,2699,6.0
47,157,Shelby,2005,427975,401452,26523,6.2
47,159,Smith,2005,9026,8485,541,6.0
47,161,Stewart,2005,5853,5422,431,7.4
47,163,Sullivan,2005,71320,67625,3695,5.2
47,165,Sumner,2005,75157,71710,3447,4.6
47,167,Tipton,2005,26376,24686,1690,6.4
47,169,Trousdale,2005,3662,3421,241,6.6
47,171,Unicoi,2005,8126,7624,502,6.2
47,173,Union,2005,8699,8215,484,5.6
47,175,Van Buren,2005,2451,2241,210,8.6
47,177,Warren,2005,18291,16842,1449,7.9
47,179,Washington,2005,57629,54811,2818,4.9
47,181,Wayne,2005,6483,5697,786,12.1
47,183,Weakley,2005,15272,14214,1058,6.9
47,185,White,2005,10764,9719,1045,9.7
47,187,Williamson,2005,80888,77811,3077,3.8
47,189,Wilson,2005,54083,51629,2454,4.5
48,1,Anderson,2005,20106,18822,1284,6.4
48,3,Andrews,2005,6362,6103,259,4.1
48,5,Angelina,2005,39453,37271,2182,5.5
48,7,Aransas,2005,11012,10401,611,5.5
48,9,Archer,2005,5311,5124,187,3.5
48,11,Armstrong,2005,1128,1083,45,4.0
48,13,Atascosa,2005,19093,18080,1013,5.3
48,15,Austin,2005,12851,12260,591,4.6
48,17,Bailey,2005,3248,3070,178,5.5
48,19,Bandera,2005,9705,9263,442,4.6
48,21,Bastrop,2005,33798,32064,1734,5.1
48,23,Baylor,2005,1871,1781,90,4.8
48,25,Bee,2005,11104,10304,800,7.2
48,27,Bell,2005,114590,108776,5814,5.1
48,29,Bexar,2005,717197,680133,37064,5.2
48,31,Blanco,2005,4710,4516,194,4.1
48,33,Borden,2005,459,441,18,3.9
48,35,Bosque,2005,8424,7989,435,5.2
48,37,Bowie,2005,42352,40030,2322,5.5
48,39,Brazoria,2005,134124,126324,7800,5.8
48,41,Brazos,2005,87056,83346,3710,4.3
48,43,Brewster,2005,5270,5070,200,3.8
48,45,Briscoe,2005,719,680,39,5.4
48,47,Brooks,2005,3105,2893,212,6.8
48,49,Brown,2005,18750,17857,893,4.8
48,51,Burleson,2005,8651,8288,363,4.2
48,53,Burnet,2005,20358,19450,908,4.5
48,55,Caldwell,2005,16035,15171,864,5.4
48,57,Calhoun,2005,9388,8837,551,5.9
48,59,Callahan,2005,7021,6732,289,4.1
48,61,Cameron,2005,140866,130014,10852,7.7
48,63,Camp,2005,5397,5082,315,5.8
48,65,Carson,2005,3503,3364,139,4.0
48,67,Cass,2005,13400,12558,842,6.3
48,69,Castro,2005,3402,3213,189,5.6
48,71,Chambers,2005,14046,13170,876,6.2
48,73,Cherokee,2005,20671,19501,1170,5.7
48,75,Childress,2005,3082,2906,176,5.7
48,77,Clay,2005,6503,6253,250,3.8
48,79,Cochran,2005,1558,1468,90,5.8
48,81,Coke,2005,1379,1301,78,5.7
48,83,Coleman,2005,4337,4135,202,4.7
48,85,Collin,2005,368999,351591,17408,4.7
48,87,Collingsworth,2005,1631,1558,73,4.5
48,89,Colorado,2005,10358,9888,470,4.5
48,91,Comal,2005,49036,46800,2236,4.6
48,93,Comanche,2005,6455,6148,307,4.8
48,95,Concho,2005,1382,1300,82,5.9
48,97,Cooke,2005,19951,19094,857,4.3
48,99,Coryell,2005,25475,23876,1599,6.3
48,101,Cottle,2005,826,779,47,5.7
48,103,Crane,2005,1586,1504,82,5.2
48,105,Crockett,2005,2044,1968,76,3.7
48,107,Crosby,2005,2936,2775,161,5.5
48,109,Culberson,2005,1655,1589,66,4.0
48,111,Dallam,2005,3091,2987,104,3.4
48,113,Dallas,2005,1147480,1081765,65715,5.7
48,115,Dawson,2005,5194,4835,359,6.9
48,117,Deaf Smith,2005,8366,7972,394,4.7
48,119,Delta,2005,2423,2288,135,5.6
48,121,Denton,2005,315424,300779,14645,4.6
48,123,DeWitt,2005,9377,8939,438,4.7
48,125,Dickens,2005,1081,1024,57,5.3
48,127,Dimmit,2005,3830,3512,318,8.3
48,129,Donley,2005,1844,1752,92,5.0
48,131,Duval,2005,5271,4943,328,6.2
48,133,Eastland,2005,8527,8079,448,5.3
48,135,Ector,2005,62544,59671,2873,4.6
48,137,Edwards,2005,1031,989,42,4.1
48,139,Ellis,2005,66583,62990,3593,5.4
48,141,El Paso,2005,291327,270545,20782,7.1
48,143,Erath,2005,17568,16834,734,4.2
48,145,Falls,2005,7308,6851,457,6.3
48,147,Fannin,2005,13866,12969,897,6.5
48,149,Fayette,2005,12047,11571,476,4.0
48,151,Fisher,2005,2037,1949,88,4.3
48,153,Floyd,2005,3269,3080,189,5.8
48,155,Foard,2005,689,656,33,4.8
48,157,Fort Bend,2005,236025,223492,12533,5.3
48,159,Franklin,2005,5159,4906,253,4.9
48,161,Freestone,2005,10053,9621,432,4.3
48,163,Frio,2005,6399,6008,391,6.1
48,165,Gaines,2005,6250,5948,302,4.8
48,167,Galveston,2005,138338,130306,8032,5.8
48,169,Garza,2005,2409,2300,109,4.5
48,171,Gillespie,2005,12798,12360,438,3.4
48,173,Glasscock,2005,640,615,25,3.9
48,175,Goliad,2005,3412,3246,166,4.9
48,177,Gonzales,2005,9673,9267,406,4.2
48,179,Gray,2005,10869,10405,464,4.3
48,181,Grayson,2005,56662,53574,3088,5.4
48,183,Gregg,2005,60785,57767,3018,5.0
48,185,Grimes,2005,10275,9641,634,6.2
48,187,Guadalupe,2005,51919,49497,2422,4.7
48,189,Hale,2005,16828,15923,905,5.4
48,191,Hall,2005,1593,1499,94,5.9
48,193,Hamilton,2005,3975,3789,186,4.7
48,195,Hansford,2005,2482,2392,90,3.6
48,197,Hardeman,2005,2302,2197,105,4.6
48,199,Hardin,2005,24732,23080,1652,6.7
48,201,Harris,2005,1831799,1726208,105591,5.8
48,203,Harrison,2005,31255,29493,1762,5.6
48,205,Hartley,2005,2286,2195,91,4.0
48,207,Haskell,2005,3161,3040,121,3.8
48,209,Hays,2005,67321,64228,3093,4.6
48,211,Hemphill,2005,2260,2194,66,2.9
48,213,Henderson,2005,34617,32601,2016,5.8
48,215,Hidalgo,2005,261782,240836,20946,8.0
48,217,Hill,2005,15417,14442,975,6.3
48,219,Hockley,2005,11095,10592,503,4.5
48,221,Hood,2005,22622,21427,1195,5.3
48,223,Hopkins,2005,17523,16710,813,4.6
48,225,Houston,2005,8532,7974,558,6.5
48,227,Howard,2005,13369,12648,721,5.4
48,229,Hudspeth,2005,1335,1241,94,7.0
48,231,Hunt,2005,38684,36544,2140,5.5
48,233,Hutchinson,2005,10233,9705,528,5.2
48,235,Irion,2005,961,927,34,3.5
48,237,Jack,2005,4096,3904,192,4.7
48,239,Jackson,2005,6654,6322,332,5.0
48,241,Jasper,2005,15658,14382,1276,8.1
48,243,Jeff Davis,2005,1208,1161,47,3.9
48,245,Jefferson,2005,112094,103251,8843,7.9
48,247,Jim Hogg,2005,2628,2501,127,4.8
48,249,Jim Wells,2005,19839,18732,1107,5.6
48,251,Johnson,2005,72415,68788,3627,5.0
48,253,Jones,2005,7903,7473,430,5.4
48,255,Karnes,2005,5461,5111,350,6.4
48,257,Kaufman,2005,43193,40791,2402,5.6
48,259,Kendall,2005,14358,13753,605,4.2
48,261,Kenedy,2005,249,242,7,2.8
48,263,Kent,2005,443,424,19,4.3
48,265,Kerr,2005,22673,21734,939,4.1
48,267,Kimble,2005,2274,2179,95,4.2
48,269,King,2005,168,161,7,4.2
48,271,Kinney,2005,1446,1357,89,6.2
48,273,Kleberg,2005,16379,15526,853,5.2
48,275,Knox,2005,1797,1710,87,4.8
48,277,Lamar,2005,23082,21630,1452,6.3
48,279,Lamb,2005,7243,6886,357,4.9
48,281,Lampasas,2005,9964,9527,437,4.4
48,283,La Salle,2005,2608,2460,148,5.7
48,285,Lavaca,2005,10398,10019,379,3.6
48,287,Lee,2005,8693,8307,386,4.4
48,289,Leon,2005,7737,7304,433,5.6
48,291,Liberty,2005,31412,29265,2147,6.8
48,293,Limestone,2005,10372,9838,534,5.1
48,295,Lipscomb,2005,1669,1610,59,3.5
48,297,Live Oak,2005,5052,4794,258,5.1
48,299,Llano,2005,8056,7642,414,5.1
48,301,Loving,2005,39,35,4,10.3
48,303,Lubbock,2005,137880,132197,5683,4.1
48,305,Lynn,2005,2843,2677,166,5.8
48,307,McCulloch,2005,3773,3582,191,5.1
48,309,McLennan,2005,112482,106760,5722,5.1
48,311,McMullen,2005,382,362,20,5.2
48,313,Madison,2005,4944,4655,289,5.8
48,315,Marion,2005,5085,4792,293,5.8
48,317,Martin,2005,2123,2028,95,4.5
48,319,Mason,2005,2394,2322,72,3.0
48,321,Matagorda,2005,16402,15053,1349,8.2
48,323,Maverick,2005,19189,16603,2586,13.5
48,325,Medina,2005,19504,18532,972,5.0
48,327,Menard,2005,1094,1044,50,4.6
48,329,Midland,2005,66588,64098,2490,3.7
48,331,Milam,2005,12210,11581,629,5.2
48,333,Mills,2005,2558,2457,101,3.9
48,335,Mitchell,2005,3378,3161,217,6.4
48,337,Montague,2005,9825,9384,441,4.5
48,339,Montgomery,2005,189888,180761,9127,4.8
48,341,Moore,2005,10275,9882,393,3.8
48,343,Morris,2005,6120,5744,376,6.1
48,345,Motley,2005,672,644,28,4.2
48,347,Nacogdoches,2005,31209,29561,1648,5.3
48,349,Navarro,2005,21535,20283,1252,5.8
48,351,Newton,2005,5799,5258,541,9.3
48,353,Nolan,2005,7591,7231,360,4.7
48,355,Nueces,2005,157226,148630,8596,5.5
48,357,Ochiltree,2005,5042,4880,162,3.2
48,359,Oldham,2005,1062,1022,40,3.8
48,361,Orange,2005,40979,37663,3316,8.1
48,363,Palo Pinto,2005,14268,13613,655,4.6
48,365,Panola,2005,11669,11090,579,5.0
48,367,Parker,2005,50868,48415,2453,4.8
48,369,Parmer,2005,4614,4429,185,4.0
48,371,Pecos,2005,6678,6331,347,5.2
48,373,Polk,2005,16810,15655,1155,6.9
48,375,Potter,2005,56783,54151,2632,4.6
48,377,Presidio,2005,3258,2895,363,11.1
48,379,Rains,2005,5110,4832,278,5.4
48,381,Randall,2005,65641,63345,2296,3.5
48,383,Reagan,2005,2190,2136,54,2.5
48,385,Real,2005,1325,1258,67,5.1
48,387,Red River,2005,6288,5896,392,6.2
48,389,Reeves,2005,4250,3930,320,7.5
48,391,Refugio,2005,3869,3675,194,5.0
48,393,Roberts,2005,553,535,18,3.3
48,395,Robertson,2005,7590,7208,382,5.0
48,397,Rockwall,2005,32516,30964,1552,4.8
48,399,Runnels,2005,4631,4389,242,5.2
48,401,Rusk,2005,22810,21605,1205,5.3
48,403,Sabine,2005,3461,3115,346,10.0
48,405,San Augustine,2005,3615,3358,257,7.1
48,407,San Jacinto,2005,10205,9565,640,6.3
48,409,San Patricio,2005,29690,27630,2060,6.9
48,411,San Saba,2005,2650,2517,133,5.0
48,413,Schleicher,2005,1368,1313,55,4.0
48,415,Scurry,2005,7126,6768,358,5.0
48,417,Shackelford,2005,1941,1882,59,3.0
48,419,Shelby,2005,11760,11062,698,5.9
48,421,Sherman,2005,1394,1334,60,4.3
48,423,Smith,2005,95769,90888,4881,5.1
48,425,Somervell,2005,3701,3499,202,5.5
48,427,Starr,2005,21288,18482,2806,13.2
48,429,Stephens,2005,4317,4117,200,4.6
48,431,Sterling,2005,941,914,27,2.9
48,433,Stonewall,2005,825,796,29,3.5
48,435,Sutton,2005,2706,2629,77,2.8
48,437,Swisher,2005,3623,3450,173,4.8
48,439,Tarrant,2005,847500,803334,44166,5.2
48,441,Taylor,2005,65488,62776,2712,4.1
48,443,Terrell,2005,384,357,27,7.0
48,445,Terry,2005,5781,5451,330,5.7
48,447,Throckmorton,2005,935,902,33,3.5
48,449,Titus,2005,14753,14048,705,4.8
48,451,Tom Green,2005,52058,49781,2277,4.4
48,453,Travis,2005,504247,481324,22923,4.5
48,455,Trinity,2005,5829,5456,373,6.4
48,457,Tyler,2005,8399,7775,624,7.4
48,459,Upshur,2005,18841,17895,946,5.0
48,461,Upton,2005,1685,1619,66,3.9
48,463,Uvalde,2005,11741,11020,721,6.1
48,465,Val Verde,2005,20131,18801,1330,6.6
48,467,Van Zandt,2005,25445,24155,1290,5.1
48,469,Victoria,2005,44086,42066,2020,4.6
48,471,Walker,2005,26143,24660,1483,5.7
48,473,Waller,2005,15901,15015,886,5.6
48,475,Ward,2005,4483,4235,248,5.5
48,477,Washington,2005,16236,15486,750,4.6
48,479,Webb,2005,85998,80774,5224,6.1
48,481,Wharton,2005,20829,19757,1072,5.1
48,483,Wheeler,2005,2688,2581,107,4.0
48,485,Wichita,2005,62753,59759,2994,4.8
48,487,Wilbarger,2005,7548,7254,294,3.9
48,489,Willacy,2005,7558,6832,726,9.6
48,491,Williamson,2005,180292,171964,8328,4.6
48,493,Wilson,2005,17762,16901,861,4.8
48,495,Winkler,2005,3047,2901,146,4.8
48,497,Wise,2005,27712,26393,1319,4.8
48,499,Wood,2005,17677,16686,991,5.6
48,501,Yoakum,2005,3299,3144,155,4.7
48,503,Young,2005,9387,8984,403,4.3
48,505,Zapata,2005,5084,4741,343,6.7
48,507,Zavala,2005,3865,3413,452,11.7
49,1,Beaver,2005,3090,2963,127,4.1
49,3,Box Elder,2005,22557,21593,964,4.3
49,5,Cache,2005,57592,55744,1848,3.2
49,7,Carbon,2005,9603,9138,465,4.8
49,9,Daggett,2005,506,480,26,5.1
49,11,Davis,2005,136741,131391,5350,3.9
49,13,Duchesne,2005,7739,7407,332,4.3
49,15,Emery,2005,5158,4897,261,5.1
49,17,Garfield,2005,2717,2523,194,7.1
49,19,Grand,2005,5061,4744,317,6.3
49,21,Iron,2005,20001,19229,772,3.9
49,23,Juab,2005,3942,3754,188,4.8
49,25,Kane,2005,3286,3126,160,4.9
49,27,Millard,2005,6131,5886,245,4.0
49,29,Morgan,2005,3843,3684,159,4.1
49,31,Piute,2005,856,822,34,4.0
49,33,Rich,2005,1300,1259,41,3.2
49,35,Salt Lake,2005,520791,500018,20773,4.0
49,37,San Juan,2005,4818,4440,378,7.8
49,39,Sanpete,2005,10631,10070,561,5.3
49,41,Sevier,2005,9208,8801,407,4.4
49,43,Summit,2005,21596,20743,853,3.9
49,45,Tooele,2005,25326,24229,1097,4.3
49,47,Uintah,2005,14765,14216,549,3.7
49,49,Utah,2005,206470,198439,8031,3.9
49,51,Wasatch,2005,9370,8987,383,4.1
49,53,Washington,2005,57313,55009,2304,4.0
49,55,Wayne,2005,1345,1273,72,5.4
49,57,Weber,2005,108899,103960,4939,4.5
50,1,Addison,2005,21483,20785,698,3.2
50,3,Bennington,2005,20018,19296,722,3.6
50,5,Caledonia,2005,16391,15763,628,3.8
50,7,Chittenden,2005,86931,84258,2673,3.1
50,9,Essex,2005,3212,3092,120,3.7
50,11,Franklin,2005,25844,24871,973,3.8
50,13,Grand Isle,2005,4232,4022,210,5.0
50,15,Lamoille,2005,14535,13972,563,3.9
50,17,Orange,2005,16100,15581,519,3.2
50,19,Orleans,2005,14035,13329,706,5.0
50,21,Rutland,2005,35649,34349,1300,3.6
50,23,Washington,2005,34056,32848,1208,3.5
50,25,Windham,2005,24905,24072,833,3.3
50,27,Windsor,2005,32129,31175,954,3.0
51,1,Accomack,2005,18847,17896,951,5.0
51,3,Albemarle,2005,47503,46047,1456,3.1
51,5,Alleghany,2005,7490,7110,380,5.1
51,7,Amelia,2005,6332,6096,236,3.7
51,9,Amherst,2005,15364,14681,683,4.4
51,11,Appomattox,2005,6846,6498,348,5.1
51,13,Arlington,2005,123514,120410,3104,2.5
51,15,Augusta,2005,36343,35139,1204,3.3
51,17,Bath,2005,2934,2821,113,3.9
51,19,Bedford,2005,36559,35181,1378,3.8
51,21,Bland,2005,3068,2936,132,4.3
51,23,Botetourt,2005,17051,16494,557,3.3
51,25,Brunswick,2005,6785,6408,377,5.6
51,27,Buchanan,2005,8434,7945,489,5.8
51,29,Buckingham,2005,6804,6485,319,4.7
51,31,Campbell,2005,26750,25606,1144,4.3
51,33,Caroline,2005,12895,12365,530,4.1
51,35,Carroll,2005,14441,13567,874,6.1
51,36,Charles City,2005,3769,3591,178,4.7
51,37,Charlotte,2005,5457,4975,482,8.8
51,41,Chesterfield,2005,158953,153521,5432,3.4
51,43,Clarke,2005,7751,7535,216,2.8
51,45,Craig,2005,2506,2401,105,4.2
51,47,Culpeper,2005,19064,18386,678,3.6
51,49,Cumberland,2005,4464,4276,188,4.2
51,51,Dickenson,2005,5746,5348,398,6.9
51,53,Dinwiddie,2005,12631,12069,562,4.4
51,57,Essex,2005,5405,5133,272,5.0
51,59,Fairfax,2005,569143,553380,15763,2.8
51,61,Fauquier,2005,35476,34454,1022,2.9
51,63,Floyd,2005,7112,6828,284,4.0
51,65,Fluvanna,2005,12819,12396,423,3.3
51,67,Franklin,2005,25400,24403,997,3.9
51,69,Frederick,2005,38355,37188,1167,3.0
51,71,Giles,2005,8381,7918,463,5.5
51,73,Gloucester,2005,19839,19178,661,3.3
51,75,Goochland,2005,10364,10029,335,3.2
51,77,Grayson,2005,7425,7050,375,5.1
51,79,Greene,2005,9676,9371,305,3.2
51,81,Greensville,2005,3946,3717,229,5.8
51,83,Halifax,2005,15861,14814,1047,6.6
51,85,Hanover,2005,53618,51903,1715,3.2
51,87,Henrico,2005,156856,151114,5742,3.7
51,89,Henry,2005,25593,23765,1828,7.1
51,91,Highland,2005,1187,1142,45,3.8
51,93,Isle of Wight,2005,17413,16721,692,4.0
51,95,James City,2005,28850,27870,980,3.4
51,97,King and Queen,2005,3273,3134,139,4.2
51,99,King George,2005,9482,9137,345,3.6
51,101,King William,2005,7930,7631,299,3.8
51,103,Lancaster,2005,5231,4914,317,6.1
51,105,Lee,2005,9262,8760,502,5.4
51,107,Loudoun,2005,147513,143637,3876,2.6
51,109,Louisa,2005,15138,14544,594,3.9
51,111,Lunenburg,2005,5598,5280,318,5.7
51,113,Madison,2005,7186,6947,239,3.3
51,115,Mathews,2005,4405,4262,143,3.2
51,117,Mecklenburg,2005,13252,12373,879,6.6
51,119,Middlesex,2005,5043,4851,192,3.8
51,121,Montgomery,2005,43227,41555,1672,3.9
51,125,Nelson,2005,7440,7180,260,3.5
51,127,New Kent,2005,8809,8501,308,3.5
51,131,Northampton,2005,5935,5606,329,5.5
51,133,Northumberland,2005,6058,5742,316,5.2
51,135,Nottoway,2005,6366,6051,315,4.9
51,137,Orange,2005,14683,14175,508,3.5
51,139,Page,2005,11475,10840,635,5.5
51,141,Patrick,2005,8821,8193,628,7.1
51,143,Pittsylvania,2005,31933,29745,2188,6.9
51,145,Powhatan,2005,13532,13114,418,3.1
51,147,Prince Edward,2005,8567,8039,528,6.2
51,149,Prince George,2005,15067,14439,628,4.2
51,153,Prince William,2005,189991,184395,5596,2.9
51,155,Pulaski,2005,18052,17174,878,4.9
51,157,Rappahannock,2005,4120,4003,117,2.8
51,159,Richmond,2005,3494,3316,178,5.1
51,161,Roanoke,2005,46730,45221,1509,3.2
51,163,Rockbridge,2005,11256,10878,378,3.4
51,165,Rockingham,2005,40326,39022,1304,3.2
51,167,Russell,2005,12004,11262,742,6.2
51,169,Scott,2005,9804,9252,552,5.6
51,171,Shenandoah,2005,19561,18915,646,3.3
51,173,Smyth,2005,15640,14858,782,5.0
51,175,Southampton,2005,7545,7205,340,4.5
51,177,Spotsylvania,2005,61990,60181,1809,2.9
51,179,Stafford,2005,61669,59854,1815,2.9
51,181,Surry,2005,3650,3461,189,5.2
51,183,Sussex,2005,4426,4147,279,6.3
51,185,Tazewell,2005,19551,18593,958,4.9
51,187,Warren,2005,18642,18029,613,3.3
51,191,Washington,2005,26015,24752,1263,4.9
51,193,Westmoreland,2005,8140,7740,400,4.9
51,195,Wise,2005,17296,16408,888,5.1
51,197,Wythe,2005,15011,14309,702,4.7
51,199,York,2005,30617,29612,1005,3.3
51,510,Alexandria city,2005,84891,82513,2378,2.8
51,520,Bristol city,2005,7767,7310,457,5.9
51,530,Buena Vista city,2005,3400,3262,138,4.1
51,540,Charlottesville city,2005,19849,19034,815,4.1
51,550,Chesapeake city,2005,111954,107610,4344,3.9
51,570,Colonial Heights city,2005,9085,8681,404,4.4
51,580,Covington city,2005,2848,2673,175,6.1
51,590,Danville city,2005,21076,18788,2288,10.9
51,595,Emporia city,2005,2443,2293,150,6.1
51,600,Fairfax city,2005,12799,12430,369,2.9
51,610,Falls Church city,2005,6442,6208,234,3.6
51,620,Franklin city,2005,3739,3530,209,5.6
51,630,Fredericksburg city,2005,11260,10719,541,4.8
51,640,Galax city,2005,3122,2949,173,5.5
51,650,Hampton city,2005,66974,63729,3245,4.8
51,660,Harrisonburg city,2005,21009,20141,868,4.1
51,670,Hopewell city,2005,10318,9680,638,6.2
51,678,Lexington city,2005,2325,2195,130,5.6
51,680,Lynchburg city,2005,31349,29809,1540,4.9
51,683,Manassas city,2005,20561,19923,638,3.1
51,685,Manassas Park city,2005,6531,6353,178,2.7
51,690,Martinsville city,2005,5990,5343,647,10.8
51,700,Newport News city,2005,86562,82367,4195,4.8
51,710,Norfolk city,2005,96457,91190,5267,5.5
51,720,Norton city,2005,1530,1439,91,5.9
51,730,Petersburg city,2005,14040,12927,1113,7.9
51,735,Poquoson city,2005,6173,5981,192,3.1
51,740,Portsmouth city,2005,44991,42391,2600,5.8
51,750,Radford city,2005,7251,6897,354,4.9
51,760,Richmond city,2005,95865,90358,5507,5.7
51,770,Roanoke city,2005,45358,43301,2057,4.5
51,775,Salem city,2005,12749,12310,439,3.4
51,790,Staunton city,2005,11257,10862,395,3.5
51,800,Suffolk city,2005,37895,36274,1621,4.3
51,810,Virginia Beach city,2005,220504,212546,7958,3.6
51,820,Waynesboro city,2005,9853,9447,406,4.1
51,830,Williamsburg city,2005,4798,4424,374,7.8
51,840,Winchester city,2005,13768,13307,461,3.3
53,1,Adams,2005,8158,7570,588,7.2
53,3,Asotin,2005,10494,9825,669,6.4
53,5,Benton,2005,84834,79651,5183,6.1
53,7,Chelan,2005,39360,36891,2469,6.3
53,9,Clallam,2005,29463,27429,2034,6.9
53,11,Clark,2005,202217,188478,13739,6.8
53,13,Columbia,2005,1633,1498,135,8.3
53,15,Cowlitz,2005,42892,39585,3307,7.7
53,17,Douglas,2005,19920,18762,1158,5.8
53,19,Ferry,2005,3005,2712,293,9.8
53,21,Franklin,2005,29219,27028,2191,7.5
53,23,Garfield,2005,1079,1016,63,5.8
53,25,Grant,2005,38288,35330,2958,7.7
53,27,Grays Harbor,2005,31168,28665,2503,8.0
53,29,Island,2005,31655,29652,2003,6.3
53,31,Jefferson,2005,13567,12756,811,6.0
53,33,King,2005,1011908,967878,44030,4.4
53,35,Kitsap,2005,120710,114154,6556,5.4
53,37,Kittitas,2005,19077,17870,1207,6.3
53,39,Klickitat,2005,9356,8579,777,8.3
53,41,Lewis,2005,30573,28081,2492,8.2
53,43,Lincoln,2005,4715,4410,305,6.5
53,45,Mason,2005,23974,22321,1653,6.9
53,47,Okanogan,2005,20664,19105,1559,7.5
53,49,Pacific,2005,9077,8392,685,7.5
53,51,Pend Oreille,2005,5058,4625,433,8.6
53,53,Pierce,2005,368325,345316,23009,6.2
53,55,San Juan,2005,8202,7819,383,4.7
53,57,Skagit,2005,56156,52608,3548,6.3
53,59,Skamania,2005,5023,4618,405,8.1
53,61,Snohomish,2005,346287,329802,16485,4.8
53,63,Spokane,2005,223627,210132,13495,6.0
53,65,Stevens,2005,17971,16509,1462,8.1
53,67,Thurston,2005,121658,115101,6557,5.4
53,69,Wahkiakum,2005,1626,1500,126,7.7
53,71,Walla Walla,2005,28918,27139,1779,6.2
53,73,Whatcom,2005,102278,96802,5476,5.4
53,75,Whitman,2005,20318,19387,931,4.6
53,77,Yakima,2005,117324,108066,9258,7.9
54,1,Barbour,2005,6584,6151,433,6.6
54,3,Berkeley,2005,43726,41882,1844,4.2
54,5,Boone,2005,9333,8873,460,4.9
54,7,Braxton,2005,5895,5517,378,6.4
54,9,Brooke,2005,11162,10295,867,7.8
54,11,Cabell,2005,44219,42090,2129,4.8
54,13,Calhoun,2005,2695,2447,248,9.2
54,15,Clay,2005,3507,3216,291,8.3
54,17,Doddridge,2005,2870,2722,148,5.2
54,19,Fayette,2005,17838,16731,1107,6.2
54,21,Gilmer,2005,3062,2909,153,5.0
54,23,Grant,2005,4961,4628,333,6.7
54,25,Greenbrier,2005,15123,14133,990,6.5
54,27,Hampshire,2005,9440,9021,419,4.4
54,29,Hancock,2005,14784,13615,1169,7.9
54,31,Hardy,2005,7006,6720,286,4.1
54,33,Harrison,2005,30568,29024,1544,5.1
54,35,Jackson,2005,11646,10912,734,6.3
54,37,Jefferson,2005,24121,23267,854,3.5
54,39,Kanawha,2005,91073,86345,4728,5.2
54,41,Lewis,2005,7271,6882,389,5.4
54,43,Lincoln,2005,7880,7340,540,6.9
54,45,Logan,2005,12762,12092,670,5.2
54,47,McDowell,2005,6425,5860,565,8.8
54,49,Marion,2005,25879,24616,1263,4.9
54,51,Marshall,2005,15124,14186,938,6.2
54,53,Mason,2005,10162,9314,848,8.3
54,55,Mercer,2005,23869,22582,1287,5.4
54,57,Mineral,2005,13449,12681,768,5.7
54,59,Mingo,2005,8174,7669,505,6.2
54,61,Monongalia,2005,44368,42626,1742,3.9
54,63,Monroe,2005,5744,5458,286,5.0
54,65,Morgan,2005,7057,6708,349,4.9
54,67,Nicholas,2005,10447,9831,616,5.9
54,69,Ohio,2005,21057,19963,1094,5.2
54,71,Pendleton,2005,3677,3527,150,4.1
54,73,Pleasants,2005,3206,2991,215,6.7
54,75,Pocahontas,2005,3771,3513,258,6.8
54,77,Preston,2005,14354,13621,733,5.1
54,79,Putnam,2005,26577,25282,1295,4.9
54,81,Raleigh,2005,32301,30669,1632,5.1
54,83,Randolph,2005,12899,12178,721,5.6
54,85,Ritchie,2005,4613,4326,287,6.2
54,87,Roane,2005,5448,5017,431,7.9
54,89,Summers,2005,4709,4393,316,6.7
54,91,Taylor,2005,6964,6577,387,5.6
54,93,Tucker,2005,3042,2839,203,6.7
54,95,Tyler,2005,3617,3336,281,7.8
54,97,Upshur,2005,10696,10140,556,5.2
54,99,Wayne,2005,17658,16673,985,5.6
54,101,Webster,2005,3308,3102,206,6.2
54,103,Wetzel,2005,6590,5930,660,10.0
54,105,Wirt,2005,2520,2321,199,7.9
54,107,Wood,2005,41140,38740,2400,5.8
54,109,Wyoming,2005,8193,7725,468,5.7
55,1,Adams,2005,9705,9030,675,7.0
55,3,Ashland,2005,9283,8736,547,5.9
55,5,Barron,2005,25511,24177,1334,5.2
55,7,Bayfield,2005,8225,7725,500,6.1
55,9,Brown,2005,136051,129918,6133,4.5
55,11,Buffalo,2005,8325,7988,337,4.0
55,13,Burnett,2005,8429,7956,473,5.6
55,15,Calumet,2005,25163,24130,1033,4.1
55,17,Chippewa,2005,32733,30966,1767,5.4
55,19,Clark,2005,17671,16694,977,5.5
55,21,Columbia,2005,31668,30261,1407,4.4
55,23,Crawford,2005,9581,9114,467,4.9
55,25,Dane,2005,286385,277382,9003,3.1
55,27,Dodge,2005,46713,44421,2292,4.9
55,29,Door,2005,16701,15776,925,5.5
55,31,Douglas,2005,22750,21545,1205,5.3
55,33,Dunn,2005,24194,23133,1061,4.4
55,35,Eau Claire,2005,53915,51712,2203,4.1
55,37,Florence,2005,2565,2390,175,6.8
55,39,Fond du Lac,2005,56026,53441,2585,4.6
55,41,Forest,2005,4964,4619,345,7.0
55,43,Grant,2005,26959,25782,1177,4.4
55,45,Green,2005,20064,19175,889,4.4
55,47,Green Lake,2005,10309,9707,602,5.8
55,49,Iowa,2005,14301,13702,599,4.2
55,51,Iron,2005,3197,2931,266,8.3
55,53,Jackson,2005,9844,9281,563,5.7
55,55,Jefferson,2005,42702,40769,1933,4.5
55,57,Juneau,2005,13351,12541,810,6.1
55,59,Kenosha,2005,82600,77914,4686,5.7
55,61,Kewaunee,2005,11833,11301,532,4.5
55,63,La Crosse,2005,61605,59131,2474,4.0
55,65,Lafayette,2005,8974,8606,368,4.1
55,67,Langlade,2005,10699,10061,638,6.0
55,69,Lincoln,2005,15870,15005,865,5.5
55,71,Manitowoc,2005,45344,43112,2232,4.9
55,73,Marathon,2005,74573,71495,3078,4.1
55,75,Marinette,2005,22414,21056,1358,6.1
55,77,Marquette,2005,7872,7388,484,6.1
55,78,Menominee,2005,1647,1482,165,10.0
55,79,Milwaukee,2005,452601,426508,26093,5.8
55,81,Monroe,2005,23396,22439,957,4.1
55,83,Oconto,2005,20280,19114,1166,5.7
55,85,Oneida,2005,20289,19112,1177,5.8
55,87,Outagamie,2005,95124,90816,4308,4.5
55,89,Ozaukee,2005,47803,46028,1775,3.7
55,91,Pepin,2005,3977,3770,207,5.2
55,93,Pierce,2005,23402,22443,959,4.1
55,95,Polk,2005,23933,22694,1239,5.2
55,97,Portage,2005,39946,38105,1841,4.6
55,99,Price,2005,8648,8224,424,4.9
55,101,Racine,2005,98795,92931,5864,5.9
55,103,Richland,2005,9862,9436,426,4.3
55,105,Rock,2005,83437,78544,4893,5.9
55,107,Rusk,2005,8015,7513,502,6.3
55,109,St. Croix,2005,44750,42696,2054,4.6
55,111,Sauk,2005,34299,32778,1521,4.4
55,113,Sawyer,2005,9375,8817,558,6.0
55,115,Shawano,2005,22471,21371,1100,4.9
55,117,Sheboygan,2005,64731,62156,2575,4.0
55,119,Taylor,2005,11132,10521,611,5.5
55,121,Trempealeau,2005,15795,15102,693,4.4
55,123,Vernon,2005,14277,13628,649,4.5
55,125,Vilas,2005,11799,11094,705,6.0
55,127,Walworth,2005,56027,53674,2353,4.2
55,129,Washburn,2005,8313,7804,509,6.1
55,131,Washington,2005,72187,69171,3016,4.2
55,133,Waukesha,2005,212463,204297,8166,3.8
55,135,Waupaca,2005,28080,26591,1489,5.3
55,137,Waushara,2005,12635,11935,700,5.5
55,139,Winnebago,2005,91444,87390,4054,4.4
55,141,Wood,2005,39661,37417,2244,5.7
56,1,Albany,2005,19548,19013,535,2.7
56,3,Big Horn,2005,5348,5108,240,4.5
56,5,Campbell,2005,23411,22809,602,2.6
56,7,Carbon,2005,7682,7386,296,3.9
56,9,Converse,2005,6735,6489,246,3.7
56,11,Crook,2005,3284,3171,113,3.4
56,13,Fremont,2005,17870,17036,834,4.7
56,15,Goshen,2005,5731,5480,251,4.4
56,17,Hot Springs,2005,2333,2241,92,3.9
56,19,Johnson,2005,3818,3676,142,3.7
56,21,Laramie,2005,41738,40035,1703,4.1
56,23,Lincoln,2005,7878,7562,316,4.0
56,25,Natrona,2005,39485,38137,1348,3.4
56,27,Niobrara,2005,1127,1084,43,3.8
56,29,Park,2005,14512,13940,572,3.9
56,31,Platte,2005,4049,3855,194,4.8
56,33,Sheridan,2005,15187,14619,568,3.7
56,35,Sublette,2005,5022,4920,102,2.0
56,37,Sweetwater,2005,22207,21564,643,2.9
56,39,Teton,2005,13885,13472,413,3.0
56,41,Uinta,2005,10746,10384,362,3.4
56,43,Washakie,2005,4299,4125,174,4.0
56,45,Weston,2005,3194,3068,126,3.9
72,1,Adjuntas Municipio,2005,5931,5109,822,13.9
72,3,Aguada Municipio,2005,16068,13871,2197,13.7
72,5,Aguadilla Municipio,2005,22468,19428,3040,13.5
72,7,Aguas Buenas Municipio,2005,9515,8370,1145,12.0
72,9,Aibonito Municipio,2005,8136,6916,1220,15.0
72,11,Anasco Municipio,2005,11122,9531,1591,14.3
72,13,Arecibo Municipio,2005,33919,29678,4241,12.5
72,15,Arroyo Municipio,2005,5626,4665,961,17.1
72,17,Barceloneta Municipio,2005,7387,6291,1096,14.8
72,19,Barranquitas Municipio,2005,7780,6792,988,12.7
72,21,Bayamon Municipio,2005,84035,76923,7112,8.5
72,23,Cabo Rojo Municipio,2005,20670,18602,2068,10.0
72,25,Caguas Municipio,2005,54820,48864,5956,10.9
72,27,Camuy Municipio,2005,12840,11406,1434,11.2
72,29,Canovanas Municipio,2005,14496,12542,1954,13.5
72,31,Carolina Municipio,2005,78568,71720,6848,8.7
72,33,Catano Municipio,2005,8251,7342,909,11.0
72,35,Cayey Municipio,2005,16066,13952,2114,13.2
72,37,Ceiba Municipio,2005,6050,5274,776,12.8
72,39,Ciales Municipio,2005,5285,4397,888,16.8
72,41,Cidra Municipio,2005,15472,13607,1865,12.1
72,43,Coamo Municipio,2005,11622,9831,1791,15.4
72,45,Comerio Municipio,2005,4919,4188,731,14.9
72,47,Corozal Municipio,2005,10760,9335,1425,13.2
72,49,Culebra Municipio,2005,873,801,72,8.2
72,51,Dorado Municipio,2005,12707,11590,1117,8.8
72,53,Fajardo Municipio,2005,15344,13225,2119,13.8
72,54,Florida Municipio,2005,4154,3519,635,15.3
72,55,Guanica Municipio,2005,6646,5499,1147,17.3
72,57,Guayama Municipio,2005,14450,12299,2151,14.9
72,59,Guayanilla Municipio,2005,7046,5905,1141,16.2
72,61,Guaynabo Municipio,2005,45025,42105,2920,6.5
72,63,Gurabo Municipio,2005,15337,13673,1664,10.8
72,65,Hatillo Municipio,2005,12892,11270,1622,12.6
72,67,Hormigueros Municipio,2005,6615,5824,791,12.0
72,69,Humacao Municipio,2005,21247,18016,3231,15.2
72,71,Isabela Municipio,2005,15925,13860,2065,13.0
72,73,Jayuya Municipio,2005,4656,3908,748,16.1
72,75,Juana Diaz Municipio,2005,17420,15322,2098,12.0
72,77,Juncos Municipio,2005,13054,11396,1658,12.7
72,79,Lajas Municipio,2005,9014,7863,1151,12.8
72,81,Lares Municipio,2005,11873,10382,1491,12.6
72,83,Las Marias Municipio,2005,3935,3384,551,14.0
72,85,Las Piedras Municipio,2005,12859,11040,1819,14.1
72,87,Loiza Municipio,2005,8949,7691,1258,14.1
72,89,Luquillo Municipio,2005,7294,6138,1156,15.8
72,91,Manati Municipio,2005,14834,12753,2081,14.0
72,93,Maricao Municipio,2005,2107,1814,293,13.9
72,95,Maunabo Municipio,2005,3823,3039,784,20.5
72,97,Mayaguez Municipio,2005,30821,26590,4231,13.7
72,99,Moca Municipio,2005,15210,13310,1900,12.5
72,101,Morovis Municipio,2005,9292,7870,1422,15.3
72,103,Naguabo Municipio,2005,7621,6427,1194,15.7
72,105,Naranjito Municipio,2005,8710,7718,992,11.4
72,107,Orocovis Municipio,2005,5470,4660,810,14.8
72,109,Patillas Municipio,2005,6079,4984,1095,18.0
72,111,Penuelas Municipio,2005,8921,7631,1290,14.5
72,113,Ponce Municipio,2005,65927,58779,7148,10.8
72,115,Quebradillas Municipio,2005,8763,7626,1137,13.0
72,117,Rincon Municipio,2005,5712,4891,821,14.4
72,119,Rio Grande Municipio,2005,17988,15923,2065,11.5
72,121,Sabana Grande Municipio,2005,9590,8287,1303,13.6
72,123,Salinas Municipio,2005,8860,7290,1570,17.7
72,125,San German Municipio,2005,13445,11609,1836,13.7
72,127,San Juan Municipio,2005,173645,159713,13932,8.0
72,129,San Lorenzo Municipio,2005,14435,12661,1774,12.3
72,131,San Sebastian Municipio,2005,15769,13561,2208,14.0
72,133,Santa Isabel Municipio,2005,9250,8076,1174,12.7
72,135,Toa Alta Municipio,2005,28556,26265,2291,8.0
72,137,Toa Baja Municipio,2005,35943,32903,3040,8.5
72,139,Trujillo Alto Municipio,2005,34523,31959,2564,7.4
72,141,Utuado Municipio,2005,9671,8198,1473,15.2
72,143,Vega Alta Municipio,2005,12539,11152,1387,11.1
72,145,Vega Baja Municipio,2005,20930,18296,2634,12.6
72,147,Vieques Municipio,2005,3062,2725,337,11.0
72,149,Villalba Municipio,2005,9506,8112,1394,14.7
72,151,Yabucoa Municipio,2005,11247,9272,1975,17.6
72,153,Yauco Municipio,2005,16695,14380,2315,13.9
1,1,Autauga,2006,24425,23619,806,3.3
1,3,Baldwin,2006,79806,77263,2543,3.2
1,5,Barbour,2006,10713,10110,603,5.6
1,7,Bibb,2006,8858,8489,369,4.2
1,9,Blount,2006,26799,25939,860,3.2
1,11,Bullock,2006,3703,3377,326,8.8
1,13,Butler,2006,9247,8722,525,5.7
1,15,Calhoun,2006,54118,51946,2172,4.0
1,17,Chambers,2006,15761,14849,912,5.8
1,19,Cherokee,2006,11864,11367,497,4.2
1,21,Chilton,2006,19792,19087,705,3.6
1,23,Choctaw,2006,5335,5038,297,5.6
1,25,Clarke,2006,10268,9636,632,6.2
1,27,Clay,2006,6189,5911,278,4.5
1,29,Cleburne,2006,6646,6415,231,3.5
1,31,Coffee,2006,20712,19945,767,3.7
1,33,Colbert,2006,25331,24162,1169,4.6
1,35,Conecuh,2006,5127,4840,287,5.6
1,37,Coosa,2006,4797,4531,266,5.5
1,39,Covington,2006,17213,16553,660,3.8
1,41,Crenshaw,2006,6602,6341,261,4.0
1,43,Cullman,2006,39418,38081,1337,3.4
1,45,Dale,2006,20498,19550,948,4.6
1,47,Dallas,2006,15909,14614,1295,8.1
1,49,DeKalb,2006,31526,30219,1307,4.1
1,51,Elmore,2006,35207,34016,1191,3.4
1,53,Escambia,2006,14362,13654,708,4.9
1,55,Etowah,2006,46568,44610,1958,4.2
1,57,Fayette,2006,7750,7424,326,4.2
1,59,Franklin,2006,13952,13310,642,4.6
1,61,Geneva,2006,11712,11274,438,3.7
1,63,Greene,2006,3395,3206,189,5.6
1,65,Hale,2006,7176,6802,374,5.2
1,67,Henry,2006,7514,7214,300,4.0
1,69,Houston,2006,46752,45164,1588,3.4
1,71,Jackson,2006,27093,25889,1204,4.4
1,73,Jefferson,2006,317080,304463,12617,4.0
1,75,Lamar,2006,6048,5735,313,5.2
1,77,Lauderdale,2006,42636,40853,1783,4.2
1,79,Lawrence,2006,15659,14910,749,4.8
1,81,Lee,2006,64898,62706,2192,3.4
1,83,Limestone,2006,35804,34508,1296,3.6
1,85,Lowndes,2006,4817,4454,363,7.5
1,87,Macon,2006,8843,8380,463,5.2
1,89,Madison,2006,161511,156243,5268,3.3
1,91,Marengo,2006,8600,8204,396,4.6
1,93,Marion,2006,13515,12930,585,4.3
1,95,Marshall,2006,42030,40583,1447,3.4
1,97,Mobile,2006,182199,174677,7522,4.1
1,99,Monroe,2006,9329,8770,559,6.0
1,101,Montgomery,2006,105816,101442,4374,4.1
1,103,Morgan,2006,55946,53712,2234,4.0
1,105,Perry,2006,3587,3289,298,8.3
1,107,Pickens,2006,8119,7713,406,5.0
1,109,Pike,2006,15182,14578,604,4.0
1,111,Randolph,2006,9765,9249,516,5.3
1,113,Russell,2006,21484,20233,1251,5.8
1,115,St. Clair,2006,35091,33868,1223,3.5
1,117,Shelby,2006,98507,95835,2672,2.7
1,119,Sumter,2006,4795,4472,323,6.7
1,121,Talladega,2006,39487,37464,2023,5.1
1,123,Tallapoosa,2006,18552,17619,933,5.0
1,125,Tuscaloosa,2006,87591,84741,2850,3.3
1,127,Walker,2006,29905,28556,1349,4.5
1,129,Washington,2006,6906,6510,396,5.7
1,131,Wilcox,2006,3572,3264,308,8.6
1,133,Winston,2006,10600,10081,519,4.9
2,13,Aleutians East Borough,2006,1136,1040,96,8.5
2,16,Aleutians West Census Area,2006,3205,3023,182,5.7
2,20,Anchorage Borough/municipality,2006,151131,143105,8026,5.3
2,50,Bethel Census Area,2006,6961,6041,920,13.2
2,60,Bristol Bay Borough,2006,1017,962,55,5.4
2,68,Denali Borough,2006,1641,1546,95,5.8
2,70,Dillingham Census Area,2006,2097,1897,200,9.5
2,90,Fairbanks North Star Borough,2006,45091,42521,2570,5.7
2,100,Haines Borough,2006,1449,1332,117,8.1
2,110,Juneau Borough/city,2006,18494,17597,897,4.9
2,122,Kenai Peninsula Borough,2006,25390,23309,2081,8.2
2,130,Ketchikan Gateway Borough,2006,8078,7582,496,6.1
2,150,Kodiak Island Borough,2006,6130,5672,458,7.5
2,158,Kusilvak Census Area,2006,2532,2007,525,20.7
2,164,Lake and Peninsula Borough,2006,1078,1013,65,6.0
2,170,Matanuska-Susitna Borough,2006,38939,36023,2916,7.5
2,180,Nome Census Area,2006,3887,3418,469,12.1
2,185,North Slope Borough,2006,4133,3850,283,6.8
2,188,Northwest Arctic Borough,2006,2956,2620,336,11.4
2,201,Prince of Wales-Outer Ketchikan Census Area,2006,2347,2011,336,14.3
2,220,Sitka Borough/city,2006,4671,4419,252,5.4
2,232,Skagway-Hoonah-Angoon Census Area,2006,1893,1652,241,12.7
2,240,Southeast Fairbanks Census Area,2006,3335,2978,357,10.7
2,261,Valdez-Cordova Census Area,2006,5177,4735,442,8.5
2,280,Wrangell-Petersburg Census Area,2006,2899,2622,277,9.6
2,282,Yakutat Borough/city,2006,310,280,30,9.7
2,290,Yukon-Koyukuk Census Area,2006,2782,2417,365,13.1
4,1,Apache,2006,20256,18183,2073,10.2
4,3,Cochise,2006,56835,54218,2617,4.6
4,5,Coconino,2006,69054,65975,3079,4.5
4,7,Gila,2006,20836,19730,1106,5.3
4,9,Graham,2006,13040,12363,677,5.2
4,11,Greenlee,2006,3749,3604,145,3.9
4,12,La Paz,2006,7709,7256,453,5.9
4,13,Maricopa,2006,1907614,1837930,69684,3.7
4,15,Mohave,2006,92279,88191,4088,4.4
4,17,Navajo,2006,37996,35133,2863,7.5
4,19,Pima,2006,448856,430294,18562,4.1
4,21,Pinal,2006,102273,97047,5226,5.1
4,23,Santa Cruz,2006,16650,15353,1297,7.8
4,25,Yavapai,2006,96088,92142,3946,4.1
4,27,Yuma,2006,77446,65636,11810,15.2
5,1,Arkansas,2006,11590,10701,889,7.7
5,3,Ashley,2006,9666,8935,731,7.6
5,5,Baxter,2006,17292,16361,931,5.4
5,7,Benton,2006,102265,98803,3462,3.4
5,9,Boone,2006,16862,16018,844,5.0
5,11,Bradley,2006,5642,5243,399,7.1
5,13,Calhoun,2006,2635,2450,185,7.0
5,15,Carroll,2006,13838,13233,605,4.4
5,17,Chicot,2006,4964,4544,420,8.5
5,19,Clark,2006,10869,10259,610,5.6
5,21,Clay,2006,7043,6462,581,8.2
5,23,Cleburne,2006,11481,10900,581,5.1
5,25,Cleveland,2006,4180,3923,257,6.1
5,27,Columbia,2006,10995,10322,673,6.1
5,29,Conway,2006,9802,9313,489,5.0
5,31,Craighead,2006,45207,43011,2196,4.9
5,33,Crawford,2006,27764,26493,1271,4.6
5,35,Crittenden,2006,22158,20633,1525,6.9
5,37,Cross,2006,8538,7913,625,7.3
5,39,Dallas,2006,3898,3640,258,6.6
5,41,Desha,2006,6271,5693,578,9.2
5,43,Drew,2006,8480,7796,684,8.1
5,45,Faulkner,2006,52839,50487,2352,4.5
5,47,Franklin,2006,8466,8097,369,4.4
5,49,Fulton,2006,5057,4798,259,5.1
5,51,Garland,2006,41728,39522,2206,5.3
5,53,Grant,2006,8568,8145,423,4.9
5,55,Greene,2006,18798,17719,1079,5.7
5,57,Hempstead,2006,10944,10344,600,5.5
5,59,Hot Spring,2006,15388,14582,806,5.2
5,61,Howard,2006,6421,6070,351,5.5
5,63,Independence,2006,17420,16451,969,5.6
5,65,Izard,2006,5342,5008,334,6.3
5,67,Jackson,2006,7819,7209,610,7.8
5,69,Jefferson,2006,35975,33116,2859,7.9
5,71,Johnson,2006,11029,10456,573,5.2
5,73,Lafayette,2006,3115,2893,222,7.1
5,75,Lawrence,2006,7379,6873,506,6.9
5,77,Lee,2006,3570,3239,331,9.3
5,79,Lincoln,2006,5126,4712,414,8.1
5,81,Little River,2006,6444,6149,295,4.6
5,83,Logan,2006,10180,9679,501,4.9
5,85,Lonoke,2006,31237,29894,1343,4.3
5,87,Madison,2006,7811,7526,285,3.6
5,89,Marion,2006,6898,6536,362,5.2
5,91,Miller,2006,19300,18389,911,4.7
5,93,Mississippi,2006,20983,19324,1659,7.9
5,95,Monroe,2006,3840,3560,280,7.3
5,97,Montgomery,2006,4340,4134,206,4.7
5,99,Nevada,2006,4384,4140,244,5.6
5,101,Newton,2006,3558,3372,186,5.2
5,103,Ouachita,2006,12364,11357,1007,8.1
5,105,Perry,2006,4836,4592,244,5.0
5,107,Phillips,2006,9027,8282,745,8.3
5,109,Pike,2006,5300,5029,271,5.1
5,111,Poinsett,2006,11204,10448,756,6.7
5,113,Polk,2006,8803,8379,424,4.8
5,115,Pope,2006,29809,28375,1434,4.8
5,117,Prairie,2006,4455,4201,254,5.7
5,119,Pulaski,2006,187285,178197,9088,4.9
5,121,Randolph,2006,7722,7161,561,7.3
5,123,St. Francis,2006,10671,9703,968,9.1
5,125,Saline,2006,47899,45768,2131,4.4
5,127,Scott,2006,4869,4651,218,4.5
5,129,Searcy,2006,3509,3340,169,4.8
5,131,Sebastian,2006,60086,57278,2808,4.7
5,133,Sevier,2006,7672,7358,314,4.1
5,135,Sharp,2006,6468,6027,441,6.8
5,137,Stone,2006,4701,4437,264,5.6
5,139,Union,2006,19582,18261,1321,6.7
5,141,Van Buren,2006,7020,6592,428,6.1
5,143,Washington,2006,101706,97970,3736,3.7
5,145,White,2006,31855,30018,1837,5.8
5,147,Woodruff,2006,3534,3238,296,8.4
5,149,Yell,2006,10763,10273,490,4.6
6,1,Alameda,2006,735010,702439,32571,4.4
6,3,Alpine,2006,483,452,31,6.4
6,5,Amador,2006,17264,16342,922,5.3
6,7,Butte,2006,99910,93712,6198,6.2
6,9,Calaveras,2006,20628,19422,1206,5.8
6,11,Colusa,2006,9930,8715,1215,12.2
6,13,Contra Costa,2006,511241,489391,21850,4.3
6,15,Del Norte,2006,10810,10069,741,6.9
6,17,El Dorado,2006,91704,87484,4220,4.6
6,19,Fresno,2006,411070,378159,32911,8.0
6,21,Glenn,2006,11631,10699,932,8.0
6,23,Humboldt,2006,59498,56217,3281,5.5
6,25,Imperial,2006,63109,53393,9716,15.4
6,27,Inyo,2006,9024,8613,411,4.6
6,29,Kern,2006,336618,311258,25360,7.5
6,31,Kings,2006,55081,50439,4642,8.4
6,33,Lake,2006,24310,22446,1864,7.7
6,35,Lassen,2006,12236,11272,964,7.9
6,37,Los Angeles,2006,4794479,4565724,228755,4.8
6,39,Madera,2006,62831,58449,4382,7.0
6,41,Marin,2006,130787,126177,4610,3.5
6,43,Mariposa,2006,9022,8513,509,5.6
6,45,Mendocino,2006,43311,41061,2250,5.2
6,47,Merced,2006,98072,88828,9244,9.4
6,49,Modoc,2006,3987,3678,309,7.8
6,51,Mono,2006,8251,7887,364,4.4
6,53,Monterey,2006,203396,189335,14061,6.9
6,55,Napa,2006,71808,69042,2766,3.9
6,57,Nevada,2006,49690,47522,2168,4.4
6,59,Orange,2006,1600366,1546035,54331,3.4
6,61,Placer,2006,169126,162094,7032,4.2
6,63,Plumas,2006,10101,9329,772,7.6
6,65,Riverside,2006,882641,838261,44380,5.0
6,67,Sacramento,2006,669881,638067,31814,4.7
6,69,San Benito,2006,24203,22471,1732,7.2
6,71,San Bernardino,2006,861389,819981,41408,4.8
6,73,San Diego,2006,1498544,1439206,59338,4.0
6,75,San Francisco/city,2006,416418,398955,17463,4.2
6,77,San Joaquin,2006,284039,262987,21052,7.4
6,79,San Luis Obispo,2006,132589,127377,5212,3.9
6,81,San Mateo,2006,364595,351228,13367,3.7
6,83,Santa Barbara,2006,211222,202700,8522,4.0
6,85,Santa Clara,2006,822881,786077,36804,4.5
6,87,Santa Cruz,2006,143282,135213,8069,5.6
6,89,Shasta,2006,82575,77135,5440,6.6
6,91,Sierra,2006,1590,1472,118,7.4
6,93,Siskiyou,2006,18625,17135,1490,8.0
6,95,Solano,2006,208181,198055,10126,4.9
6,97,Sonoma,2006,254398,244244,10154,4.0
6,99,Stanislaus,2006,224643,206789,17854,7.9
6,101,Sutter,2006,40425,36814,3611,8.9
6,103,Tehama,2006,25093,23470,1623,6.5
6,105,Trinity,2006,5066,4566,500,9.9
6,107,Tulare,2006,187696,171750,15946,8.5
6,109,Tuolumne,2006,25847,24356,1491,5.8
6,111,Ventura,2006,420231,402174,18057,4.3
6,113,Yolo,2006,93756,88913,4843,5.2
6,115,Yuba,2006,26592,24258,2334,8.8
8,1,Adams,2006,218642,208193,10449,4.8
8,3,Alamosa,2006,8287,7908,379,4.6
8,5,Arapahoe,2006,304824,291978,12846,4.2
8,7,Archuleta,2006,6497,6233,264,4.1
8,9,Baca,2006,2439,2365,74,3.0
8,11,Bent,2006,2425,2291,134,5.5
8,13,Boulder,2006,171797,165495,6302,3.7
8,14,Broomfield/city,2006,25620,24538,1082,4.2
8,15,Chaffee,2006,8205,7854,351,4.3
8,17,Cheyenne,2006,1359,1323,36,2.6
8,19,Clear Creek,2006,5831,5599,232,4.0
8,21,Conejos,2006,3794,3549,245,6.5
8,23,Costilla,2006,1336,1224,112,8.4
8,25,Crowley,2006,1601,1493,108,6.7
8,27,Custer,2006,1963,1880,83,4.2
8,29,Delta,2006,15983,15354,629,3.9
8,31,Denver/city,2006,308123,293533,14590,4.7
8,33,Dolores,2006,991,928,63,6.4
8,35,Douglas,2006,152150,146813,5337,3.5
8,37,Eagle,2006,30038,29039,999,3.3
8,39,Elbert,2006,13214,12696,518,3.9
8,41,El Paso,2006,297612,284032,13580,4.6
8,43,Fremont,2006,19572,18499,1073,5.5
8,45,Garfield,2006,33463,32486,977,2.9
8,47,Gilpin,2006,3430,3293,137,4.0
8,49,Grand,2006,8835,8552,283,3.2
8,51,Gunnison,2006,9582,9285,297,3.1
8,53,Hinsdale,2006,622,603,19,3.1
8,55,Huerfano,2006,3394,3192,202,6.0
8,57,Jackson,2006,1116,1084,32,2.9
8,59,Jefferson,2006,306370,293732,12638,4.1
8,61,Kiowa,2006,895,865,30,3.4
8,63,Kit Carson,2006,4517,4382,135,3.0
8,65,Lake,2006,4047,3878,169,4.2
8,67,La Plata,2006,30523,29510,1013,3.3
8,69,Larimer,2006,170532,163915,6617,3.9
8,71,Las Animas,2006,8515,8175,340,4.0
8,73,Lincoln,2006,3081,2972,109,3.5
8,75,Logan,2006,11207,10825,382,3.4
8,77,Mesa,2006,74675,71754,2921,3.9
8,79,Mineral,2006,456,434,22,4.8
8,81,Moffat,2006,8408,8096,312,3.7
8,83,Montezuma,2006,13254,12677,577,4.4
8,85,Montrose,2006,20427,19620,807,4.0
8,87,Morgan,2006,14445,13892,553,3.8
8,89,Otero,2006,9389,8827,562,6.0
8,91,Ouray,2006,3030,2937,93,3.1
8,93,Park,2006,9809,9427,382,3.9
8,95,Phillips,2006,2411,2331,80,3.3
8,97,Pitkin,2006,11342,10991,351,3.1
8,99,Prowers,2006,6985,6584,401,5.7
8,101,Pueblo,2006,70902,66964,3938,5.6
8,103,Rio Blanco,2006,4769,4642,127,2.7
8,105,Rio Grande,2006,6661,6356,305,4.6
8,107,Routt,2006,15093,14617,476,3.2
8,109,Saguache,2006,3220,3022,198,6.1
8,111,San Juan,2006,555,528,27,4.9
8,113,San Miguel,2006,5485,5301,184,3.4
8,115,Sedgwick,2006,1640,1590,50,3.0
8,117,Summit,2006,16964,16446,518,3.1
8,119,Teller,2006,12889,12348,541,4.2
8,121,Washington,2006,2919,2819,100,3.4
8,123,Weld,2006,115746,110401,5345,4.6
8,125,Yuma,2006,6553,6384,169,2.6
9,1,Fairfield,2006,460414,442506,17908,3.9
9,3,Hartford,2006,446246,424758,21488,4.8
9,5,Litchfield,2006,103936,99715,4221,4.1
9,7,Middlesex,2006,91373,87981,3392,3.7
9,9,New Haven,2006,438031,416848,21183,4.8
9,11,New London,2006,145758,139693,6065,4.2
9,13,Tolland,2006,82777,79616,3161,3.8
9,15,Windham,2006,62549,59270,3279,5.2
10,1,Kent,2006,74413,71807,2606,3.5
10,3,New Castle,2006,276128,264775,11353,4.1
10,5,Sussex,2006,92686,89412,3274,3.5
11,1,District of Colu,2006,320581,300323,20258,6.3
12,1,Alachua,2006,125041,122484,2557,2.0
12,3,Baker,2006,11469,11220,249,2.2
12,5,Bay,2006,85111,83085,2026,2.4
12,7,Bradford,2006,12108,11844,264,2.2
12,9,Brevard,2006,263548,256963,6585,2.5
12,11,Broward,2006,975912,952733,23179,2.4
12,13,Calhoun,2006,5345,5216,129,2.4
12,15,Charlotte,2006,68977,67208,1769,2.6
12,17,Citrus,2006,54053,52470,1583,2.9
12,19,Clay,2006,90973,88886,2087,2.3
12,21,Collier,2006,151335,147721,3614,2.4
12,23,Columbia,2006,29576,28847,729,2.5
12,27,DeSoto,2006,14087,13693,394,2.8
12,29,Dixie,2006,5650,5499,151,2.7
12,31,Duval,2006,428511,416933,11578,2.7
12,33,Escambia,2006,137173,133859,3314,2.4
12,35,Flagler,2006,30391,29338,1053,3.5
12,37,Franklin,2006,5018,4903,115,2.3
12,39,Gadsden,2006,20856,20305,551,2.6
12,41,Gilchrist,2006,7675,7506,169,2.2
12,43,Glades,2006,4648,4510,138,3.0
12,45,Gulf,2006,6371,6221,150,2.4
12,47,Hamilton,2006,4599,4464,135,2.9
12,49,Hardee,2006,11869,11507,362,3.0
12,51,Hendry,2006,17431,16579,852,4.9
12,53,Hernando,2006,59239,57197,2042,3.4
12,55,Highlands,2006,40435,39275,1160,2.9
12,57,Hillsborough,2006,580917,566204,14713,2.5
12,59,Holmes,2006,8562,8363,199,2.3
12,61,Indian River,2006,61098,59169,1929,3.2
12,63,Jackson,2006,21106,20529,577,2.7
12,65,Jefferson,2006,7017,6863,154,2.2
12,67,Lafayette,2006,2831,2771,60,2.1
12,69,Lake,2006,125330,122117,3213,2.6
12,71,Lee,2006,285160,278800,6360,2.2
12,73,Leon,2006,139657,136735,2922,2.1
12,75,Levy,2006,16360,15918,442,2.7
12,77,Liberty,2006,3515,3445,70,2.0
12,79,Madison,2006,7249,6961,288,4.0
12,81,Manatee,2006,148120,144659,3461,2.3
12,83,Marion,2006,133079,129586,3493,2.6
12,85,Martin,2006,64702,62970,1732,2.7
12,86,Miami-Dade,2006,1180505,1155886,24619,2.1
12,87,Monroe,2006,44236,43401,835,1.9
12,89,Nassau,2006,33858,33114,744,2.2
12,91,Okaloosa,2006,98167,96362,1805,1.8
12,93,Okeechobee,2006,17301,16750,551,3.2
12,95,Orange,2006,571003,557274,13729,2.4
12,97,Osceola,2006,123982,120761,3221,2.6
12,99,Palm Beach,2006,613813,596474,17339,2.8
12,101,Pasco,2006,185313,179817,5496,3.0
12,103,Pinellas,2006,449501,437927,11574,2.6
12,105,Polk,2006,261959,254632,7327,2.8
12,107,Putnam,2006,31498,30600,898,2.9
12,109,St. Johns,2006,88002,86177,1825,2.1
12,111,St. Lucie,2006,118283,114483,3800,3.2
12,113,Santa Rosa,2006,69289,67695,1594,2.3
12,115,Sarasota,2006,171517,167400,4117,2.4
12,117,Seminole,2006,232638,227412,5226,2.2
12,119,Sumter,2006,29569,28938,631,2.1
12,121,Suwannee,2006,16825,16407,418,2.5
12,123,Taylor,2006,8672,8409,263,3.0
12,125,Union,2006,5090,4988,102,2.0
12,127,Volusia,2006,248128,241900,6228,2.5
12,129,Wakulla,2006,15359,15068,291,1.9
12,131,Walton,2006,30960,30444,516,1.7
12,133,Washington,2006,9522,9280,242,2.5
13,1,Appling,2006,8846,8318,528,6.0
13,3,Atkinson,2006,3381,3185,196,5.8
13,5,Bacon,2006,4791,4555,236,4.9
13,7,Baker,2006,1783,1686,97,5.4
13,9,Baldwin,2006,20967,19741,1226,5.8
13,11,Banks,2006,9588,9254,334,3.5
13,13,Barrow,2006,32018,30555,1463,4.6
13,15,Bartow,2006,44933,42560,2373,5.3
13,17,Ben Hill,2006,8250,7746,504,6.1
13,19,Berrien,2006,8938,8539,399,4.5
13,21,Bibb,2006,73499,68984,4515,6.1
13,23,Bleckley,2006,5162,4836,326,6.3
13,25,Brantley,2006,7655,7268,387,5.1
13,27,Brooks,2006,8526,8148,378,4.4
13,29,Bryan,2006,16103,15490,613,3.8
13,31,Bulloch,2006,31434,29980,1454,4.6
13,33,Burke,2006,9885,9172,713,7.2
13,35,Butts,2006,10059,9476,583,5.8
13,37,Calhoun,2006,2432,2275,157,6.5
13,39,Camden,2006,20887,19960,927,4.4
13,43,Candler,2006,4596,4387,209,4.5
13,45,Carroll,2006,50915,48226,2689,5.3
13,47,Catoosa,2006,36037,34539,1498,4.2
13,49,Charlton,2006,4577,4352,225,4.9
13,51,Chatham,2006,127963,122335,5628,4.4
13,53,Chattahoochee,2006,2520,2257,263,10.4
13,55,Chattooga,2006,10876,10290,586,5.4
13,57,Cherokee,2006,104467,100312,4155,4.0
13,59,Clarke,2006,62613,59713,2900,4.6
13,61,Clay,2006,1547,1475,72,4.7
13,63,Clayton,2006,135605,127020,8585,6.3
13,65,Clinch,2006,2781,2632,149,5.4
13,67,Cobb,2006,373102,355979,17123,4.6
13,69,Coffee,2006,16857,15886,971,5.8
13,71,Colquitt,2006,20620,19677,943,4.6
13,73,Columbia,2006,58269,55693,2576,4.4
13,75,Cook,2006,7128,6718,410,5.8
13,77,Coweta,2006,57750,55141,2609,4.5
13,79,Crawford,2006,6249,5905,344,5.5
13,81,Crisp,2006,10369,9720,649,6.3
13,83,Dade,2006,8654,8264,390,4.5
13,85,Dawson,2006,10634,10198,436,4.1
13,87,Decatur,2006,12037,11294,743,6.2
13,89,DeKalb,2006,386680,365302,21378,5.5
13,91,Dodge,2006,9558,9050,508,5.3
13,93,Dooly,2006,4868,4577,291,6.0
13,95,Dougherty,2006,41525,38840,2685,6.5
13,97,Douglas,2006,62282,58917,3365,5.4
13,99,Early,2006,5697,5387,310,5.4
13,101,Echols,2006,2368,2289,79,3.3
13,103,Effingham,2006,27072,26082,990,3.7
13,105,Elbert,2006,10008,9313,695,6.9
13,107,Emanuel,2006,10811,10218,593,5.5
13,109,Evans,2006,4933,4694,239,4.8
13,111,Fannin,2006,10769,10305,464,4.3
13,113,Fayette,2006,53676,51372,2304,4.3
13,115,Floyd,2006,49339,46954,2385,4.8
13,117,Forsyth,2006,79741,76861,2880,3.6
13,119,Franklin,2006,10734,10150,584,5.4
13,121,Fulton,2006,472562,446949,25613,5.4
13,123,Gilmer,2006,14150,13597,553,3.9
13,125,Glascock,2006,1218,1151,67,5.5
13,127,Glynn,2006,39806,38118,1688,4.2
13,129,Gordon,2006,27084,25809,1275,4.7
13,131,Grady,2006,12266,11738,528,4.3
13,133,Greene,2006,6964,6533,431,6.2
13,135,Gwinnett,2006,410002,391493,18509,4.5
13,137,Habersham,2006,19771,18914,857,4.3
13,139,Hall,2006,86447,82894,3553,4.1
13,141,Hancock,2006,3455,3139,316,9.1
13,143,Haralson,2006,12791,12134,657,5.1
13,145,Harris,2006,15707,15065,642,4.1
13,147,Hart,2006,10967,10207,760,6.9
13,149,Heard,2006,4918,4656,262,5.3
13,151,Henry,2006,92618,88050,4568,4.9
13,153,Houston,2006,66067,63047,3020,4.6
13,155,Irwin,2006,4727,4472,255,5.4
13,157,Jackson,2006,26715,25533,1182,4.4
13,159,Jasper,2006,6395,6066,329,5.1
13,161,Jeff Davis,2006,5560,5133,427,7.7
13,163,Jefferson,2006,7059,6570,489,6.9
13,165,Jenkins,2006,3568,3358,210,5.9
13,167,Johnson,2006,3785,3567,218,5.8
13,169,Jones,2006,13882,13133,749,5.4
13,171,Lamar,2006,7820,7346,474,6.1
13,173,Lanier,2006,3974,3809,165,4.2
13,175,Laurens,2006,22612,21336,1276,5.6
13,177,Lee,2006,17248,16568,680,3.9
13,179,Liberty,2006,24013,22513,1500,6.2
13,181,Lincoln,2006,3812,3561,251,6.6
13,183,Long,2006,5717,5474,243,4.3
13,185,Lowndes,2006,52047,49871,2176,4.2
13,187,Lumpkin,2006,12754,12185,569,4.5
13,189,McDuffie,2006,10669,9954,715,6.7
13,191,McIntosh,2006,5285,5038,247,4.7
13,193,Macon,2006,5299,4859,440,8.3
13,195,Madison,2006,15396,14779,617,4.0
13,197,Marion,2006,3387,3222,165,4.9
13,199,Meriwether,2006,9665,8997,668,6.9
13,201,Miller,2006,3704,3560,144,3.9
13,205,Mitchell,2006,10473,9918,555,5.3
13,207,Monroe,2006,13075,12441,634,4.8
13,209,Montgomery,2006,4512,4261,251,5.6
13,211,Morgan,2006,9400,8960,440,4.7
13,213,Murray,2006,21450,20447,1003,4.7
13,215,Muscogee,2006,85455,80403,5052,5.9
13,217,Newton,2006,44114,41583,2531,5.7
13,219,Oconee,2006,17384,16789,595,3.4
13,221,Oglethorpe,2006,7574,7269,305,4.0
13,223,Paulding,2006,62512,59708,2804,4.5
13,225,Peach,2006,11531,10807,724,6.3
13,227,Pickens,2006,14654,14070,584,4.0
13,229,Pierce,2006,8359,7981,378,4.5
13,231,Pike,2006,7883,7497,386,4.9
13,233,Polk,2006,20723,19742,981,4.7
13,235,Pulaski,2006,4633,4407,226,4.9
13,237,Putnam,2006,10380,9872,508,4.9
13,239,Quitman,2006,1001,946,55,5.5
13,241,Rabun,2006,7530,7082,448,5.9
13,243,Randolph,2006,2879,2680,199,6.9
13,245,Richmond,2006,88943,82900,6043,6.8
13,247,Rockdale,2006,39413,37264,2149,5.5
13,249,Schley,2006,1867,1754,113,6.1
13,251,Screven,2006,7196,6821,375,5.2
13,253,Seminole,2006,4009,3787,222,5.5
13,255,Spalding,2006,28123,26202,1921,6.8
13,257,Stephens,2006,13391,12674,717,5.4
13,259,Stewart,2006,1983,1842,141,7.1
13,261,Sumter,2006,14780,13800,980,6.6
13,263,Talbot,2006,3084,2876,208,6.7
13,265,Taliaferro,2006,785,726,59,7.5
13,267,Tattnall,2006,9085,8565,520,5.7
13,269,Taylor,2006,3343,3117,226,6.8
13,271,Telfair,2006,5055,4643,412,8.2
13,273,Terrell,2006,4562,4279,283,6.2
13,275,Thomas,2006,23517,22478,1039,4.4
13,277,Tift,2006,19976,18885,1091,5.5
13,279,Toombs,2006,13492,12733,759,5.6
13,281,Towns,2006,5927,5709,218,3.7
13,283,Treutlen,2006,2694,2516,178,6.6
13,285,Troup,2006,30401,28483,1918,6.3
13,287,Turner,2006,5104,4788,316,6.2
13,289,Twiggs,2006,4584,4299,285,6.2
13,291,Union,2006,10742,10313,429,4.0
13,293,Upson,2006,11817,11017,800,6.8
13,295,Walker,2006,33718,32094,1624,4.8
13,297,Walton,2006,39072,37154,1918,4.9
13,299,Ware,2006,15086,14276,810,5.4
13,301,Warren,2006,2474,2254,220,8.9
13,303,Washington,2006,8443,7909,534,6.3
13,305,Wayne,2006,11861,11134,727,6.1
13,307,Webster,2006,1187,1130,57,4.8
13,309,Wheeler,2006,3084,2900,184,6.0
13,311,White,2006,12448,11943,505,4.1
13,313,Whitfield,2006,46882,44650,2232,4.8
13,315,Wilcox,2006,3289,3078,211,6.4
13,317,Wilkes,2006,4719,4407,312,6.6
13,319,Wilkinson,2006,4577,4294,283,6.2
13,321,Worth,2006,10395,9825,570,5.5
15,1,Hawaii,2006,83445,80928,2517,3.0
15,3,Honolulu/city,2006,442814,431934,10880,2.5
15,7,Kauai,2006,32327,31525,802,2.5
15,9,Maui,2006,76829,74975,1854,2.4
16,1,Ada,2006,193098,187965,5133,2.7
16,3,Adams,2006,2150,2006,144,6.7
16,5,Bannock,2006,40296,38923,1373,3.4
16,7,Bear Lake,2006,3039,2951,88,2.9
16,9,Benewah,2006,3939,3635,304,7.7
16,11,Bingham,2006,21026,20258,768,3.7
16,13,Blaine,2006,14113,13737,376,2.7
16,15,Boise,2006,3694,3559,135,3.7
16,17,Bonner,2006,20464,19513,951,4.6
16,19,Bonneville,2006,49609,48299,1310,2.6
16,21,Boundary,2006,4215,3897,318,7.5
16,23,Butte,2006,1424,1378,46,3.2
16,25,Camas,2006,634,613,21,3.3
16,27,Canyon,2006,82248,79077,3171,3.9
16,29,Caribou,2006,3330,3198,132,4.0
16,31,Cassia,2006,10407,9984,423,4.1
16,33,Clark,2006,524,504,20,3.8
16,35,Clearwater,2006,3304,3030,274,8.3
16,37,Custer,2006,2526,2421,105,4.2
16,39,Elmore,2006,10887,10439,448,4.1
16,41,Franklin,2006,6236,6084,152,2.4
16,43,Fremont,2006,6006,5783,223,3.7
16,45,Gem,2006,7305,6994,311,4.3
16,47,Gooding,2006,8491,8251,240,2.8
16,49,Idaho,2006,7091,6654,437,6.2
16,51,Jefferson,2006,10964,10634,330,3.0
16,53,Jerome,2006,10164,9833,331,3.3
16,55,Kootenai,2006,68403,65817,2586,3.8
16,57,Latah,2006,17533,17006,527,3.0
16,59,Lemhi,2006,3990,3782,208,5.2
16,61,Lewis,2006,1725,1678,47,2.7
16,63,Lincoln,2006,2566,2451,115,4.5
16,65,Madison,2006,14823,14435,388,2.6
16,67,Minidoka,2006,9768,9283,485,5.0
16,69,Nez Perce,2006,18950,18283,667,3.5
16,71,Oneida,2006,2224,2181,43,1.9
16,73,Owyhee,2006,4703,4605,98,2.1
16,75,Payette,2006,10349,9835,514,5.0
16,77,Power,2006,3857,3673,184,4.8
16,79,Shoshone,2006,5605,5206,399,7.1
16,81,Teton,2006,4718,4624,94,2.0
16,83,Twin Falls,2006,38191,36916,1275,3.3
16,85,Valley,2006,4957,4744,213,4.3
16,87,Washington,2006,4933,4713,220,4.5
17,1,Adams,2006,39309,37973,1336,3.4
17,3,Alexander,2006,3297,3031,266,8.1
17,5,Bond,2006,8636,8215,421,4.9
17,7,Boone,2006,25728,24296,1432,5.6
17,9,Brown,2006,3371,3270,101,3.0
17,11,Bureau,2006,19037,18202,835,4.4
17,13,Calhoun,2006,2621,2463,158,6.0
17,15,Carroll,2006,8583,8170,413,4.8
17,17,Cass,2006,7642,7328,314,4.1
17,19,Champaign,2006,102777,99006,3771,3.7
17,21,Christian,2006,17570,16739,831,4.7
17,23,Clark,2006,8911,8479,432,4.8
17,25,Clay,2006,6976,6627,349,5.0
17,27,Clinton,2006,19213,18365,848,4.4
17,29,Coles,2006,27231,26111,1120,4.1
17,31,Cook,2006,2560021,2434287,125734,4.9
17,33,Crawford,2006,9622,9130,492,5.1
17,35,Cumberland,2006,5719,5466,253,4.4
17,37,DeKalb,2006,55673,53624,2049,3.7
17,39,De Witt,2006,8360,8001,359,4.3
17,41,Douglas,2006,10298,9879,419,4.1
17,43,DuPage,2006,520347,502048,18299,3.5
17,45,Edgar,2006,10513,10014,499,4.7
17,47,Edwards,2006,3434,3289,145,4.2
17,49,Effingham,2006,18347,17602,745,4.1
17,51,Fayette,2006,10199,9625,574,5.6
17,53,Ford,2006,7378,7058,320,4.3
17,55,Franklin,2006,17920,16735,1185,6.6
17,57,Fulton,2006,17815,16906,909,5.1
17,59,Gallatin,2006,2662,2513,149,5.6
17,61,Greene,2006,7421,7084,337,4.5
17,63,Grundy,2006,24448,23170,1278,5.2
17,65,Hamilton,2006,4254,4025,229,5.4
17,67,Hancock,2006,9885,9424,461,4.7
17,69,Hardin,2006,1756,1627,129,7.3
17,71,Henderson,2006,4089,3874,215,5.3
17,73,Henry,2006,27637,26488,1149,4.2
17,75,Iroquois,2006,16446,15712,734,4.5
17,77,Jackson,2006,32801,31492,1309,4.0
17,79,Jasper,2006,5076,4826,250,4.9
17,81,Jefferson,2006,21028,20054,974,4.6
17,83,Jersey,2006,11771,11208,563,4.8
17,85,Jo Daviess,2006,13508,12995,513,3.8
17,87,Johnson,2006,5247,4973,274,5.2
17,89,Kane,2006,259123,248738,10385,4.0
17,91,Kankakee,2006,54286,51258,3028,5.6
17,93,Kendall,2006,49588,47648,1940,3.9
17,95,Knox,2006,25573,24235,1338,5.2
17,97,Lake,2006,365493,350047,15446,4.2
17,99,LaSalle,2006,57599,54533,3066,5.3
17,101,Lawrence,2006,8418,8015,403,4.8
17,103,Lee,2006,18518,17704,814,4.4
17,105,Livingston,2006,18865,18085,780,4.1
17,107,Logan,2006,13368,12753,615,4.6
17,109,McDonough,2006,17268,16572,696,4.0
17,111,McHenry,2006,172730,166062,6668,3.9
17,113,McLean,2006,88781,85767,3014,3.4
17,115,Macon,2006,53735,50898,2837,5.3
17,117,Macoupin,2006,24711,23430,1281,5.2
17,119,Madison,2006,137984,131203,6781,4.9
17,121,Marion,2006,18553,17484,1069,5.8
17,123,Marshall,2006,7240,6961,279,3.9
17,125,Mason,2006,7464,7034,430,5.8
17,127,Massac,2006,7458,7061,397,5.3
17,129,Menard,2006,6966,6690,276,4.0
17,131,Mercer,2006,9018,8538,480,5.3
17,133,Monroe,2006,18084,17388,696,3.8
17,135,Montgomery,2006,13592,12764,828,6.1
17,137,Morgan,2006,17731,16883,848,4.8
17,139,Moultrie,2006,8170,7887,283,3.5
17,141,Ogle,2006,27327,25972,1355,5.0
17,143,Peoria,2006,95105,91116,3989,4.2
17,145,Perry,2006,10246,9559,687,6.7
17,147,Piatt,2006,9245,8909,336,3.6
17,149,Pike,2006,8728,8355,373,4.3
17,151,Pope,2006,1953,1830,123,6.3
17,153,Pulaski,2006,2927,2731,196,6.7
17,155,Putnam,2006,3125,2968,157,5.0
17,157,Randolph,2006,15404,14686,718,4.7
17,159,Richland,2006,7659,7310,349,4.6
17,161,Rock Island,2006,79202,75787,3415,4.3
17,163,St. Clair,2006,123938,116776,7162,5.8
17,165,Saline,2006,12443,11776,667,5.4
17,167,Sangamon,2006,106636,102194,4442,4.2
17,169,Schuyler,2006,4445,4268,177,4.0
17,171,Scott,2006,2788,2643,145,5.2
17,173,Shelby,2006,11160,10644,516,4.6
17,175,Stark,2006,2946,2810,136,4.6
17,177,Stephenson,2006,25413,24208,1205,4.7
17,179,Tazewell,2006,71463,68765,2698,3.8
17,181,Union,2006,8482,7984,498,5.9
17,183,Vermilion,2006,37712,35594,2118,5.6
17,185,Wabash,2006,6676,6368,308,4.6
17,187,Warren,2006,9044,8636,408,4.5
17,189,Washington,2006,8492,8168,324,3.8
17,191,Wayne,2006,8219,7870,349,4.2
17,193,White,2006,8000,7627,373,4.7
17,195,Whiteside,2006,30385,28821,1564,5.1
17,197,Will,2006,350320,335103,15217,4.3
17,199,Williamson,2006,35551,33891,1660,4.7
17,201,Winnebago,2006,144827,137216,7611,5.3
17,203,Woodford,2006,20943,20297,646,3.1
18,1,Adams,2006,16229,15530,699,4.3
18,3,Allen,2006,182272,173277,8995,4.9
18,5,Bartholomew,2006,38192,36609,1583,4.1
18,7,Benton,2006,4613,4388,225,4.9
18,9,Blackford,2006,6717,6285,432,6.4
18,11,Boone,2006,28057,27026,1031,3.7
18,13,Brown,2006,7960,7574,386,4.8
18,15,Carroll,2006,10561,10074,487,4.6
18,17,Cass,2006,18920,17909,1011,5.3
18,19,Clark,2006,55014,52317,2697,4.9
18,21,Clay,2006,13169,12433,736,5.6
18,23,Clinton,2006,17002,16158,844,5.0
18,25,Crawford,2006,5307,4934,373,7.0
18,27,Daviess,2006,15104,14566,538,3.6
18,29,Dearborn,2006,26484,25083,1401,5.3
18,31,Decatur,2006,12510,11973,537,4.3
18,33,DeKalb,2006,21506,20214,1292,6.0
18,35,Delaware,2006,56853,53506,3347,5.9
18,37,Dubois,2006,22388,21593,795,3.6
18,39,Elkhart,2006,104207,99377,4830,4.6
18,41,Fayette,2006,10827,9973,854,7.9
18,43,Floyd,2006,38191,36341,1850,4.8
18,45,Fountain,2006,8753,8336,417,4.8
18,47,Franklin,2006,12054,11361,693,5.7
18,49,Fulton,2006,10469,9918,551,5.3
18,51,Gibson,2006,17289,16521,768,4.4
18,53,Grant,2006,32876,30587,2289,7.0
18,55,Greene,2006,16642,15710,932,5.6
18,57,Hamilton,2006,137092,132689,4403,3.2
18,59,Hancock,2006,35676,34242,1434,4.0
18,61,Harrison,2006,19793,18738,1055,5.3
18,63,Hendricks,2006,71739,69161,2578,3.6
18,65,Henry,2006,22778,21469,1309,5.7
18,67,Howard,2006,38856,36338,2518,6.5
18,69,Huntington,2006,20604,19534,1070,5.2
18,71,Jackson,2006,22160,21203,957,4.3
18,73,Jasper,2006,15490,14714,776,5.0
18,75,Jay,2006,11763,11239,524,4.5
18,77,Jefferson,2006,17376,16540,836,4.8
18,79,Jennings,2006,13830,13035,795,5.7
18,81,Johnson,2006,72949,70151,2798,3.8
18,83,Knox,2006,19433,18524,909,4.7
18,85,Kosciusko,2006,41904,39888,2016,4.8
18,87,LaGrange,2006,17517,16624,893,5.1
18,89,Lake,2006,227340,214311,13029,5.7
18,91,LaPorte,2006,53230,50224,3006,5.6
18,93,Lawrence,2006,22816,21251,1565,6.9
18,95,Madison,2006,62279,58542,3737,6.0
18,97,Marion,2006,461590,439011,22579,4.9
18,99,Marshall,2006,23043,21826,1217,5.3
18,101,Martin,2006,5303,5047,256,4.8
18,103,Miami,2006,17091,16044,1047,6.1
18,105,Monroe,2006,67535,64680,2855,4.2
18,107,Montgomery,2006,19730,18917,813,4.1
18,109,Morgan,2006,37610,35928,1682,4.5
18,111,Newton,2006,7048,6701,347,4.9
18,113,Noble,2006,23631,22206,1425,6.0
18,115,Ohio,2006,3108,2945,163,5.2
18,117,Orange,2006,9588,8908,680,7.1
18,119,Owen,2006,11704,11089,615,5.3
18,121,Parke,2006,7940,7507,433,5.5
18,123,Perry,2006,9760,9267,493,5.1
18,125,Pike,2006,6176,5898,278,4.5
18,127,Porter,2006,82867,79280,3587,4.3
18,129,Posey,2006,13811,13212,599,4.3
18,131,Pulaski,2006,6867,6556,311,4.5
18,133,Putnam,2006,17721,16774,947,5.3
18,135,Randolph,2006,12895,12023,872,6.8
18,137,Ripley,2006,14409,13726,683,4.7
18,139,Rush,2006,9504,9082,422,4.4
18,141,St. Joseph,2006,134825,127956,6869,5.1
18,143,Scott,2006,11393,10665,728,6.4
18,145,Shelby,2006,23917,22869,1048,4.4
18,147,Spencer,2006,10636,10114,522,4.9
18,149,Starke,2006,10586,9899,687,6.5
18,151,Steuben,2006,16624,15580,1044,6.3
18,153,Sullivan,2006,9133,8587,546,6.0
18,155,Switzerland,2006,5681,5452,229,4.0
18,157,Tippecanoe,2006,80492,77095,3397,4.2
18,159,Tipton,2006,8026,7596,430,5.4
18,161,Union,2006,3903,3691,212,5.4
18,163,Vanderburgh,2006,91486,87155,4331,4.7
18,165,Vermillion,2006,8157,7632,525,6.4
18,167,Vigo,2006,50267,47105,3162,6.3
18,169,Wabash,2006,17732,16763,969,5.5
18,171,Warren,2006,4794,4603,191,4.0
18,173,Warrick,2006,30974,29690,1284,4.1
18,175,Washington,2006,14297,13423,874,6.1
18,177,Wayne,2006,34191,32212,1979,5.8
18,179,Wells,2006,15030,14385,645,4.3
18,181,White,2006,12159,11558,601,4.9
18,183,Whitley,2006,17961,17114,847,4.7
19,1,Adair,2006,4427,4286,141,3.2
19,3,Adams,2006,2057,1964,93,4.5
19,5,Allamakee,2006,8173,7800,373,4.6
19,7,Appanoose,2006,6343,6003,340,5.4
19,9,Audubon,2006,3278,3148,130,4.0
19,11,Benton,2006,14541,13968,573,3.9
19,13,Black Hawk,2006,72139,69384,2755,3.8
19,15,Boone,2006,15514,15062,452,2.9
19,17,Bremer,2006,13928,13486,442,3.2
19,19,Buchanan,2006,11252,10776,476,4.2
19,21,Buena Vista,2006,10499,10158,341,3.2
19,23,Butler,2006,8249,7914,335,4.1
19,25,Calhoun,2006,5263,5086,177,3.4
19,27,Carroll,2006,12411,12089,322,2.6
19,29,Cass,2006,7642,7320,322,4.2
19,31,Cedar,2006,10778,10432,346,3.2
19,33,Cerro Gordo,2006,26105,25091,1014,3.9
19,35,Cherokee,2006,6553,6283,270,4.1
19,37,Chickasaw,2006,6454,6165,289,4.5
19,39,Clarke,2006,4741,4549,192,4.0
19,41,Clay,2006,9750,9429,321,3.3
19,43,Clayton,2006,9678,9193,485,5.0
19,45,Clinton,2006,27146,26089,1057,3.9
19,47,Crawford,2006,9354,9070,284,3.0
19,49,Dallas,2006,31184,30305,879,2.8
19,51,Davis,2006,4137,3945,192,4.6
19,53,Decatur,2006,4229,4060,169,4.0
19,55,Delaware,2006,10721,10329,392,3.7
19,57,Des Moines,2006,21046,20055,991,4.7
19,59,Dickinson,2006,9968,9564,404,4.1
19,61,Dubuque,2006,51854,49961,1893,3.7
19,63,Emmet,2006,6036,5793,243,4.0
19,65,Fayette,2006,11052,10553,499,4.5
19,67,Floyd,2006,8792,8381,411,4.7
19,69,Franklin,2006,5836,5613,223,3.8
19,71,Fremont,2006,3959,3811,148,3.7
19,73,Greene,2006,5056,4860,196,3.9
19,75,Grundy,2006,6905,6696,209,3.0
19,77,Guthrie,2006,6045,5824,221,3.7
19,79,Hamilton,2006,8798,8486,312,3.5
19,81,Hancock,2006,6124,5905,219,3.6
19,83,Hardin,2006,9140,8800,340,3.7
19,85,Harrison,2006,8055,7712,343,4.3
19,87,Henry,2006,10587,10033,554,5.2
19,89,Howard,2006,5316,5127,189,3.6
19,91,Humboldt,2006,5180,5011,169,3.3
19,93,Ida,2006,3964,3830,134,3.4
19,95,Iowa,2006,8829,8508,321,3.6
19,97,Jackson,2006,11244,10709,535,4.8
19,99,Jasper,2006,18294,17363,931,5.1
19,101,Jefferson,2006,8300,7953,347,4.2
19,103,Johnson,2006,75535,73578,1957,2.6
19,105,Jones,2006,10503,10100,403,3.8
19,107,Keokuk,2006,5815,5581,234,4.0
19,109,Kossuth,2006,9038,8746,292,3.2
19,111,Lee,2006,17471,16394,1077,6.2
19,113,Linn,2006,116135,111935,4200,3.6
19,115,Louisa,2006,6425,6183,242,3.8
19,117,Lucas,2006,4940,4738,202,4.1
19,119,Lyon,2006,6660,6508,152,2.3
19,121,Madison,2006,8391,8062,329,3.9
19,123,Mahaska,2006,11817,11388,429,3.6
19,125,Marion,2006,17876,17259,617,3.5
19,127,Marshall,2006,20795,20026,769,3.7
19,129,Mills,2006,8413,8098,315,3.7
19,131,Mitchell,2006,5442,5259,183,3.4
19,133,Monona,2006,4660,4408,252,5.4
19,135,Monroe,2006,4208,4041,167,4.0
19,137,Montgomery,2006,5832,5510,322,5.5
19,139,Muscatine,2006,24028,23263,765,3.2
19,141,O'Brien,2006,7722,7490,232,3.0
19,143,Osceola,2006,3414,3297,117,3.4
19,145,Page,2006,8352,8032,320,3.8
19,147,Palo Alto,2006,5356,5184,172,3.2
19,149,Plymouth,2006,14396,13948,448,3.1
19,151,Pocahontas,2006,4097,3973,124,3.0
19,153,Polk,2006,233646,225718,7928,3.4
19,155,Pottawattamie,2006,49221,47063,2158,4.4
19,157,Poweshiek,2006,10616,10213,403,3.8
19,159,Ringgold,2006,2470,2372,98,4.0
19,161,Sac,2006,5877,5683,194,3.3
19,163,Scott,2006,88836,85488,3348,3.8
19,165,Shelby,2006,7409,7177,232,3.1
19,167,Sioux,2006,19319,18850,469,2.4
19,169,Story,2006,47786,46546,1240,2.6
19,171,Tama,2006,8956,8583,373,4.2
19,173,Taylor,2006,3394,3263,131,3.9
19,175,Union,2006,6470,6209,261,4.0
19,177,Van Buren,2006,3921,3754,167,4.3
19,179,Wapello,2006,18786,17947,839,4.5
19,181,Warren,2006,25303,24496,807,3.2
19,183,Washington,2006,12443,12075,368,3.0
19,185,Wayne,2006,3207,3080,127,4.0
19,187,Webster,2006,19803,19034,769,3.9
19,189,Winnebago,2006,5807,5603,204,3.5
19,191,Winneshiek,2006,12543,12097,446,3.6
19,193,Woodbury,2006,54127,51850,2277,4.2
19,195,Worth,2006,4577,4406,171,3.7
19,197,Wright,2006,7168,6912,256,3.6
20,1,Allen,2006,7536,7221,315,4.2
20,3,Anderson,2006,4167,3964,203,4.9
20,5,Atchison,2006,8726,8310,416,4.8
20,7,Barber,2006,2599,2514,85,3.3
20,9,Barton,2006,15410,14873,537,3.5
20,11,Bourbon,2006,9152,8794,358,3.9
20,13,Brown,2006,5678,5458,220,3.9
20,15,Butler,2006,32146,30662,1484,4.6
20,17,Chase,2006,1692,1624,68,4.0
20,19,Chautauqua,2006,1890,1794,96,5.1
20,21,Cherokee,2006,10695,10143,552,5.2
20,23,Cheyenne,2006,1477,1426,51,3.5
20,25,Clark,2006,1197,1159,38,3.2
20,27,Clay,2006,4959,4789,170,3.4
20,29,Cloud,2006,5886,5687,199,3.4
20,31,Coffey,2006,5316,5056,260,4.9
20,33,Comanche,2006,1088,1057,31,2.8
20,35,Cowley,2006,18160,17369,791,4.4
20,37,Crawford,2006,19339,18345,994,5.1
20,39,Decatur,2006,1679,1623,56,3.3
20,41,Dickinson,2006,10568,10145,423,4.0
20,43,Doniphan,2006,4497,4273,224,5.0
20,45,Douglas,2006,62580,60188,2392,3.8
20,47,Edwards,2006,1715,1663,52,3.0
20,49,Elk,2006,1465,1394,71,4.8
20,51,Ellis,2006,17202,16726,476,2.8
20,53,Ellsworth,2006,3660,3539,121,3.3
20,55,Finney,2006,18119,17487,632,3.5
20,57,Ford,2006,17084,16537,547,3.2
20,59,Franklin,2006,13776,13062,714,5.2
20,61,Geary,2006,11292,10696,596,5.3
20,63,Gove,2006,1523,1480,43,2.8
20,65,Graham,2006,1449,1402,47,3.2
20,67,Grant,2006,3914,3800,114,2.9
20,69,Gray,2006,3187,3095,92,2.9
20,71,Greeley,2006,734,711,23,3.1
20,73,Greenwood,2006,3530,3366,164,4.6
20,75,Hamilton,2006,1261,1220,41,3.3
20,77,Harper,2006,3436,3324,112,3.3
20,79,Harvey,2006,17913,17119,794,4.4
20,81,Haskell,2006,2100,2039,61,2.9
20,83,Hodgeman,2006,963,929,34,3.5
20,85,Jackson,2006,6918,6546,372,5.4
20,87,Jefferson,2006,9703,9239,464,4.8
20,89,Jewell,2006,1900,1841,59,3.1
20,91,Johnson,2006,292116,280010,12106,4.1
20,93,Kearny,2006,2022,1946,76,3.8
20,95,Kingman,2006,4378,4217,161,3.7
20,97,Kiowa,2006,1637,1588,49,3.0
20,99,Labette,2006,10779,10204,575,5.3
20,101,Lane,2006,1064,1027,37,3.5
20,103,Leavenworth,2006,32776,30930,1846,5.6
20,105,Lincoln,2006,1848,1783,65,3.5
20,107,Linn,2006,4812,4511,301,6.3
20,109,Logan,2006,1494,1446,48,3.2
20,111,Lyon,2006,19441,18625,816,4.2
20,113,McPherson,2006,17234,16650,584,3.4
20,115,Marion,2006,6784,6515,269,4.0
20,117,Marshall,2006,5787,5583,204,3.5
20,119,Meade,2006,2193,2125,68,3.1
20,121,Miami,2006,16275,15525,750,4.6
20,123,Mitchell,2006,3420,3301,119,3.5
20,125,Montgomery,2006,17717,16902,815,4.6
20,127,Morris,2006,2908,2781,127,4.4
20,129,Morton,2006,1725,1677,48,2.8
20,131,Nemaha,2006,5450,5268,182,3.3
20,133,Neosho,2006,9234,8870,364,3.9
20,135,Ness,2006,1695,1647,48,2.8
20,137,Norton,2006,2702,2612,90,3.3
20,139,Osage,2006,8716,8236,480,5.5
20,141,Osborne,2006,2251,2172,79,3.5
20,143,Ottawa,2006,3374,3256,118,3.5
20,145,Pawnee,2006,3984,3851,133,3.3
20,147,Phillips,2006,3093,2996,97,3.1
20,149,Pottawatomie,2006,11189,10815,374,3.3
20,151,Pratt,2006,5609,5441,168,3.0
20,153,Rawlins,2006,1313,1270,43,3.3
20,155,Reno,2006,32994,31508,1486,4.5
20,157,Republic,2006,2729,2630,99,3.6
20,159,Rice,2006,5617,5387,230,4.1
20,161,Riley,2006,34969,33794,1175,3.4
20,163,Rooks,2006,2710,2610,100,3.7
20,165,Rush,2006,1698,1637,61,3.6
20,167,Russell,2006,3472,3339,133,3.8
20,169,Saline,2006,30468,29312,1156,3.8
20,171,Scott,2006,2778,2698,80,2.9
20,173,Sedgwick,2006,245286,233990,11296,4.6
20,175,Seward,2006,10570,10215,355,3.4
20,177,Shawnee,2006,90379,86042,4337,4.8
20,179,Sheridan,2006,1508,1464,44,2.9
20,181,Sherman,2006,3672,3564,108,2.9
20,183,Smith,2006,2237,2162,75,3.4
20,185,Stafford,2006,2238,2158,80,3.6
20,187,Stanton,2006,1159,1127,32,2.8
20,189,Stevens,2006,2330,2250,80,3.4
20,191,Sumner,2006,11951,11384,567,4.7
20,193,Thomas,2006,4526,4394,132,2.9
20,195,Trego,2006,1744,1691,53,3.0
20,197,Wabaunsee,2006,3632,3495,137,3.8
20,199,Wallace,2006,896,868,28,3.1
20,201,Washington,2006,3359,3243,116,3.5
20,203,Wichita,2006,1251,1213,38,3.0
20,205,Wilson,2006,5611,5404,207,3.7
20,207,Woodson,2006,1668,1584,84,5.0
20,209,Wyandotte,2006,71809,66321,5488,7.6
21,1,Adair,2006,8879,8376,503,5.7
21,3,Allen,2006,8450,7904,546,6.5
21,5,Anderson,2006,11011,10441,570,5.2
21,7,Ballard,2006,4162,3908,254,6.1
21,9,Barren,2006,19553,18453,1100,5.6
21,11,Bath,2006,5118,4723,395,7.7
21,13,Bell,2006,9595,8850,745,7.8
21,15,Boone,2006,61274,58394,2880,4.7
21,17,Bourbon,2006,9816,9330,486,5.0
21,19,Boyd,2006,23061,21797,1264,5.5
21,21,Boyle,2006,12815,11957,858,6.7
21,23,Bracken,2006,4333,4087,246,5.7
21,25,Breathitt,2006,5658,5243,415,7.3
21,27,Breckinridge,2006,9068,8467,601,6.6
21,29,Bullitt,2006,38563,36297,2266,5.9
21,31,Butler,2006,5771,5318,453,7.8
21,33,Caldwell,2006,6643,6296,347,5.2
21,35,Calloway,2006,17975,16957,1018,5.7
21,37,Campbell,2006,45093,42789,2304,5.1
21,39,Carlisle,2006,2314,2175,139,6.0
21,41,Carroll,2006,5759,5444,315,5.5
21,43,Carter,2006,13693,12656,1037,7.6
21,45,Casey,2006,7475,6968,507,6.8
21,47,Christian,2006,26185,24463,1722,6.6
21,49,Clark,2006,17343,16401,942,5.4
21,51,Clay,2006,7056,6353,703,10.0
21,53,Clinton,2006,4499,4232,267,5.9
21,55,Crittenden,2006,4029,3783,246,6.1
21,57,Cumberland,2006,3014,2794,220,7.3
21,59,Daviess,2006,47188,44680,2508,5.3
21,61,Edmonson,2006,5408,5038,370,6.8
21,63,Elliott,2006,3091,2832,259,8.4
21,65,Estill,2006,6114,5716,398,6.5
21,67,Fayette,2006,148468,142044,6424,4.3
21,69,Fleming,2006,6626,6197,429,6.5
21,71,Floyd,2006,15188,14214,974,6.4
21,73,Franklin,2006,25315,24139,1176,4.6
21,75,Fulton,2006,2795,2584,211,7.5
21,77,Gallatin,2006,3968,3779,189,4.8
21,79,Garrard,2006,7613,7166,447,5.9
21,81,Grant,2006,12512,11843,669,5.3
21,83,Graves,2006,15805,14678,1127,7.1
21,85,Grayson,2006,11599,10637,962,8.3
21,87,Green,2006,5607,5295,312,5.6
21,89,Greenup,2006,17391,16385,1006,5.8
21,91,Hancock,2006,4225,3975,250,5.9
21,93,Hardin,2006,47685,45129,2556,5.4
21,95,Harlan,2006,10164,9352,812,8.0
21,97,Harrison,2006,9008,8520,488,5.4
21,99,Hart,2006,7953,7451,502,6.3
21,101,Henderson,2006,23112,21938,1174,5.1
21,103,Henry,2006,8029,7573,456,5.7
21,105,Hickman,2006,2062,1926,136,6.6
21,107,Hopkins,2006,23224,21888,1336,5.8
21,109,Jackson,2006,4646,4184,462,9.9
21,111,Jefferson,2006,354553,334468,20085,5.7
21,113,Jessamine,2006,22686,21620,1066,4.7
21,115,Johnson,2006,9637,9015,622,6.5
21,117,Kenton,2006,83659,79515,4144,5.0
21,119,Knott,2006,6484,6031,453,7.0
21,121,Knox,2006,12214,11384,830,6.8
21,123,Larue,2006,7120,6725,395,5.5
21,125,Laurel,2006,25829,24330,1499,5.8
21,127,Lawrence,2006,5809,5329,480,8.3
21,129,Lee,2006,2733,2532,201,7.4
21,131,Leslie,2006,3693,3371,322,8.7
21,133,Letcher,2006,9106,8422,684,7.5
21,135,Lewis,2006,5548,5097,451,8.1
21,137,Lincoln,2006,10827,10059,768,7.1
21,139,Livingston,2006,4901,4604,297,6.1
21,141,Logan,2006,12467,11749,718,5.8
21,143,Lyon,2006,3302,3082,220,6.7
21,145,McCracken,2006,31384,29706,1678,5.3
21,147,McCreary,2006,5968,5363,605,10.1
21,149,McLean,2006,4701,4348,353,7.5
21,151,Madison,2006,42678,40638,2040,4.8
21,153,Magoffin,2006,4320,3880,440,10.2
21,155,Marion,2006,10157,9630,527,5.2
21,157,Marshall,2006,14714,13821,893,6.1
21,159,Martin,2006,3593,3328,265,7.4
21,161,Mason,2006,8693,8238,455,5.2
21,163,Meade,2006,12001,11238,763,6.4
21,165,Menifee,2006,2650,2425,225,8.5
21,167,Mercer,2006,10572,9960,612,5.8
21,169,Metcalfe,2006,4486,4242,244,5.4
21,171,Monroe,2006,5025,4712,313,6.2
21,173,Montgomery,2006,12121,11395,726,6.0
21,175,Morgan,2006,4993,4558,435,8.7
21,177,Muhlenberg,2006,12992,11809,1183,9.1
21,179,Nelson,2006,21157,19923,1234,5.8
21,181,Nicholas,2006,2982,2782,200,6.7
21,183,Ohio,2006,11795,11087,708,6.0
21,185,Oldham,2006,27355,26009,1346,4.9
21,187,Owen,2006,5211,4925,286,5.5
21,189,Owsley,2006,1532,1406,126,8.2
21,191,Pendleton,2006,7503,7084,419,5.6
21,193,Perry,2006,11469,10684,785,6.8
21,195,Pike,2006,25047,23563,1484,5.9
21,197,Powell,2006,5598,5193,405,7.2
21,199,Pulaski,2006,27213,25452,1761,6.5
21,201,Robertson,2006,1049,993,56,5.3
21,203,Rockcastle,2006,7527,7015,512,6.8
21,205,Rowan,2006,12181,11483,698,5.7
21,207,Russell,2006,8172,7638,534,6.5
21,209,Scott,2006,21881,20856,1025,4.7
21,211,Shelby,2006,21026,19942,1084,5.2
21,213,Simpson,2006,8985,8469,516,5.7
21,215,Spencer,2006,8750,8229,521,6.0
21,217,Taylor,2006,13338,12708,630,4.7
21,219,Todd,2006,5125,4636,489,9.5
21,221,Trigg,2006,6698,6313,385,5.7
21,223,Trimble,2006,4433,4137,296,6.7
21,225,Union,2006,7168,6745,423,5.9
21,227,Warren,2006,56522,53811,2711,4.8
21,229,Washington,2006,5353,5044,309,5.8
21,231,Wayne,2006,8670,8089,581,6.7
21,233,Webster,2006,6634,6295,339,5.1
21,235,Whitley,2006,15377,14437,940,6.1
21,237,Wolfe,2006,2323,2104,219,9.4
21,239,Woodford,2006,13459,12892,567,4.2
22,1,Acadia Parish,2006,26119,25244,875,3.4
22,3,Allen Parish,2006,8761,8338,423,4.8
22,5,Ascension Parish,2006,47708,45910,1798,3.8
22,7,Assumption Parish,2006,10260,9743,517,5.0
22,9,Avoyelles Parish,2006,16083,15334,749,4.7
22,11,Beauregard Parish,2006,14560,13960,600,4.1
22,13,Bienville Parish,2006,6361,6067,294,4.6
22,15,Bossier Parish,2006,52455,50637,1818,3.5
22,17,Caddo Parish,2006,118700,113707,4993,4.2
22,19,Calcasieu Parish,2006,90583,87355,3228,3.6
22,21,Caldwell Parish,2006,4439,4263,176,4.0
22,23,Cameron Parish,2006,3695,3571,124,3.4
22,25,Catahoula Parish,2006,4175,3957,218,5.2
22,27,Claiborne Parish,2006,6926,6621,305,4.4
22,29,Concordia Parish,2006,7342,6903,439,6.0
22,31,De Soto Parish,2006,11398,10877,521,4.6
22,33,East Baton Rouge Parish,2006,214592,205942,8650,4.0
22,35,East Carroll Parish,2006,3139,2894,245,7.8
22,37,East Feliciana Parish,2006,8014,7655,359,4.5
22,39,Evangeline Parish,2006,12206,11682,524,4.3
22,41,Franklin Parish,2006,7835,7370,465,5.9
22,43,Grant Parish,2006,8726,8387,339,3.9
22,45,Iberia Parish,2006,34499,33291,1208,3.5
22,47,Iberville Parish,2006,12357,11644,713,5.8
22,49,Jackson Parish,2006,6555,6294,261,4.0
22,53,Jefferson Davis Parish,2006,14526,14078,448,3.1
22,55,Lafayette Parish,2006,108532,105388,3144,2.9
22,57,Lafourche Parish,2006,47283,45878,1405,3.0
22,59,LaSalle Parish,2006,6177,5974,203,3.3
22,61,Lincoln Parish,2006,18733,17913,820,4.4
22,63,Livingston Parish,2006,54608,52572,2036,3.7
22,65,Madison Parish,2006,4592,4326,266,5.8
22,67,Morehouse Parish,2006,11580,10861,719,6.2
22,69,Natchitoches Parish,2006,17952,17191,761,4.2
22,73,Ouachita Parish,2006,72383,69559,2824,3.9
22,77,Pointe Coupee Parish,2006,9558,9116,442,4.6
22,79,Rapides Parish,2006,60069,57814,2255,3.8
22,81,Red River Parish,2006,3268,3078,190,5.8
22,83,Richland Parish,2006,8637,8219,418,4.8
22,85,Sabine Parish,2006,9646,9296,350,3.6
22,91,St. Helena Parish,2006,4235,3926,309,7.3
22,93,St. James Parish,2006,8451,7927,524,6.2
22,97,St. Landry Parish,2006,37776,36211,1565,4.1
22,99,St. Martin Parish,2006,23354,22533,821,3.5
22,101,St. Mary Parish,2006,23299,22296,1003,4.3
22,105,Tangipahoa Parish,2006,51137,48730,2407,4.7
22,107,Tensas Parish,2006,2335,2165,170,7.3
22,109,Terrebonne Parish,2006,53046,51379,1667,3.1
22,111,Union Parish,2006,10416,9990,426,4.1
22,113,Vermilion Parish,2006,24135,23272,863,3.6
22,115,Vernon Parish,2006,21689,20885,804,3.7
22,117,Washington Parish,2006,15609,14764,845,5.4
22,119,Webster Parish,2006,19807,19001,806,4.1
22,121,West Baton Rouge Parish,2006,10479,10059,420,4.0
22,123,West Carroll Parish,2006,5078,4762,316,6.2
22,125,West Feliciana Parish,2006,4857,4619,238,4.9
22,127,Winn Parish,2006,6391,6125,266,4.2
23,1,Androscoggin,2006,57671,54929,2742,4.8
23,3,Aroostook,2006,35527,33150,2377,6.7
23,5,Cumberland,2006,155928,150522,5406,3.5
23,7,Franklin,2006,14387,13539,848,5.9
23,9,Hancock,2006,29773,28152,1621,5.4
23,11,Kennebec,2006,62939,60074,2865,4.6
23,13,Knox,2006,21394,20468,926,4.3
23,15,Lincoln,2006,18470,17669,801,4.3
23,17,Oxford,2006,28481,26819,1662,5.8
23,19,Penobscot,2006,77520,73561,3959,5.1
23,21,Piscataquis,2006,7534,7019,515,6.8
23,23,Sagadahoc,2006,18695,17930,765,4.1
23,25,Somerset,2006,25182,23429,1753,7.0
23,27,Waldo,2006,19518,18480,1038,5.3
23,29,Washington,2006,15177,14005,1172,7.7
23,31,York,2006,112554,108063,4491,4.0
24,1,Allegany,2006,35475,33317,2158,6.1
24,3,Anne Arundel,2006,279772,269707,10065,3.6
24,5,Baltimore,2006,428922,410696,18226,4.2
24,9,Calvert,2006,47339,45730,1609,3.4
24,11,Caroline,2006,16179,15417,762,4.7
24,13,Carroll,2006,94953,91711,3242,3.4
24,15,Cecil,2006,50999,48593,2406,4.7
24,17,Charles,2006,74909,72358,2551,3.4
24,19,Dorchester,2006,16904,15861,1043,6.2
24,21,Frederick,2006,123559,119363,4196,3.4
24,23,Garrett,2006,16893,16010,883,5.2
24,25,Harford,2006,133120,127923,5197,3.9
24,27,Howard,2006,159252,154345,4907,3.1
24,29,Kent,2006,11081,10616,465,4.2
24,31,Montgomery,2006,513720,497787,15933,3.1
24,33,Prince George's,2006,448104,428023,20081,4.5
24,35,Queen Anne's,2006,25967,25025,942,3.6
24,37,St. Mary's,2006,50803,48953,1850,3.6
24,39,Somerset,2006,11364,10687,677,6.0
24,41,Talbot,2006,19070,18332,738,3.9
24,43,Washington,2006,68813,65497,3316,4.8
24,45,Wicomico,2006,52558,50248,2310,4.4
24,47,Worcester,2006,28468,26620,1848,6.5
24,510,Baltimore city,2006,276223,257232,18991,6.9
25,1,Barnstable,2006,122208,116203,6005,4.9
25,3,Berkshire,2006,73335,70197,3138,4.3
25,5,Bristol,2006,290028,272882,17146,5.9
25,7,Dukes,2006,11050,10626,424,3.8
25,9,Essex,2006,373643,354728,18915,5.1
25,11,Franklin,2006,39628,37934,1694,4.3
25,13,Hampden,2006,224824,211771,13053,5.8
25,15,Hampshire,2006,88342,84891,3451,3.9
25,17,Middlesex,2006,810965,779272,31693,3.9
25,19,Nantucket/town,2006,8400,8209,191,2.3
25,21,Norfolk,2006,351908,337389,14519,4.1
25,23,Plymouth,2006,258284,245796,12488,4.8
25,25,Suffolk,2006,357769,340141,17628,4.9
25,27,Worcester,2006,401310,380991,20319,5.1
26,1,Alcona,2006,4455,3972,483,10.8
26,3,Alger,2006,4472,4108,364,8.1
26,5,Allegan,2006,56374,52823,3551,6.3
26,7,Alpena,2006,14958,13779,1179,7.9
26,9,Antrim,2006,11978,11015,963,8.0
26,11,Arenac,2006,7892,7084,808,10.2
26,13,Baraga,2006,4252,3765,487,11.5
26,15,Barry,2006,31072,29398,1674,5.4
26,17,Bay,2006,55694,51697,3997,7.2
26,19,Benzie,2006,9162,8434,728,7.9
26,21,Berrien,2006,78818,73105,5713,7.2
26,23,Branch,2006,22630,20900,1730,7.6
26,25,Calhoun,2006,70687,65599,5088,7.2
26,27,Cass,2006,27430,25911,1519,5.5
26,29,Charlevoix,2006,14284,13147,1137,8.0
26,31,Cheboygan,2006,12872,11565,1307,10.2
26,33,Chippewa,2006,17626,16071,1555,8.8
26,35,Clare,2006,13349,11918,1431,10.7
26,37,Clinton,2006,37982,35927,2055,5.4
26,39,Crawford,2006,6804,6267,537,7.9
26,41,Delta,2006,20516,18991,1525,7.4
26,43,Dickinson,2006,14476,13619,857,5.9
26,45,Eaton,2006,59107,55889,3218,5.4
26,47,Emmet,2006,19977,18216,1761,8.8
26,49,Genesee,2006,212030,194097,17933,8.5
26,51,Gladwin,2006,10944,9838,1106,10.1
26,53,Gogebic,2006,7772,7171,601,7.7
26,55,Grand Traverse,2006,49104,46054,3050,6.2
26,57,Gratiot,2006,20317,18518,1799,8.9
26,59,Hillsdale,2006,22357,20564,1793,8.0
26,61,Houghton,2006,17798,16535,1263,7.1
26,63,Huron,2006,17311,15863,1448,8.4
26,65,Ingham,2006,152947,142972,9975,6.5
26,67,Ionia,2006,31511,28847,2664,8.5
26,69,Iosco,2006,11169,10122,1047,9.4
26,71,Iron,2006,6000,5553,447,7.5
26,73,Isabella,2006,38118,36081,2037,5.3
26,75,Jackson,2006,78074,72261,5813,7.4
26,77,Kalamazoo,2006,133680,126502,7178,5.4
26,79,Kalkaska,2006,8874,8162,712,8.0
26,81,Kent,2006,324290,305325,18965,5.8
26,83,Keweenaw,2006,1073,962,111,10.3
26,85,Lake,2006,4216,3763,453,10.7
26,87,Lapeer,2006,45066,41582,3484,7.7
26,89,Leelanau,2006,11574,10969,605,5.2
26,91,Lenawee,2006,50114,46306,3808,7.6
26,93,Livingston,2006,95604,90613,4991,5.2
26,95,Luce,2006,2855,2631,224,7.8
26,97,Mackinac,2006,6538,5890,648,9.9
26,99,Macomb,2006,422430,392544,29886,7.1
26,101,Manistee,2006,12284,11216,1068,8.7
26,103,Marquette,2006,35907,33662,2245,6.3
26,105,Mason,2006,15070,13836,1234,8.2
26,107,Mecosta,2006,20365,18803,1562,7.7
26,109,Menominee,2006,13125,12260,865,6.6
26,111,Midland,2006,42273,39816,2457,5.8
26,113,Missaukee,2006,6707,6173,534,8.0
26,115,Monroe,2006,78614,73316,5298,6.7
26,117,Montcalm,2006,28393,24627,3766,13.3
26,119,Montmorency,2006,4348,3812,536,12.3
26,121,Muskegon,2006,90398,83952,6446,7.1
26,123,Newaygo,2006,23400,21661,1739,7.4
26,125,Oakland,2006,629731,593831,35900,5.7
26,127,Oceana,2006,14741,13453,1288,8.7
26,129,Ogemaw,2006,9829,9001,828,8.4
26,131,Ontonagon,2006,3526,3239,287,8.1
26,133,Osceola,2006,10230,9456,774,7.6
26,135,Oscoda,2006,4080,3638,442,10.8
26,137,Otsego,2006,12610,11535,1075,8.5
26,139,Ottawa,2006,137083,129539,7544,5.5
26,141,Presque Isle,2006,6225,5452,773,12.4
26,143,Roscommon,2006,10937,9895,1042,9.5
26,145,Saginaw,2006,98586,90963,7623,7.7
26,147,St. Clair,2006,84176,77491,6685,7.9
26,149,St. Joseph,2006,31509,29387,2122,6.7
26,151,Sanilac,2006,22590,20598,1992,8.8
26,153,Schoolcraft,2006,4071,3629,442,10.9
26,155,Shiawassee,2006,36739,33659,3080,8.4
26,157,Tuscola,2006,29269,26705,2564,8.8
26,159,Van Buren,2006,41194,38334,2860,6.9
26,161,Washtenaw,2006,189935,180816,9119,4.8
26,163,Wayne,2006,895246,821043,74203,8.3
26,165,Wexford,2006,14920,13667,1253,8.4
27,1,Aitkin,2006,7762,7298,464,6.0
27,3,Anoka,2006,190460,182946,7514,3.9
27,5,Becker,2006,16820,15952,868,5.2
27,7,Beltrami,2006,21110,20002,1108,5.2
27,9,Benton,2006,22346,21341,1005,4.5
27,11,Big Stone,2006,2810,2686,124,4.4
27,13,Blue Earth,2006,36007,34814,1193,3.3
27,15,Brown,2006,14883,14223,660,4.4
27,17,Carlton,2006,17156,16248,908,5.3
27,19,Carver,2006,49247,47606,1641,3.3
27,21,Cass,2006,14378,13454,924,6.4
27,23,Chippewa,2006,7140,6864,276,3.9
27,25,Chisago,2006,27427,26085,1342,4.9
27,27,Clay,2006,31291,30274,1017,3.3
27,29,Clearwater,2006,3799,3424,375,9.9
27,31,Cook,2006,3173,3031,142,4.5
27,33,Cottonwood,2006,6406,6119,287,4.5
27,35,Crow Wing,2006,32331,30721,1610,5.0
27,37,Dakota,2006,229098,220909,8189,3.6
27,39,Dodge,2006,11112,10695,417,3.8
27,41,Douglas,2006,20016,19238,778,3.9
27,43,Faribault,2006,7847,7493,354,4.5
27,45,Fillmore,2006,11214,10746,468,4.2
27,47,Freeborn,2006,16321,15591,730,4.5
27,49,Goodhue,2006,24821,23750,1071,4.3
27,51,Grant,2006,3041,2880,161,5.3
27,53,Hennepin,2006,649726,626236,23490,3.6
27,55,Houston,2006,11240,10754,486,4.3
27,57,Hubbard,2006,9559,9024,535,5.6
27,59,Isanti,2006,21447,20388,1059,4.9
27,61,Itasca,2006,22245,20888,1357,6.1
27,63,Jackson,2006,6666,6405,261,3.9
27,65,Kanabec,2006,7787,7238,549,7.1
27,67,Kandiyohi,2006,23219,22302,917,3.9
27,69,Kittson,2006,2584,2442,142,5.5
27,71,Koochiching,2006,6655,6210,445,6.7
27,73,Lac qui Parle,2006,4094,3939,155,3.8
27,75,Lake,2006,6082,5829,253,4.2
27,77,Lake of the Woods,2006,2391,2279,112,4.7
27,79,Le Sueur,2006,14175,13403,772,5.4
27,81,Lincoln,2006,3317,3195,122,3.7
27,83,Lyon,2006,14605,14119,486,3.3
27,85,McLeod,2006,20481,19648,833,4.1
27,87,Mahnomen,2006,2496,2355,141,5.6
27,89,Marshall,2006,5301,4934,367,6.9
27,91,Martin,2006,11203,10723,480,4.3
27,93,Meeker,2006,12397,11762,635,5.1
27,95,Mille Lacs,2006,12128,11301,827,6.8
27,97,Morrison,2006,17260,16296,964,5.6
27,99,Mower,2006,20171,19390,781,3.9
27,101,Murray,2006,5469,5253,216,3.9
27,103,Nicollet,2006,19340,18725,615,3.2
27,105,Nobles,2006,11199,10846,353,3.2
27,107,Norman,2006,3604,3422,182,5.0
27,109,Olmsted,2006,78610,75884,2726,3.5
27,111,Otter Tail,2006,29181,27743,1438,4.9
27,113,Pennington,2006,8364,7897,467,5.6
27,115,Pine,2006,13605,12711,894,6.6
27,117,Pipestone,2006,5100,4927,173,3.4
27,119,Polk,2006,17076,16271,805,4.7
27,121,Pope,2006,6183,5940,243,3.9
27,123,Ramsey,2006,268830,258254,10576,3.9
27,125,Red Lake,2006,2226,2075,151,6.8
27,127,Redwood,2006,8093,7760,333,4.1
27,129,Renville,2006,8291,7883,408,4.9
27,131,Rice,2006,31730,30341,1389,4.4
27,133,Rock,2006,4966,4825,141,2.8
27,135,Roseau,2006,10135,9487,648,6.4
27,137,St. Louis,2006,101927,96740,5187,5.1
27,139,Scott,2006,71849,69313,2536,3.5
27,141,Sherburne,2006,48095,45992,2103,4.4
27,143,Sibley,2006,8737,8365,372,4.3
27,145,Stearns,2006,81666,78357,3309,4.1
27,147,Steele,2006,20026,19222,804,4.0
27,149,Stevens,2006,5667,5473,194,3.4
27,151,Swift,2006,5302,5068,234,4.4
27,153,Todd,2006,12361,11713,648,5.2
27,155,Traverse,2006,1901,1819,82,4.3
27,157,Wabasha,2006,12477,11967,510,4.1
27,159,Wadena,2006,6300,5866,434,6.9
27,161,Waseca,2006,10507,10073,434,4.1
27,163,Washington,2006,127554,122964,4590,3.6
27,165,Watonwan,2006,5636,5386,250,4.4
27,167,Wilkin,2006,3560,3425,135,3.8
27,169,Winona,2006,28517,27489,1028,3.6
27,171,Wright,2006,64712,61905,2807,4.3
27,173,Yellow Medicine,2006,5575,5344,231,4.1
28,1,Adams,2006,13132,12261,871,6.6
28,3,Alcorn,2006,15319,14240,1079,7.0
28,5,Amite,2006,5116,4814,302,5.9
28,7,Attala,2006,7395,6842,553,7.5
28,9,Benton,2006,2914,2660,254,8.7
28,11,Bolivar,2006,15517,14284,1233,7.9
28,13,Calhoun,2006,6170,5712,458,7.4
28,15,Carroll,2006,4813,4540,273,5.7
28,17,Chickasaw,2006,7571,6926,645,8.5
28,19,Choctaw,2006,3437,3188,249,7.2
28,21,Claiborne,2006,3536,3166,370,10.5
28,23,Clarke,2006,7018,6602,416,5.9
28,25,Clay,2006,8113,7265,848,10.5
28,27,Coahoma,2006,10588,9634,954,9.0
28,29,Copiah,2006,12013,11212,801,6.7
28,31,Covington,2006,8531,8062,469,5.5
28,33,DeSoto,2006,73440,70593,2847,3.9
28,35,Forrest,2006,36159,34352,1807,5.0
28,37,Franklin,2006,3130,2928,202,6.5
28,39,George,2006,8752,7975,777,8.9
28,41,Greene,2006,4888,4535,353,7.2
28,43,Grenada,2006,9733,9135,598,6.1
28,45,Hancock,2006,18031,16365,1666,9.2
28,47,Harrison,2006,81857,73954,7903,9.7
28,49,Hinds,2006,117493,111034,6459,5.5
28,51,Holmes,2006,7097,6389,708,10.0
28,53,Humphreys,2006,4213,3848,365,8.7
28,55,Issaquena,2006,722,655,67,9.3
28,57,Itawamba,2006,10148,9527,621,6.1
28,59,Jackson,2006,57927,53594,4333,7.5
28,61,Jasper,2006,7465,7040,425,5.7
28,63,Jefferson,2006,2701,2374,327,12.1
28,65,Jefferson Davis,2006,5186,4813,373,7.2
28,67,Jones,2006,30789,29399,1390,4.5
28,69,Kemper,2006,4088,3763,325,8.0
28,71,Lafayette,2006,21531,20579,952,4.4
28,73,Lamar,2006,23068,22142,926,4.0
28,75,Lauderdale,2006,32789,30801,1988,6.1
28,77,Lawrence,2006,5035,4671,364,7.2
28,79,Leake,2006,8160,7628,532,6.5
28,81,Lee,2006,37492,35347,2145,5.7
28,83,Leflore,2006,13682,12558,1124,8.2
28,85,Lincoln,2006,14210,13391,819,5.8
28,87,Lowndes,2006,25388,23746,1642,6.5
28,89,Madison,2006,44152,42197,1955,4.4
28,91,Marion,2006,10243,9613,630,6.2
28,93,Marshall,2006,14879,13766,1113,7.5
28,95,Monroe,2006,16514,15129,1385,8.4
28,97,Montgomery,2006,4527,4133,394,8.7
28,99,Neshoba,2006,14250,13577,673,4.7
28,101,Newton,2006,9505,8983,522,5.5
28,103,Noxubee,2006,4058,3608,450,11.1
28,105,Oktibbeha,2006,19619,18551,1068,5.4
28,107,Panola,2006,14739,13655,1084,7.4
28,109,Pearl River,2006,20328,19034,1294,6.4
28,111,Perry,2006,5078,4751,327,6.4
28,113,Pike,2006,15345,14377,968,6.3
28,115,Pontotoc,2006,13194,12451,743,5.6
28,117,Prentiss,2006,11077,10318,759,6.9
28,119,Quitman,2006,3840,3532,308,8.0
28,121,Rankin,2006,71452,68656,2796,3.9
28,123,Scott,2006,13172,12497,675,5.1
28,125,Sharkey,2006,2515,2290,225,8.9
28,127,Simpson,2006,11576,10960,616,5.3
28,129,Smith,2006,6726,6373,353,5.2
28,131,Stone,2006,7201,6680,521,7.2
28,133,Sunflower,2006,11078,10102,976,8.8
28,135,Tallahatchie,2006,6106,5667,439,7.2
28,137,Tate,2006,11654,10914,740,6.3
28,139,Tippah,2006,9245,8637,608,6.6
28,141,Tishomingo,2006,8048,7488,560,7.0
28,143,Tunica,2006,4319,3983,336,7.8
28,145,Union,2006,11490,10832,658,5.7
28,147,Walthall,2006,5781,5419,362,6.3
28,149,Warren,2006,22228,20978,1250,5.6
28,151,Washington,2006,21955,19955,2000,9.1
28,153,Wayne,2006,8461,7964,497,5.9
28,155,Webster,2006,3386,3123,263,7.8
28,157,Wilkinson,2006,3479,3211,268,7.7
28,159,Winston,2006,7870,7356,514,6.5
28,161,Yalobusha,2006,5233,4849,384,7.3
28,163,Yazoo,2006,9945,9138,807,8.1
29,1,Adair,2006,13759,13163,596,4.3
29,3,Andrew,2006,10217,9802,415,4.1
29,5,Atchison,2006,3165,3040,125,3.9
29,7,Audrain,2006,12126,11587,539,4.4
29,9,Barry,2006,17830,17102,728,4.1
29,11,Barton,2006,6097,5781,316,5.2
29,13,Bates,2006,7960,7506,454,5.7
29,15,Benton,2006,8545,8077,468,5.5
29,17,Bollinger,2006,5876,5553,323,5.5
29,19,Boone,2006,86930,84059,2871,3.3
29,21,Buchanan,2006,46641,44505,2136,4.6
29,23,Butler,2006,21875,20707,1168,5.3
29,25,Caldwell,2006,4400,4166,234,5.3
29,27,Callaway,2006,22650,21658,992,4.4
29,29,Camden,2006,22378,21314,1064,4.8
29,31,Cape Girardeau,2006,38713,37110,1603,4.1
29,33,Carroll,2006,5297,5053,244,4.6
29,35,Carter,2006,2971,2795,176,5.9
29,37,Cass,2006,49486,47211,2275,4.6
29,39,Cedar,2006,6385,6057,328,5.1
29,41,Chariton,2006,4071,3865,206,5.1
29,43,Christian,2006,39215,37738,1477,3.8
29,45,Clark,2006,3584,3404,180,5.0
29,47,Clay,2006,114060,109141,4919,4.3
29,49,Clinton,2006,10301,9791,510,5.0
29,51,Cole,2006,40080,38549,1531,3.8
29,53,Cooper,2006,9132,8739,393,4.3
29,55,Crawford,2006,12105,11404,701,5.8
29,57,Dade,2006,3888,3706,182,4.7
29,59,Dallas,2006,7596,7206,390,5.1
29,61,Daviess,2006,4106,3924,182,4.4
29,63,DeKalb,2006,5209,4929,280,5.4
29,65,Dent,2006,6676,6282,394,5.9
29,67,Douglas,2006,6019,5696,323,5.4
29,69,Dunklin,2006,14607,13573,1034,7.1
29,71,Franklin,2006,52924,50113,2811,5.3
29,73,Gasconade,2006,8193,7747,446,5.4
29,75,Gentry,2006,3402,3264,138,4.1
29,77,Greene,2006,139592,134328,5264,3.8
29,79,Grundy,2006,4865,4643,222,4.6
29,81,Harrison,2006,4594,4381,213,4.6
29,83,Henry,2006,10895,10335,560,5.1
29,85,Hickory,2006,3419,3181,238,7.0
29,87,Holt,2006,2712,2604,108,4.0
29,89,Howard,2006,5391,5151,240,4.5
29,91,Howell,2006,20054,19210,844,4.2
29,93,Iron,2006,5026,4751,275,5.5
29,95,Jackson,2006,336074,316802,19272,5.7
29,97,Jasper,2006,55829,53440,2389,4.3
29,99,Jefferson,2006,117089,111348,5741,4.9
29,101,Johnson,2006,26637,25570,1067,4.0
29,103,Knox,2006,2362,2270,92,3.9
29,105,Laclede,2006,17651,16815,836,4.7
29,107,Lafayette,2006,16711,15906,805,4.8
29,109,Lawrence,2006,19338,18584,754,3.9
29,111,Lewis,2006,5816,5598,218,3.7
29,113,Lincoln,2006,25796,24434,1362,5.3
29,115,Linn,2006,6613,6183,430,6.5
29,117,Livingston,2006,7115,6811,304,4.3
29,119,McDonald,2006,11941,11477,464,3.9
29,121,Macon,2006,8307,7906,401,4.8
29,123,Madison,2006,6038,5714,324,5.4
29,125,Maries,2006,4879,4659,220,4.5
29,127,Marion,2006,14512,13798,714,4.9
29,129,Mercer,2006,1855,1775,80,4.3
29,131,Miller,2006,13594,12887,707,5.2
29,133,Mississippi,2006,5937,5556,381,6.4
29,135,Moniteau,2006,7489,7140,349,4.7
29,137,Monroe,2006,4418,4179,239,5.4
29,139,Montgomery,2006,6306,5962,344,5.5
29,141,Morgan,2006,9577,8941,636,6.6
29,143,New Madrid,2006,8756,8193,563,6.4
29,145,Newton,2006,28175,26898,1277,4.5
29,147,Nodaway,2006,12646,12218,428,3.4
29,149,Oregon,2006,4380,4166,214,4.9
29,151,Osage,2006,7455,7112,343,4.6
29,153,Ozark,2006,4471,4262,209,4.7
29,155,Pemiscot,2006,8183,7641,542,6.6
29,157,Perry,2006,10529,10161,368,3.5
29,159,Pettis,2006,20746,19694,1052,5.1
29,161,Phelps,2006,22546,21567,979,4.3
29,163,Pike,2006,8990,8527,463,5.2
29,165,Platte,2006,47843,45945,1898,4.0
29,167,Polk,2006,14343,13706,637,4.4
29,169,Pulaski,2006,18608,17711,897,4.8
29,171,Putnam,2006,2562,2436,126,4.9
29,173,Ralls,2006,5649,5372,277,4.9
29,175,Randolph,2006,13220,12569,651,4.9
29,177,Ray,2006,11762,11150,612,5.2
29,179,Reynolds,2006,2558,2384,174,6.8
29,181,Ripley,2006,6670,6287,383,5.7
29,183,St. Charles,2006,191182,183689,7493,3.9
29,185,St. Clair,2006,4382,4135,247,5.6
29,186,Ste. Genevieve,2006,9883,9427,456,4.6
29,187,St. Francois,2006,28432,26758,1674,5.9
29,189,St. Louis,2006,532866,507666,25200,4.7
29,195,Saline,2006,12011,11462,549,4.6
29,197,Schuyler,2006,2313,2193,120,5.2
29,199,Scotland,2006,2487,2380,107,4.3
29,201,Scott,2006,20549,19462,1087,5.3
29,203,Shannon,2006,3775,3527,248,6.6
29,205,Shelby,2006,3243,3074,169,5.2
29,207,Stoddard,2006,15928,15030,898,5.6
29,209,Stone,2006,16414,15315,1099,6.7
29,211,Sullivan,2006,3380,3195,185,5.5
29,213,Taney,2006,26393,24555,1838,7.0
29,215,Texas,2006,10748,10166,582,5.4
29,217,Vernon,2006,10199,9750,449,4.4
29,219,Warren,2006,15885,15035,850,5.4
29,221,Washington,2006,10028,9221,807,8.0
29,223,Wayne,2006,5758,5393,365,6.3
29,225,Webster,2006,17116,16387,729,4.3
29,227,Worth,2006,1168,1123,45,3.9
29,229,Wright,2006,8228,7807,421,5.1
29,510,St. Louis city,2006,157304,146397,10907,6.9
30,1,Beaverhead,2006,5070,4924,146,2.9
30,3,Big Horn,2006,5006,4678,328,6.6
30,5,Blaine,2006,2822,2730,92,3.3
30,7,Broadwater,2006,2305,2233,72,3.1
30,9,Carbon,2006,5408,5252,156,2.9
30,11,Carter,2006,668,646,22,3.3
30,13,Cascade,2006,39562,38290,1272,3.2
30,15,Chouteau,2006,2586,2517,69,2.7
30,17,Custer,2006,5712,5535,177,3.1
30,19,Daniels,2006,761,738,23,3.0
30,21,Dawson,2006,4171,4054,117,2.8
30,23,Deer Lodge,2006,3902,3719,183,4.7
30,25,Fallon,2006,1773,1740,33,1.9
30,27,Fergus,2006,5761,5532,229,4.0
30,29,Flathead,2006,44355,42714,1641,3.7
30,31,Gallatin,2006,49392,48247,1145,2.3
30,33,Garfield,2006,640,618,22,3.4
30,35,Glacier,2006,5991,5602,389,6.5
30,37,Golden Valley,2006,530,511,19,3.6
30,39,Granite,2006,1249,1195,54,4.3
30,41,Hill,2006,7926,7634,292,3.7
30,43,Jefferson,2006,5758,5559,199,3.5
30,45,Judith Basin,2006,1045,1011,34,3.3
30,47,Lake,2006,11538,11001,537,4.7
30,49,Lewis and Clark,2006,31891,30915,976,3.1
30,51,Liberty,2006,827,802,25,3.0
30,53,Lincoln,2006,7733,7228,505,6.5
30,55,McCone,2006,998,973,25,2.5
30,57,Madison,2006,4102,3981,121,2.9
30,59,Meagher,2006,906,868,38,4.2
30,61,Mineral,2006,1962,1869,93,4.7
30,63,Missoula,2006,58857,57074,1783,3.0
30,65,Musselshell,2006,2082,2002,80,3.8
30,67,Park,2006,9265,8974,291,3.1
30,69,Petroleum,2006,226,216,10,4.4
30,71,Phillips,2006,2075,1999,76,3.7
30,73,Pondera,2006,2746,2641,105,3.8
30,75,Powder River,2006,899,871,28,3.1
30,77,Powell,2006,2667,2539,128,4.8
30,79,Prairie,2006,551,530,21,3.8
30,81,Ravalli,2006,18697,17943,754,4.0
30,83,Richland,2006,5125,4993,132,2.6
30,85,Roosevelt,2006,3899,3673,226,5.8
30,87,Rosebud,2006,3871,3665,206,5.3
30,89,Sanders,2006,4670,4435,235,5.0
30,91,Sheridan,2006,1720,1670,50,2.9
30,93,Silver Bow,2006,17343,16723,620,3.6
30,95,Stillwater,2006,4450,4330,120,2.7
30,97,Sweet Grass,2006,2826,2780,46,1.6
30,99,Teton,2006,3033,2943,90,3.0
30,101,Toole,2006,2487,2422,65,2.6
30,103,Treasure,2006,398,385,13,3.3
30,105,Valley,2006,3588,3476,112,3.1
30,107,Wheatland,2006,1012,984,28,2.8
30,109,Wibaux,2006,499,486,13,2.6
30,111,Yellowstone,2006,79839,77659,2180,2.7
31,1,Adams,2006,16789,16310,479,2.9
31,3,Antelope,2006,3765,3660,105,2.8
31,5,Arthur,2006,255,246,9,3.5
31,7,Banner,2006,419,409,10,2.4
31,9,Blaine,2006,270,262,8,3.0
31,11,Boone,2006,3169,3090,79,2.5
31,13,Box Butte,2006,5534,5369,165,3.0
31,15,Boyd,2006,1120,1085,35,3.1
31,17,Brown,2006,1906,1852,54,2.8
31,19,Buffalo,2006,27500,26890,610,2.2
31,21,Burt,2006,3898,3742,156,4.0
31,23,Butler,2006,4737,4611,126,2.7
31,25,Cass,2006,14007,13546,461,3.3
31,27,Cedar,2006,4917,4805,112,2.3
31,29,Chase,2006,2102,2052,50,2.4
31,31,Cherry,2006,3626,3547,79,2.2
31,33,Cheyenne,2006,5214,5092,122,2.3
31,35,Clay,2006,3099,3008,91,2.9
31,37,Colfax,2006,5708,5578,130,2.3
31,39,Cuming,2006,5066,4915,151,3.0
31,41,Custer,2006,6141,5997,144,2.3
31,43,Dakota,2006,10622,10202,420,4.0
31,45,Dawes,2006,4668,4538,130,2.8
31,47,Dawson,2006,12418,12031,387,3.1
31,49,Deuel,2006,1070,1042,28,2.6
31,51,Dixon,2006,3139,3043,96,3.1
31,53,Dodge,2006,19673,19004,669,3.4
31,55,Douglas,2006,265693,256578,9115,3.4
31,57,Dundy,2006,1036,1003,33,3.2
31,59,Fillmore,2006,3308,3221,87,2.6
31,61,Franklin,2006,1855,1798,57,3.1
31,63,Frontier,2006,1771,1733,38,2.1
31,65,Furnas,2006,2480,2407,73,2.9
31,67,Gage,2006,12681,12217,464,3.7
31,69,Garden,2006,1016,987,29,2.9
31,71,Garfield,2006,1051,1025,26,2.5
31,73,Gosper,2006,1037,1008,29,2.8
31,75,Grant,2006,412,403,9,2.2
31,77,Greeley,2006,1340,1301,39,2.9
31,79,Hall,2006,30440,29515,925,3.0
31,81,Hamilton,2006,5430,5311,119,2.2
31,83,Harlan,2006,1792,1747,45,2.5
31,85,Hayes,2006,496,481,15,3.0
31,87,Hitchcock,2006,1486,1435,51,3.4
31,89,Holt,2006,6166,6002,164,2.7
31,91,Hooker,2006,501,487,14,2.8
31,93,Howard,2006,3712,3609,103,2.8
31,95,Jefferson,2006,4381,4242,139,3.2
31,97,Johnson,2006,3218,3122,96,3.0
31,99,Kearney,2006,3882,3794,88,2.3
31,101,Keith,2006,4747,4627,120,2.5
31,103,Keya Paha,2006,427,415,12,2.8
31,105,Kimball,2006,2023,1969,54,2.7
31,107,Knox,2006,4811,4668,143,3.0
31,109,Lancaster,2006,156015,151697,4318,2.8
31,111,Lincoln,2006,21204,20621,583,2.7
31,113,Logan,2006,454,444,10,2.2
31,115,Loup,2006,354,341,13,3.7
31,117,McPherson,2006,287,281,6,2.1
31,119,Madison,2006,19313,18609,704,3.6
31,121,Merrick,2006,4267,4118,149,3.5
31,123,Morrill,2006,2802,2730,72,2.6
31,125,Nance,2006,2013,1956,57,2.8
31,127,Nemaha,2006,3555,3414,141,4.0
31,129,Nuckolls,2006,2342,2279,63,2.7
31,131,Otoe,2006,8740,8463,277,3.2
31,133,Pawnee,2006,1624,1575,49,3.0
31,135,Perkins,2006,1584,1550,34,2.1
31,137,Phelps,2006,5182,5067,115,2.2
31,139,Pierce,2006,4052,3936,116,2.9
31,141,Platte,2006,17623,17141,482,2.7
31,143,Polk,2006,3050,2968,82,2.7
31,145,Red Willow,2006,5958,5800,158,2.7
31,147,Richardson,2006,4367,4192,175,4.0
31,149,Rock,2006,952,930,22,2.3
31,151,Saline,2006,8189,7970,219,2.7
31,153,Sarpy,2006,74206,72074,2132,2.9
31,155,Saunders,2006,10973,10645,328,3.0
31,157,Scotts Bluff,2006,19053,18430,623,3.3
31,159,Seward,2006,9248,9003,245,2.6
31,161,Sheridan,2006,3243,3159,84,2.6
31,163,Sherman,2006,1880,1829,51,2.7
31,165,Sioux,2006,747,726,21,2.8
31,167,Stanton,2006,3611,3502,109,3.0
31,169,Thayer,2006,2904,2832,72,2.5
31,171,Thomas,2006,393,381,12,3.1
31,173,Thurston,2006,3008,2806,202,6.7
31,175,Valley,2006,2569,2506,63,2.5
31,177,Washington,2006,11249,10935,314,2.8
31,179,Wayne,2006,5459,5324,135,2.5
31,181,Webster,2006,1994,1944,50,2.5
31,183,Wheeler,2006,453,442,11,2.4
31,185,York,2006,8502,8299,203,2.4
32,1,Churchill,2006,12849,12313,536,4.2
32,3,Clark,2006,922327,885378,36949,4.0
32,5,Douglas,2006,22377,21358,1019,4.6
32,7,Elko,2006,24805,23956,849,3.4
32,9,Esmeralda,2006,470,451,19,4.0
32,11,Eureka,2006,713,687,26,3.6
32,13,Humboldt,2006,8112,7819,293,3.6
32,15,Lander,2006,2785,2677,108,3.9
32,17,Lincoln,2006,1618,1544,74,4.6
32,19,Lyon,2006,21336,20068,1268,5.9
32,21,Mineral,2006,2066,1927,139,6.7
32,23,Nye,2006,17259,16307,952,5.5
32,27,Pershing,2006,2454,2334,120,4.9
32,29,Storey,2006,2360,2262,98,4.2
32,31,Washoe,2006,217767,209394,8373,3.8
32,33,White Pine,2006,4495,4330,165,3.7
32,510,Carson City,2006,27721,26458,1263,4.6
33,1,Belknap,2006,32537,31433,1104,3.4
33,3,Carroll,2006,25345,24502,843,3.3
33,5,Cheshire,2006,42512,41105,1407,3.3
33,7,Coos,2006,16835,16119,716,4.3
33,9,Grafton,2006,47880,46475,1405,2.9
33,11,Hillsborough,2006,226713,218458,8255,3.6
33,13,Merrimack,2006,79608,77056,2552,3.2
33,15,Rockingham,2006,171678,165068,6610,3.9
33,17,Strafford,2006,66896,64730,2166,3.2
33,19,Sullivan,2006,22383,21713,670,3.0
34,1,Atlantic,2006,138235,130412,7823,5.7
34,3,Bergen,2006,470282,452238,18044,3.8
34,5,Burlington,2006,239895,230077,9818,4.1
34,7,Camden,2006,264757,251032,13725,5.2
34,9,Cape May,2006,57437,53513,3924,6.8
34,11,Cumberland,2006,69058,64298,4760,6.9
34,13,Essex,2006,361827,340913,20914,5.8
34,15,Gloucester,2006,152184,145096,7088,4.7
34,17,Hudson,2006,288343,272588,15755,5.5
34,19,Hunterdon,2006,71972,69593,2379,3.3
34,21,Mercer,2006,195187,186940,8247,4.2
34,23,Middlesex,2006,419191,401149,18042,4.3
34,25,Monmouth,2006,327011,313682,13329,4.1
34,27,Morris,2006,270523,261585,8938,3.3
34,29,Ocean,2006,254642,242132,12510,4.9
34,31,Passaic,2006,235674,222574,13100,5.6
34,33,Salem,2006,31468,29899,1569,5.0
34,35,Somerset,2006,179213,173091,6122,3.4
34,37,Sussex,2006,83876,80455,3421,4.1
34,39,Union,2006,266811,253924,12887,4.8
34,41,Warren,2006,59060,56656,2404,4.1
35,1,Bernalillo,2006,306217,294374,11843,3.9
35,3,Catron,2006,1429,1351,78,5.5
35,5,Chaves,2006,26250,25086,1164,4.4
35,6,Cibola,2006,11915,11368,547,4.6
35,7,Colfax,2006,6438,6156,282,4.4
35,9,Curry,2006,20646,19931,715,3.5
35,11,De Baca,2006,796,762,34,4.3
35,13,Dona Ana,2006,84538,80574,3964,4.7
35,15,Eddy,2006,24774,23888,886,3.6
35,17,Grant,2006,12051,11533,518,4.3
35,19,Guadalupe,2006,1838,1740,98,5.3
35,21,Harding,2006,359,344,15,4.2
35,23,Hidalgo,2006,2400,2314,86,3.6
35,25,Lea,2006,26213,25393,820,3.1
35,27,Lincoln,2006,10351,9945,406,3.9
35,28,Los Alamos,2006,10942,10676,266,2.4
35,29,Luna,2006,12149,10825,1324,10.9
35,31,McKinley,2006,26228,24759,1469,5.6
35,33,Mora,2006,1976,1802,174,8.8
35,35,Otero,2006,25663,24573,1090,4.2
35,37,Quay,2006,3885,3704,181,4.7
35,39,Rio Arriba,2006,20396,19374,1022,5.0
35,41,Roosevelt,2006,9196,8908,288,3.1
35,43,Sandoval,2006,52155,49904,2251,4.3
35,45,San Juan,2006,54550,52192,2358,4.3
35,47,San Miguel,2006,13186,12551,635,4.8
35,49,Santa Fe,2006,76201,73587,2614,3.4
35,51,Sierra,2006,5337,5100,237,4.4
35,53,Socorro,2006,9149,8810,339,3.7
35,55,Taos,2006,17360,16400,960,5.5
35,57,Torrance,2006,7472,7146,326,4.4
35,59,Union,2006,1871,1814,57,3.0
35,61,Valencia,2006,30537,29216,1321,4.3
36,1,Albany,2006,159526,153401,6125,3.8
36,3,Allegany,2006,23530,22308,1222,5.2
36,5,Bronx,2006,506580,473426,33154,6.5
36,7,Broome,2006,97035,92555,4480,4.6
36,9,Cattaraugus,2006,41942,39793,2149,5.1
36,11,Cayuga,2006,41515,39570,1945,4.7
36,13,Chautauqua,2006,67161,64133,3028,4.5
36,15,Chemung,2006,40867,38883,1984,4.9
36,17,Chenango,2006,24722,23516,1206,4.9
36,19,Clinton,2006,40080,37936,2144,5.3
36,21,Columbia,2006,32330,31138,1192,3.7
36,23,Cortland,2006,23785,22527,1258,5.3
36,25,Delaware,2006,23517,22511,1006,4.3
36,27,Dutchess,2006,147616,141987,5629,3.8
36,29,Erie,2006,471307,448164,23143,4.9
36,31,Essex,2006,18746,17705,1041,5.6
36,33,Franklin,2006,22666,21426,1240,5.5
36,35,Fulton,2006,27437,25997,1440,5.2
36,37,Genesee,2006,33132,31617,1515,4.6
36,39,Greene,2006,24109,22970,1139,4.7
36,41,Hamilton,2006,3120,2964,156,5.0
36,43,Herkimer,2006,31412,29859,1553,4.9
36,45,Jefferson,2006,48422,45776,2646,5.5
36,47,Kings,2006,1076540,1019861,56679,5.3
36,49,Lewis,2006,13047,12339,708,5.4
36,51,Livingston,2006,32889,31309,1580,4.8
36,53,Madison,2006,36100,34447,1653,4.6
36,55,Monroe,2006,375306,358987,16319,4.3
36,57,Montgomery,2006,24974,23544,1430,5.7
36,59,Nassau,2006,696705,670669,26036,3.7
36,61,New York,2006,911641,873023,38618,4.2
36,63,Niagara,2006,112252,106240,6012,5.4
36,65,Oneida,2006,110918,106104,4814,4.3
36,67,Onondaga,2006,234302,224282,10020,4.3
36,69,Ontario,2006,56840,54363,2477,4.4
36,71,Orange,2006,179973,172405,7568,4.2
36,73,Orleans,2006,19935,18813,1122,5.6
36,75,Oswego,2006,60292,56805,3487,5.8
36,77,Otsego,2006,31995,30588,1407,4.4
36,79,Putnam,2006,56200,54230,1970,3.5
36,81,Queens,2006,1094560,1046315,48245,4.4
36,83,Rensselaer,2006,83901,80483,3418,4.1
36,85,Richmond,2006,237278,226880,10398,4.4
36,87,Rockland,2006,152428,146753,5675,3.7
36,89,St. Lawrence,2006,49641,46797,2844,5.7
36,91,Saratoga,2006,120389,116152,4237,3.5
36,93,Schenectady,2006,76160,73058,3102,4.1
36,95,Schoharie,2006,15855,15046,809,5.1
36,97,Schuyler,2006,9973,9471,502,5.0
36,99,Seneca,2006,17341,16564,777,4.5
36,101,Steuben,2006,44716,42371,2345,5.2
36,103,Suffolk,2006,787335,756568,30767,3.9
36,105,Sullivan,2006,35396,33613,1783,5.0
36,107,Tioga,2006,26464,25328,1136,4.3
36,109,Tompkins,2006,55395,53511,1884,3.4
36,111,Ulster,2006,92584,88753,3831,4.1
36,113,Warren,2006,36515,34880,1635,4.5
36,115,Washington,2006,32898,31553,1345,4.1
36,117,Wayne,2006,48622,46353,2269,4.7
36,119,Westchester,2006,487586,469079,18507,3.8
36,121,Wyoming,2006,21833,20769,1064,4.9
36,123,Yates,2006,13060,12510,550,4.2
37,1,Alamance,2006,69908,65795,4113,5.9
37,3,Alexander,2006,18568,17605,963,5.2
37,5,Alleghany,2006,4969,4702,267,5.4
37,7,Anson,2006,10732,9863,869,8.1
37,9,Ashe,2006,12872,12093,779,6.1
37,11,Avery,2006,8048,7626,422,5.2
37,13,Beaufort,2006,20664,19392,1272,6.2
37,15,Bertie,2006,8776,8163,613,7.0
37,17,Bladen,2006,15308,14258,1050,6.9
37,19,Brunswick,2006,46693,44449,2244,4.8
37,21,Buncombe,2006,119106,114306,4800,4.0
37,23,Burke,2006,41727,39153,2574,6.2
37,25,Cabarrus,2006,80964,77365,3599,4.4
37,27,Caldwell,2006,40054,36838,3216,8.0
37,29,Camden,2006,4535,4326,209,4.6
37,31,Carteret,2006,33023,31553,1470,4.5
37,33,Caswell,2006,10775,9950,825,7.7
37,35,Catawba,2006,77706,73235,4471,5.8
37,37,Chatham,2006,32561,31211,1350,4.1
37,39,Cherokee,2006,10590,9978,612,5.8
37,41,Chowan,2006,7042,6665,377,5.4
37,43,Clay,2006,4699,4503,196,4.2
37,45,Cleveland,2006,48122,44843,3279,6.8
37,47,Columbus,2006,23767,22340,1427,6.0
37,49,Craven,2006,42098,40109,1989,4.7
37,51,Cumberland,2006,129553,122027,7526,5.8
37,53,Currituck,2006,12677,12218,459,3.6
37,55,Dare,2006,22496,21407,1089,4.8
37,57,Davidson,2006,80002,74969,5033,6.3
37,59,Davie,2006,20612,19689,923,4.5
37,61,Duplin,2006,23537,22228,1309,5.6
37,63,Durham,2006,134866,129189,5677,4.2
37,65,Edgecombe,2006,24432,22322,2110,8.6
37,67,Forsyth,2006,173584,165569,8015,4.6
37,69,Franklin,2006,26915,25697,1218,4.5
37,71,Gaston,2006,98478,92635,5843,5.9
37,73,Gates,2006,4974,4761,213,4.3
37,75,Graham,2006,4119,3837,282,6.8
37,77,Granville,2006,24358,22993,1365,5.6
37,79,Greene,2006,9148,8612,536,5.9
37,81,Guilford,2006,247493,235127,12366,5.0
37,83,Halifax,2006,24046,22367,1679,7.0
37,85,Harnett,2006,46905,44422,2483,5.3
37,87,Haywood,2006,27688,26483,1205,4.4
37,89,Henderson,2006,48027,46177,1850,3.9
37,91,Hertford,2006,9760,9177,583,6.0
37,93,Hoke,2006,19601,18474,1127,5.7
37,95,Hyde,2006,2692,2537,155,5.8
37,97,Iredell,2006,76912,73280,3632,4.7
37,99,Jackson,2006,21584,20741,843,3.9
37,101,Johnston,2006,74308,71140,3168,4.3
37,103,Jones,2006,4824,4587,237,4.9
37,105,Lee,2006,26347,24815,1532,5.8
37,107,Lenoir,2006,27563,25904,1659,6.0
37,109,Lincoln,2006,37974,35925,2049,5.4
37,111,McDowell,2006,21174,19782,1392,6.6
37,113,Macon,2006,16173,15407,766,4.7
37,115,Madison,2006,9966,9520,446,4.5
37,117,Martin,2006,11974,11268,706,5.9
37,119,Mecklenburg,2006,446863,425344,21519,4.8
37,121,Mitchell,2006,7603,7094,509,6.7
37,123,Montgomery,2006,12252,11365,887,7.2
37,125,Moore,2006,36489,34616,1873,5.1
37,127,Nash,2006,45007,42344,2663,5.9
37,129,New Hanover,2006,101989,97929,4060,4.0
37,131,Northampton,2006,9035,8478,557,6.2
37,133,Onslow,2006,58402,55603,2799,4.8
37,135,Orange,2006,67274,64873,2401,3.6
37,137,Pamlico,2006,5665,5385,280,4.9
37,139,Pasquotank,2006,17902,16938,964,5.4
37,141,Pender,2006,23475,22420,1055,4.5
37,143,Perquimans,2006,5285,4986,299,5.7
37,145,Person,2006,19255,17967,1288,6.7
37,147,Pitt,2006,76483,72173,4310,5.6
37,149,Polk,2006,9415,9060,355,3.8
37,151,Randolph,2006,76737,72930,3807,5.0
37,153,Richmond,2006,20337,18686,1651,8.1
37,155,Robeson,2006,54143,50544,3599,6.6
37,157,Rockingham,2006,46280,43326,2954,6.4
37,159,Rowan,2006,69588,65857,3731,5.4
37,161,Rutherford,2006,29929,27434,2495,8.3
37,163,Sampson,2006,31345,29806,1539,4.9
37,165,Scotland,2006,14905,13487,1418,9.5
37,167,Stanly,2006,30158,28505,1653,5.5
37,169,Stokes,2006,24345,23214,1131,4.6
37,171,Surry,2006,35108,33169,1939,5.5
37,173,Swain,2006,7287,6846,441,6.1
37,175,Transylvania,2006,12667,12092,575,4.5
37,177,Tyrrell,2006,2130,1998,132,6.2
37,179,Union,2006,89219,85420,3799,4.3
37,181,Vance,2006,18884,17364,1520,8.0
37,183,Wake,2006,428162,411379,16783,3.9
37,185,Warren,2006,7926,7384,542,6.8
37,187,Washington,2006,6148,5708,440,7.2
37,189,Watauga,2006,23909,22952,957,4.0
37,191,Wayne,2006,52293,49651,2642,5.1
37,193,Wilkes,2006,31541,29706,1835,5.8
37,195,Wilson,2006,39994,36940,3054,7.6
37,197,Yadkin,2006,19624,18720,904,4.6
37,199,Yancey,2006,7981,7501,480,6.0
38,1,Adams,2006,1311,1274,37,2.8
38,3,Barnes,2006,5973,5764,209,3.5
38,5,Benson,2006,2753,2594,159,5.8
38,7,Billings,2006,525,512,13,2.5
38,9,Bottineau,2006,3461,3337,124,3.6
38,11,Bowman,2006,1778,1740,38,2.1
38,13,Burke,2006,1022,997,25,2.4
38,15,Burleigh,2006,46009,44824,1185,2.6
38,17,Cass,2006,84530,82431,2099,2.5
38,19,Cavalier,2006,2148,2078,70,3.3
38,21,Dickey,2006,3031,2950,81,2.7
38,23,Divide,2006,960,925,35,3.6
38,25,Dunn,2006,1738,1682,56,3.2
38,27,Eddy,2006,1323,1258,65,4.9
38,29,Emmons,2006,1828,1742,86,4.7
38,31,Foster,2006,1727,1671,56,3.2
38,33,Golden Valley,2006,854,827,27,3.2
38,35,Grand Forks,2006,38591,37467,1124,2.9
38,37,Grant,2006,1248,1204,44,3.5
38,39,Griggs,2006,1326,1286,40,3.0
38,41,Hettinger,2006,1202,1161,41,3.4
38,43,Kidder,2006,1272,1214,58,4.6
38,45,LaMoure,2006,2277,2207,70,3.1
38,47,Logan,2006,959,929,30,3.1
38,49,McHenry,2006,2808,2672,136,4.8
38,51,McIntosh,2006,1468,1428,40,2.7
38,53,McKenzie,2006,2823,2735,88,3.1
38,55,McLean,2006,4674,4470,204,4.4
38,57,Mercer,2006,4787,4612,175,3.7
38,59,Morton,2006,14891,14417,474,3.2
38,61,Mountrail,2006,2915,2746,169,5.8
38,63,Nelson,2006,1691,1622,69,4.1
38,65,Oliver,2006,1101,1059,42,3.8
38,67,Pembina,2006,4112,3867,245,6.0
38,69,Pierce,2006,1928,1845,83,4.3
38,71,Ramsey,2006,5986,5752,234,3.9
38,73,Ransom,2006,3194,3073,121,3.8
38,75,Renville,2006,1343,1303,40,3.0
38,77,Richland,2006,9035,8731,304,3.4
38,79,Rolette,2006,5125,4670,455,8.9
38,81,Sargent,2006,2548,2453,95,3.7
38,83,Sheridan,2006,704,667,37,5.3
38,85,Sioux,2006,1336,1245,91,6.8
38,87,Slope,2006,530,518,12,2.3
38,89,Stark,2006,13767,13420,347,2.5
38,91,Steele,2006,1136,1109,27,2.4
38,93,Stutsman,2006,11964,11613,351,2.9
38,95,Towner,2006,1203,1142,61,5.1
38,97,Traill,2006,4257,4109,148,3.5
38,99,Walsh,2006,5851,5589,262,4.5
38,101,Ward,2006,28790,27920,870,3.0
38,103,Wells,2006,2202,2103,99,4.5
38,105,Williams,2006,12700,12448,252,2.0
39,1,Adams,2006,13307,12299,1008,7.6
39,3,Allen,2006,52958,49743,3215,6.1
39,5,Ashland,2006,27391,25883,1508,5.5
39,7,Ashtabula,2006,50106,46764,3342,6.7
39,9,Athens,2006,30548,28743,1805,5.9
39,11,Auglaize,2006,27214,26079,1135,4.2
39,13,Belmont,2006,32863,30951,1912,5.8
39,15,Brown,2006,22148,20627,1521,6.9
39,17,Butler,2006,190429,179654,10775,5.7
39,19,Carroll,2006,14081,13229,852,6.1
39,21,Champaign,2006,20881,19819,1062,5.1
39,23,Clark,2006,71176,67195,3981,5.6
39,25,Clermont,2006,105840,100438,5402,5.1
39,27,Clinton,2006,24312,23142,1170,4.8
39,29,Columbiana,2006,53660,50197,3463,6.5
39,31,Coshocton,2006,17689,16461,1228,6.9
39,33,Crawford,2006,22737,21269,1468,6.5
39,35,Cuyahoga,2006,649842,616482,33360,5.1
39,37,Darke,2006,28127,26543,1584,5.6
39,39,Defiance,2006,20733,19578,1155,5.6
39,41,Delaware,2006,88225,84789,3436,3.9
39,43,Erie,2006,43152,40630,2522,5.8
39,45,Fairfield,2006,75140,71529,3611,4.8
39,47,Fayette,2006,16470,15659,811,4.9
39,49,Franklin,2006,611086,582229,28857,4.7
39,51,Fulton,2006,23595,22198,1397,5.9
39,53,Gallia,2006,14779,13876,903,6.1
39,55,Geauga,2006,51025,48954,2071,4.1
39,57,Greene,2006,78560,74569,3991,5.1
39,59,Guernsey,2006,19917,18622,1295,6.5
39,61,Hamilton,2006,427909,406269,21640,5.1
39,63,Hancock,2006,41413,39585,1828,4.4
39,65,Hardin,2006,16003,15109,894,5.6
39,67,Harrison,2006,7480,7032,448,6.0
39,69,Henry,2006,16202,15223,979,6.0
39,71,Highland,2006,21615,20408,1207,5.6
39,73,Hocking,2006,14131,13257,874,6.2
39,75,Holmes,2006,19512,18768,744,3.8
39,77,Huron,2006,30256,28025,2231,7.4
39,79,Jackson,2006,16093,14897,1196,7.4
39,81,Jefferson,2006,31843,29642,2201,6.9
39,83,Knox,2006,30769,29217,1552,5.0
39,85,Lake,2006,131040,125288,5752,4.4
39,87,Lawrence,2006,29254,27713,1541,5.3
39,89,Licking,2006,83297,79037,4260,5.1
39,91,Logan,2006,25054,23888,1166,4.7
39,93,Lorain,2006,156506,148249,8257,5.3
39,95,Lucas,2006,227011,212674,14337,6.3
39,97,Madison,2006,20144,19086,1058,5.3
39,99,Mahoning,2006,120413,112699,7714,6.4
39,101,Marion,2006,32538,30783,1755,5.4
39,103,Medina,2006,93990,89907,4083,4.3
39,105,Meigs,2006,9217,8447,770,8.4
39,107,Mercer,2006,24279,23372,907,3.7
39,109,Miami,2006,55911,52891,3020,5.4
39,111,Monroe,2006,5185,4608,577,11.1
39,113,Montgomery,2006,273705,257246,16459,6.0
39,115,Morgan,2006,5773,5247,526,9.1
39,117,Morrow,2006,18028,17006,1022,5.7
39,119,Muskingum,2006,39449,36628,2821,7.2
39,121,Noble,2006,5904,5481,423,7.2
39,123,Ottawa,2006,22030,20499,1531,6.9
39,125,Paulding,2006,10662,10141,521,4.9
39,127,Perry,2006,16665,15437,1228,7.4
39,129,Pickaway,2006,24428,23013,1415,5.8
39,131,Pike,2006,10812,9855,957,8.9
39,133,Portage,2006,90760,86095,4665,5.1
39,135,Preble,2006,22188,20867,1321,6.0
39,137,Putnam,2006,17982,17138,844,4.7
39,139,Richland,2006,62928,59121,3807,6.0
39,141,Ross,2006,35016,32836,2180,6.2
39,143,Sandusky,2006,33567,31638,1929,5.7
39,145,Scioto,2006,31496,29109,2387,7.6
39,147,Seneca,2006,31591,29932,1659,5.3
39,149,Shelby,2006,28428,27222,1206,4.2
39,151,Stark,2006,190801,179745,11056,5.8
39,153,Summit,2006,295998,280325,15673,5.3
39,155,Trumbull,2006,106443,99791,6652,6.2
39,157,Tuscarawas,2006,48296,45855,2441,5.1
39,159,Union,2006,25304,24155,1149,4.5
39,161,Van Wert,2006,15666,14905,761,4.9
39,163,Vinton,2006,5745,5291,454,7.9
39,165,Warren,2006,107343,102062,5281,4.9
39,167,Washington,2006,33156,31418,1738,5.2
39,169,Wayne,2006,60393,57596,2797,4.6
39,171,Williams,2006,19947,18762,1185,5.9
39,173,Wood,2006,69270,65664,3606,5.2
39,175,Wyandot,2006,12400,11667,733,5.9
40,1,Adair,2006,10390,9946,444,4.3
40,3,Alfalfa,2006,2276,2182,94,4.1
40,5,Atoka,2006,5686,5419,267,4.7
40,7,Beaver,2006,2940,2863,77,2.6
40,9,Beckham,2006,10401,10132,269,2.6
40,11,Blaine,2006,4836,4641,195,4.0
40,13,Bryan,2006,20154,19463,691,3.4
40,15,Caddo,2006,11721,11091,630,5.4
40,17,Canadian,2006,51360,49651,1709,3.3
40,19,Carter,2006,24117,23229,888,3.7
40,21,Cherokee,2006,21444,20575,869,4.1
40,23,Choctaw,2006,6704,6383,321,4.8
40,25,Cimarron,2006,1270,1229,41,3.2
40,27,Cleveland,2006,117419,113448,3971,3.4
40,29,Coal,2006,2358,2225,133,5.6
40,31,Comanche,2006,45313,43503,1810,4.0
40,33,Cotton,2006,3325,3221,104,3.1
40,35,Craig,2006,6798,6519,279,4.1
40,37,Creek,2006,31573,30286,1287,4.1
40,39,Custer,2006,13754,13353,401,2.9
40,41,Delaware,2006,17370,16610,760,4.4
40,43,Dewey,2006,2400,2329,71,3.0
40,45,Ellis,2006,2212,2154,58,2.6
40,47,Garfield,2006,29295,28430,865,3.0
40,49,Garvin,2006,13590,13116,474,3.5
40,51,Grady,2006,23572,22454,1118,4.7
40,53,Grant,2006,2379,2295,84,3.5
40,55,Greer,2006,2068,1971,97,4.7
40,57,Harmon,2006,1429,1380,49,3.4
40,59,Harper,2006,1834,1779,55,3.0
40,61,Haskell,2006,5431,5210,221,4.1
40,63,Hughes,2006,5064,4765,299,5.9
40,65,Jackson,2006,12457,12054,403,3.2
40,67,Jefferson,2006,2343,2244,99,4.2
40,69,Johnston,2006,4969,4763,206,4.1
40,71,Kay,2006,21870,20851,1019,4.7
40,73,Kingfisher,2006,7972,7758,214,2.7
40,75,Kiowa,2006,3917,3738,179,4.6
40,77,Latimer,2006,4112,3912,200,4.9
40,79,Le Flore,2006,21675,20601,1074,5.0
40,81,Lincoln,2006,14519,13937,582,4.0
40,83,Logan,2006,17783,17142,641,3.6
40,85,Love,2006,4836,4673,163,3.4
40,87,McClain,2006,14810,14282,528,3.6
40,89,McCurtain,2006,13950,13116,834,6.0
40,91,McIntosh,2006,8238,7826,412,5.0
40,93,Major,2006,3832,3728,104,2.7
40,95,Marshall,2006,6283,6031,252,4.0
40,97,Mayes,2006,17259,16545,714,4.1
40,99,Murray,2006,7746,7519,227,2.9
40,101,Muskogee,2006,29249,27791,1458,5.0
40,103,Noble,2006,5651,5459,192,3.4
40,105,Nowata,2006,4781,4569,212,4.4
40,107,Okfuskee,2006,4474,4235,239,5.3
40,109,Oklahoma,2006,328242,314787,13455,4.1
40,111,Okmulgee,2006,16528,15646,882,5.3
40,113,Osage,2006,20559,19732,827,4.0
40,115,Ottawa,2006,16488,15741,747,4.5
40,117,Pawnee,2006,7674,7366,308,4.0
40,119,Payne,2006,35538,34285,1253,3.5
40,121,Pittsburg,2006,21407,20561,846,4.0
40,123,Pontotoc,2006,20067,19372,695,3.5
40,125,Pottawatomie,2006,31951,30575,1376,4.3
40,127,Pushmataha,2006,5507,5278,229,4.2
40,129,Roger Mills,2006,1790,1744,46,2.6
40,131,Rogers,2006,40292,38853,1439,3.6
40,133,Seminole,2006,10284,9715,569,5.5
40,135,Sequoyah,2006,18360,17389,971,5.3
40,137,Stephens,2006,20847,20142,705,3.4
40,139,Texas,2006,9089,8794,295,3.2
40,141,Tillman,2006,3482,3337,145,4.2
40,143,Tulsa,2006,293626,282784,10842,3.7
40,145,Wagoner,2006,32705,31550,1155,3.5
40,147,Washington,2006,25554,24698,856,3.3
40,149,Washita,2006,5792,5609,183,3.2
40,151,Woods,2006,4271,4043,228,5.3
40,153,Woodward,2006,11185,10896,289,2.6
41,1,Baker,2006,7202,6741,461,6.4
41,3,Benton,2006,41952,39972,1980,4.7
41,5,Clackamas,2006,194093,184756,9337,4.8
41,7,Clatsop,2006,19113,18150,963,5.0
41,9,Columbia,2006,23627,22266,1361,5.8
41,11,Coos,2006,28564,26627,1937,6.8
41,13,Crook,2006,9657,9084,573,5.9
41,15,Curry,2006,9531,8876,655,6.9
41,17,Deschutes,2006,79163,75467,3696,4.7
41,19,Douglas,2006,47170,43632,3538,7.5
41,21,Gilliam,2006,993,944,49,4.9
41,23,Grant,2006,3506,3214,292,8.3
41,25,Harney,2006,3329,3060,269,8.1
41,27,Hood River,2006,12536,11846,690,5.5
41,29,Jackson,2006,99760,94036,5724,5.7
41,31,Jefferson,2006,9180,8662,518,5.6
41,33,Josephine,2006,34988,32664,2324,6.6
41,35,Klamath,2006,30296,28264,2032,6.7
41,37,Lake,2006,3675,3398,277,7.5
41,39,Lane,2006,177067,167384,9683,5.5
41,41,Lincoln,2006,22032,20705,1327,6.0
41,43,Linn,2006,52676,49200,3476,6.6
41,45,Malheur,2006,12488,11689,799,6.4
41,47,Marion,2006,149648,141116,8532,5.7
41,49,Morrow,2006,5529,5166,363,6.6
41,51,Multnomah,2006,365933,346995,18938,5.2
41,53,Polk,2006,36864,35025,1839,5.0
41,55,Sherman,2006,883,831,52,5.9
41,57,Tillamook,2006,12395,11708,687,5.5
41,59,Umatilla,2006,35900,33484,2416,6.7
41,61,Union,2006,11954,11248,706,5.9
41,63,Wallowa,2006,3615,3378,237,6.6
41,65,Wasco,2006,13127,12407,720,5.5
41,67,Washington,2006,277351,265065,12286,4.4
41,69,Wheeler,2006,634,593,41,6.5
41,71,Yamhill,2006,45340,42998,2342,5.2
42,1,Adams,2006,55279,53356,1923,3.5
42,3,Allegheny,2006,628248,599523,28725,4.6
42,5,Armstrong,2006,32914,31140,1774,5.4
42,7,Beaver,2006,89157,84794,4363,4.9
42,9,Bedford,2006,23150,21789,1361,5.9
42,11,Berks,2006,201450,192443,9007,4.5
42,13,Blair,2006,64581,61613,2968,4.6
42,15,Bradford,2006,30702,29223,1479,4.8
42,17,Bucks,2006,346166,332417,13749,4.0
42,19,Butler,2006,96252,92013,4239,4.4
42,21,Cambria,2006,67933,64217,3716,5.5
42,23,Cameron,2006,2609,2445,164,6.3
42,25,Carbon,2006,30753,28921,1832,6.0
42,27,Centre,2006,72838,70053,2785,3.8
42,29,Chester,2006,263433,254444,8989,3.4
42,31,Clarion,2006,20681,19639,1042,5.0
42,33,Clearfield,2006,40999,38740,2259,5.5
42,35,Clinton,2006,18866,17801,1065,5.6
42,37,Columbia,2006,34658,32716,1942,5.6
42,39,Crawford,2006,42653,40385,2268,5.3
42,41,Cumberland,2006,122172,117968,4204,3.4
42,43,Dauphin,2006,135023,129501,5522,4.1
42,45,Delaware,2006,282472,270087,12385,4.4
42,47,Elk,2006,17550,16712,838,4.8
42,49,Erie,2006,140395,133129,7266,5.2
42,51,Fayette,2006,65666,61408,4258,6.5
42,53,Forest,2006,2229,2066,163,7.3
42,55,Franklin,2006,78842,76191,2651,3.4
42,57,Fulton,2006,8268,7893,375,4.5
42,59,Greene,2006,17492,16463,1029,5.9
42,61,Huntingdon,2006,22060,20888,1172,5.3
42,63,Indiana,2006,45474,43092,2382,5.2
42,65,Jefferson,2006,22769,21636,1133,5.0
42,67,Juniata,2006,12639,12093,546,4.3
42,69,Lackawanna,2006,106022,100701,5321,5.0
42,71,Lancaster,2006,267175,257588,9587,3.6
42,73,Lawrence,2006,43860,41442,2418,5.5
42,75,Lebanon,2006,71182,68719,2463,3.5
42,77,Lehigh,2006,174288,166143,8145,4.7
42,79,Luzerne,2006,158368,149639,8729,5.5
42,81,Lycoming,2006,59025,55879,3146,5.3
42,83,McKean,2006,21741,20562,1179,5.4
42,85,Mercer,2006,55411,52285,3126,5.6
42,87,Mifflin,2006,22483,21331,1152,5.1
42,89,Monroe,2006,80193,75942,4251,5.3
42,91,Montgomery,2006,426991,411357,15634,3.7
42,93,Montour,2006,9060,8688,372,4.1
42,95,Northampton,2006,150204,143216,6988,4.7
42,97,Northumberland,2006,47182,44656,2526,5.4
42,99,Perry,2006,24448,23484,964,3.9
42,101,Philadelphia/city,2006,616516,577310,39206,6.4
42,103,Pike,2006,27028,25456,1572,5.8
42,105,Potter,2006,8260,7759,501,6.1
42,107,Schuylkill,2006,71626,67656,3970,5.5
42,109,Snyder,2006,20046,19208,838,4.2
42,111,Somerset,2006,38990,36798,2192,5.6
42,113,Sullivan,2006,3022,2860,162,5.4
42,115,Susquehanna,2006,21369,20321,1048,4.9
42,117,Tioga,2006,20235,19106,1129,5.6
42,119,Union,2006,17865,16932,933,5.2
42,121,Venango,2006,26607,25193,1414,5.3
42,123,Warren,2006,21080,19996,1084,5.1
42,125,Washington,2006,103305,98093,5212,5.0
42,127,Wayne,2006,25299,24222,1077,4.3
42,129,Westmoreland,2006,185825,176398,9427,5.1
42,131,Wyoming,2006,14364,13608,756,5.3
42,133,York,2006,222524,213412,9112,4.1
44,1,Bristol,2006,28522,27225,1297,4.5
44,3,Kent,2006,97336,92524,4812,4.9
44,5,Newport,2006,44591,42456,2135,4.8
44,7,Providence,2006,327217,308743,18474,5.6
44,9,Washington,2006,73922,70727,3195,4.3
45,1,Abbeville,2006,12276,11126,1150,9.4
45,3,Aiken,2006,76562,71344,5218,6.8
45,5,Allendale,2006,3952,3527,425,10.8
45,7,Anderson,2006,86064,79822,6242,7.3
45,9,Bamberg,2006,6626,5932,694,10.5
45,11,Barnwell,2006,9448,8444,1004,10.6
45,13,Beaufort,2006,63973,60706,3267,5.1
45,15,Berkeley,2006,74448,70040,4408,5.9
45,17,Calhoun,2006,7216,6667,549,7.6
45,19,Charleston,2006,172769,163515,9254,5.4
45,21,Cherokee,2006,25597,23505,2092,8.2
45,23,Chester,2006,16506,14716,1790,10.8
45,25,Chesterfield,2006,19033,17110,1923,10.1
45,27,Clarendon,2006,13197,11904,1293,9.8
45,29,Colleton,2006,17207,16016,1191,6.9
45,31,Darlington,2006,31628,29043,2585,8.2
45,33,Dillon,2006,13678,12326,1352,9.9
45,35,Dorchester,2006,61599,58272,3327,5.4
45,37,Edgefield,2006,11284,10357,927,8.2
45,39,Fairfield,2006,11645,10530,1115,9.6
45,41,Florence,2006,63372,58465,4907,7.7
45,43,Georgetown,2006,29937,27663,2274,7.6
45,45,Greenville,2006,219566,206988,12578,5.7
45,47,Greenwood,2006,32295,29557,2738,8.5
45,49,Hampton,2006,8125,7504,621,7.6
45,51,Horry,2006,130536,122844,7692,5.9
45,53,Jasper,2006,10364,9827,537,5.2
45,55,Kershaw,2006,30151,28115,2036,6.8
45,57,Lancaster,2006,31166,28180,2986,9.6
45,59,Laurens,2006,34134,31619,2515,7.4
45,61,Lee,2006,8548,7678,870,10.2
45,63,Lexington,2006,132928,126302,6626,5.0
45,65,McCormick,2006,3672,3243,429,11.7
45,67,Marion,2006,13697,11947,1750,12.8
45,69,Marlboro,2006,12928,11392,1536,11.9
45,71,Newberry,2006,18286,17030,1256,6.9
45,73,Oconee,2006,31470,28482,2988,9.5
45,75,Orangeburg,2006,40856,36856,4000,9.8
45,77,Pickens,2006,58867,54963,3904,6.6
45,79,Richland,2006,179045,167936,11109,6.2
45,81,Saluda,2006,9537,8901,636,6.7
45,83,Spartanburg,2006,136369,126702,9667,7.1
45,85,Sumter,2006,46719,42849,3870,8.3
45,87,Union,2006,12556,11101,1455,11.6
45,89,Williamsburg,2006,16007,14319,1688,10.5
45,91,York,2006,102865,95882,6983,6.8
46,3,Aurora,2006,1355,1310,45,3.3
46,5,Beadle,2006,8987,8730,257,2.9
46,7,Bennett,2006,1477,1410,67,4.5
46,9,Bon Homme,2006,3204,3077,127,4.0
46,11,Brookings,2006,18853,18416,437,2.3
46,13,Brown,2006,20705,20183,522,2.5
46,15,Brule,2006,2730,2653,77,2.8
46,17,Buffalo,2006,543,469,74,13.6
46,19,Butte,2006,5376,5237,139,2.6
46,21,Campbell,2006,878,853,25,2.8
46,23,Charles Mix,2006,4094,3953,141,3.4
46,25,Clark,2006,1862,1793,69,3.7
46,27,Clay,2006,7434,7226,208,2.8
46,29,Codington,2006,16303,15846,457,2.8
46,31,Corson,2006,1433,1351,82,5.7
46,33,Custer,2006,4787,4648,139,2.9
46,35,Davison,2006,10808,10497,311,2.9
46,37,Day,2006,2918,2776,142,4.9
46,39,Deuel,2006,2696,2604,92,3.4
46,41,Dewey,2006,2695,2454,241,8.9
46,43,Douglas,2006,1700,1656,44,2.6
46,45,Edmunds,2006,2062,2007,55,2.7
46,47,Fall River,2006,3774,3647,127,3.4
46,49,Faulk,2006,1137,1104,33,2.9
46,51,Grant,2006,4211,4069,142,3.4
46,53,Gregory,2006,2356,2277,79,3.4
46,55,Haakon,2006,1164,1134,30,2.6
46,57,Hamlin,2006,2918,2829,89,3.1
46,59,Hand,2006,1882,1832,50,2.7
46,61,Hanson,2006,1918,1863,55,2.9
46,63,Harding,2006,759,738,21,2.8
46,65,Hughes,2006,10419,10172,247,2.4
46,67,Hutchinson,2006,3651,3527,124,3.4
46,69,Hyde,2006,768,742,26,3.4
46,71,Jackson,2006,1279,1210,69,5.4
46,73,Jerauld,2006,1335,1299,36,2.7
46,75,Jones,2006,734,717,17,2.3
46,77,Kingsbury,2006,2947,2853,94,3.2
46,79,Lake,2006,6693,6495,198,3.0
46,81,Lawrence,2006,12886,12532,354,2.7
46,83,Lincoln,2006,20243,19767,476,2.4
46,85,Lyman,2006,2013,1928,85,4.2
46,87,McCook,2006,2906,2820,86,3.0
46,89,McPherson,2006,1191,1144,47,3.9
46,91,Marshall,2006,2141,2054,87,4.1
46,93,Meade,2006,12565,12179,386,3.1
46,95,Mellette,2006,947,906,41,4.3
46,97,Miner,2006,1171,1128,43,3.7
46,99,Minnehaha,2006,94827,92309,2518,2.7
46,101,Moody,2006,4062,3906,156,3.8
46,102,Oglala Lakota,2006,4006,3690,316,7.9
46,103,Pennington,2006,52669,51173,1496,2.8
46,105,Perkins,2006,1726,1676,50,2.9
46,107,Potter,2006,1335,1296,39,2.9
46,109,Roberts,2006,4869,4667,202,4.1
46,111,Sanborn,2006,1503,1460,43,2.9
46,115,Spink,2006,3537,3430,107,3.0
46,117,Stanley,2006,1972,1928,44,2.2
46,119,Sully,2006,1013,990,23,2.3
46,121,Todd,2006,3601,3412,189,5.2
46,123,Tripp,2006,3029,2935,94,3.1
46,125,Turner,2006,4486,4353,133,3.0
46,127,Union,2006,7692,7450,242,3.1
46,129,Walworth,2006,2716,2610,106,3.9
46,135,Yankton,2006,11870,11531,339,2.9
46,137,Ziebach,2006,937,884,53,5.7
47,1,Anderson,2006,35805,34085,1720,4.8
47,3,Bedford,2006,22196,21015,1181,5.3
47,5,Benton,2006,6960,6456,504,7.2
47,7,Bledsoe,2006,4874,4553,321,6.6
47,9,Blount,2006,61725,59011,2714,4.4
47,11,Bradley,2006,48107,45662,2445,5.1
47,13,Campbell,2006,16900,15853,1047,6.2
47,15,Cannon,2006,6576,6238,338,5.1
47,17,Carroll,2006,13987,13089,898,6.4
47,19,Carter,2006,29408,27906,1502,5.1
47,21,Cheatham,2006,20881,20020,861,4.1
47,23,Chester,2006,7751,7325,426,5.5
47,25,Claiborne,2006,13395,12658,737,5.5
47,27,Clay,2006,3633,3230,403,11.1
47,29,Cocke,2006,16278,15075,1203,7.4
47,31,Coffee,2006,25759,24328,1431,5.6
47,33,Crockett,2006,6515,6061,454,7.0
47,35,Cumberland,2006,23232,21773,1459,6.3
47,37,Davidson,2006,310198,296913,13285,4.3
47,39,Decatur,2006,5543,5177,366,6.6
47,41,DeKalb,2006,10278,9714,564,5.5
47,43,Dickson,2006,23492,22390,1102,4.7
47,45,Dyer,2006,17684,16651,1033,5.8
47,47,Fayette,2006,17156,16072,1084,6.3
47,49,Fentress,2006,7637,7125,512,6.7
47,51,Franklin,2006,20168,18997,1171,5.8
47,53,Gibson,2006,21122,19471,1651,7.8
47,55,Giles,2006,13477,12500,977,7.2
47,57,Grainger,2006,10291,9673,618,6.0
47,59,Greene,2006,32746,30123,2623,8.0
47,61,Grundy,2006,5903,5423,480,8.1
47,63,Hamblen,2006,30463,28680,1783,5.9
47,65,Hamilton,2006,162687,155380,7307,4.5
47,67,Hancock,2006,2486,2311,175,7.0
47,69,Hardeman,2006,11425,10590,835,7.3
47,71,Hardin,2006,11741,11003,738,6.3
47,73,Hawkins,2006,26439,24896,1543,5.8
47,75,Haywood,2006,9723,8974,749,7.7
47,77,Henderson,2006,12364,11521,843,6.8
47,79,Henry,2006,14249,13217,1032,7.2
47,81,Hickman,2006,10296,9729,567,5.5
47,83,Houston,2006,3902,3609,293,7.5
47,85,Humphreys,2006,9044,8463,581,6.4
47,87,Jackson,2006,5059,4708,351,6.9
47,89,Jefferson,2006,24349,22939,1410,5.8
47,91,Johnson,2006,7289,6802,487,6.7
47,93,Knox,2006,222531,213639,8892,4.0
47,95,Lake,2006,2687,2499,188,7.0
47,97,Lauderdale,2006,10008,9194,814,8.1
47,99,Lawrence,2006,17063,15115,1948,11.4
47,101,Lewis,2006,5276,4891,385,7.3
47,103,Lincoln,2006,17166,16435,731,4.3
47,105,Loudon,2006,22768,21747,1021,4.5
47,107,McMinn,2006,24835,23402,1433,5.8
47,109,McNairy,2006,12348,11581,767,6.2
47,111,Macon,2006,10933,10174,759,6.9
47,113,Madison,2006,48117,45487,2630,5.5
47,115,Marion,2006,13197,12431,766,5.8
47,117,Marshall,2006,12741,11923,818,6.4
47,119,Maury,2006,36719,34681,2038,5.6
47,121,Meigs,2006,4895,4557,338,6.9
47,123,Monroe,2006,19587,18444,1143,5.8
47,125,Montgomery,2006,69074,65780,3294,4.8
47,127,Moore,2006,3136,2986,150,4.8
47,129,Morgan,2006,8354,7789,565,6.8
47,131,Obion,2006,15800,14908,892,5.6
47,133,Overton,2006,10034,9354,680,6.8
47,135,Perry,2006,3295,3072,223,6.8
47,137,Pickett,2006,1894,1732,162,8.6
47,139,Polk,2006,7388,6967,421,5.7
47,141,Putnam,2006,35318,33271,2047,5.8
47,143,Rhea,2006,13308,12462,846,6.4
47,145,Roane,2006,26810,25344,1466,5.5
47,147,Robertson,2006,33068,31576,1492,4.5
47,149,Rutherford,2006,126268,121107,5161,4.1
47,151,Scott,2006,8766,8169,597,6.8
47,153,Sequatchie,2006,6068,5789,279,4.6
47,155,Sevier,2006,47250,44639,2611,5.5
47,157,Shelby,2006,441584,415888,25696,5.8
47,159,Smith,2006,9298,8753,545,5.9
47,161,Stewart,2006,6271,5786,485,7.7
47,163,Sullivan,2006,73763,70368,3395,4.6
47,165,Sumner,2006,79150,75799,3351,4.2
47,167,Tipton,2006,27702,26136,1566,5.7
47,169,Trousdale,2006,3805,3571,234,6.1
47,171,Unicoi,2006,8399,7871,528,6.3
47,173,Union,2006,8885,8446,439,4.9
47,175,Van Buren,2006,2510,2308,202,8.0
47,177,Warren,2006,18324,16661,1663,9.1
47,179,Washington,2006,59950,57201,2749,4.6
47,181,Wayne,2006,6626,5929,697,10.5
47,183,Weakley,2006,15693,14608,1085,6.9
47,185,White,2006,10838,9843,995,9.2
47,187,Williamson,2006,86647,83556,3091,3.6
47,189,Wilson,2006,57415,54822,2593,4.5
48,1,Anderson,2006,20237,19034,1203,5.9
48,3,Andrews,2006,6788,6549,239,3.5
48,5,Angelina,2006,39988,38098,1890,4.7
48,7,Aransas,2006,11020,10496,524,4.8
48,9,Archer,2006,5451,5264,187,3.4
48,11,Armstrong,2006,1104,1064,40,3.6
48,13,Atascosa,2006,19188,18282,906,4.7
48,15,Austin,2006,12702,12144,558,4.4
48,17,Bailey,2006,3158,3000,158,5.0
48,19,Bandera,2006,9747,9328,419,4.3
48,21,Bastrop,2006,34144,32544,1600,4.7
48,23,Baylor,2006,1923,1843,80,4.2
48,25,Bee,2006,11426,10694,732,6.4
48,27,Bell,2006,115589,109747,5842,5.1
48,29,Bexar,2006,728785,694225,34560,4.7
48,31,Blanco,2006,4659,4477,182,3.9
48,33,Borden,2006,407,388,19,4.7
48,35,Bosque,2006,8195,7787,408,5.0
48,37,Bowie,2006,42735,40424,2311,5.4
48,39,Brazoria,2006,134785,127960,6825,5.1
48,41,Brazos,2006,86922,83366,3556,4.1
48,43,Brewster,2006,5414,5227,187,3.5
48,45,Briscoe,2006,694,661,33,4.8
48,47,Brooks,2006,3031,2840,191,6.3
48,49,Brown,2006,19029,18171,858,4.5
48,51,Burleson,2006,8346,8003,343,4.1
48,53,Burnet,2006,21308,20422,886,4.2
48,55,Caldwell,2006,15892,15103,789,5.0
48,57,Calhoun,2006,9378,8916,462,4.9
48,59,Callahan,2006,7112,6833,279,3.9
48,61,Cameron,2006,143072,133521,9551,6.7
48,63,Camp,2006,5498,5216,282,5.1
48,65,Carson,2006,3519,3393,126,3.6
48,67,Cass,2006,13039,12264,775,5.9
48,69,Castro,2006,3232,3079,153,4.7
48,71,Chambers,2006,13798,13072,726,5.3
48,73,Cherokee,2006,20241,19146,1095,5.4
48,75,Childress,2006,3035,2864,171,5.6
48,77,Clay,2006,6452,6204,248,3.8
48,79,Cochran,2006,1458,1369,89,6.1
48,81,Coke,2006,1351,1275,76,5.6
48,83,Coleman,2006,4276,4090,186,4.3
48,85,Collin,2006,384780,368184,16596,4.3
48,87,Collingsworth,2006,1553,1485,68,4.4
48,89,Colorado,2006,10682,10218,464,4.3
48,91,Comal,2006,51260,49133,2127,4.1
48,93,Comanche,2006,6352,6064,288,4.5
48,95,Concho,2006,1323,1251,72,5.4
48,97,Cooke,2006,20767,19971,796,3.8
48,99,Coryell,2006,24540,22928,1612,6.6
48,101,Cottle,2006,790,750,40,5.1
48,103,Crane,2006,1723,1647,76,4.4
48,105,Crockett,2006,2028,1957,71,3.5
48,107,Crosby,2006,2846,2689,157,5.5
48,109,Culberson,2006,1637,1585,52,3.2
48,111,Dallam,2006,3022,2919,103,3.4
48,113,Dallas,2006,1147466,1087673,59793,5.2
48,115,Dawson,2006,5085,4747,338,6.6
48,117,Deaf Smith,2006,8214,7859,355,4.3
48,119,Delta,2006,2422,2294,128,5.3
48,121,Denton,2006,327086,313077,14009,4.3
48,123,DeWitt,2006,9213,8800,413,4.5
48,125,Dickens,2006,1200,1148,52,4.3
48,127,Dimmit,2006,3831,3536,295,7.7
48,129,Donley,2006,1814,1727,87,4.8
48,131,Duval,2006,5238,4950,288,5.5
48,133,Eastland,2006,8329,7921,408,4.9
48,135,Ector,2006,65240,62684,2556,3.9
48,137,Edwards,2006,961,919,42,4.4
48,139,Ellis,2006,68449,64961,3488,5.1
48,141,El Paso,2006,291307,271535,19772,6.8
48,143,Erath,2006,17749,17035,714,4.0
48,145,Falls,2006,7070,6624,446,6.3
48,147,Fannin,2006,13466,12648,818,6.1
48,149,Fayette,2006,11986,11539,447,3.7
48,151,Fisher,2006,1953,1873,80,4.1
48,153,Floyd,2006,3129,2942,187,6.0
48,155,Foard,2006,666,636,30,4.5
48,157,Fort Bend,2006,244695,232934,11761,4.8
48,159,Franklin,2006,5480,5249,231,4.2
48,161,Freestone,2006,10103,9699,404,4.0
48,163,Frio,2006,6463,6107,356,5.5
48,165,Gaines,2006,6044,5762,282,4.7
48,167,Galveston,2006,137584,130432,7152,5.2
48,169,Garza,2006,2550,2451,99,3.9
48,171,Gillespie,2006,12818,12393,425,3.3
48,173,Glasscock,2006,578,552,26,4.5
48,175,Goliad,2006,3441,3300,141,4.1
48,177,Gonzales,2006,9731,9335,396,4.1
48,179,Gray,2006,10875,10445,430,4.0
48,181,Grayson,2006,56224,53453,2771,4.9
48,183,Gregg,2006,61437,58620,2817,4.6
48,185,Grimes,2006,10462,9893,569,5.4
48,187,Guadalupe,2006,54265,51887,2378,4.4
48,189,Hale,2006,16560,15687,873,5.3
48,191,Hall,2006,1456,1366,90,6.2
48,193,Hamilton,2006,4001,3831,170,4.2
48,195,Hansford,2006,2387,2301,86,3.6
48,197,Hardeman,2006,2333,2238,95,4.1
48,199,Hardin,2006,25432,24085,1347,5.3
48,201,Harris,2006,1876165,1779856,96309,5.1
48,203,Harrison,2006,31467,29845,1622,5.2
48,205,Hartley,2006,2200,2111,89,4.0
48,207,Haskell,2006,2944,2827,117,4.0
48,209,Hays,2006,69554,66609,2945,4.2
48,211,Hemphill,2006,2313,2250,63,2.7
48,213,Henderson,2006,34469,32671,1798,5.2
48,215,Hidalgo,2006,265959,246140,19819,7.5
48,217,Hill,2006,15129,14276,853,5.6
48,219,Hockley,2006,11350,10871,479,4.2
48,221,Hood,2006,23009,21870,1139,5.0
48,223,Hopkins,2006,17351,16612,739,4.3
48,225,Houston,2006,8055,7555,500,6.2
48,227,Howard,2006,13669,12997,672,4.9
48,229,Hudspeth,2006,1426,1326,100,7.0
48,231,Hunt,2006,38490,36458,2032,5.3
48,233,Hutchinson,2006,11003,10514,489,4.4
48,235,Irion,2006,993,957,36,3.6
48,237,Jack,2006,4362,4178,184,4.2
48,239,Jackson,2006,6403,6105,298,4.7
48,241,Jasper,2006,15587,14597,990,6.4
48,243,Jeff Davis,2006,1197,1148,49,4.1
48,245,Jefferson,2006,111982,105114,6868,6.1
48,247,Jim Hogg,2006,2691,2574,117,4.3
48,249,Jim Wells,2006,20450,19485,965,4.7
48,251,Johnson,2006,72615,69220,3395,4.7
48,253,Jones,2006,7991,7564,427,5.3
48,255,Karnes,2006,5326,4996,330,6.2
48,257,Kaufman,2006,44425,42168,2257,5.1
48,259,Kendall,2006,15066,14472,594,3.9
48,261,Kenedy,2006,244,237,7,2.9
48,263,Kent,2006,404,388,16,4.0
48,265,Kerr,2006,22504,21578,926,4.1
48,267,Kimble,2006,2224,2138,86,3.9
48,269,King,2006,160,153,7,4.4
48,271,Kinney,2006,1332,1254,78,5.9
48,273,Kleberg,2006,16205,15459,746,4.6
48,275,Knox,2006,1758,1684,74,4.2
48,277,Lamar,2006,23659,22368,1291,5.5
48,279,Lamb,2006,7037,6708,329,4.7
48,281,Lampasas,2006,10498,10072,426,4.1
48,283,La Salle,2006,2741,2601,140,5.1
48,285,Lavaca,2006,10230,9853,377,3.7
48,287,Lee,2006,8796,8442,354,4.0
48,289,Leon,2006,7622,7235,387,5.1
48,291,Liberty,2006,30671,28882,1789,5.8
48,293,Limestone,2006,10237,9746,491,4.8
48,295,Lipscomb,2006,1735,1677,58,3.3
48,297,Live Oak,2006,5054,4822,232,4.6
48,299,Llano,2006,8137,7752,385,4.7
48,301,Loving,2006,38,34,4,10.5
48,303,Lubbock,2006,137612,132108,5504,4.0
48,305,Lynn,2006,2744,2588,156,5.7
48,307,McCulloch,2006,3710,3540,170,4.6
48,309,McLennan,2006,111698,106287,5411,4.8
48,311,McMullen,2006,340,320,20,5.9
48,313,Madison,2006,4948,4685,263,5.3
48,315,Marion,2006,5003,4733,270,5.4
48,317,Martin,2006,2129,2039,90,4.2
48,319,Mason,2006,2429,2355,74,3.0
48,321,Matagorda,2006,15982,14842,1140,7.1
48,323,Maverick,2006,19579,17024,2555,13.0
48,325,Medina,2006,19761,18844,917,4.6
48,327,Menard,2006,1066,1022,44,4.1
48,329,Midland,2006,69652,67285,2367,3.4
48,331,Milam,2006,12112,11553,559,4.6
48,333,Mills,2006,2402,2304,98,4.1
48,335,Mitchell,2006,3363,3162,201,6.0
48,337,Montague,2006,9985,9574,411,4.1
48,339,Montgomery,2006,195312,186605,8707,4.5
48,341,Moore,2006,10375,10018,357,3.4
48,343,Morris,2006,6159,5822,337,5.5
48,345,Motley,2006,631,605,26,4.1
48,347,Nacogdoches,2006,30727,29254,1473,4.8
48,349,Navarro,2006,21111,19924,1187,5.6
48,351,Newton,2006,5664,5252,412,7.3
48,353,Nolan,2006,7584,7253,331,4.4
48,355,Nueces,2006,157413,149661,7752,4.9
48,357,Ochiltree,2006,5087,4931,156,3.1
48,359,Oldham,2006,1018,976,42,4.1
48,361,Orange,2006,41001,38579,2422,5.9
48,363,Palo Pinto,2006,14394,13770,624,4.3
48,365,Panola,2006,12001,11475,526,4.4
48,367,Parker,2006,51881,49469,2412,4.6
48,369,Parmer,2006,4372,4203,169,3.9
48,371,Pecos,2006,6717,6401,316,4.7
48,373,Polk,2006,16929,15889,1040,6.1
48,375,Potter,2006,57679,55213,2466,4.3
48,377,Presidio,2006,3219,2875,344,10.7
48,379,Rains,2006,5123,4872,251,4.9
48,381,Randall,2006,66848,64624,2224,3.3
48,383,Reagan,2006,2286,2229,57,2.5
48,385,Real,2006,1346,1279,67,5.0
48,387,Red River,2006,6233,5885,348,5.6
48,389,Reeves,2006,4126,3869,257,6.2
48,391,Refugio,2006,3808,3632,176,4.6
48,393,Roberts,2006,553,536,17,3.1
48,395,Robertson,2006,7463,7097,366,4.9
48,397,Rockwall,2006,35198,33617,1581,4.5
48,399,Runnels,2006,4398,4159,239,5.4
48,401,Rusk,2006,22904,21827,1077,4.7
48,403,Sabine,2006,3421,3119,302,8.8
48,405,San Augustine,2006,3549,3323,226,6.4
48,407,San Jacinto,2006,9947,9357,590,5.9
48,409,San Patricio,2006,29427,27795,1632,5.5
48,411,San Saba,2006,2556,2429,127,5.0
48,413,Schleicher,2006,1357,1305,52,3.8
48,415,Scurry,2006,7114,6776,338,4.8
48,417,Shackelford,2006,2012,1950,62,3.1
48,419,Shelby,2006,11950,11351,599,5.0
48,421,Sherman,2006,1313,1260,53,4.0
48,423,Smith,2006,96303,91759,4544,4.7
48,425,Somervell,2006,3748,3566,182,4.9
48,427,Starr,2006,21475,18949,2526,11.8
48,429,Stephens,2006,4421,4239,182,4.1
48,431,Sterling,2006,870,843,27,3.1
48,433,Stonewall,2006,874,844,30,3.4
48,435,Sutton,2006,2832,2756,76,2.7
48,437,Swisher,2006,3502,3345,157,4.5
48,439,Tarrant,2006,860247,818958,41289,4.8
48,441,Taylor,2006,66380,63780,2600,3.9
48,443,Terrell,2006,387,365,22,5.7
48,445,Terry,2006,5622,5328,294,5.2
48,447,Throckmorton,2006,970,936,34,3.5
48,449,Titus,2006,14497,13864,633,4.4
48,451,Tom Green,2006,52147,49957,2190,4.2
48,453,Travis,2006,515429,494203,21226,4.1
48,455,Trinity,2006,5755,5418,337,5.9
48,457,Tyler,2006,8201,7679,522,6.4
48,459,Upshur,2006,18833,17956,877,4.7
48,461,Upton,2006,1605,1544,61,3.8
48,463,Uvalde,2006,11359,10674,685,6.0
48,465,Val Verde,2006,20227,19002,1225,6.1
48,467,Van Zandt,2006,25212,24048,1164,4.6
48,469,Victoria,2006,44338,42509,1829,4.1
48,471,Walker,2006,26232,24808,1424,5.4
48,473,Waller,2006,15712,14867,845,5.4
48,475,Ward,2006,4720,4499,221,4.7
48,477,Washington,2006,16039,15353,686,4.3
48,479,Webb,2006,87957,83140,4817,5.5
48,481,Wharton,2006,20561,19565,996,4.8
48,483,Wheeler,2006,2804,2710,94,3.4
48,485,Wichita,2006,62688,59917,2771,4.4
48,487,Wilbarger,2006,7872,7586,286,3.6
48,489,Willacy,2006,7630,6927,703,9.2
48,491,Williamson,2006,188707,180675,8032,4.3
48,493,Wilson,2006,18238,17422,816,4.5
48,495,Winkler,2006,3215,3087,128,4.0
48,497,Wise,2006,27875,26638,1237,4.4
48,499,Wood,2006,17859,16937,922,5.2
48,501,Yoakum,2006,3581,3437,144,4.0
48,503,Young,2006,9659,9286,373,3.9
48,505,Zapata,2006,4920,4615,305,6.2
48,507,Zavala,2006,3757,3310,447,11.9
49,1,Beaver,2006,3154,3062,92,2.9
49,3,Box Elder,2006,23100,22390,710,3.1
49,5,Cache,2006,58955,57651,1304,2.2
49,7,Carbon,2006,9992,9659,333,3.3
49,9,Daggett,2006,511,487,24,4.7
49,11,Davis,2006,142204,138247,3957,2.8
49,13,Duchesne,2006,8590,8355,235,2.7
49,15,Emery,2006,5293,5115,178,3.4
49,17,Garfield,2006,2706,2575,131,4.8
49,19,Grand,2006,5085,4846,239,4.7
49,21,Iron,2006,21181,20589,592,2.8
49,23,Juab,2006,4081,3936,145,3.6
49,25,Kane,2006,3476,3356,120,3.5
49,27,Millard,2006,6258,6081,177,2.8
49,29,Morgan,2006,3987,3871,116,2.9
49,31,Piute,2006,901,875,26,2.9
49,33,Rich,2006,1423,1392,31,2.2
49,35,Salt Lake,2006,540712,525606,15106,2.8
49,37,San Juan,2006,4934,4643,291,5.9
49,39,Sanpete,2006,10777,10389,388,3.6
49,41,Sevier,2006,9495,9202,293,3.1
49,43,Summit,2006,22012,21406,606,2.8
49,45,Tooele,2006,26589,25754,835,3.1
49,47,Uintah,2006,16487,16101,386,2.3
49,49,Utah,2006,216671,210742,5929,2.7
49,51,Wasatch,2006,10250,9939,311,3.0
49,53,Washington,2006,62022,60229,1793,2.9
49,55,Wayne,2006,1401,1342,59,4.2
49,57,Weber,2006,111035,107447,3588,3.2
50,1,Addison,2006,21798,21075,723,3.3
50,3,Bennington,2006,20583,19831,752,3.7
50,5,Caledonia,2006,16867,16172,695,4.1
50,7,Chittenden,2006,88082,85198,2884,3.3
50,9,Essex,2006,3277,3148,129,3.9
50,11,Franklin,2006,26310,25213,1097,4.2
50,13,Grand Isle,2006,4306,4082,224,5.2
50,15,Lamoille,2006,15084,14456,628,4.2
50,17,Orange,2006,16595,16037,558,3.4
50,19,Orleans,2006,14502,13723,779,5.4
50,21,Rutland,2006,35949,34519,1430,4.0
50,23,Washington,2006,34381,33060,1321,3.8
50,25,Windham,2006,24777,23840,937,3.8
50,27,Windsor,2006,32871,31879,992,3.0
51,1,Accomack,2006,18578,17722,856,4.6
51,3,Albemarle,2006,49789,48475,1314,2.6
51,5,Alleghany,2006,7348,6964,384,5.2
51,7,Amelia,2006,6477,6266,211,3.3
51,9,Amherst,2006,15523,14979,544,3.5
51,11,Appomattox,2006,6960,6684,276,4.0
51,13,Arlington,2006,127153,124437,2716,2.1
51,15,Augusta,2006,36805,35754,1051,2.9
51,17,Bath,2006,2892,2789,103,3.6
51,19,Bedford,2006,37631,36416,1215,3.2
51,21,Bland,2006,3222,3091,131,4.1
51,23,Botetourt,2006,17413,16926,487,2.8
51,25,Brunswick,2006,6838,6480,358,5.2
51,27,Buchanan,2006,8427,7974,453,5.4
51,29,Buckingham,2006,6834,6569,265,3.9
51,31,Campbell,2006,27157,26204,953,3.5
51,33,Caroline,2006,13556,13056,500,3.7
51,35,Carroll,2006,13842,13058,784,5.7
51,36,Charles City,2006,3838,3673,165,4.3
51,37,Charlotte,2006,5270,4890,380,7.2
51,41,Chesterfield,2006,164043,159100,4943,3.0
51,43,Clarke,2006,8046,7832,214,2.7
51,45,Craig,2006,2555,2460,95,3.7
51,47,Culpeper,2006,20058,19353,705,3.5
51,49,Cumberland,2006,4522,4353,169,3.7
51,51,Dickenson,2006,5666,5353,313,5.5
51,53,Dinwiddie,2006,12764,12325,439,3.4
51,57,Essex,2006,5434,5202,232,4.3
51,59,Fairfax,2006,576788,562925,13863,2.4
51,61,Fauquier,2006,36513,35546,967,2.6
51,63,Floyd,2006,6996,6748,248,3.5
51,65,Fluvanna,2006,13370,13026,344,2.6
51,67,Franklin,2006,26000,25104,896,3.4
51,69,Frederick,2006,40526,39363,1163,2.9
51,71,Giles,2006,8481,8137,344,4.1
51,73,Gloucester,2006,20330,19748,582,2.9
51,75,Goochland,2006,10810,10521,289,2.7
51,77,Grayson,2006,7113,6691,422,5.9
51,79,Greene,2006,10140,9886,254,2.5
51,81,Greensville,2006,3935,3754,181,4.6
51,83,Halifax,2006,15789,14791,998,6.3
51,85,Hanover,2006,54699,53200,1499,2.7
51,87,Henrico,2006,159503,154529,4974,3.1
51,89,Henry,2006,25127,23833,1294,5.1
51,91,Highland,2006,1130,1091,39,3.5
51,93,Isle of Wight,2006,18266,17656,610,3.3
51,95,James City,2006,30303,29428,875,2.9
51,97,King and Queen,2006,3333,3211,122,3.7
51,99,King George,2006,9481,9135,346,3.6
51,101,King William,2006,8283,8038,245,3.0
51,103,Lancaster,2006,5187,4939,248,4.8
51,105,Lee,2006,9280,8846,434,4.7
51,107,Loudoun,2006,156794,153149,3645,2.3
51,109,Louisa,2006,15791,15263,528,3.3
51,111,Lunenburg,2006,5576,5309,267,4.8
51,113,Madison,2006,7267,7059,208,2.9
51,115,Mathews,2006,4451,4325,126,2.8
51,117,Mecklenburg,2006,13136,12387,749,5.7
51,119,Middlesex,2006,5057,4883,174,3.4
51,121,Montgomery,2006,43535,42076,1459,3.4
51,125,Nelson,2006,7709,7478,231,3.0
51,127,New Kent,2006,9260,8983,277,3.0
51,131,Northampton,2006,5869,5588,281,4.8
51,133,Northumberland,2006,5974,5702,272,4.6
51,135,Nottoway,2006,6430,6142,288,4.5
51,137,Orange,2006,15034,14539,495,3.3
51,139,Page,2006,11188,10620,568,5.1
51,141,Patrick,2006,8815,8372,443,5.0
51,143,Pittsylvania,2006,31085,29248,1837,5.9
51,145,Powhatan,2006,14203,13804,399,2.8
51,147,Prince Edward,2006,8899,8437,462,5.2
51,149,Prince George,2006,14849,14307,542,3.7
51,153,Prince William,2006,196876,191735,5141,2.6
51,155,Pulaski,2006,18089,17326,763,4.2
51,157,Rappahannock,2006,4260,4152,108,2.5
51,159,Richmond,2006,3499,3316,183,5.2
51,161,Roanoke,2006,48707,47342,1365,2.8
51,163,Rockbridge,2006,11229,10896,333,3.0
51,165,Rockingham,2006,42071,40976,1095,2.6
51,167,Russell,2006,11833,11066,767,6.5
51,169,Scott,2006,9933,9406,527,5.3
51,171,Shenandoah,2006,19774,19132,642,3.2
51,173,Smyth,2006,15349,14577,772,5.0
51,175,Southampton,2006,7588,7287,301,4.0
51,177,Spotsylvania,2006,64245,62550,1695,2.6
51,179,Stafford,2006,63570,61868,1702,2.7
51,181,Surry,2006,3706,3569,137,3.7
51,183,Sussex,2006,4479,4260,219,4.9
51,185,Tazewell,2006,19988,19129,859,4.3
51,187,Warren,2006,19133,18550,583,3.0
51,191,Washington,2006,26385,25203,1182,4.5
51,193,Westmoreland,2006,8261,7910,351,4.2
51,195,Wise,2006,17289,16448,841,4.9
51,197,Wythe,2006,14988,14323,665,4.4
51,199,York,2006,31045,30143,902,2.9
51,510,Alexandria city,2006,86727,84641,2086,2.4
51,520,Bristol city,2006,7944,7528,416,5.2
51,530,Buena Vista city,2006,3388,3263,125,3.7
51,540,Charlottesville city,2006,20399,19686,713,3.5
51,550,Chesapeake city,2006,114148,110143,4005,3.5
51,570,Colonial Heights city,2006,9130,8812,318,3.5
51,580,Covington city,2006,2798,2581,217,7.8
51,590,Danville city,2006,20249,18351,1898,9.4
51,595,Emporia city,2006,2507,2357,150,6.0
51,600,Fairfax city,2006,13216,12865,351,2.7
51,610,Falls Church city,2006,6505,6302,203,3.1
51,620,Franklin city,2006,3801,3606,195,5.1
51,630,Fredericksburg city,2006,11647,11147,500,4.3
51,640,Galax city,2006,3039,2840,199,6.5
51,650,Hampton city,2006,67149,64458,2691,4.0
51,660,Harrisonburg city,2006,21702,21000,702,3.2
51,670,Hopewell city,2006,10302,9782,520,5.0
51,678,Lexington city,2006,2293,2177,116,5.1
51,680,Lynchburg city,2006,31922,30659,1263,4.0
51,683,Manassas city,2006,20249,19674,575,2.8
51,685,Manassas Park city,2006,6614,6448,166,2.5
51,690,Martinsville city,2006,5855,5394,461,7.9
51,700,Newport News city,2006,86210,82866,3344,3.9
51,710,Norfolk city,2006,95748,91329,4419,4.6
51,720,Norton city,2006,1516,1431,85,5.6
51,730,Petersburg city,2006,13916,12974,942,6.8
51,735,Poquoson city,2006,6292,6132,160,2.5
51,740,Portsmouth city,2006,45802,43616,2186,4.8
51,750,Radford city,2006,7239,6940,299,4.1
51,760,Richmond city,2006,95514,90729,4785,5.0
51,770,Roanoke city,2006,45481,43632,1849,4.1
51,775,Salem city,2006,13066,12643,423,3.2
51,790,Staunton city,2006,11235,10861,374,3.3
51,800,Suffolk city,2006,39333,37846,1487,3.8
51,810,Virginia Beach city,2006,221436,214419,7017,3.2
51,820,Waynesboro city,2006,9873,9531,342,3.5
51,830,Williamsburg city,2006,4820,4512,308,6.4
51,840,Winchester city,2006,14203,13752,451,3.2
53,1,Adams,2006,8069,7521,548,6.8
53,3,Asotin,2006,10241,9769,472,4.6
53,5,Benton,2006,83276,78151,5125,6.2
53,7,Chelan,2006,39494,37298,2196,5.6
53,9,Clallam,2006,29639,27770,1869,6.3
53,11,Clark,2006,206025,193197,12828,6.2
53,13,Columbia,2006,1506,1367,139,9.2
53,15,Cowlitz,2006,42977,39950,3027,7.0
53,17,Douglas,2006,20145,19060,1085,5.4
53,19,Ferry,2006,2947,2653,294,10.0
53,21,Franklin,2006,30023,27751,2272,7.6
53,23,Garfield,2006,1044,984,60,5.7
53,25,Grant,2006,38952,36197,2755,7.1
53,27,Grays Harbor,2006,31060,28717,2343,7.5
53,29,Island,2006,32385,30581,1804,5.6
53,31,Jefferson,2006,13613,12875,738,5.4
53,33,King,2006,1047216,1009037,38179,3.6
53,35,Kitsap,2006,122048,115886,6162,5.0
53,37,Kittitas,2006,19479,18377,1102,5.7
53,39,Klickitat,2006,9523,8796,727,7.6
53,41,Lewis,2006,31215,28885,2330,7.5
53,43,Lincoln,2006,4666,4382,284,6.1
53,45,Mason,2006,24665,23112,1553,6.3
53,47,Okanogan,2006,20669,19197,1472,7.1
53,49,Pacific,2006,9166,8524,642,7.0
53,51,Pend Oreille,2006,5118,4710,408,8.0
53,53,Pierce,2006,373953,353307,20646,5.5
53,55,San Juan,2006,8230,7894,336,4.1
53,57,Skagit,2006,56534,53376,3158,5.6
53,59,Skamania,2006,5089,4701,388,7.6
53,61,Snohomish,2006,359232,344764,14468,4.0
53,63,Spokane,2006,227291,215020,12271,5.4
53,65,Stevens,2006,18180,16798,1382,7.6
53,67,Thurston,2006,124010,117831,6179,5.0
53,69,Wahkiakum,2006,1625,1508,117,7.2
53,71,Walla Walla,2006,28737,27059,1678,5.8
53,73,Whatcom,2006,102963,97929,5034,4.9
53,75,Whitman,2006,20355,19478,877,4.3
53,77,Yakima,2006,118701,109940,8761,7.4
54,1,Barbour,2006,6732,6327,405,6.0
54,3,Berkeley,2006,45218,43221,1997,4.4
54,5,Boone,2006,9406,8940,466,5.0
54,7,Braxton,2006,5948,5603,345,5.8
54,9,Brooke,2006,10970,10121,849,7.7
54,11,Cabell,2006,44531,42397,2134,4.8
54,13,Calhoun,2006,2718,2511,207,7.6
54,15,Clay,2006,3485,3234,251,7.2
54,17,Doddridge,2006,2878,2720,158,5.5
54,19,Fayette,2006,18014,16948,1066,5.9
54,21,Gilmer,2006,3101,2949,152,4.9
54,23,Grant,2006,5126,4802,324,6.3
54,25,Greenbrier,2006,15615,14604,1011,6.5
54,27,Hampshire,2006,9799,9390,409,4.2
54,29,Hancock,2006,14569,13408,1161,8.0
54,31,Hardy,2006,7251,6952,299,4.1
54,33,Harrison,2006,30735,29221,1514,4.9
54,35,Jackson,2006,11808,11159,649,5.5
54,37,Jefferson,2006,24743,23863,880,3.6
54,39,Kanawha,2006,91328,87133,4195,4.6
54,41,Lewis,2006,7351,6955,396,5.4
54,43,Lincoln,2006,7953,7445,508,6.4
54,45,Logan,2006,12873,12216,657,5.1
54,47,McDowell,2006,6945,6387,558,8.0
54,49,Marion,2006,26112,24890,1222,4.7
54,51,Marshall,2006,14997,14098,899,6.0
54,53,Mason,2006,10472,9707,765,7.3
54,55,Mercer,2006,24287,23030,1257,5.2
54,57,Mineral,2006,13429,12716,713,5.3
54,59,Mingo,2006,8578,8085,493,5.7
54,61,Monongalia,2006,45814,44151,1663,3.6
54,63,Monroe,2006,5937,5595,342,5.8
54,65,Morgan,2006,7111,6759,352,5.0
54,67,Nicholas,2006,10647,10050,597,5.6
54,69,Ohio,2006,20946,19896,1050,5.0
54,71,Pendleton,2006,3843,3672,171,4.4
54,73,Pleasants,2006,3174,2987,187,5.9
54,75,Pocahontas,2006,3816,3507,309,8.1
54,77,Preston,2006,14881,14173,708,4.8
54,79,Putnam,2006,27084,25918,1166,4.3
54,81,Raleigh,2006,32728,31172,1556,4.8
54,83,Randolph,2006,13113,12413,700,5.3
54,85,Ritchie,2006,4739,4489,250,5.3
54,87,Roane,2006,5526,5162,364,6.6
54,89,Summers,2006,4735,4422,313,6.6
54,91,Taylor,2006,6977,6590,387,5.5
54,93,Tucker,2006,3058,2860,198,6.5
54,95,Tyler,2006,3662,3387,275,7.5
54,97,Upshur,2006,10774,10240,534,5.0
54,99,Wayne,2006,17643,16639,1004,5.7
54,101,Webster,2006,3421,3215,206,6.0
54,103,Wetzel,2006,6347,5803,544,8.6
54,105,Wirt,2006,2544,2382,162,6.4
54,107,Wood,2006,41119,38995,2124,5.2
54,109,Wyoming,2006,8303,7819,484,5.8
55,1,Adams,2006,9924,9274,650,6.5
55,3,Ashland,2006,9270,8717,553,6.0
55,5,Barron,2006,25608,24217,1391,5.4
55,7,Bayfield,2006,8285,7763,522,6.3
55,9,Brown,2006,137297,131162,6135,4.5
55,11,Buffalo,2006,8543,8208,335,3.9
55,13,Burnett,2006,8487,7999,488,5.7
55,15,Calumet,2006,25414,24393,1021,4.0
55,17,Chippewa,2006,33687,31978,1709,5.1
55,19,Clark,2006,17846,16895,951,5.3
55,21,Columbia,2006,31697,30232,1465,4.6
55,23,Crawford,2006,9688,9220,468,4.8
55,25,Dane,2006,289478,280189,9289,3.2
55,27,Dodge,2006,47273,44952,2321,4.9
55,29,Door,2006,16698,15812,886,5.3
55,31,Douglas,2006,23121,21977,1144,4.9
55,33,Dunn,2006,23943,22866,1077,4.5
55,35,Eau Claire,2006,55636,53459,2177,3.9
55,37,Florence,2006,2589,2420,169,6.5
55,39,Fond du Lac,2006,56596,53971,2625,4.6
55,41,Forest,2006,5020,4693,327,6.5
55,43,Grant,2006,27238,26040,1198,4.4
55,45,Green,2006,20322,19445,877,4.3
55,47,Green Lake,2006,10467,9898,569,5.4
55,49,Iowa,2006,14392,13779,613,4.3
55,51,Iron,2006,3191,2934,257,8.1
55,53,Jackson,2006,10006,9464,542,5.4
55,55,Jefferson,2006,42931,41008,1923,4.5
55,57,Juneau,2006,13506,12740,766,5.7
55,59,Kenosha,2006,82952,78551,4401,5.3
55,61,Kewaunee,2006,11866,11347,519,4.4
55,63,La Crosse,2006,63831,61458,2373,3.7
55,65,Lafayette,2006,9185,8815,370,4.0
55,67,Langlade,2006,10880,10237,643,5.9
55,69,Lincoln,2006,15935,15066,869,5.5
55,71,Manitowoc,2006,45515,43301,2214,4.9
55,73,Marathon,2006,75355,72176,3179,4.2
55,75,Marinette,2006,22059,20659,1400,6.3
55,77,Marquette,2006,7850,7388,462,5.9
55,78,Menominee,2006,1671,1488,183,11.0
55,79,Milwaukee,2006,455915,430420,25495,5.6
55,81,Monroe,2006,23970,22959,1011,4.2
55,83,Oconto,2006,20581,19348,1233,6.0
55,85,Oneida,2006,20113,18958,1155,5.7
55,87,Outagamie,2006,96196,91813,4383,4.6
55,89,Ozaukee,2006,48640,46919,1721,3.5
55,91,Pepin,2006,4096,3905,191,4.7
55,93,Pierce,2006,23741,22751,990,4.2
55,95,Polk,2006,24234,22859,1375,5.7
55,97,Portage,2006,40982,39166,1816,4.4
55,99,Price,2006,8690,8218,472,5.4
55,101,Racine,2006,99622,94067,5555,5.6
55,103,Richland,2006,9967,9508,459,4.6
55,105,Rock,2006,84364,80166,4198,5.0
55,107,Rusk,2006,7903,7387,516,6.5
55,109,St. Croix,2006,46861,44584,2277,4.9
55,111,Sauk,2006,34867,33319,1548,4.4
55,113,Sawyer,2006,9363,8770,593,6.3
55,115,Shawano,2006,22537,21409,1128,5.0
55,117,Sheboygan,2006,65462,62910,2552,3.9
55,119,Taylor,2006,10980,10438,542,4.9
55,121,Trempealeau,2006,16223,15534,689,4.2
55,123,Vernon,2006,14433,13748,685,4.7
55,125,Vilas,2006,11790,11086,704,6.0
55,127,Walworth,2006,56212,53825,2387,4.2
55,129,Washburn,2006,8109,7584,525,6.5
55,131,Washington,2006,74115,71096,3019,4.1
55,133,Waukesha,2006,216847,208751,8096,3.7
55,135,Waupaca,2006,28554,27148,1406,4.9
55,137,Waushara,2006,12871,12157,714,5.5
55,139,Winnebago,2006,92589,88505,4084,4.4
55,141,Wood,2006,40192,38080,2112,5.3
56,1,Albany,2006,18854,18389,465,2.5
56,3,Big Horn,2006,5355,5145,210,3.9
56,5,Campbell,2006,25196,24688,508,2.0
56,7,Carbon,2006,7913,7663,250,3.2
56,9,Converse,2006,6893,6670,223,3.2
56,11,Crook,2006,3398,3308,90,2.6
56,13,Fremont,2006,17798,17072,726,4.1
56,15,Goshen,2006,5928,5712,216,3.6
56,17,Hot Springs,2006,2338,2258,80,3.4
56,19,Johnson,2006,3862,3749,113,2.9
56,21,Laramie,2006,41941,40410,1531,3.7
56,23,Lincoln,2006,8246,7975,271,3.3
56,25,Natrona,2006,40280,39147,1133,2.8
56,27,Niobrara,2006,1143,1108,35,3.1
56,29,Park,2006,14298,13816,482,3.4
56,31,Platte,2006,4011,3843,168,4.2
56,33,Sheridan,2006,15548,15085,463,3.0
56,35,Sublette,2006,5717,5619,98,1.7
56,37,Sweetwater,2006,23606,23051,555,2.4
56,39,Teton,2006,14113,13774,339,2.4
56,41,Uinta,2006,11092,10776,316,2.8
56,43,Washakie,2006,4208,4064,144,3.4
56,45,Weston,2006,3092,2990,102,3.3
72,1,Adjuntas Municipio,2006,5651,4880,771,13.6
72,3,Aguada Municipio,2006,16423,14431,1992,12.1
72,5,Aguadilla Municipio,2006,22975,20101,2874,12.5
72,7,Aguas Buenas Municipio,2006,9925,8787,1138,11.5
72,9,Aibonito Municipio,2006,8284,7235,1049,12.7
72,11,Anasco Municipio,2006,11280,9885,1395,12.4
72,13,Arecibo Municipio,2006,34977,30897,4080,11.7
72,15,Arroyo Municipio,2006,5926,4960,966,16.3
72,17,Barceloneta Municipio,2006,7691,6588,1103,14.3
72,19,Barranquitas Municipio,2006,8077,7116,961,11.9
72,21,Bayamon Municipio,2006,86474,79620,6854,7.9
72,23,Cabo Rojo Municipio,2006,21550,19530,2020,9.4
72,25,Caguas Municipio,2006,56670,50864,5806,10.2
72,27,Camuy Municipio,2006,13495,12033,1462,10.8
72,29,Canovanas Municipio,2006,15089,13210,1879,12.5
72,31,Carolina Municipio,2006,80945,74493,6452,8.0
72,33,Catano Municipio,2006,8379,7496,883,10.5
72,35,Cayey Municipio,2006,16545,14514,2031,12.3
72,37,Ceiba Municipio,2006,6148,5449,699,11.4
72,39,Ciales Municipio,2006,5455,4610,845,15.5
72,41,Cidra Municipio,2006,16276,14396,1880,11.6
72,43,Coamo Municipio,2006,11694,10018,1676,14.3
72,45,Comerio Municipio,2006,5034,4334,700,13.9
72,47,Corozal Municipio,2006,10974,9765,1209,11.0
72,49,Culebra Municipio,2006,903,821,82,9.1
72,51,Dorado Municipio,2006,13375,12138,1237,9.2
72,53,Fajardo Municipio,2006,15741,13723,2018,12.8
72,54,Florida Municipio,2006,4457,3783,674,15.1
72,55,Guanica Municipio,2006,6625,5646,979,14.8
72,57,Guayama Municipio,2006,15250,13056,2194,14.4
72,59,Guayanilla Municipio,2006,7142,6031,1111,15.6
72,61,Guaynabo Municipio,2006,46508,43811,2697,5.8
72,63,Gurabo Municipio,2006,16101,14527,1574,9.8
72,65,Hatillo Municipio,2006,13469,11846,1623,12.0
72,67,Hormigueros Municipio,2006,6908,6165,743,10.8
72,69,Humacao Municipio,2006,21890,18772,3118,14.2
72,71,Isabela Municipio,2006,16721,14402,2319,13.9
72,73,Jayuya Municipio,2006,4855,4073,782,16.1
72,75,Juana Diaz Municipio,2006,18005,15943,2062,11.5
72,77,Juncos Municipio,2006,13569,11974,1595,11.8
72,79,Lajas Municipio,2006,9288,8166,1122,12.1
72,81,Lares Municipio,2006,12159,10764,1395,11.5
72,83,Las Marias Municipio,2006,3761,3289,472,12.5
72,85,Las Piedras Municipio,2006,13393,11644,1749,13.1
72,87,Loiza Municipio,2006,9177,8002,1175,12.8
72,89,Luquillo Municipio,2006,7380,6331,1049,14.2
72,91,Manati Municipio,2006,15368,13362,2006,13.1
72,93,Maricao Municipio,2006,2026,1780,246,12.1
72,95,Maunabo Municipio,2006,3759,3131,628,16.7
72,97,Mayaguez Municipio,2006,31545,27669,3876,12.3
72,99,Moca Municipio,2006,15795,13874,1921,12.2
72,101,Morovis Municipio,2006,9618,8264,1354,14.1
72,103,Naguabo Municipio,2006,7802,6683,1119,14.3
72,105,Naranjito Municipio,2006,8957,7985,972,10.9
72,107,Orocovis Municipio,2006,5719,4839,880,15.4
72,109,Patillas Municipio,2006,6228,5253,975,15.7
72,111,Penuelas Municipio,2006,9094,7855,1239,13.6
72,113,Ponce Municipio,2006,67401,60367,7034,10.4
72,115,Quebradillas Municipio,2006,9001,8002,999,11.1
72,117,Rincon Municipio,2006,5775,5080,695,12.0
72,119,Rio Grande Municipio,2006,18631,16661,1970,10.6
72,121,Sabana Grande Municipio,2006,9831,8606,1225,12.5
72,123,Salinas Municipio,2006,9597,8270,1327,13.8
72,125,San German Municipio,2006,13628,11963,1665,12.2
72,127,San Juan Municipio,2006,178108,165033,13075,7.3
72,129,San Lorenzo Municipio,2006,14915,13249,1666,11.2
72,131,San Sebastian Municipio,2006,16098,14086,2012,12.5
72,133,Santa Isabel Municipio,2006,9197,7984,1213,13.2
72,135,Toa Alta Municipio,2006,30279,28062,2217,7.3
72,137,Toa Baja Municipio,2006,37089,34154,2935,7.9
72,139,Trujillo Alto Municipio,2006,36170,33660,2510,6.9
72,141,Utuado Municipio,2006,9741,8329,1412,14.5
72,143,Vega Alta Municipio,2006,12952,11594,1358,10.5
72,145,Vega Baja Municipio,2006,21654,19071,2583,11.9
72,147,Vieques Municipio,2006,3300,2992,308,9.3
72,149,Villalba Municipio,2006,9681,8417,1264,13.1
72,151,Yabucoa Municipio,2006,11562,9647,1915,16.6
72,153,Yauco Municipio,2006,16747,14658,2089,12.5
1,1,Autauga,2007,24434,23610,824,3.4
1,3,Baldwin,2007,82829,80213,2616,3.2
1,5,Barbour,2007,10363,9698,665,6.4
1,7,Bibb,2007,8810,8443,367,4.2
1,9,Blount,2007,26683,25816,867,3.2
1,11,Bullock,2007,3666,3313,353,9.6
1,13,Butler,2007,9124,8551,573,6.3
1,15,Calhoun,2007,54983,52782,2201,4.0
1,17,Chambers,2007,15517,14489,1028,6.6
1,19,Cherokee,2007,12012,11500,512,4.3
1,21,Chilton,2007,19777,19093,684,3.5
1,23,Choctaw,2007,5197,4882,315,6.1
1,25,Clarke,2007,10386,9744,642,6.2
1,27,Clay,2007,6130,5784,346,5.6
1,29,Cleburne,2007,6497,6255,242,3.7
1,31,Coffee,2007,21124,20304,820,3.9
1,33,Colbert,2007,25446,24250,1196,4.7
1,35,Conecuh,2007,4979,4653,326,6.5
1,37,Coosa,2007,4698,4421,277,5.9
1,39,Covington,2007,17108,16432,676,4.0
1,41,Crenshaw,2007,6562,6273,289,4.4
1,43,Cullman,2007,39449,38100,1349,3.4
1,45,Dale,2007,20295,19477,818,4.0
1,47,Dallas,2007,15605,14279,1326,8.5
1,49,DeKalb,2007,31084,29731,1353,4.4
1,51,Elmore,2007,35880,34669,1211,3.4
1,53,Escambia,2007,14324,13549,775,5.4
1,55,Etowah,2007,45565,43491,2074,4.6
1,57,Fayette,2007,7405,7049,356,4.8
1,59,Franklin,2007,13774,13126,648,4.7
1,61,Geneva,2007,11559,11153,406,3.5
1,63,Greene,2007,3293,3080,213,6.5
1,65,Hale,2007,6994,6611,383,5.5
1,67,Henry,2007,7559,7144,415,5.5
1,69,Houston,2007,47278,45671,1607,3.4
1,71,Jackson,2007,27084,25835,1249,4.6
1,73,Jefferson,2007,315430,303023,12407,3.9
1,75,Lamar,2007,5871,5496,375,6.4
1,77,Lauderdale,2007,43357,41447,1910,4.4
1,79,Lawrence,2007,15843,15181,662,4.2
1,81,Lee,2007,65467,63037,2430,3.7
1,83,Limestone,2007,36415,35171,1244,3.4
1,85,Lowndes,2007,4772,4406,366,7.7
1,87,Macon,2007,8888,8397,491,5.5
1,89,Madison,2007,165619,160439,5180,3.1
1,91,Marengo,2007,8170,7728,442,5.4
1,93,Marion,2007,13007,12314,693,5.3
1,95,Marshall,2007,41398,39946,1452,3.5
1,97,Mobile,2007,184901,177341,7560,4.1
1,99,Monroe,2007,8971,8381,590,6.6
1,101,Montgomery,2007,106395,101939,4456,4.2
1,103,Morgan,2007,56760,54729,2031,3.6
1,105,Perry,2007,3554,3248,306,8.6
1,107,Pickens,2007,8034,7624,410,5.1
1,109,Pike,2007,15609,14967,642,4.1
1,111,Randolph,2007,9510,9017,493,5.2
1,113,Russell,2007,21792,20442,1350,6.2
1,115,St. Clair,2007,36117,34862,1255,3.5
1,117,Shelby,2007,99839,97177,2662,2.7
1,119,Sumter,2007,4791,4472,319,6.7
1,121,Talladega,2007,39019,36949,2070,5.3
1,123,Tallapoosa,2007,18357,17364,993,5.4
1,125,Tuscaloosa,2007,89193,86200,2993,3.4
1,127,Walker,2007,29122,27839,1283,4.4
1,129,Washington,2007,7020,6595,425,6.1
1,131,Wilcox,2007,3450,3110,340,9.9
1,133,Winston,2007,10313,9725,588,5.7
2,13,Aleutians East Borough,2007,1091,1006,85,7.8
2,16,Aleutians West Census Area,2007,3081,2915,166,5.4
2,20,Anchorage Borough/municipality,2007,150839,143224,7615,5.0
2,50,Bethel Census Area,2007,6935,6057,878,12.7
2,60,Bristol Bay Borough,2007,1062,1012,50,4.7
2,68,Denali Borough,2007,1597,1499,98,6.1
2,70,Dillingham Census Area,2007,2040,1856,184,9.0
2,90,Fairbanks North Star Borough,2007,45319,42824,2495,5.5
2,100,Haines Borough,2007,1443,1337,106,7.3
2,110,Juneau Borough/city,2007,18433,17611,822,4.5
2,122,Kenai Peninsula Borough,2007,25654,23653,2001,7.8
2,130,Ketchikan Gateway Borough,2007,8208,7749,459,5.6
2,150,Kodiak Island Borough,2007,6132,5751,381,6.2
2,158,Kusilvak Census Area,2007,2576,2056,520,20.2
2,164,Lake and Peninsula Borough,2007,1164,1101,63,5.4
2,170,Matanuska-Susitna Borough,2007,39736,36906,2830,7.1
2,180,Nome Census Area,2007,3788,3372,416,11.0
2,185,North Slope Borough,2007,4666,4417,249,5.3
2,188,Northwest Arctic Borough,2007,2962,2644,318,10.7
2,201,Prince of Wales-Outer Ketchikan Census Area,2007,2269,1964,305,13.4
2,220,Sitka Borough/city,2007,4628,4394,234,5.1
2,232,Skagway-Hoonah-Angoon Census Area,2007,1920,1683,237,12.3
2,240,Southeast Fairbanks Census Area,2007,3548,3243,305,8.6
2,261,Valdez-Cordova Census Area,2007,5208,4773,435,8.4
2,280,Wrangell-Petersburg Census Area,2007,2868,2595,273,9.5
2,282,Yakutat Borough/city,2007,307,286,21,6.8
2,290,Yukon-Koyukuk Census Area,2007,2756,2380,376,13.6
4,1,Apache,2007,20077,18351,1726,8.6
4,3,Cochise,2007,56983,54709,2274,4.0
4,5,Coconino,2007,70388,67814,2574,3.7
4,7,Gila,2007,21059,20173,886,4.2
4,9,Graham,2007,14221,13624,597,4.2
4,11,Greenlee,2007,3979,3852,127,3.2
4,12,La Paz,2007,7614,7232,382,5.0
4,13,Maricopa,2007,1935839,1874182,61657,3.2
4,15,Mohave,2007,90964,86816,4148,4.6
4,17,Navajo,2007,38032,35636,2396,6.3
4,19,Pima,2007,456210,439740,16470,3.6
4,21,Pinal,2007,111050,106097,4953,4.5
4,23,Santa Cruz,2007,17058,15828,1230,7.2
4,25,Yavapai,2007,97122,93610,3512,3.6
4,27,Yuma,2007,78208,67478,10730,13.7
5,1,Arkansas,2007,11833,10784,1049,8.9
5,3,Ashley,2007,9359,8586,773,8.3
5,5,Baxter,2007,17509,16545,964,5.5
5,7,Benton,2007,103619,99669,3950,3.8
5,9,Boone,2007,16758,15895,863,5.1
5,11,Bradley,2007,5722,5368,354,6.2
5,13,Calhoun,2007,2603,2425,178,6.8
5,15,Carroll,2007,13830,13223,607,4.4
5,17,Chicot,2007,4931,4517,414,8.4
5,19,Clark,2007,10921,10301,620,5.7
5,21,Clay,2007,6664,6037,627,9.4
5,23,Cleburne,2007,11531,10819,712,6.2
5,25,Cleveland,2007,4124,3885,239,5.8
5,27,Columbia,2007,10893,10171,722,6.6
5,29,Conway,2007,9936,9445,491,4.9
5,31,Craighead,2007,45366,43058,2308,5.1
5,33,Crawford,2007,28182,26783,1399,5.0
5,35,Crittenden,2007,22118,20653,1465,6.6
5,37,Cross,2007,8346,7720,626,7.5
5,39,Dallas,2007,3830,3556,274,7.2
5,41,Desha,2007,6099,5487,612,10.0
5,43,Drew,2007,8390,7757,633,7.5
5,45,Faulkner,2007,54457,52032,2425,4.5
5,47,Franklin,2007,8483,8097,386,4.6
5,49,Fulton,2007,5099,4841,258,5.1
5,51,Garland,2007,42151,39798,2353,5.6
5,53,Grant,2007,8471,8045,426,5.0
5,55,Greene,2007,18430,17212,1218,6.6
5,57,Hempstead,2007,10831,10183,648,6.0
5,59,Hot Spring,2007,15268,14443,825,5.4
5,61,Howard,2007,6365,6013,352,5.5
5,63,Independence,2007,17161,16086,1075,6.3
5,65,Izard,2007,5372,5051,321,6.0
5,67,Jackson,2007,7787,7192,595,7.6
5,69,Jefferson,2007,35111,32441,2670,7.6
5,71,Johnson,2007,11287,10735,552,4.9
5,73,Lafayette,2007,3101,2866,235,7.6
5,75,Lawrence,2007,7303,6795,508,7.0
5,77,Lee,2007,3588,3247,341,9.5
5,79,Lincoln,2007,4978,4582,396,8.0
5,81,Little River,2007,6449,6176,273,4.2
5,83,Logan,2007,10432,9904,528,5.1
5,85,Lonoke,2007,31278,29891,1387,4.4
5,87,Madison,2007,7675,7357,318,4.1
5,89,Marion,2007,6957,6575,382,5.5
5,91,Miller,2007,19523,18638,885,4.5
5,93,Mississippi,2007,21330,19755,1575,7.4
5,95,Monroe,2007,3846,3584,262,6.8
5,97,Montgomery,2007,4205,3980,225,5.4
5,99,Nevada,2007,4304,4056,248,5.8
5,101,Newton,2007,3473,3294,179,5.2
5,103,Ouachita,2007,11895,11017,878,7.4
5,105,Perry,2007,4770,4535,235,4.9
5,107,Phillips,2007,8941,8282,659,7.4
5,109,Pike,2007,5170,4873,297,5.7
5,111,Poinsett,2007,10779,9986,793,7.4
5,113,Polk,2007,8783,8345,438,5.0
5,115,Pope,2007,29863,28420,1443,4.8
5,117,Prairie,2007,4376,4121,255,5.8
5,119,Pulaski,2007,188562,179494,9068,4.8
5,121,Randolph,2007,7568,6856,712,9.4
5,123,St. Francis,2007,10427,9409,1018,9.8
5,125,Saline,2007,48397,46342,2055,4.2
5,127,Scott,2007,4813,4588,225,4.7
5,129,Searcy,2007,3579,3401,178,5.0
5,131,Sebastian,2007,61570,58352,3218,5.2
5,133,Sevier,2007,7694,7372,322,4.2
5,135,Sharp,2007,6364,5929,435,6.8
5,137,Stone,2007,4740,4466,274,5.8
5,139,Union,2007,19204,17869,1335,7.0
5,141,Van Buren,2007,6964,6545,419,6.0
5,143,Washington,2007,103418,99365,4053,3.9
5,145,White,2007,31667,29556,2111,6.7
5,147,Woodruff,2007,3494,3185,309,8.8
5,149,Yell,2007,10500,10043,457,4.4
6,1,Alameda,2007,746245,711529,34716,4.7
6,3,Alpine,2007,494,455,39,7.9
6,5,Amador,2007,17725,16707,1018,5.7
6,7,Butte,2007,101348,94674,6674,6.6
6,9,Calaveras,2007,20749,19431,1318,6.4
6,11,Colusa,2007,10223,9033,1190,11.6
6,13,Contra Costa,2007,515040,491176,23864,4.6
6,15,Del Norte,2007,11041,10219,822,7.4
6,17,El Dorado,2007,90504,85874,4630,5.1
6,19,Fresno,2007,418979,383536,35443,8.5
6,21,Glenn,2007,11986,10942,1044,8.7
6,23,Humboldt,2007,59356,55883,3473,5.9
6,25,Imperial,2007,65955,54157,11798,17.9
6,27,Inyo,2007,8897,8463,434,4.9
6,29,Kern,2007,345537,317580,27957,8.1
6,31,Kings,2007,57381,52455,4926,8.6
6,33,Lake,2007,24065,22053,2012,8.4
6,35,Lassen,2007,12449,11445,1004,8.1
6,37,Los Angeles,2007,4864654,4614575,250079,5.1
6,39,Madera,2007,63434,58735,4699,7.4
6,41,Marin,2007,132106,127331,4775,3.6
6,43,Mariposa,2007,9072,8532,540,6.0
6,45,Mendocino,2007,43171,40823,2348,5.4
6,47,Merced,2007,99923,89973,9950,10.0
6,49,Modoc,2007,3900,3589,311,8.0
6,51,Mono,2007,8143,7756,387,4.8
6,53,Monterey,2007,205698,191156,14542,7.1
6,55,Napa,2007,73342,70424,2918,4.0
6,57,Nevada,2007,50195,47812,2383,4.7
6,59,Orange,2007,1608580,1546709,61871,3.8
6,61,Placer,2007,172718,164566,8152,4.7
6,63,Plumas,2007,9958,9117,841,8.4
6,65,Riverside,2007,903169,849266,53903,6.0
6,67,Sacramento,2007,676692,640320,36372,5.4
6,69,San Benito,2007,24032,22312,1720,7.2
6,71,San Bernardino,2007,863306,815449,47857,5.5
6,73,San Diego,2007,1517503,1449165,68338,4.5
6,75,San Francisco/city,2007,433197,415008,18189,4.2
6,77,San Joaquin,2007,288930,265796,23134,8.0
6,79,San Luis Obispo,2007,134219,128525,5694,4.2
6,81,San Mateo,2007,370061,356109,13952,3.8
6,83,Santa Barbara,2007,213781,204561,9220,4.3
6,85,Santa Clara,2007,844626,805447,39179,4.6
6,87,Santa Cruz,2007,144897,136424,8473,5.8
6,89,Shasta,2007,82629,76499,6130,7.4
6,91,Sierra,2007,1611,1485,126,7.8
6,93,Siskiyou,2007,18805,17226,1579,8.4
6,95,Solano,2007,208475,197599,10876,5.2
6,97,Sonoma,2007,257688,246623,11065,4.3
6,99,Stanislaus,2007,227104,207607,19497,8.6
6,101,Sutter,2007,41020,37094,3926,9.6
6,103,Tehama,2007,24887,23106,1781,7.2
6,105,Trinity,2007,5028,4508,520,10.3
6,107,Tulare,2007,191736,174194,17542,9.1
6,109,Tuolumne,2007,25806,24223,1583,6.1
6,111,Ventura,2007,423646,403179,20467,4.8
6,113,Yolo,2007,97644,92108,5536,5.7
6,115,Yuba,2007,27369,24861,2508,9.2
8,1,Adams,2007,221445,212201,9244,4.2
8,3,Alamosa,2007,8424,8094,330,3.9
8,5,Arapahoe,2007,307557,296142,11415,3.7
8,7,Archuleta,2007,6661,6411,250,3.8
8,9,Baca,2007,2420,2360,60,2.5
8,11,Bent,2007,2444,2327,117,4.8
8,13,Boulder,2007,175158,169467,5691,3.2
8,14,Broomfield/city,2007,30245,29189,1056,3.5
8,15,Chaffee,2007,8282,7989,293,3.5
8,17,Cheyenne,2007,1378,1344,34,2.5
8,19,Clear Creek,2007,5696,5490,206,3.6
8,21,Conejos,2007,3670,3469,201,5.5
8,23,Costilla,2007,1314,1222,92,7.0
8,25,Crowley,2007,1939,1818,121,6.2
8,27,Custer,2007,2011,1932,79,3.9
8,29,Delta,2007,16555,16014,541,3.3
8,31,Denver/city,2007,317494,304470,13024,4.1
8,33,Dolores,2007,1039,988,51,4.9
8,35,Douglas,2007,156306,151479,4827,3.1
8,37,Eagle,2007,31199,30324,875,2.8
8,39,Elbert,2007,12909,12438,471,3.6
8,41,El Paso,2007,300057,287425,12632,4.2
8,43,Fremont,2007,19814,18888,926,4.7
8,45,Garfield,2007,35252,34395,857,2.4
8,47,Gilpin,2007,3444,3325,119,3.5
8,49,Grand,2007,9239,9001,238,2.6
8,51,Gunnison,2007,9604,9337,267,2.8
8,53,Hinsdale,2007,615,597,18,2.9
8,55,Huerfano,2007,3382,3223,159,4.7
8,57,Jackson,2007,1113,1085,28,2.5
8,59,Jefferson,2007,305986,294922,11064,3.6
8,61,Kiowa,2007,919,895,24,2.6
8,63,Kit Carson,2007,4514,4394,120,2.7
8,65,Lake,2007,4062,3919,143,3.5
8,67,La Plata,2007,31278,30415,863,2.8
8,69,Larimer,2007,173516,167722,5794,3.3
8,71,Las Animas,2007,8769,8456,313,3.6
8,73,Lincoln,2007,3041,2949,92,3.0
8,75,Logan,2007,11421,11074,347,3.0
8,77,Mesa,2007,78551,76092,2459,3.1
8,79,Mineral,2007,475,455,20,4.2
8,81,Moffat,2007,8596,8335,261,3.0
8,83,Montezuma,2007,13286,12778,508,3.8
8,85,Montrose,2007,20924,20184,740,3.5
8,87,Morgan,2007,14344,13870,474,3.3
8,89,Otero,2007,8887,8449,438,4.9
8,91,Ouray,2007,3077,2988,89,2.9
8,93,Park,2007,9684,9339,345,3.6
8,95,Phillips,2007,2442,2376,66,2.7
8,97,Pitkin,2007,11370,11066,304,2.7
8,99,Prowers,2007,6849,6615,234,3.4
8,101,Pueblo,2007,72422,69048,3374,4.7
8,103,Rio Blanco,2007,5391,5281,110,2.0
8,105,Rio Grande,2007,6599,6340,259,3.9
8,107,Routt,2007,15831,15423,408,2.6
8,109,Saguache,2007,3185,3020,165,5.2
8,111,San Juan,2007,568,545,23,4.0
8,113,San Miguel,2007,5701,5526,175,3.1
8,115,Sedgwick,2007,1842,1802,40,2.2
8,117,Summit,2007,17279,16813,466,2.7
8,119,Teller,2007,12522,12043,479,3.8
8,121,Washington,2007,2905,2828,77,2.7
8,123,Weld,2007,118051,113283,4768,4.0
8,125,Yuma,2007,6793,6650,143,2.1
9,1,Fairfield,2007,466477,448160,18317,3.9
9,3,Hartford,2007,452702,430719,21983,4.9
9,5,Litchfield,2007,104527,100126,4401,4.2
9,7,Middlesex,2007,93003,89392,3611,3.9
9,9,New Haven,2007,444169,422220,21949,4.9
9,11,New London,2007,147542,141390,6152,4.2
9,13,Tolland,2007,83960,80737,3223,3.8
9,15,Windham,2007,63618,60299,3319,5.2
10,1,Kent,2007,75328,72668,2660,3.5
10,3,New Castle,2007,276948,266780,10168,3.7
10,5,Sussex,2007,93029,89754,3275,3.5
11,1,District of Colu,2007,326557,307071,19486,6.0
12,1,Alachua,2007,128559,125393,3166,2.5
12,3,Baker,2007,11856,11503,353,3.0
12,5,Bay,2007,86338,83727,2611,3.0
12,7,Bradford,2007,12288,11945,343,2.8
12,9,Brevard,2007,264160,254689,9471,3.6
12,11,Broward,2007,995871,966723,29148,2.9
12,13,Calhoun,2007,5523,5357,166,3.0
12,15,Charlotte,2007,69354,66422,2932,4.2
12,17,Citrus,2007,55226,52919,2307,4.2
12,19,Clay,2007,93384,90686,2698,2.9
12,21,Collier,2007,151003,145515,5488,3.6
12,23,Columbia,2007,30810,29892,918,3.0
12,27,DeSoto,2007,14227,13651,576,4.0
12,29,Dixie,2007,5501,5303,198,3.6
12,31,Duval,2007,438685,423659,15026,3.4
12,33,Escambia,2007,140062,135527,4535,3.2
12,35,Flagler,2007,30608,28954,1654,5.4
12,37,Franklin,2007,4903,4774,129,2.6
12,39,Gadsden,2007,20643,19899,744,3.6
12,41,Gilchrist,2007,7574,7335,239,3.2
12,43,Glades,2007,4757,4570,187,3.9
12,45,Gulf,2007,6237,6041,196,3.1
12,47,Hamilton,2007,4597,4422,175,3.8
12,49,Hardee,2007,11782,11338,444,3.8
12,51,Hendry,2007,17795,16692,1103,6.2
12,53,Hernando,2007,61131,58194,2937,4.8
12,55,Highlands,2007,39968,38371,1597,4.0
12,57,Hillsborough,2007,591899,571863,20036,3.4
12,59,Holmes,2007,8729,8475,254,2.9
12,61,Indian River,2007,62191,59292,2899,4.7
12,63,Jackson,2007,21422,20727,695,3.2
12,65,Jefferson,2007,6720,6534,186,2.8
12,67,Lafayette,2007,2910,2839,71,2.4
12,69,Lake,2007,131984,127458,4526,3.4
12,71,Lee,2007,288940,277702,11238,3.9
12,73,Leon,2007,144350,140652,3698,2.6
12,75,Levy,2007,16694,16109,585,3.5
12,77,Liberty,2007,3655,3571,84,2.3
12,79,Madison,2007,6887,6541,346,5.0
12,81,Manatee,2007,146713,141707,5006,3.4
12,83,Marion,2007,136346,131155,5191,3.8
12,85,Martin,2007,64540,62200,2340,3.6
12,86,Miami-Dade,2007,1227055,1194185,32870,2.7
12,87,Monroe,2007,44625,43633,992,2.2
12,89,Nassau,2007,35043,34073,970,2.8
12,91,Okaloosa,2007,97182,94772,2410,2.5
12,93,Okeechobee,2007,17402,16646,756,4.3
12,95,Orange,2007,591776,573278,18498,3.1
12,97,Osceola,2007,132114,127460,4654,3.5
12,99,Palm Beach,2007,622198,599605,22593,3.6
12,101,Pasco,2007,191833,183976,7857,4.1
12,103,Pinellas,2007,447795,432618,15177,3.4
12,105,Polk,2007,266472,256508,9964,3.7
12,107,Putnam,2007,31727,30491,1236,3.9
12,109,St. Johns,2007,92058,89590,2468,2.7
12,111,St. Lucie,2007,122774,116935,5839,4.8
12,113,Santa Rosa,2007,69313,67217,2096,3.0
12,115,Sarasota,2007,170519,164161,6358,3.7
12,117,Seminole,2007,237532,230464,7068,3.0
12,119,Sumter,2007,31366,30459,907,2.9
12,121,Suwannee,2007,17268,16746,522,3.0
12,123,Taylor,2007,8760,8450,310,3.5
12,125,Union,2007,5117,4985,132,2.6
12,127,Volusia,2007,251049,242458,8591,3.4
12,129,Wakulla,2007,15057,14685,372,2.5
12,131,Walton,2007,31158,30451,707,2.3
12,133,Washington,2007,9599,9281,318,3.3
13,1,Appling,2007,9074,8553,521,5.7
13,3,Atkinson,2007,3390,3181,209,6.2
13,5,Bacon,2007,4734,4487,247,5.2
13,7,Baker,2007,1655,1565,90,5.4
13,9,Baldwin,2007,20740,19486,1254,6.0
13,11,Banks,2007,10574,10229,345,3.3
13,13,Barrow,2007,33812,32275,1537,4.5
13,15,Bartow,2007,45827,43388,2439,5.3
13,17,Ben Hill,2007,7897,7309,588,7.4
13,19,Berrien,2007,8791,8375,416,4.7
13,21,Bibb,2007,73750,69582,4168,5.7
13,23,Bleckley,2007,5361,5057,304,5.7
13,25,Brantley,2007,7550,7182,368,4.9
13,27,Brooks,2007,8396,8005,391,4.7
13,29,Bryan,2007,16587,15969,618,3.7
13,31,Bulloch,2007,32348,30830,1518,4.7
13,33,Burke,2007,9994,9159,835,8.4
13,35,Butts,2007,10145,9577,568,5.6
13,37,Calhoun,2007,2177,2021,156,7.2
13,39,Camden,2007,21574,20633,941,4.4
13,43,Candler,2007,4413,4201,212,4.8
13,45,Carroll,2007,53193,50420,2773,5.2
13,47,Catoosa,2007,35382,33996,1386,3.9
13,49,Charlton,2007,4591,4354,237,5.2
13,51,Chatham,2007,133454,127715,5739,4.3
13,53,Chattahoochee,2007,1709,1535,174,10.2
13,55,Chattooga,2007,10921,10224,697,6.4
13,57,Cherokee,2007,109496,105188,4308,3.9
13,59,Clarke,2007,64284,61583,2701,4.2
13,61,Clay,2007,1475,1386,89,6.0
13,63,Clayton,2007,136196,127764,8432,6.2
13,65,Clinch,2007,2761,2602,159,5.8
13,67,Cobb,2007,379948,363385,16563,4.4
13,69,Coffee,2007,16525,15465,1060,6.4
13,71,Colquitt,2007,20450,19458,992,4.9
13,73,Columbia,2007,59806,57347,2459,4.1
13,75,Cook,2007,7133,6695,438,6.1
13,77,Coweta,2007,59580,57012,2568,4.3
13,79,Crawford,2007,6118,5806,312,5.1
13,81,Crisp,2007,10625,9958,667,6.3
13,83,Dade,2007,8424,8037,387,4.6
13,85,Dawson,2007,11081,10636,445,4.0
13,87,Decatur,2007,11774,11004,770,6.5
13,89,DeKalb,2007,393477,372948,20529,5.2
13,91,Dodge,2007,9516,9003,513,5.4
13,93,Dooly,2007,4926,4644,282,5.7
13,95,Dougherty,2007,42001,39452,2549,6.1
13,97,Douglas,2007,64762,61488,3274,5.1
13,99,Early,2007,5333,5010,323,6.1
13,101,Echols,2007,2244,2170,74,3.3
13,103,Effingham,2007,28436,27414,1022,3.6
13,105,Elbert,2007,9861,9254,607,6.2
13,107,Emanuel,2007,10821,10216,605,5.6
13,109,Evans,2007,4977,4745,232,4.7
13,111,Fannin,2007,10979,10532,447,4.1
13,113,Fayette,2007,53459,51233,2226,4.2
13,115,Floyd,2007,49742,47198,2544,5.1
13,117,Forsyth,2007,84108,81089,3019,3.6
13,119,Franklin,2007,10441,9886,555,5.3
13,121,Fulton,2007,488450,462945,25505,5.2
13,123,Gilmer,2007,14192,13643,549,3.9
13,125,Glascock,2007,1118,1056,62,5.5
13,127,Glynn,2007,40654,39067,1587,3.9
13,129,Gordon,2007,26832,25463,1369,5.1
13,131,Grady,2007,12251,11717,534,4.4
13,133,Greene,2007,7454,7023,431,5.8
13,135,Gwinnett,2007,420498,402362,18136,4.3
13,137,Habersham,2007,20184,19313,871,4.3
13,139,Hall,2007,90583,87050,3533,3.9
13,141,Hancock,2007,3312,3011,301,9.1
13,143,Haralson,2007,12859,12205,654,5.1
13,145,Harris,2007,16032,15408,624,3.9
13,147,Hart,2007,10841,10078,763,7.0
13,149,Heard,2007,4898,4632,266,5.4
13,151,Henry,2007,96781,92215,4566,4.7
13,153,Houston,2007,68198,65336,2862,4.2
13,155,Irwin,2007,4307,4026,281,6.5
13,157,Jackson,2007,26924,25713,1211,4.5
13,159,Jasper,2007,6431,6096,335,5.2
13,161,Jeff Davis,2007,5271,4884,387,7.3
13,163,Jefferson,2007,7107,6560,547,7.7
13,165,Jenkins,2007,3338,3019,319,9.6
13,167,Johnson,2007,3730,3493,237,6.4
13,169,Jones,2007,14034,13389,645,4.6
13,171,Lamar,2007,7919,7487,432,5.5
13,173,Lanier,2007,4044,3881,163,4.0
13,175,Laurens,2007,22413,21191,1222,5.5
13,177,Lee,2007,17649,16952,697,3.9
13,179,Liberty,2007,24257,22885,1372,5.7
13,181,Lincoln,2007,3838,3598,240,6.3
13,183,Long,2007,5917,5680,237,4.0
13,185,Lowndes,2007,53602,51361,2241,4.2
13,187,Lumpkin,2007,13134,12545,589,4.5
13,189,McDuffie,2007,10600,9874,726,6.8
13,191,McIntosh,2007,5390,5151,239,4.4
13,193,Macon,2007,5096,4694,402,7.9
13,195,Madison,2007,15805,15166,639,4.0
13,197,Marion,2007,3318,3149,169,5.1
13,199,Meriwether,2007,9572,8964,608,6.4
13,201,Miller,2007,3575,3404,171,4.8
13,205,Mitchell,2007,10413,9834,579,5.6
13,207,Monroe,2007,13526,12926,600,4.4
13,209,Montgomery,2007,4592,4362,230,5.0
13,211,Morgan,2007,9485,9038,447,4.7
13,213,Murray,2007,21048,20009,1039,4.9
13,215,Muscogee,2007,85562,80720,4842,5.7
13,217,Newton,2007,46396,43758,2638,5.7
13,219,Oconee,2007,17984,17403,581,3.2
13,221,Oglethorpe,2007,7717,7394,323,4.2
13,223,Paulding,2007,65890,62981,2909,4.4
13,225,Peach,2007,11533,10851,682,5.9
13,227,Pickens,2007,15121,14505,616,4.1
13,229,Pierce,2007,8558,8192,366,4.3
13,231,Pike,2007,8064,7693,371,4.6
13,233,Polk,2007,20942,19929,1013,4.8
13,235,Pulaski,2007,4642,4442,200,4.3
13,237,Putnam,2007,10400,9907,493,4.7
13,239,Quitman,2007,1059,997,62,5.9
13,241,Rabun,2007,7279,6816,463,6.4
13,243,Randolph,2007,2747,2555,192,7.0
13,245,Richmond,2007,90932,84911,6021,6.6
13,247,Rockdale,2007,40335,38146,2189,5.4
13,249,Schley,2007,1822,1705,117,6.4
13,251,Screven,2007,7233,6852,381,5.3
13,253,Seminole,2007,3989,3753,236,5.9
13,255,Spalding,2007,28265,26531,1734,6.1
13,257,Stephens,2007,13580,12865,715,5.3
13,259,Stewart,2007,2273,2118,155,6.8
13,261,Sumter,2007,14815,13675,1140,7.7
13,263,Talbot,2007,3163,2943,220,7.0
13,265,Taliaferro,2007,850,777,73,8.6
13,267,Tattnall,2007,9136,8662,474,5.2
13,269,Taylor,2007,3333,3120,213,6.4
13,271,Telfair,2007,5006,4588,418,8.3
13,273,Terrell,2007,4430,4144,286,6.5
13,275,Thomas,2007,22953,21931,1022,4.5
13,277,Tift,2007,19120,18026,1094,5.7
13,279,Toombs,2007,13850,13139,711,5.1
13,281,Towns,2007,6013,5772,241,4.0
13,283,Treutlen,2007,2714,2544,170,6.3
13,285,Troup,2007,30446,28569,1877,6.2
13,287,Turner,2007,4948,4591,357,7.2
13,289,Twiggs,2007,4668,4383,285,6.1
13,291,Union,2007,11420,10971,449,3.9
13,293,Upson,2007,12018,11184,834,6.9
13,295,Walker,2007,33041,31450,1591,4.8
13,297,Walton,2007,41040,38999,2041,5.0
13,299,Ware,2007,15136,14335,801,5.3
13,301,Warren,2007,2459,2259,200,8.1
13,303,Washington,2007,8331,7821,510,6.1
13,305,Wayne,2007,12068,11360,708,5.9
13,307,Webster,2007,1245,1184,61,4.9
13,309,Wheeler,2007,2964,2799,165,5.6
13,311,White,2007,12884,12382,502,3.9
13,313,Whitfield,2007,46987,44663,2324,4.9
13,315,Wilcox,2007,3303,3093,210,6.4
13,317,Wilkes,2007,4576,4246,330,7.2
13,319,Wilkinson,2007,4582,4314,268,5.8
13,321,Worth,2007,10181,9589,592,5.8
15,1,Hawaii,2007,84547,81598,2949,3.5
15,3,Honolulu/city,2007,441359,429940,11419,2.6
15,7,Kauai,2007,32580,31716,864,2.7
15,9,Maui,2007,78225,75971,2254,2.9
16,1,Ada,2007,196976,191741,5235,2.7
16,3,Adams,2007,2001,1886,115,5.7
16,5,Bannock,2007,41338,40114,1224,3.0
16,7,Bear Lake,2007,3162,3089,73,2.3
16,9,Benewah,2007,4065,3816,249,6.1
16,11,Bingham,2007,22266,21679,587,2.6
16,13,Blaine,2007,13693,13373,320,2.3
16,15,Boise,2007,3579,3457,122,3.4
16,17,Bonner,2007,20666,19870,796,3.9
16,19,Bonneville,2007,50341,49228,1113,2.2
16,21,Boundary,2007,4580,4296,284,6.2
16,23,Butte,2007,1371,1337,34,2.5
16,25,Camas,2007,619,603,16,2.6
16,27,Canyon,2007,83360,80281,3079,3.7
16,29,Caribou,2007,3867,3756,111,2.9
16,31,Cassia,2007,10807,10466,341,3.2
16,33,Clark,2007,554,541,13,2.3
16,35,Clearwater,2007,3211,2971,240,7.5
16,37,Custer,2007,2332,2252,80,3.4
16,39,Elmore,2007,11261,10822,439,3.9
16,41,Franklin,2007,5757,5633,124,2.2
16,43,Fremont,2007,5783,5593,190,3.3
16,45,Gem,2007,7105,6834,271,3.8
16,47,Gooding,2007,8815,8623,192,2.2
16,49,Idaho,2007,7086,6726,360,5.1
16,51,Jefferson,2007,11134,10861,273,2.5
16,53,Jerome,2007,9838,9558,280,2.8
16,55,Kootenai,2007,69508,67190,2318,3.3
16,57,Latah,2007,17023,16556,467,2.7
16,59,Lemhi,2007,3749,3577,172,4.6
16,61,Lewis,2007,1705,1660,45,2.6
16,63,Lincoln,2007,2568,2479,89,3.5
16,65,Madison,2007,16460,16105,355,2.2
16,67,Minidoka,2007,10062,9671,391,3.9
16,69,Nez Perce,2007,19032,18460,572,3.0
16,71,Oneida,2007,2384,2342,42,1.8
16,73,Owyhee,2007,4493,4407,86,1.9
16,75,Payette,2007,10532,10089,443,4.2
16,77,Power,2007,3756,3606,150,4.0
16,79,Shoshone,2007,5869,5559,310,5.3
16,81,Teton,2007,5075,4989,86,1.7
16,83,Twin Falls,2007,37788,36745,1043,2.8
16,85,Valley,2007,5025,4817,208,4.1
16,87,Washington,2007,4692,4495,197,4.2
17,1,Adams,2007,39455,37904,1551,3.9
17,3,Alexander,2007,3268,2996,272,8.3
17,5,Bond,2007,8736,8279,457,5.2
17,7,Boone,2007,26667,24893,1774,6.7
17,9,Brown,2007,3463,3367,96,2.8
17,11,Bureau,2007,19415,18461,954,4.9
17,13,Calhoun,2007,2646,2470,176,6.7
17,15,Carroll,2007,8733,8290,443,5.1
17,17,Cass,2007,7682,7349,333,4.3
17,19,Champaign,2007,104705,100252,4453,4.3
17,21,Christian,2007,17927,17020,907,5.1
17,23,Clark,2007,8943,8442,501,5.6
17,25,Clay,2007,6976,6586,390,5.6
17,27,Clinton,2007,19274,18356,918,4.8
17,29,Coles,2007,27858,26627,1231,4.4
17,31,Cook,2007,2605588,2464876,140712,5.4
17,33,Crawford,2007,9783,9245,538,5.5
17,35,Cumberland,2007,5784,5487,297,5.1
17,37,DeKalb,2007,58939,56361,2578,4.4
17,39,De Witt,2007,8571,8152,419,4.9
17,41,Douglas,2007,10518,10065,453,4.3
17,43,DuPage,2007,527740,506801,20939,4.0
17,45,Edgar,2007,10572,10023,549,5.2
17,47,Edwards,2007,3443,3273,170,4.9
17,49,Effingham,2007,18791,18022,769,4.1
17,51,Fayette,2007,10305,9651,654,6.3
17,53,Ford,2007,7321,6954,367,5.0
17,55,Franklin,2007,18206,16766,1440,7.9
17,57,Fulton,2007,17857,16903,954,5.3
17,59,Gallatin,2007,2656,2490,166,6.3
17,61,Greene,2007,7153,6793,360,5.0
17,63,Grundy,2007,25660,24151,1509,5.9
17,65,Hamilton,2007,4295,4052,243,5.7
17,67,Hancock,2007,9940,9397,543,5.5
17,69,Hardin,2007,1706,1566,140,8.2
17,71,Henderson,2007,4042,3825,217,5.4
17,73,Henry,2007,27721,26376,1345,4.9
17,75,Iroquois,2007,16753,15907,846,5.0
17,77,Jackson,2007,33030,31496,1534,4.6
17,79,Jasper,2007,5186,4917,269,5.2
17,81,Jefferson,2007,21280,20220,1060,5.0
17,83,Jersey,2007,11820,11175,645,5.5
17,85,Jo Daviess,2007,13733,13173,560,4.1
17,87,Johnson,2007,5266,4930,336,6.4
17,89,Kane,2007,268353,256114,12239,4.6
17,91,Kankakee,2007,55681,52139,3542,6.4
17,93,Kendall,2007,55484,53021,2463,4.4
17,95,Knox,2007,25536,24239,1297,5.1
17,97,Lake,2007,370966,352951,18015,4.9
17,99,LaSalle,2007,58999,55438,3561,6.0
17,101,Lawrence,2007,8389,7982,407,4.9
17,103,Lee,2007,18551,17602,949,5.1
17,105,Livingston,2007,19599,18717,882,4.5
17,107,Logan,2007,13482,12828,654,4.9
17,109,McDonough,2007,17221,16483,738,4.3
17,111,McHenry,2007,178142,170185,7957,4.5
17,113,McLean,2007,90176,86758,3418,3.8
17,115,Macon,2007,54393,51300,3093,5.7
17,117,Macoupin,2007,24737,23248,1489,6.0
17,119,Madison,2007,140460,132839,7621,5.4
17,121,Marion,2007,18837,17624,1213,6.4
17,123,Marshall,2007,7315,6993,322,4.4
17,125,Mason,2007,7397,6909,488,6.6
17,127,Massac,2007,7638,7205,433,5.7
17,129,Menard,2007,6949,6639,310,4.5
17,131,Mercer,2007,8954,8467,487,5.4
17,133,Monroe,2007,18535,17743,792,4.3
17,135,Montgomery,2007,13627,12723,904,6.6
17,137,Morgan,2007,18035,17142,893,5.0
17,139,Moultrie,2007,8157,7858,299,3.7
17,141,Ogle,2007,27917,26352,1565,5.6
17,143,Peoria,2007,97404,92871,4533,4.7
17,145,Perry,2007,10000,9165,835,8.4
17,147,Piatt,2007,9046,8700,346,3.8
17,149,Pike,2007,8762,8360,402,4.6
17,151,Pope,2007,1968,1830,138,7.0
17,153,Pulaski,2007,2936,2725,211,7.2
17,155,Putnam,2007,3222,3034,188,5.8
17,157,Randolph,2007,15665,14841,824,5.3
17,159,Richland,2007,7804,7435,369,4.7
17,161,Rock Island,2007,80045,76394,3651,4.6
17,163,St. Clair,2007,125222,117508,7714,6.2
17,165,Saline,2007,12704,11883,821,6.5
17,167,Sangamon,2007,107566,102718,4848,4.5
17,169,Schuyler,2007,4430,4249,181,4.1
17,171,Scott,2007,2779,2635,144,5.2
17,173,Shelby,2007,11214,10669,545,4.9
17,175,Stark,2007,2992,2838,154,5.1
17,177,Stephenson,2007,25440,24130,1310,5.1
17,179,Tazewell,2007,73359,70222,3137,4.3
17,181,Union,2007,8406,7825,581,6.9
17,183,Vermilion,2007,37722,35373,2349,6.2
17,185,Wabash,2007,6412,6058,354,5.5
17,187,Warren,2007,9194,8779,415,4.5
17,189,Washington,2007,8518,8125,393,4.6
17,191,Wayne,2007,8410,8009,401,4.8
17,193,White,2007,8004,7589,415,5.2
17,195,Whiteside,2007,30784,29134,1650,5.4
17,197,Will,2007,359958,342270,17688,4.9
17,199,Williamson,2007,36212,33856,2356,6.5
17,201,Winnebago,2007,148651,139654,8997,6.1
17,203,Woodford,2007,21439,20693,746,3.5
18,1,Adams,2007,15933,15245,688,4.3
18,3,Allen,2007,180425,171736,8689,4.8
18,5,Bartholomew,2007,38478,37077,1401,3.6
18,7,Benton,2007,4329,4137,192,4.4
18,9,Blackford,2007,6540,6159,381,5.8
18,11,Boone,2007,27912,26938,974,3.5
18,13,Brown,2007,7602,7265,337,4.4
18,15,Carroll,2007,9910,9503,407,4.1
18,17,Cass,2007,18643,17720,923,5.0
18,19,Clark,2007,55051,52636,2415,4.4
18,21,Clay,2007,12859,12106,753,5.9
18,23,Clinton,2007,16742,15979,763,4.6
18,25,Crawford,2007,5231,4910,321,6.1
18,27,Daviess,2007,15096,14629,467,3.1
18,29,Dearborn,2007,26052,24725,1327,5.1
18,31,Decatur,2007,12290,11726,564,4.6
18,33,DeKalb,2007,20666,19522,1144,5.5
18,35,Delaware,2007,55056,52112,2944,5.3
18,37,Dubois,2007,22110,21424,686,3.1
18,39,Elkhart,2007,101144,96453,4691,4.6
18,41,Fayette,2007,10417,9655,762,7.3
18,43,Floyd,2007,37887,36298,1589,4.2
18,45,Fountain,2007,8638,8272,366,4.2
18,47,Franklin,2007,11767,11111,656,5.6
18,49,Fulton,2007,10347,9842,505,4.9
18,51,Gibson,2007,16732,15960,772,4.6
18,53,Grant,2007,31635,29668,1967,6.2
18,55,Greene,2007,15786,14968,818,5.2
18,57,Hamilton,2007,140492,136329,4163,3.0
18,59,Hancock,2007,35758,34397,1361,3.8
18,61,Harrison,2007,19378,18498,880,4.5
18,63,Hendricks,2007,72292,69899,2393,3.3
18,65,Henry,2007,22431,21119,1312,5.8
18,67,Howard,2007,37531,35447,2084,5.6
18,69,Huntington,2007,19993,19035,958,4.8
18,71,Jackson,2007,21855,20991,864,4.0
18,73,Jasper,2007,15487,14744,743,4.8
18,75,Jay,2007,11589,11081,508,4.4
18,77,Jefferson,2007,17055,16209,846,5.0
18,79,Jennings,2007,13644,12937,707,5.2
18,81,Johnson,2007,73082,70499,2583,3.5
18,83,Knox,2007,19692,18894,798,4.1
18,85,Kosciusko,2007,41018,39188,1830,4.5
18,87,LaGrange,2007,17001,16161,840,4.9
18,89,Lake,2007,225767,213961,11806,5.2
18,91,LaPorte,2007,52496,49809,2687,5.1
18,93,Lawrence,2007,22103,20652,1451,6.6
18,95,Madison,2007,60456,56581,3875,6.4
18,97,Marion,2007,459316,438287,21029,4.6
18,99,Marshall,2007,22759,21647,1112,4.9
18,101,Martin,2007,5125,4923,202,3.9
18,103,Miami,2007,16441,15499,942,5.7
18,105,Monroe,2007,68561,65976,2585,3.8
18,107,Montgomery,2007,19219,18470,749,3.9
18,109,Morgan,2007,36750,35198,1552,4.2
18,111,Newton,2007,6956,6587,369,5.3
18,113,Noble,2007,23127,21857,1270,5.5
18,115,Ohio,2007,3022,2871,151,5.0
18,117,Orange,2007,10439,9897,542,5.2
18,119,Owen,2007,11175,10618,557,5.0
18,121,Parke,2007,8012,7609,403,5.0
18,123,Perry,2007,9690,9255,435,4.5
18,125,Pike,2007,5998,5737,261,4.4
18,127,Porter,2007,82936,79723,3213,3.9
18,129,Posey,2007,13342,12769,573,4.3
18,131,Pulaski,2007,6789,6504,285,4.2
18,133,Putnam,2007,17492,16546,946,5.4
18,135,Randolph,2007,12637,11917,720,5.7
18,137,Ripley,2007,13889,13251,638,4.6
18,139,Rush,2007,9433,9001,432,4.6
18,141,St. Joseph,2007,132579,126025,6554,4.9
18,143,Scott,2007,11036,10451,585,5.3
18,145,Shelby,2007,23545,22510,1035,4.4
18,147,Spencer,2007,10410,9971,439,4.2
18,149,Starke,2007,10438,9814,624,6.0
18,151,Steuben,2007,16470,15473,997,6.1
18,153,Sullivan,2007,8905,8408,497,5.6
18,155,Switzerland,2007,5678,5455,223,3.9
18,157,Tippecanoe,2007,81376,78126,3250,4.0
18,159,Tipton,2007,7697,7334,363,4.7
18,161,Union,2007,3612,3441,171,4.7
18,163,Vanderburgh,2007,90672,86371,4301,4.7
18,165,Vermillion,2007,7878,7431,447,5.7
18,167,Vigo,2007,50044,47366,2678,5.4
18,169,Wabash,2007,16966,16139,827,4.9
18,171,Warren,2007,4982,4820,162,3.3
18,173,Warrick,2007,30438,29242,1196,3.9
18,175,Washington,2007,13989,13249,740,5.3
18,177,Wayne,2007,33749,31916,1833,5.4
18,179,Wells,2007,14646,14032,614,4.2
18,181,White,2007,12266,11719,547,4.5
18,183,Whitley,2007,17708,16907,801,4.5
19,1,Adair,2007,4404,4250,154,3.5
19,3,Adams,2007,2102,2014,88,4.2
19,5,Allamakee,2007,8170,7780,390,4.8
19,7,Appanoose,2007,5964,5555,409,6.9
19,9,Audubon,2007,3279,3151,128,3.9
19,11,Benton,2007,14283,13726,557,3.9
19,13,Black Hawk,2007,72754,70031,2723,3.7
19,15,Boone,2007,15498,14990,508,3.3
19,17,Bremer,2007,13842,13410,432,3.1
19,19,Buchanan,2007,11041,10579,462,4.2
19,21,Buena Vista,2007,10397,10067,330,3.2
19,23,Butler,2007,8267,7935,332,4.0
19,25,Calhoun,2007,5219,5049,170,3.3
19,27,Carroll,2007,12250,11927,323,2.6
19,29,Cass,2007,7611,7296,315,4.1
19,31,Cedar,2007,10909,10555,354,3.2
19,33,Cerro Gordo,2007,25669,24663,1006,3.9
19,35,Cherokee,2007,6630,6390,240,3.6
19,37,Chickasaw,2007,6541,6268,273,4.2
19,39,Clarke,2007,4830,4629,201,4.2
19,41,Clay,2007,9765,9460,305,3.1
19,43,Clayton,2007,9750,9279,471,4.8
19,45,Clinton,2007,27469,26442,1027,3.7
19,47,Crawford,2007,9311,9003,308,3.3
19,49,Dallas,2007,32574,31640,934,2.9
19,51,Davis,2007,4084,3899,185,4.5
19,53,Decatur,2007,4200,4029,171,4.1
19,55,Delaware,2007,10779,10396,383,3.6
19,57,Des Moines,2007,21084,20149,935,4.4
19,59,Dickinson,2007,9753,9371,382,3.9
19,61,Dubuque,2007,52085,50011,2074,4.0
19,63,Emmet,2007,5934,5715,219,3.7
19,65,Fayette,2007,10913,10433,480,4.4
19,67,Floyd,2007,8719,8329,390,4.5
19,69,Franklin,2007,5969,5759,210,3.5
19,71,Fremont,2007,3961,3801,160,4.0
19,73,Greene,2007,4994,4817,177,3.5
19,75,Grundy,2007,6811,6594,217,3.2
19,77,Guthrie,2007,5862,5638,224,3.8
19,79,Hamilton,2007,8652,8375,277,3.2
19,81,Hancock,2007,6043,5815,228,3.8
19,83,Hardin,2007,9064,8720,344,3.8
19,85,Harrison,2007,7786,7460,326,4.2
19,87,Henry,2007,10324,9838,486,4.7
19,89,Howard,2007,5248,5056,192,3.7
19,91,Humboldt,2007,5204,5043,161,3.1
19,93,Ida,2007,4039,3904,135,3.3
19,95,Iowa,2007,8619,8301,318,3.7
19,97,Jackson,2007,11184,10662,522,4.7
19,99,Jasper,2007,17956,16816,1140,6.3
19,101,Jefferson,2007,8378,8033,345,4.1
19,103,Johnson,2007,77659,75549,2110,2.7
19,105,Jones,2007,10463,10029,434,4.1
19,107,Keokuk,2007,5634,5398,236,4.2
19,109,Kossuth,2007,8986,8664,322,3.6
19,111,Lee,2007,17350,16353,997,5.7
19,113,Linn,2007,118269,113920,4349,3.7
19,115,Louisa,2007,6438,6201,237,3.7
19,117,Lucas,2007,4778,4594,184,3.9
19,119,Lyon,2007,6687,6526,161,2.4
19,121,Madison,2007,8286,7943,343,4.1
19,123,Mahaska,2007,11758,11331,427,3.6
19,125,Marion,2007,17829,17191,638,3.6
19,127,Marshall,2007,20488,19658,830,4.1
19,129,Mills,2007,8093,7793,300,3.7
19,131,Mitchell,2007,5576,5390,186,3.3
19,133,Monona,2007,4589,4337,252,5.5
19,135,Monroe,2007,4179,4006,173,4.1
19,137,Montgomery,2007,5559,5213,346,6.2
19,139,Muscatine,2007,24018,23205,813,3.4
19,141,O'Brien,2007,7749,7514,235,3.0
19,143,Osceola,2007,3352,3240,112,3.3
19,145,Page,2007,8382,7996,386,4.6
19,147,Palo Alto,2007,5442,5258,184,3.4
19,149,Plymouth,2007,14445,14004,441,3.1
19,151,Pocahontas,2007,4136,4004,132,3.2
19,153,Polk,2007,237788,229474,8314,3.5
19,155,Pottawattamie,2007,48163,46111,2052,4.3
19,157,Poweshiek,2007,10758,10336,422,3.9
19,159,Ringgold,2007,2457,2355,102,4.2
19,161,Sac,2007,5803,5603,200,3.4
19,163,Scott,2007,88952,85615,3337,3.8
19,165,Shelby,2007,7545,7300,245,3.2
19,167,Sioux,2007,19355,18864,491,2.5
19,169,Story,2007,48087,46748,1339,2.8
19,171,Tama,2007,8990,8600,390,4.3
19,173,Taylor,2007,3360,3224,136,4.0
19,175,Union,2007,6585,6316,269,4.1
19,177,Van Buren,2007,3955,3786,169,4.3
19,179,Wapello,2007,18867,18047,820,4.3
19,181,Warren,2007,25497,24662,835,3.3
19,183,Washington,2007,11954,11545,409,3.4
19,185,Wayne,2007,3211,3065,146,4.5
19,187,Webster,2007,19848,19059,789,4.0
19,189,Winnebago,2007,5772,5572,200,3.5
19,191,Winneshiek,2007,12435,11982,453,3.6
19,193,Woodbury,2007,54925,52787,2138,3.9
19,195,Worth,2007,4528,4359,169,3.7
19,197,Wright,2007,7009,6734,275,3.9
20,1,Allen,2007,7507,7202,305,4.1
20,3,Anderson,2007,4149,3953,196,4.7
20,5,Atchison,2007,8793,8386,407,4.6
20,7,Barber,2007,2622,2537,85,3.2
20,9,Barton,2007,14888,14367,521,3.5
20,11,Bourbon,2007,8869,8475,394,4.4
20,13,Brown,2007,5516,5288,228,4.1
20,15,Butler,2007,32457,31111,1346,4.1
20,17,Chase,2007,1586,1522,64,4.0
20,19,Chautauqua,2007,1784,1699,85,4.8
20,21,Cherokee,2007,11123,10577,546,4.9
20,23,Cheyenne,2007,1417,1367,50,3.5
20,25,Clark,2007,1208,1171,37,3.1
20,27,Clay,2007,5074,4903,171,3.4
20,29,Cloud,2007,5598,5398,200,3.6
20,31,Coffey,2007,5108,4877,231,4.5
20,33,Comanche,2007,1080,1047,33,3.1
20,35,Cowley,2007,18235,17507,728,4.0
20,37,Crawford,2007,20245,19253,992,4.9
20,39,Decatur,2007,1666,1614,52,3.1
20,41,Dickinson,2007,10625,10211,414,3.9
20,43,Doniphan,2007,4557,4338,219,4.8
20,45,Douglas,2007,62192,59763,2429,3.9
20,47,Edwards,2007,1639,1582,57,3.5
20,49,Elk,2007,1425,1343,82,5.8
20,51,Ellis,2007,17165,16685,480,2.8
20,53,Ellsworth,2007,3695,3570,125,3.4
20,55,Finney,2007,17926,17311,615,3.4
20,57,Ford,2007,16669,16140,529,3.2
20,59,Franklin,2007,13837,13131,706,5.1
20,61,Geary,2007,11937,11410,527,4.4
20,63,Gove,2007,1504,1459,45,3.0
20,65,Graham,2007,1482,1436,46,3.1
20,67,Grant,2007,3962,3850,112,2.8
20,69,Gray,2007,3159,3075,84,2.7
20,71,Greeley,2007,699,676,23,3.3
20,73,Greenwood,2007,3575,3408,167,4.7
20,75,Hamilton,2007,1252,1209,43,3.4
20,77,Harper,2007,3399,3296,103,3.0
20,79,Harvey,2007,17992,17321,671,3.7
20,81,Haskell,2007,2155,2093,62,2.9
20,83,Hodgeman,2007,904,868,36,4.0
20,85,Jackson,2007,6955,6569,386,5.5
20,87,Jefferson,2007,9620,9138,482,5.0
20,89,Jewell,2007,1920,1865,55,2.9
20,91,Johnson,2007,299278,287082,12196,4.1
20,93,Kearny,2007,2131,2061,70,3.3
20,95,Kingman,2007,4291,4145,146,3.4
20,97,Kiowa,2007,1495,1424,71,4.7
20,99,Labette,2007,11367,10803,564,5.0
20,101,Lane,2007,1067,1029,38,3.6
20,103,Leavenworth,2007,32901,31122,1779,5.4
20,105,Lincoln,2007,1831,1759,72,3.9
20,107,Linn,2007,4759,4452,307,6.5
20,109,Logan,2007,1777,1726,51,2.9
20,111,Lyon,2007,19721,18910,811,4.1
20,113,McPherson,2007,16763,16179,584,3.5
20,115,Marion,2007,6705,6459,246,3.7
20,117,Marshall,2007,6066,5874,192,3.2
20,119,Meade,2007,2306,2239,67,2.9
20,121,Miami,2007,16491,15716,775,4.7
20,123,Mitchell,2007,3341,3222,119,3.6
20,125,Montgomery,2007,17607,16745,862,4.9
20,127,Morris,2007,2973,2828,145,4.9
20,129,Morton,2007,1686,1639,47,2.8
20,131,Nemaha,2007,5627,5454,173,3.1
20,133,Neosho,2007,9303,8919,384,4.1
20,135,Ness,2007,1737,1685,52,3.0
20,137,Norton,2007,2700,2612,88,3.3
20,139,Osage,2007,8537,8069,468,5.5
20,141,Osborne,2007,2211,2127,84,3.8
20,143,Ottawa,2007,3261,3137,124,3.8
20,145,Pawnee,2007,3996,3871,125,3.1
20,147,Phillips,2007,3233,3136,97,3.0
20,149,Pottawatomie,2007,11569,11191,378,3.3
20,151,Pratt,2007,5714,5536,178,3.1
20,153,Rawlins,2007,1235,1191,44,3.6
20,155,Reno,2007,32528,31149,1379,4.2
20,157,Republic,2007,2760,2671,89,3.2
20,159,Rice,2007,5613,5396,217,3.9
20,161,Riley,2007,39525,38284,1241,3.1
20,163,Rooks,2007,2658,2560,98,3.7
20,165,Rush,2007,1646,1585,61,3.7
20,167,Russell,2007,3493,3365,128,3.7
20,169,Saline,2007,30310,29230,1080,3.6
20,171,Scott,2007,2591,2519,72,2.8
20,173,Sedgwick,2007,251045,240393,10652,4.2
20,175,Seward,2007,10460,10106,354,3.4
20,177,Shawnee,2007,91509,87253,4256,4.7
20,179,Sheridan,2007,1555,1512,43,2.8
20,181,Sherman,2007,3637,3532,105,2.9
20,183,Smith,2007,2181,2112,69,3.2
20,185,Stafford,2007,2135,2056,79,3.7
20,187,Stanton,2007,1122,1088,34,3.0
20,189,Stevens,2007,2258,2183,75,3.3
20,191,Sumner,2007,11832,11309,523,4.4
20,193,Thomas,2007,4145,4019,126,3.0
20,195,Trego,2007,1692,1636,56,3.3
20,197,Wabaunsee,2007,3662,3515,147,4.0
20,199,Wallace,2007,905,879,26,2.9
20,201,Washington,2007,3338,3225,113,3.4
20,203,Wichita,2007,1239,1202,37,3.0
20,205,Wilson,2007,5523,5317,206,3.7
20,207,Woodson,2007,1671,1584,87,5.2
20,209,Wyandotte,2007,71548,66090,5458,7.6
21,1,Adair,2007,8926,8408,518,5.8
21,3,Allen,2007,8249,7768,481,5.8
21,5,Anderson,2007,11056,10508,548,5.0
21,7,Ballard,2007,4236,4003,233,5.5
21,9,Barren,2007,19530,18523,1007,5.2
21,11,Bath,2007,5056,4678,378,7.5
21,13,Bell,2007,9510,8750,760,8.0
21,15,Boone,2007,61815,59106,2709,4.4
21,17,Bourbon,2007,9706,9234,472,4.9
21,19,Boyd,2007,22877,21700,1177,5.1
21,21,Boyle,2007,12726,11959,767,6.0
21,23,Bracken,2007,4266,4012,254,6.0
21,25,Breathitt,2007,5650,5256,394,7.0
21,27,Breckinridge,2007,9113,8567,546,6.0
21,29,Bullitt,2007,38998,36805,2193,5.6
21,31,Butler,2007,5611,5256,355,6.3
21,33,Caldwell,2007,6641,6290,351,5.3
21,35,Calloway,2007,17778,16824,954,5.4
21,37,Campbell,2007,44606,42391,2215,5.0
21,39,Carlisle,2007,2264,2127,137,6.1
21,41,Carroll,2007,5735,5426,309,5.4
21,43,Carter,2007,13523,12566,957,7.1
21,45,Casey,2007,7332,6928,404,5.5
21,47,Christian,2007,29507,27643,1864,6.3
21,49,Clark,2007,17261,16426,835,4.8
21,51,Clay,2007,7008,6268,740,10.6
21,53,Clinton,2007,4647,4404,243,5.2
21,55,Crittenden,2007,3804,3573,231,6.1
21,57,Cumberland,2007,2968,2763,205,6.9
21,59,Daviess,2007,47197,44919,2278,4.8
21,61,Edmonson,2007,5330,4994,336,6.3
21,63,Elliott,2007,3046,2818,228,7.5
21,65,Estill,2007,6128,5735,393,6.4
21,67,Fayette,2007,151497,145461,6036,4.0
21,69,Fleming,2007,6494,6078,416,6.4
21,71,Floyd,2007,15107,14129,978,6.5
21,73,Franklin,2007,25133,24003,1130,4.5
21,75,Fulton,2007,2711,2509,202,7.5
21,77,Gallatin,2007,3899,3690,209,5.4
21,79,Garrard,2007,7698,7267,431,5.6
21,81,Grant,2007,12611,11920,691,5.5
21,83,Graves,2007,15975,14978,997,6.2
21,85,Grayson,2007,11269,10359,910,8.1
21,87,Green,2007,5640,5294,346,6.1
21,89,Greenup,2007,17516,16567,949,5.4
21,91,Hancock,2007,4195,3981,214,5.1
21,93,Hardin,2007,47474,45065,2409,5.1
21,95,Harlan,2007,10178,9267,911,9.0
21,97,Harrison,2007,9247,8798,449,4.9
21,99,Hart,2007,8150,7718,432,5.3
21,101,Henderson,2007,22727,21590,1137,5.0
21,103,Henry,2007,7832,7419,413,5.3
21,105,Hickman,2007,2037,1899,138,6.8
21,107,Hopkins,2007,23337,21959,1378,5.9
21,109,Jackson,2007,4346,3756,590,13.6
21,111,Jefferson,2007,356684,337896,18788,5.3
21,113,Jessamine,2007,22863,21852,1011,4.4
21,115,Johnson,2007,9681,9091,590,6.1
21,117,Kenton,2007,83679,79679,4000,4.8
21,119,Knott,2007,6243,5816,427,6.8
21,121,Knox,2007,12642,11797,845,6.7
21,123,Larue,2007,6944,6593,351,5.1
21,125,Laurel,2007,26656,25250,1406,5.3
21,127,Lawrence,2007,5824,5372,452,7.8
21,129,Lee,2007,2827,2642,185,6.5
21,131,Leslie,2007,3565,3256,309,8.7
21,133,Letcher,2007,8762,8113,649,7.4
21,135,Lewis,2007,5611,5188,423,7.5
21,137,Lincoln,2007,10628,9938,690,6.5
21,139,Livingston,2007,4852,4591,261,5.4
21,141,Logan,2007,12417,11757,660,5.3
21,143,Lyon,2007,3284,3075,209,6.4
21,145,McCracken,2007,31650,30113,1537,4.9
21,147,McCreary,2007,5850,5325,525,9.0
21,149,McLean,2007,4580,4315,265,5.8
21,151,Madison,2007,42707,40696,2011,4.7
21,153,Magoffin,2007,4352,3903,449,10.3
21,155,Marion,2007,10289,9761,528,5.1
21,157,Marshall,2007,14820,13970,850,5.7
21,159,Martin,2007,3451,3181,270,7.8
21,161,Mason,2007,8823,8419,404,4.6
21,163,Meade,2007,11636,10938,698,6.0
21,165,Menifee,2007,2641,2417,224,8.5
21,167,Mercer,2007,10637,10091,546,5.1
21,169,Metcalfe,2007,4432,4186,246,5.6
21,171,Monroe,2007,4866,4537,329,6.8
21,173,Montgomery,2007,12261,11553,708,5.8
21,175,Morgan,2007,4976,4545,431,8.7
21,177,Muhlenberg,2007,13570,12494,1076,7.9
21,179,Nelson,2007,21328,20102,1226,5.7
21,181,Nicholas,2007,3022,2833,189,6.3
21,183,Ohio,2007,12030,11402,628,5.2
21,185,Oldham,2007,27602,26294,1308,4.7
21,187,Owen,2007,5275,5010,265,5.0
21,189,Owsley,2007,1579,1435,144,9.1
21,191,Pendleton,2007,7319,6893,426,5.8
21,193,Perry,2007,11433,10637,796,7.0
21,195,Pike,2007,25188,23711,1477,5.9
21,197,Powell,2007,5677,5304,373,6.6
21,199,Pulaski,2007,27210,25611,1599,5.9
21,201,Robertson,2007,1066,1016,50,4.7
21,203,Rockcastle,2007,7252,6775,477,6.6
21,205,Rowan,2007,12204,11553,651,5.3
21,207,Russell,2007,8148,7650,498,6.1
21,209,Scott,2007,22371,21399,972,4.3
21,211,Shelby,2007,21293,20297,996,4.7
21,213,Simpson,2007,9361,8889,472,5.0
21,215,Spencer,2007,8934,8402,532,6.0
21,217,Taylor,2007,13751,13017,734,5.3
21,219,Todd,2007,5028,4701,327,6.5
21,221,Trigg,2007,6276,5911,365,5.8
21,223,Trimble,2007,4359,4092,267,6.1
21,225,Union,2007,7096,6703,393,5.5
21,227,Warren,2007,57637,55142,2495,4.3
21,229,Washington,2007,5414,5114,300,5.5
21,231,Wayne,2007,8588,8028,560,6.5
21,233,Webster,2007,6540,6159,381,5.8
21,235,Whitley,2007,15037,14083,954,6.3
21,237,Wolfe,2007,2318,2094,224,9.7
21,239,Woodford,2007,13288,12775,513,3.9
22,1,Acadia Parish,2007,26261,25310,951,3.6
22,3,Allen Parish,2007,8790,8307,483,5.5
22,5,Ascension Parish,2007,48869,47001,1868,3.8
22,7,Assumption Parish,2007,10439,9970,469,4.5
22,9,Avoyelles Parish,2007,15959,15165,794,5.0
22,11,Beauregard Parish,2007,14239,13565,674,4.7
22,13,Bienville Parish,2007,6560,6214,346,5.3
22,15,Bossier Parish,2007,52925,50836,2089,3.9
22,17,Caddo Parish,2007,118356,112421,5935,5.0
22,19,Calcasieu Parish,2007,91732,88138,3594,3.9
22,21,Caldwell Parish,2007,4536,4327,209,4.6
22,23,Cameron Parish,2007,3554,3429,125,3.5
22,25,Catahoula Parish,2007,4153,3921,232,5.6
22,27,Claiborne Parish,2007,6695,6339,356,5.3
22,29,Concordia Parish,2007,7315,6888,427,5.8
22,31,De Soto Parish,2007,11357,10726,631,5.6
22,33,East Baton Rouge Parish,2007,216274,207767,8507,3.9
22,35,East Carroll Parish,2007,3058,2770,288,9.4
22,37,East Feliciana Parish,2007,8037,7668,369,4.6
22,39,Evangeline Parish,2007,12308,11705,603,4.9
22,41,Franklin Parish,2007,7767,7266,501,6.5
22,43,Grant Parish,2007,8663,8274,389,4.5
22,45,Iberia Parish,2007,34374,33147,1227,3.6
22,47,Iberville Parish,2007,12240,11545,695,5.7
22,49,Jackson Parish,2007,6458,6187,271,4.2
22,51,Jefferson Parish,2007,221067,213404,7663,3.5
22,53,Jefferson Davis Parish,2007,14578,14090,488,3.3
22,55,Lafayette Parish,2007,110014,106850,3164,2.9
22,57,Lafourche Parish,2007,48759,47386,1373,2.8
22,59,LaSalle Parish,2007,6240,6010,230,3.7
22,61,Lincoln Parish,2007,18880,17981,899,4.8
22,63,Livingston Parish,2007,55789,53703,2086,3.7
22,65,Madison Parish,2007,4441,4152,289,6.5
22,67,Morehouse Parish,2007,11636,10726,910,7.8
22,69,Natchitoches Parish,2007,17419,16555,864,5.0
22,71,Orleans Parish,2007,107432,102178,5254,4.9
22,73,Ouachita Parish,2007,71533,68056,3477,4.9
22,75,Plaquemines Parish,2007,8999,8660,339,3.8
22,77,Pointe Coupee Parish,2007,9498,9067,431,4.5
22,79,Rapides Parish,2007,59757,57334,2423,4.1
22,81,Red River Parish,2007,3460,3240,220,6.4
22,83,Richland Parish,2007,8689,8161,528,6.1
22,85,Sabine Parish,2007,9423,9016,407,4.3
22,87,St. Bernard Parish,2007,9741,9335,406,4.2
22,89,St. Charles Parish,2007,26231,25270,961,3.7
22,91,St. Helena Parish,2007,4203,3898,305,7.3
22,93,St. James Parish,2007,8610,8036,574,6.7
22,95,St. John the Baptist Parish,2007,22458,21376,1082,4.8
22,97,St. Landry Parish,2007,37420,35757,1663,4.4
22,99,St. Martin Parish,2007,23628,22787,841,3.6
22,101,St. Mary Parish,2007,23316,22355,961,4.1
22,103,St. Tammany Parish,2007,116272,112677,3595,3.1
22,105,Tangipahoa Parish,2007,52269,49949,2320,4.4
22,107,Tensas Parish,2007,2206,2046,160,7.3
22,109,Terrebonne Parish,2007,54685,53097,1588,2.9
22,111,Union Parish,2007,10176,9677,499,4.9
22,113,Vermilion Parish,2007,24087,23193,894,3.7
22,115,Vernon Parish,2007,21132,20191,941,4.5
22,117,Washington Parish,2007,15848,14956,892,5.6
22,119,Webster Parish,2007,19765,18774,991,5.0
22,121,West Baton Rouge Parish,2007,10613,10193,420,4.0
22,123,West Carroll Parish,2007,4468,4058,410,9.2
22,125,West Feliciana Parish,2007,4778,4520,258,5.4
22,127,Winn Parish,2007,6362,6053,309,4.9
23,1,Androscoggin,2007,58065,55395,2670,4.6
23,3,Aroostook,2007,35097,32889,2208,6.3
23,5,Cumberland,2007,157217,151819,5398,3.4
23,7,Franklin,2007,14097,13240,857,6.1
23,9,Hancock,2007,29417,27806,1611,5.5
23,11,Kennebec,2007,62739,59864,2875,4.6
23,13,Knox,2007,21069,20152,917,4.4
23,15,Lincoln,2007,18172,17407,765,4.2
23,17,Oxford,2007,28276,26616,1660,5.9
23,19,Penobscot,2007,78472,74447,4025,5.1
23,21,Piscataquis,2007,7419,6862,557,7.5
23,23,Sagadahoc,2007,18880,18144,736,3.9
23,25,Somerset,2007,24865,23142,1723,6.9
23,27,Waldo,2007,18854,17829,1025,5.4
23,29,Washington,2007,14484,13371,1113,7.7
23,31,York,2007,112622,108082,4540,4.0
24,1,Allegany,2007,35190,33262,1928,5.5
24,3,Anne Arundel,2007,281588,272510,9078,3.2
24,5,Baltimore,2007,429814,413498,16316,3.8
24,9,Calvert,2007,47899,46452,1447,3.0
24,11,Caroline,2007,16313,15587,726,4.5
24,13,Carroll,2007,94564,91585,2979,3.2
24,15,Cecil,2007,50863,48768,2095,4.1
24,17,Charles,2007,76376,73999,2377,3.1
24,19,Dorchester,2007,16799,15758,1041,6.2
24,21,Frederick,2007,124435,120589,3846,3.1
24,23,Garrett,2007,16794,16004,790,4.7
24,25,Harford,2007,132534,127782,4752,3.6
24,27,Howard,2007,160127,155775,4352,2.7
24,29,Kent,2007,11198,10775,423,3.8
24,31,Montgomery,2007,512726,498244,14482,2.8
24,33,Prince George's,2007,448420,431117,17303,3.9
24,35,Queen Anne's,2007,26198,25324,874,3.3
24,37,St. Mary's,2007,51118,49495,1623,3.2
24,39,Somerset,2007,11257,10612,645,5.7
24,41,Talbot,2007,18985,18299,686,3.6
24,43,Washington,2007,68533,65332,3201,4.7
24,45,Wicomico,2007,52493,50299,2194,4.2
24,47,Worcester,2007,27712,25975,1737,6.3
24,510,Baltimore city,2007,277380,260952,16428,5.9
25,1,Barnstable,2007,121566,115716,5850,4.8
25,3,Berkshire,2007,72974,69747,3227,4.4
25,5,Bristol,2007,290705,273751,16954,5.8
25,7,Dukes,2007,11153,10758,395,3.5
25,9,Essex,2007,374594,356652,17942,4.8
25,11,Franklin,2007,39189,37547,1642,4.2
25,13,Hampden,2007,224123,211561,12562,5.6
25,15,Hampshire,2007,88498,85133,3365,3.8
25,17,Middlesex,2007,818839,788631,30208,3.7
25,19,Nantucket/town,2007,8548,8348,200,2.3
25,21,Norfolk,2007,355323,341383,13940,3.9
25,23,Plymouth,2007,260470,247929,12541,4.8
25,25,Suffolk,2007,365057,348575,16482,4.5
25,27,Worcester,2007,402189,382180,20009,5.0
26,1,Alcona,2007,4297,3853,444,10.3
26,3,Alger,2007,4390,4017,373,8.5
26,5,Allegan,2007,55953,52364,3589,6.4
26,7,Alpena,2007,14888,13628,1260,8.5
26,9,Antrim,2007,11850,10888,962,8.1
26,11,Arenac,2007,7862,7085,777,9.9
26,13,Baraga,2007,4260,3711,549,12.9
26,15,Barry,2007,30355,28683,1672,5.5
26,17,Bay,2007,54974,51188,3786,6.9
26,19,Benzie,2007,8988,8261,727,8.1
26,21,Berrien,2007,79601,74044,5557,7.0
26,23,Branch,2007,22234,20575,1659,7.5
26,25,Calhoun,2007,69706,64822,4884,7.0
26,27,Cass,2007,27170,25610,1560,5.7
26,29,Charlevoix,2007,14106,12862,1244,8.8
26,31,Cheboygan,2007,12459,11160,1299,10.4
26,33,Chippewa,2007,17505,15945,1560,8.9
26,35,Clare,2007,13201,11783,1418,10.7
26,37,Clinton,2007,37822,35732,2090,5.5
26,39,Crawford,2007,6649,6112,537,8.1
26,41,Delta,2007,20128,18576,1552,7.7
26,43,Dickinson,2007,14375,13495,880,6.1
26,45,Eaton,2007,58906,55787,3119,5.3
26,47,Emmet,2007,19797,17993,1804,9.1
26,49,Genesee,2007,208167,190633,17534,8.4
26,51,Gladwin,2007,10678,9591,1087,10.2
26,53,Gogebic,2007,7618,7020,598,7.8
26,55,Grand Traverse,2007,49016,45752,3264,6.7
26,57,Gratiot,2007,19839,18101,1738,8.8
26,59,Hillsdale,2007,21762,19840,1922,8.8
26,61,Houghton,2007,17641,16358,1283,7.3
26,63,Huron,2007,16699,15357,1342,8.0
26,65,Ingham,2007,153341,143744,9597,6.3
26,67,Ionia,2007,30456,28144,2312,7.6
26,69,Iosco,2007,10887,9791,1096,10.1
26,71,Iron,2007,5934,5490,444,7.5
26,73,Isabella,2007,38703,36658,2045,5.3
26,75,Jackson,2007,77491,71536,5955,7.7
26,77,Kalamazoo,2007,134522,127266,7256,5.4
26,79,Kalkaska,2007,8702,7994,708,8.1
26,81,Kent,2007,323134,303869,19265,6.0
26,83,Keweenaw,2007,1058,941,117,11.1
26,85,Lake,2007,4070,3641,429,10.5
26,87,Lapeer,2007,44033,40464,3569,8.1
26,89,Leelanau,2007,11352,10725,627,5.5
26,91,Lenawee,2007,49617,45650,3967,8.0
26,93,Livingston,2007,94300,89211,5089,5.4
26,95,Luce,2007,2771,2517,254,9.2
26,97,Mackinac,2007,6428,5774,654,10.2
26,99,Macomb,2007,418353,388415,29938,7.2
26,101,Manistee,2007,11973,10950,1023,8.5
26,103,Marquette,2007,35857,33591,2266,6.3
26,105,Mason,2007,14911,13739,1172,7.9
26,107,Mecosta,2007,20039,18511,1528,7.6
26,109,Menominee,2007,13194,12423,771,5.8
26,111,Midland,2007,42960,40557,2403,5.6
26,113,Missaukee,2007,6521,5961,560,8.6
26,115,Monroe,2007,77280,72035,5245,6.8
26,117,Montcalm,2007,26851,23695,3156,11.8
26,119,Montmorency,2007,4174,3618,556,13.3
26,121,Muskegon,2007,89376,82838,6538,7.3
26,123,Newaygo,2007,22934,21099,1835,8.0
26,125,Oakland,2007,621588,584886,36702,5.9
26,127,Oceana,2007,14389,13169,1220,8.5
26,129,Ogemaw,2007,9644,8821,823,8.5
26,131,Ontonagon,2007,3414,3125,289,8.5
26,133,Osceola,2007,9885,9085,800,8.1
26,135,Oscoda,2007,4010,3584,426,10.6
26,137,Otsego,2007,12323,11174,1149,9.3
26,139,Ottawa,2007,135690,127903,7787,5.7
26,141,Presque Isle,2007,6102,5324,778,12.7
26,143,Roscommon,2007,10464,9432,1032,9.9
26,145,Saginaw,2007,96855,89824,7031,7.3
26,147,St. Clair,2007,83278,76122,7156,8.6
26,149,St. Joseph,2007,31647,29614,2033,6.4
26,151,Sanilac,2007,21801,19810,1991,9.1
26,153,Schoolcraft,2007,3955,3520,435,11.0
26,155,Shiawassee,2007,36125,33126,2999,8.3
26,157,Tuscola,2007,28573,26132,2441,8.5
26,159,Van Buren,2007,40152,37319,2833,7.1
26,161,Washtenaw,2007,188162,178913,9249,4.9
26,163,Wayne,2007,878104,804318,73786,8.4
26,165,Wexford,2007,14577,13307,1270,8.7
27,1,Aitkin,2007,7699,7172,527,6.8
27,3,Anoka,2007,189109,180465,8644,4.6
27,5,Becker,2007,16809,15842,967,5.8
27,7,Beltrami,2007,21121,19839,1282,6.1
27,9,Benton,2007,22877,21728,1149,5.0
27,11,Big Stone,2007,2794,2660,134,4.8
27,13,Blue Earth,2007,36290,34921,1369,3.8
27,15,Brown,2007,14638,13925,713,4.9
27,17,Carlton,2007,17165,16184,981,5.7
27,19,Carver,2007,49527,47560,1967,4.0
27,21,Cass,2007,14226,13205,1021,7.2
27,23,Chippewa,2007,7053,6748,305,4.3
27,25,Chisago,2007,27278,25681,1597,5.9
27,27,Clay,2007,31196,30112,1084,3.5
27,29,Clearwater,2007,3864,3465,399,10.3
27,31,Cook,2007,3125,2973,152,4.9
27,33,Cottonwood,2007,6244,5991,253,4.1
27,35,Crow Wing,2007,32637,30802,1835,5.6
27,37,Dakota,2007,229164,219810,9354,4.1
27,39,Dodge,2007,10999,10521,478,4.3
27,41,Douglas,2007,19987,19098,889,4.4
27,43,Faribault,2007,7757,7348,409,5.3
27,45,Fillmore,2007,11129,10560,569,5.1
27,47,Freeborn,2007,16294,15485,809,5.0
27,49,Goodhue,2007,24939,23699,1240,5.0
27,51,Grant,2007,3011,2832,179,5.9
27,53,Hennepin,2007,653958,627171,26787,4.1
27,55,Houston,2007,10951,10393,558,5.1
27,57,Hubbard,2007,9166,8578,588,6.4
27,59,Isanti,2007,21635,20337,1298,6.0
27,61,Itasca,2007,22196,20576,1620,7.3
27,63,Jackson,2007,6515,6262,253,3.9
27,65,Kanabec,2007,7899,7242,657,8.3
27,67,Kandiyohi,2007,23373,22364,1009,4.3
27,69,Kittson,2007,2480,2337,143,5.8
27,71,Koochiching,2007,6501,6045,456,7.0
27,73,Lac qui Parle,2007,4045,3876,169,4.2
27,75,Lake,2007,6115,5839,276,4.5
27,77,Lake of the Woods,2007,2293,2176,117,5.1
27,79,Le Sueur,2007,14149,13272,877,6.2
27,81,Lincoln,2007,3202,3055,147,4.6
27,83,Lyon,2007,14416,13862,554,3.8
27,85,McLeod,2007,20336,19309,1027,5.1
27,87,Mahnomen,2007,2424,2259,165,6.8
27,89,Marshall,2007,5161,4745,416,8.1
27,91,Martin,2007,11228,10731,497,4.4
27,93,Meeker,2007,12350,11612,738,6.0
27,95,Mille Lacs,2007,12253,11309,944,7.7
27,97,Morrison,2007,17274,16203,1071,6.2
27,99,Mower,2007,20292,19466,826,4.1
27,101,Murray,2007,5368,5137,231,4.3
27,103,Nicollet,2007,19213,18511,702,3.7
27,105,Nobles,2007,11104,10716,388,3.5
27,107,Norman,2007,3542,3360,182,5.1
27,109,Olmsted,2007,79739,76706,3033,3.8
27,111,Otter Tail,2007,29248,27692,1556,5.3
27,113,Pennington,2007,8529,7937,592,6.9
27,115,Pine,2007,13680,12626,1054,7.7
27,117,Pipestone,2007,5278,5079,199,3.8
27,119,Polk,2007,16631,15863,768,4.6
27,121,Pope,2007,6085,5813,272,4.5
27,123,Ramsey,2007,270757,258795,11962,4.4
27,125,Red Lake,2007,2292,2105,187,8.2
27,127,Redwood,2007,8250,7859,391,4.7
27,129,Renville,2007,8460,8013,447,5.3
27,131,Rice,2007,32056,30456,1600,5.0
27,133,Rock,2007,4913,4756,157,3.2
27,135,Roseau,2007,9731,9113,618,6.4
27,137,St. Louis,2007,103076,97306,5770,5.6
27,139,Scott,2007,72908,69939,2969,4.1
27,141,Sherburne,2007,48614,46164,2450,5.0
27,143,Sibley,2007,8672,8232,440,5.1
27,145,Stearns,2007,83008,79194,3814,4.6
27,147,Steele,2007,20347,19466,881,4.3
27,149,Stevens,2007,5626,5415,211,3.8
27,151,Swift,2007,5301,5022,279,5.3
27,153,Todd,2007,12197,11531,666,5.5
27,155,Traverse,2007,1834,1739,95,5.2
27,157,Wabasha,2007,12184,11638,546,4.5
27,159,Wadena,2007,6257,5788,469,7.5
27,161,Waseca,2007,10231,9741,490,4.8
27,163,Washington,2007,127500,122373,5127,4.0
27,165,Watonwan,2007,5473,5196,277,5.1
27,167,Wilkin,2007,3475,3342,133,3.8
27,169,Winona,2007,28528,27331,1197,4.2
27,171,Wright,2007,65939,62584,3355,5.1
27,173,Yellow Medicine,2007,5672,5428,244,4.3
28,1,Adams,2007,13288,12431,857,6.4
28,3,Alcorn,2007,15297,14236,1061,6.9
28,5,Amite,2007,5118,4792,326,6.4
28,7,Attala,2007,7294,6737,557,7.6
28,9,Benton,2007,2891,2618,273,9.4
28,11,Bolivar,2007,15454,14200,1254,8.1
28,13,Calhoun,2007,6027,5534,493,8.2
28,15,Carroll,2007,4957,4640,317,6.4
28,17,Chickasaw,2007,7374,6631,743,10.1
28,19,Choctaw,2007,3454,3192,262,7.6
28,21,Claiborne,2007,3547,3154,393,11.1
28,23,Clarke,2007,7028,6508,520,7.4
28,25,Clay,2007,7876,6692,1184,15.0
28,27,Coahoma,2007,10336,9405,931,9.0
28,29,Copiah,2007,12081,11182,899,7.4
28,31,Covington,2007,8745,8273,472,5.4
28,33,DeSoto,2007,76189,73181,3008,3.9
28,35,Forrest,2007,36769,34921,1848,5.0
28,37,Franklin,2007,3114,2895,219,7.0
28,39,George,2007,9037,8390,647,7.2
28,41,Greene,2007,4896,4523,373,7.6
28,43,Grenada,2007,9577,8882,695,7.3
28,45,Hancock,2007,18154,17200,954,5.3
28,47,Harrison,2007,85695,81114,4581,5.3
28,49,Hinds,2007,116961,110451,6510,5.6
28,51,Holmes,2007,7112,6339,773,10.9
28,53,Humphreys,2007,4322,3940,382,8.8
28,55,Issaquena,2007,701,647,54,7.7
28,57,Itawamba,2007,9960,9246,714,7.2
28,59,Jackson,2007,59149,55891,3258,5.5
28,61,Jasper,2007,7498,7041,457,6.1
28,63,Jefferson,2007,2761,2395,366,13.3
28,65,Jefferson Davis,2007,5213,4843,370,7.1
28,67,Jones,2007,31064,29630,1434,4.6
28,69,Kemper,2007,4077,3757,320,7.8
28,71,Lafayette,2007,21939,20891,1048,4.8
28,73,Lamar,2007,23673,22664,1009,4.3
28,75,Lauderdale,2007,33017,30896,2121,6.4
28,77,Lawrence,2007,5111,4723,388,7.6
28,79,Leake,2007,8089,7571,518,6.4
28,81,Lee,2007,37358,35054,2304,6.2
28,83,Leflore,2007,13722,12621,1101,8.0
28,85,Lincoln,2007,14112,13197,915,6.5
28,87,Lowndes,2007,26010,24055,1955,7.5
28,89,Madison,2007,45024,42895,2129,4.7
28,91,Marion,2007,10249,9600,649,6.3
28,93,Marshall,2007,15293,14147,1146,7.5
28,95,Monroe,2007,16416,14893,1523,9.3
28,97,Montgomery,2007,4459,4049,410,9.2
28,99,Neshoba,2007,13878,13171,707,5.1
28,101,Newton,2007,9495,8959,536,5.6
28,103,Noxubee,2007,3990,3488,502,12.6
28,105,Oktibbeha,2007,19768,18458,1310,6.6
28,107,Panola,2007,14879,13689,1190,8.0
28,109,Pearl River,2007,21435,20159,1276,6.0
28,111,Perry,2007,5090,4743,347,6.8
28,113,Pike,2007,15301,14281,1020,6.7
28,115,Pontotoc,2007,13093,12239,854,6.5
28,117,Prentiss,2007,11021,10189,832,7.5
28,119,Quitman,2007,3750,3440,310,8.3
28,121,Rankin,2007,72413,69528,2885,4.0
28,123,Scott,2007,13160,12510,650,4.9
28,125,Sharkey,2007,2529,2319,210,8.3
28,127,Simpson,2007,11474,10839,635,5.5
28,129,Smith,2007,6678,6315,363,5.4
28,131,Stone,2007,7639,7205,434,5.7
28,133,Sunflower,2007,10810,9769,1041,9.6
28,135,Tallahatchie,2007,5987,5523,464,7.8
28,137,Tate,2007,11745,11036,709,6.0
28,139,Tippah,2007,9166,8512,654,7.1
28,141,Tishomingo,2007,7914,7279,635,8.0
28,143,Tunica,2007,4357,4013,344,7.9
28,145,Union,2007,11716,10991,725,6.2
28,147,Walthall,2007,5833,5463,370,6.3
28,149,Warren,2007,21958,20604,1354,6.2
28,151,Washington,2007,21888,20031,1857,8.5
28,153,Wayne,2007,8610,8052,558,6.5
28,155,Webster,2007,3388,3110,278,8.2
28,157,Wilkinson,2007,3570,3266,304,8.5
28,159,Winston,2007,7962,7431,531,6.7
28,161,Yalobusha,2007,5278,4869,409,7.7
28,163,Yazoo,2007,10078,9306,772,7.7
29,1,Adair,2007,13605,12953,652,4.8
29,3,Andrew,2007,10276,9872,404,3.9
29,5,Atchison,2007,3234,3093,141,4.4
29,7,Audrain,2007,12388,11780,608,4.9
29,9,Barry,2007,17877,17008,869,4.9
29,11,Barton,2007,5763,5266,497,8.6
29,13,Bates,2007,7982,7499,483,6.1
29,15,Benton,2007,8423,7924,499,5.9
29,17,Bollinger,2007,5784,5470,314,5.4
29,19,Boone,2007,88093,84829,3264,3.7
29,21,Buchanan,2007,48638,46480,2158,4.4
29,23,Butler,2007,21552,20140,1412,6.6
29,25,Caldwell,2007,4408,4168,240,5.4
29,27,Callaway,2007,22918,21907,1011,4.4
29,29,Camden,2007,22192,21112,1080,4.9
29,31,Cape Girardeau,2007,39294,37613,1681,4.3
29,33,Carroll,2007,5267,5002,265,5.0
29,35,Carter,2007,2926,2743,183,6.3
29,37,Cass,2007,50567,48065,2502,4.9
29,39,Cedar,2007,6534,6163,371,5.7
29,41,Chariton,2007,3965,3746,219,5.5
29,43,Christian,2007,40102,38550,1552,3.9
29,45,Clark,2007,3629,3429,200,5.5
29,47,Clay,2007,117261,112211,5050,4.3
29,49,Clinton,2007,10474,9935,539,5.1
29,51,Cole,2007,40452,38881,1571,3.9
29,53,Cooper,2007,9258,8844,414,4.5
29,55,Crawford,2007,12258,11399,859,7.0
29,57,Dade,2007,3774,3574,200,5.3
29,59,Dallas,2007,7560,7162,398,5.3
29,61,Daviess,2007,4063,3881,182,4.5
29,63,DeKalb,2007,5299,5025,274,5.2
29,65,Dent,2007,6705,6256,449,6.7
29,67,Douglas,2007,5926,5578,348,5.9
29,69,Dunklin,2007,14381,13231,1150,8.0
29,71,Franklin,2007,52942,49998,2944,5.6
29,73,Gasconade,2007,8173,7723,450,5.5
29,75,Gentry,2007,3425,3285,140,4.1
29,77,Greene,2007,142897,137206,5691,4.0
29,79,Grundy,2007,4841,4608,233,4.8
29,81,Harrison,2007,4583,4375,208,4.5
29,83,Henry,2007,10995,10379,616,5.6
29,85,Hickory,2007,3448,3191,257,7.5
29,87,Holt,2007,2724,2587,137,5.0
29,89,Howard,2007,5176,4946,230,4.4
29,91,Howell,2007,19966,19039,927,4.6
29,93,Iron,2007,5414,5126,288,5.3
29,95,Jackson,2007,339184,319386,19798,5.8
29,97,Jasper,2007,57011,54451,2560,4.5
29,99,Jefferson,2007,116953,110915,6038,5.2
29,101,Johnson,2007,26475,25252,1223,4.6
29,103,Knox,2007,2363,2273,90,3.8
29,105,Laclede,2007,17723,16738,985,5.6
29,107,Lafayette,2007,16575,15723,852,5.1
29,109,Lawrence,2007,19418,18634,784,4.0
29,111,Lewis,2007,5725,5500,225,3.9
29,113,Lincoln,2007,26569,25066,1503,5.7
29,115,Linn,2007,6504,6090,414,6.4
29,117,Livingston,2007,7215,6899,316,4.4
29,119,McDonald,2007,11593,11115,478,4.1
29,121,Macon,2007,8107,7704,403,5.0
29,123,Madison,2007,6103,5756,347,5.7
29,125,Maries,2007,4809,4560,249,5.2
29,127,Marion,2007,14546,13778,768,5.3
29,129,Mercer,2007,1818,1743,75,4.1
29,131,Miller,2007,13448,12743,705,5.2
29,133,Mississippi,2007,5924,5536,388,6.5
29,135,Moniteau,2007,7544,7197,347,4.6
29,137,Monroe,2007,4385,4134,251,5.7
29,139,Montgomery,2007,6171,5835,336,5.4
29,141,Morgan,2007,9407,8828,579,6.2
29,143,New Madrid,2007,8993,8376,617,6.9
29,145,Newton,2007,28072,26751,1321,4.7
29,147,Nodaway,2007,12672,12199,473,3.7
29,149,Oregon,2007,4589,4352,237,5.2
29,151,Osage,2007,7429,7079,350,4.7
29,153,Ozark,2007,4422,4191,231,5.2
29,155,Pemiscot,2007,8192,7654,538,6.6
29,157,Perry,2007,10497,10085,412,3.9
29,159,Pettis,2007,21136,20035,1101,5.2
29,161,Phelps,2007,22145,21054,1091,4.9
29,163,Pike,2007,8954,8505,449,5.0
29,165,Platte,2007,49063,47135,1928,3.9
29,167,Polk,2007,14486,13794,692,4.8
29,169,Pulaski,2007,18871,17897,974,5.2
29,171,Putnam,2007,2509,2370,139,5.5
29,173,Ralls,2007,5643,5367,276,4.9
29,175,Randolph,2007,13223,12516,707,5.3
29,177,Ray,2007,11565,10952,613,5.3
29,179,Reynolds,2007,2656,2474,182,6.9
29,181,Ripley,2007,6696,6251,445,6.6
29,183,St. Charles,2007,194048,186139,7909,4.1
29,185,St. Clair,2007,4256,3979,277,6.5
29,186,Ste. Genevieve,2007,10010,9544,466,4.7
29,187,St. Francois,2007,29569,27848,1721,5.8
29,189,St. Louis,2007,530105,503879,26226,4.9
29,195,Saline,2007,11792,11198,594,5.0
29,197,Schuyler,2007,2182,2057,125,5.7
29,199,Scotland,2007,2531,2411,120,4.7
29,201,Scott,2007,20087,18916,1171,5.8
29,203,Shannon,2007,3745,3489,256,6.8
29,205,Shelby,2007,3346,3179,167,5.0
29,207,Stoddard,2007,15639,14640,999,6.4
29,209,Stone,2007,16493,15435,1058,6.4
29,211,Sullivan,2007,3320,3116,204,6.1
29,213,Taney,2007,27579,25710,1869,6.8
29,215,Texas,2007,11098,10469,629,5.7
29,217,Vernon,2007,10154,9659,495,4.9
29,219,Warren,2007,16276,15399,877,5.4
29,221,Washington,2007,10083,9252,831,8.2
29,223,Wayne,2007,5735,5339,396,6.9
29,225,Webster,2007,17167,16347,820,4.8
29,227,Worth,2007,1155,1102,53,4.6
29,229,Wright,2007,8149,7663,486,6.0
29,510,St. Louis city,2007,158814,147597,11217,7.1
30,1,Beaverhead,2007,5065,4932,133,2.6
30,3,Big Horn,2007,5099,4778,321,6.3
30,5,Blaine,2007,2874,2771,103,3.6
30,7,Broadwater,2007,2386,2313,73,3.1
30,9,Carbon,2007,5384,5239,145,2.7
30,11,Carter,2007,689,669,20,2.9
30,13,Cascade,2007,39817,38511,1306,3.3
30,15,Chouteau,2007,2533,2458,75,3.0
30,17,Custer,2007,5795,5612,183,3.2
30,19,Daniels,2007,773,753,20,2.6
30,21,Dawson,2007,4282,4169,113,2.6
30,23,Deer Lodge,2007,3922,3745,177,4.5
30,25,Fallon,2007,1753,1720,33,1.9
30,27,Fergus,2007,5897,5676,221,3.7
30,29,Flathead,2007,46000,44283,1717,3.7
30,31,Gallatin,2007,50734,49480,1254,2.5
30,33,Garfield,2007,647,629,18,2.8
30,35,Glacier,2007,5831,5388,443,7.6
30,37,Golden Valley,2007,565,544,21,3.7
30,39,Granite,2007,1289,1231,58,4.5
30,41,Hill,2007,8124,7808,316,3.9
30,43,Jefferson,2007,5888,5714,174,3.0
30,45,Judith Basin,2007,1052,1015,37,3.5
30,47,Lake,2007,11699,11096,603,5.2
30,49,Lewis and Clark,2007,33502,32543,959,2.9
30,51,Liberty,2007,804,782,22,2.7
30,53,Lincoln,2007,7841,7286,555,7.1
30,55,McCone,2007,1007,986,21,2.1
30,57,Madison,2007,4475,4354,121,2.7
30,59,Meagher,2007,905,857,48,5.3
30,61,Mineral,2007,1980,1891,89,4.5
30,63,Missoula,2007,59518,57595,1923,3.2
30,65,Musselshell,2007,2047,1944,103,5.0
30,67,Park,2007,9130,8826,304,3.3
30,69,Petroleum,2007,237,225,12,5.1
30,71,Phillips,2007,2066,1984,82,4.0
30,73,Pondera,2007,2737,2635,102,3.7
30,75,Powder River,2007,903,876,27,3.0
30,77,Powell,2007,2657,2523,134,5.0
30,79,Prairie,2007,548,530,18,3.3
30,81,Ravalli,2007,18752,17958,794,4.2
30,83,Richland,2007,5472,5348,124,2.3
30,85,Roosevelt,2007,3872,3644,228,5.9
30,87,Rosebud,2007,3941,3748,193,4.9
30,89,Sanders,2007,4704,4410,294,6.3
30,91,Sheridan,2007,1742,1697,45,2.6
30,93,Silver Bow,2007,17502,16902,600,3.4
30,95,Stillwater,2007,4536,4402,134,3.0
30,97,Sweet Grass,2007,2941,2889,52,1.8
30,99,Teton,2007,3082,2992,90,2.9
30,101,Toole,2007,2471,2412,59,2.4
30,103,Treasure,2007,409,396,13,3.2
30,105,Valley,2007,3659,3539,120,3.3
30,107,Wheatland,2007,1046,1012,34,3.3
30,109,Wibaux,2007,519,505,14,2.7
30,111,Yellowstone,2007,81995,79907,2088,2.5
31,1,Adams,2007,17379,16917,462,2.7
31,3,Antelope,2007,3631,3530,101,2.8
31,5,Arthur,2007,238,229,9,3.8
31,7,Banner,2007,404,396,8,2.0
31,9,Blaine,2007,239,230,9,3.8
31,11,Boone,2007,3171,3095,76,2.4
31,13,Box Butte,2007,5614,5438,176,3.1
31,15,Boyd,2007,1076,1044,32,3.0
31,17,Brown,2007,1814,1767,47,2.6
31,19,Buffalo,2007,28054,27438,616,2.2
31,21,Burt,2007,3910,3757,153,3.9
31,23,Butler,2007,4832,4713,119,2.5
31,25,Cass,2007,13879,13429,450,3.2
31,27,Cedar,2007,4778,4664,114,2.4
31,29,Chase,2007,1997,1949,48,2.4
31,31,Cherry,2007,3390,3316,74,2.2
31,33,Cheyenne,2007,5245,5121,124,2.4
31,35,Clay,2007,3111,3027,84,2.7
31,37,Colfax,2007,5648,5526,122,2.2
31,39,Cuming,2007,4997,4864,133,2.7
31,41,Custer,2007,6007,5881,126,2.1
31,43,Dakota,2007,10928,10499,429,3.9
31,45,Dawes,2007,4803,4674,129,2.7
31,47,Dawson,2007,12353,11984,369,3.0
31,49,Deuel,2007,1050,1021,29,2.8
31,51,Dixon,2007,3314,3212,102,3.1
31,53,Dodge,2007,19831,19211,620,3.1
31,55,Douglas,2007,270030,261053,8977,3.3
31,57,Dundy,2007,1016,990,26,2.6
31,59,Fillmore,2007,3173,3095,78,2.5
31,61,Franklin,2007,1798,1749,49,2.7
31,63,Frontier,2007,1661,1624,37,2.2
31,65,Furnas,2007,2470,2397,73,3.0
31,67,Gage,2007,12512,12072,440,3.5
31,69,Garden,2007,935,911,24,2.6
31,71,Garfield,2007,1038,1012,26,2.5
31,73,Gosper,2007,1043,1011,32,3.1
31,75,Grant,2007,386,376,10,2.6
31,77,Greeley,2007,1278,1245,33,2.6
31,79,Hall,2007,30970,30127,843,2.7
31,81,Hamilton,2007,5643,5520,123,2.2
31,83,Harlan,2007,1814,1767,47,2.6
31,85,Hayes,2007,460,444,16,3.5
31,87,Hitchcock,2007,1443,1404,39,2.7
31,89,Holt,2007,6040,5888,152,2.5
31,91,Hooker,2007,465,452,13,2.8
31,93,Howard,2007,3710,3610,100,2.7
31,95,Jefferson,2007,4577,4455,122,2.7
31,97,Johnson,2007,2875,2793,82,2.9
31,99,Kearney,2007,3811,3728,83,2.2
31,101,Keith,2007,4663,4547,116,2.5
31,103,Keya Paha,2007,380,366,14,3.7
31,105,Kimball,2007,1975,1921,54,2.7
31,107,Knox,2007,4713,4577,136,2.9
31,109,Lancaster,2007,157419,153104,4315,2.7
31,111,Lincoln,2007,21763,21200,563,2.6
31,113,Logan,2007,471,458,13,2.8
31,115,Loup,2007,333,320,13,3.9
31,117,McPherson,2007,301,295,6,2.0
31,119,Madison,2007,18824,18241,583,3.1
31,121,Merrick,2007,4175,4057,118,2.8
31,123,Morrill,2007,2780,2708,72,2.6
31,125,Nance,2007,2021,1972,49,2.4
31,127,Nemaha,2007,3505,3374,131,3.7
31,129,Nuckolls,2007,2240,2183,57,2.5
31,131,Otoe,2007,8952,8689,263,2.9
31,133,Pawnee,2007,1587,1541,46,2.9
31,135,Perkins,2007,1577,1540,37,2.3
31,137,Phelps,2007,5103,4989,114,2.2
31,139,Pierce,2007,3956,3840,116,2.9
31,141,Platte,2007,18408,17968,440,2.4
31,143,Polk,2007,2967,2886,81,2.7
31,145,Red Willow,2007,5923,5777,146,2.5
31,147,Richardson,2007,4273,4101,172,4.0
31,149,Rock,2007,877,855,22,2.5
31,151,Saline,2007,8318,8101,217,2.6
31,153,Sarpy,2007,76827,74627,2200,2.9
31,155,Saunders,2007,10962,10629,333,3.0
31,157,Scotts Bluff,2007,19492,18926,566,2.9
31,159,Seward,2007,8897,8658,239,2.7
31,161,Sheridan,2007,3109,3028,81,2.6
31,163,Sherman,2007,1910,1860,50,2.6
31,165,Sioux,2007,707,688,19,2.7
31,167,Stanton,2007,3555,3452,103,2.9
31,169,Thayer,2007,2865,2790,75,2.6
31,171,Thomas,2007,377,364,13,3.4
31,173,Thurston,2007,2987,2795,192,6.4
31,175,Valley,2007,2573,2513,60,2.3
31,177,Washington,2007,11271,10958,313,2.8
31,179,Wayne,2007,5306,5173,133,2.5
31,181,Webster,2007,1804,1746,58,3.2
31,183,Wheeler,2007,418,406,12,2.9
31,185,York,2007,7651,7447,204,2.7
32,1,Churchill,2007,13287,12702,585,4.4
32,3,Clark,2007,960953,916771,44182,4.6
32,5,Douglas,2007,22834,21703,1131,5.0
32,7,Elko,2007,26685,25793,892,3.3
32,9,Esmeralda,2007,477,462,15,3.1
32,11,Eureka,2007,817,782,35,4.3
32,13,Humboldt,2007,8039,7746,293,3.6
32,15,Lander,2007,3420,3307,113,3.3
32,17,Lincoln,2007,1740,1665,75,4.3
32,19,Lyon,2007,22518,21047,1471,6.5
32,21,Mineral,2007,2260,2116,144,6.4
32,23,Nye,2007,18006,16810,1196,6.6
32,27,Pershing,2007,2517,2390,127,5.0
32,29,Storey,2007,2422,2300,122,5.0
32,31,Washoe,2007,224730,214900,9830,4.4
32,33,White Pine,2007,4796,4618,178,3.7
32,510,Carson City,2007,28705,27299,1406,4.9
33,1,Belknap,2007,32406,31252,1154,3.6
33,3,Carroll,2007,25495,24620,875,3.4
33,5,Cheshire,2007,42089,40599,1490,3.5
33,7,Coos,2007,16698,15928,770,4.6
33,9,Grafton,2007,48284,46859,1425,3.0
33,11,Hillsborough,2007,228211,220135,8076,3.5
33,13,Merrimack,2007,80318,77659,2659,3.3
33,15,Rockingham,2007,173670,167114,6556,3.8
33,17,Strafford,2007,68206,65983,2223,3.3
33,19,Sullivan,2007,22548,21875,673,3.0
34,1,Atlantic,2007,134896,127092,7804,5.8
34,3,Bergen,2007,470927,454919,16008,3.4
34,5,Burlington,2007,237345,228359,8986,3.8
34,7,Camden,2007,262212,249711,12501,4.8
34,9,Cape May,2007,56376,52731,3645,6.5
34,11,Cumberland,2007,68063,63677,4386,6.4
34,13,Essex,2007,361059,342021,19038,5.3
34,15,Gloucester,2007,153695,147157,6538,4.3
34,17,Hudson,2007,289627,275369,14258,4.9
34,19,Hunterdon,2007,71971,69949,2022,2.8
34,21,Mercer,2007,196121,188709,7412,3.8
34,23,Middlesex,2007,419879,403901,15978,3.8
34,25,Monmouth,2007,330722,318516,12206,3.7
34,27,Morris,2007,271413,263313,8100,3.0
34,29,Ocean,2007,256167,244647,11520,4.5
34,31,Passaic,2007,236167,223703,12464,5.3
34,33,Salem,2007,31235,29709,1526,4.9
34,35,Somerset,2007,179046,173572,5474,3.1
34,37,Sussex,2007,84000,80747,3253,3.9
34,39,Union,2007,266732,254927,11805,4.4
34,41,Warren,2007,58441,56253,2188,3.7
35,1,Bernalillo,2007,307876,297337,10539,3.4
35,3,Catron,2007,1483,1414,69,4.7
35,5,Chaves,2007,26424,25436,988,3.7
35,6,Cibola,2007,11794,11317,477,4.0
35,7,Colfax,2007,6467,6248,219,3.4
35,9,Curry,2007,20673,20109,564,2.7
35,11,De Baca,2007,768,739,29,3.8
35,13,Dona Ana,2007,85682,82263,3419,4.0
35,15,Eddy,2007,25690,24958,732,2.8
35,17,Grant,2007,12054,11612,442,3.7
35,19,Guadalupe,2007,1763,1664,99,5.6
35,21,Harding,2007,383,373,10,2.6
35,23,Hidalgo,2007,2483,2411,72,2.9
35,25,Lea,2007,27304,26655,649,2.4
35,27,Lincoln,2007,10731,10413,318,3.0
35,28,Los Alamos,2007,10342,10126,216,2.1
35,29,Luna,2007,12105,10925,1180,9.7
35,31,McKinley,2007,26334,25160,1174,4.5
35,33,Mora,2007,1985,1835,150,7.6
35,35,Otero,2007,25620,24685,935,3.6
35,37,Quay,2007,3783,3619,164,4.3
35,39,Rio Arriba,2007,20011,19099,912,4.6
35,41,Roosevelt,2007,9379,9126,253,2.7
35,43,Sandoval,2007,53232,51042,2190,4.1
35,45,San Juan,2007,54851,53075,1776,3.2
35,47,San Miguel,2007,13150,12622,528,4.0
35,49,Santa Fe,2007,76926,74709,2217,2.9
35,51,Sierra,2007,5466,5281,185,3.4
35,53,Socorro,2007,9219,8935,284,3.1
35,55,Taos,2007,17482,16662,820,4.7
35,57,Torrance,2007,6982,6671,311,4.5
35,59,Union,2007,1848,1800,48,2.6
35,61,Valencia,2007,30385,29244,1141,3.8
36,1,Albany,2007,158424,152391,6033,3.8
36,3,Allegany,2007,23355,22102,1253,5.4
36,5,Bronx,2007,512095,478314,33781,6.6
36,7,Broome,2007,96672,92442,4230,4.4
36,9,Cattaraugus,2007,41186,39119,2067,5.0
36,11,Cayuga,2007,41059,39267,1792,4.4
36,13,Chautauqua,2007,66653,63716,2937,4.4
36,15,Chemung,2007,40876,39035,1841,4.5
36,17,Chenango,2007,24356,23173,1183,4.9
36,19,Clinton,2007,39699,37513,2186,5.5
36,21,Columbia,2007,31708,30495,1213,3.8
36,23,Cortland,2007,23688,22482,1206,5.1
36,25,Delaware,2007,23085,22102,983,4.3
36,27,Dutchess,2007,145248,139676,5572,3.8
36,29,Erie,2007,464418,442978,21440,4.6
36,31,Essex,2007,18518,17486,1032,5.6
36,33,Franklin,2007,22586,21354,1232,5.5
36,35,Fulton,2007,27288,25845,1443,5.3
36,37,Genesee,2007,32805,31339,1466,4.5
36,39,Greene,2007,24076,22951,1125,4.7
36,41,Hamilton,2007,3201,3053,148,4.6
36,43,Herkimer,2007,30911,29422,1489,4.8
36,45,Jefferson,2007,48036,45457,2579,5.4
36,47,Kings,2007,1086150,1029077,57073,5.3
36,49,Lewis,2007,12460,11795,665,5.3
36,51,Livingston,2007,32185,30635,1550,4.8
36,53,Madison,2007,35889,34246,1643,4.6
36,55,Monroe,2007,372313,356147,16166,4.3
36,57,Montgomery,2007,24424,23019,1405,5.8
36,59,Nassau,2007,693675,668578,25097,3.6
36,61,New York,2007,917707,879249,38458,4.2
36,63,Niagara,2007,111140,105306,5834,5.2
36,65,Oneida,2007,109712,105098,4614,4.2
36,67,Onondaga,2007,232090,222787,9303,4.0
36,69,Ontario,2007,56121,53810,2311,4.1
36,71,Orange,2007,178890,171341,7549,4.2
36,73,Orleans,2007,19435,18328,1107,5.7
36,75,Oswego,2007,59289,56021,3268,5.5
36,77,Otsego,2007,31561,30159,1402,4.4
36,79,Putnam,2007,55576,53725,1851,3.3
36,81,Queens,2007,1102462,1054783,47679,4.3
36,83,Rensselaer,2007,82971,79498,3473,4.2
36,85,Richmond,2007,239804,229204,10600,4.4
36,87,Rockland,2007,153592,147773,5819,3.8
36,89,St. Lawrence,2007,49230,46422,2808,5.7
36,91,Saratoga,2007,119208,114914,4294,3.6
36,93,Schenectady,2007,75410,72334,3076,4.1
36,95,Schoharie,2007,15691,14799,892,5.7
36,97,Schuyler,2007,9946,9458,488,4.9
36,99,Seneca,2007,16960,16218,742,4.4
36,101,Steuben,2007,44642,42337,2305,5.2
36,103,Suffolk,2007,786514,756666,29848,3.8
36,105,Sullivan,2007,35155,33353,1802,5.1
36,107,Tioga,2007,26127,24923,1204,4.6
36,109,Tompkins,2007,55255,53423,1832,3.3
36,111,Ulster,2007,90314,86455,3859,4.3
36,113,Warren,2007,36254,34666,1588,4.4
36,115,Washington,2007,32343,31024,1319,4.1
36,117,Wayne,2007,47470,45264,2206,4.6
36,119,Westchester,2007,488704,470894,17810,3.6
36,121,Wyoming,2007,21381,20351,1030,4.8
36,123,Yates,2007,13030,12493,537,4.1
37,1,Alamance,2007,70249,66406,3843,5.5
37,3,Alexander,2007,18278,17244,1034,5.7
37,5,Alleghany,2007,4917,4642,275,5.6
37,7,Anson,2007,10361,9541,820,7.9
37,9,Ashe,2007,13127,12416,711,5.4
37,11,Avery,2007,8285,7865,420,5.1
37,13,Beaufort,2007,21404,20110,1294,6.0
37,15,Bertie,2007,8855,8320,535,6.0
37,17,Bladen,2007,15742,14693,1049,6.7
37,19,Brunswick,2007,47983,45622,2361,4.9
37,21,Buncombe,2007,120498,115900,4598,3.8
37,23,Burke,2007,40252,37662,2590,6.4
37,25,Cabarrus,2007,82931,78964,3967,4.8
37,27,Caldwell,2007,38639,35691,2948,7.6
37,29,Camden,2007,4634,4434,200,4.3
37,31,Carteret,2007,33324,31880,1444,4.3
37,33,Caswell,2007,10762,9987,775,7.2
37,35,Catawba,2007,76726,72163,4563,5.9
37,37,Chatham,2007,32586,31244,1342,4.1
37,39,Cherokee,2007,10280,9590,690,6.7
37,41,Chowan,2007,7157,6683,474,6.6
37,43,Clay,2007,4917,4703,214,4.4
37,45,Cleveland,2007,49586,46392,3194,6.4
37,47,Columbus,2007,24447,23023,1424,5.8
37,49,Craven,2007,43367,41363,2004,4.6
37,51,Cumberland,2007,129942,122499,7443,5.7
37,53,Currituck,2007,12557,12127,430,3.4
37,55,Dare,2007,22742,21547,1195,5.3
37,57,Davidson,2007,79680,74889,4791,6.0
37,59,Davie,2007,20656,19570,1086,5.3
37,61,Duplin,2007,24359,23187,1172,4.8
37,63,Durham,2007,136911,131286,5625,4.1
37,65,Edgecombe,2007,24384,22415,1969,8.1
37,67,Forsyth,2007,174005,165749,8256,4.7
37,69,Franklin,2007,27018,25722,1296,4.8
37,71,Gaston,2007,98017,91999,6018,6.1
37,73,Gates,2007,5003,4771,232,4.6
37,75,Graham,2007,4705,4342,363,7.7
37,77,Granville,2007,25193,23801,1392,5.5
37,79,Greene,2007,9212,8670,542,5.9
37,81,Guilford,2007,248155,235493,12662,5.1
37,83,Halifax,2007,24476,22779,1697,6.9
37,85,Harnett,2007,48130,45607,2523,5.2
37,87,Haywood,2007,27500,26300,1200,4.4
37,89,Henderson,2007,48538,46696,1842,3.8
37,91,Hertford,2007,9964,9400,564,5.7
37,93,Hoke,2007,19198,18146,1052,5.5
37,95,Hyde,2007,2701,2535,166,6.1
37,97,Iredell,2007,80127,76150,3977,5.0
37,99,Jackson,2007,21940,21067,873,4.0
37,101,Johnston,2007,75311,71967,3344,4.4
37,103,Jones,2007,4836,4603,233,4.8
37,105,Lee,2007,26583,24959,1624,6.1
37,107,Lenoir,2007,28046,26446,1600,5.7
37,109,Lincoln,2007,39920,37796,2124,5.3
37,111,McDowell,2007,21530,20233,1297,6.0
37,113,Macon,2007,16692,15954,738,4.4
37,115,Madison,2007,9857,9436,421,4.3
37,117,Martin,2007,12070,11379,691,5.7
37,119,Mecklenburg,2007,458257,435790,22467,4.9
37,121,Mitchell,2007,7385,6818,567,7.7
37,123,Montgomery,2007,11981,11164,817,6.8
37,125,Moore,2007,37314,35474,1840,4.9
37,127,Nash,2007,46555,43885,2670,5.7
37,129,New Hanover,2007,104582,100316,4266,4.1
37,131,Northampton,2007,9124,8536,588,6.4
37,133,Onslow,2007,60085,57173,2912,4.8
37,135,Orange,2007,68066,65684,2382,3.5
37,137,Pamlico,2007,5618,5358,260,4.6
37,139,Pasquotank,2007,18357,17364,993,5.4
37,141,Pender,2007,23662,22580,1082,4.6
37,143,Perquimans,2007,5358,5057,301,5.6
37,145,Person,2007,18960,17583,1377,7.3
37,147,Pitt,2007,79309,74957,4352,5.5
37,149,Polk,2007,9723,9364,359,3.7
37,151,Randolph,2007,74495,70711,3784,5.1
37,153,Richmond,2007,20812,19140,1672,8.0
37,155,Robeson,2007,57102,53299,3803,6.7
37,157,Rockingham,2007,44779,41796,2983,6.7
37,159,Rowan,2007,70793,66188,4605,6.5
37,161,Rutherford,2007,30445,28334,2111,6.9
37,163,Sampson,2007,33116,31693,1423,4.3
37,165,Scotland,2007,14623,13049,1574,10.8
37,167,Stanly,2007,30792,29173,1619,5.3
37,169,Stokes,2007,23883,22751,1132,4.7
37,171,Surry,2007,35273,33243,2030,5.8
37,173,Swain,2007,7327,6829,498,6.8
37,175,Transylvania,2007,13391,12856,535,4.0
37,177,Tyrrell,2007,2223,2087,136,6.1
37,179,Union,2007,91931,87999,3932,4.3
37,181,Vance,2007,19723,18309,1414,7.2
37,183,Wake,2007,442662,425915,16747,3.8
37,185,Warren,2007,7832,7306,526,6.7
37,187,Washington,2007,6444,5995,449,7.0
37,189,Watauga,2007,24800,23890,910,3.7
37,191,Wayne,2007,52896,50316,2580,4.9
37,193,Wilkes,2007,31485,29642,1843,5.9
37,195,Wilson,2007,40921,38149,2772,6.8
37,197,Yadkin,2007,19145,18260,885,4.6
37,199,Yancey,2007,8113,7605,508,6.3
38,1,Adams,2007,1295,1264,31,2.4
38,3,Barnes,2007,6035,5852,183,3.0
38,5,Benson,2007,2644,2475,169,6.4
38,7,Billings,2007,507,495,12,2.4
38,9,Bottineau,2007,3425,3306,119,3.5
38,11,Bowman,2007,1764,1730,34,1.9
38,13,Burke,2007,1017,992,25,2.5
38,15,Burleigh,2007,47286,46069,1217,2.6
38,17,Cass,2007,87785,85607,2178,2.5
38,19,Cavalier,2007,2095,2033,62,3.0
38,21,Dickey,2007,2950,2873,77,2.6
38,23,Divide,2007,901,872,29,3.2
38,25,Dunn,2007,1692,1629,63,3.7
38,27,Eddy,2007,1294,1225,69,5.3
38,29,Emmons,2007,1704,1618,86,5.0
38,31,Foster,2007,1702,1646,56,3.3
38,33,Golden Valley,2007,877,854,23,2.6
38,35,Grand Forks,2007,39420,38324,1096,2.8
38,37,Grant,2007,1200,1159,41,3.4
38,39,Griggs,2007,1314,1281,33,2.5
38,41,Hettinger,2007,1156,1111,45,3.9
38,43,Kidder,2007,1226,1168,58,4.7
38,45,LaMoure,2007,2189,2122,67,3.1
38,47,Logan,2007,929,897,32,3.4
38,49,McHenry,2007,2727,2595,132,4.8
38,51,McIntosh,2007,1422,1383,39,2.7
38,53,McKenzie,2007,2930,2843,87,3.0
38,55,McLean,2007,4728,4517,211,4.5
38,57,Mercer,2007,4756,4564,192,4.0
38,59,Morton,2007,15033,14543,490,3.3
38,61,Mountrail,2007,2971,2806,165,5.6
38,63,Nelson,2007,1643,1578,65,4.0
38,65,Oliver,2007,1131,1085,46,4.1
38,67,Pembina,2007,4022,3804,218,5.4
38,69,Pierce,2007,1913,1830,83,4.3
38,71,Ramsey,2007,5894,5668,226,3.8
38,73,Ransom,2007,3064,2971,93,3.0
38,75,Renville,2007,1292,1254,38,2.9
38,77,Richland,2007,9003,8712,291,3.2
38,79,Rolette,2007,5153,4699,454,8.8
38,81,Sargent,2007,2228,2149,79,3.5
38,83,Sheridan,2007,635,604,31,4.9
38,85,Sioux,2007,1293,1213,80,6.2
38,87,Slope,2007,630,620,10,1.6
38,89,Stark,2007,13961,13626,335,2.4
38,91,Steele,2007,1120,1095,25,2.2
38,93,Stutsman,2007,11887,11558,329,2.8
38,95,Towner,2007,1145,1101,44,3.8
38,97,Traill,2007,4240,4103,137,3.2
38,99,Walsh,2007,5737,5502,235,4.1
38,101,Ward,2007,29368,28515,853,2.9
38,103,Wells,2007,2133,2038,95,4.5
38,105,Williams,2007,13098,12857,241,1.8
39,1,Adams,2007,13648,12596,1052,7.7
39,3,Allen,2007,52648,49320,3328,6.3
39,5,Ashland,2007,27860,26187,1673,6.0
39,7,Ashtabula,2007,50101,46591,3510,7.0
39,9,Athens,2007,30839,28953,1886,6.1
39,11,Auglaize,2007,27356,26138,1218,4.5
39,13,Belmont,2007,33120,31260,1860,5.6
39,15,Brown,2007,21955,20527,1428,6.5
39,17,Butler,2007,192022,182161,9861,5.1
39,19,Carroll,2007,14038,13167,871,6.2
39,21,Champaign,2007,21198,19942,1256,5.9
39,23,Clark,2007,71896,67401,4495,6.3
39,25,Clermont,2007,106862,101426,5436,5.1
39,27,Clinton,2007,24629,23453,1176,4.8
39,29,Columbiana,2007,53931,50568,3363,6.2
39,31,Coshocton,2007,17644,16431,1213,6.9
39,33,Crawford,2007,22515,20936,1579,7.0
39,35,Cuyahoga,2007,648158,609626,38532,5.9
39,37,Darke,2007,28522,26913,1609,5.6
39,39,Defiance,2007,20948,19765,1183,5.6
39,41,Delaware,2007,91113,87466,3647,4.0
39,43,Erie,2007,42991,40386,2605,6.1
39,45,Fairfield,2007,76071,72248,3823,5.0
39,47,Fayette,2007,17020,16199,821,4.8
39,49,Franklin,2007,626677,597043,29634,4.7
39,51,Fulton,2007,23465,21981,1484,6.3
39,53,Gallia,2007,14614,13705,909,6.2
39,55,Geauga,2007,51191,48761,2430,4.7
39,57,Greene,2007,80265,76040,4225,5.3
39,59,Guernsey,2007,20037,18747,1290,6.4
39,61,Hamilton,2007,440844,418428,22416,5.1
39,63,Hancock,2007,41906,40013,1893,4.5
39,65,Hardin,2007,15924,14970,954,6.0
39,67,Harrison,2007,7472,7006,466,6.2
39,69,Henry,2007,16049,15036,1013,6.3
39,71,Highland,2007,21726,20432,1294,6.0
39,73,Hocking,2007,14336,13417,919,6.4
39,75,Holmes,2007,19884,19078,806,4.1
39,77,Huron,2007,29961,27523,2438,8.1
39,79,Jackson,2007,16042,14763,1279,8.0
39,81,Jefferson,2007,32246,30184,2062,6.4
39,83,Knox,2007,31359,29662,1697,5.4
39,85,Lake,2007,132620,125912,6708,5.1
39,87,Lawrence,2007,29820,28253,1567,5.3
39,89,Licking,2007,84252,79775,4477,5.3
39,91,Logan,2007,25512,24240,1272,5.0
39,93,Lorain,2007,158242,148800,9442,6.0
39,95,Lucas,2007,226009,210673,15336,6.8
39,97,Madison,2007,20246,19180,1066,5.3
39,99,Mahoning,2007,117965,110581,7384,6.3
39,101,Marion,2007,33215,31388,1827,5.5
39,103,Medina,2007,95218,90417,4801,5.0
39,105,Meigs,2007,9343,8506,837,9.0
39,107,Mercer,2007,24772,23818,954,3.9
39,109,Miami,2007,55687,52655,3032,5.4
39,111,Monroe,2007,5613,5153,460,8.2
39,113,Montgomery,2007,273316,256347,16969,6.2
39,115,Morgan,2007,5801,5258,543,9.4
39,117,Morrow,2007,18146,17084,1062,5.9
39,119,Muskingum,2007,39391,36321,3070,7.8
39,121,Noble,2007,5874,5438,436,7.4
39,123,Ottawa,2007,21927,20340,1587,7.2
39,125,Paulding,2007,11051,10498,553,5.0
39,127,Perry,2007,16571,15352,1219,7.4
39,129,Pickaway,2007,24719,23213,1506,6.1
39,131,Pike,2007,11005,9958,1047,9.5
39,133,Portage,2007,92879,87918,4961,5.3
39,135,Preble,2007,21850,20584,1266,5.8
39,137,Putnam,2007,18416,17531,885,4.8
39,139,Richland,2007,63057,58954,4103,6.5
39,141,Ross,2007,35319,32876,2443,6.9
39,143,Sandusky,2007,34203,32116,2087,6.1
39,145,Scioto,2007,32540,30112,2428,7.5
39,147,Seneca,2007,31457,29652,1805,5.7
39,149,Shelby,2007,28653,27271,1382,4.8
39,151,Stark,2007,193537,182223,11314,5.8
39,153,Summit,2007,299648,283411,16237,5.4
39,155,Trumbull,2007,107117,100405,6712,6.3
39,157,Tuscarawas,2007,48597,45986,2611,5.4
39,159,Union,2007,25663,24548,1115,4.3
39,161,Van Wert,2007,15701,14832,869,5.5
39,163,Vinton,2007,5939,5471,468,7.9
39,165,Warren,2007,108960,103929,5031,4.6
39,167,Washington,2007,33424,31688,1736,5.2
39,169,Wayne,2007,60649,57710,2939,4.8
39,171,Williams,2007,19932,18724,1208,6.1
39,173,Wood,2007,69936,66185,3751,5.4
39,175,Wyandot,2007,12337,11531,806,6.5
40,1,Adair,2007,10855,10356,499,4.6
40,3,Alfalfa,2007,2325,2226,99,4.3
40,5,Atoka,2007,5901,5591,310,5.3
40,7,Beaver,2007,3079,2999,80,2.6
40,9,Beckham,2007,11595,11323,272,2.3
40,11,Blaine,2007,4934,4732,202,4.1
40,13,Bryan,2007,20646,19945,701,3.4
40,15,Caddo,2007,11914,11340,574,4.8
40,17,Canadian,2007,50915,49046,1869,3.7
40,19,Carter,2007,25563,24718,845,3.3
40,21,Cherokee,2007,23148,22237,911,3.9
40,23,Choctaw,2007,6826,6475,351,5.1
40,25,Cimarron,2007,1259,1213,46,3.7
40,27,Cleveland,2007,117647,113429,4218,3.6
40,29,Coal,2007,2493,2343,150,6.0
40,31,Comanche,2007,44806,42921,1885,4.2
40,33,Cotton,2007,3958,3856,102,2.6
40,35,Craig,2007,7390,7060,330,4.5
40,37,Creek,2007,30926,29612,1314,4.2
40,39,Custer,2007,14481,14055,426,2.9
40,41,Delaware,2007,18359,17545,814,4.4
40,43,Dewey,2007,2447,2374,73,3.0
40,45,Ellis,2007,2372,2315,57,2.4
40,47,Garfield,2007,30253,29393,860,2.8
40,49,Garvin,2007,14485,14025,460,3.2
40,51,Grady,2007,22727,21759,968,4.3
40,53,Grant,2007,2535,2456,79,3.1
40,55,Greer,2007,1998,1903,95,4.8
40,57,Harmon,2007,1337,1292,45,3.4
40,59,Harper,2007,1875,1824,51,2.7
40,61,Haskell,2007,5641,5419,222,3.9
40,63,Hughes,2007,4846,4559,287,5.9
40,65,Jackson,2007,12561,12148,413,3.3
40,67,Jefferson,2007,2350,2237,113,4.8
40,69,Johnston,2007,5088,4876,212,4.2
40,71,Kay,2007,22885,21952,933,4.1
40,73,Kingfisher,2007,8347,8134,213,2.6
40,75,Kiowa,2007,3956,3787,169,4.3
40,77,Latimer,2007,4201,3998,203,4.8
40,79,Le Flore,2007,21133,19995,1138,5.4
40,81,Lincoln,2007,13883,13317,566,4.1
40,83,Logan,2007,16962,16329,633,3.7
40,85,Love,2007,5091,4938,153,3.0
40,87,McClain,2007,14710,14166,544,3.7
40,89,McCurtain,2007,13819,12962,857,6.2
40,91,McIntosh,2007,8480,8034,446,5.3
40,93,Major,2007,3961,3855,106,2.7
40,95,Marshall,2007,6368,6100,268,4.2
40,97,Mayes,2007,18223,17461,762,4.2
40,99,Murray,2007,8101,7877,224,2.8
40,101,Muskogee,2007,29521,27943,1578,5.3
40,103,Noble,2007,5924,5730,194,3.3
40,105,Nowata,2007,4903,4667,236,4.8
40,107,Okfuskee,2007,4655,4432,223,4.8
40,109,Oklahoma,2007,322760,308915,13845,4.3
40,111,Okmulgee,2007,16028,15170,858,5.4
40,113,Osage,2007,20118,19302,816,4.1
40,115,Ottawa,2007,16907,16098,809,4.8
40,117,Pawnee,2007,7362,7039,323,4.4
40,119,Payne,2007,37621,36271,1350,3.6
40,121,Pittsburg,2007,22615,21767,848,3.7
40,123,Pontotoc,2007,19978,19282,696,3.5
40,125,Pottawatomie,2007,32716,31396,1320,4.0
40,127,Pushmataha,2007,5216,4967,249,4.8
40,129,Roger Mills,2007,1866,1817,49,2.6
40,131,Rogers,2007,39805,38336,1469,3.7
40,133,Seminole,2007,10545,9987,558,5.3
40,135,Sequoyah,2007,17871,16865,1006,5.6
40,137,Stephens,2007,21527,20767,760,3.5
40,139,Texas,2007,9363,9077,286,3.1
40,141,Tillman,2007,3450,3294,156,4.5
40,143,Tulsa,2007,291123,280258,10865,3.7
40,145,Wagoner,2007,32510,31311,1199,3.7
40,147,Washington,2007,26882,25983,899,3.3
40,149,Washita,2007,5948,5774,174,2.9
40,151,Woods,2007,4413,4161,252,5.7
40,153,Woodward,2007,11987,11681,306,2.6
41,1,Baker,2007,7250,6830,420,5.8
41,3,Benton,2007,42085,40344,1741,4.1
41,5,Clackamas,2007,195293,186359,8934,4.6
41,7,Clatsop,2007,19777,18852,925,4.7
41,9,Columbia,2007,23611,22263,1348,5.7
41,11,Coos,2007,28059,26213,1846,6.6
41,13,Crook,2007,9735,9131,604,6.2
41,15,Curry,2007,9455,8837,618,6.5
41,17,Deschutes,2007,81208,77178,4030,5.0
41,19,Douglas,2007,46768,43171,3597,7.7
41,21,Gilliam,2007,1040,993,47,4.5
41,23,Grant,2007,3416,3142,274,8.0
41,25,Harney,2007,3299,3058,241,7.3
41,27,Hood River,2007,12809,12231,578,4.5
41,29,Jackson,2007,100900,95200,5700,5.6
41,31,Jefferson,2007,9236,8612,624,6.8
41,33,Josephine,2007,34666,32219,2447,7.1
41,35,Klamath,2007,30398,28294,2104,6.9
41,37,Lake,2007,3618,3355,263,7.3
41,39,Lane,2007,180440,171075,9365,5.2
41,41,Lincoln,2007,22382,21150,1232,5.5
41,43,Linn,2007,53351,49979,3372,6.3
41,45,Malheur,2007,12647,11934,713,5.6
41,47,Marion,2007,150907,142759,8148,5.4
41,49,Morrow,2007,5296,5007,289,5.5
41,51,Multnomah,2007,377019,358612,18407,4.9
41,53,Polk,2007,38251,36368,1883,4.9
41,55,Sherman,2007,925,880,45,4.9
41,57,Tillamook,2007,12362,11753,609,4.9
41,59,Umatilla,2007,36435,34322,2113,5.8
41,61,Union,2007,12165,11496,669,5.5
41,63,Wallowa,2007,3627,3407,220,6.1
41,65,Wasco,2007,13161,12514,647,4.9
41,67,Washington,2007,282376,270191,12185,4.3
41,69,Wheeler,2007,608,574,34,5.6
41,71,Yamhill,2007,46319,44001,2318,5.0
42,1,Adams,2007,55901,53971,1930,3.5
42,3,Allegheny,2007,633964,606795,27169,4.3
42,5,Armstrong,2007,32860,31159,1701,5.2
42,7,Beaver,2007,88987,84814,4173,4.7
42,9,Bedford,2007,23569,22191,1378,5.8
42,11,Berks,2007,203172,194242,8930,4.4
42,13,Blair,2007,65125,62299,2826,4.3
42,15,Bradford,2007,30850,29337,1513,4.9
42,17,Bucks,2007,347487,333787,13700,3.9
42,19,Butler,2007,96988,92956,4032,4.2
42,21,Cambria,2007,68397,64634,3763,5.5
42,23,Cameron,2007,2558,2399,159,6.2
42,25,Carbon,2007,31110,29382,1728,5.6
42,27,Centre,2007,73716,71036,2680,3.6
42,29,Chester,2007,267246,258591,8655,3.2
42,31,Clarion,2007,20299,19298,1001,4.9
42,33,Clearfield,2007,40819,38510,2309,5.7
42,35,Clinton,2007,19166,18126,1040,5.4
42,37,Columbia,2007,35235,33394,1841,5.2
42,39,Crawford,2007,42820,40631,2189,5.1
42,41,Cumberland,2007,123205,119042,4163,3.4
42,43,Dauphin,2007,135876,130371,5505,4.1
42,45,Delaware,2007,283258,271318,11940,4.2
42,47,Elk,2007,17494,16641,853,4.9
42,49,Erie,2007,140692,133663,7029,5.0
42,51,Fayette,2007,65728,61852,3876,5.9
42,53,Forest,2007,2398,2235,163,6.8
42,55,Franklin,2007,80767,77931,2836,3.5
42,57,Fulton,2007,8112,7644,468,5.8
42,59,Greene,2007,18142,17205,937,5.2
42,61,Huntingdon,2007,22205,21021,1184,5.3
42,63,Indiana,2007,45735,43532,2203,4.8
42,65,Jefferson,2007,23109,22004,1105,4.8
42,67,Juniata,2007,12495,11950,545,4.4
42,69,Lackawanna,2007,106985,101684,5301,5.0
42,71,Lancaster,2007,269648,260103,9545,3.5
42,73,Lawrence,2007,44107,41725,2382,5.4
42,75,Lebanon,2007,72139,69554,2585,3.6
42,77,Lehigh,2007,175900,167885,8015,4.6
42,79,Luzerne,2007,159243,151021,8222,5.2
42,81,Lycoming,2007,59374,56349,3025,5.1
42,83,McKean,2007,21693,20569,1124,5.2
42,85,Mercer,2007,55488,52304,3184,5.7
42,87,Mifflin,2007,22534,21315,1219,5.4
42,89,Monroe,2007,81675,77525,4150,5.1
42,91,Montgomery,2007,430147,414682,15465,3.6
42,93,Montour,2007,9218,8850,368,4.0
42,95,Northampton,2007,151980,145040,6940,4.6
42,97,Northumberland,2007,47347,44856,2491,5.3
42,99,Perry,2007,24570,23540,1030,4.2
42,101,Philadelphia/city,2007,621257,582110,39147,6.3
42,103,Pike,2007,27658,26106,1552,5.6
42,105,Potter,2007,7770,7189,581,7.5
42,107,Schuylkill,2007,73652,69833,3819,5.2
42,109,Snyder,2007,19847,18893,954,4.8
42,111,Somerset,2007,38908,36693,2215,5.7
42,113,Sullivan,2007,2998,2855,143,4.8
42,115,Susquehanna,2007,21659,20685,974,4.5
42,117,Tioga,2007,20394,19239,1155,5.7
42,119,Union,2007,17692,16728,964,5.4
42,121,Venango,2007,26093,24765,1328,5.1
42,123,Warren,2007,21436,20425,1011,4.7
42,125,Washington,2007,104136,99199,4937,4.7
42,127,Wayne,2007,25668,24554,1114,4.3
42,129,Westmoreland,2007,185955,177143,8812,4.7
42,131,Wyoming,2007,14426,13639,787,5.5
42,133,York,2007,225503,216627,8876,3.9
44,1,Bristol,2007,27550,26333,1217,4.4
44,3,Kent,2007,97450,92665,4785,4.9
44,5,Newport,2007,45216,43198,2018,4.5
44,7,Providence,2007,326920,308909,18011,5.5
44,9,Washington,2007,73949,70850,3099,4.2
45,1,Abbeville,2007,11693,10680,1013,8.7
45,3,Aiken,2007,75585,71235,4350,5.8
45,5,Allendale,2007,3610,3211,399,11.1
45,7,Anderson,2007,86160,80824,5336,6.2
45,9,Bamberg,2007,6335,5717,618,9.8
45,11,Barnwell,2007,8966,8072,894,10.0
45,13,Beaufort,2007,64720,61689,3031,4.7
45,15,Berkeley,2007,78657,74615,4042,5.1
45,17,Calhoun,2007,6994,6525,469,6.7
45,19,Charleston,2007,175734,167524,8210,4.7
45,21,Cherokee,2007,25627,23763,1864,7.3
45,23,Chester,2007,15752,13918,1834,11.6
45,25,Chesterfield,2007,18754,17197,1557,8.3
45,27,Clarendon,2007,12843,11690,1153,9.0
45,29,Colleton,2007,16690,15601,1089,6.5
45,31,Darlington,2007,31216,29032,2184,7.0
45,33,Dillon,2007,13192,11909,1283,9.7
45,35,Dorchester,2007,62931,59975,2956,4.7
45,37,Edgefield,2007,11133,10378,755,6.8
45,39,Fairfield,2007,11295,10269,1026,9.1
45,41,Florence,2007,63466,59334,4132,6.5
45,43,Georgetown,2007,29554,27596,1958,6.6
45,45,Greenville,2007,223700,212452,11248,5.0
45,47,Greenwood,2007,31394,29070,2324,7.4
45,49,Hampton,2007,7969,7398,571,7.2
45,51,Horry,2007,132002,124896,7106,5.4
45,53,Jasper,2007,10192,9692,500,4.9
45,55,Kershaw,2007,30034,28308,1726,5.7
45,57,Lancaster,2007,30290,27187,3103,10.2
45,59,Laurens,2007,33854,31258,2596,7.7
45,61,Lee,2007,8265,7546,719,8.7
45,63,Lexington,2007,133178,127316,5862,4.4
45,65,McCormick,2007,3557,3178,379,10.7
45,67,Marion,2007,13091,11479,1612,12.3
45,69,Marlboro,2007,12054,10525,1529,12.7
45,71,Newberry,2007,18266,17167,1099,6.0
45,73,Oconee,2007,30672,28413,2259,7.4
45,75,Orangeburg,2007,40935,37380,3555,8.7
45,77,Pickens,2007,58904,55703,3201,5.4
45,79,Richland,2007,181905,171683,10222,5.6
45,81,Saluda,2007,9239,8713,526,5.7
45,83,Spartanburg,2007,136097,127857,8240,6.1
45,85,Sumter,2007,45266,41859,3407,7.5
45,87,Union,2007,11848,10710,1138,9.6
45,89,Williamsburg,2007,15510,14016,1494,9.6
45,91,York,2007,106071,99935,6136,5.8
46,3,Aurora,2007,1362,1322,40,2.9
46,5,Beadle,2007,9314,9086,228,2.4
46,7,Bennett,2007,1370,1314,56,4.1
46,9,Bon Homme,2007,3048,2932,116,3.8
46,11,Brookings,2007,19429,19007,422,2.2
46,13,Brown,2007,20950,20464,486,2.3
46,15,Brule,2007,2774,2702,72,2.6
46,17,Buffalo,2007,482,429,53,11.0
46,19,Butte,2007,5267,5125,142,2.7
46,21,Campbell,2007,824,798,26,3.2
46,23,Charles Mix,2007,3973,3839,134,3.4
46,25,Clark,2007,1808,1743,65,3.6
46,27,Clay,2007,7507,7318,189,2.5
46,29,Codington,2007,16542,16102,440,2.7
46,31,Corson,2007,1334,1258,76,5.7
46,33,Custer,2007,4645,4516,129,2.8
46,35,Davison,2007,11125,10852,273,2.5
46,37,Day,2007,2834,2698,136,4.8
46,39,Deuel,2007,2639,2547,92,3.5
46,41,Dewey,2007,2481,2242,239,9.6
46,43,Douglas,2007,1652,1610,42,2.5
46,45,Edmunds,2007,2034,1982,52,2.6
46,47,Fall River,2007,3701,3581,120,3.2
46,49,Faulk,2007,1103,1068,35,3.2
46,51,Grant,2007,4167,4027,140,3.4
46,53,Gregory,2007,2341,2266,75,3.2
46,55,Haakon,2007,1150,1121,29,2.5
46,57,Hamlin,2007,2960,2877,83,2.8
46,59,Hand,2007,1847,1796,51,2.8
46,61,Hanson,2007,1950,1891,59,3.0
46,63,Harding,2007,737,718,19,2.6
46,65,Hughes,2007,10086,9851,235,2.3
46,67,Hutchinson,2007,3730,3617,113,3.0
46,69,Hyde,2007,724,700,24,3.3
46,71,Jackson,2007,1190,1126,64,5.4
46,73,Jerauld,2007,1359,1326,33,2.4
46,75,Jones,2007,693,678,15,2.2
46,77,Kingsbury,2007,2910,2827,83,2.9
46,79,Lake,2007,6793,6596,197,2.9
46,81,Lawrence,2007,13272,12933,339,2.6
46,83,Lincoln,2007,20903,20429,474,2.3
46,85,Lyman,2007,1943,1859,84,4.3
46,87,McCook,2007,2751,2675,76,2.8
46,89,McPherson,2007,1115,1068,47,4.2
46,91,Marshall,2007,2040,1954,86,4.2
46,93,Meade,2007,12295,11946,349,2.8
46,95,Mellette,2007,876,837,39,4.5
46,97,Miner,2007,1182,1141,41,3.5
46,99,Minnehaha,2007,98022,95554,2468,2.5
46,101,Moody,2007,4004,3854,150,3.7
46,102,Oglala Lakota,2007,3746,3451,295,7.9
46,103,Pennington,2007,53589,52138,1451,2.7
46,105,Perkins,2007,1623,1575,48,3.0
46,107,Potter,2007,1288,1250,38,3.0
46,109,Roberts,2007,4809,4615,194,4.0
46,111,Sanborn,2007,1451,1415,36,2.5
46,115,Spink,2007,3346,3240,106,3.2
46,117,Stanley,2007,1900,1856,44,2.3
46,119,Sully,2007,978,956,22,2.2
46,121,Todd,2007,3381,3185,196,5.8
46,123,Tripp,2007,2964,2878,86,2.9
46,125,Turner,2007,4244,4119,125,2.9
46,127,Union,2007,8092,7848,244,3.0
46,129,Walworth,2007,2676,2571,105,3.9
46,135,Yankton,2007,12126,11814,312,2.6
46,137,Ziebach,2007,853,802,51,6.0
47,1,Anderson,2007,35650,34152,1498,4.2
47,3,Bedford,2007,22837,21749,1088,4.8
47,5,Benton,2007,6956,6535,421,6.1
47,7,Bledsoe,2007,4910,4628,282,5.7
47,9,Blount,2007,62491,60050,2441,3.9
47,11,Bradley,2007,48006,45873,2133,4.4
47,13,Campbell,2007,16931,16036,895,5.3
47,15,Cannon,2007,6403,6095,308,4.8
47,17,Carroll,2007,13747,12887,860,6.3
47,19,Carter,2007,29527,28104,1423,4.8
47,21,Cheatham,2007,20405,19629,776,3.8
47,23,Chester,2007,7865,7455,410,5.2
47,25,Claiborne,2007,13156,12456,700,5.3
47,27,Clay,2007,3503,3227,276,7.9
47,29,Cocke,2007,16493,15465,1028,6.2
47,31,Coffee,2007,25828,24665,1163,4.5
47,33,Crockett,2007,6552,6152,400,6.1
47,35,Cumberland,2007,23057,21801,1256,5.4
47,37,Davidson,2007,323214,310959,12255,3.8
47,39,Decatur,2007,5752,5433,319,5.5
47,41,DeKalb,2007,10352,9896,456,4.4
47,43,Dickson,2007,23226,22269,957,4.1
47,45,Dyer,2007,17435,16579,856,4.9
47,47,Fayette,2007,17882,16807,1075,6.0
47,49,Fentress,2007,7789,7302,487,6.3
47,51,Franklin,2007,20149,19165,984,4.9
47,53,Gibson,2007,20967,19530,1437,6.9
47,55,Giles,2007,13374,12547,827,6.2
47,57,Grainger,2007,10151,9621,530,5.2
47,59,Greene,2007,31502,29347,2155,6.8
47,61,Grundy,2007,5954,5604,350,5.9
47,63,Hamblen,2007,30196,28780,1416,4.7
47,65,Hamilton,2007,167674,161101,6573,3.9
47,67,Hancock,2007,2449,2312,137,5.6
47,69,Hardeman,2007,11567,10818,749,6.5
47,71,Hardin,2007,11934,11289,645,5.4
47,73,Hawkins,2007,26231,25037,1194,4.6
47,75,Haywood,2007,9843,9163,680,6.9
47,77,Henderson,2007,12084,11310,774,6.4
47,79,Henry,2007,14076,13210,866,6.2
47,81,Hickman,2007,10039,9500,539,5.4
47,83,Houston,2007,3890,3681,209,5.4
47,85,Humphreys,2007,9122,8622,500,5.5
47,87,Jackson,2007,4957,4621,336,6.8
47,89,Jefferson,2007,24344,23111,1233,5.1
47,91,Johnson,2007,7365,6956,409,5.6
47,93,Knox,2007,228294,220566,7728,3.4
47,95,Lake,2007,2703,2546,157,5.8
47,97,Lauderdale,2007,10407,9727,680,6.5
47,99,Lawrence,2007,16640,15302,1338,8.0
47,101,Lewis,2007,5403,5013,390,7.2
47,103,Lincoln,2007,17413,16798,615,3.5
47,105,Loudon,2007,23146,22254,892,3.9
47,107,McMinn,2007,24737,23381,1356,5.5
47,109,McNairy,2007,12335,11602,733,5.9
47,111,Macon,2007,10499,9876,623,5.9
47,113,Madison,2007,48695,46312,2383,4.9
47,115,Marion,2007,13065,12300,765,5.9
47,117,Marshall,2007,12978,12010,968,7.5
47,119,Maury,2007,36660,33822,2838,7.7
47,121,Meigs,2007,4896,4593,303,6.2
47,123,Monroe,2007,19496,18364,1132,5.8
47,125,Montgomery,2007,68424,65228,3196,4.7
47,127,Moore,2007,3175,3045,130,4.1
47,129,Morgan,2007,8436,7952,484,5.7
47,131,Obion,2007,15632,14772,860,5.5
47,133,Overton,2007,10119,9395,724,7.2
47,135,Perry,2007,3134,2897,237,7.6
47,137,Pickett,2007,1924,1769,155,8.1
47,139,Polk,2007,7101,6747,354,5.0
47,141,Putnam,2007,35422,33830,1592,4.5
47,143,Rhea,2007,13085,12332,753,5.8
47,145,Roane,2007,26889,25714,1175,4.4
47,147,Robertson,2007,32877,31455,1422,4.3
47,149,Rutherford,2007,129770,124997,4773,3.7
47,151,Scott,2007,8712,8105,607,7.0
47,153,Sequatchie,2007,6144,5849,295,4.8
47,155,Sevier,2007,48027,45665,2362,4.9
47,157,Shelby,2007,443787,421526,22261,5.0
47,159,Smith,2007,9086,8604,482,5.3
47,161,Stewart,2007,5856,5501,355,6.1
47,163,Sullivan,2007,73546,70644,2902,3.9
47,165,Sumner,2007,78991,75782,3209,4.1
47,167,Tipton,2007,28106,26671,1435,5.1
47,169,Trousdale,2007,3661,3455,206,5.6
47,171,Unicoi,2007,8372,7938,434,5.2
47,173,Union,2007,8768,8382,386,4.4
47,175,Van Buren,2007,2488,2341,147,5.9
47,177,Warren,2007,17814,16687,1127,6.3
47,179,Washington,2007,61197,58747,2450,4.0
47,181,Wayne,2007,6626,6141,485,7.3
47,183,Weakley,2007,15629,14619,1010,6.5
47,185,White,2007,10540,9908,632,6.0
47,187,Williamson,2007,87630,84446,3184,3.6
47,189,Wilson,2007,57106,54819,2287,4.0
48,1,Anderson,2007,20053,19022,1031,5.1
48,3,Andrews,2007,6681,6464,217,3.2
48,5,Angelina,2007,39659,37901,1758,4.4
48,7,Aransas,2007,11005,10553,452,4.1
48,9,Archer,2007,5103,4939,164,3.2
48,11,Armstrong,2007,1069,1032,37,3.5
48,13,Atascosa,2007,18732,17955,777,4.1
48,15,Austin,2007,12829,12341,488,3.8
48,17,Bailey,2007,3280,3137,143,4.4
48,19,Bandera,2007,9585,9218,367,3.8
48,21,Bastrop,2007,33403,31993,1410,4.2
48,23,Baylor,2007,2025,1948,77,3.8
48,25,Bee,2007,11192,10522,670,6.0
48,27,Bell,2007,118680,113296,5384,4.5
48,29,Bexar,2007,734071,703389,30682,4.2
48,31,Blanco,2007,4767,4609,158,3.3
48,33,Borden,2007,372,357,15,4.0
48,35,Bosque,2007,8173,7820,353,4.3
48,37,Bowie,2007,42948,40893,2055,4.8
48,39,Brazoria,2007,138019,131878,6141,4.4
48,41,Brazos,2007,88163,84933,3230,3.7
48,43,Brewster,2007,5221,5046,175,3.4
48,45,Briscoe,2007,713,682,31,4.3
48,47,Brooks,2007,3084,2917,167,5.4
48,49,Brown,2007,18519,17750,769,4.2
48,51,Burleson,2007,7738,7435,303,3.9
48,53,Burnet,2007,21732,20968,764,3.5
48,55,Caldwell,2007,15421,14726,695,4.5
48,57,Calhoun,2007,9253,8836,417,4.5
48,59,Callahan,2007,6929,6691,238,3.4
48,61,Cameron,2007,142921,134360,8561,6.0
48,63,Camp,2007,5555,5299,256,4.6
48,65,Carson,2007,3351,3246,105,3.1
48,67,Cass,2007,12985,12277,708,5.5
48,69,Castro,2007,3425,3296,129,3.8
48,71,Chambers,2007,13829,13178,651,4.7
48,73,Cherokee,2007,20271,19285,986,4.9
48,75,Childress,2007,3012,2864,148,4.9
48,77,Clay,2007,6217,5997,220,3.5
48,79,Cochran,2007,1479,1404,75,5.1
48,81,Coke,2007,1379,1301,78,5.7
48,83,Coleman,2007,4371,4216,155,3.5
48,85,Collin,2007,396115,380761,15354,3.9
48,87,Collingsworth,2007,1535,1483,52,3.4
48,89,Colorado,2007,10449,10069,380,3.6
48,91,Comal,2007,52398,50490,1908,3.6
48,93,Comanche,2007,6466,6218,248,3.8
48,95,Concho,2007,1317,1250,67,5.1
48,97,Cooke,2007,21659,20876,783,3.6
48,99,Coryell,2007,23274,21884,1390,6.0
48,101,Cottle,2007,819,786,33,4.0
48,103,Crane,2007,1647,1579,68,4.1
48,105,Crockett,2007,2070,2008,62,3.0
48,107,Crosby,2007,2641,2514,127,4.8
48,109,Culberson,2007,1753,1705,48,2.7
48,111,Dallam,2007,3236,3145,91,2.8
48,113,Dallas,2007,1138195,1085305,52890,4.6
48,115,Dawson,2007,5080,4812,268,5.3
48,117,Deaf Smith,2007,8711,8397,314,3.6
48,119,Delta,2007,2304,2193,111,4.8
48,121,Denton,2007,337816,324568,13248,3.9
48,123,DeWitt,2007,8994,8636,358,4.0
48,125,Dickens,2007,1177,1131,46,3.9
48,127,Dimmit,2007,3961,3709,252,6.4
48,129,Donley,2007,1806,1726,80,4.4
48,131,Duval,2007,5137,4882,255,5.0
48,133,Eastland,2007,8126,7770,356,4.4
48,135,Ector,2007,66638,64365,2273,3.4
48,137,Edwards,2007,1001,961,40,4.0
48,139,Ellis,2007,69194,66175,3019,4.4
48,141,El Paso,2007,291434,274214,17220,5.9
48,143,Erath,2007,17926,17271,655,3.7
48,145,Falls,2007,6803,6442,361,5.3
48,147,Fannin,2007,13389,12690,699,5.2
48,149,Fayette,2007,12058,11669,389,3.2
48,151,Fisher,2007,1973,1895,78,4.0
48,153,Floyd,2007,3135,2970,165,5.3
48,155,Foard,2007,687,661,26,3.8
48,157,Fort Bend,2007,253156,242821,10335,4.1
48,159,Franklin,2007,5433,5222,211,3.9
48,161,Freestone,2007,9897,9532,365,3.7
48,163,Frio,2007,6510,6188,322,4.9
48,165,Gaines,2007,6403,6162,241,3.8
48,167,Galveston,2007,138157,131734,6423,4.6
48,169,Garza,2007,2425,2342,83,3.4
48,171,Gillespie,2007,12910,12547,363,2.8
48,173,Glasscock,2007,600,579,21,3.5
48,175,Goliad,2007,3442,3310,132,3.8
48,177,Gonzales,2007,9687,9313,374,3.9
48,179,Gray,2007,11161,10779,382,3.4
48,181,Grayson,2007,55276,52701,2575,4.7
48,183,Gregg,2007,62433,60037,2396,3.8
48,185,Grimes,2007,10455,9965,490,4.7
48,187,Guadalupe,2007,55481,53356,2125,3.8
48,189,Hale,2007,16222,15456,766,4.7
48,191,Hall,2007,1400,1324,76,5.4
48,193,Hamilton,2007,4026,3883,143,3.6
48,195,Hansford,2007,2507,2430,77,3.1
48,197,Hardeman,2007,2322,2238,84,3.6
48,199,Hardin,2007,25749,24545,1204,4.7
48,201,Harris,2007,1899745,1817793,81952,4.3
48,203,Harrison,2007,32091,30649,1442,4.5
48,205,Hartley,2007,2289,2214,75,3.3
48,207,Haskell,2007,3056,2947,109,3.6
48,209,Hays,2007,73294,70529,2765,3.8
48,211,Hemphill,2007,2648,2592,56,2.1
48,213,Henderson,2007,34173,32639,1534,4.5
48,215,Hidalgo,2007,272038,254009,18029,6.6
48,217,Hill,2007,15377,14651,726,4.7
48,219,Hockley,2007,11384,10968,416,3.7
48,221,Hood,2007,23791,22802,989,4.2
48,223,Hopkins,2007,16958,16300,658,3.9
48,225,Houston,2007,7862,7395,467,5.9
48,227,Howard,2007,13892,13318,574,4.1
48,229,Hudspeth,2007,1527,1449,78,5.1
48,231,Hunt,2007,37645,35891,1754,4.7
48,233,Hutchinson,2007,11095,10648,447,4.0
48,235,Irion,2007,925,897,28,3.0
48,237,Jack,2007,4972,4819,153,3.1
48,239,Jackson,2007,6637,6383,254,3.8
48,241,Jasper,2007,15495,14612,883,5.7
48,243,Jeff Davis,2007,1180,1141,39,3.3
48,245,Jefferson,2007,112241,106033,6208,5.5
48,247,Jim Hogg,2007,2738,2633,105,3.8
48,249,Jim Wells,2007,21133,20285,848,4.0
48,251,Johnson,2007,71785,68773,3012,4.2
48,253,Jones,2007,7632,7267,365,4.8
48,255,Karnes,2007,5199,4906,293,5.6
48,257,Kaufman,2007,45253,43109,2144,4.7
48,259,Kendall,2007,15381,14840,541,3.5
48,261,Kenedy,2007,236,229,7,3.0
48,263,Kent,2007,423,409,14,3.3
48,265,Kerr,2007,22546,21756,790,3.5
48,267,Kimble,2007,2229,2154,75,3.4
48,269,King,2007,175,167,8,4.6
48,271,Kinney,2007,1356,1291,65,4.8
48,273,Kleberg,2007,15977,15309,668,4.2
48,275,Knox,2007,1807,1740,67,3.7
48,277,Lamar,2007,24150,23016,1134,4.7
48,279,Lamb,2007,6975,6692,283,4.1
48,281,Lampasas,2007,10114,9737,377,3.7
48,283,La Salle,2007,2757,2621,136,4.9
48,285,Lavaca,2007,10110,9790,320,3.2
48,287,Lee,2007,8871,8559,312,3.5
48,289,Leon,2007,7568,7251,317,4.2
48,291,Liberty,2007,30648,29029,1619,5.3
48,293,Limestone,2007,10330,9890,440,4.3
48,295,Lipscomb,2007,1841,1793,48,2.6
48,297,Live Oak,2007,5031,4834,197,3.9
48,299,Llano,2007,8157,7828,329,4.0
48,301,Loving,2007,41,38,3,7.3
48,303,Lubbock,2007,136111,131168,4943,3.6
48,305,Lynn,2007,2676,2544,132,4.9
48,307,McCulloch,2007,3702,3558,144,3.9
48,309,McLennan,2007,110366,105644,4722,4.3
48,311,McMullen,2007,336,319,17,5.1
48,313,Madison,2007,4985,4751,234,4.7
48,315,Marion,2007,5076,4841,235,4.6
48,317,Martin,2007,2132,2054,78,3.7
48,319,Mason,2007,2373,2306,67,2.8
48,321,Matagorda,2007,16498,15506,992,6.0
48,323,Maverick,2007,19877,17574,2303,11.6
48,325,Medina,2007,19410,18589,821,4.2
48,327,Menard,2007,1067,1029,38,3.6
48,329,Midland,2007,71312,69248,2064,2.9
48,331,Milam,2007,12228,11711,517,4.2
48,333,Mills,2007,2293,2208,85,3.7
48,335,Mitchell,2007,3277,3105,172,5.2
48,337,Montague,2007,10262,9897,365,3.6
48,339,Montgomery,2007,202873,194957,7916,3.9
48,341,Moore,2007,10650,10336,314,2.9
48,343,Morris,2007,6050,5729,321,5.3
48,345,Motley,2007,683,656,27,4.0
48,347,Nacogdoches,2007,30273,29003,1270,4.2
48,349,Navarro,2007,20652,19627,1025,5.0
48,351,Newton,2007,5758,5381,377,6.5
48,353,Nolan,2007,7540,7259,281,3.7
48,355,Nueces,2007,157826,150993,6833,4.3
48,357,Ochiltree,2007,5229,5090,139,2.7
48,359,Oldham,2007,932,895,37,4.0
48,361,Orange,2007,40637,38495,2142,5.3
48,363,Palo Pinto,2007,13873,13356,517,3.7
48,365,Panola,2007,12385,11908,477,3.9
48,367,Parker,2007,52126,50007,2119,4.1
48,369,Parmer,2007,4355,4216,139,3.2
48,371,Pecos,2007,6560,6280,280,4.3
48,373,Polk,2007,16620,15637,983,5.9
48,375,Potter,2007,56725,54530,2195,3.9
48,377,Presidio,2007,3215,2924,291,9.1
48,379,Rains,2007,5121,4902,219,4.3
48,381,Randall,2007,67007,65016,1991,3.0
48,383,Reagan,2007,2395,2345,50,2.1
48,385,Real,2007,1372,1318,54,3.9
48,387,Red River,2007,6062,5757,305,5.0
48,389,Reeves,2007,4094,3878,216,5.3
48,391,Refugio,2007,3865,3720,145,3.8
48,393,Roberts,2007,561,548,13,2.3
48,395,Robertson,2007,6912,6561,351,5.1
48,397,Rockwall,2007,36954,35488,1466,4.0
48,399,Runnels,2007,4419,4223,196,4.4
48,401,Rusk,2007,23430,22447,983,4.2
48,403,Sabine,2007,3390,3113,277,8.2
48,405,San Augustine,2007,3501,3309,192,5.5
48,407,San Jacinto,2007,9982,9459,523,5.2
48,409,San Patricio,2007,29104,27665,1439,4.9
48,411,San Saba,2007,2473,2356,117,4.7
48,413,Schleicher,2007,1416,1366,50,3.5
48,415,Scurry,2007,7293,7013,280,3.8
48,417,Shackelford,2007,2046,1992,54,2.6
48,419,Shelby,2007,12185,11664,521,4.3
48,421,Sherman,2007,1342,1295,47,3.5
48,423,Smith,2007,96807,92708,4099,4.2
48,425,Somervell,2007,3891,3716,175,4.5
48,427,Starr,2007,21314,19020,2294,10.8
48,429,Stephens,2007,4473,4313,160,3.6
48,431,Sterling,2007,791,768,23,2.9
48,433,Stonewall,2007,878,850,28,3.2
48,435,Sutton,2007,3106,3039,67,2.2
48,437,Swisher,2007,3489,3338,151,4.3
48,439,Tarrant,2007,869387,831763,37624,4.3
48,441,Taylor,2007,65470,63183,2287,3.5
48,443,Terrell,2007,357,339,18,5.0
48,445,Terry,2007,5716,5451,265,4.6
48,447,Throckmorton,2007,970,933,37,3.8
48,449,Titus,2007,14288,13746,542,3.8
48,451,Tom Green,2007,51747,49817,1930,3.7
48,453,Travis,2007,529314,509961,19353,3.7
48,455,Trinity,2007,5846,5563,283,4.8
48,457,Tyler,2007,8052,7606,446,5.5
48,459,Upshur,2007,19161,18385,776,4.0
48,461,Upton,2007,1661,1610,51,3.1
48,463,Uvalde,2007,10969,10385,584,5.3
48,465,Val Verde,2007,20242,19128,1114,5.5
48,467,Van Zandt,2007,25349,24351,998,3.9
48,469,Victoria,2007,44468,42912,1556,3.5
48,471,Walker,2007,25846,24610,1236,4.8
48,473,Waller,2007,16041,15310,731,4.6
48,475,Ward,2007,4864,4682,182,3.7
48,477,Washington,2007,16041,15445,596,3.7
48,479,Webb,2007,89376,85119,4257,4.8
48,481,Wharton,2007,20597,19728,869,4.2
48,483,Wheeler,2007,3053,2975,78,2.6
48,485,Wichita,2007,61795,59164,2631,4.3
48,487,Wilbarger,2007,7665,7402,263,3.4
48,489,Willacy,2007,7551,6931,620,8.2
48,491,Williamson,2007,193203,185955,7248,3.8
48,493,Wilson,2007,18164,17414,750,4.1
48,495,Winkler,2007,3342,3235,107,3.2
48,497,Wise,2007,27344,26191,1153,4.2
48,499,Wood,2007,17934,17117,817,4.6
48,501,Yoakum,2007,3877,3749,128,3.3
48,503,Young,2007,9545,9234,311,3.3
48,505,Zapata,2007,4948,4682,266,5.4
48,507,Zavala,2007,3720,3321,399,10.7
49,1,Beaver,2007,3219,3138,81,2.5
49,3,Box Elder,2007,23778,23147,631,2.7
49,5,Cache,2007,61558,60303,1255,2.0
49,7,Carbon,2007,9765,9410,355,3.6
49,9,Daggett,2007,526,507,19,3.6
49,11,Davis,2007,146581,142912,3669,2.5
49,13,Duchesne,2007,9343,9134,209,2.2
49,15,Emery,2007,5203,5030,173,3.3
49,17,Garfield,2007,2766,2638,128,4.6
49,19,Grand,2007,5241,4999,242,4.6
49,21,Iron,2007,21294,20680,614,2.9
49,23,Juab,2007,4167,4037,130,3.1
49,25,Kane,2007,3539,3427,112,3.2
49,27,Millard,2007,6291,6135,156,2.5
49,29,Morgan,2007,4049,3943,106,2.6
49,31,Piute,2007,939,918,21,2.2
49,33,Rich,2007,1464,1435,29,2.0
49,35,Salt Lake,2007,558195,544296,13899,2.5
49,37,San Juan,2007,5038,4777,261,5.2
49,39,Sanpete,2007,11104,10764,340,3.1
49,41,Sevier,2007,9609,9347,262,2.7
49,43,Summit,2007,22081,21534,547,2.5
49,45,Tooele,2007,27277,26513,764,2.8
49,47,Uintah,2007,17505,17145,360,2.1
49,49,Utah,2007,226175,220711,5464,2.4
49,51,Wasatch,2007,10878,10602,276,2.5
49,53,Washington,2007,64370,62609,1761,2.7
49,55,Wayne,2007,1419,1361,58,4.1
49,57,Weber,2007,114269,110785,3484,3.0
50,1,Addison,2007,21528,20715,813,3.8
50,3,Bennington,2007,20450,19639,811,4.0
50,5,Caledonia,2007,16706,15974,732,4.4
50,7,Chittenden,2007,88226,85310,2916,3.3
50,9,Essex,2007,3260,3091,169,5.2
50,11,Franklin,2007,25928,24829,1099,4.2
50,13,Grand Isle,2007,4190,3966,224,5.3
50,15,Lamoille,2007,15089,14387,702,4.7
50,17,Orange,2007,16462,15859,603,3.7
50,19,Orleans,2007,14338,13482,856,6.0
50,21,Rutland,2007,35653,34124,1529,4.3
50,23,Washington,2007,34110,32744,1366,4.0
50,25,Windham,2007,24670,23684,986,4.0
50,27,Windsor,2007,32661,31580,1081,3.3
51,1,Accomack,2007,18810,17974,836,4.4
51,3,Albemarle,2007,51323,50080,1243,2.4
51,5,Alleghany,2007,6991,6662,329,4.7
51,7,Amelia,2007,6567,6371,196,3.0
51,9,Amherst,2007,15544,14960,584,3.8
51,11,Appomattox,2007,7006,6712,294,4.2
51,13,Arlington,2007,131327,128594,2733,2.1
51,15,Augusta,2007,37195,36135,1060,2.8
51,17,Bath,2007,2932,2831,101,3.4
51,19,Bedford,2007,37743,36527,1216,3.2
51,21,Bland,2007,3389,3251,138,4.1
51,23,Botetourt,2007,17427,16930,497,2.9
51,25,Brunswick,2007,6888,6531,357,5.2
51,27,Buchanan,2007,8675,8219,456,5.3
51,29,Buckingham,2007,7005,6743,262,3.7
51,31,Campbell,2007,27279,26269,1010,3.7
51,33,Caroline,2007,13919,13359,560,4.0
51,35,Carroll,2007,13941,13091,850,6.1
51,36,Charles City,2007,3814,3653,161,4.2
51,37,Charlotte,2007,5281,4978,303,5.7
51,41,Chesterfield,2007,165729,161024,4705,2.8
51,43,Clarke,2007,8020,7787,233,2.9
51,45,Craig,2007,2563,2460,103,4.0
51,47,Culpeper,2007,20248,19460,788,3.9
51,49,Cumberland,2007,4596,4437,159,3.5
51,51,Dickenson,2007,5800,5473,327,5.6
51,53,Dinwiddie,2007,12853,12375,478,3.7
51,57,Essex,2007,5497,5279,218,4.0
51,59,Fairfax,2007,581325,567649,13676,2.4
51,61,Fauquier,2007,36937,35937,1000,2.7
51,63,Floyd,2007,7114,6846,268,3.8
51,65,Fluvanna,2007,13799,13447,352,2.6
51,67,Franklin,2007,26410,25460,950,3.6
51,69,Frederick,2007,41145,39829,1316,3.2
51,71,Giles,2007,8159,7763,396,4.9
51,73,Gloucester,2007,20553,20001,552,2.7
51,75,Goochland,2007,11126,10839,287,2.6
51,77,Grayson,2007,7139,6745,394,5.5
51,79,Greene,2007,10420,10179,241,2.3
51,81,Greensville,2007,4296,4087,209,4.9
51,83,Halifax,2007,15455,14394,1061,6.9
51,85,Hanover,2007,54745,53285,1460,2.7
51,87,Henrico,2007,162685,157824,4861,3.0
51,89,Henry,2007,25820,24289,1531,5.9
51,91,Highland,2007,1128,1087,41,3.6
51,93,Isle of Wight,2007,18598,18023,575,3.1
51,95,James City,2007,31349,30513,836,2.7
51,97,King and Queen,2007,3334,3208,126,3.8
51,99,King George,2007,9362,9006,356,3.8
51,101,King William,2007,8465,8217,248,2.9
51,103,Lancaster,2007,5328,5076,252,4.7
51,105,Lee,2007,9600,9168,432,4.5
51,107,Loudoun,2007,163946,160226,3720,2.3
51,109,Louisa,2007,16160,15653,507,3.1
51,111,Lunenburg,2007,5518,5248,270,4.9
51,113,Madison,2007,7355,7142,213,2.9
51,115,Mathews,2007,4428,4306,122,2.8
51,117,Mecklenburg,2007,13222,12501,721,5.5
51,119,Middlesex,2007,5045,4881,164,3.3
51,121,Montgomery,2007,44326,42791,1535,3.5
51,125,Nelson,2007,7908,7678,230,2.9
51,127,New Kent,2007,9418,9142,276,2.9
51,131,Northampton,2007,5969,5707,262,4.4
51,133,Northumberland,2007,5958,5678,280,4.7
51,135,Nottoway,2007,6586,6310,276,4.2
51,137,Orange,2007,15408,14874,534,3.5
51,139,Page,2007,11356,10735,621,5.5
51,141,Patrick,2007,9062,8665,397,4.4
51,143,Pittsylvania,2007,31042,29128,1914,6.2
51,145,Powhatan,2007,14288,13924,364,2.5
51,147,Prince Edward,2007,9070,8620,450,5.0
51,149,Prince George,2007,14704,14192,512,3.5
51,153,Prince William,2007,200343,194996,5347,2.7
51,155,Pulaski,2007,17753,16698,1055,5.9
51,157,Rappahannock,2007,4315,4198,117,2.7
51,159,Richmond,2007,3506,3342,164,4.7
51,161,Roanoke,2007,48986,47652,1334,2.7
51,163,Rockbridge,2007,11246,10891,355,3.2
51,165,Rockingham,2007,41537,40419,1118,2.7
51,167,Russell,2007,11800,11144,656,5.6
51,169,Scott,2007,9823,9332,491,5.0
51,171,Shenandoah,2007,20024,19335,689,3.4
51,173,Smyth,2007,15106,14217,889,5.9
51,175,Southampton,2007,7681,7383,298,3.9
51,177,Spotsylvania,2007,64682,62909,1773,2.7
51,179,Stafford,2007,64522,62697,1825,2.8
51,181,Surry,2007,3733,3596,137,3.7
51,183,Sussex,2007,4472,4256,216,4.8
51,185,Tazewell,2007,20335,19347,988,4.9
51,187,Warren,2007,19451,18811,640,3.3
51,191,Washington,2007,26789,25475,1314,4.9
51,193,Westmoreland,2007,8327,7949,378,4.5
51,195,Wise,2007,17481,16737,744,4.3
51,197,Wythe,2007,15503,14755,748,4.8
51,199,York,2007,31008,30175,833,2.7
51,510,Alexandria city,2007,89472,87317,2155,2.4
51,520,Bristol city,2007,7985,7542,443,5.5
51,530,Buena Vista city,2007,3380,3249,131,3.9
51,540,Charlottesville city,2007,21259,20557,702,3.3
51,550,Chesapeake city,2007,114407,110684,3723,3.3
51,570,Colonial Heights city,2007,9213,8889,324,3.5
51,580,Covington city,2007,2712,2540,172,6.3
51,590,Danville city,2007,19794,18214,1580,8.0
51,595,Emporia city,2007,2464,2300,164,6.7
51,600,Fairfax city,2007,13905,13524,381,2.7
51,610,Falls Church city,2007,6665,6444,221,3.3
51,620,Franklin city,2007,3931,3736,195,5.0
51,630,Fredericksburg city,2007,12452,11849,603,4.8
51,640,Galax city,2007,3133,2942,191,6.1
51,650,Hampton city,2007,68566,65927,2639,3.8
51,660,Harrisonburg city,2007,22773,22057,716,3.1
51,670,Hopewell city,2007,10458,9931,527,5.0
51,678,Lexington city,2007,2371,2253,118,5.0
51,680,Lynchburg city,2007,33650,32288,1362,4.0
51,683,Manassas city,2007,19787,19163,624,3.2
51,685,Manassas Park city,2007,6563,6383,180,2.7
51,690,Martinsville city,2007,5949,5422,527,8.9
51,700,Newport News city,2007,87649,84270,3379,3.9
51,710,Norfolk city,2007,99895,95475,4420,4.4
51,720,Norton city,2007,1567,1498,69,4.4
51,730,Petersburg city,2007,14134,13180,954,6.7
51,735,Poquoson city,2007,6328,6172,156,2.5
51,740,Portsmouth city,2007,46501,44398,2103,4.5
51,750,Radford city,2007,7768,7429,339,4.4
51,760,Richmond city,2007,99048,94368,4680,4.7
51,770,Roanoke city,2007,46347,44462,1885,4.1
51,775,Salem city,2007,13378,12950,428,3.2
51,790,Staunton city,2007,11618,11230,388,3.3
51,800,Suffolk city,2007,39827,38414,1413,3.5
51,810,Virginia Beach city,2007,223066,216443,6623,3.0
51,820,Waynesboro city,2007,10100,9723,377,3.7
51,830,Williamsburg city,2007,5127,4816,311,6.1
51,840,Winchester city,2007,14339,13842,497,3.5
53,1,Adams,2007,8010,7494,516,6.4
53,3,Asotin,2007,10253,9733,520,5.1
53,5,Benton,2007,85969,81360,4609,5.4
53,7,Chelan,2007,40567,38383,2184,5.4
53,9,Clallam,2007,29964,28038,1926,6.4
53,11,Clark,2007,209683,196776,12907,6.2
53,13,Columbia,2007,1528,1417,111,7.3
53,15,Cowlitz,2007,43743,40718,3025,6.9
53,17,Douglas,2007,20929,19849,1080,5.2
53,19,Ferry,2007,2969,2711,258,8.7
53,21,Franklin,2007,32414,30205,2209,6.8
53,23,Garfield,2007,1017,963,54,5.3
53,25,Grant,2007,40473,37898,2575,6.4
53,27,Grays Harbor,2007,31429,28994,2435,7.7
53,29,Island,2007,32933,31147,1786,5.4
53,31,Jefferson,2007,13678,12966,712,5.2
53,33,King,2007,1067828,1034460,33368,3.1
53,35,Kitsap,2007,122892,116957,5935,4.8
53,37,Kittitas,2007,20337,19264,1073,5.3
53,39,Klickitat,2007,9739,9027,712,7.3
53,41,Lewis,2007,31159,28760,2399,7.7
53,43,Lincoln,2007,4697,4428,269,5.7
53,45,Mason,2007,25152,23541,1611,6.4
53,47,Okanogan,2007,20606,19189,1417,6.9
53,49,Pacific,2007,9277,8589,688,7.4
53,51,Pend Oreille,2007,5281,4874,407,7.7
53,53,Pierce,2007,386920,366729,20191,5.2
53,55,San Juan,2007,8477,8158,319,3.8
53,57,Skagit,2007,57865,54864,3001,5.2
53,59,Skamania,2007,5050,4681,369,7.3
53,61,Snohomish,2007,363448,350897,12551,3.5
53,63,Spokane,2007,233409,221229,12180,5.2
53,65,Stevens,2007,18598,17144,1454,7.8
53,67,Thurston,2007,127860,121714,6146,4.8
53,69,Wahkiakum,2007,1664,1544,120,7.2
53,71,Walla Walla,2007,29136,27600,1536,5.3
53,73,Whatcom,2007,106236,101362,4874,4.6
53,75,Whitman,2007,20280,19432,848,4.2
53,77,Yakima,2007,119936,111701,8235,6.9
54,1,Barbour,2007,6681,6297,384,5.7
54,3,Berkeley,2007,45592,43619,1973,4.3
54,5,Boone,2007,9374,8909,465,5.0
54,7,Braxton,2007,5971,5626,345,5.8
54,9,Brooke,2007,10864,10185,679,6.3
54,11,Cabell,2007,45255,43314,1941,4.3
54,13,Calhoun,2007,2735,2532,203,7.4
54,15,Clay,2007,3475,3219,256,7.4
54,17,Doddridge,2007,2800,2656,144,5.1
54,19,Fayette,2007,17996,16966,1030,5.7
54,21,Gilmer,2007,3078,2947,131,4.3
54,23,Grant,2007,5267,4976,291,5.5
54,25,Greenbrier,2007,15500,14508,992,6.4
54,27,Hampshire,2007,9607,9241,366,3.8
54,29,Hancock,2007,14306,13440,866,6.1
54,31,Hardy,2007,7159,6842,317,4.4
54,33,Harrison,2007,30497,29130,1367,4.5
54,35,Jackson,2007,11956,11345,611,5.1
54,37,Jefferson,2007,25017,24171,846,3.4
54,39,Kanawha,2007,91237,87393,3844,4.2
54,41,Lewis,2007,7315,6921,394,5.4
54,43,Lincoln,2007,7954,7499,455,5.7
54,45,Logan,2007,12783,12079,704,5.5
54,47,McDowell,2007,6895,6358,537,7.8
54,49,Marion,2007,26041,24880,1161,4.5
54,51,Marshall,2007,14747,13927,820,5.6
54,53,Mason,2007,10282,9537,745,7.2
54,55,Mercer,2007,24608,23519,1089,4.4
54,57,Mineral,2007,13287,12627,660,5.0
54,59,Mingo,2007,8736,8214,522,6.0
54,61,Monongalia,2007,46983,45430,1553,3.3
54,63,Monroe,2007,5905,5613,292,4.9
54,65,Morgan,2007,7025,6677,348,5.0
54,67,Nicholas,2007,10705,10143,562,5.2
54,69,Ohio,2007,20906,19979,927,4.4
54,71,Pendleton,2007,3774,3626,148,3.9
54,73,Pleasants,2007,3139,2950,189,6.0
54,75,Pocahontas,2007,3721,3436,285,7.7
54,77,Preston,2007,14732,14062,670,4.5
54,79,Putnam,2007,27223,26157,1066,3.9
54,81,Raleigh,2007,32469,30953,1516,4.7
54,83,Randolph,2007,12979,12284,695,5.4
54,85,Ritchie,2007,4591,4343,248,5.4
54,87,Roane,2007,5553,5177,376,6.8
54,89,Summers,2007,4718,4420,298,6.3
54,91,Taylor,2007,6889,6536,353,5.1
54,93,Tucker,2007,2971,2781,190,6.4
54,95,Tyler,2007,3648,3409,239,6.6
54,97,Upshur,2007,10738,10240,498,4.6
54,99,Wayne,2007,17603,16734,869,4.9
54,101,Webster,2007,3346,3147,199,5.9
54,103,Wetzel,2007,6265,5814,451,7.2
54,105,Wirt,2007,2471,2316,155,6.3
54,107,Wood,2007,40804,38799,2005,4.9
54,109,Wyoming,2007,8142,7616,526,6.5
55,1,Adams,2007,10100,9446,654,6.5
55,3,Ashland,2007,9056,8522,534,5.9
55,5,Barron,2007,25028,23575,1453,5.8
55,7,Bayfield,2007,8166,7636,530,6.5
55,9,Brown,2007,139062,132783,6279,4.5
55,11,Buffalo,2007,8235,7881,354,4.3
55,13,Burnett,2007,8107,7560,547,6.7
55,15,Calumet,2007,25550,24356,1194,4.7
55,17,Chippewa,2007,33797,32007,1790,5.3
55,19,Clark,2007,17795,16794,1001,5.6
55,21,Columbia,2007,31153,29609,1544,5.0
55,23,Crawford,2007,9723,9205,518,5.3
55,25,Dane,2007,292864,282907,9957,3.4
55,27,Dodge,2007,46910,44568,2342,5.0
55,29,Door,2007,17009,16104,905,5.3
55,31,Douglas,2007,23173,22034,1139,4.9
55,33,Dunn,2007,25963,24816,1147,4.4
55,35,Eau Claire,2007,57278,54918,2360,4.1
55,37,Florence,2007,2499,2353,146,5.8
55,39,Fond du Lac,2007,56879,54238,2641,4.6
55,41,Forest,2007,5024,4672,352,7.0
55,43,Grant,2007,28220,26887,1333,4.7
55,45,Green,2007,20353,19413,940,4.6
55,47,Green Lake,2007,10496,9935,561,5.3
55,49,Iowa,2007,14048,13423,625,4.4
55,51,Iron,2007,3063,2821,242,7.9
55,53,Jackson,2007,9861,9314,547,5.5
55,55,Jefferson,2007,42241,40221,2020,4.8
55,57,Juneau,2007,13295,12506,789,5.9
55,59,Kenosha,2007,84386,80126,4260,5.0
55,61,Kewaunee,2007,11719,11186,533,4.5
55,63,La Crosse,2007,64432,61952,2480,3.8
55,65,Lafayette,2007,9314,8935,379,4.1
55,67,Langlade,2007,10686,10039,647,6.1
55,69,Lincoln,2007,15566,14702,864,5.6
55,71,Manitowoc,2007,44704,42310,2394,5.4
55,73,Marathon,2007,75973,72711,3262,4.3
55,75,Marinette,2007,22331,20960,1371,6.1
55,77,Marquette,2007,7923,7447,476,6.0
55,78,Menominee,2007,1648,1479,169,10.3
55,79,Milwaukee,2007,469623,442863,26760,5.7
55,81,Monroe,2007,24073,22982,1091,4.5
55,83,Oconto,2007,20346,19101,1245,6.1
55,85,Oneida,2007,19426,18247,1179,6.1
55,87,Outagamie,2007,97151,92720,4431,4.6
55,89,Ozaukee,2007,47854,46054,1800,3.8
55,91,Pepin,2007,4121,3915,206,5.0
55,93,Pierce,2007,23807,22786,1021,4.3
55,95,Polk,2007,24215,22734,1481,6.1
55,97,Portage,2007,41954,40106,1848,4.4
55,99,Price,2007,8230,7817,413,5.0
55,101,Racine,2007,100239,94452,5787,5.8
55,103,Richland,2007,9939,9428,511,5.1
55,105,Rock,2007,84369,79712,4657,5.5
55,107,Rusk,2007,7303,6778,525,7.2
55,109,St. Croix,2007,47326,45041,2285,4.8
55,111,Sauk,2007,35049,33423,1626,4.6
55,113,Sawyer,2007,9566,8928,638,6.7
55,115,Shawano,2007,22163,21018,1145,5.2
55,117,Sheboygan,2007,66079,63339,2740,4.1
55,119,Taylor,2007,10469,9880,589,5.6
55,121,Trempealeau,2007,16308,15590,718,4.4
55,123,Vernon,2007,14215,13488,727,5.1
55,125,Vilas,2007,11585,10857,728,6.3
55,127,Walworth,2007,56078,53531,2547,4.5
55,129,Washburn,2007,7898,7367,531,6.7
55,131,Washington,2007,73847,70721,3126,4.2
55,133,Waukesha,2007,214237,205727,8510,4.0
55,135,Waupaca,2007,28190,26716,1474,5.2
55,137,Waushara,2007,12715,11985,730,5.7
55,139,Winnebago,2007,93680,89486,4194,4.5
55,141,Wood,2007,41920,39738,2182,5.2
56,1,Albany,2007,18812,18386,426,2.3
56,3,Big Horn,2007,4931,4744,187,3.8
56,5,Campbell,2007,26358,25859,499,1.9
56,7,Carbon,2007,8355,8128,227,2.7
56,9,Converse,2007,6993,6806,187,2.7
56,11,Crook,2007,3447,3358,89,2.6
56,13,Fremont,2007,18142,17504,638,3.5
56,15,Goshen,2007,5946,5765,181,3.0
56,17,Hot Springs,2007,2383,2309,74,3.1
56,19,Johnson,2007,3944,3821,123,3.1
56,21,Laramie,2007,42425,41014,1411,3.3
56,23,Lincoln,2007,9024,8811,213,2.4
56,25,Natrona,2007,40533,39546,987,2.4
56,27,Niobrara,2007,1207,1173,34,2.8
56,29,Park,2007,14291,13871,420,2.9
56,31,Platte,2007,3969,3820,149,3.8
56,33,Sheridan,2007,15883,15461,422,2.7
56,35,Sublette,2007,6711,6619,92,1.4
56,37,Sweetwater,2007,24068,23566,502,2.1
56,39,Teton,2007,14589,14288,301,2.1
56,41,Uinta,2007,11277,10996,281,2.5
56,43,Washakie,2007,4253,4115,138,3.2
56,45,Weston,2007,3204,3109,95,3.0
72,1,Adjuntas Municipio,2007,5206,4474,732,14.1
72,3,Aguada Municipio,2007,16278,14205,2073,12.7
72,5,Aguadilla Municipio,2007,22557,19657,2900,12.9
72,7,Aguas Buenas Municipio,2007,9766,8556,1210,12.4
72,9,Aibonito Municipio,2007,8076,6973,1103,13.7
72,11,Anasco Municipio,2007,11148,9711,1437,12.9
72,13,Arecibo Municipio,2007,33965,29866,4099,12.1
72,15,Arroyo Municipio,2007,5803,4895,908,15.6
72,17,Barceloneta Municipio,2007,7469,6354,1115,14.9
72,19,Barranquitas Municipio,2007,7900,6888,1012,12.8
72,21,Bayamon Municipio,2007,84040,76436,7604,9.0
72,23,Cabo Rojo Municipio,2007,21096,19106,1990,9.4
72,25,Caguas Municipio,2007,55241,49106,6135,11.1
72,27,Camuy Municipio,2007,13171,11770,1401,10.6
72,29,Canovanas Municipio,2007,14838,12856,1982,13.4
72,31,Carolina Municipio,2007,78610,71822,6788,8.6
72,33,Catano Municipio,2007,8080,7093,987,12.2
72,35,Cayey Municipio,2007,16067,13989,2078,12.9
72,37,Ceiba Municipio,2007,6105,5275,830,13.6
72,39,Ciales Municipio,2007,5296,4441,855,16.1
72,41,Cidra Municipio,2007,16104,14069,2035,12.6
72,43,Coamo Municipio,2007,11623,10067,1556,13.4
72,45,Comerio Municipio,2007,4861,4155,706,14.5
72,47,Corozal Municipio,2007,10861,9466,1395,12.8
72,49,Culebra Municipio,2007,858,800,58,6.8
72,51,Dorado Municipio,2007,13110,11815,1295,9.9
72,53,Fajardo Municipio,2007,15534,13459,2075,13.4
72,54,Florida Municipio,2007,4324,3745,579,13.4
72,55,Guanica Municipio,2007,6567,5557,1010,15.4
72,57,Guayama Municipio,2007,14966,12918,2048,13.7
72,59,Guayanilla Municipio,2007,6954,5939,1015,14.6
72,61,Guaynabo Municipio,2007,45395,42362,3033,6.7
72,63,Gurabo Municipio,2007,16033,14279,1754,10.9
72,65,Hatillo Municipio,2007,13211,11581,1630,12.3
72,67,Hormigueros Municipio,2007,6830,6102,728,10.7
72,69,Humacao Municipio,2007,21295,18130,3165,14.9
72,71,Isabela Municipio,2007,16159,14174,1985,12.3
72,73,Jayuya Municipio,2007,4559,3896,663,14.5
72,75,Juana Diaz Municipio,2007,17587,15484,2103,12.0
72,77,Juncos Municipio,2007,13513,11709,1804,13.4
72,79,Lajas Municipio,2007,9140,7934,1206,13.2
72,81,Lares Municipio,2007,12030,10617,1413,11.7
72,83,Las Marias Municipio,2007,4271,3801,470,11.0
72,85,Las Piedras Municipio,2007,13190,11410,1780,13.5
72,87,Loiza Municipio,2007,8950,7730,1220,13.6
72,89,Luquillo Municipio,2007,7313,6199,1114,15.2
72,91,Manati Municipio,2007,15068,12983,2085,13.8
72,93,Maricao Municipio,2007,1841,1579,262,14.2
72,95,Maunabo Municipio,2007,3748,3019,729,19.5
72,97,Mayaguez Municipio,2007,30885,27000,3885,12.6
72,99,Moca Municipio,2007,15551,13717,1834,11.8
72,101,Morovis Municipio,2007,9435,8034,1401,14.8
72,103,Naguabo Municipio,2007,7716,6473,1243,16.1
72,105,Naranjito Municipio,2007,8740,7714,1026,11.7
72,107,Orocovis Municipio,2007,5526,4700,826,14.9
72,109,Patillas Municipio,2007,6211,5188,1023,16.5
72,111,Penuelas Municipio,2007,9096,7776,1320,14.5
72,113,Ponce Municipio,2007,65445,58109,7336,11.2
72,115,Quebradillas Municipio,2007,8861,7786,1075,12.1
72,117,Rincon Municipio,2007,5740,5023,717,12.5
72,119,Rio Grande Municipio,2007,18266,16192,2074,11.4
72,121,Sabana Grande Municipio,2007,9677,8325,1352,14.0
72,123,Salinas Municipio,2007,8891,7570,1321,14.9
72,125,San German Municipio,2007,13283,11550,1733,13.0
72,127,San Juan Municipio,2007,172437,158470,13967,8.1
72,129,San Lorenzo Municipio,2007,14740,12907,1833,12.4
72,131,San Sebastian Municipio,2007,15861,13837,2024,12.8
72,133,Santa Isabel Municipio,2007,8518,7307,1211,14.2
72,135,Toa Alta Municipio,2007,30318,27813,2505,8.3
72,137,Toa Baja Municipio,2007,36123,32909,3214,8.9
72,139,Trujillo Alto Municipio,2007,35625,32943,2682,7.5
72,141,Utuado Municipio,2007,9177,7817,1360,14.8
72,143,Vega Alta Municipio,2007,12663,11235,1428,11.3
72,145,Vega Baja Municipio,2007,21115,18445,2670,12.6
72,147,Vieques Municipio,2007,3317,2955,362,10.9
72,149,Villalba Municipio,2007,9479,8223,1256,13.3
72,151,Yabucoa Municipio,2007,11425,9348,2077,18.2
72,153,Yauco Municipio,2007,16635,14451,2184,13.1
1,1,Autauga,2008,24687,23376,1311,5.3
1,3,Baldwin,2008,83205,79222,3983,4.8
1,5,Barbour,2008,10175,9249,926,9.1
1,7,Bibb,2008,8751,8225,526,6.0
1,9,Blount,2008,26693,25405,1288,4.8
1,11,Bullock,2008,3641,3244,397,10.9
1,13,Butler,2008,9063,8263,800,8.8
1,15,Calhoun,2008,54574,51371,3203,5.9
1,17,Chambers,2008,15066,12823,2243,14.9
1,19,Cherokee,2008,11999,11287,712,5.9
1,21,Chilton,2008,19609,18583,1026,5.2
1,23,Choctaw,2008,5076,4638,438,8.6
1,25,Clarke,2008,10366,9401,965,9.3
1,27,Clay,2008,5739,5269,470,8.2
1,29,Cleburne,2008,6557,6213,344,5.2
1,31,Coffee,2008,20908,19859,1049,5.0
1,33,Colbert,2008,25171,23478,1693,6.7
1,35,Conecuh,2008,4886,4413,473,9.7
1,37,Coosa,2008,4664,4266,398,8.5
1,39,Covington,2008,16805,15773,1032,6.1
1,41,Crenshaw,2008,6464,6093,371,5.7
1,43,Cullman,2008,39092,37118,1974,5.0
1,45,Dale,2008,19834,18724,1110,5.6
1,47,Dallas,2008,15508,13732,1776,11.5
1,49,DeKalb,2008,30689,28841,1848,6.0
1,51,Elmore,2008,36219,34306,1913,5.3
1,53,Escambia,2008,14424,13295,1129,7.8
1,55,Etowah,2008,45741,42914,2827,6.2
1,57,Fayette,2008,7123,6591,532,7.5
1,59,Franklin,2008,13389,12363,1026,7.7
1,61,Geneva,2008,11338,10697,641,5.7
1,63,Greene,2008,3284,2995,289,8.8
1,65,Hale,2008,6997,6461,536,7.7
1,67,Henry,2008,7383,6794,589,8.0
1,69,Houston,2008,46447,44096,2351,5.1
1,71,Jackson,2008,26866,25153,1713,6.4
1,73,Jefferson,2008,311643,294233,17410,5.6
1,75,Lamar,2008,5698,5227,471,8.3
1,77,Lauderdale,2008,42878,40330,2548,5.9
1,79,Lawrence,2008,15874,14809,1065,6.7
1,81,Lee,2008,65191,61678,3513,5.4
1,83,Limestone,2008,37419,35596,1823,4.9
1,85,Lowndes,2008,4861,4313,548,11.3
1,87,Macon,2008,9112,8410,702,7.7
1,89,Madison,2008,168276,161020,7256,4.3
1,91,Marengo,2008,7985,7374,611,7.7
1,93,Marion,2008,12727,11679,1048,8.2
1,95,Marshall,2008,41694,39645,2049,4.9
1,97,Mobile,2008,187300,176287,11013,5.9
1,99,Monroe,2008,8806,7881,925,10.5
1,101,Montgomery,2008,106185,99685,6500,6.1
1,103,Morgan,2008,56997,53912,3085,5.4
1,105,Perry,2008,3600,3180,420,11.7
1,107,Pickens,2008,7931,7345,586,7.4
1,109,Pike,2008,15803,15005,798,5.0
1,111,Randolph,2008,9616,8888,728,7.6
1,113,Russell,2008,21717,19921,1796,8.3
1,115,St. Clair,2008,36480,34586,1894,5.2
1,117,Shelby,2008,101102,97190,3912,3.9
1,119,Sumter,2008,4728,4300,428,9.1
1,121,Talladega,2008,38306,35452,2854,7.5
1,123,Tallapoosa,2008,18192,16843,1349,7.4
1,125,Tuscaloosa,2008,89168,84817,4351,4.9
1,127,Walker,2008,28764,27062,1702,5.9
1,129,Washington,2008,6891,6290,601,8.7
1,131,Wilcox,2008,3493,2990,503,14.4
1,133,Winston,2008,9995,9103,892,8.9
2,13,Aleutians East Borough,2008,1141,1045,96,8.4
2,16,Aleutians West Census Area,2008,3055,2883,172,5.6
2,20,Anchorage Borough/municipality,2008,151840,143873,7967,5.2
2,50,Bethel Census Area,2008,6900,5973,927,13.4
2,60,Bristol Bay Borough,2008,1006,959,47,4.7
2,68,Denali Borough,2008,1601,1507,94,5.9
2,70,Dillingham Census Area,2008,2061,1875,186,9.0
2,90,Fairbanks North Star Borough,2008,45900,43209,2691,5.9
2,100,Haines Borough,2008,1354,1238,116,8.6
2,110,Juneau Borough/city,2008,18755,17886,869,4.6
2,122,Kenai Peninsula Borough,2008,26253,24180,2073,7.9
2,130,Ketchikan Gateway Borough,2008,8281,7807,474,5.7
2,150,Kodiak Island Borough,2008,6386,5963,423,6.6
2,158,Kusilvak Census Area,2008,2597,2079,518,19.9
2,164,Lake and Peninsula Borough,2008,1134,1059,75,6.6
2,170,Matanuska-Susitna Borough,2008,41424,38382,3042,7.3
2,180,Nome Census Area,2008,3976,3578,398,10.0
2,185,North Slope Borough,2008,5138,4928,210,4.1
2,188,Northwest Arctic Borough,2008,2969,2637,332,11.2
2,201,Prince of Wales-Outer Ketchikan Census Area,2008,2327,2016,311,13.4
2,220,Sitka Borough/city,2008,4612,4354,258,5.6
2,232,Skagway-Hoonah-Angoon Census Area,2008,1912,1673,239,12.5
2,240,Southeast Fairbanks Census Area,2008,3544,3242,302,8.5
2,261,Valdez-Cordova Census Area,2008,5243,4816,427,8.1
2,280,Wrangell-Petersburg Census Area,2008,2802,2513,289,10.3
2,282,Yakutat Borough/city,2008,319,296,23,7.2
2,290,Yukon-Koyukuk Census Area,2008,2771,2393,378,13.6
4,1,Apache,2008,21131,18810,2321,11.0
4,3,Cochise,2008,60117,56801,3316,5.5
4,5,Coconino,2008,73026,69176,3850,5.3
4,7,Gila,2008,22258,20902,1356,6.1
4,9,Graham,2008,16083,15011,1072,6.7
4,11,Greenlee,2008,4398,4178,220,5.0
4,12,La Paz,2008,7523,6975,548,7.3
4,13,Maricopa,2008,1966052,1866392,99660,5.1
4,15,Mohave,2008,92235,85565,6670,7.2
4,17,Navajo,2008,39094,35362,3732,9.5
4,19,Pima,2008,473209,447233,25976,5.5
4,21,Pinal,2008,121870,113386,8484,7.0
4,23,Santa Cruz,2008,17783,15930,1853,10.4
4,25,Yavapai,2008,97796,92100,5696,5.8
4,27,Yuma,2008,83416,68876,14540,17.4
5,1,Arkansas,2008,11999,10835,1164,9.7
5,3,Ashley,2008,9342,8638,704,7.5
5,5,Baxter,2008,17478,16433,1045,6.0
5,7,Benton,2008,105357,101031,4326,4.1
5,9,Boone,2008,16832,15920,912,5.4
5,11,Bradley,2008,5549,5152,397,7.2
5,13,Calhoun,2008,2580,2422,158,6.1
5,15,Carroll,2008,14082,13454,628,4.5
5,17,Chicot,2008,4902,4500,402,8.2
5,19,Clark,2008,10913,10271,642,5.9
5,21,Clay,2008,6598,6071,527,8.0
5,23,Cleburne,2008,11957,11288,669,5.6
5,25,Cleveland,2008,4083,3845,238,5.8
5,27,Columbia,2008,10787,10042,745,6.9
5,29,Conway,2008,10107,9553,554,5.5
5,31,Craighead,2008,45985,43767,2218,4.8
5,33,Crawford,2008,28355,26993,1362,4.8
5,35,Crittenden,2008,22307,20554,1753,7.9
5,37,Cross,2008,8449,7877,572,6.8
5,39,Dallas,2008,3857,3581,276,7.2
5,41,Desha,2008,5865,5356,509,8.7
5,43,Drew,2008,8393,7736,657,7.8
5,45,Faulkner,2008,55531,52914,2617,4.7
5,47,Franklin,2008,8458,8085,373,4.4
5,49,Fulton,2008,5178,4910,268,5.2
5,51,Garland,2008,42236,39876,2360,5.6
5,53,Grant,2008,8581,8137,444,5.2
5,55,Greene,2008,18882,17653,1229,6.5
5,57,Hempstead,2008,10597,9988,609,5.7
5,59,Hot Spring,2008,15014,14033,981,6.5
5,61,Howard,2008,6298,5952,346,5.5
5,63,Independence,2008,16900,15728,1172,6.9
5,65,Izard,2008,5405,5045,360,6.7
5,67,Jackson,2008,7826,7224,602,7.7
5,69,Jefferson,2008,34882,32236,2646,7.6
5,71,Johnson,2008,11483,10945,538,4.7
5,73,Lafayette,2008,3030,2818,212,7.0
5,75,Lawrence,2008,7213,6704,509,7.1
5,77,Lee,2008,3571,3269,302,8.5
5,79,Lincoln,2008,4944,4548,396,8.0
5,81,Little River,2008,6662,6403,259,3.9
5,83,Logan,2008,10300,9633,667,6.5
5,85,Lonoke,2008,32049,30625,1424,4.4
5,87,Madison,2008,7661,7327,334,4.4
5,89,Marion,2008,6873,6446,427,6.2
5,91,Miller,2008,19988,19187,801,4.0
5,93,Mississippi,2008,21776,20119,1657,7.6
5,95,Monroe,2008,3810,3568,242,6.4
5,97,Montgomery,2008,4150,3917,233,5.6
5,99,Nevada,2008,4225,3940,285,6.7
5,101,Newton,2008,3458,3263,195,5.6
5,103,Ouachita,2008,11826,11076,750,6.3
5,105,Perry,2008,4760,4495,265,5.6
5,107,Phillips,2008,8930,8295,635,7.1
5,109,Pike,2008,5056,4753,303,6.0
5,111,Poinsett,2008,10657,9979,678,6.4
5,113,Polk,2008,8806,8356,450,5.1
5,115,Pope,2008,30116,28654,1462,4.9
5,117,Prairie,2008,4369,4123,246,5.6
5,119,Pulaski,2008,189490,180574,8916,4.7
5,121,Randolph,2008,7497,6889,608,8.1
5,123,St. Francis,2008,10292,9335,957,9.3
5,125,Saline,2008,49402,47224,2178,4.4
5,127,Scott,2008,4827,4599,228,4.7
5,129,Searcy,2008,3591,3399,192,5.3
5,131,Sebastian,2008,61428,58413,3015,4.9
5,133,Sevier,2008,7543,7240,303,4.0
5,135,Sharp,2008,6237,5770,467,7.5
5,137,Stone,2008,4683,4378,305,6.5
5,139,Union,2008,19046,17845,1201,6.3
5,141,Van Buren,2008,6991,6533,458,6.6
5,143,Washington,2008,102564,98272,4292,4.2
5,145,White,2008,32864,30920,1944,5.9
5,147,Woodruff,2008,3474,3198,276,7.9
5,149,Yell,2008,10517,10045,472,4.5
6,1,Alameda,2008,756795,709639,47156,6.2
6,3,Alpine,2008,466,417,49,10.5
6,5,Amador,2008,17806,16433,1373,7.7
6,7,Butte,2008,102869,94144,8725,8.5
6,9,Calaveras,2008,20632,18836,1796,8.7
6,11,Colusa,2008,10501,9045,1456,13.9
6,13,Contra Costa,2008,523981,491295,32686,6.2
6,15,Del Norte,2008,11368,10362,1006,8.8
6,17,El Dorado,2008,90644,84284,6360,7.0
6,19,Fresno,2008,429911,384431,45480,10.6
6,21,Glenn,2008,12189,10908,1281,10.5
6,23,Humboldt,2008,59983,55597,4386,7.3
6,25,Imperial,2008,72509,56114,16395,22.6
6,27,Inyo,2008,9092,8489,603,6.6
6,29,Kern,2008,359331,323905,35426,9.9
6,31,Kings,2008,58767,52527,6240,10.6
6,33,Lake,2008,24540,21916,2624,10.7
6,35,Lassen,2008,12826,11595,1231,9.6
6,37,Los Angeles,2008,4923903,4553013,370890,7.5
6,39,Madera,2008,65054,58879,6175,9.5
6,41,Marin,2008,132263,126011,6252,4.7
6,43,Mariposa,2008,9278,8577,701,7.6
6,45,Mendocino,2008,43233,40242,2991,6.9
6,47,Merced,2008,102211,89272,12939,12.7
6,49,Modoc,2008,3939,3556,383,9.7
6,51,Mono,2008,8609,8098,511,5.9
6,53,Monterey,2008,212165,194178,17987,8.5
6,55,Napa,2008,75582,71699,3883,5.1
6,57,Nevada,2008,50377,47047,3330,6.6
6,59,Orange,2008,1616256,1530120,86136,5.3
6,61,Placer,2008,177065,165535,11530,6.5
6,63,Plumas,2008,9817,8777,1040,10.6
6,65,Riverside,2008,912039,833559,78480,8.6
6,67,Sacramento,2008,679749,630472,49277,7.2
6,69,San Benito,2008,24852,22442,2410,9.7
6,71,San Bernardino,2008,862596,793074,69522,8.1
6,73,San Diego,2008,1546617,1453044,93573,6.1
6,75,San Francisco/city,2008,457204,433111,24093,5.3
6,77,San Joaquin,2008,293019,262350,30669,10.5
6,79,San Luis Obispo,2008,136469,128561,7908,5.8
6,81,San Mateo,2008,372532,354267,18265,4.9
6,83,Santa Barbara,2008,218183,206192,11991,5.5
6,85,Santa Clara,2008,869347,816863,52484,6.0
6,87,Santa Cruz,2008,146188,135383,10805,7.4
6,89,Shasta,2008,82622,74279,8343,10.1
6,91,Sierra,2008,1590,1421,169,10.6
6,93,Siskiyou,2008,19214,17247,1967,10.2
6,95,Solano,2008,211167,196562,14605,6.9
6,97,Sonoma,2008,259757,244727,15030,5.8
6,99,Stanislaus,2008,231840,206074,25766,11.1
6,101,Sutter,2008,41082,35991,5091,12.4
6,103,Tehama,2008,25166,22839,2327,9.2
6,105,Trinity,2008,4853,4230,623,12.8
6,107,Tulare,2008,199013,177406,21607,10.9
6,109,Tuolumne,2008,25779,23710,2069,8.0
6,111,Ventura,2008,429007,401897,27110,6.3
6,113,Yolo,2008,98348,91039,7309,7.4
6,115,Yuba,2008,27716,24403,3313,12.0
8,1,Adams,2008,227365,215050,12315,5.4
8,3,Alamosa,2008,8410,7969,441,5.2
8,5,Arapahoe,2008,314696,299269,15427,4.9
8,7,Archuleta,2008,6567,6234,333,5.1
8,9,Baca,2008,2256,2179,77,3.4
8,11,Bent,2008,2357,2210,147,6.2
8,13,Boulder,2008,178629,171193,7436,4.2
8,14,Broomfield/city,2008,31046,29639,1407,4.5
8,15,Chaffee,2008,8417,8037,380,4.5
8,17,Cheyenne,2008,1264,1230,34,2.7
8,19,Clear Creek,2008,5689,5427,262,4.6
8,21,Conejos,2008,3658,3390,268,7.3
8,23,Costilla,2008,1288,1188,100,7.8
8,25,Crowley,2008,1833,1698,135,7.4
8,27,Custer,2008,1924,1826,98,5.1
8,29,Delta,2008,16608,15878,730,4.4
8,31,Denver/city,2008,325465,307910,17555,5.4
8,33,Dolores,2008,990,919,71,7.2
8,35,Douglas,2008,162039,155246,6793,4.2
8,37,Eagle,2008,31874,30731,1143,3.6
8,39,Elbert,2008,13105,12475,630,4.8
8,41,El Paso,2008,302182,285022,17160,5.7
8,43,Fremont,2008,19868,18605,1263,6.4
8,45,Garfield,2008,36991,35836,1155,3.1
8,47,Gilpin,2008,3492,3344,148,4.2
8,49,Grand,2008,9207,8866,341,3.7
8,51,Gunnison,2008,9566,9221,345,3.6
8,53,Hinsdale,2008,648,626,22,3.4
8,55,Huerfano,2008,3457,3235,222,6.4
8,57,Jackson,2008,1089,1053,36,3.3
8,59,Jefferson,2008,309867,295301,14566,4.7
8,61,Kiowa,2008,855,823,32,3.7
8,63,Kit Carson,2008,4375,4228,147,3.4
8,65,Lake,2008,4128,3938,190,4.6
8,67,La Plata,2008,31631,30487,1144,3.6
8,69,Larimer,2008,176659,169158,7501,4.2
8,71,Las Animas,2008,8852,8452,400,4.5
8,73,Lincoln,2008,2908,2800,108,3.7
8,75,Logan,2008,11273,10836,437,3.9
8,77,Mesa,2008,82329,79116,3213,3.9
8,79,Mineral,2008,478,452,26,5.4
8,81,Moffat,2008,8782,8447,335,3.8
8,83,Montezuma,2008,12986,12305,681,5.2
8,85,Montrose,2008,20902,19853,1049,5.0
8,87,Morgan,2008,14174,13570,604,4.3
8,89,Otero,2008,8763,8241,522,6.0
8,91,Ouray,2008,3037,2924,113,3.7
8,93,Park,2008,9741,9275,466,4.8
8,95,Phillips,2008,2253,2176,77,3.4
8,97,Pitkin,2008,11646,11260,386,3.3
8,99,Prowers,2008,6572,6276,296,4.5
8,101,Pueblo,2008,73763,69262,4501,6.1
8,103,Rio Blanco,2008,5148,5013,135,2.6
8,105,Rio Grande,2008,6464,6098,366,5.7
8,107,Routt,2008,15692,15157,535,3.4
8,109,Saguache,2008,3060,2839,221,7.2
8,111,San Juan,2008,571,539,32,5.6
8,113,San Miguel,2008,5556,5339,217,3.9
8,115,Sedgwick,2008,1542,1493,49,3.2
8,117,Summit,2008,17110,16466,644,3.8
8,119,Teller,2008,12360,11678,682,5.5
8,121,Washington,2008,2673,2586,87,3.3
8,123,Weld,2008,119726,113448,6278,5.2
8,125,Yuma,2008,6547,6371,176,2.7
9,1,Fairfield,2008,470482,446436,24046,5.1
9,3,Hartford,2008,459529,432011,27518,6.0
9,5,Litchfield,2008,105491,99943,5548,5.3
9,7,Middlesex,2008,94388,89871,4517,4.8
9,9,New Haven,2008,448557,420791,27766,6.2
9,11,New London,2008,149933,141882,8051,5.4
9,13,Tolland,2008,85152,81087,4065,4.8
9,15,Windham,2008,64587,60371,4216,6.5
10,1,Kent,2008,76008,72229,3779,5.0
10,3,New Castle,2008,279751,265800,13951,5.0
10,5,Sussex,2008,94505,89664,4841,5.1
11,1,District of Colu,2008,334487,311588,22899,6.8
12,1,Alachua,2008,130644,125407,5237,4.0
12,3,Baker,2008,12171,11529,642,5.3
12,5,Bay,2008,88132,83615,4517,5.1
12,7,Bradford,2008,12410,11854,556,4.5
12,9,Brevard,2008,266986,250711,16275,6.1
12,11,Broward,2008,1000985,950653,50332,5.0
12,13,Calhoun,2008,5724,5438,286,5.0
12,15,Charlotte,2008,68940,63722,5218,7.6
12,17,Citrus,2008,56134,51883,4251,7.6
12,19,Clay,2008,95447,90694,4753,5.0
12,21,Collier,2008,147300,137802,9498,6.4
12,23,Columbia,2008,31375,29759,1616,5.2
12,27,DeSoto,2008,14676,13757,919,6.3
12,29,Dixie,2008,5453,5079,374,6.9
12,31,Duval,2008,443919,418382,25537,5.8
12,33,Escambia,2008,137128,129477,7651,5.6
12,35,Flagler,2008,31611,28765,2846,9.0
12,37,Franklin,2008,4792,4581,211,4.4
12,39,Gadsden,2008,20971,19781,1190,5.7
12,41,Gilchrist,2008,7781,7372,409,5.3
12,43,Glades,2008,4641,4344,297,6.4
12,45,Gulf,2008,6326,5956,370,5.8
12,47,Hamilton,2008,4755,4441,314,6.6
12,49,Hardee,2008,11677,10951,726,6.2
12,51,Hendry,2008,17372,15618,1754,10.1
12,53,Hernando,2008,62591,57571,5020,8.0
12,55,Highlands,2008,40633,37913,2720,6.7
12,57,Hillsborough,2008,595242,559987,35255,5.9
12,59,Holmes,2008,8951,8530,421,4.7
12,61,Indian River,2008,62413,57741,4672,7.5
12,63,Jackson,2008,22034,20971,1063,4.8
12,65,Jefferson,2008,6807,6490,317,4.7
12,67,Lafayette,2008,2964,2839,125,4.2
12,69,Lake,2008,135919,127800,8119,6.0
12,71,Lee,2008,283660,262190,21470,7.6
12,73,Leon,2008,146511,140351,6160,4.2
12,75,Levy,2008,16766,15664,1102,6.6
12,77,Liberty,2008,3833,3682,151,3.9
12,79,Madison,2008,6982,6529,453,6.5
12,81,Manatee,2008,143216,133917,9299,6.5
12,83,Marion,2008,137240,127207,10033,7.3
12,85,Martin,2008,63211,59118,4093,6.5
12,86,Miami-Dade,2008,1222595,1169309,53286,4.4
12,87,Monroe,2008,46452,44706,1746,3.8
12,89,Nassau,2008,36068,34256,1812,5.0
12,91,Okaloosa,2008,96383,92255,4128,4.3
12,93,Okeechobee,2008,17513,16181,1332,7.6
12,95,Orange,2008,599559,566785,32774,5.5
12,97,Osceola,2008,137160,129078,8082,5.9
12,99,Palm Beach,2008,624078,585877,38201,6.1
12,101,Pasco,2008,196070,182451,13619,6.9
12,103,Pinellas,2008,444720,418164,26556,6.0
12,105,Polk,2008,271499,254459,17040,6.3
12,107,Putnam,2008,31809,29615,2194,6.9
12,109,St. Johns,2008,95847,91354,4493,4.7
12,111,St. Lucie,2008,123358,113341,10017,8.1
12,113,Santa Rosa,2008,69942,66281,3661,5.2
12,115,Sarasota,2008,165899,154806,11093,6.7
12,117,Seminole,2008,239743,227177,12566,5.2
12,119,Sumter,2008,30750,29141,1609,5.2
12,121,Suwannee,2008,16903,15977,926,5.5
12,123,Taylor,2008,9077,8524,553,6.1
12,125,Union,2008,5282,5044,238,4.5
12,127,Volusia,2008,252800,237272,15528,6.1
12,129,Wakulla,2008,15840,15176,664,4.2
12,131,Walton,2008,30979,29680,1299,4.2
12,133,Washington,2008,9815,9233,582,5.9
13,1,Appling,2008,9330,8625,705,7.6
13,3,Atkinson,2008,3384,3079,305,9.0
13,5,Bacon,2008,4778,4455,323,6.8
13,7,Baker,2008,1672,1556,116,6.9
13,9,Baldwin,2008,21062,19274,1788,8.5
13,11,Banks,2008,11002,10463,539,4.9
13,13,Barrow,2008,35217,32811,2406,6.8
13,15,Bartow,2008,46819,43209,3610,7.7
13,17,Ben Hill,2008,7542,6660,882,11.7
13,19,Berrien,2008,8642,7990,652,7.5
13,21,Bibb,2008,75452,70173,5279,7.0
13,23,Bleckley,2008,5393,4969,424,7.9
13,25,Brantley,2008,7653,7123,530,6.9
13,27,Brooks,2008,8374,7857,517,6.2
13,29,Bryan,2008,17021,16113,908,5.3
13,31,Bulloch,2008,33044,30866,2178,6.6
13,33,Burke,2008,9991,9053,938,9.4
13,35,Butts,2008,10433,9589,844,8.1
13,37,Calhoun,2008,2402,2194,208,8.7
13,39,Camden,2008,21290,20000,1290,6.1
13,43,Candler,2008,4334,4039,295,6.8
13,45,Carroll,2008,53780,49871,3909,7.3
13,47,Catoosa,2008,35626,33650,1976,5.5
13,49,Charlton,2008,4573,4240,333,7.3
13,51,Chatham,2008,134094,125887,8207,6.1
13,53,Chattahoochee,2008,2563,2226,337,13.1
13,55,Chattooga,2008,11278,10083,1195,10.6
13,57,Cherokee,2008,111944,105550,6394,5.7
13,59,Clarke,2008,65879,62243,3636,5.5
13,61,Clay,2008,1474,1358,116,7.9
13,63,Clayton,2008,136326,125133,11193,8.2
13,65,Clinch,2008,2791,2574,217,7.8
13,67,Cobb,2008,380211,357151,23060,6.1
13,69,Coffee,2008,16703,15213,1490,8.9
13,71,Colquitt,2008,20697,19350,1347,6.5
13,73,Columbia,2008,60657,57530,3127,5.2
13,75,Cook,2008,7237,6632,605,8.4
13,77,Coweta,2008,61181,57395,3786,6.2
13,79,Crawford,2008,6256,5848,408,6.5
13,81,Crisp,2008,10203,9354,849,8.3
13,83,Dade,2008,8419,7902,517,6.1
13,85,Dawson,2008,11334,10612,722,6.4
13,87,Decatur,2008,12090,11092,998,8.3
13,89,DeKalb,2008,391727,364679,27048,6.9
13,91,Dodge,2008,9392,8710,682,7.3
13,93,Dooly,2008,4791,4442,349,7.3
13,95,Dougherty,2008,42176,39002,3174,7.5
13,97,Douglas,2008,66163,61546,4617,7.0
13,99,Early,2008,5508,5112,396,7.2
13,101,Echols,2008,2207,2104,103,4.7
13,103,Effingham,2008,28952,27439,1513,5.2
13,105,Elbert,2008,10073,9165,908,9.0
13,107,Emanuel,2008,10779,9919,860,8.0
13,109,Evans,2008,5006,4665,341,6.8
13,111,Fannin,2008,10923,10185,738,6.8
13,113,Fayette,2008,53063,50054,3009,5.7
13,115,Floyd,2008,50172,46663,3509,7.0
13,117,Forsyth,2008,88105,83529,4576,5.2
13,119,Franklin,2008,10437,9648,789,7.6
13,121,Fulton,2008,495844,461289,34555,7.0
13,123,Gilmer,2008,14065,13172,893,6.3
13,125,Glascock,2008,1127,1044,83,7.4
13,127,Glynn,2008,41315,39055,2260,5.5
13,129,Gordon,2008,26582,24452,2130,8.0
13,131,Grady,2008,11954,11178,776,6.5
13,133,Greene,2008,7603,7045,558,7.3
13,135,Gwinnett,2008,424217,398541,25676,6.1
13,137,Habersham,2008,20775,19491,1284,6.2
13,139,Hall,2008,92736,87307,5429,5.9
13,141,Hancock,2008,3370,2898,472,14.0
13,143,Haralson,2008,12912,11995,917,7.1
13,145,Harris,2008,16352,15521,831,5.1
13,147,Hart,2008,10692,9678,1014,9.5
13,149,Heard,2008,4951,4547,404,8.2
13,151,Henry,2008,99010,92461,6549,6.6
13,153,Houston,2008,69693,65760,3933,5.6
13,155,Irwin,2008,4236,3782,454,10.7
13,157,Jackson,2008,27603,25747,1856,6.7
13,159,Jasper,2008,6607,6017,590,8.9
13,161,Jeff Davis,2008,5312,4752,560,10.5
13,163,Jefferson,2008,7179,6419,760,10.6
13,165,Jenkins,2008,2878,2393,485,16.9
13,167,Johnson,2008,3709,3389,320,8.6
13,169,Jones,2008,14518,13613,905,6.2
13,171,Lamar,2008,7945,7310,635,8.0
13,173,Lanier,2008,4211,3947,264,6.3
13,175,Laurens,2008,22384,20665,1719,7.7
13,177,Lee,2008,17986,17108,878,4.9
13,179,Liberty,2008,25389,23751,1638,6.5
13,181,Lincoln,2008,3900,3601,299,7.7
13,183,Long,2008,6490,6178,312,4.8
13,185,Lowndes,2008,54754,51528,3226,5.9
13,187,Lumpkin,2008,13425,12410,1015,7.6
13,189,McDuffie,2008,10774,9862,912,8.5
13,191,McIntosh,2008,5449,5100,349,6.4
13,193,Macon,2008,5147,4678,469,9.1
13,195,Madison,2008,16256,15341,915,5.6
13,197,Marion,2008,3328,3105,223,6.7
13,199,Meriwether,2008,9649,8767,882,9.1
13,201,Miller,2008,3585,3392,193,5.4
13,205,Mitchell,2008,10543,9765,778,7.4
13,207,Monroe,2008,13899,13048,851,6.1
13,209,Montgomery,2008,4549,4189,360,7.9
13,211,Morgan,2008,9593,8972,621,6.5
13,213,Murray,2008,20375,18749,1626,8.0
13,215,Muscogee,2008,86000,80248,5752,6.7
13,217,Newton,2008,47612,43743,3869,8.1
13,219,Oconee,2008,18788,17963,825,4.4
13,221,Oglethorpe,2008,7953,7506,447,5.6
13,223,Paulding,2008,68244,63854,4390,6.4
13,225,Peach,2008,12141,11213,928,7.6
13,227,Pickens,2008,15443,14447,996,6.4
13,229,Pierce,2008,8675,8170,505,5.8
13,231,Pike,2008,8239,7653,586,7.1
13,233,Polk,2008,21431,19963,1468,6.8
13,235,Pulaski,2008,4589,4324,265,5.8
13,237,Putnam,2008,10470,9671,799,7.6
13,239,Quitman,2008,1030,934,96,9.3
13,241,Rabun,2008,6951,6473,478,6.9
13,243,Randolph,2008,2787,2533,254,9.1
13,245,Richmond,2008,92026,84905,7121,7.7
13,247,Rockdale,2008,40731,37686,3045,7.5
13,249,Schley,2008,1874,1740,134,7.2
13,251,Screven,2008,7369,6745,624,8.5
13,253,Seminole,2008,4095,3771,324,7.9
13,255,Spalding,2008,28936,26289,2647,9.1
13,257,Stephens,2008,13763,12840,923,6.7
13,259,Stewart,2008,2318,2122,196,8.5
13,261,Sumter,2008,14711,13492,1219,8.3
13,263,Talbot,2008,3183,2956,227,7.1
13,265,Taliaferro,2008,847,772,75,8.9
13,267,Tattnall,2008,9252,8589,663,7.2
13,269,Taylor,2008,3439,3162,277,8.1
13,271,Telfair,2008,4716,4170,546,11.6
13,273,Terrell,2008,4423,4107,316,7.1
13,275,Thomas,2008,22139,20753,1386,6.3
13,277,Tift,2008,19028,17564,1464,7.7
13,279,Toombs,2008,14014,12928,1086,7.7
13,281,Towns,2008,5810,5437,373,6.4
13,283,Treutlen,2008,2888,2622,266,9.2
13,285,Troup,2008,30545,27855,2690,8.8
13,287,Turner,2008,4793,4373,420,8.8
13,289,Twiggs,2008,4754,4397,357,7.5
13,291,Union,2008,11133,10429,704,6.3
13,293,Upson,2008,12014,10940,1074,8.9
13,295,Walker,2008,33337,30958,2379,7.1
13,297,Walton,2008,42123,39207,2916,6.9
13,299,Ware,2008,15209,14123,1086,7.1
13,301,Warren,2008,2490,2215,275,11.0
13,303,Washington,2008,8208,7510,698,8.5
13,305,Wayne,2008,12227,11210,1017,8.3
13,307,Webster,2008,1302,1229,73,5.6
13,309,Wheeler,2008,2924,2701,223,7.6
13,311,White,2008,12622,11872,750,5.9
13,313,Whitfield,2008,46218,42432,3786,8.2
13,315,Wilcox,2008,3274,2983,291,8.9
13,317,Wilkes,2008,4685,4265,420,9.0
13,319,Wilkinson,2008,4750,4397,353,7.4
13,321,Worth,2008,10224,9483,741,7.2
15,1,Hawaii,2008,85022,80269,4753,5.6
15,3,Honolulu/city,2008,445353,429383,15970,3.6
15,7,Kauai,2008,32737,31261,1476,4.5
15,9,Maui,2008,78413,74853,3560,4.5
16,1,Ada,2008,197620,188197,9423,4.8
16,3,Adams,2008,1921,1722,199,10.4
16,5,Bannock,2008,39831,37990,1841,4.6
16,7,Bear Lake,2008,3324,3215,109,3.3
16,9,Benewah,2008,4097,3694,403,9.8
16,11,Bingham,2008,22523,21637,886,3.9
16,13,Blaine,2008,13810,13280,530,3.8
16,15,Boise,2008,3502,3297,205,5.9
16,17,Bonner,2008,20529,19200,1329,6.5
16,19,Bonneville,2008,50465,48695,1770,3.5
16,21,Boundary,2008,4612,4216,396,8.6
16,23,Butte,2008,1378,1320,58,4.2
16,25,Camas,2008,635,607,28,4.4
16,27,Canyon,2008,84581,79206,5375,6.4
16,29,Caribou,2008,3924,3782,142,3.6
16,31,Cassia,2008,11054,10630,424,3.8
16,33,Clark,2008,600,579,21,3.5
16,35,Clearwater,2008,3230,2885,345,10.7
16,37,Custer,2008,2453,2343,110,4.5
16,39,Elmore,2008,11448,10812,636,5.6
16,41,Franklin,2008,5727,5539,188,3.3
16,43,Fremont,2008,5798,5517,281,4.8
16,45,Gem,2008,7076,6582,494,7.0
16,47,Gooding,2008,8790,8494,296,3.4
16,49,Idaho,2008,7171,6638,533,7.4
16,51,Jefferson,2008,11350,10925,425,3.7
16,53,Jerome,2008,10028,9610,418,4.2
16,55,Kootenai,2008,71186,67133,4053,5.7
16,57,Latah,2008,17287,16574,713,4.1
16,59,Lemhi,2008,3686,3438,248,6.7
16,61,Lewis,2008,1698,1633,65,3.8
16,63,Lincoln,2008,2587,2443,144,5.6
16,65,Madison,2008,16778,16193,585,3.5
16,67,Minidoka,2008,10139,9685,454,4.5
16,69,Nez Perce,2008,18673,17834,839,4.5
16,71,Oneida,2008,2319,2239,80,3.4
16,73,Owyhee,2008,4391,4257,134,3.1
16,75,Payette,2008,10508,9894,614,5.8
16,77,Power,2008,3564,3378,186,5.2
16,79,Shoshone,2008,6225,5712,513,8.2
16,81,Teton,2008,5338,5186,152,2.8
16,83,Twin Falls,2008,38347,36828,1519,4.0
16,85,Valley,2008,4802,4381,421,8.8
16,87,Washington,2008,4673,4408,265,5.7
17,1,Adams,2008,38682,36794,1888,4.9
17,3,Alexander,2008,3106,2805,301,9.7
17,5,Bond,2008,8767,8171,596,6.8
17,7,Boone,2008,26732,24196,2536,9.5
17,9,Brown,2008,3530,3394,136,3.9
17,11,Bureau,2008,19264,18071,1193,6.2
17,13,Calhoun,2008,2575,2385,190,7.4
17,15,Carroll,2008,8495,7930,565,6.7
17,17,Cass,2008,7595,7187,408,5.4
17,19,Champaign,2008,105481,99511,5970,5.7
17,21,Christian,2008,17918,16726,1192,6.7
17,23,Clark,2008,8578,7888,690,8.0
17,25,Clay,2008,6757,6259,498,7.4
17,27,Clinton,2008,19292,18087,1205,6.2
17,29,Coles,2008,27696,25969,1727,6.2
17,31,Cook,2008,2615934,2441528,174406,6.7
17,33,Crawford,2008,9692,9045,647,6.7
17,35,Cumberland,2008,5645,5234,411,7.3
17,37,DeKalb,2008,60238,56676,3562,5.9
17,39,De Witt,2008,8637,8116,521,6.0
17,41,Douglas,2008,10450,9826,624,6.0
17,43,DuPage,2008,529047,501815,27232,5.1
17,45,Edgar,2008,10265,9542,723,7.0
17,47,Edwards,2008,3279,3066,213,6.5
17,49,Effingham,2008,18510,17474,1036,5.6
17,51,Fayette,2008,10222,9406,816,8.0
17,53,Ford,2008,7170,6725,445,6.2
17,55,Franklin,2008,17913,16231,1682,9.4
17,57,Fulton,2008,17932,16733,1199,6.7
17,59,Gallatin,2008,2611,2397,214,8.2
17,61,Greene,2008,6934,6510,424,6.1
17,63,Grundy,2008,26243,24292,1951,7.4
17,65,Hamilton,2008,4218,3923,295,7.0
17,67,Hancock,2008,9845,9161,684,6.9
17,69,Hardin,2008,1711,1550,161,9.4
17,71,Henderson,2008,3904,3618,286,7.3
17,73,Henry,2008,27553,25848,1705,6.2
17,75,Iroquois,2008,16729,15595,1134,6.8
17,77,Jackson,2008,32416,30554,1862,5.7
17,79,Jasper,2008,5193,4849,344,6.6
17,81,Jefferson,2008,20794,19482,1312,6.3
17,83,Jersey,2008,11773,11011,762,6.5
17,85,Jo Daviess,2008,13399,12638,761,5.7
17,87,Johnson,2008,5116,4699,417,8.2
17,89,Kane,2008,271348,254554,16794,6.2
17,91,Kankakee,2008,55847,51085,4762,8.5
17,93,Kendall,2008,59573,56020,3553,6.0
17,95,Knox,2008,25527,23851,1676,6.6
17,97,Lake,2008,370463,346288,24175,6.5
17,99,LaSalle,2008,59018,54355,4663,7.9
17,101,Lawrence,2008,8280,7659,621,7.5
17,103,Lee,2008,18195,16925,1270,7.0
17,105,Livingston,2008,19356,18202,1154,6.0
17,107,Logan,2008,13378,12478,900,6.7
17,109,McDonough,2008,16863,15924,939,5.6
17,111,McHenry,2008,180494,169705,10789,6.0
17,113,McLean,2008,90447,85918,4529,5.0
17,115,Macon,2008,54510,50721,3789,7.0
17,117,Macoupin,2008,24547,22692,1855,7.6
17,119,Madison,2008,139466,130274,9192,6.6
17,121,Marion,2008,18529,16969,1560,8.4
17,123,Marshall,2008,7223,6823,400,5.5
17,125,Mason,2008,7380,6791,589,8.0
17,127,Massac,2008,7402,6872,530,7.2
17,129,Menard,2008,6915,6527,388,5.6
17,131,Mercer,2008,8917,8308,609,6.8
17,133,Monroe,2008,18566,17583,983,5.3
17,135,Montgomery,2008,13430,12257,1173,8.7
17,137,Morgan,2008,17914,16807,1107,6.2
17,139,Moultrie,2008,8000,7586,414,5.2
17,141,Ogle,2008,27893,25707,2186,7.8
17,143,Peoria,2008,97974,92242,5732,5.9
17,145,Perry,2008,9571,8641,930,9.7
17,147,Piatt,2008,8940,8492,448,5.0
17,149,Pike,2008,8527,8024,503,5.9
17,151,Pope,2008,1934,1771,163,8.4
17,153,Pulaski,2008,2892,2620,272,9.4
17,155,Putnam,2008,3201,2973,228,7.1
17,157,Randolph,2008,15304,14280,1024,6.7
17,159,Richland,2008,7518,7023,495,6.6
17,161,Rock Island,2008,79192,74769,4423,5.6
17,163,St. Clair,2008,124905,115353,9552,7.6
17,165,Saline,2008,12511,11485,1026,8.2
17,167,Sangamon,2008,107531,101413,6118,5.7
17,169,Schuyler,2008,4339,4114,225,5.2
17,171,Scott,2008,2733,2568,165,6.0
17,173,Shelby,2008,11148,10411,737,6.6
17,175,Stark,2008,2975,2783,192,6.5
17,177,Stephenson,2008,25419,23669,1750,6.9
17,179,Tazewell,2008,73616,69692,3924,5.3
17,181,Union,2008,8323,7597,726,8.7
17,183,Vermilion,2008,37345,34400,2945,7.9
17,185,Wabash,2008,6119,5669,450,7.4
17,187,Warren,2008,9234,8708,526,5.7
17,189,Washington,2008,8324,7818,506,6.1
17,191,Wayne,2008,8301,7766,535,6.4
17,193,White,2008,7816,7310,506,6.5
17,195,Whiteside,2008,30243,28164,2079,6.9
17,197,Will,2008,365116,342189,22927,6.3
17,199,Williamson,2008,35312,32820,2492,7.1
17,201,Winnebago,2008,147583,134880,12703,8.6
17,203,Woodford,2008,21680,20740,940,4.3
18,1,Adams,2008,15581,14389,1192,7.7
18,3,Allen,2008,182016,171141,10875,6.0
18,5,Bartholomew,2008,39713,37870,1843,4.6
18,7,Benton,2008,4422,4190,232,5.2
18,9,Blackford,2008,6509,6012,497,7.6
18,11,Boone,2008,28542,27303,1239,4.3
18,13,Brown,2008,7618,7185,433,5.7
18,15,Carroll,2008,10210,9610,600,5.9
18,17,Cass,2008,18878,17691,1187,6.3
18,19,Clark,2008,56284,53281,3003,5.3
18,21,Clay,2008,12923,12006,917,7.1
18,23,Clinton,2008,16947,16018,929,5.5
18,25,Crawford,2008,5410,5002,408,7.5
18,27,Daviess,2008,15261,14676,585,3.8
18,29,Dearborn,2008,26348,24803,1545,5.9
18,31,Decatur,2008,12730,11932,798,6.3
18,33,DeKalb,2008,20699,19193,1506,7.3
18,35,Delaware,2008,55689,51955,3734,6.7
18,37,Dubois,2008,22380,21518,862,3.9
18,39,Elkhart,2008,98188,89778,8410,8.6
18,41,Fayette,2008,10119,8967,1152,11.4
18,43,Floyd,2008,38498,36533,1965,5.1
18,45,Fountain,2008,8686,8223,463,5.3
18,47,Franklin,2008,11935,11147,788,6.6
18,49,Fulton,2008,10318,9640,678,6.6
18,51,Gibson,2008,16895,16018,877,5.2
18,53,Grant,2008,32514,30040,2474,7.6
18,55,Greene,2008,16076,15083,993,6.2
18,57,Hamilton,2008,145713,140159,5554,3.8
18,59,Hancock,2008,36565,34804,1761,4.8
18,61,Harrison,2008,19731,18567,1164,5.9
18,63,Hendricks,2008,74291,71090,3201,4.3
18,65,Henry,2008,22812,21215,1597,7.0
18,67,Howard,2008,37261,34354,2907,7.8
18,69,Huntington,2008,20258,18903,1355,6.7
18,71,Jackson,2008,21874,20708,1166,5.3
18,73,Jasper,2008,15813,14889,924,5.8
18,75,Jay,2008,11797,11113,684,5.8
18,77,Jefferson,2008,16811,15787,1024,6.1
18,79,Jennings,2008,13848,12856,992,7.2
18,81,Johnson,2008,75486,71956,3530,4.7
18,83,Knox,2008,20266,19246,1020,5.0
18,85,Kosciusko,2008,42230,39469,2761,6.5
18,87,LaGrange,2008,16661,15228,1433,8.6
18,89,Lake,2008,229273,215032,14241,6.2
18,91,LaPorte,2008,52910,49608,3302,6.2
18,93,Lawrence,2008,22150,20312,1838,8.3
18,95,Madison,2008,61669,57383,4286,7.0
18,97,Marion,2008,465015,438816,26199,5.6
18,99,Marshall,2008,23272,21573,1699,7.3
18,101,Martin,2008,5163,4912,251,4.9
18,103,Miami,2008,16667,15342,1325,7.9
18,105,Monroe,2008,70082,66898,3184,4.5
18,107,Montgomery,2008,19166,18219,947,4.9
18,109,Morgan,2008,37668,35496,2172,5.8
18,111,Newton,2008,7001,6561,440,6.3
18,113,Noble,2008,22836,20902,1934,8.5
18,115,Ohio,2008,3057,2867,190,6.2
18,117,Orange,2008,10443,9776,667,6.4
18,119,Owen,2008,11460,10726,734,6.4
18,121,Parke,2008,8086,7598,488,6.0
18,123,Perry,2008,9745,9240,505,5.2
18,125,Pike,2008,6055,5714,341,5.6
18,127,Porter,2008,84701,80644,4057,4.8
18,129,Posey,2008,13414,12760,654,4.9
18,131,Pulaski,2008,6825,6441,384,5.6
18,133,Putnam,2008,17772,16574,1198,6.7
18,135,Randolph,2008,12766,11884,882,6.9
18,137,Ripley,2008,14107,13265,842,6.0
18,139,Rush,2008,9267,8696,571,6.2
18,141,St. Joseph,2008,133416,124654,8762,6.6
18,143,Scott,2008,11142,10419,723,6.5
18,145,Shelby,2008,23910,22508,1402,5.9
18,147,Spencer,2008,10560,10025,535,5.1
18,149,Starke,2008,10743,9909,834,7.8
18,151,Steuben,2008,16241,15023,1218,7.5
18,153,Sullivan,2008,8904,8307,597,6.7
18,155,Switzerland,2008,5716,5428,288,5.0
18,157,Tippecanoe,2008,83886,79925,3961,4.7
18,159,Tipton,2008,7628,7076,552,7.2
18,161,Union,2008,3618,3394,224,6.2
18,163,Vanderburgh,2008,91843,87069,4774,5.2
18,165,Vermillion,2008,7842,7273,569,7.3
18,167,Vigo,2008,50602,47346,3256,6.4
18,169,Wabash,2008,16607,15358,1249,7.5
18,171,Warren,2008,4814,4616,198,4.1
18,173,Warrick,2008,31166,29719,1447,4.6
18,175,Washington,2008,14162,13220,942,6.7
18,177,Wayne,2008,33411,31034,2377,7.1
18,179,Wells,2008,14796,13961,835,5.6
18,181,White,2008,12461,11740,721,5.8
18,183,Whitley,2008,17949,16806,1143,6.4
19,1,Adair,2008,4384,4209,175,4.0
19,3,Adams,2008,2115,2026,89,4.2
19,5,Allamakee,2008,7895,7393,502,6.4
19,7,Appanoose,2008,6037,5708,329,5.4
19,9,Audubon,2008,3234,3090,144,4.5
19,11,Benton,2008,14449,13850,599,4.1
19,13,Black Hawk,2008,73858,70851,3007,4.1
19,15,Boone,2008,15686,15127,559,3.6
19,17,Bremer,2008,13939,13447,492,3.5
19,19,Buchanan,2008,11196,10743,453,4.0
19,21,Buena Vista,2008,10648,10268,380,3.6
19,23,Butler,2008,8516,8123,393,4.6
19,25,Calhoun,2008,5294,5110,184,3.5
19,27,Carroll,2008,12372,12021,351,2.8
19,29,Cass,2008,7620,7272,348,4.6
19,31,Cedar,2008,11344,10933,411,3.6
19,33,Cerro Gordo,2008,25753,24533,1220,4.7
19,35,Cherokee,2008,6506,6278,228,3.5
19,37,Chickasaw,2008,6902,6565,337,4.9
19,39,Clarke,2008,4916,4690,226,4.6
19,41,Clay,2008,9746,9414,332,3.4
19,43,Clayton,2008,9987,9445,542,5.4
19,45,Clinton,2008,28159,26978,1181,4.2
19,47,Crawford,2008,9409,9099,310,3.3
19,49,Dallas,2008,34014,32911,1103,3.2
19,51,Davis,2008,4076,3873,203,5.0
19,53,Decatur,2008,4280,4118,162,3.8
19,55,Delaware,2008,10861,10435,426,3.9
19,57,Des Moines,2008,20908,19698,1210,5.8
19,59,Dickinson,2008,9710,9287,423,4.4
19,61,Dubuque,2008,52284,50012,2272,4.3
19,63,Emmet,2008,5950,5716,234,3.9
19,65,Fayette,2008,10947,10368,579,5.3
19,67,Floyd,2008,8625,8125,500,5.8
19,69,Franklin,2008,5858,5600,258,4.4
19,71,Fremont,2008,3917,3742,175,4.5
19,73,Greene,2008,5088,4890,198,3.9
19,75,Grundy,2008,6888,6643,245,3.6
19,77,Guthrie,2008,5807,5556,251,4.3
19,79,Hamilton,2008,8594,8266,328,3.8
19,81,Hancock,2008,5957,5579,378,6.3
19,83,Hardin,2008,9281,8888,393,4.2
19,85,Harrison,2008,7761,7437,324,4.2
19,87,Henry,2008,10176,9635,541,5.3
19,89,Howard,2008,5224,4980,244,4.7
19,91,Humboldt,2008,5173,4985,188,3.6
19,93,Ida,2008,4208,4047,161,3.8
19,95,Iowa,2008,8672,8311,361,4.2
19,97,Jackson,2008,11321,10740,581,5.1
19,99,Jasper,2008,17764,16415,1349,7.6
19,101,Jefferson,2008,8449,8074,375,4.4
19,103,Johnson,2008,79427,77055,2372,3.0
19,105,Jones,2008,10566,10097,469,4.4
19,107,Keokuk,2008,5649,5395,254,4.5
19,109,Kossuth,2008,9055,8699,356,3.9
19,111,Lee,2008,17486,16350,1136,6.5
19,113,Linn,2008,121416,116538,4878,4.0
19,115,Louisa,2008,6384,6080,304,4.8
19,117,Lucas,2008,4665,4474,191,4.1
19,119,Lyon,2008,6843,6663,180,2.6
19,121,Madison,2008,8343,7945,398,4.8
19,123,Mahaska,2008,11836,11302,534,4.5
19,125,Marion,2008,17838,17128,710,4.0
19,127,Marshall,2008,20534,19488,1046,5.1
19,129,Mills,2008,8125,7829,296,3.6
19,131,Mitchell,2008,5771,5538,233,4.0
19,133,Monona,2008,4621,4374,247,5.3
19,135,Monroe,2008,4223,4036,187,4.4
19,137,Montgomery,2008,5419,5111,308,5.7
19,139,Muscatine,2008,23974,22931,1043,4.4
19,141,O'Brien,2008,7812,7554,258,3.3
19,143,Osceola,2008,3399,3270,129,3.8
19,145,Page,2008,8167,7778,389,4.8
19,147,Palo Alto,2008,5449,5220,229,4.2
19,149,Plymouth,2008,14360,13884,476,3.3
19,151,Pocahontas,2008,4246,4113,133,3.1
19,153,Polk,2008,241374,231688,9686,4.0
19,155,Pottawattamie,2008,48693,46651,2042,4.2
19,157,Poweshiek,2008,10503,10028,475,4.5
19,159,Ringgold,2008,2430,2320,110,4.5
19,161,Sac,2008,5793,5579,214,3.7
19,163,Scott,2008,90614,86809,3805,4.2
19,165,Shelby,2008,7600,7370,230,3.0
19,167,Sioux,2008,19766,19213,553,2.8
19,169,Story,2008,48911,47372,1539,3.1
19,171,Tama,2008,8954,8482,472,5.3
19,173,Taylor,2008,3376,3241,135,4.0
19,175,Union,2008,6721,6417,304,4.5
19,177,Van Buren,2008,3957,3766,191,4.8
19,179,Wapello,2008,18907,17967,940,5.0
19,181,Warren,2008,25799,24829,970,3.8
19,183,Washington,2008,12039,11553,486,4.0
19,185,Wayne,2008,3251,3116,135,4.2
19,187,Webster,2008,20093,19226,867,4.3
19,189,Winnebago,2008,5931,5553,378,6.4
19,191,Winneshiek,2008,12410,11878,532,4.3
19,193,Woodbury,2008,56027,53891,2136,3.8
19,195,Worth,2008,4583,4346,237,5.2
19,197,Wright,2008,7125,6811,314,4.4
20,1,Allen,2008,7376,7041,335,4.5
20,3,Anderson,2008,4321,4114,207,4.8
20,5,Atchison,2008,8817,8413,404,4.6
20,7,Barber,2008,2744,2654,90,3.3
20,9,Barton,2008,15560,15047,513,3.3
20,11,Bourbon,2008,8481,8072,409,4.8
20,13,Brown,2008,5535,5295,240,4.3
20,15,Butler,2008,32603,31174,1429,4.4
20,17,Chase,2008,1462,1402,60,4.1
20,19,Chautauqua,2008,1852,1768,84,4.5
20,21,Cherokee,2008,11162,10586,576,5.2
20,23,Cheyenne,2008,1469,1423,46,3.1
20,25,Clark,2008,1246,1207,39,3.1
20,27,Clay,2008,5149,4973,176,3.4
20,29,Cloud,2008,5558,5355,203,3.7
20,31,Coffey,2008,5350,5098,252,4.7
20,33,Comanche,2008,1108,1072,36,3.2
20,35,Cowley,2008,18066,17265,801,4.4
20,37,Crawford,2008,19820,18771,1049,5.3
20,39,Decatur,2008,1777,1722,55,3.1
20,41,Dickinson,2008,10671,10249,422,4.0
20,43,Doniphan,2008,4467,4220,247,5.5
20,45,Douglas,2008,61455,58883,2572,4.2
20,47,Edwards,2008,1749,1700,49,2.8
20,49,Elk,2008,1456,1374,82,5.6
20,51,Ellis,2008,17300,16777,523,3.0
20,53,Ellsworth,2008,3857,3730,127,3.3
20,55,Finney,2008,19051,18379,672,3.5
20,57,Ford,2008,18019,17474,545,3.0
20,59,Franklin,2008,13723,12957,766,5.6
20,61,Geary,2008,13511,12882,629,4.7
20,63,Gove,2008,1510,1468,42,2.8
20,65,Graham,2008,1514,1464,50,3.3
20,67,Grant,2008,3986,3872,114,2.9
20,69,Gray,2008,3309,3223,86,2.6
20,71,Greeley,2008,727,700,27,3.7
20,73,Greenwood,2008,3613,3423,190,5.3
20,75,Hamilton,2008,1283,1239,44,3.4
20,77,Harper,2008,3424,3315,109,3.2
20,79,Harvey,2008,18011,17308,703,3.9
20,81,Haskell,2008,2183,2124,59,2.7
20,83,Hodgeman,2008,940,908,32,3.4
20,85,Jackson,2008,6843,6451,392,5.7
20,87,Jefferson,2008,9574,9073,501,5.2
20,89,Jewell,2008,1941,1880,61,3.1
20,91,Johnson,2008,300329,286565,13764,4.6
20,93,Kearny,2008,2169,2096,73,3.4
20,95,Kingman,2008,4472,4323,149,3.3
20,97,Kiowa,2008,1427,1379,48,3.4
20,99,Labette,2008,11419,10818,601,5.3
20,101,Lane,2008,1092,1052,40,3.7
20,103,Leavenworth,2008,32787,30894,1893,5.8
20,105,Lincoln,2008,1924,1853,71,3.7
20,107,Linn,2008,4620,4312,308,6.7
20,109,Logan,2008,1653,1607,46,2.8
20,111,Lyon,2008,18794,17698,1096,5.8
20,113,McPherson,2008,16453,15865,588,3.6
20,115,Marion,2008,6726,6479,247,3.7
20,117,Marshall,2008,5952,5730,222,3.7
20,119,Meade,2008,2393,2323,70,2.9
20,121,Miami,2008,16247,15416,831,5.1
20,123,Mitchell,2008,3555,3438,117,3.3
20,125,Montgomery,2008,17893,16899,994,5.6
20,127,Morris,2008,2892,2753,139,4.8
20,129,Morton,2008,1770,1721,49,2.8
20,131,Nemaha,2008,5744,5565,179,3.1
20,133,Neosho,2008,9177,8728,449,4.9
20,135,Ness,2008,1814,1759,55,3.0
20,137,Norton,2008,2807,2717,90,3.2
20,139,Osage,2008,8473,7968,505,6.0
20,141,Osborne,2008,2241,2165,76,3.4
20,143,Ottawa,2008,3372,3249,123,3.6
20,145,Pawnee,2008,3803,3682,121,3.2
20,147,Phillips,2008,3052,2922,130,4.3
20,149,Pottawatomie,2008,10734,10350,384,3.6
20,151,Pratt,2008,5683,5488,195,3.4
20,153,Rawlins,2008,1228,1186,42,3.4
20,155,Reno,2008,34264,32860,1404,4.1
20,157,Republic,2008,2956,2864,92,3.1
20,159,Rice,2008,5819,5599,220,3.8
20,161,Riley,2008,37174,35875,1299,3.5
20,163,Rooks,2008,2681,2558,123,4.6
20,165,Rush,2008,1703,1637,66,3.9
20,167,Russell,2008,3595,3462,133,3.7
20,169,Saline,2008,31406,30206,1200,3.8
20,171,Scott,2008,2725,2652,73,2.7
20,173,Sedgwick,2008,253759,242342,11417,4.5
20,175,Seward,2008,11077,10731,346,3.1
20,177,Shawnee,2008,92075,87466,4609,5.0
20,179,Sheridan,2008,1564,1523,41,2.6
20,181,Sherman,2008,3731,3615,116,3.1
20,183,Smith,2008,2162,2076,86,4.0
20,185,Stafford,2008,2148,2069,79,3.7
20,187,Stanton,2008,1113,1076,37,3.3
20,189,Stevens,2008,2283,2206,77,3.4
20,191,Sumner,2008,11646,11110,536,4.6
20,193,Thomas,2008,4216,4086,130,3.1
20,195,Trego,2008,1864,1808,56,3.0
20,197,Wabaunsee,2008,3692,3526,166,4.5
20,199,Wallace,2008,846,806,40,4.7
20,201,Washington,2008,3326,3206,120,3.6
20,203,Wichita,2008,1260,1221,39,3.1
20,205,Wilson,2008,5502,5195,307,5.6
20,207,Woodson,2008,1667,1573,94,5.6
20,209,Wyandotte,2008,70843,65151,5692,8.0
21,1,Adair,2008,8885,8272,613,6.9
21,3,Allen,2008,8399,7801,598,7.1
21,5,Anderson,2008,10918,10212,706,6.5
21,7,Ballard,2008,4150,3889,261,6.3
21,9,Barren,2008,19486,18276,1210,6.2
21,11,Bath,2008,5048,4593,455,9.0
21,13,Bell,2008,9640,8777,863,9.0
21,15,Boone,2008,63099,59622,3477,5.5
21,17,Bourbon,2008,9585,9022,563,5.9
21,19,Boyd,2008,22880,21519,1361,5.9
21,21,Boyle,2008,12792,11920,872,6.8
21,23,Bracken,2008,4258,3947,311,7.3
21,25,Breathitt,2008,5640,5225,415,7.4
21,27,Breckinridge,2008,9187,8496,691,7.5
21,29,Bullitt,2008,39487,36711,2776,7.0
21,31,Butler,2008,5478,5042,436,8.0
21,33,Caldwell,2008,6686,6244,442,6.6
21,35,Calloway,2008,17873,16823,1050,5.9
21,37,Campbell,2008,44544,41819,2725,6.1
21,39,Carlisle,2008,2278,2128,150,6.6
21,41,Carroll,2008,5559,5140,419,7.5
21,43,Carter,2008,13355,12255,1100,8.2
21,45,Casey,2008,7150,6693,457,6.4
21,47,Christian,2008,29085,26656,2429,8.4
21,49,Clark,2008,17154,16055,1099,6.4
21,51,Clay,2008,6826,6112,714,10.5
21,53,Clinton,2008,4727,4418,309,6.5
21,55,Crittenden,2008,4041,3774,267,6.6
21,57,Cumberland,2008,2957,2723,234,7.9
21,59,Daviess,2008,47474,44735,2739,5.8
21,61,Edmonson,2008,5336,4929,407,7.6
21,63,Elliott,2008,3156,2890,266,8.4
21,65,Estill,2008,6188,5703,485,7.8
21,67,Fayette,2008,150541,143168,7373,4.9
21,69,Fleming,2008,6480,6009,471,7.3
21,71,Floyd,2008,15323,14288,1035,6.8
21,73,Franklin,2008,24877,23417,1460,5.9
21,75,Fulton,2008,2721,2511,210,7.7
21,77,Gallatin,2008,3931,3650,281,7.1
21,79,Garrard,2008,7603,7101,502,6.6
21,81,Grant,2008,12820,11916,904,7.1
21,83,Graves,2008,15865,14761,1104,7.0
21,85,Grayson,2008,11159,10039,1120,10.0
21,87,Green,2008,5551,5120,431,7.8
21,89,Greenup,2008,17563,16454,1109,6.3
21,91,Hancock,2008,4206,3958,248,5.9
21,93,Hardin,2008,47696,44701,2995,6.3
21,95,Harlan,2008,10090,9189,901,8.9
21,97,Harrison,2008,9296,8705,591,6.4
21,99,Hart,2008,8268,7719,549,6.6
21,101,Henderson,2008,22919,21502,1417,6.2
21,103,Henry,2008,7795,7305,490,6.3
21,105,Hickman,2008,2102,1953,149,7.1
21,107,Hopkins,2008,23196,21485,1711,7.4
21,109,Jackson,2008,4121,3650,471,11.4
21,111,Jefferson,2008,357046,334260,22786,6.4
21,113,Jessamine,2008,23101,21816,1285,5.6
21,115,Johnson,2008,9533,8870,663,7.0
21,117,Kenton,2008,83972,78919,5053,6.0
21,119,Knott,2008,6302,5873,429,6.8
21,121,Knox,2008,12780,11794,986,7.7
21,123,Larue,2008,6988,6529,459,6.6
21,125,Laurel,2008,26144,24397,1747,6.7
21,127,Lawrence,2008,5892,5384,508,8.6
21,129,Lee,2008,2686,2486,200,7.4
21,131,Leslie,2008,3558,3261,297,8.3
21,133,Letcher,2008,8731,8125,606,6.9
21,135,Lewis,2008,5539,5006,533,9.6
21,137,Lincoln,2008,10541,9746,795,7.5
21,139,Livingston,2008,4734,4443,291,6.1
21,141,Logan,2008,12413,11617,796,6.4
21,143,Lyon,2008,3290,3036,254,7.7
21,145,McCracken,2008,31174,29355,1819,5.8
21,147,McCreary,2008,5732,5176,556,9.7
21,149,McLean,2008,4573,4245,328,7.2
21,151,Madison,2008,43003,40615,2388,5.6
21,153,Magoffin,2008,4279,3817,462,10.8
21,155,Marion,2008,10266,9598,668,6.5
21,157,Marshall,2008,14771,13831,940,6.4
21,159,Martin,2008,3525,3255,270,7.7
21,161,Mason,2008,8809,8279,530,6.0
21,163,Meade,2008,11563,10661,902,7.8
21,165,Menifee,2008,2593,2334,259,10.0
21,167,Mercer,2008,10491,9825,666,6.3
21,169,Metcalfe,2008,4412,4100,312,7.1
21,171,Monroe,2008,4760,4362,398,8.4
21,173,Montgomery,2008,12277,11364,913,7.4
21,175,Morgan,2008,4922,4440,482,9.8
21,177,Muhlenberg,2008,13148,12014,1134,8.6
21,179,Nelson,2008,21630,20035,1595,7.4
21,181,Nicholas,2008,3089,2862,227,7.3
21,183,Ohio,2008,12549,11740,809,6.4
21,185,Oldham,2008,27852,26276,1576,5.7
21,187,Owen,2008,5317,4969,348,6.5
21,189,Owsley,2008,1533,1409,124,8.1
21,191,Pendleton,2008,7324,6756,568,7.8
21,193,Perry,2008,11225,10451,774,6.9
21,195,Pike,2008,25779,24257,1522,5.9
21,197,Powell,2008,5462,4989,473,8.7
21,199,Pulaski,2008,27188,25340,1848,6.8
21,201,Robertson,2008,987,926,61,6.2
21,203,Rockcastle,2008,7249,6712,537,7.4
21,205,Rowan,2008,12376,11626,750,6.1
21,207,Russell,2008,8270,7657,613,7.4
21,209,Scott,2008,22860,21605,1255,5.5
21,211,Shelby,2008,21542,20294,1248,5.8
21,213,Simpson,2008,9399,8790,609,6.5
21,215,Spencer,2008,9207,8526,681,7.4
21,217,Taylor,2008,13591,12760,831,6.1
21,219,Todd,2008,5248,4871,377,7.2
21,221,Trigg,2008,6272,5781,491,7.8
21,223,Trimble,2008,4356,4036,320,7.3
21,225,Union,2008,7684,7174,510,6.6
21,227,Warren,2008,58049,54902,3147,5.4
21,229,Washington,2008,5421,5024,397,7.3
21,231,Wayne,2008,8423,7718,705,8.4
21,233,Webster,2008,6427,6015,412,6.4
21,235,Whitley,2008,15429,14283,1146,7.4
21,237,Wolfe,2008,2322,2093,229,9.9
21,239,Woodford,2008,13181,12545,636,4.8
22,1,Acadia Parish,2008,26855,25791,1064,4.0
22,3,Allen Parish,2008,8777,8258,519,5.9
22,5,Ascension Parish,2008,50461,48367,2094,4.1
22,7,Assumption Parish,2008,10563,9980,583,5.5
22,9,Avoyelles Parish,2008,16309,15378,931,5.7
22,11,Beauregard Parish,2008,14497,13747,750,5.2
22,13,Bienville Parish,2008,6121,5747,374,6.1
22,15,Bossier Parish,2008,54281,51976,2305,4.2
22,17,Caddo Parish,2008,119929,113460,6469,5.4
22,19,Calcasieu Parish,2008,93583,89620,3963,4.2
22,21,Caldwell Parish,2008,4536,4312,224,4.9
22,23,Cameron Parish,2008,3531,3383,148,4.2
22,25,Catahoula Parish,2008,4190,3922,268,6.4
22,27,Claiborne Parish,2008,6568,6180,388,5.9
22,29,Concordia Parish,2008,7550,7018,532,7.0
22,31,De Soto Parish,2008,11654,10861,793,6.8
22,33,East Baton Rouge Parish,2008,216740,207120,9620,4.4
22,35,East Carroll Parish,2008,3042,2738,304,10.0
22,37,East Feliciana Parish,2008,8108,7694,414,5.1
22,39,Evangeline Parish,2008,12463,11828,635,5.1
22,41,Franklin Parish,2008,7774,7214,560,7.2
22,43,Grant Parish,2008,8848,8404,444,5.0
22,45,Iberia Parish,2008,34911,33495,1416,4.1
22,47,Iberville Parish,2008,12387,11577,810,6.5
22,49,Jackson Parish,2008,6602,6295,307,4.7
22,51,Jefferson Parish,2008,215107,206047,9060,4.2
22,53,Jefferson Davis Parish,2008,14884,14319,565,3.8
22,55,Lafayette Parish,2008,112131,108523,3608,3.2
22,57,Lafourche Parish,2008,49703,48051,1652,3.3
22,59,LaSalle Parish,2008,6351,6108,243,3.8
22,61,Lincoln Parish,2008,19224,18230,994,5.2
22,63,Livingston Parish,2008,57870,55477,2393,4.1
22,65,Madison Parish,2008,4631,4283,348,7.5
22,67,Morehouse Parish,2008,11742,10740,1002,8.5
22,69,Natchitoches Parish,2008,17168,16174,994,5.8
22,71,Orleans Parish,2008,132498,124926,7572,5.7
22,73,Ouachita Parish,2008,71150,67661,3489,4.9
22,75,Plaquemines Parish,2008,8395,8020,375,4.5
22,77,Pointe Coupee Parish,2008,9565,9084,481,5.0
22,79,Rapides Parish,2008,61659,58962,2697,4.4
22,81,Red River Parish,2008,3466,3209,257,7.4
22,83,Richland Parish,2008,8805,8259,546,6.2
22,85,Sabine Parish,2008,9559,9106,453,4.7
22,87,St. Bernard Parish,2008,17390,16649,741,4.3
22,89,St. Charles Parish,2008,24558,23464,1094,4.5
22,91,St. Helena Parish,2008,4233,3876,357,8.4
22,93,St. James Parish,2008,9089,8446,643,7.1
22,95,St. John the Baptist Parish,2008,20957,19749,1208,5.8
22,97,St. Landry Parish,2008,37749,35840,1909,5.1
22,99,St. Martin Parish,2008,24060,23102,958,4.0
22,101,St. Mary Parish,2008,23505,22417,1088,4.6
22,103,St. Tammany Parish,2008,110671,106488,4183,3.8
22,105,Tangipahoa Parish,2008,52781,49955,2826,5.4
22,107,Tensas Parish,2008,2109,1938,171,8.1
22,109,Terrebonne Parish,2008,55989,53999,1990,3.6
22,111,Union Parish,2008,10078,9552,526,5.2
22,113,Vermilion Parish,2008,24398,23384,1014,4.2
22,115,Vernon Parish,2008,20686,19732,954,4.6
22,117,Washington Parish,2008,15898,14920,978,6.2
22,119,Webster Parish,2008,20086,18895,1191,5.9
22,121,West Baton Rouge Parish,2008,10674,10175,499,4.7
22,123,West Carroll Parish,2008,4413,3975,438,9.9
22,125,West Feliciana Parish,2008,4754,4494,260,5.5
22,127,Winn Parish,2008,6432,6085,347,5.4
23,1,Androscoggin,2008,58172,55035,3137,5.4
23,3,Aroostook,2008,34950,32565,2385,6.8
23,5,Cumberland,2008,157401,150942,6459,4.1
23,7,Franklin,2008,14238,13254,984,6.9
23,9,Hancock,2008,29697,27945,1752,5.9
23,11,Kennebec,2008,63405,60116,3289,5.2
23,13,Knox,2008,20936,19860,1076,5.1
23,15,Lincoln,2008,18330,17406,924,5.0
23,17,Oxford,2008,28212,26303,1909,6.8
23,19,Penobscot,2008,78842,74419,4423,5.6
23,21,Piscataquis,2008,7399,6793,606,8.2
23,23,Sagadahoc,2008,19066,18172,894,4.7
23,25,Somerset,2008,24767,22856,1911,7.7
23,27,Waldo,2008,19085,17928,1157,6.1
23,29,Washington,2008,14507,13298,1209,8.3
23,31,York,2008,112923,107554,5369,4.8
24,1,Allegany,2008,35668,33521,2147,6.0
24,3,Anne Arundel,2008,285489,274099,11390,4.0
24,5,Baltimore,2008,433891,413616,20275,4.7
24,9,Calvert,2008,49210,47401,1809,3.7
24,11,Caroline,2008,16624,15680,944,5.7
24,13,Carroll,2008,95810,92077,3733,3.9
24,15,Cecil,2008,51355,48575,2780,5.4
24,17,Charles,2008,78275,75276,2999,3.8
24,19,Dorchester,2008,16809,15607,1202,7.2
24,21,Frederick,2008,124426,119634,4792,3.9
24,23,Garrett,2008,16942,16067,875,5.2
24,25,Harford,2008,134412,128560,5852,4.4
24,27,Howard,2008,162551,157247,5304,3.3
24,29,Kent,2008,11125,10561,564,5.1
24,31,Montgomery,2008,520067,502576,17491,3.4
24,33,Prince George's,2008,454281,433384,20897,4.6
24,35,Queen Anne's,2008,26872,25724,1148,4.3
24,37,St. Mary's,2008,52528,50511,2017,3.8
24,39,Somerset,2008,11376,10607,769,6.8
24,41,Talbot,2008,19378,18517,861,4.4
24,43,Washington,2008,68316,64286,4030,5.9
24,45,Wicomico,2008,53240,50317,2923,5.5
24,47,Worcester,2008,27888,25738,2150,7.7
24,510,Baltimore city,2008,281402,261928,19474,6.9
25,1,Barnstable,2008,122145,115089,7056,5.8
25,3,Berkshire,2008,73119,69383,3736,5.1
25,5,Bristol,2008,291587,271170,20417,7.0
25,7,Dukes,2008,11235,10773,462,4.1
25,9,Essex,2008,378507,357273,21234,5.6
25,11,Franklin,2008,39094,37154,1940,5.0
25,13,Hampden,2008,225643,211185,14458,6.4
25,15,Hampshire,2008,88793,84929,3864,4.4
25,17,Middlesex,2008,828076,792201,35875,4.3
25,19,Nantucket/town,2008,8441,8166,275,3.3
25,21,Norfolk,2008,359125,342321,16804,4.7
25,23,Plymouth,2008,262430,247725,14705,5.6
25,25,Suffolk,2008,373295,353875,19420,5.2
25,27,Worcester,2008,404398,381054,23344,5.8
26,1,Alcona,2008,4287,3792,495,11.5
26,3,Alger,2008,4278,3872,406,9.5
26,5,Allegan,2008,55140,51033,4107,7.4
26,7,Alpena,2008,14841,13516,1325,8.9
26,9,Antrim,2008,11636,10536,1100,9.5
26,11,Arenac,2008,7967,7138,829,10.4
26,13,Baraga,2008,4264,3683,581,13.6
26,15,Barry,2008,29908,27967,1941,6.5
26,17,Bay,2008,54566,50401,4165,7.6
26,19,Benzie,2008,8833,8034,799,9.0
26,21,Berrien,2008,79503,73253,6250,7.9
26,23,Branch,2008,21808,19966,1842,8.4
26,25,Calhoun,2008,68759,63626,5133,7.5
26,27,Cass,2008,26484,24692,1792,6.8
26,29,Charlevoix,2008,14038,12671,1367,9.7
26,31,Cheboygan,2008,12170,10799,1371,11.3
26,33,Chippewa,2008,17225,15565,1660,9.6
26,35,Clare,2008,12899,11403,1496,11.6
26,37,Clinton,2008,37651,35425,2226,5.9
26,39,Crawford,2008,6454,5851,603,9.3
26,41,Delta,2008,19673,18026,1647,8.4
26,43,Dickinson,2008,14400,13413,987,6.9
26,45,Eaton,2008,58663,55019,3644,6.2
26,47,Emmet,2008,19785,17833,1952,9.9
26,49,Genesee,2008,202076,181485,20591,10.2
26,51,Gladwin,2008,10445,9320,1125,10.8
26,53,Gogebic,2008,7527,6885,642,8.5
26,55,Grand Traverse,2008,48705,45101,3604,7.4
26,57,Gratiot,2008,19350,17551,1799,9.3
26,59,Hillsdale,2008,20864,18712,2152,10.3
26,61,Houghton,2008,17383,16027,1356,7.8
26,63,Huron,2008,16245,14793,1452,8.9
26,65,Ingham,2008,152368,141670,10698,7.0
26,67,Ionia,2008,29998,27487,2511,8.4
26,69,Iosco,2008,10659,9500,1159,10.9
26,71,Iron,2008,5832,5345,487,8.4
26,73,Isabella,2008,38591,36282,2309,6.0
26,75,Jackson,2008,76333,69952,6381,8.4
26,77,Kalamazoo,2008,133800,125527,8273,6.2
26,79,Kalkaska,2008,8514,7770,744,8.7
26,81,Kent,2008,319781,298230,21551,6.7
26,83,Keweenaw,2008,1061,946,115,10.8
26,85,Lake,2008,3938,3493,445,11.3
26,87,Lapeer,2008,43055,38808,4247,9.9
26,89,Leelanau,2008,11127,10444,683,6.1
26,91,Lenawee,2008,48592,43811,4781,9.8
26,93,Livingston,2008,92442,86338,6104,6.6
26,95,Luce,2008,2736,2483,253,9.2
26,97,Mackinac,2008,6298,5560,738,11.7
26,99,Macomb,2008,412082,376995,35087,8.5
26,101,Manistee,2008,11704,10671,1033,8.8
26,103,Marquette,2008,35860,33378,2482,6.9
26,105,Mason,2008,14801,13551,1250,8.4
26,107,Mecosta,2008,19687,18001,1686,8.6
26,109,Menominee,2008,13052,12232,820,6.3
26,111,Midland,2008,43133,40473,2660,6.2
26,113,Missaukee,2008,6405,5740,665,10.4
26,115,Monroe,2008,75842,69306,6536,8.6
26,117,Montcalm,2008,26309,23301,3008,11.4
26,119,Montmorency,2008,4010,3453,557,13.9
26,121,Muskegon,2008,88615,81070,7545,8.5
26,123,Newaygo,2008,22590,20563,2027,9.0
26,125,Oakland,2008,608180,566130,42050,6.9
26,127,Oceana,2008,14056,12597,1459,10.4
26,129,Ogemaw,2008,9528,8645,883,9.3
26,131,Ontonagon,2008,3273,2971,302,9.2
26,133,Osceola,2008,9434,8545,889,9.4
26,135,Oscoda,2008,3878,3384,494,12.7
26,137,Otsego,2008,12017,10809,1208,10.1
26,139,Ottawa,2008,134006,124815,9191,6.9
26,141,Presque Isle,2008,6011,5192,819,13.6
26,143,Roscommon,2008,10201,9076,1125,11.0
26,145,Saginaw,2008,94180,86261,7919,8.4
26,147,St. Clair,2008,81701,73389,8312,10.2
26,149,St. Joseph,2008,30566,27926,2640,8.6
26,151,Sanilac,2008,21139,18814,2325,11.0
26,153,Schoolcraft,2008,3891,3453,438,11.3
26,155,Shiawassee,2008,35309,31855,3454,9.8
26,157,Tuscola,2008,27852,25041,2811,10.1
26,159,Van Buren,2008,39896,36661,3235,8.1
26,161,Washtenaw,2008,186154,175542,10612,5.7
26,163,Wayne,2008,863168,779638,83530,9.7
26,165,Wexford,2008,14311,12746,1565,10.9
27,1,Aitkin,2008,7652,7036,616,8.1
27,3,Anoka,2008,189160,178872,10288,5.4
27,5,Becker,2008,16746,15617,1129,6.7
27,7,Beltrami,2008,21117,19663,1454,6.9
27,9,Benton,2008,23006,21617,1389,6.0
27,11,Big Stone,2008,2793,2639,154,5.5
27,13,Blue Earth,2008,37279,35646,1633,4.4
27,15,Brown,2008,14848,13960,888,6.0
27,17,Carlton,2008,17372,16219,1153,6.6
27,19,Carver,2008,50316,47862,2454,4.9
27,21,Cass,2008,14121,12909,1212,8.6
27,23,Chippewa,2008,7110,6741,369,5.2
27,25,Chisago,2008,27311,25454,1857,6.8
27,27,Clay,2008,32127,30943,1184,3.7
27,29,Clearwater,2008,4030,3570,460,11.4
27,31,Cook,2008,3110,2937,173,5.6
27,33,Cottonwood,2008,6266,5938,328,5.2
27,35,Crow Wing,2008,32613,30357,2256,6.9
27,37,Dakota,2008,229798,218579,11219,4.9
27,39,Dodge,2008,11000,10430,570,5.2
27,41,Douglas,2008,20288,19284,1004,4.9
27,43,Faribault,2008,7721,7241,480,6.2
27,45,Fillmore,2008,10928,10265,663,6.1
27,47,Freeborn,2008,16285,15362,923,5.7
27,49,Goodhue,2008,25044,23627,1417,5.7
27,51,Grant,2008,3042,2828,214,7.0
27,53,Hennepin,2008,654479,622437,32042,4.9
27,55,Houston,2008,10870,10246,624,5.7
27,57,Hubbard,2008,9526,8808,718,7.5
27,59,Isanti,2008,21697,20202,1495,6.9
27,61,Itasca,2008,22144,20405,1739,7.9
27,63,Jackson,2008,6597,6321,276,4.2
27,65,Kanabec,2008,7983,7166,817,10.2
27,67,Kandiyohi,2008,23489,22329,1160,4.9
27,69,Kittson,2008,2467,2328,139,5.6
27,71,Koochiching,2008,6508,6009,499,7.7
27,73,Lac qui Parle,2008,4098,3901,197,4.8
27,75,Lake,2008,6145,5822,323,5.3
27,77,Lake of the Woods,2008,2264,2128,136,6.0
27,79,Le Sueur,2008,14309,13259,1050,7.3
27,81,Lincoln,2008,3248,3084,164,5.0
27,83,Lyon,2008,14504,13864,640,4.4
27,85,McLeod,2008,20427,19198,1229,6.0
27,87,Mahnomen,2008,2404,2231,173,7.2
27,89,Marshall,2008,5149,4745,404,7.8
27,91,Martin,2008,11449,10891,558,4.9
27,93,Meeker,2008,12451,11632,819,6.6
27,95,Mille Lacs,2008,12271,11164,1107,9.0
27,97,Morrison,2008,17617,16289,1328,7.5
27,99,Mower,2008,20373,19441,932,4.6
27,101,Murray,2008,5412,5137,275,5.1
27,103,Nicollet,2008,19768,18912,856,4.3
27,105,Nobles,2008,11103,10643,460,4.1
27,107,Norman,2008,3524,3326,198,5.6
27,109,Olmsted,2008,79671,76145,3526,4.4
27,111,Otter Tail,2008,29533,27739,1794,6.1
27,113,Pennington,2008,8686,8071,615,7.1
27,115,Pine,2008,14108,12905,1203,8.5
27,117,Pipestone,2008,5595,5347,248,4.4
27,119,Polk,2008,16830,15987,843,5.0
27,121,Pope,2008,6070,5748,322,5.3
27,123,Ramsey,2008,270816,256640,14176,5.2
27,125,Red Lake,2008,2353,2167,186,7.9
27,127,Redwood,2008,8059,7624,435,5.4
27,129,Renville,2008,8651,8153,498,5.8
27,131,Rice,2008,32609,30696,1913,5.9
27,133,Rock,2008,4927,4737,190,3.9
27,135,Roseau,2008,9526,9056,470,4.9
27,137,St. Louis,2008,104049,97480,6569,6.3
27,139,Scott,2008,74064,70397,3667,5.0
27,141,Sherburne,2008,49406,46366,3040,6.2
27,143,Sibley,2008,8617,8080,537,6.2
27,145,Stearns,2008,83201,78595,4606,5.5
27,147,Steele,2008,20720,19672,1048,5.1
27,149,Stevens,2008,5607,5346,261,4.7
27,151,Swift,2008,5204,4888,316,6.1
27,153,Todd,2008,12149,11356,793,6.5
27,155,Traverse,2008,1751,1656,95,5.4
27,157,Wabasha,2008,12041,11436,605,5.0
27,159,Wadena,2008,6482,5954,528,8.1
27,161,Waseca,2008,10455,9893,562,5.4
27,163,Washington,2008,128837,122424,6413,5.0
27,165,Watonwan,2008,5449,5095,354,6.5
27,167,Wilkin,2008,3477,3325,152,4.4
27,169,Winona,2008,28822,27450,1372,4.8
27,171,Wright,2008,67187,63100,4087,6.1
27,173,Yellow Medicine,2008,5825,5530,295,5.1
28,1,Adams,2008,13350,12468,882,6.6
28,3,Alcorn,2008,15096,13927,1169,7.7
28,5,Amite,2008,5158,4792,366,7.1
28,7,Attala,2008,7233,6578,655,9.1
28,9,Benton,2008,2856,2536,320,11.2
28,11,Bolivar,2008,15119,13820,1299,8.6
28,13,Calhoun,2008,5928,5395,533,9.0
28,15,Carroll,2008,4845,4499,346,7.1
28,17,Chickasaw,2008,7185,6402,783,10.9
28,19,Choctaw,2008,3394,3121,273,8.0
28,21,Claiborne,2008,3595,3203,392,10.9
28,23,Clarke,2008,6954,6416,538,7.7
28,25,Clay,2008,7253,6306,947,13.1
28,27,Coahoma,2008,10072,9150,922,9.2
28,29,Copiah,2008,11926,11062,864,7.2
28,31,Covington,2008,8721,8196,525,6.0
28,33,DeSoto,2008,77771,74091,3680,4.7
28,35,Forrest,2008,36495,34408,2087,5.7
28,37,Franklin,2008,3052,2820,232,7.6
28,39,George,2008,9468,8758,710,7.5
28,41,Greene,2008,4911,4460,451,9.2
28,43,Grenada,2008,9497,8791,706,7.4
28,45,Hancock,2008,18205,17178,1027,5.6
28,47,Harrison,2008,85905,81168,4737,5.5
28,49,Hinds,2008,115473,108551,6922,6.0
28,51,Holmes,2008,7078,6151,927,13.1
28,53,Humphreys,2008,4295,3874,421,9.8
28,55,Issaquena,2008,680,621,59,8.7
28,57,Itawamba,2008,9967,9156,811,8.1
28,59,Jackson,2008,60927,57380,3547,5.8
28,61,Jasper,2008,7439,6910,529,7.1
28,63,Jefferson,2008,2777,2407,370,13.3
28,65,Jefferson Davis,2008,5565,5176,389,7.0
28,67,Jones,2008,30588,28975,1613,5.3
28,69,Kemper,2008,3987,3658,329,8.3
28,71,Lafayette,2008,22014,20845,1169,5.3
28,73,Lamar,2008,23780,22654,1126,4.7
28,75,Lauderdale,2008,33206,30945,2261,6.8
28,77,Lawrence,2008,5271,4857,414,7.9
28,79,Leake,2008,8362,7792,570,6.8
28,81,Lee,2008,37456,34840,2616,7.0
28,83,Leflore,2008,13391,12197,1194,8.9
28,85,Lincoln,2008,13983,12961,1022,7.3
28,87,Lowndes,2008,25637,23663,1974,7.7
28,89,Madison,2008,45719,43354,2365,5.2
28,91,Marion,2008,10303,9573,730,7.1
28,93,Marshall,2008,15225,13981,1244,8.2
28,95,Monroe,2008,15711,14175,1536,9.8
28,97,Montgomery,2008,4448,4057,391,8.8
28,99,Neshoba,2008,13949,13195,754,5.4
28,101,Newton,2008,9354,8736,618,6.6
28,103,Noxubee,2008,3778,3258,520,13.8
28,105,Oktibbeha,2008,20248,18972,1276,6.3
28,107,Panola,2008,14570,13336,1234,8.5
28,109,Pearl River,2008,21237,19810,1427,6.7
28,111,Perry,2008,5029,4615,414,8.2
28,113,Pike,2008,15543,14447,1096,7.1
28,115,Pontotoc,2008,13128,12105,1023,7.8
28,117,Prentiss,2008,11056,10156,900,8.1
28,119,Quitman,2008,3581,3262,319,8.9
28,121,Rankin,2008,73086,70010,3076,4.2
28,123,Scott,2008,13343,12668,675,5.1
28,125,Sharkey,2008,2458,2247,211,8.6
28,127,Simpson,2008,11482,10798,684,6.0
28,129,Smith,2008,6428,6008,420,6.5
28,131,Stone,2008,7701,7249,452,5.9
28,133,Sunflower,2008,10557,9464,1093,10.4
28,135,Tallahatchie,2008,5926,5427,499,8.4
28,137,Tate,2008,11687,10893,794,6.8
28,139,Tippah,2008,8716,7835,881,10.1
28,141,Tishomingo,2008,7859,7157,702,8.9
28,143,Tunica,2008,4388,3920,468,10.7
28,145,Union,2008,11844,11007,837,7.1
28,147,Walthall,2008,5825,5402,423,7.3
28,149,Warren,2008,22321,20889,1432,6.4
28,151,Washington,2008,22119,20009,2110,9.5
28,153,Wayne,2008,8480,7837,643,7.6
28,155,Webster,2008,3383,3067,316,9.3
28,157,Wilkinson,2008,3662,3368,294,8.0
28,159,Winston,2008,7953,7352,601,7.6
28,161,Yalobusha,2008,5387,4920,467,8.7
28,163,Yazoo,2008,10031,9145,886,8.8
29,1,Adair,2008,13763,13033,730,5.3
29,3,Andrew,2008,10109,9621,488,4.8
29,5,Atchison,2008,3253,3097,156,4.8
29,7,Audrain,2008,12545,11757,788,6.3
29,9,Barry,2008,18002,17006,996,5.5
29,11,Barton,2008,5388,4882,506,9.4
29,13,Bates,2008,7954,7380,574,7.2
29,15,Benton,2008,8457,7869,588,7.0
29,17,Bollinger,2008,5654,5272,382,6.8
29,19,Boone,2008,87900,83993,3907,4.4
29,21,Buchanan,2008,49255,46666,2589,5.3
29,23,Butler,2008,22121,20740,1381,6.2
29,25,Caldwell,2008,4373,4077,296,6.8
29,27,Callaway,2008,22907,21666,1241,5.4
29,29,Camden,2008,22713,21278,1435,6.3
29,31,Cape Girardeau,2008,38914,36889,2025,5.2
29,33,Carroll,2008,5107,4742,365,7.1
29,35,Carter,2008,3006,2788,218,7.3
29,37,Cass,2008,50873,47821,3052,6.0
29,39,Cedar,2008,6533,6103,430,6.6
29,41,Chariton,2008,4027,3777,250,6.2
29,43,Christian,2008,40463,38408,2055,5.1
29,45,Clark,2008,3594,3371,223,6.2
29,47,Clay,2008,118270,112124,6146,5.2
29,49,Clinton,2008,10474,9848,626,6.0
29,51,Cole,2008,40581,38742,1839,4.5
29,53,Cooper,2008,9333,8792,541,5.8
29,55,Crawford,2008,12234,11235,999,8.2
29,57,Dade,2008,3613,3385,228,6.3
29,59,Dallas,2008,7485,6912,573,7.7
29,61,Daviess,2008,3968,3754,214,5.4
29,63,DeKalb,2008,5228,4897,331,6.3
29,65,Dent,2008,6904,6371,533,7.7
29,67,Douglas,2008,6112,5694,418,6.8
29,69,Dunklin,2008,14478,13322,1156,8.0
29,71,Franklin,2008,53509,49471,4038,7.5
29,73,Gasconade,2008,7986,7372,614,7.7
29,75,Gentry,2008,3524,3364,160,4.5
29,77,Greene,2008,141044,133817,7227,5.1
29,79,Grundy,2008,4988,4708,280,5.6
29,81,Harrison,2008,4625,4396,229,5.0
29,83,Henry,2008,11031,10286,745,6.8
29,85,Hickory,2008,3494,3154,340,9.7
29,87,Holt,2008,2792,2651,141,5.1
29,89,Howard,2008,5165,4855,310,6.0
29,91,Howell,2008,20093,18945,1148,5.7
29,93,Iron,2008,5801,5469,332,5.7
29,95,Jackson,2008,337880,314298,23582,7.0
29,97,Jasper,2008,57396,54365,3031,5.3
29,99,Jefferson,2008,117756,109627,8129,6.9
29,101,Johnson,2008,26804,25376,1428,5.3
29,103,Knox,2008,2389,2276,113,4.7
29,105,Laclede,2008,18090,16707,1383,7.6
29,107,Lafayette,2008,16571,15548,1023,6.2
29,109,Lawrence,2008,19635,18677,958,4.9
29,111,Lewis,2008,5592,5320,272,4.9
29,113,Lincoln,2008,27348,25188,2160,7.9
29,115,Linn,2008,6609,6147,462,7.0
29,117,Livingston,2008,7188,6814,374,5.2
29,119,McDonald,2008,11165,10612,553,5.0
29,121,Macon,2008,7945,7467,478,6.0
29,123,Madison,2008,6249,5864,385,6.2
29,125,Maries,2008,4846,4540,306,6.3
29,127,Marion,2008,14880,14034,846,5.7
29,129,Mercer,2008,1856,1766,90,4.8
29,131,Miller,2008,13351,12446,905,6.8
29,133,Mississippi,2008,5890,5459,431,7.3
29,135,Moniteau,2008,7508,7091,417,5.6
29,137,Monroe,2008,4397,4088,309,7.0
29,139,Montgomery,2008,6200,5751,449,7.2
29,141,Morgan,2008,9459,8740,719,7.6
29,143,New Madrid,2008,9028,8378,650,7.2
29,145,Newton,2008,27948,26388,1560,5.6
29,147,Nodaway,2008,13024,12470,554,4.3
29,149,Oregon,2008,4629,4356,273,5.9
29,151,Osage,2008,7497,7032,465,6.2
29,153,Ozark,2008,4461,4189,272,6.1
29,155,Pemiscot,2008,8353,7728,625,7.5
29,157,Perry,2008,10563,10069,494,4.7
29,159,Pettis,2008,21496,20152,1344,6.3
29,161,Phelps,2008,22485,21157,1328,5.9
29,163,Pike,2008,9319,8780,539,5.8
29,165,Platte,2008,49218,46832,2386,4.8
29,167,Polk,2008,14261,13387,874,6.1
29,169,Pulaski,2008,19907,18757,1150,5.8
29,171,Putnam,2008,2536,2398,138,5.4
29,173,Ralls,2008,5762,5451,311,5.4
29,175,Randolph,2008,13385,12563,822,6.1
29,177,Ray,2008,11472,10737,735,6.4
29,179,Reynolds,2008,2722,2520,202,7.4
29,181,Ripley,2008,6811,6348,463,6.8
29,183,St. Charles,2008,196319,185519,10800,5.5
29,185,St. Clair,2008,4304,3997,307,7.1
29,186,Ste. Genevieve,2008,10201,9595,606,5.9
29,187,St. Francois,2008,30512,28335,2177,7.1
29,189,St. Louis,2008,524683,492727,31956,6.1
29,195,Saline,2008,11612,10943,669,5.8
29,197,Schuyler,2008,2191,2049,142,6.5
29,199,Scotland,2008,2584,2411,173,6.7
29,201,Scott,2008,20098,18768,1330,6.6
29,203,Shannon,2008,3773,3473,300,8.0
29,205,Shelby,2008,3363,3183,180,5.4
29,207,Stoddard,2008,15596,14410,1186,7.6
29,209,Stone,2008,16738,15418,1320,7.9
29,211,Sullivan,2008,3553,3347,206,5.8
29,213,Taney,2008,28646,26413,2233,7.8
29,215,Texas,2008,11318,10525,793,7.0
29,217,Vernon,2008,10120,9547,573,5.7
29,219,Warren,2008,16742,15478,1264,7.5
29,221,Washington,2008,10219,9164,1055,10.3
29,223,Wayne,2008,5918,5515,403,6.8
29,225,Webster,2008,16979,16006,973,5.7
29,227,Worth,2008,1159,1095,64,5.5
29,229,Wright,2008,8310,7705,605,7.3
29,510,St. Louis city,2008,158816,146296,12520,7.9
30,1,Beaverhead,2008,5163,4968,195,3.8
30,3,Big Horn,2008,5227,4827,400,7.7
30,5,Blaine,2008,3014,2887,127,4.2
30,7,Broadwater,2008,2475,2347,128,5.2
30,9,Carbon,2008,5349,5136,213,4.0
30,11,Carter,2008,759,736,23,3.0
30,13,Cascade,2008,40661,38911,1750,4.3
30,15,Chouteau,2008,2675,2586,89,3.3
30,17,Custer,2008,5933,5701,232,3.9
30,19,Daniels,2008,808,780,28,3.5
30,21,Dawson,2008,4427,4276,151,3.4
30,23,Deer Lodge,2008,3867,3628,239,6.2
30,25,Fallon,2008,1837,1792,45,2.4
30,27,Fergus,2008,5988,5724,264,4.4
30,29,Flathead,2008,46559,43652,2907,6.2
30,31,Gallatin,2008,51233,49227,2006,3.9
30,33,Garfield,2008,662,640,22,3.3
30,35,Glacier,2008,5868,5371,497,8.5
30,37,Golden Valley,2008,583,556,27,4.6
30,39,Granite,2008,1298,1217,81,6.2
30,41,Hill,2008,8283,7896,387,4.7
30,43,Jefferson,2008,6035,5777,258,4.3
30,45,Judith Basin,2008,1115,1070,45,4.0
30,47,Lake,2008,11727,10907,820,7.0
30,49,Lewis and Clark,2008,34333,33014,1319,3.8
30,51,Liberty,2008,781,751,30,3.8
30,53,Lincoln,2008,7863,7073,790,10.0
30,55,McCone,2008,1039,1012,27,2.6
30,57,Madison,2008,4580,4401,179,3.9
30,59,Meagher,2008,895,837,58,6.5
30,61,Mineral,2008,1904,1777,127,6.7
30,63,Missoula,2008,59465,56708,2757,4.6
30,65,Musselshell,2008,2168,2050,118,5.4
30,67,Park,2008,9087,8642,445,4.9
30,69,Petroleum,2008,251,238,13,5.2
30,71,Phillips,2008,2199,2095,104,4.7
30,73,Pondera,2008,2642,2507,135,5.1
30,75,Powder River,2008,956,925,31,3.2
30,77,Powell,2008,2767,2570,197,7.1
30,79,Prairie,2008,598,575,23,3.8
30,81,Ravalli,2008,18887,17737,1150,6.1
30,83,Richland,2008,5608,5443,165,2.9
30,85,Roosevelt,2008,3995,3722,273,6.8
30,87,Rosebud,2008,4066,3828,238,5.9
30,89,Sanders,2008,4696,4240,456,9.7
30,91,Sheridan,2008,1855,1801,54,2.9
30,93,Silver Bow,2008,17946,17141,805,4.5
30,95,Stillwater,2008,4645,4454,191,4.1
30,97,Sweet Grass,2008,2900,2827,73,2.5
30,99,Teton,2008,3134,3011,123,3.9
30,101,Toole,2008,2621,2541,80,3.1
30,103,Treasure,2008,409,393,16,3.9
30,105,Valley,2008,3680,3534,146,4.0
30,107,Wheatland,2008,1105,1063,42,3.8
30,109,Wibaux,2008,536,519,17,3.2
30,111,Yellowstone,2008,83121,80215,2906,3.5
31,1,Adams,2008,17669,17140,529,3.0
31,3,Antelope,2008,3641,3535,106,2.9
31,5,Arthur,2008,242,233,9,3.7
31,7,Banner,2008,401,391,10,2.5
31,9,Blaine,2008,243,231,12,4.9
31,11,Boone,2008,3249,3166,83,2.6
31,13,Box Butte,2008,5617,5413,204,3.6
31,15,Boyd,2008,1107,1072,35,3.2
31,17,Brown,2008,1844,1796,48,2.6
31,19,Buffalo,2008,27820,27142,678,2.4
31,21,Burt,2008,3952,3791,161,4.1
31,23,Butler,2008,4901,4763,138,2.8
31,25,Cass,2008,13956,13452,504,3.6
31,27,Cedar,2008,4818,4700,118,2.4
31,29,Chase,2008,1987,1936,51,2.6
31,31,Cherry,2008,3396,3318,78,2.3
31,33,Cheyenne,2008,5227,5083,144,2.8
31,35,Clay,2008,3112,3015,97,3.1
31,37,Colfax,2008,5616,5472,144,2.6
31,39,Cuming,2008,4927,4787,140,2.8
31,41,Custer,2008,6048,5906,142,2.3
31,43,Dakota,2008,10975,10530,445,4.1
31,45,Dawes,2008,4817,4679,138,2.9
31,47,Dawson,2008,12432,11944,488,3.9
31,49,Deuel,2008,1052,1022,30,2.9
31,51,Dixon,2008,3374,3269,105,3.1
31,53,Dodge,2008,19960,19280,680,3.4
31,55,Douglas,2008,273568,263715,9853,3.6
31,57,Dundy,2008,1033,1004,29,2.8
31,59,Fillmore,2008,3174,3082,92,2.9
31,61,Franklin,2008,1773,1721,52,2.9
31,63,Frontier,2008,1625,1581,44,2.7
31,65,Furnas,2008,2512,2440,72,2.9
31,67,Gage,2008,12202,11645,557,4.6
31,69,Garden,2008,947,919,28,3.0
31,71,Garfield,2008,1051,1025,26,2.5
31,73,Gosper,2008,1020,988,32,3.1
31,75,Grant,2008,373,362,11,2.9
31,77,Greeley,2008,1301,1264,37,2.8
31,79,Hall,2008,31672,30710,962,3.0
31,81,Hamilton,2008,5871,5732,139,2.4
31,83,Harlan,2008,1838,1783,55,3.0
31,85,Hayes,2008,476,459,17,3.6
31,87,Hitchcock,2008,1469,1420,49,3.3
31,89,Holt,2008,6125,5964,161,2.6
31,91,Hooker,2008,414,396,18,4.3
31,93,Howard,2008,3730,3619,111,3.0
31,95,Jefferson,2008,4311,4149,162,3.8
31,97,Johnson,2008,2932,2841,91,3.1
31,99,Kearney,2008,3685,3587,98,2.7
31,101,Keith,2008,4541,4415,126,2.8
31,103,Keya Paha,2008,375,357,18,4.8
31,105,Kimball,2008,1937,1873,64,3.3
31,107,Knox,2008,4656,4512,144,3.1
31,109,Lancaster,2008,159498,154744,4754,3.0
31,111,Lincoln,2008,21934,21303,631,2.9
31,113,Logan,2008,463,454,9,1.9
31,115,Loup,2008,339,326,13,3.8
31,117,McPherson,2008,310,303,7,2.3
31,119,Madison,2008,18812,18204,608,3.2
31,121,Merrick,2008,4214,4086,128,3.0
31,123,Morrill,2008,2876,2788,88,3.1
31,125,Nance,2008,2051,1992,59,2.9
31,127,Nemaha,2008,3406,3252,154,4.5
31,129,Nuckolls,2008,2249,2185,64,2.8
31,131,Otoe,2008,9050,8740,310,3.4
31,133,Pawnee,2008,1562,1511,51,3.3
31,135,Perkins,2008,1672,1633,39,2.3
31,137,Phelps,2008,5141,5020,121,2.4
31,139,Pierce,2008,3931,3817,114,2.9
31,141,Platte,2008,18359,17830,529,2.9
31,143,Polk,2008,3027,2944,83,2.7
31,145,Red Willow,2008,6007,5838,169,2.8
31,147,Richardson,2008,4208,4027,181,4.3
31,149,Rock,2008,845,822,23,2.7
31,151,Saline,2008,8382,8104,278,3.3
31,153,Sarpy,2008,79074,76584,2490,3.1
31,155,Saunders,2008,10943,10560,383,3.5
31,157,Scotts Bluff,2008,19480,18777,703,3.6
31,159,Seward,2008,9048,8762,286,3.2
31,161,Sheridan,2008,3055,2973,82,2.7
31,163,Sherman,2008,1932,1880,52,2.7
31,165,Sioux,2008,714,691,23,3.2
31,167,Stanton,2008,3506,3411,95,2.7
31,169,Thayer,2008,2814,2725,89,3.2
31,171,Thomas,2008,372,358,14,3.8
31,173,Thurston,2008,2985,2789,196,6.6
31,175,Valley,2008,2571,2501,70,2.7
31,177,Washington,2008,11231,10888,343,3.1
31,179,Wayne,2008,5191,5045,146,2.8
31,181,Webster,2008,1787,1728,59,3.3
31,183,Wheeler,2008,486,475,11,2.3
31,185,York,2008,7034,6780,254,3.6
32,1,Churchill,2008,13584,12753,831,6.1
32,3,Clark,2008,987088,919898,67190,6.8
32,5,Douglas,2008,22781,21056,1725,7.6
32,7,Elko,2008,26911,25738,1173,4.4
32,9,Esmeralda,2008,490,465,25,5.1
32,11,Eureka,2008,859,814,45,5.2
32,13,Humboldt,2008,8210,7795,415,5.1
32,15,Lander,2008,3669,3505,164,4.5
32,17,Lincoln,2008,1846,1741,105,5.7
32,19,Lyon,2008,22800,20517,2283,10.0
32,21,Mineral,2008,2409,2225,184,7.6
32,23,Nye,2008,17760,15990,1770,10.0
32,27,Pershing,2008,2538,2356,182,7.2
32,29,Storey,2008,2480,2304,176,7.1
32,31,Washoe,2008,225931,210215,15716,7.0
32,33,White Pine,2008,4823,4591,232,4.8
32,510,Carson City,2008,28927,26826,2101,7.3
33,1,Belknap,2008,32646,31354,1292,4.0
33,3,Carroll,2008,25915,25014,901,3.5
33,5,Cheshire,2008,42158,40665,1493,3.5
33,7,Coos,2008,16500,15674,826,5.0
33,9,Grafton,2008,48810,47321,1489,3.1
33,11,Hillsborough,2008,229028,220458,8570,3.7
33,13,Merrimack,2008,81113,78250,2863,3.5
33,15,Rockingham,2008,174279,167104,7175,4.1
33,17,Strafford,2008,69689,67240,2449,3.5
33,19,Sullivan,2008,22756,22008,748,3.3
34,1,Atlantic,2008,135516,126103,9413,6.9
34,3,Bergen,2008,477222,455885,21337,4.5
34,5,Burlington,2008,238994,227028,11966,5.0
34,7,Camden,2008,266721,250683,16038,6.0
34,9,Cape May,2008,56464,51937,4527,8.0
34,11,Cumberland,2008,68949,63425,5524,8.0
34,13,Essex,2008,364912,340984,23928,6.6
34,15,Gloucester,2008,156276,147822,8454,5.4
34,17,Hudson,2008,293535,274966,18569,6.3
34,19,Hunterdon,2008,72804,70054,2750,3.8
34,21,Mercer,2008,201705,191976,9729,4.8
34,23,Middlesex,2008,424692,403436,21256,5.0
34,25,Monmouth,2008,334387,318165,16222,4.9
34,27,Morris,2008,274808,263856,10952,4.0
34,29,Ocean,2008,261271,245781,15490,5.9
34,31,Passaic,2008,240108,223873,16235,6.8
34,33,Salem,2008,31530,29564,1966,6.2
34,35,Somerset,2008,181200,173810,7390,4.1
34,37,Sussex,2008,85034,80763,4271,5.0
34,39,Union,2008,270753,255251,15502,5.7
34,41,Warren,2008,59059,56096,2963,5.0
35,1,Bernalillo,2008,309849,296852,12997,4.2
35,3,Catron,2008,1518,1440,78,5.1
35,5,Chaves,2008,26526,25420,1106,4.2
35,6,Cibola,2008,12215,11672,543,4.4
35,7,Colfax,2008,6546,6270,276,4.2
35,9,Curry,2008,20785,20154,631,3.0
35,11,De Baca,2008,797,766,31,3.9
35,13,Dona Ana,2008,87857,83858,3999,4.6
35,15,Eddy,2008,27012,26222,790,2.9
35,17,Grant,2008,12227,11647,580,4.7
35,19,Guadalupe,2008,1706,1605,101,5.9
35,21,Harding,2008,393,382,11,2.8
35,23,Hidalgo,2008,2590,2483,107,4.1
35,25,Lea,2008,28960,28165,795,2.7
35,27,Lincoln,2008,10925,10553,372,3.4
35,28,Los Alamos,2008,9889,9604,285,2.9
35,29,Luna,2008,12148,10732,1416,11.7
35,31,McKinley,2008,26348,24947,1401,5.3
35,33,Mora,2008,1999,1834,165,8.3
35,35,Otero,2008,25590,24512,1078,4.2
35,37,Quay,2008,3881,3697,184,4.7
35,39,Rio Arriba,2008,20230,19170,1060,5.2
35,41,Roosevelt,2008,9371,9090,281,3.0
35,43,Sandoval,2008,55150,52388,2762,5.0
35,45,San Juan,2008,56467,54331,2136,3.8
35,47,San Miguel,2008,13158,12532,626,4.8
35,49,Santa Fe,2008,77291,74506,2785,3.6
35,51,Sierra,2008,5826,5599,227,3.9
35,53,Socorro,2008,9407,9085,322,3.4
35,55,Taos,2008,17435,16519,916,5.3
35,57,Torrance,2008,6833,6468,365,5.3
35,59,Union,2008,1928,1874,54,2.8
35,61,Valencia,2008,30773,29269,1504,4.9
36,1,Albany,2008,159330,151681,7649,4.8
36,3,Allegany,2008,23933,22419,1514,6.3
36,5,Bronx,2008,526398,486813,39585,7.5
36,7,Broome,2008,97404,92038,5366,5.5
36,9,Cattaraugus,2008,41440,38946,2494,6.0
36,11,Cayuga,2008,41480,39204,2276,5.5
36,13,Chautauqua,2008,66804,63143,3661,5.5
36,15,Chemung,2008,41141,38872,2269,5.5
36,17,Chenango,2008,24478,22941,1537,6.3
36,19,Clinton,2008,39673,37106,2567,6.5
36,21,Columbia,2008,31638,30128,1510,4.8
36,23,Cortland,2008,23979,22464,1515,6.3
36,25,Delaware,2008,22739,21398,1341,5.9
36,27,Dutchess,2008,145570,138199,7371,5.1
36,29,Erie,2008,469884,443377,26507,5.6
36,31,Essex,2008,18470,17253,1217,6.6
36,33,Franklin,2008,22872,21312,1560,6.8
36,35,Fulton,2008,27447,25626,1821,6.6
36,37,Genesee,2008,33281,31435,1846,5.5
36,39,Greene,2008,24181,22777,1404,5.8
36,41,Hamilton,2008,3054,2866,188,6.2
36,43,Herkimer,2008,31065,29192,1873,6.0
36,45,Jefferson,2008,48885,45589,3296,6.7
36,47,Kings,2008,1111934,1045310,66624,6.0
36,49,Lewis,2008,12537,11712,825,6.6
36,51,Livingston,2008,32275,30379,1896,5.9
36,53,Madison,2008,36222,34168,2054,5.7
36,55,Monroe,2008,375178,354893,20285,5.4
36,57,Montgomery,2008,24622,22902,1720,7.0
36,59,Nassau,2008,695385,662814,32571,4.7
36,61,New York,2008,936462,890733,45729,4.9
36,63,Niagara,2008,113118,105618,7500,6.6
36,65,Oneida,2008,110436,104554,5882,5.3
36,67,Onondaga,2008,233793,221809,11984,5.1
36,69,Ontario,2008,56544,53662,2882,5.1
36,71,Orange,2008,180142,170568,9574,5.3
36,73,Orleans,2008,19419,18086,1333,6.9
36,75,Oswego,2008,60047,55918,4129,6.9
36,77,Otsego,2008,31457,29689,1768,5.6
36,79,Putnam,2008,55642,53204,2438,4.4
36,81,Queens,2008,1126326,1070035,56291,5.0
36,83,Rensselaer,2008,83684,79411,4273,5.1
36,85,Richmond,2008,245424,232990,12434,5.1
36,87,Rockland,2008,155013,147721,7292,4.7
36,89,St. Lawrence,2008,49885,46391,3494,7.0
36,91,Saratoga,2008,120995,115542,5453,4.5
36,93,Schenectady,2008,76416,72573,3843,5.0
36,95,Schoharie,2008,15786,14717,1069,6.8
36,97,Schuyler,2008,10078,9501,577,5.7
36,99,Seneca,2008,17052,16123,929,5.4
36,101,Steuben,2008,45565,42828,2737,6.0
36,103,Suffolk,2008,793907,754554,39353,5.0
36,105,Sullivan,2008,35380,33103,2277,6.4
36,107,Tioga,2008,26164,24797,1367,5.2
36,109,Tompkins,2008,55800,53517,2283,4.1
36,111,Ulster,2008,90018,85167,4851,5.4
36,113,Warren,2008,36405,34380,2025,5.6
36,115,Washington,2008,32596,30879,1717,5.3
36,117,Wayne,2008,47814,45050,2764,5.8
36,119,Westchester,2008,492072,468768,23304,4.7
36,121,Wyoming,2008,21224,19921,1303,6.1
36,123,Yates,2008,13140,12505,635,4.8
37,1,Alamance,2008,71473,66884,4589,6.4
37,3,Alexander,2008,18289,17006,1283,7.0
37,5,Alleghany,2008,4569,4226,343,7.5
37,7,Anson,2008,10295,9381,914,8.9
37,9,Ashe,2008,12605,11751,854,6.8
37,11,Avery,2008,8863,8354,509,5.7
37,13,Beaufort,2008,20829,19336,1493,7.2
37,15,Bertie,2008,8731,8064,667,7.6
37,17,Bladen,2008,15510,14307,1203,7.8
37,19,Brunswick,2008,50139,46940,3199,6.4
37,21,Buncombe,2008,122757,116987,5770,4.7
37,23,Burke,2008,40462,37161,3301,8.2
37,25,Cabarrus,2008,85255,80371,4884,5.7
37,27,Caldwell,2008,38311,35332,2979,7.8
37,29,Camden,2008,4559,4312,247,5.4
37,31,Carteret,2008,32879,31109,1770,5.4
37,33,Caswell,2008,10793,9922,871,8.1
37,35,Catawba,2008,77036,71548,5488,7.1
37,37,Chatham,2008,33898,32226,1672,4.9
37,39,Cherokee,2008,10021,9099,922,9.2
37,41,Chowan,2008,6721,6137,584,8.7
37,43,Clay,2008,4678,4376,302,6.5
37,45,Cleveland,2008,49045,45002,4043,8.2
37,47,Columbus,2008,24252,22371,1881,7.8
37,49,Craven,2008,42264,39745,2519,6.0
37,51,Cumberland,2008,133744,125512,8232,6.2
37,53,Currituck,2008,12847,12280,567,4.4
37,55,Dare,2008,22102,20671,1431,6.5
37,57,Davidson,2008,78037,72485,5552,7.1
37,59,Davie,2008,21035,19762,1273,6.1
37,61,Duplin,2008,24122,22720,1402,5.8
37,63,Durham,2008,141862,135129,6733,4.7
37,65,Edgecombe,2008,24605,22101,2504,10.2
37,67,Forsyth,2008,177654,167604,10050,5.7
37,69,Franklin,2008,27856,26115,1741,6.3
37,71,Gaston,2008,100046,92453,7593,7.6
37,73,Gates,2008,4873,4613,260,5.3
37,75,Graham,2008,4392,3920,472,10.7
37,77,Granville,2008,25541,23825,1716,6.7
37,79,Greene,2008,9299,8686,613,6.6
37,81,Guilford,2008,251557,236423,15134,6.0
37,83,Halifax,2008,23899,21751,2148,9.0
37,85,Harnett,2008,48082,44901,3181,6.6
37,87,Haywood,2008,27927,26357,1570,5.6
37,89,Henderson,2008,49735,47385,2350,4.7
37,91,Hertford,2008,9852,9196,656,6.7
37,93,Hoke,2008,19778,18649,1129,5.7
37,95,Hyde,2008,2686,2498,188,7.0
37,97,Iredell,2008,79170,74098,5072,6.4
37,99,Jackson,2008,21044,19978,1066,5.1
37,101,Johnston,2008,78100,73650,4450,5.7
37,103,Jones,2008,4716,4412,304,6.4
37,105,Lee,2008,25906,23945,1961,7.6
37,107,Lenoir,2008,27118,25161,1957,7.2
37,109,Lincoln,2008,39507,36641,2866,7.3
37,111,McDowell,2008,20887,19170,1717,8.2
37,113,Macon,2008,16353,15378,975,6.0
37,115,Madison,2008,10058,9487,571,5.7
37,117,Martin,2008,11939,11165,774,6.5
37,119,Mecklenburg,2008,468852,440764,28088,6.0
37,121,Mitchell,2008,7118,6542,576,8.1
37,123,Montgomery,2008,11350,10418,932,8.2
37,125,Moore,2008,36517,34272,2245,6.1
37,127,Nash,2008,47077,43578,3499,7.4
37,129,New Hanover,2008,105861,100365,5496,5.2
37,131,Northampton,2008,8705,8028,677,7.8
37,133,Onslow,2008,63263,59670,3593,5.7
37,135,Orange,2008,69998,67186,2812,4.0
37,137,Pamlico,2008,5436,5110,326,6.0
37,139,Pasquotank,2008,18028,16787,1241,6.9
37,141,Pender,2008,24480,22993,1487,6.1
37,143,Perquimans,2008,5321,4959,362,6.8
37,145,Person,2008,19096,17708,1388,7.3
37,147,Pitt,2008,81320,76059,5261,6.5
37,149,Polk,2008,9575,9112,463,4.8
37,151,Randolph,2008,75365,70565,4800,6.4
37,153,Richmond,2008,20196,18325,1871,9.3
37,155,Robeson,2008,56158,51685,4473,8.0
37,157,Rockingham,2008,44691,41340,3351,7.5
37,159,Rowan,2008,70252,65471,4781,6.8
37,161,Rutherford,2008,29789,27385,2404,8.1
37,163,Sampson,2008,32497,30749,1748,5.4
37,165,Scotland,2008,13950,12416,1534,11.0
37,167,Stanly,2008,30211,28236,1975,6.5
37,169,Stokes,2008,24185,22769,1416,5.9
37,171,Surry,2008,34275,31602,2673,7.8
37,173,Swain,2008,6967,6415,552,7.9
37,175,Transylvania,2008,13398,12709,689,5.1
37,177,Tyrrell,2008,2214,2056,158,7.1
37,179,Union,2008,95972,90687,5285,5.5
37,181,Vance,2008,19605,17865,1740,8.9
37,183,Wake,2008,457854,436760,21094,4.6
37,185,Warren,2008,7798,7141,657,8.4
37,187,Washington,2008,6172,5697,475,7.7
37,189,Watauga,2008,23089,21992,1097,4.8
37,191,Wayne,2008,53725,50627,3098,5.8
37,193,Wilkes,2008,30264,27990,2274,7.5
37,195,Wilson,2008,40096,36996,3100,7.7
37,197,Yadkin,2008,19404,18311,1093,5.6
37,199,Yancey,2008,7794,7198,596,7.6
38,1,Adams,2008,1262,1233,29,2.3
38,3,Barnes,2008,6289,6110,179,2.8
38,5,Benson,2008,2643,2478,165,6.2
38,7,Billings,2008,526,515,11,2.1
38,9,Bottineau,2008,3610,3496,114,3.2
38,11,Bowman,2008,1741,1705,36,2.1
38,13,Burke,2008,1062,1037,25,2.4
38,15,Burleigh,2008,47525,46241,1284,2.7
38,17,Cass,2008,89135,86787,2348,2.6
38,19,Cavalier,2008,2042,1980,62,3.0
38,21,Dickey,2008,2925,2839,86,2.9
38,23,Divide,2008,890,862,28,3.1
38,25,Dunn,2008,1757,1702,55,3.1
38,27,Eddy,2008,1250,1182,68,5.4
38,29,Emmons,2008,1688,1608,80,4.7
38,31,Foster,2008,1773,1721,52,2.9
38,33,Golden Valley,2008,870,847,23,2.6
38,35,Grand Forks,2008,39036,37896,1140,2.9
38,37,Grant,2008,1202,1154,48,4.0
38,39,Griggs,2008,1279,1248,31,2.4
38,41,Hettinger,2008,1124,1086,38,3.4
38,43,Kidder,2008,1245,1195,50,4.0
38,45,LaMoure,2008,2244,2172,72,3.2
38,47,Logan,2008,926,894,32,3.5
38,49,McHenry,2008,2738,2602,136,5.0
38,51,McIntosh,2008,1396,1357,39,2.8
38,53,McKenzie,2008,3119,3046,73,2.3
38,55,McLean,2008,4843,4630,213,4.4
38,57,Mercer,2008,4850,4634,216,4.5
38,59,Morton,2008,15034,14524,510,3.4
38,61,Mountrail,2008,2995,2873,122,4.1
38,63,Nelson,2008,1736,1680,56,3.2
38,65,Oliver,2008,1151,1100,51,4.4
38,67,Pembina,2008,3946,3746,200,5.1
38,69,Pierce,2008,1937,1855,82,4.2
38,71,Ramsey,2008,5852,5638,214,3.7
38,73,Ransom,2008,3100,2992,108,3.5
38,75,Renville,2008,1266,1234,32,2.5
38,77,Richland,2008,8985,8645,340,3.8
38,79,Rolette,2008,5016,4549,467,9.3
38,81,Sargent,2008,2235,2134,101,4.5
38,83,Sheridan,2008,646,620,26,4.0
38,85,Sioux,2008,1308,1241,67,5.1
38,87,Slope,2008,763,753,10,1.3
38,89,Stark,2008,14349,14021,328,2.3
38,91,Steele,2008,1172,1147,25,2.1
38,93,Stutsman,2008,11776,11441,335,2.8
38,95,Towner,2008,1112,1077,35,3.1
38,97,Traill,2008,4176,4042,134,3.2
38,99,Walsh,2008,5696,5455,241,4.2
38,101,Ward,2008,29785,28931,854,2.9
38,103,Wells,2008,2116,2026,90,4.3
38,105,Williams,2008,14715,14471,244,1.7
39,1,Adams,2008,13310,12055,1255,9.4
39,3,Allen,2008,52109,48211,3898,7.5
39,5,Ashland,2008,27439,25366,2073,7.6
39,7,Ashtabula,2008,49457,45446,4011,8.1
39,9,Athens,2008,31055,28955,2100,6.8
39,11,Auglaize,2008,27106,25610,1496,5.5
39,13,Belmont,2008,33583,31509,2074,6.2
39,15,Brown,2008,21957,20260,1697,7.7
39,17,Butler,2008,192762,181221,11541,6.0
39,19,Carroll,2008,14072,12987,1085,7.7
39,21,Champaign,2008,20666,19209,1457,7.1
39,23,Clark,2008,71712,66858,4854,6.8
39,25,Clermont,2008,107496,101079,6417,6.0
39,27,Clinton,2008,23619,22173,1446,6.1
39,29,Columbiana,2008,53408,49489,3919,7.3
39,31,Coshocton,2008,17333,15827,1506,8.7
39,33,Crawford,2008,22121,20179,1942,8.8
39,35,Cuyahoga,2008,640260,599162,41098,6.4
39,37,Darke,2008,28175,26335,1840,6.5
39,39,Defiance,2008,20836,19254,1582,7.6
39,41,Delaware,2008,92961,88582,4379,4.7
39,43,Erie,2008,43054,39867,3187,7.4
39,45,Fairfield,2008,76204,71781,4423,5.8
39,47,Fayette,2008,17101,16110,991,5.8
39,49,Franklin,2008,630495,595188,35307,5.6
39,51,Fulton,2008,23419,21484,1935,8.3
39,53,Gallia,2008,14261,13313,948,6.6
39,55,Geauga,2008,50855,48233,2622,5.2
39,57,Greene,2008,81732,76600,5132,6.3
39,59,Guernsey,2008,19772,18048,1724,8.7
39,61,Hamilton,2008,442854,417423,25431,5.7
39,63,Hancock,2008,41226,38764,2462,6.0
39,65,Hardin,2008,15169,14063,1106,7.3
39,67,Harrison,2008,7407,6867,540,7.3
39,69,Henry,2008,15841,14564,1277,8.1
39,71,Highland,2008,20841,19275,1566,7.5
39,73,Hocking,2008,14359,13249,1110,7.7
39,75,Holmes,2008,19595,18619,976,5.0
39,77,Huron,2008,29300,26395,2905,9.9
39,79,Jackson,2008,15407,14082,1325,8.6
39,81,Jefferson,2008,33155,30788,2367,7.1
39,83,Knox,2008,30469,28485,1984,6.5
39,85,Lake,2008,132518,125252,7266,5.5
39,87,Lawrence,2008,29659,28018,1641,5.5
39,89,Licking,2008,84436,79126,5310,6.3
39,91,Logan,2008,25526,23965,1561,6.1
39,93,Lorain,2008,159121,148648,10473,6.6
39,95,Lucas,2008,224344,205605,18739,8.4
39,97,Madison,2008,20383,19099,1284,6.3
39,99,Mahoning,2008,116879,108411,8468,7.2
39,101,Marion,2008,32851,30518,2333,7.1
39,103,Medina,2008,95654,90426,5228,5.5
39,105,Meigs,2008,9230,8291,939,10.2
39,107,Mercer,2008,24930,23686,1244,5.0
39,109,Miami,2008,55140,51557,3583,6.5
39,111,Monroe,2008,5764,5264,500,8.7
39,113,Montgomery,2008,269680,249261,20419,7.6
39,115,Morgan,2008,5865,5257,608,10.4
39,117,Morrow,2008,18133,16835,1298,7.2
39,119,Muskingum,2008,38758,35360,3398,8.8
39,121,Noble,2008,5889,5379,510,8.7
39,123,Ottawa,2008,21730,19789,1941,8.9
39,125,Paulding,2008,10889,10102,787,7.2
39,127,Perry,2008,16534,15107,1427,8.6
39,129,Pickaway,2008,25036,23230,1806,7.2
39,131,Pike,2008,10961,9833,1128,10.3
39,133,Portage,2008,93712,87763,5949,6.3
39,135,Preble,2008,21616,20098,1518,7.0
39,137,Putnam,2008,18611,17521,1090,5.9
39,139,Richland,2008,62920,58178,4742,7.5
39,141,Ross,2008,35005,32188,2817,8.0
39,143,Sandusky,2008,33621,31166,2455,7.3
39,145,Scioto,2008,32830,30052,2778,8.5
39,147,Seneca,2008,30762,28561,2201,7.2
39,149,Shelby,2008,27854,26105,1749,6.3
39,151,Stark,2008,193755,180468,13287,6.9
39,153,Summit,2008,300963,282208,18755,6.2
39,155,Trumbull,2008,106548,98440,8108,7.6
39,157,Tuscarawas,2008,48266,45208,3058,6.3
39,159,Union,2008,26126,24742,1384,5.3
39,161,Van Wert,2008,15552,14213,1339,8.6
39,163,Vinton,2008,5774,5236,538,9.3
39,165,Warren,2008,110207,104056,6151,5.6
39,167,Washington,2008,33355,31500,1855,5.6
39,169,Wayne,2008,59957,56491,3466,5.8
39,171,Williams,2008,20086,18518,1568,7.8
39,173,Wood,2008,69535,64775,4760,6.8
39,175,Wyandot,2008,11558,10634,924,8.0
40,1,Adair,2008,10809,10299,510,4.7
40,3,Alfalfa,2008,2471,2398,73,3.0
40,5,Atoka,2008,6024,5757,267,4.4
40,7,Beaver,2008,3255,3191,64,2.0
40,9,Beckham,2008,12443,12167,276,2.2
40,11,Blaine,2008,4980,4806,174,3.5
40,13,Bryan,2008,20280,19609,671,3.3
40,15,Caddo,2008,12439,11954,485,3.9
40,17,Canadian,2008,51912,50220,1692,3.3
40,19,Carter,2008,26698,25868,830,3.1
40,21,Cherokee,2008,22845,22012,833,3.6
40,23,Choctaw,2008,6888,6550,338,4.9
40,25,Cimarron,2008,1247,1211,36,2.9
40,27,Cleveland,2008,118871,114971,3900,3.3
40,29,Coal,2008,2484,2368,116,4.7
40,31,Comanche,2008,45757,44084,1673,3.7
40,33,Cotton,2008,3882,3778,104,2.7
40,35,Craig,2008,7402,7130,272,3.7
40,37,Creek,2008,31109,29842,1267,4.1
40,39,Custer,2008,14713,14338,375,2.5
40,41,Delaware,2008,18859,18102,757,4.0
40,43,Dewey,2008,2631,2571,60,2.3
40,45,Ellis,2008,2532,2479,53,2.1
40,47,Garfield,2008,31442,30668,774,2.5
40,49,Garvin,2008,14831,14401,430,2.9
40,51,Grady,2008,22812,21944,868,3.8
40,53,Grant,2008,2595,2533,62,2.4
40,55,Greer,2008,2032,1947,85,4.2
40,57,Harmon,2008,1330,1287,43,3.2
40,59,Harper,2008,2039,1995,44,2.2
40,61,Haskell,2008,5943,5729,214,3.6
40,63,Hughes,2008,5074,4812,262,5.2
40,65,Jackson,2008,12323,11946,377,3.1
40,67,Jefferson,2008,2391,2294,97,4.1
40,69,Johnston,2008,5159,4946,213,4.1
40,71,Kay,2008,23842,23040,802,3.4
40,73,Kingfisher,2008,8507,8316,191,2.2
40,75,Kiowa,2008,4024,3878,146,3.6
40,77,Latimer,2008,4676,4482,194,4.1
40,79,Le Flore,2008,20780,19735,1045,5.0
40,81,Lincoln,2008,13790,13264,526,3.8
40,83,Logan,2008,17679,17069,610,3.5
40,85,Love,2008,5296,5149,147,2.8
40,87,McClain,2008,14908,14390,518,3.5
40,89,McCurtain,2008,14070,13173,897,6.4
40,91,McIntosh,2008,8561,8167,394,4.6
40,93,Major,2008,4284,4188,96,2.2
40,95,Marshall,2008,6539,6285,254,3.9
40,97,Mayes,2008,18479,17729,750,4.1
40,99,Murray,2008,8503,8286,217,2.6
40,101,Muskogee,2008,29616,28273,1343,4.5
40,103,Noble,2008,5741,5562,179,3.1
40,105,Nowata,2008,5010,4804,206,4.1
40,107,Okfuskee,2008,4581,4398,183,4.0
40,109,Oklahoma,2008,323063,310909,12154,3.8
40,111,Okmulgee,2008,15894,15093,801,5.0
40,113,Osage,2008,20027,19228,799,4.0
40,115,Ottawa,2008,17771,17053,718,4.0
40,117,Pawnee,2008,7270,6958,312,4.3
40,119,Payne,2008,34953,33634,1319,3.8
40,121,Pittsburg,2008,23785,23053,732,3.1
40,123,Pontotoc,2008,20234,19621,613,3.0
40,125,Pottawatomie,2008,32895,31679,1216,3.7
40,127,Pushmataha,2008,5234,4992,242,4.6
40,129,Roger Mills,2008,1938,1895,43,2.2
40,131,Rogers,2008,40118,38769,1349,3.4
40,133,Seminole,2008,10995,10522,473,4.3
40,135,Sequoyah,2008,17621,16620,1001,5.7
40,137,Stephens,2008,22133,21401,732,3.3
40,139,Texas,2008,9725,9471,254,2.6
40,141,Tillman,2008,3509,3372,137,3.9
40,143,Tulsa,2008,292805,282707,10098,3.4
40,145,Wagoner,2008,33161,32014,1147,3.5
40,147,Washington,2008,27346,26547,799,2.9
40,149,Washita,2008,6123,5965,158,2.6
40,151,Woods,2008,4331,4214,117,2.7
40,153,Woodward,2008,12572,12302,270,2.1
41,1,Baker,2008,7407,6902,505,6.8
41,3,Benton,2008,42950,41029,1921,4.5
41,5,Clackamas,2008,199400,188533,10867,5.4
41,7,Clatsop,2008,20297,19281,1016,5.0
41,9,Columbia,2008,24088,22454,1634,6.8
41,11,Coos,2008,27955,25742,2213,7.9
41,13,Crook,2008,9740,8816,924,9.5
41,15,Curry,2008,9468,8736,732,7.7
41,17,Deschutes,2008,81331,74972,6359,7.8
41,19,Douglas,2008,46269,41886,4383,9.5
41,21,Gilliam,2008,1197,1147,50,4.2
41,23,Grant,2008,3358,3018,340,10.1
41,25,Harney,2008,3331,3028,303,9.1
41,27,Hood River,2008,13305,12622,683,5.1
41,29,Jackson,2008,101393,93717,7676,7.6
41,31,Jefferson,2008,9296,8402,894,9.6
41,33,Josephine,2008,34791,31732,3059,8.8
41,35,Klamath,2008,30692,28003,2689,8.8
41,37,Lake,2008,3566,3271,295,8.3
41,39,Lane,2008,183059,171294,11765,6.4
41,41,Lincoln,2008,22748,21314,1434,6.3
41,43,Linn,2008,54956,50878,4078,7.4
41,45,Malheur,2008,12699,11787,912,7.2
41,47,Marion,2008,154692,144909,9783,6.3
41,49,Morrow,2008,5424,5094,330,6.1
41,51,Multnomah,2008,386798,365102,21696,5.6
41,53,Polk,2008,39552,37423,2129,5.4
41,55,Sherman,2008,970,916,54,5.6
41,57,Tillamook,2008,12555,11897,658,5.2
41,59,Umatilla,2008,37474,35125,2349,6.3
41,61,Union,2008,12256,11309,947,7.7
41,63,Wallowa,2008,3654,3389,265,7.3
41,65,Wasco,2008,13283,12513,770,5.8
41,67,Washington,2008,288292,273704,14588,5.1
41,69,Wheeler,2008,614,579,35,5.7
41,71,Yamhill,2008,47684,44735,2949,6.2
42,1,Adams,2008,56295,53856,2439,4.3
42,3,Allegheny,2008,642211,611134,31077,4.8
42,5,Armstrong,2008,33345,31364,1981,5.9
42,7,Beaver,2008,90386,85414,4972,5.5
42,9,Bedford,2008,24425,22753,1672,6.8
42,11,Berks,2008,206125,195056,11069,5.4
42,13,Blair,2008,65455,62047,3408,5.2
42,15,Bradford,2008,31090,29447,1643,5.3
42,17,Bucks,2008,352807,336113,16694,4.7
42,19,Butler,2008,99053,94437,4616,4.7
42,21,Cambria,2008,69457,65176,4281,6.2
42,23,Cameron,2008,2531,2303,228,9.0
42,25,Carbon,2008,31547,29413,2134,6.8
42,27,Centre,2008,75397,72142,3255,4.3
42,29,Chester,2008,273712,262937,10775,3.9
42,31,Clarion,2008,20799,19496,1303,6.3
42,33,Clearfield,2008,40705,37958,2747,6.7
42,35,Clinton,2008,19425,18219,1206,6.2
42,37,Columbia,2008,36346,34201,2145,5.9
42,39,Crawford,2008,43484,41029,2455,5.6
42,41,Cumberland,2008,125594,120245,5349,4.3
42,43,Dauphin,2008,137831,131355,6476,4.7
42,45,Delaware,2008,286958,272605,14353,5.0
42,47,Elk,2008,17545,16496,1049,6.0
42,49,Erie,2008,141662,133653,8009,5.7
42,51,Fayette,2008,66605,62231,4374,6.6
42,53,Forest,2008,2388,2205,183,7.7
42,55,Franklin,2008,82616,79051,3565,4.3
42,57,Fulton,2008,8131,7543,588,7.2
42,59,Greene,2008,18589,17509,1080,5.8
42,61,Huntingdon,2008,22590,21103,1487,6.6
42,63,Indiana,2008,46885,44404,2481,5.3
42,65,Jefferson,2008,23260,21963,1297,5.6
42,67,Juniata,2008,12429,11763,666,5.4
42,69,Lackawanna,2008,108335,102017,6318,5.8
42,71,Lancaster,2008,274034,262326,11708,4.3
42,73,Lawrence,2008,43874,41153,2721,6.2
42,75,Lebanon,2008,73229,70176,3053,4.2
42,77,Lehigh,2008,178632,168540,10092,5.6
42,79,Luzerne,2008,161460,151324,10136,6.3
42,81,Lycoming,2008,60597,57016,3581,5.9
42,83,McKean,2008,21899,20551,1348,6.2
42,85,Mercer,2008,55709,51961,3748,6.7
42,87,Mifflin,2008,22749,21252,1497,6.6
42,89,Monroe,2008,83866,78825,5041,6.0
42,91,Montgomery,2008,437181,418247,18934,4.3
42,93,Montour,2008,9420,8969,451,4.8
42,95,Northampton,2008,153524,145096,8428,5.5
42,97,Northumberland,2008,47945,44802,3143,6.6
42,99,Perry,2008,24957,23650,1307,5.2
42,101,Philadelphia/city,2008,629517,584793,44724,7.1
42,103,Pike,2008,28395,26680,1715,6.0
42,105,Potter,2008,7771,7213,558,7.2
42,107,Schuylkill,2008,74363,69719,4644,6.2
42,109,Snyder,2008,19786,18576,1210,6.1
42,111,Somerset,2008,39371,36865,2506,6.4
42,113,Sullivan,2008,3000,2829,171,5.7
42,115,Susquehanna,2008,21990,20740,1250,5.7
42,117,Tioga,2008,20588,19334,1254,6.1
42,119,Union,2008,17818,16698,1120,6.3
42,121,Venango,2008,26400,24895,1505,5.7
42,123,Warren,2008,21785,20647,1138,5.2
42,125,Washington,2008,106229,100664,5565,5.2
42,127,Wayne,2008,25697,24349,1348,5.2
42,129,Westmoreland,2008,188667,178647,10020,5.3
42,131,Wyoming,2008,14523,13643,880,6.1
42,133,York,2008,228801,218000,10801,4.7
44,1,Bristol,2008,27358,25548,1810,6.6
44,3,Kent,2008,96998,90029,6969,7.2
44,5,Newport,2008,43861,40960,2901,6.6
44,7,Providence,2008,326229,299594,26635,8.2
44,9,Washington,2008,73785,69058,4727,6.4
45,1,Abbeville,2008,11439,10452,987,8.6
45,3,Aiken,2008,75469,70744,4725,6.3
45,5,Allendale,2008,3387,2793,594,17.5
45,7,Anderson,2008,86021,79806,6215,7.2
45,9,Bamberg,2008,6401,5633,768,12.0
45,11,Barnwell,2008,8915,7880,1035,11.6
45,13,Beaufort,2008,64201,60558,3643,5.7
45,15,Berkeley,2008,80474,75200,5274,6.6
45,17,Calhoun,2008,6823,6266,557,8.2
45,19,Charleston,2008,175535,165562,9973,5.7
45,21,Cherokee,2008,25801,23307,2494,9.7
45,23,Chester,2008,15498,13549,1949,12.6
45,25,Chesterfield,2008,18776,16982,1794,9.6
45,27,Clarendon,2008,12643,11326,1317,10.4
45,29,Colleton,2008,16805,15328,1477,8.8
45,31,Darlington,2008,31442,28586,2856,9.1
45,33,Dillon,2008,13115,11673,1442,11.0
45,35,Dorchester,2008,63993,60124,3869,6.0
45,37,Edgefield,2008,11024,10232,792,7.2
45,39,Fairfield,2008,11320,10036,1284,11.3
45,41,Florence,2008,63398,58654,4744,7.5
45,43,Georgetown,2008,30632,28204,2428,7.9
45,45,Greenville,2008,225610,212221,13389,5.9
45,47,Greenwood,2008,30889,28373,2516,8.1
45,49,Hampton,2008,7797,7051,746,9.6
45,51,Horry,2008,131823,121866,9957,7.6
45,53,Jasper,2008,10134,9478,656,6.5
45,55,Kershaw,2008,29994,27892,2102,7.0
45,57,Lancaster,2008,29934,26266,3668,12.3
45,59,Laurens,2008,33187,30564,2623,7.9
45,61,Lee,2008,8209,7392,817,10.0
45,63,Lexington,2008,133531,126555,6976,5.2
45,65,McCormick,2008,3482,3083,399,11.5
45,67,Marion,2008,12935,11051,1884,14.6
45,69,Marlboro,2008,11806,10234,1572,13.3
45,71,Newberry,2008,18740,17346,1394,7.4
45,73,Oconee,2008,30874,28461,2413,7.8
45,75,Orangeburg,2008,41529,37056,4473,10.8
45,77,Pickens,2008,58607,54815,3792,6.5
45,79,Richland,2008,181861,169980,11881,6.5
45,81,Saluda,2008,8998,8422,576,6.4
45,83,Spartanburg,2008,136844,126841,10003,7.3
45,85,Sumter,2008,44170,40268,3902,8.8
45,87,Union,2008,11829,10466,1363,11.5
45,89,Williamsburg,2008,15608,13880,1728,11.1
45,91,York,2008,108594,100454,8140,7.5
46,3,Aurora,2008,1455,1410,45,3.1
46,5,Beadle,2008,9543,9303,240,2.5
46,7,Bennett,2008,1345,1290,55,4.1
46,9,Bon Homme,2008,3023,2918,105,3.5
46,11,Brookings,2008,19267,18797,470,2.4
46,13,Brown,2008,20876,20359,517,2.5
46,15,Brule,2008,2757,2682,75,2.7
46,17,Buffalo,2008,474,426,48,10.1
46,19,Butte,2008,5392,5242,150,2.8
46,21,Campbell,2008,825,801,24,2.9
46,23,Charles Mix,2008,3986,3845,141,3.5
46,25,Clark,2008,1785,1716,69,3.9
46,27,Clay,2008,7572,7362,210,2.8
46,29,Codington,2008,16348,15852,496,3.0
46,31,Corson,2008,1343,1273,70,5.2
46,33,Custer,2008,4821,4685,136,2.8
46,35,Davison,2008,11105,10813,292,2.6
46,37,Day,2008,2865,2740,125,4.4
46,39,Deuel,2008,2728,2623,105,3.8
46,41,Dewey,2008,2472,2243,229,9.3
46,43,Douglas,2008,1678,1632,46,2.7
46,45,Edmunds,2008,2038,1982,56,2.7
46,47,Fall River,2008,3695,3569,126,3.4
46,49,Faulk,2008,1126,1093,33,2.9
46,51,Grant,2008,4189,4036,153,3.7
46,53,Gregory,2008,2329,2249,80,3.4
46,55,Haakon,2008,1141,1111,30,2.6
46,57,Hamlin,2008,2954,2855,99,3.4
46,59,Hand,2008,1859,1810,49,2.6
46,61,Hanson,2008,1947,1887,60,3.1
46,63,Harding,2008,772,751,21,2.7
46,65,Hughes,2008,10151,9908,243,2.4
46,67,Hutchinson,2008,3695,3581,114,3.1
46,69,Hyde,2008,726,705,21,2.9
46,71,Jackson,2008,1206,1135,71,5.9
46,73,Jerauld,2008,1411,1378,33,2.3
46,75,Jones,2008,680,663,17,2.5
46,77,Kingsbury,2008,2961,2864,97,3.3
46,79,Lake,2008,6702,6489,213,3.2
46,81,Lawrence,2008,13319,12935,384,2.9
46,83,Lincoln,2008,21752,21208,544,2.5
46,85,Lyman,2008,1954,1865,89,4.6
46,87,McCook,2008,2698,2602,96,3.6
46,89,McPherson,2008,1099,1052,47,4.3
46,91,Marshall,2008,2075,1984,91,4.4
46,93,Meade,2008,12178,11795,383,3.1
46,95,Mellette,2008,866,828,38,4.4
46,97,Miner,2008,1233,1190,43,3.5
46,99,Minnehaha,2008,99268,96438,2830,2.9
46,101,Moody,2008,3997,3824,173,4.3
46,102,Oglala Lakota,2008,3727,3411,316,8.5
46,103,Pennington,2008,54313,52710,1603,3.0
46,105,Perkins,2008,1593,1543,50,3.1
46,107,Potter,2008,1286,1246,40,3.1
46,109,Roberts,2008,4780,4579,201,4.2
46,111,Sanborn,2008,1399,1361,38,2.7
46,115,Spink,2008,3298,3188,110,3.3
46,117,Stanley,2008,1872,1826,46,2.5
46,119,Sully,2008,985,963,22,2.2
46,121,Todd,2008,3382,3165,217,6.4
46,123,Tripp,2008,2926,2838,88,3.0
46,125,Turner,2008,4201,4061,140,3.3
46,127,Union,2008,8281,7994,287,3.5
46,129,Walworth,2008,2636,2522,114,4.3
46,135,Yankton,2008,12022,11683,339,2.8
46,137,Ziebach,2008,833,783,50,6.0
47,1,Anderson,2008,35859,33798,2061,5.7
47,3,Bedford,2008,22523,21014,1509,6.7
47,5,Benton,2008,7068,6458,610,8.6
47,7,Bledsoe,2008,4929,4520,409,8.3
47,9,Blount,2008,63545,59681,3864,6.1
47,11,Bradley,2008,47637,44631,3006,6.3
47,13,Campbell,2008,17013,15709,1304,7.7
47,15,Cannon,2008,6605,6124,481,7.3
47,17,Carroll,2008,13797,12552,1245,9.0
47,19,Carter,2008,29774,27832,1942,6.5
47,21,Cheatham,2008,20431,19332,1099,5.4
47,23,Chester,2008,7961,7415,546,6.9
47,25,Claiborne,2008,13356,12367,989,7.4
47,27,Clay,2008,3487,3121,366,10.5
47,29,Cocke,2008,16527,15096,1431,8.7
47,31,Coffee,2008,25775,24172,1603,6.2
47,33,Crockett,2008,6473,5904,569,8.8
47,35,Cumberland,2008,23229,21432,1797,7.7
47,37,Davidson,2008,324565,307247,17318,5.3
47,39,Decatur,2008,5683,5209,474,8.3
47,41,DeKalb,2008,10190,9519,671,6.6
47,43,Dickson,2008,23623,22012,1611,6.8
47,45,Dyer,2008,17634,16322,1312,7.4
47,47,Fayette,2008,18208,16873,1335,7.3
47,49,Fentress,2008,8062,7314,748,9.3
47,51,Franklin,2008,19930,18621,1309,6.6
47,53,Gibson,2008,21231,19246,1985,9.3
47,55,Giles,2008,13484,12417,1067,7.9
47,57,Grainger,2008,10261,9455,806,7.9
47,59,Greene,2008,30311,27523,2788,9.2
47,61,Grundy,2008,5957,5466,491,8.2
47,63,Hamblen,2008,30350,28223,2127,7.0
47,65,Hamilton,2008,168258,158818,9440,5.6
47,67,Hancock,2008,2566,2356,210,8.2
47,69,Hardeman,2008,11599,10615,984,8.5
47,71,Hardin,2008,11913,11017,896,7.5
47,73,Hawkins,2008,27033,25245,1788,6.6
47,75,Haywood,2008,9503,8517,986,10.4
47,77,Henderson,2008,12109,10887,1222,10.1
47,79,Henry,2008,13947,12747,1200,8.6
47,81,Hickman,2008,10160,9317,843,8.3
47,83,Houston,2008,3871,3561,310,8.0
47,85,Humphreys,2008,9037,8284,753,8.3
47,87,Jackson,2008,4988,4564,424,8.5
47,89,Jefferson,2008,24665,22936,1729,7.0
47,91,Johnson,2008,7290,6668,622,8.5
47,93,Knox,2008,230698,219362,11336,4.9
47,95,Lake,2008,2678,2476,202,7.5
47,97,Lauderdale,2008,10366,9095,1271,12.3
47,99,Lawrence,2008,16649,15041,1608,9.7
47,101,Lewis,2008,5470,4928,542,9.9
47,103,Lincoln,2008,17252,16414,838,4.9
47,105,Loudon,2008,23612,22295,1317,5.6
47,107,McMinn,2008,24072,21998,2074,8.6
47,109,McNairy,2008,11540,10507,1033,9.0
47,111,Macon,2008,10656,9780,876,8.2
47,113,Madison,2008,48769,45529,3240,6.6
47,115,Marion,2008,13062,12075,987,7.6
47,117,Marshall,2008,12611,11462,1149,9.1
47,119,Maury,2008,37639,34627,3012,8.0
47,121,Meigs,2008,4975,4540,435,8.7
47,123,Monroe,2008,18987,17128,1859,9.8
47,125,Montgomery,2008,68150,63923,4227,6.2
47,127,Moore,2008,3172,2998,174,5.5
47,129,Morgan,2008,8582,7938,644,7.5
47,131,Obion,2008,15631,14549,1082,6.9
47,133,Overton,2008,10130,9233,897,8.9
47,135,Perry,2008,2982,2510,472,15.8
47,137,Pickett,2008,1896,1695,201,10.6
47,139,Polk,2008,7051,6491,560,7.9
47,141,Putnam,2008,36135,33837,2298,6.4
47,143,Rhea,2008,13469,12409,1060,7.9
47,145,Roane,2008,27295,25711,1584,5.8
47,147,Robertson,2008,33552,31516,2036,6.1
47,149,Rutherford,2008,133807,126171,7636,5.7
47,151,Scott,2008,8547,7573,974,11.4
47,153,Sequatchie,2008,6280,5810,470,7.5
47,155,Sevier,2008,48557,45181,3376,7.0
47,157,Shelby,2008,440899,410833,30066,6.8
47,159,Smith,2008,9276,8530,746,8.0
47,161,Stewart,2008,5938,5438,500,8.4
47,163,Sullivan,2008,74793,70881,3912,5.2
47,165,Sumner,2008,80148,75433,4715,5.9
47,167,Tipton,2008,28786,26550,2236,7.8
47,169,Trousdale,2008,3727,3420,307,8.2
47,171,Unicoi,2008,8448,7831,617,7.3
47,173,Union,2008,8820,8274,546,6.2
47,175,Van Buren,2008,2511,2305,206,8.2
47,177,Warren,2008,17536,16070,1466,8.4
47,179,Washington,2008,62332,58874,3458,5.5
47,181,Wayne,2008,6650,5990,660,9.9
47,183,Weakley,2008,15684,14417,1267,8.1
47,185,White,2008,10640,9762,878,8.3
47,187,Williamson,2008,89266,85216,4050,4.5
47,189,Wilson,2008,58654,55339,3315,5.7
48,1,Anderson,2008,20239,19098,1141,5.6
48,3,Andrews,2008,6876,6645,231,3.4
48,5,Angelina,2008,39126,37255,1871,4.8
48,7,Aransas,2008,11402,10896,506,4.4
48,9,Archer,2008,5134,4945,189,3.7
48,11,Armstrong,2008,1092,1054,38,3.5
48,13,Atascosa,2008,18925,18032,893,4.7
48,15,Austin,2008,13028,12475,553,4.2
48,17,Bailey,2008,3343,3205,138,4.1
48,19,Bandera,2008,9671,9245,426,4.4
48,21,Bastrop,2008,33708,32048,1660,4.9
48,23,Baylor,2008,2033,1957,76,3.7
48,25,Bee,2008,11249,10550,699,6.2
48,27,Bell,2008,122506,116501,6005,4.9
48,29,Bexar,2008,749530,714302,35228,4.7
48,31,Blanco,2008,4876,4698,178,3.7
48,33,Borden,2008,397,384,13,3.3
48,35,Bosque,2008,8273,7896,377,4.6
48,37,Bowie,2008,43523,41347,2176,5.0
48,39,Brazoria,2008,142502,135180,7322,5.1
48,41,Brazos,2008,91793,88213,3580,3.9
48,43,Brewster,2008,5106,4917,189,3.7
48,45,Briscoe,2008,704,674,30,4.3
48,47,Brooks,2008,3272,3098,174,5.3
48,49,Brown,2008,18451,17636,815,4.4
48,51,Burleson,2008,7893,7544,349,4.4
48,53,Burnet,2008,22186,21318,868,3.9
48,55,Caldwell,2008,15391,14579,812,5.3
48,57,Calhoun,2008,9388,8939,449,4.8
48,59,Callahan,2008,7109,6851,258,3.6
48,61,Cameron,2008,146091,136353,9738,6.7
48,63,Camp,2008,5565,5293,272,4.9
48,65,Carson,2008,3289,3179,110,3.3
48,67,Cass,2008,12904,12113,791,6.1
48,69,Castro,2008,3604,3474,130,3.6
48,71,Chambers,2008,14288,13471,817,5.7
48,73,Cherokee,2008,20351,19151,1200,5.9
48,75,Childress,2008,3055,2901,154,5.0
48,77,Clay,2008,6045,5807,238,3.9
48,79,Cochran,2008,1503,1431,72,4.8
48,81,Coke,2008,1284,1184,100,7.8
48,83,Coleman,2008,4365,4186,179,4.1
48,85,Collin,2008,406181,387806,18375,4.5
48,87,Collingsworth,2008,1476,1418,58,3.9
48,89,Colorado,2008,10943,10511,432,3.9
48,91,Comal,2008,54739,52505,2234,4.1
48,93,Comanche,2008,6534,6286,248,3.8
48,95,Concho,2008,1329,1260,69,5.2
48,97,Cooke,2008,22478,21693,785,3.5
48,99,Coryell,2008,23482,22014,1468,6.3
48,101,Cottle,2008,830,796,34,4.1
48,103,Crane,2008,1705,1635,70,4.1
48,105,Crockett,2008,2207,2143,64,2.9
48,107,Crosby,2008,2603,2474,129,5.0
48,109,Culberson,2008,1756,1704,52,3.0
48,111,Dallam,2008,3562,3454,108,3.0
48,113,Dallas,2008,1142035,1080697,61338,5.4
48,115,Dawson,2008,5129,4856,273,5.3
48,117,Deaf Smith,2008,8941,8602,339,3.8
48,119,Delta,2008,2299,2175,124,5.4
48,121,Denton,2008,344843,329513,15330,4.4
48,123,DeWitt,2008,9053,8678,375,4.1
48,125,Dickens,2008,996,945,51,5.1
48,127,Dimmit,2008,3970,3708,262,6.6
48,129,Donley,2008,1881,1800,81,4.3
48,131,Duval,2008,5176,4898,278,5.4
48,133,Eastland,2008,8452,8073,379,4.5
48,135,Ector,2008,70677,68259,2418,3.4
48,137,Edwards,2008,1043,1004,39,3.7
48,139,Ellis,2008,70283,66754,3529,5.0
48,141,El Paso,2008,298075,279688,18387,6.2
48,143,Erath,2008,18641,17940,701,3.8
48,145,Falls,2008,6563,6181,382,5.8
48,147,Fannin,2008,13452,12668,784,5.8
48,149,Fayette,2008,12334,11908,426,3.5
48,151,Fisher,2008,1983,1907,76,3.8
48,153,Floyd,2008,3215,3063,152,4.7
48,155,Foard,2008,713,683,30,4.2
48,157,Fort Bend,2008,265673,253918,11755,4.4
48,159,Franklin,2008,5307,5083,224,4.2
48,161,Freestone,2008,10203,9794,409,4.0
48,163,Frio,2008,6869,6499,370,5.4
48,165,Gaines,2008,6801,6539,262,3.9
48,167,Galveston,2008,141992,133953,8039,5.7
48,169,Garza,2008,2404,2312,92,3.8
48,171,Gillespie,2008,13199,12793,406,3.1
48,173,Glasscock,2008,630,606,24,3.8
48,175,Goliad,2008,3469,3339,130,3.7
48,177,Gonzales,2008,9751,9368,383,3.9
48,179,Gray,2008,11378,10982,396,3.5
48,181,Grayson,2008,55599,52723,2876,5.2
48,183,Gregg,2008,64029,61483,2546,4.0
48,185,Grimes,2008,10841,10283,558,5.1
48,187,Guadalupe,2008,57789,55309,2480,4.3
48,189,Hale,2008,16771,16018,753,4.5
48,191,Hall,2008,1438,1358,80,5.6
48,193,Hamilton,2008,4263,4110,153,3.6
48,195,Hansford,2008,2649,2563,86,3.2
48,197,Hardeman,2008,2331,2248,83,3.6
48,199,Hardin,2008,26159,24771,1388,5.3
48,201,Harris,2008,1935331,1843580,91751,4.7
48,203,Harrison,2008,32342,30836,1506,4.7
48,205,Hartley,2008,2450,2369,81,3.3
48,207,Haskell,2008,3257,3152,105,3.2
48,209,Hays,2008,76680,73382,3298,4.3
48,211,Hemphill,2008,3144,3085,59,1.9
48,213,Henderson,2008,34594,32765,1829,5.3
48,215,Hidalgo,2008,282708,262352,20356,7.2
48,217,Hill,2008,15964,15167,797,5.0
48,219,Hockley,2008,11948,11504,444,3.7
48,221,Hood,2008,25272,24209,1063,4.2
48,223,Hopkins,2008,17558,16833,725,4.1
48,225,Houston,2008,7979,7463,516,6.5
48,227,Howard,2008,13989,13349,640,4.6
48,229,Hudspeth,2008,1594,1531,63,4.0
48,231,Hunt,2008,36966,34993,1973,5.3
48,233,Hutchinson,2008,11231,10768,463,4.1
48,235,Irion,2008,888,857,31,3.5
48,237,Jack,2008,5449,5277,172,3.2
48,239,Jackson,2008,6813,6536,277,4.1
48,241,Jasper,2008,15484,14503,981,6.3
48,243,Jeff Davis,2008,1193,1149,44,3.7
48,245,Jefferson,2008,113930,106376,7554,6.6
48,247,Jim Hogg,2008,2771,2666,105,3.8
48,249,Jim Wells,2008,21489,20582,907,4.2
48,251,Johnson,2008,73218,69840,3378,4.6
48,253,Jones,2008,7775,7389,386,5.0
48,255,Karnes,2008,5289,4978,311,5.9
48,257,Kaufman,2008,46372,43916,2456,5.3
48,259,Kendall,2008,16151,15535,616,3.8
48,261,Kenedy,2008,238,230,8,3.4
48,263,Kent,2008,441,423,18,4.1
48,265,Kerr,2008,23102,22182,920,4.0
48,267,Kimble,2008,2197,2115,82,3.7
48,269,King,2008,178,170,8,4.5
48,271,Kinney,2008,1375,1302,73,5.3
48,273,Kleberg,2008,16533,15830,703,4.3
48,275,Knox,2008,1808,1739,69,3.8
48,277,Lamar,2008,23517,22249,1268,5.4
48,279,Lamb,2008,7098,6784,314,4.4
48,281,Lampasas,2008,10299,9877,422,4.1
48,283,La Salle,2008,2911,2754,157,5.4
48,285,Lavaca,2008,9916,9572,344,3.5
48,287,Lee,2008,8998,8646,352,3.9
48,289,Leon,2008,7804,7468,336,4.3
48,291,Liberty,2008,30880,29044,1836,5.9
48,293,Limestone,2008,10736,10269,467,4.3
48,295,Lipscomb,2008,1807,1756,51,2.8
48,297,Live Oak,2008,5112,4894,218,4.3
48,299,Llano,2008,8438,8076,362,4.3
48,301,Loving,2008,43,40,3,7.0
48,303,Lubbock,2008,138524,133372,5152,3.7
48,305,Lynn,2008,2771,2642,129,4.7
48,307,McCulloch,2008,3983,3826,157,3.9
48,309,McLennan,2008,111042,106017,5025,4.5
48,311,McMullen,2008,333,315,18,5.4
48,313,Madison,2008,4983,4723,260,5.2
48,315,Marion,2008,5006,4753,253,5.1
48,317,Martin,2008,2236,2157,79,3.5
48,319,Mason,2008,2348,2277,71,3.0
48,321,Matagorda,2008,17058,15908,1150,6.7
48,323,Maverick,2008,20855,18630,2225,10.7
48,325,Medina,2008,19735,18738,997,5.1
48,327,Menard,2008,1090,1043,47,4.3
48,329,Midland,2008,75277,73109,2168,2.9
48,331,Milam,2008,11987,11335,652,5.4
48,333,Mills,2008,2340,2248,92,3.9
48,335,Mitchell,2008,3301,3121,180,5.5
48,337,Montague,2008,10659,10278,381,3.6
48,339,Montgomery,2008,212533,203512,9021,4.2
48,341,Moore,2008,11247,10898,349,3.1
48,343,Morris,2008,6071,5706,365,6.0
48,345,Motley,2008,692,662,30,4.3
48,347,Nacogdoches,2008,30842,29501,1341,4.3
48,349,Navarro,2008,20917,19767,1150,5.5
48,351,Newton,2008,5729,5307,422,7.4
48,353,Nolan,2008,7716,7417,299,3.9
48,355,Nueces,2008,162583,155232,7351,4.5
48,357,Ochiltree,2008,5615,5461,154,2.7
48,359,Oldham,2008,904,863,41,4.5
48,361,Orange,2008,41255,38606,2649,6.4
48,363,Palo Pinto,2008,14028,13442,586,4.2
48,365,Panola,2008,13013,12506,507,3.9
48,367,Parker,2008,53281,50924,2357,4.4
48,369,Parmer,2008,4476,4325,151,3.4
48,371,Pecos,2008,7062,6746,316,4.5
48,373,Polk,2008,16788,15744,1044,6.2
48,375,Potter,2008,56682,54395,2287,4.0
48,377,Presidio,2008,3349,2999,350,10.5
48,379,Rains,2008,5062,4803,259,5.1
48,381,Randall,2008,67767,65645,2122,3.1
48,383,Reagan,2008,2544,2491,53,2.1
48,385,Real,2008,1460,1405,55,3.8
48,387,Red River,2008,5932,5546,386,6.5
48,389,Reeves,2008,4182,3940,242,5.8
48,391,Refugio,2008,4041,3884,157,3.9
48,393,Roberts,2008,568,554,14,2.5
48,395,Robertson,2008,6945,6599,346,5.0
48,397,Rockwall,2008,38177,36454,1723,4.5
48,399,Runnels,2008,4461,4247,214,4.8
48,401,Rusk,2008,24094,23059,1035,4.3
48,403,Sabine,2008,3397,3092,305,9.0
48,405,San Augustine,2008,3505,3287,218,6.2
48,407,San Jacinto,2008,10084,9500,584,5.8
48,409,San Patricio,2008,29907,28310,1597,5.3
48,411,San Saba,2008,2414,2281,133,5.5
48,413,Schleicher,2008,1470,1421,49,3.3
48,415,Scurry,2008,7548,7245,303,4.0
48,417,Shackelford,2008,2145,2089,56,2.6
48,419,Shelby,2008,12435,11841,594,4.8
48,421,Sherman,2008,1457,1402,55,3.8
48,423,Smith,2008,98766,93950,4816,4.9
48,425,Somervell,2008,4112,3927,185,4.5
48,427,Starr,2008,22286,19739,2547,11.4
48,429,Stephens,2008,4683,4512,171,3.7
48,431,Sterling,2008,850,825,25,2.9
48,433,Stonewall,2008,862,833,29,3.4
48,435,Sutton,2008,3517,3448,69,2.0
48,437,Swisher,2008,3560,3401,159,4.5
48,439,Tarrant,2008,881829,839259,42570,4.8
48,441,Taylor,2008,67200,64705,2495,3.7
48,443,Terrell,2008,331,309,22,6.6
48,445,Terry,2008,5866,5620,246,4.2
48,447,Throckmorton,2008,943,910,33,3.5
48,449,Titus,2008,14119,13512,607,4.3
48,451,Tom Green,2008,51710,49576,2134,4.1
48,453,Travis,2008,537471,514663,22808,4.2
48,455,Trinity,2008,5800,5482,318,5.5
48,457,Tyler,2008,8249,7753,496,6.0
48,459,Upshur,2008,19804,18964,840,4.2
48,461,Upton,2008,1776,1721,55,3.1
48,463,Uvalde,2008,11168,10526,642,5.7
48,465,Val Verde,2008,20442,19254,1188,5.8
48,467,Van Zandt,2008,25567,24444,1123,4.4
48,469,Victoria,2008,45249,43525,1724,3.8
48,471,Walker,2008,26336,24957,1379,5.2
48,473,Waller,2008,16176,15365,811,5.0
48,475,Ward,2008,5076,4877,199,3.9
48,477,Washington,2008,16387,15734,653,4.0
48,479,Webb,2008,92471,87522,4949,5.4
48,481,Wharton,2008,20898,19981,917,4.4
48,483,Wheeler,2008,3393,3311,82,2.4
48,485,Wichita,2008,61169,58181,2988,4.9
48,487,Wilbarger,2008,7594,7324,270,3.6
48,489,Willacy,2008,7718,7031,687,8.9
48,491,Williamson,2008,202460,193342,9118,4.5
48,493,Wilson,2008,18746,17877,869,4.6
48,495,Winkler,2008,3456,3326,130,3.8
48,497,Wise,2008,27547,26347,1200,4.4
48,499,Wood,2008,18076,17158,918,5.1
48,501,Yoakum,2008,4089,3963,126,3.1
48,503,Young,2008,9821,9481,340,3.5
48,505,Zapata,2008,5167,4881,286,5.5
48,507,Zavala,2008,3649,3259,390,10.7
49,1,Beaver,2008,3151,3049,102,3.2
49,3,Box Elder,2008,23942,23043,899,3.8
49,5,Cache,2008,62224,60627,1597,2.6
49,7,Carbon,2008,10218,9809,409,4.0
49,9,Daggett,2008,456,439,17,3.7
49,11,Davis,2008,147087,142449,4638,3.2
49,13,Duchesne,2008,10408,10150,258,2.5
49,15,Emery,2008,5106,4925,181,3.5
49,17,Garfield,2008,2842,2679,163,5.7
49,19,Grand,2008,5309,5016,293,5.5
49,21,Iron,2008,21054,20192,862,4.1
49,23,Juab,2008,3985,3781,204,5.1
49,25,Kane,2008,3518,3381,137,3.9
49,27,Millard,2008,6116,5925,191,3.1
49,29,Morgan,2008,4104,3976,128,3.1
49,31,Piute,2008,913,888,25,2.7
49,33,Rich,2008,1440,1404,36,2.5
49,35,Salt Lake,2008,563645,545829,17816,3.2
49,37,San Juan,2008,5050,4750,300,5.9
49,39,Sanpete,2008,11225,10782,443,3.9
49,41,Sevier,2008,9728,9363,365,3.8
49,43,Summit,2008,22339,21652,687,3.1
49,45,Tooele,2008,28223,27214,1009,3.6
49,47,Uintah,2008,18795,18394,401,2.1
49,49,Utah,2008,225584,218201,7383,3.3
49,51,Wasatch,2008,10411,10052,359,3.4
49,53,Washington,2008,62371,59613,2758,4.4
49,55,Wayne,2008,1405,1333,72,5.1
49,57,Weber,2008,115001,110479,4522,3.9
50,1,Addison,2008,21611,20684,927,4.3
50,3,Bennington,2008,20483,19529,954,4.7
50,5,Caledonia,2008,16768,15927,841,5.0
50,7,Chittenden,2008,88773,85333,3440,3.9
50,9,Essex,2008,3250,3055,195,6.0
50,11,Franklin,2008,25926,24690,1236,4.8
50,13,Grand Isle,2008,4256,4008,248,5.8
50,15,Lamoille,2008,15095,14301,794,5.3
50,17,Orange,2008,16268,15574,694,4.3
50,19,Orleans,2008,14192,13242,950,6.7
50,21,Rutland,2008,35629,33730,1899,5.3
50,23,Washington,2008,34257,32690,1567,4.6
50,25,Windham,2008,24761,23666,1095,4.4
50,27,Windsor,2008,32709,31506,1203,3.7
51,1,Accomack,2008,18986,17964,1022,5.4
51,3,Albemarle,2008,52545,50855,1690,3.2
51,5,Alleghany,2008,6882,6481,401,5.8
51,7,Amelia,2008,6756,6430,326,4.8
51,9,Amherst,2008,16007,15295,712,4.4
51,11,Appomattox,2008,7292,6941,351,4.8
51,13,Arlington,2008,136375,132754,3621,2.7
51,15,Augusta,2008,37833,36355,1478,3.9
51,17,Bath,2008,2795,2672,123,4.4
51,19,Bedford,2008,38554,37028,1526,4.0
51,21,Bland,2008,3494,3315,179,5.1
51,23,Botetourt,2008,17728,17103,625,3.5
51,25,Brunswick,2008,7050,6548,502,7.1
51,27,Buchanan,2008,8948,8464,484,5.4
51,29,Buckingham,2008,7264,6880,384,5.3
51,31,Campbell,2008,27883,26688,1195,4.3
51,33,Caroline,2008,14264,13528,736,5.2
51,35,Carroll,2008,14072,13065,1007,7.2
51,36,Charles City,2008,3885,3675,210,5.4
51,37,Charlotte,2008,5438,5091,347,6.4
51,41,Chesterfield,2008,169701,162997,6704,4.0
51,43,Clarke,2008,8182,7880,302,3.7
51,45,Craig,2008,2550,2439,111,4.4
51,47,Culpeper,2008,20952,19867,1085,5.2
51,49,Cumberland,2008,4696,4455,241,5.1
51,51,Dickenson,2008,6076,5701,375,6.2
51,53,Dinwiddie,2008,13183,12537,646,4.9
51,57,Essex,2008,5649,5333,316,5.6
51,59,Fairfax,2008,591663,573490,18173,3.1
51,61,Fauquier,2008,37765,36403,1362,3.6
51,63,Floyd,2008,7156,6816,340,4.8
51,65,Fluvanna,2008,14138,13634,504,3.6
51,67,Franklin,2008,27080,25688,1392,5.1
51,69,Frederick,2008,41414,39544,1870,4.5
51,71,Giles,2008,8373,7888,485,5.8
51,73,Gloucester,2008,21033,20244,789,3.8
51,75,Goochland,2008,11434,11025,409,3.6
51,77,Grayson,2008,7176,6676,500,7.0
51,79,Greene,2008,10668,10290,378,3.5
51,81,Greensville,2008,4389,4128,261,5.9
51,83,Halifax,2008,15765,14601,1164,7.4
51,85,Hanover,2008,55745,53678,2067,3.7
51,87,Henrico,2008,165784,159279,6505,3.9
51,89,Henry,2008,25452,23254,2198,8.6
51,91,Highland,2008,1143,1080,63,5.5
51,93,Isle of Wight,2008,19071,18315,756,4.0
51,95,James City,2008,32356,31247,1109,3.4
51,97,King and Queen,2008,3347,3182,165,4.9
51,99,King George,2008,9649,9120,529,5.5
51,101,King William,2008,8750,8397,353,4.0
51,103,Lancaster,2008,5543,5202,341,6.2
51,105,Lee,2008,9788,9227,561,5.7
51,107,Loudoun,2008,172780,167549,5231,3.0
51,109,Louisa,2008,16777,16017,760,4.5
51,111,Lunenburg,2008,5504,5152,352,6.4
51,113,Madison,2008,7394,7095,299,4.0
51,115,Mathews,2008,4493,4320,173,3.9
51,117,Mecklenburg,2008,13478,12528,950,7.0
51,119,Middlesex,2008,5126,4914,212,4.1
51,121,Montgomery,2008,45828,43811,2017,4.4
51,125,Nelson,2008,8065,7753,312,3.9
51,127,New Kent,2008,9912,9529,383,3.9
51,131,Northampton,2008,6113,5755,358,5.9
51,133,Northumberland,2008,5913,5549,364,6.2
51,135,Nottoway,2008,6589,6200,389,5.9
51,137,Orange,2008,15667,14893,774,4.9
51,139,Page,2008,11793,10920,873,7.4
51,141,Patrick,2008,9148,8511,637,7.0
51,143,Pittsylvania,2008,31744,29473,2271,7.2
51,145,Powhatan,2008,14548,14021,527,3.6
51,147,Prince Edward,2008,9648,9075,573,5.9
51,149,Prince George,2008,14971,14282,689,4.6
51,153,Prince William,2008,205732,198411,7321,3.6
51,155,Pulaski,2008,18161,16911,1250,6.9
51,157,Rappahannock,2008,4274,4113,161,3.8
51,159,Richmond,2008,3879,3669,210,5.4
51,161,Roanoke,2008,49704,47992,1712,3.4
51,163,Rockbridge,2008,11491,10980,511,4.4
51,165,Rockingham,2008,42199,40674,1525,3.6
51,167,Russell,2008,11882,11144,738,6.2
51,169,Scott,2008,10102,9512,590,5.8
51,171,Shenandoah,2008,20278,19260,1018,5.0
51,173,Smyth,2008,15137,14143,994,6.6
51,175,Southampton,2008,8109,7688,421,5.2
51,177,Spotsylvania,2008,66122,63683,2439,3.7
51,179,Stafford,2008,66023,63567,2456,3.7
51,181,Surry,2008,3813,3629,184,4.8
51,183,Sussex,2008,4505,4222,283,6.3
51,185,Tazewell,2008,20736,19750,986,4.8
51,187,Warren,2008,20055,19102,953,4.8
51,191,Washington,2008,27502,26043,1459,5.3
51,193,Westmoreland,2008,8874,8391,483,5.4
51,195,Wise,2008,18096,17195,901,5.0
51,197,Wythe,2008,16174,15243,931,5.8
51,199,York,2008,31269,30157,1112,3.6
51,510,Alexandria city,2008,93019,90246,2773,3.0
51,520,Bristol city,2008,8093,7591,502,6.2
51,530,Buena Vista city,2008,3450,3260,190,5.5
51,540,Charlottesville city,2008,21703,20790,913,4.2
51,550,Chesapeake city,2008,116435,111591,4844,4.2
51,570,Colonial Heights city,2008,9316,8871,445,4.8
51,580,Covington city,2008,2678,2481,197,7.4
51,590,Danville city,2008,20219,18219,2000,9.9
51,595,Emporia city,2008,2524,2323,201,8.0
51,600,Fairfax city,2008,14387,13888,499,3.5
51,610,Falls Church city,2008,6908,6609,299,4.3
51,620,Franklin city,2008,3954,3687,267,6.8
51,630,Fredericksburg city,2008,12972,12128,844,6.5
51,640,Galax city,2008,3132,2926,206,6.6
51,650,Hampton city,2008,69225,65685,3540,5.1
51,660,Harrisonburg city,2008,22958,21925,1033,4.5
51,670,Hopewell city,2008,10663,9977,686,6.4
51,678,Lexington city,2008,2425,2257,168,6.9
51,680,Lynchburg city,2008,35112,33301,1811,5.2
51,683,Manassas city,2008,20058,19146,912,4.5
51,685,Manassas Park city,2008,6623,6355,268,4.0
51,690,Martinsville city,2008,5961,5198,763,12.8
51,700,Newport News city,2008,89268,84808,4460,5.0
51,710,Norfolk city,2008,100841,95108,5733,5.7
51,720,Norton city,2008,1620,1529,91,5.6
51,730,Petersburg city,2008,14311,13187,1124,7.9
51,735,Poquoson city,2008,6390,6179,211,3.3
51,740,Portsmouth city,2008,46497,43911,2586,5.6
51,750,Radford city,2008,7993,7536,457,5.7
51,760,Richmond city,2008,101541,95224,6317,6.2
51,770,Roanoke city,2008,47042,44736,2306,4.9
51,775,Salem city,2008,13630,13093,537,3.9
51,790,Staunton city,2008,11861,11313,548,4.6
51,800,Suffolk city,2008,40828,39026,1802,4.4
51,810,Virginia Beach city,2008,225528,216685,8843,3.9
51,820,Waynesboro city,2008,10423,9872,551,5.3
51,830,Williamsburg city,2008,5345,4852,493,9.2
51,840,Winchester city,2008,14344,13640,704,4.9
53,1,Adams,2008,8110,7589,521,6.4
53,3,Asotin,2008,10393,9716,677,6.5
53,5,Benton,2008,88736,84049,4687,5.3
53,7,Chelan,2008,40845,38474,2371,5.8
53,9,Clallam,2008,30049,27831,2218,7.4
53,11,Clark,2008,214879,199107,15772,7.3
53,13,Columbia,2008,1563,1448,115,7.4
53,15,Cowlitz,2008,44306,40550,3756,8.5
53,17,Douglas,2008,21174,20003,1171,5.5
53,19,Ferry,2008,2993,2718,275,9.2
53,21,Franklin,2008,34094,31911,2183,6.4
53,23,Garfield,2008,1021,972,49,4.8
53,25,Grant,2008,40910,38173,2737,6.7
53,27,Grays Harbor,2008,31850,29287,2563,8.0
53,29,Island,2008,33049,31166,1883,5.7
53,31,Jefferson,2008,13706,12915,791,5.8
53,33,King,2008,1088536,1047485,41051,3.8
53,35,Kitsap,2008,124727,118252,6475,5.2
53,37,Kittitas,2008,20935,19649,1286,6.1
53,39,Klickitat,2008,10162,9363,799,7.9
53,41,Lewis,2008,31475,28788,2687,8.5
53,43,Lincoln,2008,4825,4551,274,5.7
53,45,Mason,2008,25494,23625,1869,7.3
53,47,Okanogan,2008,21370,19930,1440,6.7
53,49,Pacific,2008,9203,8475,728,7.9
53,51,Pend Oreille,2008,5516,5025,491,8.9
53,53,Pierce,2008,394313,370985,23328,5.9
53,55,San Juan,2008,8769,8430,339,3.9
53,57,Skagit,2008,58746,55270,3476,5.9
53,59,Skamania,2008,5149,4693,456,8.9
53,61,Snohomish,2008,372224,355754,16470,4.4
53,63,Spokane,2008,239134,225197,13937,5.8
53,65,Stevens,2008,18862,17303,1559,8.3
53,67,Thurston,2008,131604,124703,6901,5.2
53,69,Wahkiakum,2008,1771,1638,133,7.5
53,71,Walla Walla,2008,30427,28881,1546,5.1
53,73,Whatcom,2008,108685,103050,5635,5.2
53,75,Whitman,2008,21246,20345,901,4.2
53,77,Yakima,2008,123195,114367,8828,7.2
54,1,Barbour,2008,6671,6318,353,5.3
54,3,Berkeley,2008,46105,43729,2376,5.2
54,5,Boone,2008,9341,8946,395,4.2
54,7,Braxton,2008,5872,5546,326,5.6
54,9,Brooke,2008,11065,10380,685,6.2
54,11,Cabell,2008,45046,43159,1887,4.2
54,13,Calhoun,2008,2772,2568,204,7.4
54,15,Clay,2008,3483,3247,236,6.8
54,17,Doddridge,2008,2794,2646,148,5.3
54,19,Fayette,2008,17978,17078,900,5.0
54,21,Gilmer,2008,3107,2980,127,4.1
54,23,Grant,2008,5214,4916,298,5.7
54,25,Greenbrier,2008,14974,14084,890,5.9
54,27,Hampshire,2008,9378,8942,436,4.6
54,29,Hancock,2008,14625,13698,927,6.3
54,31,Hardy,2008,6818,6481,337,4.9
54,33,Harrison,2008,30795,29491,1304,4.2
54,35,Jackson,2008,11887,11238,649,5.5
54,37,Jefferson,2008,24706,23685,1021,4.1
54,39,Kanawha,2008,91922,88417,3505,3.8
54,41,Lewis,2008,7391,7056,335,4.5
54,43,Lincoln,2008,8028,7621,407,5.1
54,45,Logan,2008,13076,12488,588,4.5
54,47,McDowell,2008,7143,6687,456,6.4
54,49,Marion,2008,26248,25229,1019,3.9
54,51,Marshall,2008,14707,13893,814,5.5
54,53,Mason,2008,10075,9313,762,7.6
54,55,Mercer,2008,24915,23825,1090,4.4
54,57,Mineral,2008,13458,12793,665,4.9
54,59,Mingo,2008,8977,8564,413,4.6
54,61,Monongalia,2008,48154,46702,1452,3.0
54,63,Monroe,2008,5822,5540,282,4.8
54,65,Morgan,2008,6929,6532,397,5.7
54,67,Nicholas,2008,10583,10055,528,5.0
54,69,Ohio,2008,20980,20030,950,4.5
54,71,Pendleton,2008,3685,3513,172,4.7
54,73,Pleasants,2008,3123,2926,197,6.3
54,75,Pocahontas,2008,3585,3310,275,7.7
54,77,Preston,2008,14992,14354,638,4.3
54,79,Putnam,2008,27723,26737,986,3.6
54,81,Raleigh,2008,32525,31125,1400,4.3
54,83,Randolph,2008,12714,11967,747,5.9
54,85,Ritchie,2008,4510,4243,267,5.9
54,87,Roane,2008,5502,5121,381,6.9
54,89,Summers,2008,4617,4367,250,5.4
54,91,Taylor,2008,6912,6581,331,4.8
54,93,Tucker,2008,2904,2702,202,7.0
54,95,Tyler,2008,3596,3353,243,6.8
54,97,Upshur,2008,10642,10153,489,4.6
54,99,Wayne,2008,17469,16580,889,5.1
54,101,Webster,2008,3271,3075,196,6.0
54,103,Wetzel,2008,6233,5750,483,7.7
54,105,Wirt,2008,2447,2287,160,6.5
54,107,Wood,2008,40801,38713,2088,5.1
54,109,Wyoming,2008,7968,7562,406,5.1
55,1,Adams,2008,10077,9366,711,7.1
55,3,Ashland,2008,9006,8459,547,6.1
55,5,Barron,2008,25144,23690,1454,5.8
55,7,Bayfield,2008,8066,7521,545,6.8
55,9,Brown,2008,139615,133165,6450,4.6
55,11,Buffalo,2008,8155,7804,351,4.3
55,13,Burnett,2008,7922,7351,571,7.2
55,15,Calumet,2008,25705,24596,1109,4.3
55,17,Chippewa,2008,33420,31644,1776,5.3
55,19,Clark,2008,17591,16604,987,5.6
55,21,Columbia,2008,31134,29538,1596,5.1
55,23,Crawford,2008,9611,9033,578,6.0
55,25,Dane,2008,296424,286154,10270,3.5
55,27,Dodge,2008,47323,44901,2422,5.1
55,29,Door,2008,17200,16262,938,5.5
55,31,Douglas,2008,23433,22189,1244,5.3
55,33,Dunn,2008,25608,24460,1148,4.5
55,35,Eau Claire,2008,57125,54738,2387,4.2
55,37,Florence,2008,2464,2317,147,6.0
55,39,Fond du Lac,2008,57058,54298,2760,4.8
55,41,Forest,2008,4896,4551,345,7.0
55,43,Grant,2008,28179,26806,1373,4.9
55,45,Green,2008,20403,19436,967,4.7
55,47,Green Lake,2008,10424,9837,587,5.6
55,49,Iowa,2008,14100,13435,665,4.7
55,51,Iron,2008,3032,2789,243,8.0
55,53,Jackson,2008,9815,9250,565,5.8
55,55,Jefferson,2008,42508,40414,2094,4.9
55,57,Juneau,2008,13394,12587,807,6.0
55,59,Kenosha,2008,85616,80901,4715,5.5
55,61,Kewaunee,2008,11573,11054,519,4.5
55,63,La Crosse,2008,65497,62895,2602,4.0
55,65,Lafayette,2008,9119,8730,389,4.3
55,67,Langlade,2008,10700,10042,658,6.1
55,69,Lincoln,2008,15581,14681,900,5.8
55,71,Manitowoc,2008,45306,43027,2279,5.0
55,73,Marathon,2008,75565,72086,3479,4.6
55,75,Marinette,2008,22125,20759,1366,6.2
55,77,Marquette,2008,7842,7339,503,6.4
55,78,Menominee,2008,1647,1470,177,10.7
55,79,Milwaukee,2008,470352,443464,26888,5.7
55,81,Monroe,2008,24518,23365,1153,4.7
55,83,Oconto,2008,20337,19040,1297,6.4
55,85,Oneida,2008,19246,18055,1191,6.2
55,87,Outagamie,2008,98099,93480,4619,4.7
55,89,Ozaukee,2008,48033,46162,1871,3.9
55,91,Pepin,2008,4105,3909,196,4.8
55,93,Pierce,2008,24088,23024,1064,4.4
55,95,Polk,2008,24118,22678,1440,6.0
55,97,Portage,2008,42312,40377,1935,4.6
55,99,Price,2008,8373,7946,427,5.1
55,101,Racine,2008,100113,94253,5860,5.9
55,103,Richland,2008,10257,9768,489,4.8
55,105,Rock,2008,83733,78444,5289,6.3
55,107,Rusk,2008,7265,6751,514,7.1
55,109,St. Croix,2008,47650,45495,2155,4.5
55,111,Sauk,2008,35373,33619,1754,5.0
55,113,Sawyer,2008,9161,8513,648,7.1
55,115,Shawano,2008,22219,21049,1170,5.3
55,117,Sheboygan,2008,65838,62849,2989,4.5
55,119,Taylor,2008,10476,9780,696,6.6
55,121,Trempealeau,2008,16219,15470,749,4.6
55,123,Vernon,2008,14695,13969,726,4.9
55,125,Vilas,2008,11277,10545,732,6.5
55,127,Walworth,2008,56663,53942,2721,4.8
55,129,Washburn,2008,7861,7333,528,6.7
55,131,Washington,2008,74643,71361,3282,4.4
55,133,Waukesha,2008,214939,206260,8679,4.0
55,135,Waupaca,2008,28106,26588,1518,5.4
55,137,Waushara,2008,12740,11983,757,5.9
55,139,Winnebago,2008,94585,90394,4191,4.4
55,141,Wood,2008,42148,39838,2310,5.5
56,1,Albany,2008,19134,18669,465,2.4
56,3,Big Horn,2008,4984,4792,192,3.9
56,5,Campbell,2008,27681,27161,520,1.9
56,7,Carbon,2008,8360,8100,260,3.1
56,9,Converse,2008,7428,7232,196,2.6
56,11,Crook,2008,3520,3422,98,2.8
56,13,Fremont,2008,18598,17865,733,3.9
56,15,Goshen,2008,6153,5944,209,3.4
56,17,Hot Springs,2008,2441,2364,77,3.2
56,19,Johnson,2008,4099,3969,130,3.2
56,21,Laramie,2008,42995,41382,1613,3.8
56,23,Lincoln,2008,8471,8184,287,3.4
56,25,Natrona,2008,41157,40047,1110,2.7
56,27,Niobrara,2008,1248,1208,40,3.2
56,29,Park,2008,14597,14103,494,3.4
56,31,Platte,2008,3988,3833,155,3.9
56,33,Sheridan,2008,16244,15763,481,3.0
56,35,Sublette,2008,7099,6988,111,1.6
56,37,Sweetwater,2008,24557,23997,560,2.3
56,39,Teton,2008,14623,14214,409,2.8
56,41,Uinta,2008,11645,11321,324,2.8
56,43,Washakie,2008,4338,4191,147,3.4
56,45,Weston,2008,3262,3162,100,3.1
72,1,Adjuntas Municipio,2008,5175,4453,722,14.0
72,3,Aguada Municipio,2008,15932,13859,2073,13.0
72,5,Aguadilla Municipio,2008,21786,19098,2688,12.3
72,7,Aguas Buenas Municipio,2008,9495,8233,1262,13.3
72,9,Aibonito Municipio,2008,7792,6657,1135,14.6
72,11,Anasco Municipio,2008,10784,9441,1343,12.5
72,13,Arecibo Municipio,2008,32503,28565,3938,12.1
72,15,Arroyo Municipio,2008,5751,4783,968,16.8
72,17,Barceloneta Municipio,2008,7196,6085,1111,15.4
72,19,Barranquitas Municipio,2008,7695,6615,1080,14.0
72,21,Bayamon Municipio,2008,80678,72705,7973,9.9
72,23,Cabo Rojo Municipio,2008,20871,18849,2022,9.7
72,25,Caguas Municipio,2008,53130,46961,6169,11.6
72,27,Camuy Municipio,2008,12795,11378,1417,11.1
72,29,Canovanas Municipio,2008,14582,12391,2191,15.0
72,31,Carolina Municipio,2008,75533,68530,7003,9.3
72,33,Catano Municipio,2008,7635,6656,979,12.8
72,35,Cayey Municipio,2008,15526,13310,2216,14.3
72,37,Ceiba Municipio,2008,5786,4955,831,14.4
72,39,Ciales Municipio,2008,5241,4259,982,18.7
72,41,Cidra Municipio,2008,15595,13606,1989,12.8
72,43,Coamo Municipio,2008,11803,9921,1882,15.9
72,45,Comerio Municipio,2008,4747,3951,796,16.8
72,47,Corozal Municipio,2008,10485,9077,1408,13.4
72,49,Culebra Municipio,2008,852,796,56,6.6
72,51,Dorado Municipio,2008,12651,11371,1280,10.1
72,53,Fajardo Municipio,2008,14743,12701,2042,13.9
72,54,Florida Municipio,2008,4103,3681,422,10.3
72,55,Guanica Municipio,2008,6467,5513,954,14.8
72,57,Guayama Municipio,2008,14906,12674,2232,15.0
72,59,Guayanilla Municipio,2008,6957,5873,1084,15.6
72,61,Guaynabo Municipio,2008,43695,40504,3191,7.3
72,63,Gurabo Municipio,2008,15566,13888,1678,10.8
72,65,Hatillo Municipio,2008,12822,11208,1614,12.6
72,67,Hormigueros Municipio,2008,6766,5994,772,11.4
72,69,Humacao Municipio,2008,20545,17351,3194,15.5
72,71,Isabela Municipio,2008,15761,13808,1953,12.4
72,73,Jayuya Municipio,2008,4567,3910,657,14.4
72,75,Juana Diaz Municipio,2008,17192,15045,2147,12.5
72,77,Juncos Municipio,2008,13118,11324,1794,13.7
72,79,Lajas Municipio,2008,8983,7752,1231,13.7
72,81,Lares Municipio,2008,11955,10360,1595,13.3
72,83,Las Marias Municipio,2008,4360,3886,474,10.9
72,85,Las Piedras Municipio,2008,12874,11071,1803,14.0
72,87,Loiza Municipio,2008,8755,7399,1356,15.5
72,89,Luquillo Municipio,2008,6931,5850,1081,15.6
72,91,Manati Municipio,2008,14595,12514,2081,14.3
72,93,Maricao Municipio,2008,1934,1672,262,13.5
72,95,Maunabo Municipio,2008,3567,2880,687,19.3
72,97,Mayaguez Municipio,2008,30077,26132,3945,13.1
72,99,Moca Municipio,2008,15269,13440,1829,12.0
72,101,Morovis Municipio,2008,9216,7754,1462,15.9
72,103,Naguabo Municipio,2008,7473,6187,1286,17.2
72,105,Naranjito Municipio,2008,8453,7347,1106,13.1
72,107,Orocovis Municipio,2008,5403,4493,910,16.8
72,109,Patillas Municipio,2008,6108,5068,1040,17.0
72,111,Penuelas Municipio,2008,9144,7778,1366,14.9
72,113,Ponce Municipio,2008,63324,55888,7436,11.7
72,115,Quebradillas Municipio,2008,8579,7505,1074,12.5
72,117,Rincon Municipio,2008,5650,4922,728,12.9
72,119,Rio Grande Municipio,2008,17888,15558,2330,13.0
72,121,Sabana Grande Municipio,2008,9509,8134,1375,14.5
72,123,Salinas Municipio,2008,8935,7429,1506,16.9
72,125,San German Municipio,2008,12979,11222,1757,13.5
72,127,San Juan Municipio,2008,164801,150529,14272,8.7
72,129,San Lorenzo Municipio,2008,14281,12454,1827,12.8
72,131,San Sebastian Municipio,2008,15597,13539,2058,13.2
72,133,Santa Isabel Municipio,2008,8860,7712,1148,13.0
72,135,Toa Alta Municipio,2008,29998,27287,2711,9.0
72,137,Toa Baja Municipio,2008,34808,31376,3432,9.9
72,139,Trujillo Alto Municipio,2008,34728,31976,2752,7.9
72,141,Utuado Municipio,2008,8951,7679,1272,14.2
72,143,Vega Alta Municipio,2008,12350,10769,1581,12.8
72,145,Vega Baja Municipio,2008,20372,17693,2679,13.2
72,147,Vieques Municipio,2008,3214,2811,403,12.5
72,149,Villalba Municipio,2008,9324,8036,1288,13.8
72,151,Yabucoa Municipio,2008,10904,8931,1973,18.1
72,153,Yauco Municipio,2008,16555,14394,2161,13.1
1,1,Autauga,2009,24660,22464,2196,8.9
1,3,Baldwin,2009,82314,74950,7364,8.9
1,5,Barbour,2009,9944,8635,1309,13.2
1,7,Bibb,2009,8696,7637,1059,12.2
1,9,Blount,2009,26426,24005,2421,9.2
1,11,Bullock,2009,3713,3179,534,14.4
1,13,Butler,2009,9033,7671,1362,15.1
1,15,Calhoun,2009,53760,48278,5482,10.2
1,17,Chambers,2009,14487,11863,2624,18.1
1,19,Cherokee,2009,11715,10460,1255,10.7
1,21,Chilton,2009,19393,17501,1892,9.8
1,23,Choctaw,2009,5106,4474,632,12.4
1,25,Clarke,2009,10298,8728,1570,15.2
1,27,Clay,2009,5596,4737,859,15.4
1,29,Cleburne,2009,6499,5893,606,9.3
1,31,Coffee,2009,21423,19755,1668,7.8
1,33,Colbert,2009,25324,22625,2699,10.7
1,35,Conecuh,2009,4853,3959,894,18.4
1,37,Coosa,2009,4557,3884,673,14.8
1,39,Covington,2009,16672,15021,1651,9.9
1,41,Crenshaw,2009,6424,5810,614,9.6
1,43,Cullman,2009,38449,34838,3611,9.4
1,45,Dale,2009,20000,18232,1768,8.8
1,47,Dallas,2009,15671,12607,3064,19.6
1,49,DeKalb,2009,29733,25834,3899,13.1
1,51,Elmore,2009,36337,33185,3152,8.7
1,53,Escambia,2009,14683,12863,1820,12.4
1,55,Etowah,2009,44839,40128,4711,10.5
1,57,Fayette,2009,6930,6037,893,12.9
1,59,Franklin,2009,13171,11547,1624,12.3
1,61,Geneva,2009,11143,10043,1100,9.9
1,63,Greene,2009,3110,2672,438,14.1
1,65,Hale,2009,6828,5933,895,13.1
1,67,Henry,2009,7109,6380,729,10.3
1,69,Houston,2009,45841,41941,3900,8.5
1,71,Jackson,2009,26247,23173,3074,11.7
1,73,Jefferson,2009,306180,276008,30172,9.9
1,75,Lamar,2009,5503,4692,811,14.7
1,77,Lauderdale,2009,43319,39087,4232,9.8
1,79,Lawrence,2009,15702,13734,1968,12.5
1,81,Lee,2009,64799,59215,5584,8.6
1,83,Limestone,2009,38219,34795,3424,9.0
1,85,Lowndes,2009,4867,3999,868,17.8
1,87,Macon,2009,9308,8263,1045,11.2
1,89,Madison,2009,168854,156443,12411,7.4
1,91,Marengo,2009,8052,7000,1052,13.1
1,93,Marion,2009,12259,10386,1873,15.3
1,95,Marshall,2009,40653,36871,3782,9.3
1,97,Mobile,2009,186230,166932,19298,10.4
1,99,Monroe,2009,8573,7029,1544,18.0
1,101,Montgomery,2009,104848,94765,10083,9.6
1,103,Morgan,2009,56231,50661,5570,9.9
1,105,Perry,2009,3727,3043,684,18.4
1,107,Pickens,2009,7997,6992,1005,12.6
1,109,Pike,2009,15777,14404,1373,8.7
1,111,Randolph,2009,9354,8072,1282,13.7
1,113,Russell,2009,21477,19041,2436,11.3
1,115,St. Clair,2009,36664,33003,3661,10.0
1,117,Shelby,2009,99778,92685,7093,7.1
1,119,Sumter,2009,4730,4081,649,13.7
1,121,Talladega,2009,37552,32583,4969,13.2
1,123,Tallapoosa,2009,18055,15801,2254,12.5
1,125,Tuscaloosa,2009,88900,80625,8275,9.3
1,127,Walker,2009,28095,25092,3003,10.7
1,129,Washington,2009,6889,5933,956,13.9
1,131,Wilcox,2009,3586,2717,869,24.2
1,133,Winston,2009,9433,7890,1543,16.4
2,13,Aleutians East Borough,2009,1133,1018,115,10.2
2,16,Aleutians West Census Area,2009,3002,2785,217,7.2
2,20,Anchorage Borough/municipality,2009,153655,143338,10317,6.7
2,50,Bethel Census Area,2009,7039,6019,1020,14.5
2,60,Bristol Bay Borough,2009,1043,992,51,4.9
2,68,Denali Borough,2009,1411,1291,120,8.5
2,70,Dillingham Census Area,2009,2152,1927,225,10.5
2,90,Fairbanks North Star Borough,2009,45971,42618,3353,7.3
2,100,Haines Borough,2009,1416,1284,132,9.3
2,110,Juneau Borough/city,2009,18369,17253,1116,6.1
2,122,Kenai Peninsula Borough,2009,26907,24189,2718,10.1
2,130,Ketchikan Gateway Borough,2009,8324,7713,611,7.3
2,150,Kodiak Island Borough,2009,6598,6112,486,7.4
2,158,Kusilvak Census Area,2009,2705,2128,577,21.3
2,164,Lake and Peninsula Borough,2009,1088,997,91,8.4
2,170,Matanuska-Susitna Borough,2009,42473,38588,3885,9.1
2,180,Nome Census Area,2009,3970,3494,476,12.0
2,185,North Slope Borough,2009,5295,5037,258,4.9
2,188,Northwest Arctic Borough,2009,2989,2623,366,12.2
2,201,Prince of Wales-Outer Ketchikan Census Area,2009,2389,2015,374,15.7
2,220,Sitka Borough/city,2009,4641,4343,298,6.4
2,232,Skagway-Hoonah-Angoon Census Area,2009,1798,1527,271,15.1
2,240,Southeast Fairbanks Census Area,2009,3612,3254,358,9.9
2,261,Valdez-Cordova Census Area,2009,5338,4872,466,8.7
2,280,Wrangell-Petersburg Census Area,2009,2870,2563,307,10.7
2,282,Yakutat Borough/city,2009,314,277,37,11.8
2,290,Yukon-Koyukuk Census Area,2009,2879,2463,416,14.4
4,1,Apache,2009,22905,19380,3525,15.4
4,3,Cochise,2009,63101,58204,4897,7.8
4,5,Coconino,2009,74852,68643,6209,8.3
4,7,Gila,2009,23272,20694,2578,11.1
4,9,Graham,2009,15229,12993,2236,14.7
4,11,Greenlee,2009,4387,3576,811,18.5
4,12,La Paz,2009,7705,6963,742,9.6
4,13,Maricopa,2009,1967563,1792986,174577,8.9
4,15,Mohave,2009,91543,81375,10168,11.1
4,17,Navajo,2009,41145,35002,6143,14.9
4,19,Pima,2009,486097,443226,42871,8.8
4,21,Pinal,2009,126725,111541,15184,12.0
4,23,Santa Cruz,2009,18564,15704,2860,15.4
4,25,Yavapai,2009,98321,88310,10011,10.2
4,27,Yuma,2009,87485,67830,19655,22.5
5,1,Arkansas,2009,12240,10347,1893,15.5
5,3,Ashley,2009,9302,8334,968,10.4
5,5,Baxter,2009,17254,15669,1585,9.2
5,7,Benton,2009,107277,100476,6801,6.3
5,9,Boone,2009,16919,15666,1253,7.4
5,11,Bradley,2009,5461,4936,525,9.6
5,13,Calhoun,2009,2572,2358,214,8.3
5,15,Carroll,2009,13961,13122,839,6.0
5,17,Chicot,2009,4851,4318,533,11.0
5,19,Clark,2009,10737,9880,857,8.0
5,21,Clay,2009,6640,5897,743,11.2
5,23,Cleburne,2009,11747,10879,868,7.4
5,25,Cleveland,2009,4025,3703,322,8.0
5,27,Columbia,2009,10571,9555,1016,9.6
5,29,Conway,2009,10223,9463,760,7.4
5,31,Craighead,2009,46584,43354,3230,6.9
5,33,Crawford,2009,27829,25681,2148,7.7
5,35,Crittenden,2009,21954,19594,2360,10.7
5,37,Cross,2009,8502,7801,701,8.2
5,39,Dallas,2009,3921,3528,393,10.0
5,41,Desha,2009,5568,4946,622,11.2
5,43,Drew,2009,8186,7296,890,10.9
5,45,Faulkner,2009,56178,52329,3849,6.9
5,47,Franklin,2009,8151,7567,584,7.2
5,49,Fulton,2009,5233,4847,386,7.4
5,51,Garland,2009,42392,39205,3187,7.5
5,53,Grant,2009,8485,7889,596,7.0
5,55,Greene,2009,18683,16830,1853,9.9
5,57,Hempstead,2009,10658,9790,868,8.1
5,59,Hot Spring,2009,15273,13976,1297,8.5
5,61,Howard,2009,6201,5710,491,7.9
5,63,Independence,2009,16805,15349,1456,8.7
5,65,Izard,2009,5326,4844,482,9.0
5,67,Jackson,2009,7609,6787,822,10.8
5,69,Jefferson,2009,35472,32033,3439,9.7
5,71,Johnson,2009,11517,10700,817,7.1
5,73,Lafayette,2009,2978,2698,280,9.4
5,75,Lawrence,2009,7289,6628,661,9.1
5,77,Lee,2009,3520,3200,320,9.1
5,79,Lincoln,2009,4966,4481,485,9.8
5,81,Little River,2009,6748,6347,401,5.9
5,83,Logan,2009,10076,9158,918,9.1
5,85,Lonoke,2009,32219,30230,1989,6.2
5,87,Madison,2009,7367,6876,491,6.7
5,89,Marion,2009,6679,5900,779,11.7
5,91,Miller,2009,19876,18769,1107,5.6
5,93,Mississippi,2009,21428,18477,2951,13.8
5,95,Monroe,2009,3702,3405,297,8.0
5,97,Montgomery,2009,4152,3863,289,7.0
5,99,Nevada,2009,4232,3844,388,9.2
5,101,Newton,2009,3446,3175,271,7.9
5,103,Ouachita,2009,12086,11129,957,7.9
5,105,Perry,2009,4705,4340,365,7.8
5,107,Phillips,2009,8803,7977,826,9.4
5,109,Pike,2009,5030,4650,380,7.6
5,111,Poinsett,2009,10498,9579,919,8.8
5,113,Polk,2009,8762,8101,661,7.5
5,115,Pope,2009,29455,27263,2192,7.4
5,117,Prairie,2009,4276,3944,332,7.8
5,119,Pulaski,2009,189196,176754,12442,6.6
5,121,Randolph,2009,7631,6935,696,9.1
5,123,St. Francis,2009,10343,9281,1062,10.3
5,125,Saline,2009,49398,46183,3215,6.5
5,127,Scott,2009,4894,4564,330,6.7
5,129,Searcy,2009,3555,3285,270,7.6
5,131,Sebastian,2009,60333,55783,4550,7.5
5,133,Sevier,2009,7541,7105,436,5.8
5,135,Sharp,2009,6221,5656,565,9.1
5,137,Stone,2009,4578,4179,399,8.7
5,139,Union,2009,19089,17141,1948,10.2
5,141,Van Buren,2009,6997,6275,722,10.3
5,143,Washington,2009,99100,92956,6144,6.2
5,145,White,2009,33917,31176,2741,8.1
5,147,Woodruff,2009,3353,2988,365,10.9
5,149,Yell,2009,10599,9740,859,8.1
6,1,Alameda,2009,764554,682769,81785,10.7
6,3,Alpine,2009,449,383,66,14.7
6,5,Amador,2009,17912,15779,2133,11.9
6,7,Butte,2009,104335,90989,13346,12.8
6,9,Calaveras,2009,20456,17561,2895,14.2
6,11,Colusa,2009,11610,9490,2120,18.3
6,13,Contra Costa,2009,527243,472520,54723,10.4
6,15,Del Norte,2009,11744,10302,1442,12.3
6,17,El Dorado,2009,92136,81706,10430,11.3
6,19,Fresno,2009,437028,370280,66748,15.3
6,21,Glenn,2009,12662,10799,1863,14.7
6,23,Humboldt,2009,61139,54327,6812,11.1
6,25,Imperial,2009,76558,54882,21676,28.3
6,27,Inyo,2009,9427,8546,881,9.3
6,29,Kern,2009,365111,311671,53440,14.6
6,31,Kings,2009,60891,51870,9021,14.8
6,33,Lake,2009,25551,21563,3988,15.6
6,35,Lassen,2009,13642,11892,1750,12.8
6,37,Los Angeles,2009,4936966,4357147,579819,11.7
6,39,Madera,2009,66889,57591,9298,13.9
6,41,Marin,2009,132442,122046,10396,7.8
6,43,Mariposa,2009,9442,8431,1011,10.7
6,45,Mendocino,2009,43508,38951,4557,10.5
6,47,Merced,2009,106193,87855,18338,17.3
6,49,Modoc,2009,4067,3555,512,12.6
6,51,Mono,2009,8771,7968,803,9.2
6,53,Monterey,2009,216502,190569,25933,12.0
6,55,Napa,2009,75854,69233,6621,8.7
6,57,Nevada,2009,50620,45199,5421,10.7
6,59,Orange,2009,1595687,1451508,144179,9.0
6,61,Placer,2009,180575,161396,19179,10.6
6,63,Plumas,2009,10087,8474,1613,16.0
6,65,Riverside,2009,921434,795712,125722,13.6
6,67,Sacramento,2009,684611,605996,78615,11.5
6,69,San Benito,2009,25026,21390,3636,14.5
6,71,San Bernardino,2009,862804,749047,113757,13.2
6,73,San Diego,2009,1561162,1408178,152984,9.8
6,75,San Francisco/city,2009,461298,419496,41802,9.1
6,77,San Joaquin,2009,299895,253280,46615,15.5
6,79,San Luis Obispo,2009,136937,124356,12581,9.2
6,81,San Mateo,2009,375635,343453,32182,8.6
6,83,Santa Barbara,2009,220831,201849,18982,8.6
6,85,Santa Clara,2009,879339,782289,97050,11.0
6,87,Santa Cruz,2009,148422,131288,17134,11.5
6,89,Shasta,2009,84524,71911,12613,14.9
6,91,Sierra,2009,1606,1357,249,15.5
6,93,Siskiyou,2009,19760,16833,2927,14.8
6,95,Solano,2009,215564,192203,23361,10.8
6,97,Sonoma,2009,257651,232371,25280,9.8
6,99,Stanislaus,2009,236170,198080,38090,16.1
6,101,Sutter,2009,42204,34987,7217,17.1
6,103,Tehama,2009,25506,21884,3622,14.2
6,105,Trinity,2009,5024,4148,876,17.4
6,107,Tulare,2009,204579,172976,31603,15.4
6,109,Tuolumne,2009,25871,22592,3279,12.7
6,111,Ventura,2009,432230,388774,43456,10.1
6,113,Yolo,2009,99246,87851,11395,11.5
6,115,Yuba,2009,28573,23572,5001,17.5
8,1,Adams,2009,229197,208259,20938,9.1
8,3,Alamosa,2009,8954,8343,611,6.8
8,5,Arapahoe,2009,313359,288803,24556,7.8
8,7,Archuleta,2009,6353,5841,512,8.1
8,9,Baca,2009,2591,2489,102,3.9
8,11,Bent,2009,2686,2497,189,7.0
8,13,Boulder,2009,175833,164180,11653,6.6
8,14,Broomfield/city,2009,30919,28620,2299,7.4
8,15,Chaffee,2009,8593,8009,584,6.8
8,17,Cheyenne,2009,1371,1333,38,2.8
8,19,Clear Creek,2009,5441,5018,423,7.8
8,21,Conejos,2009,3749,3449,300,8.0
8,23,Costilla,2009,1384,1249,135,9.8
8,25,Crowley,2009,1996,1810,186,9.3
8,27,Custer,2009,2043,1905,138,6.8
8,29,Delta,2009,17017,15704,1313,7.7
8,31,Denver/city,2009,325469,296981,28488,8.8
8,33,Dolores,2009,1052,903,149,14.2
8,35,Douglas,2009,161640,150859,10781,6.7
8,37,Eagle,2009,30603,28284,2319,7.6
8,39,Elbert,2009,12967,11986,981,7.6
8,41,El Paso,2009,301220,275602,25618,8.5
8,43,Fremont,2009,20059,18214,1845,9.2
8,45,Garfield,2009,34775,32161,2614,7.5
8,47,Gilpin,2009,3682,3441,241,6.5
8,49,Grand,2009,9073,8418,655,7.2
8,51,Gunnison,2009,9438,8883,555,5.9
8,53,Hinsdale,2009,664,641,23,3.5
8,55,Huerfano,2009,3503,3174,329,9.4
8,57,Jackson,2009,1293,1235,58,4.5
8,59,Jefferson,2009,304742,281264,23478,7.7
8,61,Kiowa,2009,1002,956,46,4.6
8,63,Kit Carson,2009,4859,4653,206,4.2
8,65,Lake,2009,3920,3558,362,9.2
8,67,La Plata,2009,31353,29527,1826,5.8
8,69,Larimer,2009,177237,165232,12005,6.8
8,71,Las Animas,2009,8649,7889,760,8.8
8,73,Lincoln,2009,3108,2969,139,4.5
8,75,Logan,2009,12040,11393,647,5.4
8,77,Mesa,2009,82368,74934,7434,9.0
8,79,Mineral,2009,479,445,34,7.1
8,81,Moffat,2009,9093,8482,611,6.7
8,83,Montezuma,2009,13308,12253,1055,7.9
8,85,Montrose,2009,21175,19322,1853,8.8
8,87,Morgan,2009,15101,14221,880,5.8
8,89,Otero,2009,9330,8640,690,7.4
8,91,Ouray,2009,2905,2729,176,6.1
8,93,Park,2009,9360,8656,704,7.5
8,95,Phillips,2009,2606,2505,101,3.9
8,97,Pitkin,2009,11161,10435,726,6.5
8,99,Prowers,2009,7019,6577,442,6.3
8,101,Pueblo,2009,74910,68290,6620,8.8
8,103,Rio Blanco,2009,4662,4416,246,5.3
8,105,Rio Grande,2009,6799,6352,447,6.6
8,107,Routt,2009,15272,14197,1075,7.0
8,109,Saguache,2009,3433,3136,297,8.7
8,111,San Juan,2009,557,513,44,7.9
8,113,San Miguel,2009,5230,4894,336,6.4
8,115,Sedgwick,2009,1719,1649,70,4.1
8,117,Summit,2009,16673,15578,1095,6.6
8,119,Teller,2009,12137,11147,990,8.2
8,121,Washington,2009,2983,2854,129,4.3
8,123,Weld,2009,121392,110676,10716,8.8
8,125,Yuma,2009,7107,6852,255,3.6
9,1,Fairfield,2009,471164,434256,36908,7.8
9,3,Hartford,2009,464189,423624,40565,8.7
9,5,Litchfield,2009,105572,96847,8725,8.3
9,7,Middlesex,2009,94949,88320,6629,7.0
9,9,New Haven,2009,450352,409934,40418,9.0
9,11,New London,2009,150711,138935,11776,7.8
9,13,Tolland,2009,86378,80367,6011,7.0
9,15,Windham,2009,65070,59083,5987,9.2
10,1,Kent,2009,73933,67857,6076,8.2
10,3,New Castle,2009,271845,248960,22885,8.4
10,5,Sussex,2009,92605,84901,7704,8.3
11,1,District of Colu,2009,338113,304277,33836,10.0
12,1,Alachua,2009,128714,120235,8479,6.6
12,3,Baker,2009,11979,10856,1123,9.4
12,5,Bay,2009,87890,80463,7427,8.5
12,7,Bradford,2009,12356,11434,922,7.5
12,9,Brevard,2009,263752,238302,25450,9.6
12,11,Broward,2009,970562,888508,82054,8.5
12,13,Calhoun,2009,5859,5397,462,7.9
12,15,Charlotte,2009,67995,60508,7487,11.0
12,17,Citrus,2009,56040,49750,6290,11.2
12,19,Clay,2009,93803,85748,8055,8.6
12,21,Collier,2009,141675,127073,14602,10.3
12,23,Columbia,2009,31274,28592,2682,8.6
12,27,DeSoto,2009,14806,13420,1386,9.4
12,29,Dixie,2009,5515,4930,585,10.6
12,31,Duval,2009,436659,394060,42599,9.8
12,33,Escambia,2009,135551,123155,12396,9.1
12,35,Flagler,2009,32247,27830,4417,13.7
12,37,Franklin,2009,4875,4541,334,6.9
12,39,Gadsden,2009,21030,19092,1938,9.2
12,41,Gilchrist,2009,7633,6973,660,8.6
12,43,Glades,2009,4793,4381,412,8.6
12,45,Gulf,2009,6294,5737,557,8.8
12,47,Hamilton,2009,4790,4294,496,10.4
12,49,Hardee,2009,11831,10671,1160,9.8
12,51,Hendry,2009,16951,14702,2249,13.3
12,53,Hernando,2009,61470,53902,7568,12.3
12,55,Highlands,2009,40018,36011,4007,10.0
12,57,Hillsborough,2009,590111,532167,57944,9.8
12,59,Holmes,2009,8800,8150,650,7.4
12,61,Indian River,2009,61483,54107,7376,12.0
12,63,Jackson,2009,21763,20270,1493,6.9
12,65,Jefferson,2009,6515,6024,491,7.5
12,67,Lafayette,2009,3046,2836,210,6.9
12,69,Lake,2009,134272,120405,13867,10.3
12,71,Lee,2009,275235,243832,31403,11.4
12,73,Leon,2009,146115,136571,9544,6.5
12,75,Levy,2009,16539,14782,1757,10.6
12,77,Liberty,2009,3839,3634,205,5.3
12,79,Madison,2009,7059,6360,699,9.9
12,81,Manatee,2009,140663,125543,15120,10.7
12,83,Marion,2009,133492,117671,15821,11.9
12,85,Martin,2009,62196,55865,6331,10.2
12,86,Miami-Dade,2009,1191175,1083040,108135,9.1
12,87,Monroe,2009,45003,42158,2845,6.3
12,89,Nassau,2009,35542,32376,3166,8.9
12,91,Okaloosa,2009,95578,89244,6334,6.6
12,93,Okeechobee,2009,17975,15994,1981,11.0
12,95,Orange,2009,589318,532347,56971,9.7
12,97,Osceola,2009,137167,122861,14306,10.4
12,99,Palm Beach,2009,608457,548109,60348,9.9
12,101,Pasco,2009,192835,171526,21309,11.1
12,103,Pinellas,2009,435605,392019,43586,10.0
12,105,Polk,2009,269910,241636,28274,10.5
12,107,Putnam,2009,31913,28433,3480,10.9
12,109,St. Johns,2009,95640,88208,7432,7.8
12,111,St. Lucie,2009,121977,106794,15183,12.4
12,113,Santa Rosa,2009,69504,63677,5827,8.4
12,115,Sarasota,2009,159852,143057,16795,10.5
12,117,Seminole,2009,233139,211892,21247,9.1
12,119,Sumter,2009,31550,28884,2666,8.5
12,121,Suwannee,2009,17265,15720,1545,8.9
12,123,Taylor,2009,9060,8158,902,10.0
12,125,Union,2009,5341,4968,373,7.0
12,127,Volusia,2009,249544,224533,25011,10.0
12,129,Wakulla,2009,16590,15525,1065,6.4
12,131,Walton,2009,30556,28417,2139,7.0
12,133,Washington,2009,9811,8897,914,9.3
13,1,Appling,2009,9465,8462,1003,10.6
13,3,Atkinson,2009,3301,2785,516,15.6
13,5,Bacon,2009,4646,4188,458,9.9
13,7,Baker,2009,1586,1432,154,9.7
13,9,Baldwin,2009,20444,17789,2655,13.0
13,11,Banks,2009,10550,9704,846,8.0
13,13,Barrow,2009,35260,31340,3920,11.1
13,15,Bartow,2009,46539,40630,5909,12.7
13,17,Ben Hill,2009,7315,6121,1194,16.3
13,19,Berrien,2009,8232,7108,1124,13.7
13,21,Bibb,2009,74697,67084,7613,10.2
13,23,Bleckley,2009,5456,4887,569,10.4
13,25,Brantley,2009,7557,6694,863,11.4
13,27,Brooks,2009,8023,7302,721,9.0
13,29,Bryan,2009,16978,15583,1395,8.2
13,31,Bulloch,2009,32985,29735,3250,9.9
13,33,Burke,2009,9960,8721,1239,12.4
13,35,Butts,2009,10164,8883,1281,12.6
13,37,Calhoun,2009,2347,2071,276,11.8
13,39,Camden,2009,20765,18819,1946,9.4
13,43,Candler,2009,4344,3921,423,9.7
13,45,Carroll,2009,52772,46703,6069,11.5
13,47,Catoosa,2009,34615,31548,3067,8.9
13,49,Charlton,2009,4479,3966,513,11.5
13,51,Chatham,2009,131201,119302,11899,9.1
13,53,Chattahoochee,2009,2630,2222,408,15.5
13,55,Chattooga,2009,10805,9298,1507,13.9
13,57,Cherokee,2009,110278,100023,10255,9.3
13,59,Clarke,2009,64063,58954,5109,8.0
13,61,Clay,2009,1414,1287,127,9.0
13,63,Clayton,2009,133393,116941,16452,12.3
13,65,Clinch,2009,2794,2471,323,11.6
13,67,Cobb,2009,375048,339129,35919,9.6
13,69,Coffee,2009,16437,13794,2643,16.1
13,71,Colquitt,2009,20485,18528,1957,9.6
13,73,Columbia,2009,60839,56425,4414,7.3
13,75,Cook,2009,6985,6051,934,13.4
13,77,Coweta,2009,61383,55051,6332,10.3
13,79,Crawford,2009,6082,5441,641,10.5
13,81,Crisp,2009,9786,8536,1250,12.8
13,83,Dade,2009,8157,7262,895,11.0
13,85,Dawson,2009,11267,10089,1178,10.5
13,87,Decatur,2009,11940,10358,1582,13.2
13,89,DeKalb,2009,381692,341611,40081,10.5
13,91,Dodge,2009,9092,8069,1023,11.3
13,93,Dooly,2009,4841,4337,504,10.4
13,95,Dougherty,2009,42259,37595,4664,11.0
13,97,Douglas,2009,65280,57878,7402,11.3
13,99,Early,2009,5524,4916,608,11.0
13,101,Echols,2009,2203,2036,167,7.6
13,103,Effingham,2009,28604,26131,2473,8.6
13,105,Elbert,2009,10067,8777,1290,12.8
13,107,Emanuel,2009,10582,9397,1185,11.2
13,109,Evans,2009,4959,4504,455,9.2
13,111,Fannin,2009,10825,9634,1191,11.0
13,113,Fayette,2009,51085,46569,4516,8.8
13,115,Floyd,2009,49588,44106,5482,11.1
13,117,Forsyth,2009,87994,80459,7535,8.6
13,119,Franklin,2009,10281,9002,1279,12.4
13,121,Fulton,2009,487473,435814,51659,10.6
13,123,Gilmer,2009,13636,12152,1484,10.9
13,125,Glascock,2009,1135,999,136,12.0
13,127,Glynn,2009,40424,36839,3585,8.9
13,129,Gordon,2009,25563,22092,3471,13.6
13,131,Grady,2009,11774,10575,1199,10.2
13,133,Greene,2009,7601,6697,904,11.9
13,135,Gwinnett,2009,417812,378416,39396,9.4
13,137,Habersham,2009,20263,18138,2125,10.5
13,139,Hall,2009,89747,80925,8822,9.8
13,141,Hancock,2009,3309,2633,676,20.4
13,143,Haralson,2009,12692,11093,1599,12.6
13,145,Harris,2009,16398,15148,1250,7.6
13,147,Hart,2009,10488,9011,1477,14.1
13,149,Heard,2009,4905,4236,669,13.6
13,151,Henry,2009,97451,87496,9955,10.2
13,153,Houston,2009,70754,65411,5343,7.6
13,155,Irwin,2009,4085,3440,645,15.8
13,157,Jackson,2009,27098,23947,3151,11.6
13,159,Jasper,2009,6476,5626,850,13.1
13,161,Jeff Davis,2009,5374,4599,775,14.4
13,163,Jefferson,2009,7131,6052,1079,15.1
13,165,Jenkins,2009,2740,2182,558,20.4
13,167,Johnson,2009,3551,3086,465,13.1
13,169,Jones,2009,14324,13037,1287,9.0
13,171,Lamar,2009,8157,7000,1157,14.2
13,173,Lanier,2009,4142,3748,394,9.5
13,175,Laurens,2009,22096,19504,2592,11.7
13,177,Lee,2009,18171,16791,1380,7.6
13,179,Liberty,2009,26006,23691,2315,8.9
13,181,Lincoln,2009,3907,3461,446,11.4
13,183,Long,2009,6649,6193,456,6.9
13,185,Lowndes,2009,53914,49118,4796,8.9
13,187,Lumpkin,2009,13331,11691,1640,12.3
13,189,McDuffie,2009,10811,9519,1292,12.0
13,191,McIntosh,2009,5281,4720,561,10.6
13,193,Macon,2009,5207,4531,676,13.0
13,195,Madison,2009,15790,14346,1444,9.1
13,197,Marion,2009,3320,2974,346,10.4
13,199,Meriwether,2009,9477,8112,1365,14.4
13,201,Miller,2009,3615,3286,329,9.1
13,205,Mitchell,2009,10405,9313,1092,10.5
13,207,Monroe,2009,13805,12491,1314,9.5
13,209,Montgomery,2009,4486,4064,422,9.4
13,211,Morgan,2009,9355,8378,977,10.4
13,213,Murray,2009,19773,17087,2686,13.6
13,215,Muscogee,2009,86139,77931,8208,9.5
13,217,Newton,2009,47203,41151,6052,12.8
13,219,Oconee,2009,18564,17351,1213,6.5
13,221,Oglethorpe,2009,7817,7121,696,8.9
13,223,Paulding,2009,68007,60796,7211,10.6
13,225,Peach,2009,12353,11014,1339,10.8
13,227,Pickens,2009,15117,13438,1679,11.1
13,229,Pierce,2009,8684,7829,855,9.8
13,231,Pike,2009,8088,7160,928,11.5
13,233,Polk,2009,21218,18822,2396,11.3
13,235,Pulaski,2009,4357,4000,357,8.2
13,237,Putnam,2009,10387,9194,1193,11.5
13,239,Quitman,2009,970,849,121,12.5
13,241,Rabun,2009,6976,6217,759,10.9
13,243,Randolph,2009,2758,2407,351,12.7
13,245,Richmond,2009,91347,81671,9676,10.6
13,247,Rockdale,2009,40213,35522,4691,11.7
13,249,Schley,2009,1908,1654,254,13.3
13,251,Screven,2009,7327,6241,1086,14.8
13,253,Seminole,2009,4096,3633,463,11.3
13,255,Spalding,2009,28987,24689,4298,14.8
13,257,Stephens,2009,13912,12365,1547,11.1
13,259,Stewart,2009,2319,2061,258,11.1
13,261,Sumter,2009,14423,12464,1959,13.6
13,263,Talbot,2009,3127,2817,310,9.9
13,265,Taliaferro,2009,835,708,127,15.2
13,267,Tattnall,2009,9359,8475,884,9.4
13,269,Taylor,2009,3557,3114,443,12.5
13,271,Telfair,2009,4630,3956,674,14.6
13,273,Terrell,2009,4448,3965,483,10.9
13,275,Thomas,2009,21424,19357,2067,9.6
13,277,Tift,2009,18905,16734,2171,11.5
13,279,Toombs,2009,13923,12479,1444,10.4
13,281,Towns,2009,5741,5217,524,9.1
13,283,Treutlen,2009,2932,2580,352,12.0
13,285,Troup,2009,30989,26804,4185,13.5
13,287,Turner,2009,4641,3958,683,14.7
13,289,Twiggs,2009,4661,4121,540,11.6
13,291,Union,2009,10991,9900,1091,9.9
13,293,Upson,2009,11942,10325,1617,13.5
13,295,Walker,2009,32248,28556,3692,11.4
13,297,Walton,2009,41524,37002,4522,10.9
13,299,Ware,2009,14915,13217,1698,11.4
13,301,Warren,2009,2637,2139,498,18.9
13,303,Washington,2009,7939,6801,1138,14.3
13,305,Wayne,2009,12073,10586,1487,12.3
13,307,Webster,2009,1194,1069,125,10.5
13,309,Wheeler,2009,2933,2637,296,10.1
13,311,White,2009,12397,11127,1270,10.2
13,313,Whitfield,2009,44219,38312,5907,13.4
13,315,Wilcox,2009,3259,2849,410,12.6
13,317,Wilkes,2009,4504,3942,562,12.5
13,319,Wilkinson,2009,4634,4095,539,11.6
13,321,Worth,2009,10166,9092,1074,10.6
15,1,Hawaii,2009,83751,75769,7982,9.5
15,3,Honolulu/city,2009,440309,415520,24789,5.6
15,7,Kauai,2009,31942,29026,2916,9.1
15,9,Maui,2009,75969,69483,6486,8.5
16,1,Ada,2009,198030,180477,17553,8.9
16,3,Adams,2009,2143,1792,351,16.4
16,5,Bannock,2009,39682,36584,3098,7.8
16,7,Bear Lake,2009,3394,3193,201,5.9
16,9,Benewah,2009,4214,3581,633,15.0
16,11,Bingham,2009,22016,20573,1443,6.6
16,13,Blaine,2009,13462,12340,1122,8.3
16,15,Boise,2009,3414,3107,307,9.0
16,17,Bonner,2009,21143,18795,2348,11.1
16,19,Bonneville,2009,50490,47286,3204,6.3
16,21,Boundary,2009,4450,3846,604,13.6
16,23,Butte,2009,1484,1399,85,5.7
16,25,Camas,2009,603,540,63,10.4
16,27,Canyon,2009,85964,76313,9651,11.2
16,29,Caribou,2009,3494,3262,232,6.6
16,31,Cassia,2009,10277,9666,611,5.9
16,33,Clark,2009,554,521,33,6.0
16,35,Clearwater,2009,3556,3028,528,14.8
16,37,Custer,2009,2701,2536,165,6.1
16,39,Elmore,2009,11506,10528,978,8.5
16,41,Franklin,2009,5844,5521,323,5.5
16,43,Fremont,2009,5601,5103,498,8.9
16,45,Gem,2009,7047,6223,824,11.7
16,47,Gooding,2009,8453,7927,526,6.2
16,49,Idaho,2009,7425,6599,826,11.1
16,51,Jefferson,2009,11603,10789,814,7.0
16,53,Jerome,2009,10539,9791,748,7.1
16,55,Kootenai,2009,71593,64368,7225,10.1
16,57,Latah,2009,17947,16729,1218,6.8
16,59,Lemhi,2009,4012,3649,363,9.0
16,61,Lewis,2009,1795,1686,109,6.1
16,63,Lincoln,2009,2607,2295,312,12.0
16,65,Madison,2009,16185,15204,981,6.1
16,67,Minidoka,2009,9576,8935,641,6.7
16,69,Nez Perce,2009,18866,17589,1277,6.8
16,71,Oneida,2009,2242,2101,141,6.3
16,73,Owyhee,2009,4365,4171,194,4.4
16,75,Payette,2009,11103,10003,1100,9.9
16,77,Power,2009,3489,3206,283,8.1
16,79,Shoshone,2009,6362,5462,900,14.1
16,81,Teton,2009,5333,4963,370,6.9
16,83,Twin Falls,2009,39357,36613,2744,7.0
16,85,Valley,2009,4753,4067,686,14.4
16,87,Washington,2009,4964,4473,491,9.9
17,1,Adams,2009,38148,35339,2809,7.4
17,3,Alexander,2009,2993,2623,370,12.4
17,5,Bond,2009,8540,7689,851,10.0
17,7,Boone,2009,26063,22006,4057,15.6
17,9,Brown,2009,3454,3297,157,4.5
17,11,Bureau,2009,19209,17167,2042,10.6
17,13,Calhoun,2009,2479,2228,251,10.1
17,15,Carroll,2009,8267,7361,906,11.0
17,17,Cass,2009,7660,7124,536,7.0
17,19,Champaign,2009,104941,96130,8811,8.4
17,21,Christian,2009,17674,15891,1783,10.1
17,23,Clark,2009,8094,7028,1066,13.2
17,25,Clay,2009,6451,5634,817,12.7
17,27,Clinton,2009,18598,17008,1590,8.5
17,29,Coles,2009,27597,25068,2529,9.2
17,31,Cook,2009,2598079,2326339,271740,10.5
17,33,Crawford,2009,9695,8723,972,10.0
17,35,Cumberland,2009,5553,5003,550,9.9
17,37,DeKalb,2009,59996,53939,6057,10.1
17,39,De Witt,2009,8793,8037,756,8.6
17,41,Douglas,2009,10190,9292,898,8.8
17,43,DuPage,2009,524449,479866,44583,8.5
17,45,Edgar,2009,10146,9095,1051,10.4
17,47,Edwards,2009,3099,2813,286,9.2
17,49,Effingham,2009,18093,16624,1469,8.1
17,51,Fayette,2009,10094,8972,1122,11.1
17,53,Ford,2009,7080,6366,714,10.1
17,55,Franklin,2009,17640,15320,2320,13.2
17,57,Fulton,2009,18452,16336,2116,11.5
17,59,Gallatin,2009,2620,2356,264,10.1
17,61,Greene,2009,6756,6186,570,8.4
17,63,Grundy,2009,26629,23403,3226,12.1
17,65,Hamilton,2009,4059,3674,385,9.5
17,67,Hancock,2009,9415,8359,1056,11.2
17,69,Hardin,2009,1755,1561,194,11.1
17,71,Henderson,2009,3790,3425,365,9.6
17,73,Henry,2009,26698,24226,2472,9.3
17,75,Iroquois,2009,16704,15088,1616,9.7
17,77,Jackson,2009,32026,29666,2360,7.4
17,79,Jasper,2009,4929,4472,457,9.3
17,81,Jefferson,2009,20541,18559,1982,9.6
17,83,Jersey,2009,11513,10422,1091,9.5
17,85,Jo Daviess,2009,13047,11865,1182,9.1
17,87,Johnson,2009,5081,4542,539,10.6
17,89,Kane,2009,270542,242013,28529,10.5
17,91,Kankakee,2009,56061,49140,6921,12.3
17,93,Kendall,2009,60203,54158,6045,10.0
17,95,Knox,2009,25910,23392,2518,9.7
17,97,Lake,2009,362202,326251,35951,9.9
17,99,LaSalle,2009,59291,52000,7291,12.3
17,101,Lawrence,2009,8161,7335,826,10.1
17,103,Lee,2009,18260,16331,1929,10.6
17,105,Livingston,2009,19243,17247,1996,10.4
17,107,Logan,2009,13317,12072,1245,9.3
17,109,McDonough,2009,16904,15440,1464,8.7
17,111,McHenry,2009,180692,163110,17582,9.7
17,113,McLean,2009,91225,84563,6662,7.3
17,115,Macon,2009,54681,48357,6324,11.6
17,117,Macoupin,2009,23945,21385,2560,10.7
17,119,Madison,2009,138151,123884,14267,10.3
17,121,Marion,2009,18293,16092,2201,12.0
17,123,Marshall,2009,7098,6347,751,10.6
17,125,Mason,2009,7554,6617,937,12.4
17,127,Massac,2009,7141,6494,647,9.1
17,129,Menard,2009,6886,6371,515,7.5
17,131,Mercer,2009,8626,7728,898,10.4
17,133,Monroe,2009,18362,16917,1445,7.9
17,135,Montgomery,2009,13300,11706,1594,12.0
17,137,Morgan,2009,17522,16094,1428,8.1
17,139,Moultrie,2009,7835,7147,688,8.8
17,141,Ogle,2009,27441,23995,3446,12.6
17,143,Peoria,2009,97422,86594,10828,11.1
17,145,Perry,2009,9388,8253,1135,12.1
17,147,Piatt,2009,8855,8140,715,8.1
17,149,Pike,2009,8446,7759,687,8.1
17,151,Pope,2009,1896,1698,198,10.4
17,153,Pulaski,2009,2838,2520,318,11.2
17,155,Putnam,2009,3298,2847,451,13.7
17,157,Randolph,2009,15162,13748,1414,9.3
17,159,Richland,2009,7256,6520,736,10.1
17,161,Rock Island,2009,77625,70410,7215,9.3
17,163,St. Clair,2009,123698,110095,13603,11.0
17,165,Saline,2009,12624,11362,1262,10.0
17,167,Sangamon,2009,107466,99377,8089,7.5
17,169,Schuyler,2009,4216,3930,286,6.8
17,171,Scott,2009,2702,2490,212,7.8
17,173,Shelby,2009,11109,10005,1104,9.9
17,175,Stark,2009,2830,2534,296,10.5
17,177,Stephenson,2009,25017,22140,2877,11.5
17,179,Tazewell,2009,72885,65134,7751,10.6
17,181,Union,2009,8092,7178,914,11.3
17,183,Vermilion,2009,37046,32735,4311,11.6
17,185,Wabash,2009,6031,5399,632,10.5
17,187,Warren,2009,9205,8512,693,7.5
17,189,Washington,2009,8048,7390,658,8.2
17,191,Wayne,2009,8113,7297,816,10.1
17,193,White,2009,7675,7009,666,8.7
17,195,Whiteside,2009,30340,27172,3168,10.4
17,197,Will,2009,366000,328507,37493,10.2
17,199,Williamson,2009,34559,31333,3226,9.3
17,201,Winnebago,2009,144667,122725,21942,15.2
17,203,Woodford,2009,21183,19423,1760,8.3
18,1,Adams,2009,15237,12979,2258,14.8
18,3,Allen,2009,179446,160367,19079,10.6
18,5,Bartholomew,2009,38710,34947,3763,9.7
18,7,Benton,2009,4313,3877,436,10.1
18,9,Blackford,2009,6462,5541,921,14.3
18,11,Boone,2009,28469,26230,2239,7.9
18,13,Brown,2009,7504,6747,757,10.1
18,15,Carroll,2009,10087,9001,1086,10.8
18,17,Cass,2009,18865,16564,2301,12.2
18,19,Clark,2009,56399,51409,4990,8.8
18,21,Clay,2009,13099,11602,1497,11.4
18,23,Clinton,2009,17069,15203,1866,10.9
18,25,Crawford,2009,5254,4600,654,12.4
18,27,Daviess,2009,15026,14130,896,6.0
18,29,Dearborn,2009,26275,23657,2618,10.0
18,31,Decatur,2009,12720,11119,1601,12.6
18,33,DeKalb,2009,20508,17665,2843,13.9
18,35,Delaware,2009,55728,49694,6034,10.8
18,37,Dubois,2009,22200,20518,1682,7.6
18,39,Elkhart,2009,91469,74872,16597,18.1
18,41,Fayette,2009,9931,8404,1527,15.4
18,43,Floyd,2009,38232,34915,3317,8.7
18,45,Fountain,2009,8469,7380,1089,12.9
18,47,Franklin,2009,11681,10436,1245,10.7
18,49,Fulton,2009,10075,8773,1302,12.9
18,51,Gibson,2009,16857,15356,1501,8.9
18,53,Grant,2009,33306,29335,3971,11.9
18,55,Greene,2009,16096,14704,1392,8.6
18,57,Hamilton,2009,146050,136275,9775,6.7
18,59,Hancock,2009,36346,33199,3147,8.7
18,61,Harrison,2009,19662,17825,1837,9.3
18,63,Hendricks,2009,74142,68405,5737,7.7
18,65,Henry,2009,22953,20004,2949,12.8
18,67,Howard,2009,35899,30512,5387,15.0
18,69,Huntington,2009,19878,17294,2584,13.0
18,71,Jackson,2009,21405,18986,2419,11.3
18,73,Jasper,2009,15796,14164,1632,10.3
18,75,Jay,2009,11448,10138,1310,11.4
18,77,Jefferson,2009,16691,14850,1841,11.0
18,79,Jennings,2009,13730,11835,1895,13.8
18,81,Johnson,2009,75019,68719,6300,8.4
18,83,Knox,2009,19944,18442,1502,7.5
18,85,Kosciusko,2009,41700,36465,5235,12.6
18,87,LaGrange,2009,15676,12906,2770,17.7
18,89,Lake,2009,227636,203038,24598,10.8
18,91,LaPorte,2009,52969,46596,6373,12.0
18,93,Lawrence,2009,21936,19001,2935,13.4
18,95,Madison,2009,62823,55867,6956,11.1
18,97,Marion,2009,460644,417053,43591,9.5
18,99,Marshall,2009,22715,19601,3114,13.7
18,101,Martin,2009,5254,4866,388,7.4
18,103,Miami,2009,16306,13911,2395,14.7
18,105,Monroe,2009,70999,66334,4665,6.6
18,107,Montgomery,2009,18919,16972,1947,10.3
18,109,Morgan,2009,36876,33436,3440,9.3
18,111,Newton,2009,6884,6102,782,11.4
18,113,Noble,2009,22349,18456,3893,17.4
18,115,Ohio,2009,3110,2770,340,10.9
18,117,Orange,2009,10524,9382,1142,10.9
18,119,Owen,2009,11616,10504,1112,9.6
18,121,Parke,2009,8089,7267,822,10.2
18,123,Perry,2009,9685,8681,1004,10.4
18,125,Pike,2009,5890,5319,571,9.7
18,127,Porter,2009,84794,76748,8046,9.5
18,129,Posey,2009,13265,12166,1099,8.3
18,131,Pulaski,2009,6798,6078,720,10.6
18,133,Putnam,2009,17344,15422,1922,11.1
18,135,Randolph,2009,12942,11371,1571,12.1
18,137,Ripley,2009,13863,12340,1523,11.0
18,139,Rush,2009,9150,8175,975,10.7
18,141,St. Joseph,2009,130031,114865,15166,11.7
18,143,Scott,2009,11032,9585,1447,13.1
18,145,Shelby,2009,23815,21291,2524,10.6
18,147,Spencer,2009,10459,9481,978,9.4
18,149,Starke,2009,10813,9256,1557,14.4
18,151,Steuben,2009,16431,14004,2427,14.8
18,153,Sullivan,2009,8911,8013,898,10.1
18,155,Switzerland,2009,5710,5251,459,8.0
18,157,Tippecanoe,2009,84835,76989,7846,9.2
18,159,Tipton,2009,7272,6310,962,13.2
18,161,Union,2009,3552,3183,369,10.4
18,163,Vanderburgh,2009,91197,83593,7604,8.3
18,165,Vermillion,2009,8033,7047,986,12.3
18,167,Vigo,2009,51316,46050,5266,10.3
18,169,Wabash,2009,16455,14274,2181,13.3
18,171,Warren,2009,4679,4181,498,10.6
18,173,Warrick,2009,31292,28844,2448,7.8
18,175,Washington,2009,14143,12426,1717,12.1
18,177,Wayne,2009,32534,28459,4075,12.5
18,179,Wells,2009,14324,12772,1552,10.8
18,181,White,2009,12516,11111,1405,11.2
18,183,Whitley,2009,17988,15691,2297,12.8
19,1,Adair,2009,4212,3969,243,5.8
19,3,Adams,2009,2142,2011,131,6.1
19,5,Allamakee,2009,7511,6744,767,10.2
19,7,Appanoose,2009,6206,5668,538,8.7
19,9,Audubon,2009,3271,3080,191,5.8
19,11,Benton,2009,14654,13730,924,6.3
19,13,Black Hawk,2009,74537,69984,4553,6.1
19,15,Boone,2009,15724,14791,933,5.9
19,17,Bremer,2009,13806,13059,747,5.4
19,19,Buchanan,2009,11163,10425,738,6.6
19,21,Buena Vista,2009,10711,10149,562,5.2
19,23,Butler,2009,8450,7895,555,6.6
19,25,Calhoun,2009,5239,4969,270,5.2
19,27,Carroll,2009,12309,11791,518,4.2
19,29,Cass,2009,7624,7109,515,6.8
19,31,Cedar,2009,11386,10750,636,5.6
19,33,Cerro Gordo,2009,25407,23646,1761,6.9
19,35,Cherokee,2009,6574,6273,301,4.6
19,37,Chickasaw,2009,6918,6305,613,8.9
19,39,Clarke,2009,4907,4534,373,7.6
19,41,Clay,2009,9525,8877,648,6.8
19,43,Clayton,2009,9934,9083,851,8.6
19,45,Clinton,2009,28056,26021,2035,7.3
19,47,Crawford,2009,9500,9060,440,4.6
19,49,Dallas,2009,34776,33059,1717,4.9
19,51,Davis,2009,4030,3662,368,9.1
19,53,Decatur,2009,4178,3897,281,6.7
19,55,Delaware,2009,10816,10090,726,6.7
19,57,Des Moines,2009,21059,19367,1692,8.0
19,59,Dickinson,2009,9329,8665,664,7.1
19,61,Dubuque,2009,52584,49113,3471,6.6
19,63,Emmet,2009,5836,5353,483,8.3
19,65,Fayette,2009,10908,9969,939,8.6
19,67,Floyd,2009,8516,7771,745,8.7
19,69,Franklin,2009,5844,5412,432,7.4
19,71,Fremont,2009,3772,3513,259,6.9
19,73,Greene,2009,5090,4791,299,5.9
19,75,Grundy,2009,6914,6511,403,5.8
19,77,Guthrie,2009,5697,5339,358,6.3
19,79,Hamilton,2009,8212,7586,626,7.6
19,81,Hancock,2009,5617,5056,561,10.0
19,83,Hardin,2009,9314,8703,611,6.6
19,85,Harrison,2009,7655,7276,379,5.0
19,87,Henry,2009,9802,8889,913,9.3
19,89,Howard,2009,5066,4621,445,8.8
19,91,Humboldt,2009,5122,4818,304,5.9
19,93,Ida,2009,3961,3746,215,5.4
19,95,Iowa,2009,8543,7935,608,7.1
19,97,Jackson,2009,11171,10237,934,8.4
19,99,Jasper,2009,17724,16204,1520,8.6
19,101,Jefferson,2009,8221,7513,708,8.6
19,103,Johnson,2009,80234,76661,3573,4.5
19,105,Jones,2009,10709,9943,766,7.2
19,107,Keokuk,2009,5676,5223,453,8.0
19,109,Kossuth,2009,8925,8401,524,5.9
19,111,Lee,2009,17327,15553,1774,10.2
19,113,Linn,2009,122438,115018,7420,6.1
19,115,Louisa,2009,5946,5454,492,8.3
19,117,Lucas,2009,4661,4363,298,6.4
19,119,Lyon,2009,6880,6585,295,4.3
19,121,Madison,2009,8225,7671,554,6.7
19,123,Mahaska,2009,11779,10804,975,8.3
19,125,Marion,2009,17380,16221,1159,6.7
19,127,Marshall,2009,20496,18996,1500,7.3
19,129,Mills,2009,7914,7551,363,4.6
19,131,Mitchell,2009,5800,5459,341,5.9
19,133,Monona,2009,4540,4200,340,7.5
19,135,Monroe,2009,4310,3983,327,7.6
19,137,Montgomery,2009,5239,4771,468,8.9
19,139,Muscatine,2009,23730,21668,2062,8.7
19,141,O'Brien,2009,7840,7425,415,5.3
19,143,Osceola,2009,3304,3100,204,6.2
19,145,Page,2009,7815,7145,670,8.6
19,147,Palo Alto,2009,5288,4913,375,7.1
19,149,Plymouth,2009,14410,13739,671,4.7
19,151,Pocahontas,2009,4107,3871,236,5.7
19,153,Polk,2009,242474,227606,14868,6.1
19,155,Pottawattamie,2009,48075,45622,2453,5.1
19,157,Poweshiek,2009,10237,9539,698,6.8
19,159,Ringgold,2009,2438,2303,135,5.5
19,161,Sac,2009,5764,5471,293,5.1
19,163,Scott,2009,90024,83653,6371,7.1
19,165,Shelby,2009,7554,7251,303,4.0
19,167,Sioux,2009,19600,18747,853,4.4
19,169,Story,2009,49059,46733,2326,4.7
19,171,Tama,2009,8919,8275,644,7.2
19,173,Taylor,2009,3356,3126,230,6.9
19,175,Union,2009,6890,6436,454,6.6
19,177,Van Buren,2009,3827,3490,337,8.8
19,179,Wapello,2009,18792,17148,1644,8.7
19,181,Warren,2009,25754,24241,1513,5.9
19,183,Washington,2009,11851,11193,658,5.6
19,185,Wayne,2009,3216,3013,203,6.3
19,187,Webster,2009,19699,18238,1461,7.4
19,189,Winnebago,2009,5735,5195,540,9.4
19,191,Winneshiek,2009,12192,11430,762,6.3
19,193,Woodbury,2009,55653,52487,3166,5.7
19,195,Worth,2009,4457,4139,318,7.1
19,197,Wright,2009,7004,6488,516,7.4
20,1,Allen,2009,7509,6919,590,7.9
20,3,Anderson,2009,4465,4123,342,7.7
20,5,Atchison,2009,8829,8013,816,9.2
20,7,Barber,2009,2910,2780,130,4.5
20,9,Barton,2009,15987,15082,905,5.7
20,11,Bourbon,2009,8761,8148,613,7.0
20,13,Brown,2009,5892,5558,334,5.7
20,15,Butler,2009,32594,30188,2406,7.4
20,17,Chase,2009,1541,1459,82,5.3
20,19,Chautauqua,2009,1861,1697,164,8.8
20,21,Cherokee,2009,11564,10587,977,8.4
20,23,Cheyenne,2009,1524,1470,54,3.5
20,25,Clark,2009,1275,1227,48,3.8
20,27,Clay,2009,5269,5033,236,4.5
20,29,Cloud,2009,5794,5537,257,4.4
20,31,Coffey,2009,5555,5232,323,5.8
20,33,Comanche,2009,1102,1062,40,3.6
20,35,Cowley,2009,18517,17225,1292,7.0
20,37,Crawford,2009,20152,18422,1730,8.6
20,39,Decatur,2009,1808,1741,67,3.7
20,41,Dickinson,2009,10877,10308,569,5.2
20,43,Doniphan,2009,4618,4135,483,10.5
20,45,Douglas,2009,62953,59337,3616,5.7
20,47,Edwards,2009,1797,1721,76,4.2
20,49,Elk,2009,1522,1397,125,8.2
20,51,Ellis,2009,18020,17317,703,3.9
20,53,Ellsworth,2009,3859,3697,162,4.2
20,55,Finney,2009,19666,18798,868,4.4
20,57,Ford,2009,18851,18189,662,3.5
20,59,Franklin,2009,13609,12357,1252,9.2
20,61,Geary,2009,14065,13024,1041,7.4
20,63,Gove,2009,1617,1569,48,3.0
20,65,Graham,2009,1479,1413,66,4.5
20,67,Grant,2009,4140,3978,162,3.9
20,69,Gray,2009,3462,3357,105,3.0
20,71,Greeley,2009,730,702,28,3.8
20,73,Greenwood,2009,3566,3327,239,6.7
20,75,Hamilton,2009,1339,1286,53,4.0
20,77,Harper,2009,3455,3279,176,5.1
20,79,Harvey,2009,18194,16907,1287,7.1
20,81,Haskell,2009,2290,2213,77,3.4
20,83,Hodgeman,2009,950,912,38,4.0
20,85,Jackson,2009,7012,6521,491,7.0
20,87,Jefferson,2009,9687,8950,737,7.6
20,89,Jewell,2009,1988,1904,84,4.2
20,91,Johnson,2009,298579,278997,19582,6.6
20,93,Kearny,2009,2165,2069,96,4.4
20,95,Kingman,2009,4615,4355,260,5.6
20,97,Kiowa,2009,1574,1519,55,3.5
20,99,Labette,2009,11616,10615,1001,8.6
20,101,Lane,2009,1138,1100,38,3.3
20,103,Leavenworth,2009,32607,29979,2628,8.1
20,105,Lincoln,2009,2013,1902,111,5.5
20,107,Linn,2009,4517,4010,507,11.2
20,109,Logan,2009,1723,1666,57,3.3
20,111,Lyon,2009,18575,17431,1144,6.2
20,113,McPherson,2009,16873,16035,838,5.0
20,115,Marion,2009,6996,6608,388,5.5
20,117,Marshall,2009,6136,5792,344,5.6
20,119,Meade,2009,2549,2451,98,3.8
20,121,Miami,2009,16085,14760,1325,8.2
20,123,Mitchell,2009,3799,3622,177,4.7
20,125,Montgomery,2009,18665,16821,1844,9.9
20,127,Morris,2009,3074,2859,215,7.0
20,129,Morton,2009,1776,1702,74,4.2
20,131,Nemaha,2009,5898,5656,242,4.1
20,133,Neosho,2009,8700,7964,736,8.5
20,135,Ness,2009,1856,1783,73,3.9
20,137,Norton,2009,2887,2760,127,4.4
20,139,Osage,2009,8506,7843,663,7.8
20,141,Osborne,2009,2289,2187,102,4.5
20,143,Ottawa,2009,3406,3215,191,5.6
20,145,Pawnee,2009,3944,3792,152,3.9
20,147,Phillips,2009,3186,2988,198,6.2
20,149,Pottawatomie,2009,11060,10428,632,5.7
20,151,Pratt,2009,5962,5665,297,5.0
20,153,Rawlins,2009,1314,1262,52,4.0
20,155,Reno,2009,34978,32930,2048,5.9
20,157,Republic,2009,2890,2768,122,4.2
20,159,Rice,2009,6026,5723,303,5.0
20,161,Riley,2009,37414,35742,1672,4.5
20,163,Rooks,2009,2795,2607,188,6.7
20,165,Rush,2009,1698,1601,97,5.7
20,167,Russell,2009,3592,3414,178,5.0
20,169,Saline,2009,31745,29991,1754,5.5
20,171,Scott,2009,2876,2789,87,3.0
20,173,Sedgwick,2009,258448,236624,21824,8.4
20,175,Seward,2009,11115,10570,545,4.9
20,177,Shawnee,2009,94258,88063,6195,6.6
20,179,Sheridan,2009,1598,1552,46,2.9
20,181,Sherman,2009,3784,3632,152,4.0
20,183,Smith,2009,2244,2137,107,4.8
20,185,Stafford,2009,2266,2148,118,5.2
20,187,Stanton,2009,1180,1141,39,3.3
20,189,Stevens,2009,2369,2256,113,4.8
20,191,Sumner,2009,11628,10614,1014,8.7
20,193,Thomas,2009,4294,4133,161,3.7
20,195,Trego,2009,1887,1816,71,3.8
20,197,Wabaunsee,2009,3753,3480,273,7.3
20,199,Wallace,2009,916,861,55,6.0
20,201,Washington,2009,3461,3293,168,4.9
20,203,Wichita,2009,1276,1233,43,3.4
20,205,Wilson,2009,5286,4714,572,10.8
20,207,Woodson,2009,1786,1633,153,8.6
20,209,Wyandotte,2009,70283,62743,7540,10.7
21,1,Adair,2009,9240,8204,1036,11.2
21,3,Allen,2009,8778,7462,1316,15.0
21,5,Anderson,2009,11117,9912,1205,10.8
21,7,Ballard,2009,4106,3680,426,10.4
21,9,Barren,2009,19402,16911,2491,12.8
21,11,Bath,2009,5141,4315,826,16.1
21,13,Bell,2009,9807,8582,1225,12.5
21,15,Boone,2009,64461,58430,6031,9.4
21,17,Bourbon,2009,9282,8347,935,10.1
21,19,Boyd,2009,22778,20781,1997,8.8
21,21,Boyle,2009,12985,11450,1535,11.8
21,23,Bracken,2009,4301,3797,504,11.7
21,25,Breathitt,2009,5688,5083,605,10.6
21,27,Breckinridge,2009,9406,8252,1154,12.3
21,29,Bullitt,2009,39859,35382,4477,11.2
21,31,Butler,2009,5522,4700,822,14.9
21,33,Caldwell,2009,6924,6203,721,10.4
21,35,Calloway,2009,17963,16403,1560,8.7
21,37,Campbell,2009,45146,40460,4686,10.4
21,39,Carlisle,2009,2343,2127,216,9.2
21,41,Carroll,2009,5465,4723,742,13.6
21,43,Carter,2009,13563,11801,1762,13.0
21,45,Casey,2009,7162,6371,791,11.0
21,47,Christian,2009,29485,25702,3783,12.8
21,49,Clark,2009,17083,15126,1957,11.5
21,51,Clay,2009,6990,5995,995,14.2
21,53,Clinton,2009,4860,4382,478,9.8
21,55,Crittenden,2009,4120,3666,454,11.0
21,57,Cumberland,2009,3074,2663,411,13.4
21,59,Daviess,2009,48386,43699,4687,9.7
21,61,Edmonson,2009,5294,4542,752,14.2
21,63,Elliott,2009,3286,2827,459,14.0
21,65,Estill,2009,6433,5598,835,13.0
21,67,Fayette,2009,152340,139945,12395,8.1
21,69,Fleming,2009,6564,5721,843,12.8
21,71,Floyd,2009,15653,13873,1780,11.4
21,73,Franklin,2009,24607,22322,2285,9.3
21,75,Fulton,2009,2692,2336,356,13.2
21,77,Gallatin,2009,4043,3532,511,12.6
21,79,Garrard,2009,7760,6808,952,12.3
21,81,Grant,2009,12894,11345,1549,12.0
21,83,Graves,2009,16383,14683,1700,10.4
21,85,Grayson,2009,11530,9768,1762,15.3
21,87,Green,2009,5698,4997,701,12.3
21,89,Greenup,2009,17906,16170,1736,9.7
21,91,Hancock,2009,4345,3814,531,12.2
21,93,Hardin,2009,47976,42826,5150,10.7
21,95,Harlan,2009,10619,9415,1204,11.3
21,97,Harrison,2009,9417,8300,1117,11.9
21,99,Hart,2009,8352,7452,900,10.8
21,101,Henderson,2009,23356,20762,2594,11.1
21,103,Henry,2009,8000,7124,876,11.0
21,105,Hickman,2009,2129,1933,196,9.2
21,107,Hopkins,2009,23062,20841,2221,9.6
21,109,Jackson,2009,4319,3582,737,17.1
21,111,Jefferson,2009,361153,322958,38195,10.6
21,113,Jessamine,2009,22829,20666,2163,9.5
21,115,Johnson,2009,9944,8877,1067,10.7
21,117,Kenton,2009,84356,75684,8672,10.3
21,119,Knott,2009,6578,5854,724,11.0
21,121,Knox,2009,12899,11342,1557,12.1
21,123,Larue,2009,7018,6152,866,12.3
21,125,Laurel,2009,26586,23761,2825,10.6
21,127,Lawrence,2009,6226,5458,768,12.3
21,129,Lee,2009,2794,2453,341,12.2
21,131,Leslie,2009,3634,3163,471,13.0
21,133,Letcher,2009,8811,7830,981,11.1
21,135,Lewis,2009,5624,4736,888,15.8
21,137,Lincoln,2009,10693,9293,1400,13.1
21,139,Livingston,2009,4784,4291,493,10.3
21,141,Logan,2009,12460,11045,1415,11.4
21,143,Lyon,2009,3373,2941,432,12.8
21,145,McCracken,2009,31554,28668,2886,9.1
21,147,McCreary,2009,5884,5026,858,14.6
21,149,McLean,2009,4572,4073,499,10.9
21,151,Madison,2009,43261,39148,4113,9.5
21,153,Magoffin,2009,4501,3640,861,19.1
21,155,Marion,2009,10204,8799,1405,13.8
21,157,Marshall,2009,14703,13083,1620,11.0
21,159,Martin,2009,3829,3377,452,11.8
21,161,Mason,2009,8846,7847,999,11.3
21,163,Meade,2009,11533,9987,1546,13.4
21,165,Menifee,2009,2615,2168,447,17.1
21,167,Mercer,2009,10479,9241,1238,11.8
21,169,Metcalfe,2009,4411,3694,717,16.3
21,171,Monroe,2009,4770,4081,689,14.4
21,173,Montgomery,2009,12504,10888,1616,12.9
21,175,Morgan,2009,5119,4393,726,14.2
21,177,Muhlenberg,2009,13877,12317,1560,11.2
21,179,Nelson,2009,22206,19345,2861,12.9
21,181,Nicholas,2009,3166,2765,401,12.7
21,183,Ohio,2009,12698,11411,1287,10.1
21,185,Oldham,2009,28104,25655,2449,8.7
21,187,Owen,2009,5548,4982,566,10.2
21,189,Owsley,2009,1580,1407,173,10.9
21,191,Pendleton,2009,7332,6389,943,12.9
21,193,Perry,2009,11669,10368,1301,11.1
21,195,Pike,2009,26397,23747,2650,10.0
21,197,Powell,2009,5777,4843,934,16.2
21,199,Pulaski,2009,27870,24862,3008,10.8
21,201,Robertson,2009,1070,959,111,10.4
21,203,Rockcastle,2009,7283,6279,1004,13.8
21,205,Rowan,2009,12503,11313,1190,9.5
21,207,Russell,2009,8437,7383,1054,12.5
21,209,Scott,2009,22988,20674,2314,10.1
21,211,Shelby,2009,21982,19832,2150,9.8
21,213,Simpson,2009,9268,8021,1247,13.5
21,215,Spencer,2009,9318,8316,1002,10.8
21,217,Taylor,2009,13795,12292,1503,10.9
21,219,Todd,2009,5347,4681,666,12.5
21,221,Trigg,2009,6487,5445,1042,16.1
21,223,Trimble,2009,4367,3834,533,12.2
21,225,Union,2009,7881,6948,933,11.8
21,227,Warren,2009,58693,52622,6071,10.3
21,229,Washington,2009,5431,4697,734,13.5
21,231,Wayne,2009,8572,7344,1228,14.3
21,233,Webster,2009,6467,5819,648,10.0
21,235,Whitley,2009,15703,13856,1847,11.8
21,237,Wolfe,2009,2398,2062,336,14.0
21,239,Woodford,2009,13001,11884,1117,8.6
22,1,Acadia Parish,2009,26214,24527,1687,6.4
22,3,Allen Parish,2009,9106,8254,852,9.4
22,5,Ascension Parish,2009,51599,48546,3053,5.9
22,7,Assumption Parish,2009,10452,9615,837,8.0
22,9,Avoyelles Parish,2009,16443,15214,1229,7.5
22,11,Beauregard Parish,2009,14396,13262,1134,7.9
22,13,Bienville Parish,2009,6272,5673,599,9.6
22,15,Bossier Parish,2009,54029,50786,3243,6.0
22,17,Caddo Parish,2009,119083,109941,9142,7.7
22,19,Calcasieu Parish,2009,92159,86370,5789,6.3
22,21,Caldwell Parish,2009,4608,4169,439,9.5
22,23,Cameron Parish,2009,3118,2935,183,5.9
22,25,Catahoula Parish,2009,4268,3835,433,10.1
22,27,Claiborne Parish,2009,6653,6031,622,9.3
22,29,Concordia Parish,2009,7493,6665,828,11.1
22,31,De Soto Parish,2009,11470,10500,970,8.5
22,33,East Baton Rouge Parish,2009,218317,204829,13488,6.2
22,35,East Carroll Parish,2009,2980,2593,387,13.0
22,37,East Feliciana Parish,2009,8117,7534,583,7.2
22,39,Evangeline Parish,2009,12734,11731,1003,7.9
22,41,Franklin Parish,2009,7802,6965,837,10.7
22,43,Grant Parish,2009,8837,8149,688,7.8
22,45,Iberia Parish,2009,34295,31943,2352,6.9
22,47,Iberville Parish,2009,12446,11270,1176,9.4
22,49,Jackson Parish,2009,6524,6025,499,7.6
22,51,Jefferson Parish,2009,211466,198168,13298,6.3
22,53,Jefferson Davis Parish,2009,14708,13856,852,5.8
22,55,Lafayette Parish,2009,112171,106478,5693,5.1
22,57,Lafourche Parish,2009,48533,46326,2207,4.5
22,59,LaSalle Parish,2009,6429,5990,439,6.8
22,61,Lincoln Parish,2009,19330,17894,1436,7.4
22,63,Livingston Parish,2009,59041,55451,3590,6.1
22,65,Madison Parish,2009,4686,4244,442,9.4
22,67,Morehouse Parish,2009,11576,9903,1673,14.5
22,69,Natchitoches Parish,2009,17372,15971,1401,8.1
22,71,Orleans Parish,2009,146041,134507,11534,7.9
22,73,Ouachita Parish,2009,71206,66269,4937,6.9
22,75,Plaquemines Parish,2009,7986,7469,517,6.5
22,77,Pointe Coupee Parish,2009,9529,8871,658,6.9
22,79,Rapides Parish,2009,60831,56962,3869,6.4
22,81,Red River Parish,2009,3523,3188,335,9.5
22,83,Richland Parish,2009,8919,8052,867,9.7
22,85,Sabine Parish,2009,9467,8698,769,8.1
22,87,St. Bernard Parish,2009,18102,16979,1123,6.2
22,89,St. Charles Parish,2009,23776,22231,1545,6.5
22,91,St. Helena Parish,2009,4238,3780,458,10.8
22,93,St. James Parish,2009,9349,8485,864,9.2
22,95,St. John the Baptist Parish,2009,20483,18723,1760,8.6
22,97,St. Landry Parish,2009,38145,35328,2817,7.4
22,99,St. Martin Parish,2009,23857,22291,1566,6.6
22,101,St. Mary Parish,2009,23102,21362,1740,7.5
22,103,St. Tammany Parish,2009,107945,102102,5843,5.4
22,105,Tangipahoa Parish,2009,52784,48764,4020,7.6
22,107,Tensas Parish,2009,2053,1807,246,12.0
22,109,Terrebonne Parish,2009,54398,51783,2615,4.8
22,111,Union Parish,2009,10319,9221,1098,10.6
22,113,Vermilion Parish,2009,24675,23058,1617,6.6
22,115,Vernon Parish,2009,20605,19228,1377,6.7
22,117,Washington Parish,2009,15737,14359,1378,8.8
22,119,Webster Parish,2009,19657,17959,1698,8.6
22,121,West Baton Rouge Parish,2009,10667,9955,712,6.7
22,123,West Carroll Parish,2009,4497,3767,730,16.2
22,125,West Feliciana Parish,2009,4750,4395,355,7.5
22,127,Winn Parish,2009,6514,5970,544,8.4
23,1,Androscoggin,2009,57986,52923,5063,8.7
23,3,Aroostook,2009,34628,31136,3492,10.1
23,5,Cumberland,2009,156407,145897,10510,6.7
23,7,Franklin,2009,14418,12860,1558,10.8
23,9,Hancock,2009,29407,26762,2645,9.0
23,11,Kennebec,2009,63236,58264,4972,7.9
23,13,Knox,2009,20599,18911,1688,8.2
23,15,Lincoln,2009,17952,16541,1411,7.9
23,17,Oxford,2009,28141,25016,3125,11.1
23,19,Penobscot,2009,78702,72006,6696,8.5
23,21,Piscataquis,2009,7402,6466,936,12.6
23,23,Sagadahoc,2009,18719,17334,1385,7.4
23,25,Somerset,2009,24731,21925,2806,11.3
23,27,Waldo,2009,19071,17315,1756,9.2
23,29,Washington,2009,14439,12792,1647,11.4
23,31,York,2009,111875,102976,8899,8.0
24,1,Allegany,2009,36454,33109,3345,9.2
24,3,Anne Arundel,2009,288114,268328,19786,6.9
24,5,Baltimore,2009,435306,400495,34811,8.0
24,9,Calvert,2009,49164,46058,3106,6.3
24,11,Caroline,2009,16559,14954,1605,9.7
24,13,Carroll,2009,95692,89068,6624,6.9
24,15,Cecil,2009,51428,46401,5027,9.8
24,17,Charles,2009,78435,73478,4957,6.3
24,19,Dorchester,2009,17017,15069,1948,11.4
24,21,Frederick,2009,124770,116310,8460,6.8
24,23,Garrett,2009,16922,15506,1416,8.4
24,25,Harford,2009,135341,124934,10407,7.7
24,27,Howard,2009,164453,155243,9210,5.6
24,29,Kent,2009,10954,10058,896,8.2
24,31,Montgomery,2009,524629,494416,30213,5.8
24,33,Prince George's,2009,460136,425672,34464,7.5
24,35,Queen Anne's,2009,27188,25231,1957,7.2
24,37,St. Mary's,2009,53978,50720,3258,6.0
24,39,Somerset,2009,11189,10050,1139,10.2
24,41,Talbot,2009,18817,17347,1470,7.8
24,43,Washington,2009,68833,61653,7180,10.4
24,45,Wicomico,2009,52801,48053,4748,9.0
24,47,Worcester,2009,28071,24778,3293,11.7
24,510,Baltimore city,2009,283620,252468,31152,11.0
25,1,Barnstable,2009,122070,111861,10209,8.4
25,3,Berkshire,2009,73092,67467,5625,7.7
25,5,Bristol,2009,292650,261506,31144,10.6
25,7,Dukes,2009,11332,10610,722,6.4
25,9,Essex,2009,381092,348127,32965,8.7
25,11,Franklin,2009,38914,35965,2949,7.6
25,13,Hampden,2009,226897,205804,21093,9.3
25,15,Hampshire,2009,87434,81809,5625,6.4
25,17,Middlesex,2009,826729,769965,56764,6.9
25,19,Nantucket/town,2009,7808,7282,526,6.7
25,21,Norfolk,2009,358033,331923,26110,7.3
25,23,Plymouth,2009,263810,241485,22325,8.5
25,25,Suffolk,2009,374525,345635,28890,7.7
25,27,Worcester,2009,406052,370065,35987,8.9
26,1,Alcona,2009,4094,3342,752,18.4
26,3,Alger,2009,4237,3672,565,13.3
26,5,Allegan,2009,54033,47245,6788,12.6
26,7,Alpena,2009,14833,12831,2002,13.5
26,9,Antrim,2009,11434,9737,1697,14.8
26,11,Arenac,2009,7858,6580,1278,16.3
26,13,Baraga,2009,4454,3398,1056,23.7
26,15,Barry,2009,28750,25845,2905,10.1
26,17,Bay,2009,54536,48189,6347,11.6
26,19,Benzie,2009,8666,7502,1164,13.4
26,21,Berrien,2009,77325,67723,9602,12.4
26,23,Branch,2009,21460,18500,2960,13.8
26,25,Calhoun,2009,68153,60342,7811,11.5
26,27,Cass,2009,25162,22376,2786,11.1
26,29,Charlevoix,2009,13671,11702,1969,14.4
26,31,Cheboygan,2009,11832,10230,1602,13.5
26,33,Chippewa,2009,17083,14969,2114,12.4
26,35,Clare,2009,12883,10797,2086,16.2
26,37,Clinton,2009,37030,33626,3404,9.2
26,39,Crawford,2009,6347,5511,836,13.2
26,41,Delta,2009,19376,17061,2315,11.9
26,43,Dickinson,2009,14205,12596,1609,11.3
26,45,Eaton,2009,57604,51756,5848,10.2
26,47,Emmet,2009,19454,16744,2710,13.9
26,49,Genesee,2009,198024,169285,28739,14.5
26,51,Gladwin,2009,10345,8675,1670,16.1
26,53,Gogebic,2009,7445,6507,938,12.6
26,55,Grand Traverse,2009,48213,42659,5554,11.5
26,57,Gratiot,2009,19473,16819,2654,13.6
26,59,Hillsdale,2009,20827,17298,3529,16.9
26,61,Houghton,2009,17586,15733,1853,10.5
26,63,Huron,2009,16076,13783,2293,14.3
26,65,Ingham,2009,151008,134201,16807,11.1
26,67,Ionia,2009,29088,25095,3993,13.7
26,69,Iosco,2009,10507,8688,1819,17.3
26,71,Iron,2009,5744,5067,677,11.8
26,73,Isabella,2009,38111,34816,3295,8.6
26,75,Jackson,2009,76000,65948,10052,13.2
26,77,Kalamazoo,2009,132752,119597,13155,9.9
26,79,Kalkaska,2009,8438,7252,1186,14.1
26,81,Kent,2009,312565,279174,33391,10.7
26,83,Keweenaw,2009,1122,967,155,13.8
26,85,Lake,2009,4049,3390,659,16.3
26,87,Lapeer,2009,42651,35605,7046,16.5
26,89,Leelanau,2009,10884,9901,983,9.0
26,91,Lenawee,2009,48140,40840,7300,15.2
26,93,Livingston,2009,90474,80244,10230,11.3
26,95,Luce,2009,2706,2356,350,12.9
26,97,Mackinac,2009,6146,5303,843,13.7
26,99,Macomb,2009,411420,349665,61755,15.0
26,101,Manistee,2009,11532,10074,1458,12.6
26,103,Marquette,2009,36124,32465,3659,10.1
26,105,Mason,2009,14715,12807,1908,13.0
26,107,Mecosta,2009,20190,17657,2533,12.5
26,109,Menominee,2009,13076,11563,1513,11.6
26,111,Midland,2009,42622,38587,4035,9.5
26,113,Missaukee,2009,6277,5323,954,15.2
26,115,Monroe,2009,74223,63688,10535,14.2
26,117,Montcalm,2009,26524,22219,4305,16.2
26,119,Montmorency,2009,3974,3169,805,20.3
26,121,Muskegon,2009,87695,74933,12762,14.6
26,123,Newaygo,2009,22062,19068,2994,13.6
26,125,Oakland,2009,599894,526060,73834,12.3
26,127,Oceana,2009,14108,11889,2219,15.7
26,129,Ogemaw,2009,9564,8302,1262,13.2
26,131,Ontonagon,2009,3188,2698,490,15.4
26,133,Osceola,2009,9479,8068,1411,14.9
26,135,Oscoda,2009,3725,2950,775,20.8
26,137,Otsego,2009,11911,10208,1703,14.3
26,139,Ottawa,2009,130221,114401,15820,12.1
26,141,Presque Isle,2009,5995,4897,1098,18.3
26,143,Roscommon,2009,9982,8512,1470,14.7
26,145,Saginaw,2009,93935,82466,11469,12.2
26,147,St. Clair,2009,81118,67469,13649,16.8
26,149,St. Joseph,2009,28689,24568,4121,14.4
26,151,Sanilac,2009,20867,17298,3569,17.1
26,153,Schoolcraft,2009,3903,3348,555,14.2
26,155,Shiawassee,2009,35150,30047,5103,14.5
26,157,Tuscola,2009,27823,23510,4313,15.5
26,159,Van Buren,2009,39712,34768,4944,12.4
26,161,Washtenaw,2009,184354,168878,15476,8.4
26,163,Wayne,2009,858770,726528,132242,15.4
26,165,Wexford,2009,14371,11906,2465,17.2
27,1,Aitkin,2009,7698,6892,806,10.5
27,3,Anoka,2009,190279,174077,16202,8.5
27,5,Becker,2009,17224,15720,1504,8.7
27,7,Beltrami,2009,21631,19728,1903,8.8
27,9,Benton,2009,23169,21172,1997,8.6
27,11,Big Stone,2009,2933,2761,172,5.9
27,13,Blue Earth,2009,37679,35214,2465,6.5
27,15,Brown,2009,15013,13895,1118,7.4
27,17,Carlton,2009,17510,15999,1511,8.6
27,19,Carver,2009,50744,47001,3743,7.4
27,21,Cass,2009,14100,12574,1526,10.8
27,23,Chippewa,2009,7274,6699,575,7.9
27,25,Chisago,2009,27380,24616,2764,10.1
27,27,Clay,2009,32641,31045,1596,4.9
27,29,Clearwater,2009,4218,3587,631,15.0
27,31,Cook,2009,3106,2884,222,7.1
27,33,Cottonwood,2009,6453,6040,413,6.4
27,35,Crow Wing,2009,33314,30039,3275,9.8
27,37,Dakota,2009,228603,211839,16764,7.3
27,39,Dodge,2009,11092,10258,834,7.5
27,41,Douglas,2009,20694,19292,1402,6.8
27,43,Faribault,2009,7690,6971,719,9.3
27,45,Fillmore,2009,11234,10308,926,8.2
27,47,Freeborn,2009,16474,15061,1413,8.6
27,49,Goodhue,2009,25636,23645,1991,7.8
27,51,Grant,2009,3164,2895,269,8.5
27,53,Hennepin,2009,653860,605520,48340,7.4
27,55,Houston,2009,10974,10084,890,8.1
27,57,Hubbard,2009,9544,8576,968,10.1
27,59,Isanti,2009,21793,19561,2232,10.2
27,61,Itasca,2009,22824,20321,2503,11.0
27,63,Jackson,2009,6949,6565,384,5.5
27,65,Kanabec,2009,8098,7021,1077,13.3
27,67,Kandiyohi,2009,23884,22258,1626,6.8
27,69,Kittson,2009,2514,2330,184,7.3
27,71,Koochiching,2009,6659,6020,639,9.6
27,73,Lac qui Parle,2009,4317,4049,268,6.2
27,75,Lake,2009,6176,5606,570,9.2
27,77,Lake of the Woods,2009,2265,2090,175,7.7
27,79,Le Sueur,2009,14389,12836,1553,10.8
27,81,Lincoln,2009,3365,3165,200,5.9
27,83,Lyon,2009,14707,13839,868,5.9
27,85,McLeod,2009,20095,18151,1944,9.7
27,87,Mahnomen,2009,2429,2237,192,7.9
27,89,Marshall,2009,5336,4803,533,10.0
27,91,Martin,2009,11649,10762,887,7.6
27,93,Meeker,2009,12515,11298,1217,9.7
27,95,Mille Lacs,2009,12395,10812,1583,12.8
27,97,Morrison,2009,18294,16240,2054,11.2
27,99,Mower,2009,20943,19611,1332,6.4
27,101,Murray,2009,5735,5402,333,5.8
27,103,Nicollet,2009,19877,18611,1266,6.4
27,105,Nobles,2009,11570,10954,616,5.3
27,107,Norman,2009,3582,3349,233,6.5
27,109,Olmsted,2009,81242,76186,5056,6.2
27,111,Otter Tail,2009,30131,27685,2446,8.1
27,113,Pennington,2009,8949,8143,806,9.0
27,115,Pine,2009,14507,12855,1652,11.4
27,117,Pipestone,2009,5557,5199,358,6.4
27,119,Polk,2009,17086,16061,1025,6.0
27,121,Pope,2009,6228,5776,452,7.3
27,123,Ramsey,2009,269667,248761,20906,7.8
27,125,Red Lake,2009,2426,2176,250,10.3
27,127,Redwood,2009,8408,7831,577,6.9
27,129,Renville,2009,8742,8043,699,8.0
27,131,Rice,2009,33522,30622,2900,8.7
27,133,Rock,2009,5032,4760,272,5.4
27,135,Roseau,2009,9502,8765,737,7.8
27,137,St. Louis,2009,105286,95489,9797,9.3
27,139,Scott,2009,74688,69155,5533,7.4
27,141,Sherburne,2009,49143,44599,4544,9.2
27,143,Sibley,2009,8863,8153,710,8.0
27,145,Stearns,2009,83993,77349,6644,7.9
27,147,Steele,2009,20746,18931,1815,8.7
27,149,Stevens,2009,5608,5302,306,5.5
27,151,Swift,2009,5488,5088,400,7.3
27,153,Todd,2009,12495,11360,1135,9.1
27,155,Traverse,2009,1785,1664,121,6.8
27,157,Wabasha,2009,12219,11273,946,7.7
27,159,Wadena,2009,6543,5817,726,11.1
27,161,Waseca,2009,10459,9586,873,8.3
27,163,Washington,2009,128435,118957,9478,7.4
27,165,Watonwan,2009,5568,5067,501,9.0
27,167,Wilkin,2009,3532,3338,194,5.5
27,169,Winona,2009,28784,26540,2244,7.8
27,171,Wright,2009,67885,61694,6191,9.1
27,173,Yellow Medicine,2009,5852,5469,383,6.5
28,1,Adams,2009,12800,11646,1154,9.0
28,3,Alcorn,2009,14861,13120,1741,11.7
28,5,Amite,2009,4947,4427,520,10.5
28,7,Attala,2009,6929,6016,913,13.2
28,9,Benton,2009,2785,2395,390,14.0
28,11,Bolivar,2009,14729,13186,1543,10.5
28,13,Calhoun,2009,5860,5218,642,11.0
28,15,Carroll,2009,4737,4235,502,10.6
28,17,Chickasaw,2009,7095,6166,929,13.1
28,19,Choctaw,2009,3326,2925,401,12.1
28,21,Claiborne,2009,3669,3103,566,15.4
28,23,Clarke,2009,6681,5949,732,11.0
28,25,Clay,2009,7133,5882,1251,17.5
28,27,Coahoma,2009,9906,8722,1184,12.0
28,29,Copiah,2009,11719,10539,1180,10.1
28,31,Covington,2009,8587,7889,698,8.1
28,33,DeSoto,2009,76313,70946,5367,7.0
28,35,Forrest,2009,36309,33501,2808,7.7
28,37,Franklin,2009,2994,2665,329,11.0
28,39,George,2009,9378,8450,928,9.9
28,41,Greene,2009,4824,4273,551,11.4
28,43,Grenada,2009,8939,7856,1083,12.1
28,45,Hancock,2009,18089,16664,1425,7.9
28,47,Harrison,2009,84750,78336,6414,7.6
28,49,Hinds,2009,113484,104252,9232,8.1
28,51,Holmes,2009,6942,5625,1317,19.0
28,53,Humphreys,2009,4150,3635,515,12.4
28,55,Issaquena,2009,661,586,75,11.3
28,57,Itawamba,2009,9588,8497,1091,11.4
28,59,Jackson,2009,60563,55625,4938,8.2
28,61,Jasper,2009,7097,6352,745,10.5
28,63,Jefferson,2009,2798,2337,461,16.5
28,65,Jefferson Davis,2009,5129,4600,529,10.3
28,67,Jones,2009,29500,27334,2166,7.3
28,69,Kemper,2009,3858,3379,479,12.4
28,71,Lafayette,2009,21469,19778,1691,7.9
28,73,Lamar,2009,23536,21985,1551,6.6
28,75,Lauderdale,2009,32343,29319,3024,9.3
28,77,Lawrence,2009,5122,4559,563,11.0
28,79,Leake,2009,8434,7666,768,9.1
28,81,Lee,2009,36704,32890,3814,10.4
28,83,Leflore,2009,12984,11375,1609,12.4
28,85,Lincoln,2009,13581,12205,1376,10.1
28,87,Lowndes,2009,24979,22368,2611,10.5
28,89,Madison,2009,45510,42427,3083,6.8
28,91,Marion,2009,10281,9248,1033,10.0
28,93,Marshall,2009,14696,12982,1714,11.7
28,95,Monroe,2009,15472,13363,2109,13.6
28,97,Montgomery,2009,4497,3879,618,13.7
28,99,Neshoba,2009,13331,12113,1218,9.1
28,101,Newton,2009,9033,8213,820,9.1
28,103,Noxubee,2009,3675,3001,674,18.3
28,105,Oktibbeha,2009,19835,18117,1718,8.7
28,107,Panola,2009,14525,12770,1755,12.1
28,109,Pearl River,2009,20910,19045,1865,8.9
28,111,Perry,2009,4844,4330,514,10.6
28,113,Pike,2009,15015,13517,1498,10.0
28,115,Pontotoc,2009,12694,11416,1278,10.1
28,117,Prentiss,2009,10807,9431,1376,12.7
28,119,Quitman,2009,3428,3008,420,12.3
28,121,Rankin,2009,72610,68303,4307,5.9
28,123,Scott,2009,13410,12482,928,6.9
28,125,Sharkey,2009,2379,2126,253,10.6
28,127,Simpson,2009,11285,10329,956,8.5
28,129,Smith,2009,6278,5712,566,9.0
28,131,Stone,2009,7754,7145,609,7.9
28,133,Sunflower,2009,10246,8958,1288,12.6
28,135,Tallahatchie,2009,5866,5217,649,11.1
28,137,Tate,2009,11440,10230,1210,10.6
28,139,Tippah,2009,8322,7112,1210,14.5
28,141,Tishomingo,2009,7541,6609,932,12.4
28,143,Tunica,2009,4269,3656,613,14.4
28,145,Union,2009,11536,10356,1180,10.2
28,147,Walthall,2009,5591,4965,626,11.2
28,149,Warren,2009,21397,19325,2072,9.7
28,151,Washington,2009,21376,18505,2871,13.4
28,153,Wayne,2009,8127,7261,866,10.7
28,155,Webster,2009,3398,2937,461,13.6
28,157,Wilkinson,2009,3872,3460,412,10.6
28,159,Winston,2009,7598,6335,1263,16.6
28,161,Yalobusha,2009,5436,4676,760,14.0
28,163,Yazoo,2009,9944,8798,1146,11.5
29,1,Adair,2009,13664,12787,877,6.4
29,3,Andrew,2009,10205,9440,765,7.5
29,5,Atchison,2009,3246,3014,232,7.1
29,7,Audrain,2009,12213,11102,1111,9.1
29,9,Barry,2009,17451,16053,1398,8.0
29,11,Barton,2009,5263,4716,547,10.4
29,13,Bates,2009,7577,6790,787,10.4
29,15,Benton,2009,8316,7509,807,9.7
29,17,Bollinger,2009,5615,5052,563,10.0
29,19,Boone,2009,88501,83066,5435,6.1
29,21,Buchanan,2009,49789,45669,4120,8.3
29,23,Butler,2009,21589,19892,1697,7.9
29,25,Caldwell,2009,4181,3783,398,9.5
29,27,Callaway,2009,22985,21179,1806,7.9
29,29,Camden,2009,22173,20078,2095,9.4
29,31,Cape Girardeau,2009,38898,36141,2757,7.1
29,33,Carroll,2009,5110,4591,519,10.2
29,35,Carter,2009,3114,2818,296,9.5
29,37,Cass,2009,50299,45611,4688,9.3
29,39,Cedar,2009,6333,5769,564,8.9
29,41,Chariton,2009,4059,3673,386,9.5
29,43,Christian,2009,40799,37532,3267,8.0
29,45,Clark,2009,3590,3170,420,11.7
29,47,Clay,2009,121169,111232,9937,8.2
29,49,Clinton,2009,10160,9188,972,9.6
29,51,Cole,2009,40704,38002,2702,6.6
29,53,Cooper,2009,9143,8351,792,8.7
29,55,Crawford,2009,12264,10949,1315,10.7
29,57,Dade,2009,3579,3270,309,8.6
29,59,Dallas,2009,7334,6502,832,11.3
29,61,Daviess,2009,3890,3552,338,8.7
29,63,DeKalb,2009,5183,4706,477,9.2
29,65,Dent,2009,6857,6222,635,9.3
29,67,Douglas,2009,6770,6186,584,8.6
29,69,Dunklin,2009,14959,13395,1564,10.5
29,71,Franklin,2009,53824,47506,6318,11.7
29,73,Gasconade,2009,8017,7114,903,11.3
29,75,Gentry,2009,3606,3384,222,6.2
29,77,Greene,2009,140164,128712,11452,8.2
29,79,Grundy,2009,4940,4571,369,7.5
29,81,Harrison,2009,4634,4289,345,7.4
29,83,Henry,2009,11000,9977,1023,9.3
29,85,Hickory,2009,3522,3062,460,13.1
29,87,Holt,2009,2798,2606,192,6.9
29,89,Howard,2009,5131,4710,421,8.2
29,91,Howell,2009,19916,18039,1877,9.4
29,93,Iron,2009,5799,5300,499,8.6
29,95,Jackson,2009,345229,310957,34272,9.9
29,97,Jasper,2009,58129,53505,4624,8.0
29,99,Jefferson,2009,117697,105552,12145,10.3
29,101,Johnson,2009,26301,24134,2167,8.2
29,103,Knox,2009,2354,2216,138,5.9
29,105,Laclede,2009,16584,14560,2024,12.2
29,107,Lafayette,2009,15933,14419,1514,9.5
29,109,Lawrence,2009,19191,17637,1554,8.1
29,111,Lewis,2009,5498,5055,443,8.1
29,113,Lincoln,2009,27521,24345,3176,11.5
29,115,Linn,2009,6662,6042,620,9.3
29,117,Livingston,2009,7397,6840,557,7.5
29,119,McDonald,2009,10704,9891,813,7.6
29,121,Macon,2009,8247,7569,678,8.2
29,123,Madison,2009,6293,5662,631,10.0
29,125,Maries,2009,4844,4464,380,7.8
29,127,Marion,2009,15005,13626,1379,9.2
29,129,Mercer,2009,1769,1643,126,7.1
29,131,Miller,2009,12854,11393,1461,11.4
29,133,Mississippi,2009,6206,5682,524,8.4
29,135,Moniteau,2009,7491,6895,596,8.0
29,137,Monroe,2009,4245,3709,536,12.6
29,139,Montgomery,2009,6129,5424,705,11.5
29,141,Morgan,2009,9325,8182,1143,12.3
29,143,New Madrid,2009,8512,7739,773,9.1
29,145,Newton,2009,27869,25671,2198,7.9
29,147,Nodaway,2009,12796,12002,794,6.2
29,149,Oregon,2009,4683,4265,418,8.9
29,151,Osage,2009,7366,6882,484,6.6
29,153,Ozark,2009,4523,4165,358,7.9
29,155,Pemiscot,2009,8544,7564,980,11.5
29,157,Perry,2009,10641,9910,731,6.9
29,159,Pettis,2009,20806,19037,1769,8.5
29,161,Phelps,2009,22138,20567,1571,7.1
29,163,Pike,2009,9321,8496,825,8.9
29,165,Platte,2009,50091,46333,3758,7.5
29,167,Polk,2009,14225,12842,1383,9.7
29,169,Pulaski,2009,20955,19497,1458,7.0
29,171,Putnam,2009,2506,2328,178,7.1
29,173,Ralls,2009,5626,5145,481,8.5
29,175,Randolph,2009,13258,11884,1374,10.4
29,177,Ray,2009,11112,10024,1088,9.8
29,179,Reynolds,2009,2825,2464,361,12.8
29,181,Ripley,2009,6798,6175,623,9.2
29,183,St. Charles,2009,196874,180536,16338,8.3
29,185,St. Clair,2009,4264,3857,407,9.5
29,186,Ste. Genevieve,2009,10147,9217,930,9.2
29,187,St. Francois,2009,30624,27334,3290,10.7
29,189,St. Louis,2009,516937,471724,45213,8.7
29,195,Saline,2009,11910,11007,903,7.6
29,197,Schuyler,2009,2180,2011,169,7.8
29,199,Scotland,2009,2505,2311,194,7.7
29,201,Scott,2009,20497,18725,1772,8.6
29,203,Shannon,2009,3766,3319,447,11.9
29,205,Shelby,2009,3315,3030,285,8.6
29,207,Stoddard,2009,15243,13825,1418,9.3
29,209,Stone,2009,16127,14230,1897,11.8
29,211,Sullivan,2009,3642,3402,240,6.6
29,213,Taney,2009,28314,24998,3316,11.7
29,215,Texas,2009,11205,10200,1005,9.0
29,217,Vernon,2009,9398,8682,716,7.6
29,219,Warren,2009,16793,14938,1855,11.0
29,221,Washington,2009,10122,8717,1405,13.9
29,223,Wayne,2009,6059,5523,536,8.8
29,225,Webster,2009,16864,15275,1589,9.4
29,227,Worth,2009,1153,1068,85,7.4
29,229,Wright,2009,8278,7458,820,9.9
29,510,St. Louis city,2009,158964,140858,18106,11.4
30,1,Beaverhead,2009,5173,4904,269,5.2
30,3,Big Horn,2009,5246,4728,518,9.9
30,5,Blaine,2009,2888,2733,155,5.4
30,7,Broadwater,2009,2417,2223,194,8.0
30,9,Carbon,2009,5263,4950,313,5.9
30,11,Carter,2009,718,690,28,3.9
30,13,Cascade,2009,40713,38415,2298,5.6
30,15,Chouteau,2009,2596,2487,109,4.2
30,17,Custer,2009,5859,5560,299,5.1
30,19,Daniels,2009,782,748,34,4.3
30,21,Dawson,2009,4376,4160,216,4.9
30,23,Deer Lodge,2009,3950,3638,312,7.9
30,25,Fallon,2009,1897,1834,63,3.3
30,27,Fergus,2009,6059,5714,345,5.7
30,29,Flathead,2009,44878,39371,5507,12.3
30,31,Gallatin,2009,48991,45447,3544,7.2
30,33,Garfield,2009,653,628,25,3.8
30,35,Glacier,2009,5791,5231,560,9.7
30,37,Golden Valley,2009,555,525,30,5.4
30,39,Granite,2009,1258,1122,136,10.8
30,41,Hill,2009,8229,7760,469,5.7
30,43,Jefferson,2009,6054,5653,401,6.6
30,45,Judith Basin,2009,1072,1013,59,5.5
30,47,Lake,2009,11459,10359,1100,9.6
30,49,Lewis and Clark,2009,34016,32228,1788,5.3
30,51,Liberty,2009,753,719,34,4.5
30,53,Lincoln,2009,7942,6727,1215,15.3
30,55,McCone,2009,1018,984,34,3.3
30,57,Madison,2009,4219,3941,278,6.6
30,59,Meagher,2009,860,784,76,8.8
30,61,Mineral,2009,1928,1718,210,10.9
30,63,Missoula,2009,58899,55021,3878,6.6
30,65,Musselshell,2009,2445,2276,169,6.9
30,67,Park,2009,8624,7907,717,8.3
30,69,Petroleum,2009,236,223,13,5.5
30,71,Phillips,2009,2243,2111,132,5.9
30,73,Pondera,2009,2581,2413,168,6.5
30,75,Powder River,2009,902,864,38,4.2
30,77,Powell,2009,2728,2470,258,9.5
30,79,Prairie,2009,590,565,25,4.2
30,81,Ravalli,2009,18340,16586,1754,9.6
30,83,Richland,2009,5495,5223,272,4.9
30,85,Roosevelt,2009,4045,3718,327,8.1
30,87,Rosebud,2009,4053,3768,285,7.0
30,89,Sanders,2009,4566,3830,736,16.1
30,91,Sheridan,2009,1791,1710,81,4.5
30,93,Silver Bow,2009,17292,16159,1133,6.6
30,95,Stillwater,2009,4486,4198,288,6.4
30,97,Sweet Grass,2009,2428,2311,117,4.8
30,99,Teton,2009,3031,2874,157,5.2
30,101,Toole,2009,2528,2414,114,4.5
30,103,Treasure,2009,402,380,22,5.5
30,105,Valley,2009,3597,3401,196,5.4
30,107,Wheatland,2009,1046,984,62,5.9
30,109,Wibaux,2009,576,547,29,5.0
30,111,Yellowstone,2009,82065,77833,4232,5.2
31,1,Adams,2009,17529,16639,890,5.1
31,3,Antelope,2009,3724,3585,139,3.7
31,5,Arthur,2009,241,227,14,5.8
31,7,Banner,2009,350,338,12,3.4
31,9,Blaine,2009,260,246,14,5.4
31,11,Boone,2009,3330,3216,114,3.4
31,13,Box Butte,2009,5620,5248,372,6.6
31,15,Boyd,2009,1128,1084,44,3.9
31,17,Brown,2009,1833,1776,57,3.1
31,19,Buffalo,2009,27599,26597,1002,3.6
31,21,Burt,2009,3984,3761,223,5.6
31,23,Butler,2009,4732,4533,199,4.2
31,25,Cass,2009,13689,12973,716,5.2
31,27,Cedar,2009,4825,4649,176,3.6
31,29,Chase,2009,2074,2014,60,2.9
31,31,Cherry,2009,3476,3385,91,2.6
31,33,Cheyenne,2009,5155,4925,230,4.5
31,35,Clay,2009,3021,2889,132,4.4
31,37,Colfax,2009,5761,5546,215,3.7
31,39,Cuming,2009,4972,4782,190,3.8
31,41,Custer,2009,6172,5967,205,3.3
31,43,Dakota,2009,11111,10437,674,6.1
31,45,Dawes,2009,4751,4541,210,4.4
31,47,Dawson,2009,12582,11998,584,4.6
31,49,Deuel,2009,1066,1024,42,3.9
31,51,Dixon,2009,3319,3163,156,4.7
31,53,Dodge,2009,19809,18807,1002,5.1
31,55,Douglas,2009,273769,259591,14178,5.2
31,57,Dundy,2009,1062,1020,42,4.0
31,59,Fillmore,2009,3187,3056,131,4.1
31,61,Franklin,2009,1780,1711,69,3.9
31,63,Frontier,2009,1649,1597,52,3.2
31,65,Furnas,2009,2552,2458,94,3.7
31,67,Gage,2009,11970,11220,750,6.3
31,69,Garden,2009,958,917,41,4.3
31,71,Garfield,2009,1082,1050,32,3.0
31,73,Gosper,2009,972,934,38,3.9
31,75,Grant,2009,367,354,13,3.5
31,77,Greeley,2009,1326,1279,47,3.5
31,79,Hall,2009,32055,30691,1364,4.3
31,81,Hamilton,2009,5511,5331,180,3.3
31,83,Harlan,2009,1866,1797,69,3.7
31,85,Hayes,2009,491,471,20,4.1
31,87,Hitchcock,2009,1486,1404,82,5.5
31,89,Holt,2009,6216,6022,194,3.1
31,91,Hooker,2009,410,389,21,5.1
31,93,Howard,2009,3601,3468,133,3.7
31,95,Jefferson,2009,4284,4077,207,4.8
31,97,Johnson,2009,3021,2894,127,4.2
31,99,Kearney,2009,3612,3471,141,3.9
31,101,Keith,2009,4453,4252,201,4.5
31,103,Keya Paha,2009,395,377,18,4.6
31,105,Kimball,2009,1916,1824,92,4.8
31,107,Knox,2009,4841,4668,173,3.6
31,109,Lancaster,2009,160106,153175,6931,4.3
31,111,Lincoln,2009,21738,20866,872,4.0
31,113,Logan,2009,456,442,14,3.1
31,115,Loup,2009,335,318,17,5.1
31,117,McPherson,2009,291,280,11,3.8
31,119,Madison,2009,18863,18041,822,4.4
31,121,Merrick,2009,4162,3988,174,4.2
31,123,Morrill,2009,2852,2731,121,4.2
31,125,Nance,2009,2141,2070,71,3.3
31,127,Nemaha,2009,3420,3240,180,5.3
31,129,Nuckolls,2009,2304,2199,105,4.6
31,131,Otoe,2009,8918,8473,445,5.0
31,133,Pawnee,2009,1540,1483,57,3.7
31,135,Perkins,2009,1699,1648,51,3.0
31,137,Phelps,2009,5192,5007,185,3.6
31,139,Pierce,2009,3859,3706,153,4.0
31,141,Platte,2009,18293,17542,751,4.1
31,143,Polk,2009,3036,2922,114,3.8
31,145,Red Willow,2009,6076,5802,274,4.5
31,147,Richardson,2009,4204,3949,255,6.1
31,149,Rock,2009,874,848,26,3.0
31,151,Saline,2009,8311,7930,381,4.6
31,153,Sarpy,2009,79378,75677,3701,4.7
31,155,Saunders,2009,10784,10240,544,5.0
31,157,Scotts Bluff,2009,19616,18603,1013,5.2
31,159,Seward,2009,8806,8444,362,4.1
31,161,Sheridan,2009,3105,2983,122,3.9
31,163,Sherman,2009,2000,1936,64,3.2
31,165,Sioux,2009,732,707,25,3.4
31,167,Stanton,2009,3477,3333,144,4.1
31,169,Thayer,2009,2789,2670,119,4.3
31,171,Thomas,2009,358,342,16,4.5
31,173,Thurston,2009,3149,2817,332,10.5
31,175,Valley,2009,2562,2477,85,3.3
31,177,Washington,2009,11003,10495,508,4.6
31,179,Wayne,2009,5171,4967,204,3.9
31,181,Webster,2009,1806,1736,70,3.9
31,183,Wheeler,2009,460,443,17,3.7
31,185,York,2009,7051,6706,345,4.9
32,1,Churchill,2009,13670,12447,1223,8.9
32,3,Clark,2009,980724,863864,116860,11.9
32,5,Douglas,2009,22626,19918,2708,12.0
32,7,Elko,2009,27703,25900,1803,6.5
32,9,Esmeralda,2009,494,458,36,7.3
32,11,Eureka,2009,905,843,62,6.9
32,13,Humboldt,2009,8682,8025,657,7.6
32,15,Lander,2009,4052,3807,245,6.0
32,17,Lincoln,2009,1699,1542,157,9.2
32,19,Lyon,2009,23245,19531,3714,16.0
32,21,Mineral,2009,2381,2167,214,9.0
32,23,Nye,2009,18042,15452,2590,14.4
32,27,Pershing,2009,2632,2366,266,10.1
32,29,Storey,2009,2503,2197,306,12.2
32,31,Washoe,2009,223760,197997,25763,11.5
32,33,White Pine,2009,5010,4649,361,7.2
32,510,Carson City,2009,29243,25892,3351,11.5
33,1,Belknap,2009,32342,30220,2122,6.6
33,3,Carroll,2009,25706,24294,1412,5.5
33,5,Cheshire,2009,41792,39435,2357,5.6
33,7,Coos,2009,16278,15011,1267,7.8
33,9,Grafton,2009,48605,46151,2454,5.0
33,11,Hillsborough,2009,228322,213775,14547,6.4
33,13,Merrimack,2009,81246,76734,4512,5.6
33,15,Rockingham,2009,173534,162273,11261,6.5
33,17,Strafford,2009,69326,65101,4225,6.1
33,19,Sullivan,2009,22664,21381,1283,5.7
34,1,Atlantic,2009,136729,120629,16100,11.8
34,3,Bergen,2009,480078,443081,36997,7.7
34,5,Burlington,2009,241460,221307,20153,8.3
34,7,Camden,2009,270872,244323,26549,9.8
34,9,Cape May,2009,57805,51390,6415,11.1
34,11,Cumberland,2009,70655,61891,8764,12.4
34,13,Essex,2009,366635,329127,37508,10.2
34,15,Gloucester,2009,159515,144922,14593,9.1
34,17,Hudson,2009,299436,268245,31191,10.4
34,19,Hunterdon,2009,73072,68235,4837,6.6
34,21,Mercer,2009,205099,189706,15393,7.5
34,23,Middlesex,2009,426829,390883,35946,8.4
34,25,Monmouth,2009,336127,308421,27706,8.2
34,27,Morris,2009,274752,255530,19222,7.0
34,29,Ocean,2009,264523,239548,24975,9.4
34,31,Passaic,2009,244491,217853,26638,10.9
34,33,Salem,2009,31713,28381,3332,10.5
34,35,Somerset,2009,182330,169248,13082,7.2
34,37,Sussex,2009,85415,78167,7248,8.5
34,39,Union,2009,273350,248204,25146,9.2
34,41,Warren,2009,59420,54278,5142,8.7
35,1,Bernalillo,2009,306172,284520,21652,7.1
35,3,Catron,2009,1557,1422,135,8.7
35,5,Chaves,2009,26971,25203,1768,6.6
35,6,Cibola,2009,12185,11402,783,6.4
35,7,Colfax,2009,6521,6055,466,7.1
35,9,Curry,2009,21130,20235,895,4.2
35,11,De Baca,2009,819,779,40,4.9
35,13,Dona Ana,2009,89070,82937,6133,6.9
35,15,Eddy,2009,27680,26155,1525,5.5
35,17,Grant,2009,11648,10247,1401,12.0
35,19,Guadalupe,2009,1759,1629,130,7.4
35,21,Harding,2009,383,365,18,4.7
35,23,Hidalgo,2009,2643,2439,204,7.7
35,25,Lea,2009,27963,25888,2075,7.4
35,27,Lincoln,2009,10759,10169,590,5.5
35,28,Los Alamos,2009,9790,9492,298,3.0
35,29,Luna,2009,12193,10175,2018,16.6
35,31,McKinley,2009,26720,24628,2092,7.8
35,33,Mora,2009,2013,1770,243,12.1
35,35,Otero,2009,25622,24000,1622,6.3
35,37,Quay,2009,3912,3662,250,6.4
35,39,Rio Arriba,2009,19938,18510,1428,7.2
35,41,Roosevelt,2009,9210,8795,415,4.5
35,43,Sandoval,2009,55582,51132,4450,8.0
35,45,San Juan,2009,55673,51546,4127,7.4
35,47,San Miguel,2009,13127,12221,906,6.9
35,49,Santa Fe,2009,75574,70920,4654,6.2
35,51,Sierra,2009,5893,5574,319,5.4
35,53,Socorro,2009,9361,8899,462,4.9
35,55,Taos,2009,17351,15908,1443,8.3
35,57,Torrance,2009,6808,6206,602,8.8
35,59,Union,2009,1904,1805,99,5.2
35,61,Valencia,2009,30445,28002,2443,8.0
36,1,Albany,2009,158969,148024,10945,6.9
36,3,Allegany,2009,23911,21794,2117,8.9
36,5,Bronx,2009,535750,471589,64161,12.0
36,7,Broome,2009,97545,89457,8088,8.3
36,9,Cattaraugus,2009,41689,38038,3651,8.8
36,11,Cayuga,2009,41607,38116,3491,8.4
36,13,Chautauqua,2009,65963,60400,5563,8.4
36,15,Chemung,2009,41039,37324,3715,9.1
36,17,Chenango,2009,24419,22206,2213,9.1
36,19,Clinton,2009,39812,36046,3766,9.5
36,21,Columbia,2009,31442,29090,2352,7.5
36,23,Cortland,2009,24318,22065,2253,9.3
36,25,Delaware,2009,22274,20340,1934,8.7
36,27,Dutchess,2009,144898,133601,11297,7.8
36,29,Erie,2009,470857,432055,38802,8.2
36,31,Essex,2009,18351,16653,1698,9.3
36,33,Franklin,2009,23041,21051,1990,8.6
36,35,Fulton,2009,27264,24602,2662,9.8
36,37,Genesee,2009,33110,30543,2567,7.8
36,39,Greene,2009,24090,22052,2038,8.5
36,41,Hamilton,2009,3016,2787,229,7.6
36,43,Herkimer,2009,31185,28664,2521,8.1
36,45,Jefferson,2009,49539,45092,4447,9.0
36,47,Kings,2009,1123905,1012858,111047,9.9
36,49,Lewis,2009,12760,11623,1137,8.9
36,51,Livingston,2009,32157,29411,2746,8.5
36,53,Madison,2009,36103,33140,2963,8.2
36,55,Monroe,2009,375537,345560,29977,8.0
36,57,Montgomery,2009,24441,22094,2347,9.6
36,59,Nassau,2009,693067,644412,48655,7.0
36,61,New York,2009,935069,856532,78537,8.4
36,63,Niagara,2009,113741,103033,10708,9.4
36,65,Oneida,2009,110657,102360,8297,7.5
36,67,Onondaga,2009,233715,215560,18155,7.8
36,69,Ontario,2009,56971,52770,4201,7.4
36,71,Orange,2009,180557,166191,14366,8.0
36,73,Orleans,2009,19388,17553,1835,9.5
36,75,Oswego,2009,60070,54081,5989,10.0
36,77,Otsego,2009,31648,29229,2419,7.6
36,79,Putnam,2009,55021,51273,3748,6.8
36,81,Queens,2009,1133603,1038748,94855,8.4
36,83,Rensselaer,2009,83921,77597,6324,7.5
36,85,Richmond,2009,247007,226828,20179,8.2
36,87,Rockland,2009,153887,143105,10782,7.0
36,89,St. Lawrence,2009,49791,44835,4956,10.0
36,91,Saratoga,2009,122067,114192,7875,6.5
36,93,Schenectady,2009,76815,71134,5681,7.4
36,95,Schoharie,2009,15588,14183,1405,9.0
36,97,Schuyler,2009,10059,9206,853,8.5
36,99,Seneca,2009,17212,15886,1326,7.7
36,101,Steuben,2009,46044,41528,4516,9.8
36,103,Suffolk,2009,792114,733488,58626,7.4
36,105,Sullivan,2009,35397,32273,3124,8.8
36,107,Tioga,2009,26255,24098,2157,8.2
36,109,Tompkins,2009,56668,53291,3377,6.0
36,111,Ulster,2009,89978,82926,7052,7.8
36,113,Warren,2009,36446,33520,2926,8.0
36,115,Washington,2009,32518,30059,2459,7.6
36,117,Wayne,2009,47710,43678,4032,8.5
36,119,Westchester,2009,487767,452610,35157,7.2
36,121,Wyoming,2009,21041,19127,1914,9.1
36,123,Yates,2009,13235,12328,907,6.9
37,1,Alamance,2009,72085,63318,8767,12.2
37,3,Alexander,2009,18379,15721,2658,14.5
37,5,Alleghany,2009,4714,4130,584,12.4
37,7,Anson,2009,10209,8639,1570,15.4
37,9,Ashe,2009,12677,11088,1589,12.5
37,11,Avery,2009,9065,8189,876,9.7
37,13,Beaufort,2009,20992,18505,2487,11.8
37,15,Bertie,2009,9102,8064,1038,11.4
37,17,Bladen,2009,15505,13536,1969,12.7
37,19,Brunswick,2009,51452,45703,5749,11.2
37,21,Buncombe,2009,122941,112255,10686,8.7
37,23,Burke,2009,40114,34201,5913,14.7
37,25,Cabarrus,2009,85639,75860,9779,11.4
37,27,Caldwell,2009,38395,32391,6004,15.6
37,29,Camden,2009,4502,4108,394,8.8
37,31,Carteret,2009,32898,29922,2976,9.0
37,33,Caswell,2009,10973,9542,1431,13.0
37,35,Catawba,2009,77896,66567,11329,14.5
37,37,Chatham,2009,34609,31746,2863,8.3
37,39,Cherokee,2009,10089,8480,1609,15.9
37,41,Chowan,2009,6598,5787,811,12.3
37,43,Clay,2009,4649,4084,565,12.2
37,45,Cleveland,2009,49153,41446,7707,15.7
37,47,Columbus,2009,24688,21375,3313,13.4
37,49,Craven,2009,42724,38104,4620,10.8
37,51,Cumberland,2009,138201,125326,12875,9.3
37,53,Currituck,2009,12801,11882,919,7.2
37,55,Dare,2009,21942,19622,2320,10.6
37,57,Davidson,2009,78371,67934,10437,13.3
37,59,Davie,2009,21007,18522,2485,11.8
37,61,Duplin,2009,24645,22215,2430,9.9
37,63,Durham,2009,144806,133083,11723,8.1
37,65,Edgecombe,2009,24711,20645,4066,16.5
37,67,Forsyth,2009,180733,162903,17830,9.9
37,69,Franklin,2009,27886,24899,2987,10.7
37,71,Gaston,2009,100933,86442,14491,14.4
37,73,Gates,2009,4860,4483,377,7.8
37,75,Graham,2009,3744,3076,668,17.8
37,77,Granville,2009,25860,23030,2830,10.9
37,79,Greene,2009,9343,8325,1018,10.9
37,81,Guilford,2009,252006,224093,27913,11.1
37,83,Halifax,2009,24502,21037,3465,14.1
37,85,Harnett,2009,48724,42949,5775,11.9
37,87,Haywood,2009,28063,25258,2805,10.0
37,89,Henderson,2009,50191,45569,4622,9.2
37,91,Hertford,2009,10143,9121,1022,10.1
37,93,Hoke,2009,20965,19212,1753,8.4
37,95,Hyde,2009,2649,2407,242,9.1
37,97,Iredell,2009,79729,69159,10570,13.3
37,99,Jackson,2009,20880,18937,1943,9.3
37,101,Johnston,2009,79213,71013,8200,10.4
37,103,Jones,2009,4664,4141,523,11.2
37,105,Lee,2009,26331,22439,3892,14.8
37,107,Lenoir,2009,27241,23877,3364,12.3
37,109,Lincoln,2009,39633,33910,5723,14.4
37,111,McDowell,2009,20719,17428,3291,15.9
37,113,Macon,2009,16077,14228,1849,11.5
37,115,Madison,2009,9994,9013,981,9.8
37,117,Martin,2009,11974,10644,1330,11.1
37,119,Mecklenburg,2009,470015,418194,51821,11.0
37,121,Mitchell,2009,7255,6315,940,13.0
37,123,Montgomery,2009,11179,9609,1570,14.0
37,125,Moore,2009,36599,32727,3872,10.6
37,127,Nash,2009,47839,41828,6011,12.6
37,129,New Hanover,2009,105613,95406,10207,9.7
37,131,Northampton,2009,8717,7688,1029,11.8
37,133,Onslow,2009,66352,60483,5869,8.8
37,135,Orange,2009,70504,65753,4751,6.7
37,137,Pamlico,2009,5344,4787,557,10.4
37,139,Pasquotank,2009,17957,16095,1862,10.4
37,141,Pender,2009,24855,22019,2836,11.4
37,143,Perquimans,2009,5235,4658,577,11.0
37,145,Person,2009,19380,17092,2288,11.8
37,147,Pitt,2009,83068,74349,8719,10.5
37,149,Polk,2009,9529,8625,904,9.5
37,151,Randolph,2009,74985,66201,8784,11.7
37,153,Richmond,2009,20194,17252,2942,14.6
37,155,Robeson,2009,56425,49426,6999,12.4
37,157,Rockingham,2009,44363,38507,5856,13.2
37,159,Rowan,2009,71304,61862,9442,13.2
37,161,Rutherford,2009,28669,23812,4857,16.9
37,163,Sampson,2009,31567,28674,2893,9.2
37,165,Scotland,2009,13961,11517,2444,17.5
37,167,Stanly,2009,30570,26732,3838,12.6
37,169,Stokes,2009,23722,21100,2622,11.1
37,171,Surry,2009,34077,29655,4422,13.0
37,173,Swain,2009,6865,6007,858,12.5
37,175,Transylvania,2009,13346,12052,1294,9.7
37,177,Tyrrell,2009,2227,1975,252,11.3
37,179,Union,2009,96241,86204,10037,10.4
37,181,Vance,2009,19574,16788,2786,14.2
37,183,Wake,2009,462756,422898,39858,8.6
37,185,Warren,2009,7984,6889,1095,13.7
37,187,Washington,2009,6290,5519,771,12.3
37,189,Watauga,2009,23227,21299,1928,8.3
37,191,Wayne,2009,54394,49423,4971,9.1
37,193,Wilkes,2009,30481,26451,4030,13.2
37,195,Wilson,2009,40074,34792,5282,13.2
37,197,Yadkin,2009,18921,16867,2054,10.9
37,199,Yancey,2009,7958,6967,991,12.5
38,1,Adams,2009,1277,1238,39,3.1
38,3,Barnes,2009,6275,6017,258,4.1
38,5,Benson,2009,2641,2489,152,5.8
38,7,Billings,2009,531,519,12,2.3
38,9,Bottineau,2009,3657,3523,134,3.7
38,11,Bowman,2009,1746,1696,50,2.9
38,13,Burke,2009,1107,1073,34,3.1
38,15,Burleigh,2009,47788,46164,1624,3.4
38,17,Cass,2009,88255,84783,3472,3.9
38,19,Cavalier,2009,1988,1923,65,3.3
38,21,Dickey,2009,2783,2644,139,5.0
38,23,Divide,2009,883,852,31,3.5
38,25,Dunn,2009,1788,1716,72,4.0
38,27,Eddy,2009,1189,1129,60,5.0
38,29,Emmons,2009,1683,1575,108,6.4
38,31,Foster,2009,1737,1677,60,3.5
38,33,Golden Valley,2009,895,866,29,3.2
38,35,Grand Forks,2009,38081,36638,1443,3.8
38,37,Grant,2009,1207,1158,49,4.1
38,39,Griggs,2009,1291,1249,42,3.3
38,41,Hettinger,2009,1183,1141,42,3.6
38,43,Kidder,2009,1215,1159,56,4.6
38,45,LaMoure,2009,2280,2188,92,4.0
38,47,Logan,2009,947,915,32,3.4
38,49,McHenry,2009,2688,2556,132,4.9
38,51,McIntosh,2009,1348,1298,50,3.7
38,53,McKenzie,2009,2925,2834,91,3.1
38,55,McLean,2009,4975,4751,224,4.5
38,57,Mercer,2009,5151,4941,210,4.1
38,59,Morton,2009,15032,14408,624,4.2
38,61,Mountrail,2009,3723,3582,141,3.8
38,63,Nelson,2009,1724,1656,68,3.9
38,65,Oliver,2009,1287,1238,49,3.8
38,67,Pembina,2009,3925,3704,221,5.6
38,69,Pierce,2009,1904,1808,96,5.0
38,71,Ramsey,2009,5717,5487,230,4.0
38,73,Ransom,2009,2954,2729,225,7.6
38,75,Renville,2009,1248,1201,47,3.8
38,77,Richland,2009,8714,8285,429,4.9
38,79,Rolette,2009,4956,4409,547,11.0
38,81,Sargent,2009,2005,1801,204,10.2
38,83,Sheridan,2009,662,629,33,5.0
38,85,Sioux,2009,1292,1230,62,4.8
38,87,Slope,2009,564,553,11,2.0
38,89,Stark,2009,14481,14040,441,3.0
38,91,Steele,2009,1122,1091,31,2.8
38,93,Stutsman,2009,11940,11536,404,3.4
38,95,Towner,2009,1082,1050,32,3.0
38,97,Traill,2009,4043,3889,154,3.8
38,99,Walsh,2009,5617,5355,262,4.7
38,101,Ward,2009,29975,28917,1058,3.5
38,103,Wells,2009,2048,1945,103,5.0
38,105,Williams,2009,14835,14480,355,2.4
39,1,Adams,2009,13005,11101,1904,14.6
39,3,Allen,2009,51265,45481,5784,11.3
39,5,Ashland,2009,27176,23782,3394,12.5
39,7,Ashtabula,2009,48517,41944,6573,13.5
39,9,Athens,2009,31285,28538,2747,8.8
39,11,Auglaize,2009,26484,23667,2817,10.6
39,13,Belmont,2009,33875,30759,3116,9.2
39,15,Brown,2009,21775,19003,2772,12.7
39,17,Butler,2009,189168,170946,18222,9.6
39,19,Carroll,2009,14101,12166,1935,13.7
39,21,Champaign,2009,20259,17846,2413,11.9
39,23,Clark,2009,70419,62985,7434,10.6
39,25,Clermont,2009,105511,95187,10324,9.8
39,27,Clinton,2009,21022,17922,3100,14.7
39,29,Columbiana,2009,53027,45938,7089,13.4
39,31,Coshocton,2009,17045,14743,2302,13.5
39,33,Crawford,2009,21791,18571,3220,14.8
39,35,Cuyahoga,2009,628705,578982,49723,7.9
39,37,Darke,2009,27836,24676,3160,11.4
39,39,Defiance,2009,20361,17490,2871,14.1
39,41,Delaware,2009,91789,85323,6466,7.0
39,43,Erie,2009,42526,37526,5000,11.8
39,45,Fairfield,2009,74866,68341,6525,8.7
39,47,Fayette,2009,16746,14871,1875,11.2
39,49,Franklin,2009,624088,571242,52846,8.5
39,51,Fulton,2009,22338,19229,3109,13.9
39,53,Gallia,2009,14141,12796,1345,9.5
39,55,Geauga,2009,52312,49041,3271,6.3
39,57,Greene,2009,80069,72265,7804,9.7
39,59,Guernsey,2009,19456,17091,2365,12.2
39,61,Hamilton,2009,431844,392769,39075,9.0
39,63,Hancock,2009,39902,35746,4156,10.4
39,65,Hardin,2009,15057,13214,1843,12.2
39,67,Harrison,2009,7281,6433,848,11.6
39,69,Henry,2009,15683,13561,2122,13.5
39,71,Highland,2009,20521,17339,3182,15.5
39,73,Hocking,2009,14249,12635,1614,11.3
39,75,Holmes,2009,19158,17644,1514,7.9
39,77,Huron,2009,28714,24199,4515,15.7
39,79,Jackson,2009,15397,13655,1742,11.3
39,81,Jefferson,2009,32763,28730,4033,12.3
39,83,Knox,2009,29942,27003,2939,9.8
39,85,Lake,2009,132898,123241,9657,7.3
39,87,Lawrence,2009,29114,26705,2409,8.3
39,89,Licking,2009,82837,74915,7922,9.6
39,91,Logan,2009,24588,21645,2943,12.0
39,93,Lorain,2009,158992,145201,13791,8.7
39,95,Lucas,2009,221507,194011,27496,12.4
39,97,Madison,2009,20205,18287,1918,9.5
39,99,Mahoning,2009,115362,100893,14469,12.5
39,101,Marion,2009,31540,27926,3614,11.5
39,103,Medina,2009,96145,89394,6751,7.0
39,105,Meigs,2009,9369,7974,1395,14.9
39,107,Mercer,2009,24293,22119,2174,8.9
39,109,Miami,2009,55030,48529,6501,11.8
39,111,Monroe,2009,5656,4937,719,12.7
39,113,Montgomery,2009,263984,233320,30664,11.6
39,115,Morgan,2009,5995,5121,874,14.6
39,117,Morrow,2009,17957,15947,2010,11.2
39,119,Muskingum,2009,38599,33721,4878,12.6
39,121,Noble,2009,5855,5005,850,14.5
39,123,Ottawa,2009,20759,17798,2961,14.3
39,125,Paulding,2009,10409,8968,1441,13.8
39,127,Perry,2009,16751,14499,2252,13.4
39,129,Pickaway,2009,24705,21963,2742,11.1
39,131,Pike,2009,11072,9380,1692,15.3
39,133,Portage,2009,92038,82700,9338,10.1
39,135,Preble,2009,21415,18786,2629,12.3
39,137,Putnam,2009,18192,16252,1940,10.7
39,139,Richland,2009,61506,53576,7930,12.9
39,141,Ross,2009,34853,30611,4242,12.2
39,143,Sandusky,2009,32938,28933,4005,12.2
39,145,Scioto,2009,32665,28582,4083,12.5
39,147,Seneca,2009,30439,26565,3874,12.7
39,149,Shelby,2009,26421,22792,3629,13.7
39,151,Stark,2009,190272,168577,21695,11.4
39,153,Summit,2009,292502,263254,29248,10.0
39,155,Trumbull,2009,106371,91589,14782,13.9
39,157,Tuscarawas,2009,47057,41735,5322,11.3
39,159,Union,2009,25859,23641,2218,8.6
39,161,Van Wert,2009,15146,12890,2256,14.9
39,163,Vinton,2009,5720,4964,756,13.2
39,165,Warren,2009,108755,99082,9673,8.9
39,167,Washington,2009,32824,29682,3142,9.6
39,169,Wayne,2009,57946,52125,5821,10.0
39,171,Williams,2009,20074,16890,3184,15.9
39,173,Wood,2009,65606,58103,7503,11.4
39,175,Wyandot,2009,11158,9592,1566,14.0
40,1,Adair,2009,11203,10281,922,8.2
40,3,Alfalfa,2009,2538,2412,126,5.0
40,5,Atoka,2009,6277,5745,532,8.5
40,7,Beaver,2009,3337,3217,120,3.6
40,9,Beckham,2009,12151,11417,734,6.0
40,11,Blaine,2009,5011,4722,289,5.8
40,13,Bryan,2009,20619,19511,1108,5.4
40,15,Caddo,2009,12959,12135,824,6.4
40,17,Canadian,2009,53474,50419,3055,5.7
40,19,Carter,2009,28641,27006,1635,5.7
40,21,Cherokee,2009,24773,23403,1370,5.5
40,23,Choctaw,2009,7318,6790,528,7.2
40,25,Cimarron,2009,1292,1242,50,3.9
40,27,Cleveland,2009,120515,113898,6617,5.5
40,29,Coal,2009,2644,2411,233,8.8
40,31,Comanche,2009,47737,45173,2564,5.4
40,33,Cotton,2009,3621,3456,165,4.6
40,35,Craig,2009,7564,7129,435,5.8
40,37,Creek,2009,31245,28687,2558,8.2
40,39,Custer,2009,15407,14675,732,4.8
40,41,Delaware,2009,19720,18409,1311,6.6
40,43,Dewey,2009,2753,2630,123,4.5
40,45,Ellis,2009,2472,2356,116,4.7
40,47,Garfield,2009,32110,30666,1444,4.5
40,49,Garvin,2009,15203,14316,887,5.8
40,51,Grady,2009,23263,21553,1710,7.4
40,53,Grant,2009,2693,2589,104,3.9
40,55,Greer,2009,2104,1938,166,7.9
40,57,Harmon,2009,1385,1308,77,5.6
40,59,Harper,2009,2065,1981,84,4.1
40,61,Haskell,2009,6194,5705,489,7.9
40,63,Hughes,2009,5786,5182,604,10.4
40,65,Jackson,2009,12282,11648,634,5.2
40,67,Jefferson,2009,2552,2335,217,8.5
40,69,Johnston,2009,5267,4862,405,7.7
40,71,Kay,2009,23719,21904,1815,7.7
40,73,Kingfisher,2009,7791,7436,355,4.6
40,75,Kiowa,2009,4160,3895,265,6.4
40,77,Latimer,2009,4505,4009,496,11.0
40,79,Le Flore,2009,20902,18799,2103,10.1
40,81,Lincoln,2009,13911,12899,1012,7.3
40,83,Logan,2009,18155,17098,1057,5.8
40,85,Love,2009,5618,5319,299,5.3
40,87,McClain,2009,15212,14321,891,5.9
40,89,McCurtain,2009,14821,13231,1590,10.7
40,91,McIntosh,2009,8944,8214,730,8.2
40,93,Major,2009,4345,4145,200,4.6
40,95,Marshall,2009,6588,6037,551,8.4
40,97,Mayes,2009,18569,16943,1626,8.8
40,99,Murray,2009,9270,8867,403,4.3
40,101,Muskogee,2009,31138,28720,2418,7.8
40,103,Noble,2009,5926,5454,472,8.0
40,105,Nowata,2009,5244,4774,470,9.0
40,107,Okfuskee,2009,4819,4419,400,8.3
40,109,Oklahoma,2009,326787,306237,20550,6.3
40,111,Okmulgee,2009,15935,14449,1486,9.3
40,113,Osage,2009,19724,18197,1527,7.7
40,115,Ottawa,2009,18720,17522,1198,6.4
40,117,Pawnee,2009,7339,6694,645,8.8
40,119,Payne,2009,35392,33172,2220,6.3
40,121,Pittsburg,2009,23679,22176,1503,6.3
40,123,Pontotoc,2009,20869,19710,1159,5.6
40,125,Pottawatomie,2009,33857,31661,2196,6.5
40,127,Pushmataha,2009,5556,5082,474,8.5
40,129,Roger Mills,2009,1948,1858,90,4.6
40,131,Rogers,2009,40526,37640,2886,7.1
40,133,Seminole,2009,11195,10206,989,8.8
40,135,Sequoyah,2009,17681,15950,1731,9.8
40,137,Stephens,2009,22268,20569,1699,7.6
40,139,Texas,2009,7709,7297,412,5.3
40,141,Tillman,2009,3579,3321,258,7.2
40,143,Tulsa,2009,294494,274690,19804,6.7
40,145,Wagoner,2009,33471,31227,2244,6.7
40,147,Washington,2009,28308,26713,1595,5.6
40,149,Washita,2009,6321,5957,364,5.8
40,151,Woods,2009,4581,4382,199,4.3
40,153,Woodward,2009,11707,10961,746,6.4
41,1,Baker,2009,7599,6842,757,10.0
41,3,Benton,2009,43534,40208,3326,7.6
41,5,Clackamas,2009,201496,181400,20096,10.0
41,7,Clatsop,2009,20659,18847,1812,8.8
41,9,Columbia,2009,24514,21372,3142,12.8
41,11,Coos,2009,28431,24871,3560,12.5
41,13,Crook,2009,9478,7819,1659,17.5
41,15,Curry,2009,9436,8240,1196,12.7
41,17,Deschutes,2009,81274,69626,11648,14.3
41,19,Douglas,2009,46866,39797,7069,15.1
41,21,Gilliam,2009,1224,1143,81,6.6
41,23,Grant,2009,3443,2991,452,13.1
41,25,Harney,2009,3514,2962,552,15.7
41,27,Hood River,2009,13918,12827,1091,7.8
41,29,Jackson,2009,101808,89274,12534,12.3
41,31,Jefferson,2009,9295,7952,1343,14.4
41,33,Josephine,2009,35133,30234,4899,13.9
41,35,Klamath,2009,31091,26870,4221,13.6
41,37,Lake,2009,3672,3226,446,12.1
41,39,Lane,2009,183031,161388,21643,11.8
41,41,Lincoln,2009,23162,20803,2359,10.2
41,43,Linn,2009,55894,48392,7502,13.4
41,45,Malheur,2009,13103,11731,1372,10.5
41,47,Marion,2009,157453,140618,16835,10.7
41,49,Morrow,2009,5786,5267,519,9.0
41,51,Multnomah,2009,391875,352178,39697,10.1
41,53,Polk,2009,40062,36419,3643,9.1
41,55,Sherman,2009,1047,955,92,8.8
41,57,Tillamook,2009,12826,11649,1177,9.2
41,59,Umatilla,2009,38603,34991,3612,9.4
41,61,Union,2009,12579,11176,1403,11.2
41,63,Wallowa,2009,3745,3312,433,11.6
41,65,Wasco,2009,14089,12862,1227,8.7
41,67,Washington,2009,289903,263525,26378,9.1
41,69,Wheeler,2009,653,596,57,8.7
41,71,Yamhill,2009,48178,42798,5380,11.2
42,1,Adams,2009,54983,50934,4049,7.4
42,3,Allegheny,2009,639448,596378,43070,6.7
42,5,Armstrong,2009,33100,30106,2994,9.0
42,7,Beaver,2009,89937,82732,7205,8.0
42,9,Bedford,2009,24275,21656,2619,10.8
42,11,Berks,2009,203880,186244,17636,8.7
42,13,Blair,2009,65102,60496,4606,7.1
42,15,Bradford,2009,31346,28747,2599,8.3
42,17,Bucks,2009,343952,319056,24896,7.2
42,19,Butler,2009,99704,92801,6903,6.9
42,21,Cambria,2009,69063,63222,5841,8.5
42,23,Cameron,2009,2361,1961,400,16.9
42,25,Carbon,2009,31448,28304,3144,10.0
42,27,Centre,2009,75335,71000,4335,5.8
42,29,Chester,2009,268170,251584,16586,6.2
42,31,Clarion,2009,20657,18717,1940,9.4
42,33,Clearfield,2009,40724,36704,4020,9.9
42,35,Clinton,2009,19337,17643,1694,8.8
42,37,Columbia,2009,36445,33355,3090,8.5
42,39,Crawford,2009,42878,38680,4198,9.8
42,41,Cumberland,2009,124917,116715,8202,6.6
42,43,Dauphin,2009,137080,126950,10130,7.4
42,45,Delaware,2009,280089,259010,21079,7.5
42,47,Elk,2009,17099,14957,2142,12.5
42,49,Erie,2009,139877,127534,12343,8.8
42,51,Fayette,2009,66002,60005,5997,9.1
42,53,Forest,2009,2381,2124,257,10.8
42,55,Franklin,2009,80944,74463,6481,8.0
42,57,Fulton,2009,7638,6622,1016,13.3
42,59,Greene,2009,19111,17702,1409,7.4
42,61,Huntingdon,2009,22733,20371,2362,10.4
42,63,Indiana,2009,47201,43715,3486,7.4
42,65,Jefferson,2009,22832,20708,2124,9.3
42,67,Juniata,2009,12158,11207,951,7.8
42,69,Lackawanna,2009,107191,98475,8716,8.1
42,71,Lancaster,2009,269588,250328,19260,7.1
42,73,Lawrence,2009,43575,39555,4020,9.2
42,75,Lebanon,2009,72774,67940,4834,6.6
42,77,Lehigh,2009,178417,163083,15334,8.6
42,79,Luzerne,2009,161283,146899,14384,8.9
42,81,Lycoming,2009,60005,54767,5238,8.7
42,83,McKean,2009,21184,19031,2153,10.2
42,85,Mercer,2009,54733,48681,6052,11.1
42,87,Mifflin,2009,22554,20344,2210,9.8
42,89,Monroe,2009,82852,75421,7431,9.0
42,91,Montgomery,2009,425141,396422,28719,6.8
42,93,Montour,2009,9343,8736,607,6.5
42,95,Northampton,2009,153704,140937,12767,8.3
42,97,Northumberland,2009,47318,42783,4535,9.6
42,99,Perry,2009,24729,22806,1923,7.8
42,101,Philadelphia/city,2009,652248,589286,62962,9.7
42,103,Pike,2009,28395,25841,2554,9.0
42,105,Potter,2009,7715,6866,849,11.0
42,107,Schuylkill,2009,73915,66678,7237,9.8
42,109,Snyder,2009,19374,17648,1726,8.9
42,111,Somerset,2009,38853,35574,3279,8.4
42,113,Sullivan,2009,3023,2770,253,8.4
42,115,Susquehanna,2009,21794,19958,1836,8.4
42,117,Tioga,2009,20410,18446,1964,9.6
42,119,Union,2009,17680,16094,1586,9.0
42,121,Venango,2009,26337,24073,2264,8.6
42,123,Warren,2009,21900,20202,1698,7.8
42,125,Washington,2009,106462,98426,8036,7.5
42,127,Wayne,2009,25643,23755,1888,7.4
42,129,Westmoreland,2009,188747,174167,14580,7.7
42,131,Wyoming,2009,14446,13230,1216,8.4
42,133,York,2009,226702,208451,18251,8.1
44,1,Bristol,2009,27256,24401,2855,10.5
44,3,Kent,2009,97463,86868,10595,10.9
44,5,Newport,2009,43711,39272,4439,10.2
44,7,Providence,2009,329173,288605,40568,12.3
44,9,Washington,2009,73604,66786,6818,9.3
45,1,Abbeville,2009,11339,9709,1630,14.4
45,3,Aiken,2009,77105,69895,7210,9.4
45,5,Allendale,2009,3425,2709,716,20.9
45,7,Anderson,2009,85741,75294,10447,12.2
45,9,Bamberg,2009,6482,5453,1029,15.9
45,11,Barnwell,2009,9066,7490,1576,17.4
45,13,Beaufort,2009,63266,57658,5608,8.9
45,15,Berkeley,2009,80970,72536,8434,10.4
45,17,Calhoun,2009,6772,5929,843,12.4
45,19,Charleston,2009,174633,159095,15538,8.9
45,21,Cherokee,2009,25778,21636,4142,16.1
45,23,Chester,2009,15756,12591,3165,20.1
45,25,Chesterfield,2009,19160,15951,3209,16.7
45,27,Clarendon,2009,12847,10890,1957,15.2
45,29,Colleton,2009,17303,15011,2292,13.2
45,31,Darlington,2009,31277,27156,4121,13.2
45,33,Dillon,2009,13879,11723,2156,15.5
45,35,Dorchester,2009,64442,58062,6380,9.9
45,37,Edgefield,2009,11221,10064,1157,10.3
45,39,Fairfield,2009,10889,9435,1454,13.4
45,41,Florence,2009,64055,56806,7249,11.3
45,43,Georgetown,2009,30425,26739,3686,12.1
45,45,Greenville,2009,224564,202267,22297,9.9
45,47,Greenwood,2009,31200,27245,3955,12.7
45,49,Hampton,2009,8011,6810,1201,15.0
45,51,Horry,2009,131142,115587,15555,11.9
45,53,Jasper,2009,10159,9095,1064,10.5
45,55,Kershaw,2009,30062,26836,3226,10.7
45,57,Lancaster,2009,30567,25183,5384,17.6
45,59,Laurens,2009,32261,28419,3842,11.9
45,61,Lee,2009,8554,7316,1238,14.5
45,63,Lexington,2009,133772,122856,10916,8.2
45,65,McCormick,2009,3448,2885,563,16.3
45,67,Marion,2009,13019,10333,2686,20.6
45,69,Marlboro,2009,12129,9783,2346,19.3
45,71,Newberry,2009,18565,16425,2140,11.5
45,73,Oconee,2009,31439,27205,4234,13.5
45,75,Orangeburg,2009,41846,35357,6489,15.5
45,77,Pickens,2009,57350,51237,6113,10.7
45,79,Richland,2009,180968,163973,16995,9.4
45,81,Saluda,2009,9019,8149,870,9.6
45,83,Spartanburg,2009,136523,120037,16486,12.1
45,85,Sumter,2009,45116,39487,5629,12.5
45,87,Union,2009,12171,9807,2364,19.4
45,89,Williamsburg,2009,15968,13613,2355,14.7
45,91,York,2009,113056,97572,15484,13.7
46,3,Aurora,2009,1514,1452,62,4.1
46,5,Beadle,2009,9629,9301,328,3.4
46,7,Bennett,2009,1416,1345,71,5.0
46,9,Bon Homme,2009,3102,2948,154,5.0
46,11,Brookings,2009,18841,18187,654,3.5
46,13,Brown,2009,21019,20314,705,3.4
46,15,Brule,2009,2830,2738,92,3.3
46,17,Buffalo,2009,501,430,71,14.2
46,19,Butte,2009,5389,5136,253,4.7
46,21,Campbell,2009,848,815,33,3.9
46,23,Charles Mix,2009,4149,3960,189,4.6
46,25,Clark,2009,1807,1712,95,5.3
46,27,Clay,2009,7579,7297,282,3.7
46,29,Codington,2009,16069,15146,923,5.7
46,31,Corson,2009,1398,1312,86,6.2
46,33,Custer,2009,4969,4776,193,3.9
46,35,Davison,2009,11110,10612,498,4.5
46,37,Day,2009,2884,2698,186,6.4
46,39,Deuel,2009,2697,2548,149,5.5
46,41,Dewey,2009,2629,2360,269,10.2
46,43,Douglas,2009,1758,1690,68,3.9
46,45,Edmunds,2009,1990,1926,64,3.2
46,47,Fall River,2009,3768,3558,210,5.6
46,49,Faulk,2009,1139,1102,37,3.2
46,51,Grant,2009,4160,3977,183,4.4
46,53,Gregory,2009,2327,2238,89,3.8
46,55,Haakon,2009,1157,1117,40,3.5
46,57,Hamlin,2009,2937,2790,147,5.0
46,59,Hand,2009,1911,1856,55,2.9
46,61,Hanson,2009,1902,1823,79,4.2
46,63,Harding,2009,790,767,23,2.9
46,65,Hughes,2009,10299,9991,308,3.0
46,67,Hutchinson,2009,3771,3625,146,3.9
46,69,Hyde,2009,752,725,27,3.6
46,71,Jackson,2009,1256,1176,80,6.4
46,73,Jerauld,2009,1379,1340,39,2.8
46,75,Jones,2009,718,697,21,2.9
46,77,Kingsbury,2009,2942,2797,145,4.9
46,79,Lake,2009,6658,6265,393,5.9
46,81,Lawrence,2009,13452,12909,543,4.0
46,83,Lincoln,2009,22067,21182,885,4.0
46,85,Lyman,2009,1997,1885,112,5.6
46,87,McCook,2009,2613,2482,131,5.0
46,89,McPherson,2009,1152,1095,57,4.9
46,91,Marshall,2009,2082,1954,128,6.1
46,93,Meade,2009,11947,11393,554,4.6
46,95,Mellette,2009,865,808,57,6.6
46,97,Miner,2009,1265,1202,63,5.0
46,99,Minnehaha,2009,99450,94805,4645,4.7
46,101,Moody,2009,3908,3665,243,6.2
46,102,Oglala Lakota,2009,3934,3536,398,10.1
46,103,Pennington,2009,54752,52267,2485,4.5
46,105,Perkins,2009,1618,1556,62,3.8
46,107,Potter,2009,1300,1255,45,3.5
46,109,Roberts,2009,4748,4483,265,5.6
46,111,Sanborn,2009,1398,1347,51,3.6
46,115,Spink,2009,3437,3304,133,3.9
46,117,Stanley,2009,1933,1876,57,2.9
46,119,Sully,2009,992,964,28,2.8
46,121,Todd,2009,3516,3283,233,6.6
46,123,Tripp,2009,2938,2842,96,3.3
46,125,Turner,2009,4040,3847,193,4.8
46,127,Union,2009,8446,7977,469,5.6
46,129,Walworth,2009,2691,2564,127,4.7
46,135,Yankton,2009,11889,11273,616,5.2
46,137,Ziebach,2009,878,821,57,6.5
47,1,Anderson,2009,35824,32392,3432,9.6
47,3,Bedford,2009,22265,19626,2639,11.9
47,5,Benton,2009,7002,6058,944,13.5
47,7,Bledsoe,2009,4895,4229,666,13.6
47,9,Blount,2009,63323,57272,6051,9.6
47,11,Bradley,2009,47375,43022,4353,9.2
47,13,Campbell,2009,16851,14698,2153,12.8
47,15,Cannon,2009,6544,5785,759,11.6
47,17,Carroll,2009,13642,11522,2120,15.5
47,19,Carter,2009,29226,26307,2919,10.0
47,21,Cheatham,2009,20262,18409,1853,9.1
47,23,Chester,2009,7808,6954,854,10.9
47,25,Claiborne,2009,13083,11555,1528,11.7
47,27,Clay,2009,3310,2840,470,14.2
47,29,Cocke,2009,16507,14273,2234,13.5
47,31,Coffee,2009,25369,22725,2644,10.4
47,33,Crockett,2009,6473,5649,824,12.7
47,35,Cumberland,2009,22881,20360,2521,11.0
47,37,Davidson,2009,321139,293471,27668,8.6
47,39,Decatur,2009,5663,4928,735,13.0
47,41,DeKalb,2009,9934,8885,1049,10.6
47,43,Dickson,2009,23358,20859,2499,10.7
47,45,Dyer,2009,17452,15092,2360,13.5
47,47,Fayette,2009,18088,16147,1941,10.7
47,49,Fentress,2009,7916,6888,1028,13.0
47,51,Franklin,2009,19501,17439,2062,10.6
47,53,Gibson,2009,21414,18361,3053,14.3
47,55,Giles,2009,13315,11387,1928,14.5
47,57,Grainger,2009,10040,8674,1366,13.6
47,59,Greene,2009,29649,25096,4553,15.4
47,61,Grundy,2009,5968,5151,817,13.7
47,63,Hamblen,2009,29751,26093,3658,12.3
47,65,Hamilton,2009,163228,148986,14242,8.7
47,67,Hancock,2009,2643,2263,380,14.4
47,69,Hardeman,2009,11247,9864,1383,12.3
47,71,Hardin,2009,11778,10353,1425,12.1
47,73,Hawkins,2009,27296,24315,2981,10.9
47,75,Haywood,2009,9221,7793,1428,15.5
47,77,Henderson,2009,11947,9847,2100,17.6
47,79,Henry,2009,13568,11810,1758,13.0
47,81,Hickman,2009,10014,8752,1262,12.6
47,83,Houston,2009,3894,3437,457,11.7
47,85,Humphreys,2009,8965,7857,1108,12.4
47,87,Jackson,2009,4967,4308,659,13.3
47,89,Jefferson,2009,24118,21167,2951,12.2
47,91,Johnson,2009,7406,6483,923,12.5
47,93,Knox,2009,229032,211089,17943,7.8
47,95,Lake,2009,2644,2361,283,10.7
47,97,Lauderdale,2009,10316,8433,1883,18.3
47,99,Lawrence,2009,16730,14227,2503,15.0
47,101,Lewis,2009,5529,4686,843,15.2
47,103,Lincoln,2009,17003,15821,1182,7.0
47,105,Loudon,2009,23505,21300,2205,9.4
47,107,McMinn,2009,23362,20193,3169,13.6
47,109,McNairy,2009,10988,9498,1490,13.6
47,111,Macon,2009,10549,9294,1255,11.9
47,113,Madison,2009,48058,43104,4954,10.3
47,115,Marion,2009,12616,11111,1505,11.9
47,117,Marshall,2009,12396,10302,2094,16.9
47,119,Maury,2009,37080,32130,4950,13.3
47,121,Meigs,2009,5094,4374,720,14.1
47,123,Monroe,2009,18594,15436,3158,17.0
47,125,Montgomery,2009,68912,62978,5934,8.6
47,127,Moore,2009,3032,2753,279,9.2
47,129,Morgan,2009,8751,7790,961,11.0
47,131,Obion,2009,15101,13596,1505,10.0
47,133,Overton,2009,10025,8727,1298,12.9
47,135,Perry,2009,2797,2172,625,22.3
47,137,Pickett,2009,1806,1543,263,14.6
47,139,Polk,2009,7027,6169,858,12.2
47,141,Putnam,2009,35788,32424,3364,9.4
47,143,Rhea,2009,13364,11611,1753,13.1
47,145,Roane,2009,27315,24902,2413,8.8
47,147,Robertson,2009,33758,30419,3339,9.9
47,149,Rutherford,2009,135027,122404,12623,9.3
47,151,Scott,2009,8439,6936,1503,17.8
47,153,Sequatchie,2009,6265,5514,751,12.0
47,155,Sevier,2009,48404,43321,5083,10.5
47,157,Shelby,2009,435361,392698,42663,9.8
47,159,Smith,2009,9287,8064,1223,13.2
47,161,Stewart,2009,5873,5195,678,11.5
47,163,Sullivan,2009,74546,68195,6351,8.5
47,165,Sumner,2009,80084,72466,7618,9.5
47,167,Tipton,2009,28806,25344,3462,12.0
47,169,Trousdale,2009,3691,3259,432,11.7
47,171,Unicoi,2009,8413,7467,946,11.2
47,173,Union,2009,8853,7923,930,10.5
47,175,Van Buren,2009,2432,2081,351,14.4
47,177,Warren,2009,17009,14645,2364,13.9
47,179,Washington,2009,62245,56998,5247,8.4
47,181,Wayne,2009,6642,5777,865,13.0
47,183,Weakley,2009,15835,13921,1914,12.1
47,185,White,2009,10596,9142,1454,13.7
47,187,Williamson,2009,89196,82689,6507,7.3
47,189,Wilson,2009,58384,53283,5101,8.7
48,1,Anderson,2009,20909,19099,1810,8.7
48,3,Andrews,2009,7005,6514,491,7.0
48,5,Angelina,2009,40071,36796,3275,8.2
48,7,Aransas,2009,11600,10810,790,6.8
48,9,Archer,2009,5016,4720,296,5.9
48,11,Armstrong,2009,1063,1015,48,4.5
48,13,Atascosa,2009,19474,18034,1440,7.4
48,15,Austin,2009,13252,12285,967,7.3
48,17,Bailey,2009,3360,3172,188,5.6
48,19,Bandera,2009,9845,9205,640,6.5
48,21,Bastrop,2009,34343,31633,2710,7.9
48,23,Baylor,2009,1967,1857,110,5.6
48,25,Bee,2009,11912,10843,1069,9.0
48,27,Bell,2009,127238,118800,8438,6.6
48,29,Bexar,2009,766091,714633,51458,6.7
48,31,Blanco,2009,5081,4819,262,5.2
48,33,Borden,2009,425,402,23,5.4
48,35,Bosque,2009,8574,7909,665,7.8
48,37,Bowie,2009,44310,41387,2923,6.6
48,39,Brazoria,2009,146544,134733,11811,8.1
48,41,Brazos,2009,96932,91652,5280,5.4
48,43,Brewster,2009,5168,4907,261,5.1
48,45,Briscoe,2009,716,680,36,5.0
48,47,Brooks,2009,3318,3009,309,9.3
48,49,Brown,2009,19067,17772,1295,6.8
48,51,Burleson,2009,8165,7607,558,6.8
48,53,Burnet,2009,22287,20935,1352,6.1
48,55,Caldwell,2009,15784,14473,1311,8.3
48,57,Calhoun,2009,9472,8671,801,8.5
48,59,Callahan,2009,7112,6700,412,5.8
48,61,Cameron,2009,151819,137116,14703,9.7
48,63,Camp,2009,5759,5251,508,8.8
48,65,Carson,2009,3270,3080,190,5.8
48,67,Cass,2009,13372,11861,1511,11.3
48,69,Castro,2009,3704,3527,177,4.8
48,71,Chambers,2009,15390,13996,1394,9.1
48,73,Cherokee,2009,21023,19179,1844,8.8
48,75,Childress,2009,3307,3107,200,6.0
48,77,Clay,2009,6092,5675,417,6.8
48,79,Cochran,2009,1511,1414,97,6.4
48,81,Coke,2009,1324,1218,106,8.0
48,83,Coleman,2009,4394,4092,302,6.9
48,85,Collin,2009,416163,386087,30076,7.2
48,87,Collingsworth,2009,1497,1416,81,5.4
48,89,Colorado,2009,10773,10089,684,6.3
48,91,Comal,2009,57442,53925,3517,6.1
48,93,Comanche,2009,6853,6441,412,6.0
48,95,Concho,2009,1352,1256,96,7.1
48,97,Cooke,2009,21882,20465,1417,6.5
48,99,Coryell,2009,24346,22355,1991,8.2
48,101,Cottle,2009,802,758,44,5.5
48,103,Crane,2009,1776,1622,154,8.7
48,105,Crockett,2009,2288,2093,195,8.5
48,107,Crosby,2009,2588,2410,178,6.9
48,109,Culberson,2009,1814,1743,71,3.9
48,111,Dallam,2009,3768,3612,156,4.1
48,113,Dallas,2009,1146371,1052348,94023,8.2
48,115,Dawson,2009,5373,4947,426,7.9
48,117,Deaf Smith,2009,9165,8689,476,5.2
48,119,Delta,2009,2260,2065,195,8.6
48,121,Denton,2009,351698,326721,24977,7.1
48,123,DeWitt,2009,9203,8513,690,7.5
48,125,Dickens,2009,1029,956,73,7.1
48,127,Dimmit,2009,4210,3791,419,10.0
48,129,Donley,2009,1932,1820,112,5.8
48,131,Duval,2009,5269,4695,574,10.9
48,133,Eastland,2009,8616,7968,648,7.5
48,135,Ector,2009,71664,65874,5790,8.1
48,137,Edwards,2009,1079,1003,76,7.0
48,139,Ellis,2009,71140,65505,5635,7.9
48,141,El Paso,2009,308412,281253,27159,8.8
48,143,Erath,2009,19251,18041,1210,6.3
48,145,Falls,2009,6689,6108,581,8.7
48,147,Fannin,2009,13666,12494,1172,8.6
48,149,Fayette,2009,12296,11626,670,5.4
48,151,Fisher,2009,2026,1905,121,6.0
48,153,Floyd,2009,3230,3020,210,6.5
48,155,Foard,2009,722,681,41,5.7
48,157,Fort Bend,2009,277586,257850,19736,7.1
48,159,Franklin,2009,5481,5109,372,6.8
48,161,Freestone,2009,10168,9529,639,6.3
48,163,Frio,2009,7460,6905,555,7.4
48,165,Gaines,2009,7062,6620,442,6.3
48,167,Galveston,2009,140873,129344,11529,8.2
48,169,Garza,2009,2464,2337,127,5.2
48,171,Gillespie,2009,13731,13122,609,4.4
48,173,Glasscock,2009,654,624,30,4.6
48,175,Goliad,2009,3393,3160,233,6.9
48,177,Gonzales,2009,10155,9598,557,5.5
48,179,Gray,2009,11309,10396,913,8.1
48,181,Grayson,2009,56932,52423,4509,7.9
48,183,Gregg,2009,65181,60569,4612,7.1
48,185,Grimes,2009,11576,10587,989,8.5
48,187,Guadalupe,2009,60210,56356,3854,6.4
48,189,Hale,2009,17371,16328,1043,6.0
48,191,Hall,2009,1466,1346,120,8.2
48,193,Hamilton,2009,4365,4121,244,5.6
48,195,Hansford,2009,2793,2647,146,5.2
48,197,Hardeman,2009,2269,2104,165,7.3
48,199,Hardin,2009,27295,24975,2320,8.5
48,201,Harris,2009,1976914,1827894,149020,7.5
48,203,Harrison,2009,32909,30228,2681,8.1
48,205,Hartley,2009,2473,2373,100,4.0
48,207,Haskell,2009,3249,3085,164,5.0
48,209,Hays,2009,79174,73980,5194,6.6
48,211,Hemphill,2009,2625,2535,90,3.4
48,213,Henderson,2009,35235,32405,2830,8.0
48,215,Hidalgo,2009,297367,266261,31106,10.5
48,217,Hill,2009,16466,15183,1283,7.8
48,219,Hockley,2009,12231,11411,820,6.7
48,221,Hood,2009,26304,24416,1888,7.2
48,223,Hopkins,2009,17877,16796,1081,6.0
48,225,Houston,2009,8236,7486,750,9.1
48,227,Howard,2009,14367,13323,1044,7.3
48,229,Hudspeth,2009,1724,1631,93,5.4
48,231,Hunt,2009,36524,33546,2978,8.2
48,233,Hutchinson,2009,11386,10618,768,6.7
48,235,Irion,2009,923,875,48,5.2
48,237,Jack,2009,5292,4963,329,6.2
48,239,Jackson,2009,6941,6431,510,7.3
48,241,Jasper,2009,15977,14368,1609,10.1
48,243,Jeff Davis,2009,1204,1147,57,4.7
48,245,Jefferson,2009,115751,104745,11006,9.5
48,247,Jim Hogg,2009,3017,2785,232,7.7
48,249,Jim Wells,2009,21714,19758,1956,9.0
48,251,Johnson,2009,75127,69009,6118,8.1
48,253,Jones,2009,7789,7194,595,7.6
48,255,Karnes,2009,5497,5005,492,9.0
48,257,Kaufman,2009,46998,43137,3861,8.2
48,259,Kendall,2009,16761,15816,945,5.6
48,261,Kenedy,2009,236,222,14,5.9
48,263,Kent,2009,464,440,24,5.2
48,265,Kerr,2009,23389,22044,1345,5.8
48,267,Kimble,2009,2151,2039,112,5.2
48,269,King,2009,196,186,10,5.1
48,271,Kinney,2009,1440,1329,111,7.7
48,273,Kleberg,2009,17076,15934,1142,6.7
48,275,Knox,2009,1837,1731,106,5.8
48,277,Lamar,2009,23569,21773,1796,7.6
48,279,Lamb,2009,7101,6596,505,7.1
48,281,Lampasas,2009,10523,9914,609,5.8
48,283,La Salle,2009,2928,2658,270,9.2
48,285,Lavaca,2009,10035,9466,569,5.7
48,287,Lee,2009,9139,8532,607,6.6
48,289,Leon,2009,8273,7695,578,7.0
48,291,Liberty,2009,31539,28351,3188,10.1
48,293,Limestone,2009,11266,10561,705,6.3
48,295,Lipscomb,2009,1735,1618,117,6.7
48,297,Live Oak,2009,5211,4848,363,7.0
48,299,Llano,2009,8546,7956,590,6.9
48,301,Loving,2009,43,39,4,9.3
48,303,Lubbock,2009,142374,134756,7618,5.4
48,305,Lynn,2009,2879,2708,171,5.9
48,307,McCulloch,2009,3947,3635,312,7.9
48,309,McLennan,2009,114083,106425,7658,6.7
48,311,McMullen,2009,361,336,25,6.9
48,313,Madison,2009,5343,4949,394,7.4
48,315,Marion,2009,5146,4618,528,10.3
48,317,Martin,2009,2252,2144,108,4.8
48,319,Mason,2009,2406,2286,120,5.0
48,321,Matagorda,2009,17885,16109,1776,9.9
48,323,Maverick,2009,22780,19528,3252,14.3
48,325,Medina,2009,19934,18611,1323,6.6
48,327,Menard,2009,1105,1033,72,6.5
48,329,Midland,2009,75148,70984,4164,5.5
48,331,Milam,2009,11485,10239,1246,10.8
48,333,Mills,2009,2457,2326,131,5.3
48,335,Mitchell,2009,3507,3217,290,8.3
48,337,Montague,2009,10725,9965,760,7.1
48,339,Montgomery,2009,220860,205646,15214,6.9
48,341,Moore,2009,11545,11011,534,4.6
48,343,Morris,2009,6095,5193,902,14.8
48,345,Motley,2009,688,651,37,5.4
48,347,Nacogdoches,2009,31918,29859,2059,6.5
48,349,Navarro,2009,21378,19706,1672,7.8
48,351,Newton,2009,5868,5198,670,11.4
48,353,Nolan,2009,7879,7387,492,6.2
48,355,Nueces,2009,166093,154931,11162,6.7
48,357,Ochiltree,2009,5517,5192,325,5.9
48,359,Oldham,2009,925,874,51,5.5
48,361,Orange,2009,41511,37440,4071,9.8
48,363,Palo Pinto,2009,14250,13137,1113,7.8
48,365,Panola,2009,13236,12268,968,7.3
48,367,Parker,2009,54763,50623,4140,7.6
48,369,Parmer,2009,4636,4433,203,4.4
48,371,Pecos,2009,8433,7711,722,8.6
48,373,Polk,2009,18027,16398,1629,9.0
48,375,Potter,2009,57790,54325,3465,6.0
48,377,Presidio,2009,3753,3149,604,16.1
48,379,Rains,2009,5130,4721,409,8.0
48,381,Randall,2009,69361,66177,3184,4.6
48,383,Reagan,2009,2221,2088,133,6.0
48,385,Real,2009,1542,1457,85,5.5
48,387,Red River,2009,6027,5477,550,9.1
48,389,Reeves,2009,4699,4164,535,11.4
48,391,Refugio,2009,4152,3887,265,6.4
48,393,Roberts,2009,585,557,28,4.8
48,395,Robertson,2009,7240,6676,564,7.8
48,397,Rockwall,2009,39443,36626,2817,7.1
48,399,Runnels,2009,4574,4233,341,7.5
48,401,Rusk,2009,24334,22449,1885,7.7
48,403,Sabine,2009,3549,3019,530,14.9
48,405,San Augustine,2009,3614,3252,362,10.0
48,407,San Jacinto,2009,10167,9226,941,9.3
48,409,San Patricio,2009,30713,28097,2616,8.5
48,411,San Saba,2009,2462,2288,174,7.1
48,413,Schleicher,2009,1513,1373,140,9.3
48,415,Scurry,2009,7784,7262,522,6.7
48,417,Shackelford,2009,2133,2048,85,4.0
48,419,Shelby,2009,12648,11732,916,7.2
48,421,Sherman,2009,1448,1385,63,4.4
48,423,Smith,2009,100678,93095,7583,7.5
48,425,Somervell,2009,4235,3936,299,7.1
48,427,Starr,2009,24489,20479,4010,16.4
48,429,Stephens,2009,4641,4329,312,6.7
48,431,Sterling,2009,858,822,36,4.2
48,433,Stonewall,2009,851,815,36,4.2
48,435,Sutton,2009,3459,3214,245,7.1
48,437,Swisher,2009,3659,3450,209,5.7
48,439,Tarrant,2009,898809,829943,68866,7.7
48,441,Taylor,2009,68021,64222,3799,5.6
48,443,Terrell,2009,384,349,35,9.1
48,445,Terry,2009,6046,5632,414,6.8
48,447,Throckmorton,2009,1036,986,50,4.8
48,449,Titus,2009,14348,13315,1033,7.2
48,451,Tom Green,2009,52942,49612,3330,6.3
48,453,Travis,2009,548967,512405,36562,6.7
48,455,Trinity,2009,5922,5422,500,8.4
48,457,Tyler,2009,8464,7644,820,9.7
48,459,Upshur,2009,19707,18221,1486,7.5
48,461,Upton,2009,1822,1723,99,5.4
48,463,Uvalde,2009,11623,10707,916,7.9
48,465,Val Verde,2009,21055,19122,1933,9.2
48,467,Van Zandt,2009,26014,24216,1798,6.9
48,469,Victoria,2009,45512,42379,3133,6.9
48,471,Walker,2009,27748,25817,1931,7.0
48,473,Waller,2009,16486,15132,1354,8.2
48,475,Ward,2009,5047,4606,441,8.7
48,477,Washington,2009,17014,15993,1021,6.0
48,479,Webb,2009,94396,86377,8019,8.5
48,481,Wharton,2009,21269,19790,1479,7.0
48,483,Wheeler,2009,3220,3039,181,5.6
48,485,Wichita,2009,61577,56955,4622,7.5
48,487,Wilbarger,2009,7896,7527,369,4.7
48,489,Willacy,2009,8410,7411,999,11.9
48,491,Williamson,2009,210536,195151,15385,7.3
48,493,Wilson,2009,18955,17729,1226,6.5
48,495,Winkler,2009,3421,3103,318,9.3
48,497,Wise,2009,28321,25870,2451,8.7
48,499,Wood,2009,18658,17173,1485,8.0
48,501,Yoakum,2009,4112,3801,311,7.6
48,503,Young,2009,9700,9077,623,6.4
48,505,Zapata,2009,5341,4763,578,10.8
48,507,Zavala,2009,3932,3364,568,14.4
49,1,Beaver,2009,3571,3353,218,6.1
49,3,Box Elder,2009,23351,21488,1863,8.0
49,5,Cache,2009,62421,59035,3386,5.4
49,7,Carbon,2009,10547,9722,825,7.8
49,9,Daggett,2009,482,454,28,5.8
49,11,Davis,2009,145736,136223,9513,6.5
49,13,Duchesne,2009,10408,9528,880,8.5
49,15,Emery,2009,5279,4909,370,7.0
49,17,Garfield,2009,2888,2590,298,10.3
49,19,Grand,2009,5432,4904,528,9.7
49,21,Iron,2009,21066,19231,1835,8.7
49,23,Juab,2009,3984,3589,395,9.9
49,25,Kane,2009,3539,3273,266,7.5
49,27,Millard,2009,6516,6156,360,5.5
49,29,Morgan,2009,4091,3836,255,6.2
49,31,Piute,2009,899,841,58,6.5
49,33,Rich,2009,1470,1396,74,5.0
49,35,Salt Lake,2009,556963,517994,38969,7.0
49,37,San Juan,2009,5321,4697,624,11.7
49,39,Sanpete,2009,11399,10449,950,8.3
49,41,Sevier,2009,9931,9157,774,7.8
49,43,Summit,2009,22341,20792,1549,6.9
49,45,Tooele,2009,28364,26143,2221,7.8
49,47,Uintah,2009,17790,16318,1472,8.3
49,49,Utah,2009,222838,207334,15504,7.0
49,51,Wasatch,2009,10078,9242,836,8.3
49,53,Washington,2009,60341,54486,5855,9.7
49,55,Wayne,2009,1487,1367,120,8.1
49,57,Weber,2009,115309,105702,9607,8.3
50,1,Addison,2009,21880,20624,1256,5.7
50,3,Bennington,2009,20572,19097,1475,7.2
50,5,Caledonia,2009,16738,15518,1220,7.3
50,7,Chittenden,2009,90297,85543,4754,5.3
50,9,Essex,2009,3309,3030,279,8.4
50,11,Franklin,2009,26578,24944,1634,6.1
50,13,Grand Isle,2009,4252,3942,310,7.3
50,15,Lamoille,2009,15659,14546,1113,7.1
50,17,Orange,2009,16614,15647,967,5.8
50,19,Orleans,2009,14536,13285,1251,8.6
50,21,Rutland,2009,35572,32919,2653,7.5
50,23,Washington,2009,34789,32733,2056,5.9
50,25,Windham,2009,25228,23736,1492,5.9
50,27,Windsor,2009,33274,31464,1810,5.4
51,1,Accomack,2009,19790,18478,1312,6.6
51,3,Albemarle,2009,52139,49407,2732,5.2
51,5,Alleghany,2009,7105,6445,660,9.3
51,7,Amelia,2009,6681,6152,529,7.9
51,9,Amherst,2009,15699,14458,1241,7.9
51,11,Appomattox,2009,7174,6595,579,8.1
51,13,Arlington,2009,137724,131729,5995,4.4
51,15,Augusta,2009,38600,36065,2535,6.6
51,17,Bath,2009,2702,2530,172,6.4
51,19,Bedford,2009,37871,35236,2635,7.0
51,21,Bland,2009,3611,3338,273,7.6
51,23,Botetourt,2009,17565,16437,1128,6.4
51,25,Brunswick,2009,7234,6406,828,11.4
51,27,Buchanan,2009,9280,8472,808,8.7
51,29,Buckingham,2009,7407,6794,613,8.3
51,31,Campbell,2009,27258,25245,2013,7.4
51,33,Caroline,2009,14193,12977,1216,8.6
51,35,Carroll,2009,14484,12884,1600,11.0
51,36,Charles City,2009,3852,3498,354,9.2
51,37,Charlotte,2009,5575,5051,524,9.4
51,41,Chesterfield,2009,168067,156656,11411,6.8
51,43,Clarke,2009,8136,7612,524,6.4
51,45,Craig,2009,2454,2269,185,7.5
51,47,Culpeper,2009,21407,19677,1730,8.1
51,49,Cumberland,2009,4618,4274,344,7.4
51,51,Dickenson,2009,6473,5901,572,8.8
51,53,Dinwiddie,2009,13121,12044,1077,8.2
51,57,Essex,2009,5848,5366,482,8.2
51,59,Fairfax,2009,589897,561229,28668,4.9
51,61,Fauquier,2009,37560,35459,2101,5.6
51,63,Floyd,2009,7370,6795,575,7.8
51,65,Fluvanna,2009,14050,13227,823,5.9
51,67,Franklin,2009,26934,24679,2255,8.4
51,69,Frederick,2009,41089,37925,3164,7.7
51,71,Giles,2009,8375,7593,782,9.3
51,73,Gloucester,2009,20917,19633,1284,6.1
51,75,Goochland,2009,11433,10674,759,6.6
51,77,Grayson,2009,7334,6534,800,10.9
51,79,Greene,2009,10799,10161,638,5.9
51,81,Greensville,2009,4422,4018,404,9.1
51,83,Halifax,2009,16621,14709,1912,11.5
51,85,Hanover,2009,54812,51158,3654,6.7
51,87,Henrico,2009,165056,153471,11585,7.0
51,89,Henry,2009,25744,22154,3590,13.9
51,91,Highland,2009,1167,1077,90,7.7
51,93,Isle of Wight,2009,18920,17720,1200,6.3
51,95,James City,2009,32303,30533,1770,5.5
51,97,King and Queen,2009,3278,3010,268,8.2
51,99,King George,2009,10299,9503,796,7.7
51,101,King William,2009,8701,8078,623,7.2
51,103,Lancaster,2009,5682,5145,537,9.5
51,105,Lee,2009,10171,9421,750,7.4
51,107,Loudoun,2009,174974,166583,8391,4.8
51,109,Louisa,2009,16743,15401,1342,8.0
51,111,Lunenburg,2009,5643,5109,534,9.5
51,113,Madison,2009,7461,6993,468,6.3
51,115,Mathews,2009,4353,4108,245,5.6
51,117,Mecklenburg,2009,14142,12569,1573,11.1
51,119,Middlesex,2009,5208,4854,354,6.8
51,121,Montgomery,2009,45648,42404,3244,7.1
51,125,Nelson,2009,8074,7547,527,6.5
51,127,New Kent,2009,9918,9213,705,7.1
51,131,Northampton,2009,6411,5910,501,7.8
51,133,Northumberland,2009,6144,5599,545,8.9
51,135,Nottoway,2009,6670,6124,546,8.2
51,137,Orange,2009,15909,14655,1254,7.9
51,139,Page,2009,12136,10681,1455,12.0
51,141,Patrick,2009,9299,8244,1055,11.3
51,143,Pittsylvania,2009,31966,28511,3455,10.8
51,145,Powhatan,2009,14225,13310,915,6.4
51,147,Prince Edward,2009,10041,9130,911,9.1
51,149,Prince George,2009,15118,14048,1070,7.1
51,153,Prince William,2009,209271,197618,11653,5.6
51,155,Pulaski,2009,18218,16192,2026,11.1
51,157,Rappahannock,2009,4246,3994,252,5.9
51,159,Richmond,2009,4108,3784,324,7.9
51,161,Roanoke,2009,48708,45783,2925,6.0
51,163,Rockbridge,2009,11720,10948,772,6.6
51,165,Rockingham,2009,41878,39370,2508,6.0
51,167,Russell,2009,12461,11126,1335,10.7
51,169,Scott,2009,9911,8944,967,9.8
51,171,Shenandoah,2009,20327,18628,1699,8.4
51,173,Smyth,2009,15233,13509,1724,11.3
51,175,Southampton,2009,8132,7471,661,8.1
51,177,Spotsylvania,2009,65184,61441,3743,5.7
51,179,Stafford,2009,65781,62102,3679,5.6
51,181,Surry,2009,3737,3451,286,7.7
51,183,Sussex,2009,4464,4002,462,10.3
51,185,Tazewell,2009,21580,19919,1661,7.7
51,187,Warren,2009,19837,18309,1528,7.7
51,191,Washington,2009,27125,24770,2355,8.7
51,193,Westmoreland,2009,9175,8462,713,7.8
51,195,Wise,2009,19498,18181,1317,6.8
51,197,Wythe,2009,16481,14721,1760,10.7
51,199,York,2009,30559,28902,1657,5.4
51,510,Alexandria city,2009,94797,90145,4652,4.9
51,520,Bristol city,2009,8166,7335,831,10.2
51,530,Buena Vista city,2009,3465,3164,301,8.7
51,540,Charlottesville city,2009,21811,20374,1437,6.6
51,550,Chesapeake city,2009,115430,107923,7507,6.5
51,570,Colonial Heights city,2009,9203,8464,739,8.0
51,580,Covington city,2009,2756,2473,283,10.3
51,590,Danville city,2009,20221,17437,2784,13.8
51,595,Emporia city,2009,2549,2234,315,12.4
51,600,Fairfax city,2009,14585,13761,824,5.6
51,610,Falls Church city,2009,7291,6777,514,7.0
51,620,Franklin city,2009,3965,3556,409,10.3
51,630,Fredericksburg city,2009,13049,11802,1247,9.6
51,640,Galax city,2009,3250,2929,321,9.9
51,650,Hampton city,2009,67619,62217,5402,8.0
51,660,Harrisonburg city,2009,23149,21558,1591,6.9
51,670,Hopewell city,2009,10608,9480,1128,10.6
51,678,Lexington city,2009,2492,2246,246,9.9
51,680,Lynchburg city,2009,35007,32130,2877,8.2
51,683,Manassas city,2009,20561,19026,1535,7.5
51,685,Manassas Park city,2009,6899,6473,426,6.2
51,690,Martinsville city,2009,6253,5025,1228,19.6
51,700,Newport News city,2009,94857,87673,7184,7.6
51,710,Norfolk city,2009,99228,90574,8654,8.7
51,720,Norton city,2009,1732,1619,113,6.5
51,730,Petersburg city,2009,14545,12568,1977,13.6
51,735,Poquoson city,2009,6222,5893,329,5.3
51,740,Portsmouth city,2009,45386,41442,3944,8.7
51,750,Radford city,2009,7960,7235,725,9.1
51,760,Richmond city,2009,101605,91672,9933,9.8
51,770,Roanoke city,2009,47493,43316,4177,8.8
51,775,Salem city,2009,13346,12476,870,6.5
51,790,Staunton city,2009,11945,11060,885,7.4
51,800,Suffolk city,2009,40753,37961,2792,6.9
51,810,Virginia Beach city,2009,220666,207169,13497,6.1
51,820,Waynesboro city,2009,10750,9814,936,8.7
51,830,Williamsburg city,2009,5577,4734,843,15.1
51,840,Winchester city,2009,14283,13103,1180,8.3
53,1,Adams,2009,8142,7461,681,8.4
53,3,Asotin,2009,10162,9259,903,8.9
53,5,Benton,2009,90965,84898,6067,6.7
53,7,Chelan,2009,41241,38159,3082,7.5
53,9,Clallam,2009,29697,26921,2776,9.3
53,11,Clark,2009,213889,187511,26378,12.3
53,13,Columbia,2009,1564,1404,160,10.2
53,15,Cowlitz,2009,43883,38406,5477,12.5
53,17,Douglas,2009,21711,20100,1611,7.4
53,19,Ferry,2009,3007,2635,372,12.4
53,21,Franklin,2009,35989,33192,2797,7.8
53,23,Garfield,2009,1006,939,67,6.7
53,25,Grant,2009,41414,37603,3811,9.2
53,27,Grays Harbor,2009,30818,27029,3789,12.3
53,29,Island,2009,32300,29635,2665,8.3
53,31,Jefferson,2009,12891,11826,1065,8.3
53,33,King,2009,1094788,1017652,77136,7.0
53,35,Kitsap,2009,122953,114167,8786,7.1
53,37,Kittitas,2009,20476,18746,1730,8.4
53,39,Klickitat,2009,10661,9632,1029,9.7
53,41,Lewis,2009,30994,27173,3821,12.3
53,43,Lincoln,2009,4757,4380,377,7.9
53,45,Mason,2009,24966,22473,2493,10.0
53,47,Okanogan,2009,21665,19729,1936,8.9
53,49,Pacific,2009,9073,7994,1079,11.9
53,51,Pend Oreille,2009,5431,4695,736,13.6
53,53,Pierce,2009,388901,353966,34935,9.0
53,55,San Juan,2009,8337,7820,517,6.2
53,57,Skagit,2009,57257,51882,5375,9.4
53,59,Skamania,2009,4993,4386,607,12.2
53,61,Snohomish,2009,374720,343643,31077,8.3
53,63,Spokane,2009,234821,214705,20116,8.6
53,65,Stevens,2009,18521,16269,2252,12.2
53,67,Thurston,2009,129173,119725,9448,7.3
53,69,Wahkiakum,2009,1583,1370,213,13.5
53,71,Walla Walla,2009,30518,28591,1927,6.3
53,73,Whatcom,2009,105730,97426,8304,7.9
53,75,Whitman,2009,21421,20298,1123,5.2
53,77,Yakima,2009,123294,113028,10266,8.3
54,1,Barbour,2009,6859,6216,643,9.4
54,3,Berkeley,2009,46436,42201,4235,9.1
54,5,Boone,2009,9349,8569,780,8.3
54,7,Braxton,2009,5928,5402,526,8.9
54,9,Brooke,2009,11124,9811,1313,11.8
54,11,Cabell,2009,44521,41308,3213,7.2
54,13,Calhoun,2009,2851,2461,390,13.7
54,15,Clay,2009,3553,3128,425,12.0
54,17,Doddridge,2009,2850,2612,238,8.4
54,19,Fayette,2009,18066,16429,1637,9.1
54,21,Gilmer,2009,3205,2977,228,7.1
54,23,Grant,2009,5085,4542,543,10.7
54,25,Greenbrier,2009,14822,13336,1486,10.0
54,27,Hampshire,2009,9261,8449,812,8.8
54,29,Hancock,2009,14590,12831,1759,12.1
54,31,Hardy,2009,6733,6087,646,9.6
54,33,Harrison,2009,31340,29149,2191,7.0
54,35,Jackson,2009,11716,10290,1426,12.2
54,37,Jefferson,2009,24543,22796,1747,7.1
54,39,Kanawha,2009,92093,85897,6196,6.7
54,41,Lewis,2009,7678,7074,604,7.9
54,43,Lincoln,2009,8143,7300,843,10.4
54,45,Logan,2009,13344,12188,1156,8.7
54,47,McDowell,2009,7460,6538,922,12.4
54,49,Marion,2009,26373,24694,1679,6.4
54,51,Marshall,2009,14868,13468,1400,9.4
54,53,Mason,2009,10279,8985,1294,12.6
54,55,Mercer,2009,25231,23456,1775,7.0
54,57,Mineral,2009,13763,12681,1082,7.9
54,59,Mingo,2009,8914,8064,850,9.5
54,61,Monongalia,2009,49568,47214,2354,4.7
54,63,Monroe,2009,5807,5355,452,7.8
54,65,Morgan,2009,6866,6216,650,9.5
54,67,Nicholas,2009,10667,9677,990,9.3
54,69,Ohio,2009,21232,19502,1730,8.1
54,71,Pendleton,2009,3550,3261,289,8.1
54,73,Pleasants,2009,3217,2865,352,10.9
54,75,Pocahontas,2009,3601,3143,458,12.7
54,77,Preston,2009,15360,14196,1164,7.6
54,79,Putnam,2009,27789,25974,1815,6.5
54,81,Raleigh,2009,32728,30195,2533,7.7
54,83,Randolph,2009,12682,11474,1208,9.5
54,85,Ritchie,2009,4395,3955,440,10.0
54,87,Roane,2009,5563,4850,713,12.8
54,89,Summers,2009,4636,4244,392,8.5
54,91,Taylor,2009,7110,6567,543,7.6
54,93,Tucker,2009,2881,2531,350,12.1
54,95,Tyler,2009,3628,3220,408,11.2
54,97,Upshur,2009,10718,9755,963,9.0
54,99,Wayne,2009,17250,15786,1464,8.5
54,101,Webster,2009,3254,2889,365,11.2
54,103,Wetzel,2009,6305,5515,790,12.5
54,105,Wirt,2009,2434,2118,316,13.0
54,107,Wood,2009,40851,37106,3745,9.2
54,109,Wyoming,2009,8203,7326,877,10.7
55,1,Adams,2009,10038,8934,1104,11.0
55,3,Ashland,2009,9179,8222,957,10.4
55,5,Barron,2009,25250,22872,2378,9.4
55,7,Bayfield,2009,8063,7294,769,9.5
55,9,Brown,2009,141515,130122,11393,8.1
55,11,Buffalo,2009,8341,7738,603,7.2
55,13,Burnett,2009,8024,7121,903,11.3
55,15,Calumet,2009,25724,23674,2050,8.0
55,17,Chippewa,2009,33271,30335,2936,8.8
55,19,Clark,2009,17924,16159,1765,9.8
55,21,Columbia,2009,31243,28536,2707,8.7
55,23,Crawford,2009,9426,8458,968,10.3
55,25,Dane,2009,299671,281543,18128,6.0
55,27,Dodge,2009,47482,42710,4772,10.1
55,29,Door,2009,17455,15842,1613,9.2
55,31,Douglas,2009,23591,21570,2021,8.6
55,33,Dunn,2009,25870,23916,1954,7.6
55,35,Eau Claire,2009,56993,52939,4054,7.1
55,37,Florence,2009,2421,2159,262,10.8
55,39,Fond du Lac,2009,56468,51152,5316,9.4
55,41,Forest,2009,4998,4463,535,10.7
55,43,Grant,2009,28835,26572,2263,7.8
55,45,Green,2009,20417,18521,1896,9.3
55,47,Green Lake,2009,10287,9254,1033,10.0
55,49,Iowa,2009,14064,12928,1136,8.1
55,51,Iron,2009,3006,2626,380,12.6
55,53,Jackson,2009,10022,9090,932,9.3
55,55,Jefferson,2009,42865,38756,4109,9.6
55,57,Juneau,2009,13616,12194,1422,10.4
55,59,Kenosha,2009,86569,77135,9434,10.9
55,61,Kewaunee,2009,11612,10662,950,8.2
55,63,La Crosse,2009,66196,61588,4608,7.0
55,65,Lafayette,2009,9307,8604,703,7.6
55,67,Langlade,2009,11038,9869,1169,10.6
55,69,Lincoln,2009,15667,13830,1837,11.7
55,71,Manitowoc,2009,46514,41680,4834,10.4
55,73,Marathon,2009,75251,68365,6886,9.2
55,75,Marinette,2009,22571,19846,2725,12.1
55,77,Marquette,2009,7823,6983,840,10.7
55,78,Menominee,2009,1650,1411,239,14.5
55,79,Milwaukee,2009,469652,423341,46311,9.9
55,81,Monroe,2009,24868,22882,1986,8.0
55,83,Oconto,2009,20688,18246,2442,11.8
55,85,Oneida,2009,19058,17124,1934,10.1
55,87,Outagamie,2009,99722,91058,8664,8.7
55,89,Ozaukee,2009,47739,44006,3733,7.8
55,91,Pepin,2009,4148,3829,319,7.7
55,93,Pierce,2009,23573,21698,1875,8.0
55,95,Polk,2009,24388,21766,2622,10.8
55,97,Portage,2009,43289,40057,3232,7.5
55,99,Price,2009,8384,7430,954,11.4
55,101,Racine,2009,99862,89191,10671,10.7
55,103,Richland,2009,10195,9254,941,9.2
55,105,Rock,2009,82897,72030,10867,13.1
55,107,Rusk,2009,7427,6424,1003,13.5
55,109,St. Croix,2009,47498,43509,3989,8.4
55,111,Sauk,2009,35845,32744,3101,8.7
55,113,Sawyer,2009,9130,8176,954,10.4
55,115,Shawano,2009,22774,20565,2209,9.7
55,117,Sheboygan,2009,65203,58953,6250,9.6
55,119,Taylor,2009,10804,9505,1299,12.0
55,121,Trempealeau,2009,16370,15075,1295,7.9
55,123,Vernon,2009,15303,14055,1248,8.2
55,125,Vilas,2009,11043,9901,1142,10.3
55,127,Walworth,2009,56421,51080,5341,9.5
55,129,Washburn,2009,7989,7173,816,10.2
55,131,Washington,2009,75133,68312,6821,9.1
55,133,Waukesha,2009,213797,196928,16869,7.9
55,135,Waupaca,2009,28508,25655,2853,10.0
55,137,Waushara,2009,12910,11574,1336,10.3
55,139,Winnebago,2009,95576,87892,7684,8.0
55,141,Wood,2009,42046,38187,3859,9.2
56,1,Albany,2009,19694,18880,814,4.1
56,3,Big Horn,2009,5059,4624,435,8.6
56,5,Campbell,2009,28789,27262,1527,5.3
56,7,Carbon,2009,7943,7375,568,7.2
56,9,Converse,2009,7629,7196,433,5.7
56,11,Crook,2009,3594,3391,203,5.6
56,13,Fremont,2009,19235,17766,1469,7.6
56,15,Goshen,2009,6309,5974,335,5.3
56,17,Hot Springs,2009,2535,2387,148,5.8
56,19,Johnson,2009,4095,3791,304,7.4
56,21,Laramie,2009,43806,40998,2808,6.4
56,23,Lincoln,2009,8407,7756,651,7.7
56,25,Natrona,2009,41229,38545,2684,6.5
56,27,Niobrara,2009,1298,1234,64,4.9
56,29,Park,2009,14899,13987,912,6.1
56,31,Platte,2009,4136,3888,248,6.0
56,33,Sheridan,2009,16494,15386,1108,6.7
56,35,Sublette,2009,7291,6972,319,4.4
56,37,Sweetwater,2009,24307,22764,1543,6.3
56,39,Teton,2009,13874,12917,957,6.9
56,41,Uinta,2009,11561,10788,773,6.7
56,43,Washakie,2009,4400,4136,264,6.0
56,45,Weston,2009,3311,3107,204,6.2
72,1,Adjuntas Municipio,2009,5084,4115,969,19.1
72,3,Aguada Municipio,2009,15358,12854,2504,16.3
72,5,Aguadilla Municipio,2009,20962,17601,3361,16.0
72,7,Aguas Buenas Municipio,2009,9298,7691,1607,17.3
72,9,Aibonito Municipio,2009,7551,6169,1382,18.3
72,11,Anasco Municipio,2009,10502,8722,1780,16.9
72,13,Arecibo Municipio,2009,31328,26468,4860,15.5
72,15,Arroyo Municipio,2009,5738,4482,1256,21.9
72,17,Barceloneta Municipio,2009,7049,5629,1420,20.1
72,19,Barranquitas Municipio,2009,7518,6167,1351,18.0
72,21,Bayamon Municipio,2009,76835,67044,9791,12.7
72,23,Cabo Rojo Municipio,2009,20261,17611,2650,13.1
72,25,Caguas Municipio,2009,51080,43492,7588,14.9
72,27,Camuy Municipio,2009,12422,10649,1773,14.3
72,29,Canovanas Municipio,2009,14406,11574,2832,19.7
72,31,Carolina Municipio,2009,72244,63347,8897,12.3
72,33,Catano Municipio,2009,7341,6051,1290,17.6
72,35,Cayey Municipio,2009,14864,12307,2557,17.2
72,37,Ceiba Municipio,2009,5478,4495,983,17.9
72,39,Ciales Municipio,2009,5260,3970,1290,24.5
72,41,Cidra Municipio,2009,15236,12774,2462,16.2
72,43,Coamo Municipio,2009,11480,9060,2420,21.1
72,45,Comerio Municipio,2009,4622,3644,978,21.2
72,47,Corozal Municipio,2009,10111,8448,1663,16.4
72,49,Culebra Municipio,2009,815,729,86,10.6
72,51,Dorado Municipio,2009,12229,10567,1662,13.6
72,53,Fajardo Municipio,2009,14097,11627,2470,17.5
72,54,Florida Municipio,2009,4326,3503,823,19.0
72,55,Guanica Municipio,2009,6284,5115,1169,18.6
72,57,Guayama Municipio,2009,14822,11910,2912,19.6
72,59,Guayanilla Municipio,2009,6865,5435,1430,20.8
72,61,Guaynabo Municipio,2009,41528,37529,3999,9.6
72,63,Gurabo Municipio,2009,15418,13097,2321,15.1
72,65,Hatillo Municipio,2009,12456,10482,1974,15.8
72,67,Hormigueros Municipio,2009,6520,5522,998,15.3
72,69,Humacao Municipio,2009,19993,16098,3895,19.5
72,71,Isabela Municipio,2009,15370,12772,2598,16.9
72,73,Jayuya Municipio,2009,4532,3605,927,20.5
72,75,Juana Diaz Municipio,2009,17062,14220,2842,16.7
72,77,Juncos Municipio,2009,12881,10598,2283,17.7
72,79,Lajas Municipio,2009,8767,7196,1571,17.9
72,81,Lares Municipio,2009,11629,9616,2013,17.3
72,83,Las Marias Municipio,2009,4197,3511,686,16.3
72,85,Las Piedras Municipio,2009,12622,10418,2204,17.5
72,87,Loiza Municipio,2009,8585,6872,1713,20.0
72,89,Luquillo Municipio,2009,6723,5371,1352,20.1
72,91,Manati Municipio,2009,14323,11699,2624,18.3
72,93,Maricao Municipio,2009,1884,1526,358,19.0
72,95,Maunabo Municipio,2009,3655,2659,996,27.3
72,97,Mayaguez Municipio,2009,28720,23805,4915,17.1
72,99,Moca Municipio,2009,14897,12507,2390,16.0
72,101,Morovis Municipio,2009,9104,7237,1867,20.5
72,103,Naguabo Municipio,2009,7442,5746,1696,22.8
72,105,Naranjito Municipio,2009,8288,6820,1468,17.7
72,107,Orocovis Municipio,2009,5298,4181,1117,21.1
72,109,Patillas Municipio,2009,6124,4764,1360,22.2
72,111,Penuelas Municipio,2009,9017,7267,1750,19.4
72,113,Ponce Municipio,2009,61194,52308,8886,14.5
72,115,Quebradillas Municipio,2009,8345,7049,1296,15.5
72,117,Rincon Municipio,2009,5498,4582,916,16.7
72,119,Rio Grande Municipio,2009,17363,14537,2826,16.3
72,121,Sabana Grande Municipio,2009,9190,7575,1615,17.6
72,123,Salinas Municipio,2009,8709,6763,1946,22.3
72,125,San German Municipio,2009,12519,10363,2156,17.2
72,127,San Juan Municipio,2009,155825,138542,17283,11.1
72,129,San Lorenzo Municipio,2009,14052,11626,2426,17.3
72,131,San Sebastian Municipio,2009,15181,12550,2631,17.3
72,133,Santa Isabel Municipio,2009,9088,7358,1730,19.0
72,135,Toa Alta Municipio,2009,29403,25977,3426,11.7
72,137,Toa Baja Municipio,2009,33213,29032,4181,12.6
72,139,Trujillo Alto Municipio,2009,33367,29991,3376,10.1
72,141,Utuado Municipio,2009,8781,7132,1649,18.8
72,143,Vega Alta Municipio,2009,11807,10009,1798,15.2
72,145,Vega Baja Municipio,2009,19955,16433,3522,17.6
72,147,Vieques Municipio,2009,3124,2425,699,22.4
72,149,Villalba Municipio,2009,9518,7628,1890,19.9
72,151,Yabucoa Municipio,2009,10816,8302,2514,23.2
72,153,Yauco Municipio,2009,15826,13318,2508,15.8
1,1,Autauga,2010,25749,23481,2268,8.8
1,3,Baldwin,2010,83551,75283,8268,9.9
1,5,Barbour,2010,10219,8978,1241,12.1
1,7,Bibb,2010,8936,7931,1005,11.2
1,9,Blount,2010,24928,22509,2419,9.7
1,11,Bullock,2010,4941,4365,576,11.7
1,13,Butler,2010,9252,8015,1237,13.4
1,15,Calhoun,2010,51577,45798,5779,11.2
1,17,Chambers,2010,14734,12581,2153,14.6
1,19,Cherokee,2010,11466,10267,1199,10.5
1,21,Chilton,2010,19474,17502,1972,10.1
1,23,Choctaw,2010,4857,4225,632,13.0
1,25,Clarke,2010,9088,7316,1772,19.5
1,27,Clay,2010,5844,5016,828,14.2
1,29,Cleburne,2010,6035,5441,594,9.8
1,31,Coffee,2010,21099,19313,1786,8.5
1,33,Colbert,2010,24229,21499,2730,11.3
1,35,Conecuh,2010,4982,4140,842,16.9
1,37,Coosa,2010,4648,3946,702,15.1
1,39,Covington,2010,16428,14753,1675,10.2
1,41,Crenshaw,2010,6290,5658,632,10.0
1,43,Cullman,2010,35983,32272,3711,10.3
1,45,Dale,2010,22099,20167,1932,8.7
1,47,Dallas,2010,17782,14839,2943,16.6
1,49,DeKalb,2010,30918,27084,3834,12.4
1,51,Elmore,2010,36732,33435,3297,9.0
1,53,Escambia,2010,15000,13266,1734,11.6
1,55,Etowah,2010,44018,39278,4740,10.8
1,57,Fayette,2010,6827,5955,872,12.8
1,59,Franklin,2010,14252,12752,1500,10.5
1,61,Geneva,2010,11564,10385,1179,10.2
1,63,Greene,2010,3302,2741,561,17.0
1,65,Hale,2010,6439,5485,954,14.8
1,67,Henry,2010,7265,6483,782,10.8
1,69,Houston,2010,46463,42261,4202,9.0
1,71,Jackson,2010,24347,21514,2833,11.6
1,73,Jefferson,2010,318651,286248,32403,10.2
1,75,Lamar,2010,5797,5046,751,13.0
1,77,Lauderdale,2010,43622,39278,4344,10.0
1,79,Lawrence,2010,14892,13052,1840,12.4
1,81,Lee,2010,66841,60891,5950,8.9
1,83,Limestone,2010,38356,34700,3656,9.5
1,85,Lowndes,2010,4342,3555,787,18.1
1,87,Macon,2010,8928,7635,1293,14.5
1,89,Madison,2010,169944,155994,13950,8.2
1,91,Marengo,2010,8130,7036,1094,13.5
1,93,Marion,2010,13203,11448,1755,13.3
1,95,Marshall,2010,41688,37721,3967,9.5
1,97,Mobile,2010,192800,171314,21486,11.1
1,99,Monroe,2010,8694,7147,1547,17.8
1,101,Montgomery,2010,108868,98105,10763,9.9
1,103,Morgan,2010,57844,51711,6133,10.6
1,105,Perry,2010,3885,3243,642,16.5
1,107,Pickens,2010,7696,6701,995,12.9
1,109,Pike,2010,15698,14229,1469,9.4
1,111,Randolph,2010,9701,8428,1273,13.1
1,113,Russell,2010,23828,21271,2557,10.7
1,115,St. Clair,2010,38296,34472,3824,10.0
1,117,Shelby,2010,102466,95317,7149,7.0
1,119,Sumter,2010,5774,5018,756,13.1
1,121,Talladega,2010,35097,30455,4642,13.2
1,123,Tallapoosa,2010,19075,16615,2460,12.9
1,125,Tuscaloosa,2010,94028,85458,8570,9.1
1,127,Walker,2010,27274,23867,3407,12.5
1,129,Washington,2010,7377,6348,1029,13.9
1,131,Wilcox,2010,3054,2266,788,25.8
1,133,Winston,2010,9868,8322,1546,15.7
2,13,Aleutians East Borough,2010,2028,1910,118,5.8
2,16,Aleutians West Census Area,2010,3949,3742,207,5.2
2,20,Anchorage Borough/municipality,2010,157743,146993,10750,6.8
2,50,Bethel Census Area,2010,7174,6091,1083,15.1
2,60,Bristol Bay Borough,2010,505,454,51,10.1
2,68,Denali Borough,2010,1013,888,125,12.3
2,70,Dillingham Census Area,2010,2090,1871,219,10.5
2,90,Fairbanks North Star Borough,2010,48234,44917,3317,6.9
2,100,Haines Borough,2010,1151,1024,127,11.0
2,105,Hoonah-Angoon Census Area,2010,1067,912,155,14.5
2,110,Juneau Borough/city,2010,17880,16787,1093,6.1
2,122,Kenai Peninsula Borough,2010,27009,24220,2789,10.3
2,130,Ketchikan Gateway Borough,2010,7122,6477,645,9.1
2,150,Kodiak Island Borough,2010,6465,5971,494,7.6
2,158,Kusilvak Census Area,2010,2668,2107,561,21.0
2,164,Lake and Peninsula Borough,2010,605,515,90,14.9
2,170,Matanuska-Susitna Borough,2010,42324,38178,4146,9.8
2,180,Nome Census Area,2010,4115,3582,533,13.0
2,185,North Slope Borough,2010,3965,3635,330,8.3
2,188,Northwest Arctic Borough,2010,2962,2551,411,13.9
2,195,Petersburg Borough,2010,1844,1692,152,8.2
2,198,Prince of Wales-Hyder Census Area,2010,2544,2267,277,10.9
2,220,Sitka Borough/city,2010,4556,4258,298,6.5
2,230,Skagway Municipality,2010,719,611,108,15.0
2,240,Southeast Fairbanks Census Area,2010,3200,2806,394,12.3
2,261,Valdez-Cordova Census Area,2010,4876,4403,473,9.7
2,275,Wrangell Borough/city,2010,1028,942,86,8.4
2,282,Yakutat Borough/city,2010,297,264,33,11.1
2,290,Yukon-Koyukuk Census Area,2010,2575,2117,458,17.8
4,1,Apache,2010,23475,19645,3830,16.3
4,3,Cochise,2010,57146,51843,5303,9.3
4,5,Coconino,2010,72998,65838,7160,9.8
4,7,Gila,2010,21664,18969,2695,12.4
4,9,Graham,2010,14598,12724,1874,12.8
4,11,Greenlee,2010,3444,2883,561,16.3
4,12,La Paz,2010,7885,7084,801,10.2
4,13,Maricopa,2010,1923669,1741749,181920,9.5
4,15,Mohave,2010,82880,72206,10674,12.9
4,17,Navajo,2010,43978,37557,6421,14.6
4,19,Pima,2010,479984,435352,44632,9.3
4,21,Pinal,2010,154038,137636,16402,10.6
4,23,Santa Cruz,2010,20917,17748,3169,15.2
4,25,Yavapai,2010,96734,86472,10262,10.6
4,27,Yuma,2010,92909,69699,23210,25.0
5,1,Arkansas,2010,11273,9251,2022,17.9
5,3,Ashley,2010,9896,8949,947,9.6
5,5,Baxter,2010,16596,15088,1508,9.1
5,7,Benton,2010,107052,100219,6833,6.4
5,9,Boone,2010,16502,15259,1243,7.5
5,11,Bradley,2010,5157,4637,520,10.1
5,13,Calhoun,2010,2701,2474,227,8.4
5,15,Carroll,2010,12601,11711,890,7.1
5,17,Chicot,2010,4271,3763,508,11.9
5,19,Clark,2010,10366,9526,840,8.1
5,21,Clay,2010,7464,6673,791,10.6
5,23,Cleburne,2010,10348,9491,857,8.3
5,25,Cleveland,2010,3884,3570,314,8.1
5,27,Columbia,2010,10516,9504,1012,9.6
5,29,Conway,2010,9023,8183,840,9.3
5,31,Craighead,2010,47751,44346,3405,7.1
5,33,Crawford,2010,28286,26053,2233,7.9
5,35,Crittenden,2010,22778,20478,2300,10.1
5,37,Cross,2010,8608,7921,687,8.0
5,39,Dallas,2010,3602,3187,415,11.5
5,41,Desha,2010,5895,5264,631,10.7
5,43,Drew,2010,8702,7799,903,10.4
5,45,Faulkner,2010,58662,54585,4077,6.9
5,47,Franklin,2010,7796,7216,580,7.4
5,49,Fulton,2010,5167,4778,389,7.5
5,51,Garland,2010,41504,38130,3374,8.1
5,53,Grant,2010,8561,7978,583,6.8
5,55,Greene,2010,19641,17804,1837,9.4
5,57,Hempstead,2010,10693,9740,953,8.9
5,59,Hot Spring,2010,14225,13051,1174,8.3
5,61,Howard,2010,6575,6086,489,7.4
5,63,Independence,2010,17042,15596,1446,8.5
5,65,Izard,2010,5132,4634,498,9.7
5,67,Jackson,2010,6719,5950,769,11.4
5,69,Jefferson,2010,33924,30505,3419,10.1
5,71,Johnson,2010,10972,10103,869,7.9
5,73,Lafayette,2010,3073,2785,288,9.4
5,75,Lawrence,2010,7433,6752,681,9.2
5,77,Lee,2010,3699,3395,304,8.2
5,79,Lincoln,2010,4693,4268,425,9.1
5,81,Little River,2010,6213,5750,463,7.5
5,83,Logan,2010,9795,8988,807,8.2
5,85,Lonoke,2010,33265,31105,2160,6.5
5,87,Madison,2010,7265,6771,494,6.8
5,89,Marion,2010,6706,6051,655,9.8
5,91,Miller,2010,20554,19406,1148,5.6
5,93,Mississippi,2010,20369,17940,2429,11.9
5,95,Monroe,2010,3410,3107,303,8.9
5,97,Montgomery,2010,3931,3602,329,8.4
5,99,Nevada,2010,4021,3635,386,9.6
5,101,Newton,2010,3788,3536,252,6.7
5,103,Ouachita,2010,11386,10346,1040,9.1
5,105,Perry,2010,4554,4163,391,8.6
5,107,Phillips,2010,8572,7699,873,10.2
5,109,Pike,2010,4900,4475,425,8.7
5,111,Poinsett,2010,10722,9758,964,9.0
5,113,Polk,2010,9012,8367,645,7.2
5,115,Pope,2010,30095,27834,2261,7.5
5,117,Prairie,2010,3964,3613,351,8.9
5,119,Pulaski,2010,189160,175899,13261,7.0
5,121,Randolph,2010,7246,6530,716,9.9
5,123,St. Francis,2010,9815,8806,1009,10.3
5,125,Saline,2010,53348,49934,3414,6.4
5,127,Scott,2010,4756,4434,322,6.8
5,129,Searcy,2010,3388,3088,300,8.9
5,131,Sebastian,2010,59472,54881,4591,7.7
5,133,Sevier,2010,7089,6613,476,6.7
5,135,Sharp,2010,6302,5706,596,9.5
5,137,Stone,2010,5517,5115,402,7.3
5,139,Union,2010,17213,15321,1892,11.0
5,141,Van Buren,2010,6469,5768,701,10.8
5,143,Washington,2010,102805,96374,6431,6.3
5,145,White,2010,36409,33516,2893,7.9
5,147,Woodruff,2010,3621,3258,363,10.0
5,149,Yell,2010,9722,8967,755,7.8
6,1,Alameda,2010,782680,695343,87337,11.2
6,3,Alpine,2010,542,471,71,13.1
6,5,Amador,2010,15523,13291,2232,14.4
6,7,Butte,2010,102713,88098,14615,14.2
6,9,Calaveras,2010,21045,17931,3114,14.8
6,11,Colusa,2010,11560,9095,2465,21.3
6,13,Contra Costa,2010,525745,466727,59018,11.2
6,15,Del Norte,2010,10944,9465,1479,13.5
6,17,El Dorado,2010,91205,79799,11406,12.5
6,19,Fresno,2010,440562,365290,75272,17.1
6,21,Glenn,2010,13242,11151,2091,15.8
6,23,Humboldt,2010,66064,58933,7131,10.8
6,25,Imperial,2010,79098,55836,23262,29.4
6,27,Inyo,2010,9755,8783,972,10.0
6,29,Kern,2010,372229,312566,59663,16.0
6,31,Kings,2010,59562,49730,9832,16.5
6,33,Lake,2010,29899,25279,4620,15.5
6,35,Lassen,2010,12117,10374,1743,14.4
6,37,Los Angeles,2010,4940672,4318722,621950,12.6
6,39,Madera,2010,61743,51236,10507,17.0
6,41,Marin,2010,132971,122259,10712,8.1
6,43,Mariposa,2010,8720,7563,1157,13.3
6,45,Mendocino,2010,41614,36679,4935,11.9
6,47,Merced,2010,113874,92954,20920,18.4
6,49,Modoc,2010,3821,3228,593,15.5
6,51,Mono,2010,8890,7963,927,10.4
6,53,Monterey,2010,216038,187860,28178,13.0
6,55,Napa,2010,70244,62830,7414,10.6
6,57,Nevada,2010,48939,43068,5871,12.0
6,59,Orange,2010,1537701,1383916,153785,10.0
6,61,Placer,2010,173433,152847,20586,11.9
6,63,Plumas,2010,9172,7460,1712,18.7
6,65,Riverside,2010,977784,839147,138637,14.2
6,67,Sacramento,2010,683829,595476,88353,12.9
6,69,San Benito,2010,27957,23632,4325,15.5
6,71,San Bernardino,2010,891422,767935,123487,13.9
6,73,San Diego,2010,1515862,1348833,167029,11.0
6,75,San Francisco/city,2010,485779,441571,44208,9.1
6,77,San Joaquin,2010,312104,259334,52770,16.9
6,79,San Luis Obispo,2010,133590,119904,13686,10.2
6,81,San Mateo,2010,392869,359249,33620,8.6
6,83,Santa Barbara,2010,212274,191192,21082,9.9
6,85,Santa Clara,2010,926868,828008,98860,10.7
6,87,Santa Cruz,2010,141873,122559,19314,13.6
6,89,Shasta,2010,78680,65168,13512,17.2
6,91,Sierra,2010,1614,1361,253,15.7
6,93,Siskiyou,2010,19672,16283,3389,17.2
6,95,Solano,2010,202546,176520,26026,12.8
6,97,Sonoma,2010,244609,217546,27063,11.1
6,99,Stanislaus,2010,243828,201670,42158,17.3
6,101,Sutter,2010,46089,37433,8656,18.8
6,103,Tehama,2010,25762,21699,4063,15.8
6,105,Trinity,2010,5436,4490,946,17.4
6,107,Tulare,2010,203498,167682,35816,17.6
6,109,Tuolumne,2010,22657,19124,3533,15.6
6,111,Ventura,2010,430235,382449,47786,11.1
6,113,Yolo,2010,102253,89606,12647,12.4
6,115,Yuba,2010,29137,23841,5296,18.2
8,1,Adams,2010,233563,209082,24481,10.5
8,3,Alamosa,2010,7681,6955,726,9.5
8,5,Arapahoe,2010,315828,287454,28374,9.0
8,7,Archuleta,2010,5771,5129,642,11.1
8,9,Baca,2010,2074,1967,107,5.2
8,11,Bent,2010,2000,1829,171,8.6
8,13,Boulder,2010,169678,157072,12606,7.4
8,14,Broomfield/city,2010,31418,28970,2448,7.8
8,15,Chaffee,2010,8244,7575,669,8.1
8,17,Cheyenne,2010,1042,996,46,4.4
8,19,Clear Creek,2010,5597,5126,471,8.4
8,21,Conejos,2010,3744,3368,376,10.0
8,23,Costilla,2010,1550,1378,172,11.1
8,25,Crowley,2010,1520,1373,147,9.7
8,27,Custer,2010,2070,1925,145,7.0
8,29,Delta,2010,14477,12860,1617,11.2
8,31,Denver/city,2010,346523,313456,33067,9.5
8,33,Dolores,2010,1003,817,186,18.5
8,35,Douglas,2010,156945,145418,11527,7.3
8,37,Eagle,2010,32342,29465,2877,8.9
8,39,Elbert,2010,12712,11635,1077,8.5
8,41,El Paso,2010,305347,275510,29837,9.8
8,43,Fremont,2010,15798,13864,1934,12.2
8,45,Garfield,2010,31281,27896,3385,10.8
8,47,Gilpin,2010,3316,3036,280,8.4
8,49,Grand,2010,8924,8102,822,9.2
8,51,Gunnison,2010,10047,9365,682,6.8
8,53,Hinsdale,2010,468,440,28,6.0
8,55,Huerfano,2010,2703,2309,394,14.6
8,57,Jackson,2010,917,832,85,9.3
8,59,Jefferson,2010,303208,276614,26594,8.8
8,61,Kiowa,2010,776,724,52,6.7
8,63,Kit Carson,2010,4368,4158,210,4.8
8,65,Lake,2010,4362,3860,502,11.5
8,67,La Plata,2010,29766,27527,2239,7.5
8,69,Larimer,2010,169439,155799,13640,8.1
8,71,Las Animas,2010,7178,6381,797,11.1
8,73,Lincoln,2010,2144,2009,135,6.3
8,75,Logan,2010,11215,10469,746,6.7
8,77,Mesa,2010,75893,67247,8646,11.4
8,79,Mineral,2010,414,384,30,7.2
8,81,Moffat,2010,8063,7220,843,10.5
8,83,Montezuma,2010,13018,11774,1244,9.6
8,85,Montrose,2010,20572,18217,2355,11.4
8,87,Morgan,2010,14383,13318,1065,7.4
8,89,Otero,2010,8464,7650,814,9.6
8,91,Ouray,2010,2148,1925,223,10.4
8,93,Park,2010,9605,8786,819,8.5
8,95,Phillips,2010,2187,2065,122,5.6
8,97,Pitkin,2010,10845,9922,923,8.5
8,99,Prowers,2010,6143,5691,452,7.4
8,101,Pueblo,2010,74239,66147,8092,10.9
8,103,Rio Blanco,2010,3139,2844,295,9.4
8,105,Rio Grande,2010,5201,4618,583,11.2
8,107,Routt,2010,14497,13089,1408,9.7
8,109,Saguache,2010,3059,2734,325,10.6
8,111,San Juan,2010,505,439,66,13.1
8,113,San Miguel,2010,4874,4473,401,8.2
8,115,Sedgwick,2010,1097,1011,86,7.8
8,117,Summit,2010,19050,17698,1352,7.1
8,119,Teller,2010,12312,11110,1202,9.8
8,121,Washington,2010,2579,2418,161,6.2
8,123,Weld,2010,131495,118861,12634,9.6
8,125,Yuma,2010,4905,4614,291,5.9
9,1,Fairfield,2010,473105,431248,41857,8.8
9,3,Hartford,2010,479532,431991,47541,9.9
9,5,Litchfield,2010,108288,98338,9950,9.2
9,7,Middlesex,2010,93234,85502,7732,8.3
9,9,New Haven,2010,462398,413885,48513,10.5
9,11,New London,2010,143832,130327,13505,9.4
9,13,Tolland,2010,86340,79251,7089,8.2
9,15,Windham,2010,64564,57581,6983,10.8
10,1,Kent,2010,73026,66336,6690,9.2
10,3,New Castle,2010,272650,249470,23180,8.5
10,5,Sussex,2010,90518,82581,7937,8.8
11,1,District of Colu,2010,346707,312132,34575,10.0
12,1,Alachua,2010,127384,117504,9880,7.8
12,3,Baker,2010,11453,10197,1256,11.0
12,5,Bay,2010,85366,76683,8683,10.2
12,7,Bradford,2010,11490,10393,1097,9.5
12,9,Brevard,2010,263342,234627,28715,10.9
12,11,Broward,2010,928815,837443,91372,9.8
12,13,Calhoun,2010,5269,4754,515,9.8
12,15,Charlotte,2010,65696,57567,8129,12.4
12,17,Citrus,2010,52351,45375,6976,13.3
12,19,Clay,2010,95069,85944,9125,9.6
12,21,Collier,2010,144056,127810,16246,11.3
12,23,Columbia,2010,28547,25546,3001,10.5
12,27,DeSoto,2010,12965,11425,1540,11.9
12,29,Dixie,2010,5694,4983,711,12.5
12,31,Duval,2010,450860,401244,49616,11.0
12,33,Escambia,2010,138672,125154,13518,9.7
12,35,Flagler,2010,40956,36034,4922,12.0
12,37,Franklin,2010,4899,4522,377,7.7
12,39,Gadsden,2010,19897,17629,2268,11.4
12,41,Gilchrist,2010,6814,6102,712,10.4
12,43,Glades,2010,5498,4993,505,9.2
12,45,Gulf,2010,6180,5564,616,10.0
12,47,Hamilton,2010,4766,4238,528,11.1
12,49,Hardee,2010,11664,10359,1305,11.2
12,51,Hendry,2010,18174,15707,2467,13.6
12,53,Hernando,2010,65828,57188,8640,13.1
12,55,Highlands,2010,36899,32428,4471,12.1
12,57,Hillsborough,2010,640114,573638,66476,10.4
12,59,Holmes,2010,7130,6414,716,10.0
12,61,Indian River,2010,60783,52594,8189,13.5
12,63,Jackson,2010,18782,17131,1651,8.8
12,65,Jefferson,2010,5992,5417,575,9.6
12,67,Lafayette,2010,3379,3141,238,7.0
12,69,Lake,2010,132826,117680,15146,11.4
12,71,Lee,2010,280605,246599,34006,12.1
12,73,Leon,2010,148825,137411,11414,7.7
12,75,Levy,2010,17175,15189,1986,11.6
12,77,Liberty,2010,2910,2663,247,8.5
12,79,Madison,2010,7878,7114,764,9.7
12,81,Manatee,2010,146334,130121,16213,11.1
12,83,Marion,2010,131068,113748,17320,13.2
12,85,Martin,2010,66056,59186,6870,10.4
12,86,Miami-Dade,2010,1229381,1085051,144330,11.7
12,87,Monroe,2010,41862,38716,3146,7.5
12,89,Nassau,2010,35491,31842,3649,10.3
12,91,Okaloosa,2010,88348,81155,7193,8.1
12,93,Okeechobee,2010,17934,15740,2194,12.2
12,95,Orange,2010,629808,563766,66042,10.5
12,97,Osceola,2010,136117,119677,16440,12.1
12,99,Palm Beach,2010,640308,572130,68178,10.6
12,101,Pasco,2010,205550,181719,23831,11.6
12,103,Pinellas,2010,461265,412869,48396,10.5
12,105,Polk,2010,275957,243488,32469,11.8
12,107,Putnam,2010,30235,26307,3928,13.0
12,109,St. Johns,2010,98319,90007,8312,8.5
12,111,St. Lucie,2010,127436,110442,16994,13.3
12,113,Santa Rosa,2010,70749,64403,6346,9.0
12,115,Sarasota,2010,165757,147114,18643,11.2
12,117,Seminole,2010,228713,205181,23532,10.3
12,119,Sumter,2010,25080,21850,3230,12.9
12,121,Suwannee,2010,18988,17184,1804,9.5
12,123,Taylor,2010,9390,8430,960,10.2
12,125,Union,2010,5436,4989,447,8.2
12,127,Volusia,2010,236074,207981,28093,11.9
12,129,Wakulla,2010,14475,13304,1171,8.1
12,131,Walton,2010,25774,23433,2341,9.1
12,133,Washington,2010,10206,9166,1040,10.2
13,1,Appling,2010,8771,7720,1051,12.0
13,3,Atkinson,2010,3463,2929,534,15.4
13,5,Bacon,2010,4554,4064,490,10.8
13,7,Baker,2010,1237,1084,153,12.4
13,9,Baldwin,2010,19261,16264,2997,15.6
13,11,Banks,2010,8479,7649,830,9.8
13,13,Barrow,2010,34778,30977,3801,10.9
13,15,Bartow,2010,47979,42059,5920,12.3
13,17,Ben Hill,2010,6538,5488,1050,16.1
13,19,Berrien,2010,8013,6959,1054,13.2
13,21,Bibb,2010,70421,62130,8291,11.8
13,23,Bleckley,2010,5490,4798,692,12.6
13,25,Brantley,2010,7492,6525,967,12.9
13,27,Brooks,2010,7328,6614,714,9.7
13,29,Bryan,2010,14492,13086,1406,9.7
13,31,Bulloch,2010,33233,29839,3394,10.2
13,33,Burke,2010,9819,8611,1208,12.3
13,35,Butts,2010,10521,9299,1222,11.6
13,37,Calhoun,2010,2626,2393,233,8.9
13,39,Camden,2010,20754,18666,2088,10.1
13,43,Candler,2010,4928,4487,441,8.9
13,45,Carroll,2010,51982,45819,6163,11.9
13,47,Catoosa,2010,31426,28700,2726,8.7
13,49,Charlton,2010,4811,4294,517,10.7
13,51,Chatham,2010,127700,114919,12781,10.0
13,53,Chattahoochee,2010,2224,1978,246,11.1
13,55,Chattooga,2010,10699,9436,1263,11.8
13,57,Cherokee,2010,112852,102814,10038,8.9
13,59,Clarke,2010,56779,51424,5355,9.4
13,61,Clay,2010,1104,974,130,11.8
13,63,Clayton,2010,125582,108377,17205,13.7
13,65,Clinch,2010,2907,2582,325,11.2
13,67,Cobb,2010,381245,345298,35947,9.4
13,69,Coffee,2010,17260,14502,2758,16.0
13,71,Colquitt,2010,21369,19271,2098,9.8
13,73,Columbia,2010,61662,57098,4564,7.4
13,75,Cook,2010,7907,6975,932,11.8
13,77,Coweta,2010,64514,58167,6347,9.8
13,79,Crawford,2010,5791,5116,675,11.7
13,81,Crisp,2010,9237,7911,1326,14.4
13,83,Dade,2010,8369,7634,735,8.8
13,85,Dawson,2010,10997,9783,1214,11.0
13,87,Decatur,2010,12482,10910,1572,12.6
13,89,DeKalb,2010,363973,324087,39886,11.0
13,91,Dodge,2010,8389,7280,1109,13.2
13,93,Dooly,2010,4974,4392,582,11.7
13,95,Dougherty,2010,41623,36327,5296,12.7
13,97,Douglas,2010,66764,59181,7583,11.4
13,99,Early,2010,4491,3957,534,11.9
13,101,Echols,2010,1880,1724,156,8.3
13,103,Effingham,2010,25849,23339,2510,9.7
13,105,Elbert,2010,8963,7615,1348,15.0
13,107,Emanuel,2010,9147,7956,1191,13.0
13,109,Evans,2010,4781,4341,440,9.2
13,111,Fannin,2010,10301,9082,1219,11.8
13,113,Fayette,2010,53058,48624,4434,8.4
13,115,Floyd,2010,45235,39799,5436,12.0
13,117,Forsyth,2010,88550,81352,7198,8.1
13,119,Franklin,2010,9730,8478,1252,12.9
13,121,Fulton,2010,486278,434852,51426,10.6
13,123,Gilmer,2010,12848,11380,1468,11.4
13,125,Glascock,2010,1328,1179,149,11.2
13,127,Glynn,2010,38450,34551,3899,10.1
13,129,Gordon,2010,26145,22777,3368,12.9
13,131,Grady,2010,10427,9320,1107,10.6
13,133,Greene,2010,6432,5574,858,13.3
13,135,Gwinnett,2010,419533,380264,39269,9.4
13,137,Habersham,2010,18396,16410,1986,10.8
13,139,Hall,2010,86778,78302,8476,9.8
13,141,Hancock,2010,3119,2396,723,23.2
13,143,Haralson,2010,12422,10879,1543,12.4
13,145,Harris,2010,16454,15168,1286,7.8
13,147,Hart,2010,10990,9709,1281,11.7
13,149,Heard,2010,5265,4621,644,12.2
13,151,Henry,2010,101410,90799,10611,10.5
13,153,Houston,2010,67259,61498,5761,8.6
13,155,Irwin,2010,3687,3139,548,14.9
13,157,Jackson,2010,28732,25692,3040,10.6
13,159,Jasper,2010,6893,6077,816,11.8
13,161,Jeff Davis,2010,6390,5564,826,12.9
13,163,Jefferson,2010,7181,6159,1022,14.2
13,165,Jenkins,2010,3239,2741,498,15.4
13,167,Johnson,2010,4251,3786,465,10.9
13,169,Jones,2010,13732,12381,1351,9.8
13,171,Lamar,2010,8185,7006,1179,14.4
13,173,Lanier,2010,3885,3468,417,10.7
13,175,Laurens,2010,20664,17901,2763,13.4
13,177,Lee,2010,14382,13063,1319,9.2
13,179,Liberty,2010,26999,24523,2476,9.2
13,181,Lincoln,2010,3693,3261,432,11.7
13,183,Long,2010,6246,5713,533,8.5
13,185,Lowndes,2010,51165,46177,4988,9.7
13,187,Lumpkin,2010,14748,13200,1548,10.5
13,189,McDuffie,2010,9477,8214,1263,13.3
13,191,McIntosh,2010,6305,5632,673,10.7
13,193,Macon,2010,5399,4677,722,13.4
13,195,Madison,2010,13415,11999,1416,10.6
13,197,Marion,2010,3733,3330,403,10.8
13,199,Meriwether,2010,9367,8065,1302,13.9
13,201,Miller,2010,2811,2515,296,10.5
13,205,Mitchell,2010,9673,8613,1060,11.0
13,207,Monroe,2010,12587,11287,1300,10.3
13,209,Montgomery,2010,3889,3415,474,12.2
13,211,Morgan,2010,8654,7739,915,10.6
13,213,Murray,2010,17234,14831,2403,13.9
13,215,Muscogee,2010,81995,73575,8420,10.3
13,217,Newton,2010,48138,41951,6187,12.9
13,219,Oconee,2010,16875,15655,1220,7.2
13,221,Oglethorpe,2010,7099,6404,695,9.8
13,223,Paulding,2010,73923,66434,7489,10.1
13,225,Peach,2010,12958,11373,1585,12.2
13,227,Pickens,2010,14086,12521,1565,11.1
13,229,Pierce,2010,8270,7396,874,10.6
13,231,Pike,2010,8528,7608,920,10.8
13,233,Polk,2010,18755,16464,2291,12.2
13,235,Pulaski,2010,4541,4117,424,9.3
13,237,Putnam,2010,9082,7893,1189,13.1
13,239,Quitman,2010,1009,906,103,10.2
13,241,Rabun,2010,7162,6306,856,12.0
13,243,Randolph,2010,2988,2620,368,12.3
13,245,Richmond,2010,88125,78306,9819,11.1
13,247,Rockdale,2010,42071,37256,4815,11.4
13,249,Schley,2010,2170,1905,265,12.2
13,251,Screven,2010,5826,4824,1002,17.2
13,253,Seminole,2010,3395,2963,432,12.7
13,255,Spalding,2010,28762,24439,4323,15.0
13,257,Stephens,2010,11928,10442,1486,12.5
13,259,Stewart,2010,2408,2157,251,10.4
13,261,Sumter,2010,14306,12385,1921,13.4
13,263,Talbot,2010,2883,2588,295,10.2
13,265,Taliaferro,2010,637,521,116,18.2
13,267,Tattnall,2010,9702,8813,889,9.2
13,269,Taylor,2010,3266,2788,478,14.6
13,271,Telfair,2010,5250,4468,782,14.9
13,273,Terrell,2010,3931,3444,487,12.4
13,275,Thomas,2010,17948,15894,2054,11.4
13,277,Tift,2010,18838,16557,2281,12.1
13,279,Toombs,2010,12340,10805,1535,12.4
13,281,Towns,2010,4355,3788,567,13.0
13,283,Treutlen,2010,2954,2593,361,12.2
13,285,Troup,2010,32636,28823,3813,11.7
13,287,Turner,2010,3542,2947,595,16.8
13,289,Twiggs,2010,3276,2764,512,15.6
13,291,Union,2010,9534,8466,1068,11.2
13,293,Upson,2010,11967,10484,1483,12.4
13,295,Walker,2010,31068,27822,3246,10.4
13,297,Walton,2010,41152,36712,4440,10.8
13,299,Ware,2010,15604,13865,1739,11.1
13,301,Warren,2010,2666,2203,463,17.4
13,303,Washington,2010,8150,6951,1199,14.7
13,305,Wayne,2010,12412,10900,1512,12.2
13,307,Webster,2010,1047,910,137,13.1
13,309,Wheeler,2010,1944,1646,298,15.3
13,311,White,2010,12941,11603,1338,10.3
13,313,Whitfield,2010,47771,42030,5741,12.0
13,315,Wilcox,2010,2943,2573,370,12.6
13,317,Wilkes,2010,4030,3491,539,13.4
13,319,Wilkinson,2010,3856,3307,549,14.2
13,321,Worth,2010,9810,8607,1203,12.3
15,1,Hawaii,2010,88539,79996,8543,9.6
15,3,Honolulu/city,2010,445120,418973,26147,5.9
15,7,Kauai,2010,34970,31983,2987,8.5
15,9,Maui,2010,79920,73258,6662,8.3
16,1,Ada,2010,197285,181222,16063,8.1
16,3,Adams,2010,1856,1521,335,18.0
16,5,Bannock,2010,41151,37947,3204,7.8
16,7,Bear Lake,2010,2887,2679,208,7.2
16,9,Benewah,2010,4208,3649,559,13.3
16,11,Bingham,2010,22875,21276,1599,7.0
16,13,Blaine,2010,11972,10846,1126,9.4
16,15,Boise,2010,3054,2736,318,10.4
16,17,Bonner,2010,19521,17040,2481,12.7
16,19,Bonneville,2010,49159,45843,3316,6.7
16,21,Boundary,2010,5372,4664,708,13.2
16,23,Butte,2010,1354,1259,95,7.0
16,25,Camas,2010,644,563,81,12.6
16,27,Canyon,2010,84900,75463,9437,11.1
16,29,Caribou,2010,3845,3553,292,7.6
16,31,Cassia,2010,11127,10363,764,6.9
16,33,Clark,2010,537,488,49,9.1
16,35,Clearwater,2010,3420,2932,488,14.3
16,37,Custer,2010,2297,2114,183,8.0
16,39,Elmore,2010,11413,10447,966,8.5
16,41,Franklin,2010,6205,5888,317,5.1
16,43,Fremont,2010,6759,6184,575,8.5
16,45,Gem,2010,7696,6827,869,11.3
16,47,Gooding,2010,8506,7890,616,7.2
16,49,Idaho,2010,6660,5845,815,12.2
16,51,Jefferson,2010,12625,11762,863,6.8
16,53,Jerome,2010,11016,10155,861,7.8
16,55,Kootenai,2010,68944,61560,7384,10.7
16,57,Latah,2010,19308,18066,1242,6.4
16,59,Lemhi,2010,3780,3402,378,10.0
16,61,Lewis,2010,1573,1471,102,6.5
16,63,Lincoln,2010,2715,2363,352,13.0
16,65,Madison,2010,17513,16604,909,5.2
16,67,Minidoka,2010,10478,9725,753,7.2
16,69,Nez Perce,2010,20116,18811,1305,6.5
16,71,Oneida,2010,2009,1892,117,5.8
16,73,Owyhee,2010,5062,4856,206,4.1
16,75,Payette,2010,11166,10102,1064,9.5
16,77,Power,2010,3876,3528,348,9.0
16,79,Shoshone,2010,5482,4632,850,15.5
16,81,Teton,2010,5452,5036,416,7.6
16,83,Twin Falls,2010,36893,33836,3057,8.3
16,85,Valley,2010,4696,3970,726,15.5
16,87,Washington,2010,4735,4253,482,10.2
17,1,Adams,2010,34827,32120,2707,7.8
17,3,Alexander,2010,2967,2615,352,11.9
17,5,Bond,2010,8525,7657,868,10.2
17,7,Boone,2010,27346,23540,3806,13.9
17,9,Brown,2010,2581,2400,181,7.0
17,11,Bureau,2010,19131,17050,2081,10.9
17,13,Calhoun,2010,2494,2241,253,10.1
17,15,Carroll,2010,8528,7633,895,10.5
17,17,Cass,2010,6980,6396,584,8.4
17,19,Champaign,2010,108706,99758,8948,8.2
17,21,Christian,2010,17132,15382,1750,10.2
17,23,Clark,2010,8305,7328,977,11.8
17,25,Clay,2010,6813,6038,775,11.4
17,27,Clinton,2010,20503,18999,1504,7.3
17,29,Coles,2010,25634,23089,2545,9.9
17,31,Cook,2010,2640576,2350480,290096,11.0
17,33,Crawford,2010,10371,9475,896,8.6
17,35,Cumberland,2010,6054,5496,558,9.2
17,37,DeKalb,2010,56305,50323,5982,10.6
17,39,De Witt,2010,8798,8022,776,8.8
17,41,Douglas,2010,10321,9407,914,8.9
17,43,DuPage,2010,502193,457100,45093,9.0
17,45,Edgar,2010,9447,8382,1065,11.3
17,47,Edwards,2010,3224,2940,284,8.8
17,49,Effingham,2010,18626,17148,1478,7.9
17,51,Fayette,2010,11220,10083,1137,10.1
17,53,Ford,2010,7279,6585,694,9.5
17,55,Franklin,2010,17976,15740,2236,12.4
17,57,Fulton,2010,17564,15489,2075,11.8
17,59,Gallatin,2010,2632,2377,255,9.7
17,61,Greene,2010,6804,6167,637,9.4
17,63,Grundy,2010,25918,22448,3470,13.4
17,65,Hamilton,2010,4007,3626,381,9.5
17,67,Hancock,2010,9939,8882,1057,10.6
17,69,Hardin,2010,1791,1596,195,10.9
17,71,Henderson,2010,3922,3554,368,9.4
17,73,Henry,2010,26769,24312,2457,9.2
17,75,Iroquois,2010,15968,14337,1631,10.2
17,77,Jackson,2010,29798,27328,2470,8.3
17,79,Jasper,2010,5089,4633,456,9.0
17,81,Jefferson,2010,18197,16328,1869,10.3
17,83,Jersey,2010,11590,10521,1069,9.2
17,85,Jo Daviess,2010,12424,11312,1112,9.0
17,87,Johnson,2010,4447,3887,560,12.6
17,89,Kane,2010,266908,237132,29776,11.2
17,91,Kankakee,2010,56343,49205,7138,12.7
17,93,Kendall,2010,62309,55943,6366,10.2
17,95,Knox,2010,25303,22866,2437,9.6
17,97,Lake,2010,368953,332048,36905,10.0
17,99,LaSalle,2010,61782,54282,7500,12.1
17,101,Lawrence,2010,6694,5971,723,10.8
17,103,Lee,2010,19198,17263,1935,10.1
17,105,Livingston,2010,19285,17342,1943,10.1
17,107,Logan,2010,13912,12688,1224,8.8
17,109,McDonough,2010,15611,14270,1341,8.6
17,111,McHenry,2010,168589,150630,17959,10.7
17,113,McLean,2010,95925,89107,6818,7.1
17,115,Macon,2010,55417,49217,6200,11.2
17,117,Macoupin,2010,24739,22168,2571,10.4
17,119,Madison,2010,138482,124794,13688,9.9
17,121,Marion,2010,19371,17249,2122,11.0
17,123,Marshall,2010,6413,5750,663,10.3
17,125,Mason,2010,7419,6505,914,12.3
17,127,Massac,2010,7059,6384,675,9.6
17,129,Menard,2010,7037,6498,539,7.7
17,131,Mercer,2010,8970,8071,899,10.0
17,133,Monroe,2010,17970,16647,1323,7.4
17,135,Montgomery,2010,13867,12143,1724,12.4
17,137,Morgan,2010,18336,16777,1559,8.5
17,139,Moultrie,2010,7673,7012,661,8.6
17,141,Ogle,2010,28157,24627,3530,12.5
17,143,Peoria,2010,95831,85660,10171,10.6
17,145,Perry,2010,9580,8511,1069,11.2
17,147,Piatt,2010,9157,8434,723,7.9
17,149,Pike,2010,8109,7378,731,9.0
17,151,Pope,2010,2029,1835,194,9.6
17,153,Pulaski,2010,2477,2166,311,12.6
17,155,Putnam,2010,3304,2905,399,12.1
17,157,Randolph,2010,15003,13671,1332,8.9
17,159,Richland,2010,7999,7281,718,9.0
17,161,Rock Island,2010,76412,69113,7299,9.6
17,163,St. Clair,2010,132854,119089,13765,10.4
17,165,Saline,2010,11615,10421,1194,10.3
17,167,Sangamon,2010,106966,98527,8439,7.9
17,169,Schuyler,2010,3856,3536,320,8.3
17,171,Scott,2010,2874,2622,252,8.8
17,173,Shelby,2010,11199,10103,1096,9.8
17,175,Stark,2010,3023,2725,298,9.9
17,177,Stephenson,2010,24640,21889,2751,11.2
17,179,Tazewell,2010,71500,64357,7143,10.0
17,181,Union,2010,7958,6998,960,12.1
17,183,Vermilion,2010,37725,33348,4377,11.6
17,185,Wabash,2010,5851,5275,576,9.8
17,187,Warren,2010,9275,8552,723,7.8
17,189,Washington,2010,8482,7861,621,7.3
17,191,Wayne,2010,8381,7629,752,9.0
17,193,White,2010,7569,6920,649,8.6
17,195,Whiteside,2010,29842,26748,3094,10.4
17,197,Will,2010,355134,315408,39726,11.2
17,199,Williamson,2010,32485,29292,3193,9.8
17,201,Winnebago,2010,149585,128423,21162,14.1
17,203,Woodford,2010,20285,18719,1566,7.7
18,1,Adams,2010,16403,14792,1611,9.8
18,3,Allen,2010,176022,157623,18399,10.5
18,5,Bartholomew,2010,38406,34840,3566,9.3
18,7,Benton,2010,4664,4246,418,9.0
18,9,Blackford,2010,5841,5023,818,14.0
18,11,Boone,2010,29421,27251,2170,7.4
18,13,Brown,2010,7568,6803,765,10.1
18,15,Carroll,2010,10258,9269,989,9.6
18,17,Cass,2010,18855,16865,1990,10.6
18,19,Clark,2010,55330,50206,5124,9.3
18,21,Clay,2010,13182,11750,1432,10.9
18,23,Clinton,2010,16905,15234,1671,9.9
18,25,Crawford,2010,4917,4297,620,12.6
18,27,Daviess,2010,14768,13835,933,6.3
18,29,Dearborn,2010,25530,22826,2704,10.6
18,31,Decatur,2010,12917,11452,1465,11.3
18,33,DeKalb,2010,20591,18197,2394,11.6
18,35,Delaware,2010,54704,48559,6145,11.2
18,37,Dubois,2010,21951,20351,1600,7.3
18,39,Elkhart,2010,94442,82165,12277,13.0
18,41,Fayette,2010,9761,8369,1392,14.3
18,43,Floyd,2010,37875,34617,3258,8.6
18,45,Fountain,2010,8601,7612,989,11.5
18,47,Franklin,2010,11391,10121,1270,11.1
18,49,Fulton,2010,10284,9139,1145,11.1
18,51,Gibson,2010,16911,15593,1318,7.8
18,53,Grant,2010,33556,29763,3793,11.3
18,55,Greene,2010,14395,12898,1497,10.4
18,57,Hamilton,2010,145059,135598,9461,6.5
18,59,Hancock,2010,35819,32597,3222,9.0
18,61,Harrison,2010,18998,17174,1824,9.6
18,63,Hendricks,2010,74792,69076,5716,7.6
18,65,Henry,2010,21375,18486,2889,13.5
18,67,Howard,2010,35792,31402,4390,12.3
18,69,Huntington,2010,19035,16828,2207,11.6
18,71,Jackson,2010,20484,18383,2101,10.3
18,73,Jasper,2010,16144,14503,1641,10.2
18,75,Jay,2010,10627,9525,1102,10.4
18,77,Jefferson,2010,15467,13753,1714,11.1
18,79,Jennings,2010,13298,11619,1679,12.6
18,81,Johnson,2010,71626,65495,6131,8.6
18,83,Knox,2010,18537,17061,1476,8.0
18,85,Kosciusko,2010,39230,35013,4217,10.7
18,87,LaGrange,2010,16567,14622,1945,11.7
18,89,Lake,2010,229122,205072,24050,10.5
18,91,LaPorte,2010,51325,45305,6020,11.7
18,93,Lawrence,2010,20719,18158,2561,12.4
18,95,Madison,2010,59393,52412,6981,11.8
18,97,Marion,2010,452930,406386,46544,10.3
18,99,Marshall,2010,23475,20890,2585,11.0
18,101,Martin,2010,5269,4881,388,7.4
18,103,Miami,2010,15942,14002,1940,12.2
18,105,Monroe,2010,67804,62576,5228,7.7
18,107,Montgomery,2010,18894,17025,1869,9.9
18,109,Morgan,2010,35035,31496,3539,10.1
18,111,Newton,2010,7075,6293,782,11.1
18,113,Noble,2010,22998,20049,2949,12.8
18,115,Ohio,2010,3264,2912,352,10.8
18,117,Orange,2010,9098,7974,1124,12.4
18,119,Owen,2010,10316,9155,1161,11.3
18,121,Parke,2010,7333,6552,781,10.7
18,123,Perry,2010,8934,8013,921,10.3
18,125,Pike,2010,6205,5630,575,9.3
18,127,Porter,2010,81658,74116,7542,9.2
18,129,Posey,2010,13502,12481,1021,7.6
18,131,Pulaski,2010,6373,5755,618,9.7
18,133,Putnam,2010,16673,14780,1893,11.4
18,135,Randolph,2010,13017,11524,1493,11.5
18,137,Ripley,2010,14523,12940,1583,10.9
18,139,Rush,2010,8685,7741,944,10.9
18,141,St. Joseph,2010,130450,115758,14692,11.3
18,143,Scott,2010,10584,9225,1359,12.8
18,145,Shelby,2010,22713,20289,2424,10.7
18,147,Spencer,2010,11004,10063,941,8.6
18,149,Starke,2010,10437,9081,1356,13.0
18,151,Steuben,2010,18439,16439,2000,10.8
18,153,Sullivan,2010,9086,8196,890,9.8
18,155,Switzerland,2010,5029,4573,456,9.1
18,157,Tippecanoe,2010,86557,79118,7439,8.6
18,159,Tipton,2010,8048,7244,804,10.0
18,161,Union,2010,3730,3357,373,10.0
18,163,Vanderburgh,2010,92169,84166,8003,8.7
18,165,Vermillion,2010,7806,6821,985,12.6
18,167,Vigo,2010,51135,45548,5587,10.9
18,169,Wabash,2010,15954,14179,1775,11.1
18,171,Warren,2010,4203,3770,433,10.3
18,173,Warrick,2010,30846,28437,2409,7.8
18,175,Washington,2010,13802,12157,1645,11.9
18,177,Wayne,2010,31315,27398,3917,12.5
18,179,Wells,2010,14144,12798,1346,9.5
18,181,White,2010,12980,11651,1329,10.2
18,183,Whitley,2010,17602,15630,1972,11.2
19,1,Adair,2010,4095,3864,231,5.6
19,3,Adams,2010,2234,2124,110,4.9
19,5,Allamakee,2010,7899,7270,629,8.0
19,7,Appanoose,2010,6189,5728,461,7.4
19,9,Audubon,2010,3469,3272,197,5.7
19,11,Benton,2010,14294,13395,899,6.3
19,13,Black Hawk,2010,70810,66355,4455,6.3
19,15,Boone,2010,14806,13946,860,5.8
19,17,Bremer,2010,13826,13136,690,5.0
19,19,Buchanan,2010,11322,10633,689,6.1
19,21,Buena Vista,2010,11391,10842,549,4.8
19,23,Butler,2010,8179,7675,504,6.2
19,25,Calhoun,2010,4644,4360,284,6.1
19,27,Carroll,2010,11680,11168,512,4.4
19,29,Cass,2010,7391,6920,471,6.4
19,31,Cedar,2010,10959,10358,601,5.5
19,33,Cerro Gordo,2010,24504,22799,1705,7.0
19,35,Cherokee,2010,7069,6745,324,4.6
19,37,Chickasaw,2010,6543,6047,496,7.6
19,39,Clarke,2010,4774,4402,372,7.8
19,41,Clay,2010,9323,8767,556,6.0
19,43,Clayton,2010,10461,9702,759,7.3
19,45,Clinton,2010,26397,24505,1892,7.2
19,47,Crawford,2010,8958,8530,428,4.8
19,49,Dallas,2010,37190,35464,1726,4.6
19,51,Davis,2010,4246,3936,310,7.3
19,53,Decatur,2010,4455,4180,275,6.2
19,55,Delaware,2010,10336,9699,637,6.2
19,57,Des Moines,2010,20173,18641,1532,7.6
19,59,Dickinson,2010,9274,8634,640,6.9
19,61,Dubuque,2010,54082,50899,3183,5.9
19,63,Emmet,2010,5857,5437,420,7.2
19,65,Fayette,2010,10990,10190,800,7.3
19,67,Floyd,2010,8532,7900,632,7.4
19,69,Franklin,2010,6011,5630,381,6.3
19,71,Fremont,2010,3968,3730,238,6.0
19,73,Greene,2010,5188,4877,311,6.0
19,75,Grundy,2010,6738,6348,390,5.8
19,77,Guthrie,2010,5838,5454,384,6.6
19,79,Hamilton,2010,8066,7468,598,7.4
19,81,Hancock,2010,6056,5646,410,6.8
19,83,Hardin,2010,9110,8506,604,6.6
19,85,Harrison,2010,7980,7527,453,5.7
19,87,Henry,2010,9939,9099,840,8.5
19,89,Howard,2010,5329,4985,344,6.5
19,91,Humboldt,2010,5212,4938,274,5.3
19,93,Ida,2010,3836,3637,199,5.2
19,95,Iowa,2010,9634,9096,538,5.6
19,97,Jackson,2010,11090,10274,816,7.4
19,99,Jasper,2010,18992,17572,1420,7.5
19,101,Jefferson,2010,8938,8290,648,7.2
19,103,Johnson,2010,79040,75638,3402,4.3
19,105,Jones,2010,11079,10363,716,6.5
19,107,Keokuk,2010,5534,5166,368,6.6
19,109,Kossuth,2010,8358,7926,432,5.2
19,111,Lee,2010,17706,16108,1598,9.0
19,113,Linn,2010,119813,112523,7290,6.1
19,115,Louisa,2010,5950,5510,440,7.4
19,117,Lucas,2010,4221,3959,262,6.2
19,119,Lyon,2010,6385,6135,250,3.9
19,121,Madison,2010,8439,7888,551,6.5
19,123,Mahaska,2010,11891,11073,818,6.9
19,125,Marion,2010,17553,16495,1058,6.0
19,127,Marshall,2010,20107,18708,1399,7.0
19,129,Mills,2010,7589,7184,405,5.3
19,131,Mitchell,2010,5718,5417,301,5.3
19,133,Monona,2010,4877,4519,358,7.3
19,135,Monroe,2010,4087,3787,300,7.3
19,137,Montgomery,2010,5238,4808,430,8.2
19,139,Muscatine,2010,21776,19999,1777,8.2
19,141,O'Brien,2010,8122,7738,384,4.7
19,143,Osceola,2010,3659,3476,183,5.0
19,145,Page,2010,7116,6623,493,6.9
19,147,Palo Alto,2010,4833,4536,297,6.1
19,149,Plymouth,2010,14527,13865,662,4.6
19,151,Pocahontas,2010,4045,3835,210,5.2
19,153,Polk,2010,244314,229491,14823,6.1
19,155,Pottawattamie,2010,50212,47261,2951,5.9
19,157,Poweshiek,2010,10543,9922,621,5.9
19,159,Ringgold,2010,2608,2483,125,4.8
19,161,Sac,2010,5700,5429,271,4.8
19,163,Scott,2010,87001,81133,5868,6.7
19,165,Shelby,2010,6593,6288,305,4.6
19,167,Sioux,2010,19613,18831,782,4.0
19,169,Story,2010,53189,50916,2273,4.3
19,171,Tama,2010,9334,8723,611,6.5
19,173,Taylor,2010,3182,3001,181,5.7
19,175,Union,2010,7001,6599,402,5.7
19,177,Van Buren,2010,3964,3669,295,7.4
19,179,Wapello,2010,18480,16990,1490,8.1
19,181,Warren,2010,26286,24778,1508,5.7
19,183,Washington,2010,12387,11745,642,5.2
19,185,Wayne,2010,2869,2689,180,6.3
19,187,Webster,2010,20100,18678,1422,7.1
19,189,Winnebago,2010,5807,5411,396,6.8
19,191,Winneshiek,2010,12262,11573,689,5.6
19,193,Woodbury,2010,55861,52119,3742,6.7
19,195,Worth,2010,4332,4012,320,7.4
19,197,Wright,2010,6840,6342,498,7.3
20,1,Allen,2010,7003,6434,569,8.1
20,3,Anderson,2010,4572,4224,348,7.6
20,5,Atchison,2010,7933,7160,773,9.7
20,7,Barber,2010,2770,2646,124,4.5
20,9,Barton,2010,15002,14113,889,5.9
20,11,Bourbon,2010,7219,6577,642,8.9
20,13,Brown,2010,5267,4922,345,6.6
20,15,Butler,2010,32998,30473,2525,7.7
20,17,Chase,2010,1442,1362,80,5.5
20,19,Chautauqua,2010,1739,1584,155,8.9
20,21,Cherokee,2010,10796,9826,970,9.0
20,23,Cheyenne,2010,1405,1349,56,4.0
20,25,Clark,2010,1224,1170,54,4.4
20,27,Clay,2010,4632,4378,254,5.5
20,29,Cloud,2010,4655,4396,259,5.6
20,31,Coffey,2010,4846,4483,363,7.5
20,33,Comanche,2010,994,950,44,4.4
20,35,Cowley,2010,17254,15919,1335,7.7
20,37,Crawford,2010,19343,17687,1656,8.6
20,39,Decatur,2010,1457,1385,72,4.9
20,41,Dickinson,2010,10233,9565,668,6.5
20,43,Doniphan,2010,4538,4142,396,8.7
20,45,Douglas,2010,64384,60627,3757,5.8
20,47,Edwards,2010,1683,1594,89,5.3
20,49,Elk,2010,1414,1297,117,8.3
20,51,Ellis,2010,17648,16961,687,3.9
20,53,Ellsworth,2010,3396,3238,158,4.7
20,55,Finney,2010,20180,19272,908,4.5
20,57,Ford,2010,18120,17376,744,4.1
20,59,Franklin,2010,14347,13081,1266,8.8
20,61,Geary,2010,13351,12146,1205,9.0
20,63,Gove,2010,1505,1455,50,3.3
20,65,Graham,2010,1389,1324,65,4.7
20,67,Grant,2010,4203,4024,179,4.3
20,69,Gray,2010,3491,3379,112,3.2
20,71,Greeley,2010,827,799,28,3.4
20,73,Greenwood,2010,3440,3184,256,7.4
20,75,Hamilton,2010,1825,1769,56,3.1
20,77,Harper,2010,2937,2756,181,6.2
20,79,Harvey,2010,17771,16511,1260,7.1
20,81,Haskell,2010,2446,2359,87,3.6
20,83,Hodgeman,2010,1086,1046,40,3.7
20,85,Jackson,2010,7509,7052,457,6.1
20,87,Jefferson,2010,10670,9880,790,7.4
20,89,Jewell,2010,1558,1474,84,5.4
20,91,Johnson,2010,307208,288721,18487,6.0
20,93,Kearny,2010,2155,2060,95,4.4
20,95,Kingman,2010,3862,3597,265,6.9
20,97,Kiowa,2010,1398,1326,72,5.2
20,99,Labette,2010,11270,10212,1058,9.4
20,101,Lane,2010,986,945,41,4.2
20,103,Leavenworth,2010,34328,31763,2565,7.5
20,105,Lincoln,2010,1882,1771,111,5.9
20,107,Linn,2010,4532,4032,500,11.0
20,109,Logan,2010,1738,1677,61,3.5
20,111,Lyon,2010,17482,16331,1151,6.6
20,113,McPherson,2010,16480,15641,839,5.1
20,115,Marion,2010,6742,6347,395,5.9
20,117,Marshall,2010,5910,5613,297,5.0
20,119,Meade,2010,2568,2461,107,4.2
20,121,Miami,2010,17109,15829,1280,7.5
20,123,Mitchell,2010,3875,3692,183,4.7
20,125,Montgomery,2010,18072,16172,1900,10.5
20,127,Morris,2010,3311,3088,223,6.7
20,129,Morton,2010,1757,1681,76,4.3
20,131,Nemaha,2010,5822,5575,247,4.2
20,133,Neosho,2010,7408,6657,751,10.1
20,135,Ness,2010,1618,1555,63,3.9
20,137,Norton,2010,3100,2983,117,3.8
20,139,Osage,2010,8613,7912,701,8.1
20,141,Osborne,2010,2224,2118,106,4.8
20,143,Ottawa,2010,3286,3093,193,5.9
20,145,Pawnee,2010,3609,3442,167,4.6
20,147,Phillips,2010,3037,2883,154,5.1
20,149,Pottawatomie,2010,11893,11278,615,5.2
20,151,Pratt,2010,5290,4998,292,5.5
20,153,Rawlins,2010,1511,1459,52,3.4
20,155,Reno,2010,32895,30827,2068,6.3
20,157,Republic,2010,2734,2617,117,4.3
20,159,Rice,2010,5306,5022,284,5.4
20,161,Riley,2010,36098,34319,1779,4.9
20,163,Rooks,2010,2767,2595,172,6.2
20,165,Rush,2010,1793,1698,95,5.3
20,167,Russell,2010,3741,3553,188,5.0
20,169,Saline,2010,30935,29052,1883,6.1
20,171,Scott,2010,2769,2664,105,3.8
20,173,Sedgwick,2010,252552,230696,21856,8.7
20,175,Seward,2010,10796,10270,526,4.9
20,177,Shawnee,2010,93578,87123,6455,6.9
20,179,Sheridan,2010,1514,1464,50,3.3
20,181,Sherman,2010,3154,3006,148,4.7
20,183,Smith,2010,2334,2234,100,4.3
20,185,Stafford,2010,2366,2248,118,5.0
20,187,Stanton,2010,1093,1049,44,4.0
20,189,Stevens,2010,2871,2752,119,4.1
20,191,Sumner,2010,11953,10905,1048,8.8
20,193,Thomas,2010,4544,4367,177,3.9
20,195,Trego,2010,1510,1440,70,4.6
20,197,Wabaunsee,2010,3887,3636,251,6.5
20,199,Wallace,2010,894,841,53,5.9
20,201,Washington,2010,3347,3187,160,4.8
20,203,Wichita,2010,1336,1291,45,3.4
20,205,Wilson,2010,4492,3965,527,11.7
20,207,Woodson,2010,1736,1601,135,7.8
20,209,Wyandotte,2010,74897,67492,7405,9.9
21,1,Adair,2010,7852,6867,985,12.5
21,3,Allen,2010,9175,8089,1086,11.8
21,5,Anderson,2010,11637,10509,1128,9.7
21,7,Ballard,2010,3860,3460,400,10.4
21,9,Barren,2010,19853,17613,2240,11.3
21,11,Bath,2010,4914,4189,725,14.8
21,13,Bell,2010,10252,8996,1256,12.3
21,15,Boone,2010,63579,57900,5679,8.9
21,17,Bourbon,2010,10114,9189,925,9.1
21,19,Boyd,2010,20531,18418,2113,10.3
21,21,Boyle,2010,13415,11902,1513,11.3
21,23,Bracken,2010,4002,3543,459,11.5
21,25,Breathitt,2010,4554,3933,621,13.6
21,27,Breckinridge,2010,8317,7232,1085,13.0
21,29,Bullitt,2010,39018,34815,4203,10.8
21,31,Butler,2010,5485,4822,663,12.1
21,33,Caldwell,2010,5948,5315,633,10.6
21,35,Calloway,2010,19008,17463,1545,8.1
21,37,Campbell,2010,48957,44467,4490,9.2
21,39,Carlisle,2010,2262,2055,207,9.2
21,41,Carroll,2010,5027,4292,735,14.6
21,43,Carter,2010,11990,10286,1704,14.2
21,45,Casey,2010,6951,6180,771,11.1
21,47,Christian,2010,27446,24207,3239,11.8
21,49,Clark,2010,17866,15927,1939,10.9
21,51,Clay,2010,6064,5175,889,14.7
21,53,Clinton,2010,4296,3819,477,11.1
21,55,Crittenden,2010,4086,3675,411,10.1
21,57,Cumberland,2010,3191,2812,379,11.9
21,59,Daviess,2010,47121,42700,4421,9.4
21,61,Edmonson,2010,5150,4458,692,13.4
21,63,Elliott,2010,2413,2028,385,16.0
21,65,Estill,2010,5726,4944,782,13.7
21,67,Fayette,2010,164103,151818,12285,7.5
21,69,Fleming,2010,6749,5965,784,11.6
21,71,Floyd,2010,14018,12113,1905,13.6
21,73,Franklin,2010,24748,22574,2174,8.8
21,75,Fulton,2010,2743,2425,318,11.6
21,77,Gallatin,2010,4098,3588,510,12.4
21,79,Garrard,2010,7977,7080,897,11.2
21,81,Grant,2010,11747,10351,1396,11.9
21,83,Graves,2010,16914,15294,1620,9.6
21,85,Grayson,2010,11613,9945,1668,14.4
21,87,Green,2010,5626,4959,667,11.9
21,89,Greenup,2010,15430,13635,1795,11.6
21,91,Hancock,2010,4081,3658,423,10.4
21,93,Hardin,2010,47145,42536,4609,9.8
21,95,Harlan,2010,10247,9016,1231,12.0
21,97,Harrison,2010,9065,8047,1018,11.2
21,99,Hart,2010,8152,7294,858,10.5
21,101,Henderson,2010,22968,20588,2380,10.4
21,103,Henry,2010,7873,7090,783,9.9
21,105,Hickman,2010,2312,2121,191,8.3
21,107,Hopkins,2010,21318,19237,2081,9.8
21,109,Jackson,2010,5170,4437,733,14.2
21,111,Jefferson,2010,380641,342218,38423,10.1
21,113,Jessamine,2010,24833,22709,2124,8.6
21,115,Johnson,2010,8973,7836,1137,12.7
21,117,Kenton,2010,84234,75923,8311,9.9
21,119,Knott,2010,5956,5147,809,13.6
21,121,Knox,2010,10708,9247,1461,13.6
21,123,Larue,2010,6095,5401,694,11.4
21,125,Laurel,2010,25083,22197,2886,11.5
21,127,Lawrence,2010,5800,5003,797,13.7
21,129,Lee,2010,2604,2273,331,12.7
21,131,Leslie,2010,3627,3154,473,13.0
21,133,Letcher,2010,8705,7701,1004,11.5
21,135,Lewis,2010,5621,4839,782,13.9
21,137,Lincoln,2010,10681,9299,1382,12.9
21,139,Livingston,2010,4057,3564,493,12.2
21,141,Logan,2010,12680,11409,1271,10.0
21,143,Lyon,2010,2999,2648,351,11.7
21,145,McCracken,2010,30813,27992,2821,9.2
21,147,McCreary,2010,5755,4917,838,14.6
21,149,McLean,2010,4549,4079,470,10.3
21,151,Madison,2010,43266,39550,3716,8.6
21,153,Magoffin,2010,4317,3426,891,20.6
21,155,Marion,2010,9160,7994,1166,12.7
21,157,Marshall,2010,15483,13840,1643,10.6
21,159,Martin,2010,4017,3600,417,10.4
21,161,Mason,2010,7937,7033,904,11.4
21,163,Meade,2010,12403,10927,1476,11.9
21,165,Menifee,2010,2575,2172,403,15.7
21,167,Mercer,2010,10587,9391,1196,11.3
21,169,Metcalfe,2010,4700,4068,632,13.4
21,171,Monroe,2010,4875,4349,526,10.8
21,173,Montgomery,2010,12141,10647,1494,12.3
21,175,Morgan,2010,5141,4465,676,13.1
21,177,Muhlenberg,2010,13112,11663,1449,11.1
21,179,Nelson,2010,22087,19595,2492,11.3
21,181,Nicholas,2010,3650,3278,372,10.2
21,183,Ohio,2010,10371,9197,1174,11.3
21,185,Oldham,2010,29391,27155,2236,7.6
21,187,Owen,2010,5944,5440,504,8.5
21,189,Owsley,2010,1370,1186,184,13.4
21,191,Pendleton,2010,7427,6507,920,12.4
21,193,Perry,2010,11122,9806,1316,11.8
21,195,Pike,2010,24639,22039,2600,10.6
21,197,Powell,2010,5321,4487,834,15.7
21,199,Pulaski,2010,27921,24934,2987,10.7
21,201,Robertson,2010,873,771,102,11.7
21,203,Rockcastle,2010,7065,6266,799,11.3
21,205,Rowan,2010,10969,9848,1121,10.2
21,207,Russell,2010,7338,6387,951,13.0
21,209,Scott,2010,25556,23312,2244,8.8
21,211,Shelby,2010,21961,19982,1979,9.0
21,213,Simpson,2010,8689,7552,1137,13.1
21,215,Spencer,2010,9248,8326,922,10.0
21,217,Taylor,2010,11868,10398,1470,12.4
21,219,Todd,2010,5704,5127,577,10.1
21,221,Trigg,2010,6476,5554,922,14.2
21,223,Trimble,2010,4110,3576,534,13.0
21,225,Union,2010,7728,6971,757,9.8
21,227,Warren,2010,58510,53080,5430,9.3
21,229,Washington,2010,6120,5494,626,10.2
21,231,Wayne,2010,8257,7088,1169,14.2
21,233,Webster,2010,6152,5565,587,9.5
21,235,Whitley,2010,14200,12397,1803,12.7
21,237,Wolfe,2010,2164,1807,357,16.5
21,239,Woodford,2010,14511,13449,1062,7.3
22,1,Acadia Parish,2010,26121,24332,1789,6.8
22,3,Allen Parish,2010,9380,8506,874,9.3
22,5,Ascension Parish,2010,53365,49616,3749,7.0
22,7,Assumption Parish,2010,10038,8938,1100,11.0
22,9,Avoyelles Parish,2010,16852,15516,1336,7.9
22,11,Beauregard Parish,2010,14574,13484,1090,7.5
22,13,Bienville Parish,2010,5906,5345,561,9.5
22,15,Bossier Parish,2010,56595,53369,3226,5.7
22,17,Caddo Parish,2010,116713,107724,8989,7.7
22,19,Calcasieu Parish,2010,87825,81183,6642,7.6
22,21,Caldwell Parish,2010,4171,3742,429,10.3
22,23,Cameron Parish,2010,3300,3105,195,5.9
22,25,Catahoula Parish,2010,4220,3807,413,9.8
22,27,Claiborne Parish,2010,6887,6315,572,8.3
22,29,Concordia Parish,2010,7860,7122,738,9.4
22,31,De Soto Parish,2010,11379,10434,945,8.3
22,33,East Baton Rouge Parish,2010,221852,205954,15898,7.2
22,35,East Carroll Parish,2010,2461,2047,414,16.8
22,37,East Feliciana Parish,2010,8095,7457,638,7.9
22,39,Evangeline Parish,2010,13127,12064,1063,8.1
22,41,Franklin Parish,2010,8310,7439,871,10.5
22,43,Grant Parish,2010,8581,7896,685,8.0
22,45,Iberia Parish,2010,32211,29584,2627,8.2
22,47,Iberville Parish,2010,14002,12674,1328,9.5
22,49,Jackson Parish,2010,7082,6595,487,6.9
22,51,Jefferson Parish,2010,216160,201126,15034,7.0
22,53,Jefferson Davis Parish,2010,13106,12173,933,7.1
22,55,Lafayette Parish,2010,113598,106923,6675,5.9
22,57,Lafourche Parish,2010,45083,42477,2606,5.8
22,59,LaSalle Parish,2010,6445,6049,396,6.1
22,61,Lincoln Parish,2010,20284,18609,1675,8.3
22,63,Livingston Parish,2010,61247,56907,4340,7.1
22,65,Madison Parish,2010,4157,3683,474,11.4
22,67,Morehouse Parish,2010,11036,9423,1613,14.6
22,69,Natchitoches Parish,2010,16567,15163,1404,8.5
22,71,Orleans Parish,2010,162385,149075,13310,8.2
22,73,Ouachita Parish,2010,70667,65154,5513,7.8
22,75,Plaquemines Parish,2010,10031,9458,573,5.7
22,77,Pointe Coupee Parish,2010,9988,9171,817,8.2
22,79,Rapides Parish,2010,58785,54571,4214,7.2
22,81,Red River Parish,2010,4016,3695,321,8.0
22,83,Richland Parish,2010,8782,7866,916,10.4
22,85,Sabine Parish,2010,9669,9006,663,6.9
22,87,St. Bernard Parish,2010,15934,14681,1253,7.9
22,89,St. Charles Parish,2010,25470,23691,1779,7.0
22,91,St. Helena Parish,2010,4697,4114,583,12.4
22,93,St. James Parish,2010,10102,8985,1117,11.1
22,95,St. John the Baptist Parish,2010,21478,19331,2147,10.0
22,97,St. Landry Parish,2010,34256,31142,3114,9.1
22,99,St. Martin Parish,2010,24030,22227,1803,7.5
22,101,St. Mary Parish,2010,25141,22908,2233,8.9
22,103,St. Tammany Parish,2010,108779,102325,6454,5.9
22,105,Tangipahoa Parish,2010,53565,48649,4916,9.2
22,107,Tensas Parish,2010,2112,1836,276,13.1
22,109,Terrebonne Parish,2010,50914,47811,3103,6.1
22,111,Union Parish,2010,9654,8702,952,9.9
22,113,Vermilion Parish,2010,25628,23867,1761,6.9
22,115,Vernon Parish,2010,18530,17027,1503,8.1
22,117,Washington Parish,2010,17086,15533,1553,9.1
22,119,Webster Parish,2010,16794,15145,1649,9.8
22,121,West Baton Rouge Parish,2010,11917,11032,885,7.4
22,123,West Carroll Parish,2010,4425,3742,683,15.4
22,125,West Feliciana Parish,2010,5237,4905,332,6.3
22,127,Winn Parish,2010,5804,5292,512,8.8
23,1,Androscoggin,2010,56130,51144,4986,8.9
23,3,Aroostook,2010,34871,31361,3510,10.1
23,5,Cumberland,2010,156505,145927,10578,6.8
23,7,Franklin,2010,15567,14079,1488,9.6
23,9,Hancock,2010,29941,27201,2740,9.2
23,11,Kennebec,2010,63150,58167,4983,7.9
23,13,Knox,2010,20464,18894,1570,7.7
23,15,Lincoln,2010,17186,15834,1352,7.9
23,17,Oxford,2010,28055,24947,3108,11.1
23,19,Penobscot,2010,79325,72360,6965,8.8
23,21,Piscataquis,2010,8000,7114,886,11.1
23,23,Sagadahoc,2010,19281,17950,1331,6.9
23,25,Somerset,2010,24804,21952,2852,11.5
23,27,Waldo,2010,20489,18686,1803,8.8
23,29,Washington,2010,15017,13339,1678,11.2
23,31,York,2010,109048,100031,9017,8.3
24,1,Allegany,2010,34477,31189,3288,9.5
24,3,Anne Arundel,2010,286473,266214,20259,7.1
24,5,Baltimore,2010,432111,395705,36406,8.4
24,9,Calvert,2010,47901,44522,3379,7.1
24,11,Caroline,2010,17459,15803,1656,9.5
24,13,Carroll,2010,92731,86236,6495,7.0
24,15,Cecil,2010,52082,47005,5077,9.7
24,17,Charles,2010,78337,72775,5562,7.1
24,19,Dorchester,2010,16586,14657,1929,11.6
24,21,Frederick,2010,128100,119018,9082,7.1
24,23,Garrett,2010,15839,14397,1442,9.1
24,25,Harford,2010,133007,122387,10620,8.0
24,27,Howard,2010,160815,151535,9280,5.8
24,29,Kent,2010,10653,9688,965,9.1
24,31,Montgomery,2010,533156,502458,30698,5.8
24,33,Prince George's,2010,480390,443412,36978,7.7
24,35,Queen Anne's,2010,26181,24220,1961,7.5
24,37,St. Mary's,2010,53693,50089,3604,6.7
24,39,Somerset,2010,9952,8744,1208,12.1
24,41,Talbot,2010,19436,17849,1587,8.2
24,43,Washington,2010,75930,68493,7437,9.8
24,45,Wicomico,2010,50451,45440,5011,9.9
24,47,Worcester,2010,26529,22894,3635,13.7
24,510,Baltimore city,2010,296080,262216,33864,11.4
25,1,Barnstable,2010,111029,100326,10703,9.6
25,3,Berkshire,2010,67575,61835,5740,8.5
25,5,Bristol,2010,286598,257154,29444,10.3
25,7,Dukes,2010,9099,8236,863,9.5
25,9,Essex,2010,392023,358919,33104,8.4
25,11,Franklin,2010,39978,37023,2955,7.4
25,13,Hampden,2010,220805,198769,22036,10.0
25,15,Hampshire,2010,85567,79750,5817,6.8
25,17,Middlesex,2010,825988,770485,55503,6.7
25,19,Nantucket/town,2010,6165,5588,577,9.4
25,21,Norfolk,2010,358261,332376,25885,7.2
25,23,Plymouth,2010,262080,239319,22761,8.7
25,25,Suffolk,2010,393922,364715,29207,7.4
25,27,Worcester,2010,420213,384122,36091,8.6
26,1,Alcona,2010,3836,3171,665,17.3
26,3,Alger,2010,3556,3068,488,13.7
26,5,Allegan,2010,56490,50270,6220,11.0
26,7,Alpena,2010,14130,12328,1802,12.8
26,9,Antrim,2010,10448,8826,1622,15.5
26,11,Arenac,2010,6881,5778,1103,16.0
26,13,Baraga,2010,3858,3132,726,18.8
26,15,Barry,2010,29098,26171,2927,10.1
26,17,Bay,2010,54152,48078,6074,11.2
26,19,Benzie,2010,8870,7712,1158,13.1
26,21,Berrien,2010,75898,67041,8857,11.7
26,23,Branch,2010,19846,17409,2437,12.3
26,25,Calhoun,2010,64398,57068,7330,11.4
26,27,Cass,2010,24365,21670,2695,11.1
26,29,Charlevoix,2010,13220,11420,1800,13.6
26,31,Cheboygan,2010,11238,9719,1519,13.5
26,33,Chippewa,2010,17637,15595,2042,11.6
26,35,Clare,2010,12407,10533,1874,15.1
26,37,Clinton,2010,39302,36106,3196,8.1
26,39,Crawford,2010,5571,4804,767,13.8
26,41,Delta,2010,17998,15809,2189,12.2
26,43,Dickinson,2010,13090,11627,1463,11.2
26,45,Eaton,2010,56702,51387,5315,9.4
26,47,Emmet,2010,18319,15752,2567,14.0
26,49,Genesee,2010,184543,159283,25260,13.7
26,51,Gladwin,2010,10304,8820,1484,14.4
26,53,Gogebic,2010,7154,6245,909,12.7
26,55,Grand Traverse,2010,47109,41783,5326,11.3
26,57,Gratiot,2010,19358,17137,2221,11.5
26,59,Hillsdale,2010,21271,18474,2797,13.1
26,61,Houghton,2010,17777,15920,1857,10.4
26,63,Huron,2010,16481,14486,1995,12.1
26,65,Ingham,2010,147144,132451,14693,10.0
26,67,Ionia,2010,29644,26215,3429,11.6
26,69,Iosco,2010,10265,8689,1576,15.4
26,71,Iron,2010,5245,4635,610,11.6
26,73,Isabella,2010,35219,31867,3352,9.5
26,75,Jackson,2010,73954,65197,8757,11.8
26,77,Kalamazoo,2010,128519,116004,12515,9.7
26,79,Kalkaska,2010,7833,6643,1190,15.2
26,81,Kent,2010,313539,282588,30951,9.9
26,83,Keweenaw,2010,1003,857,146,14.6
26,85,Lake,2010,3847,3240,607,15.8
26,87,Lapeer,2010,40953,34495,6458,15.8
26,89,Leelanau,2010,10492,9438,1054,10.0
26,91,Lenawee,2010,49318,43076,6242,12.7
26,93,Livingston,2010,93444,83377,10067,10.8
26,95,Luce,2010,2473,2151,322,13.0
26,97,Mackinac,2010,5500,4721,779,14.2
26,99,Macomb,2010,417371,361414,55957,13.4
26,101,Manistee,2010,10942,9552,1390,12.7
26,103,Marquette,2010,34642,31326,3316,9.6
26,105,Mason,2010,14424,12662,1762,12.2
26,107,Mecosta,2010,19116,16778,2338,12.2
26,109,Menominee,2010,11847,10508,1339,11.3
26,111,Midland,2010,40881,36989,3892,9.5
26,113,Missaukee,2010,7076,6206,870,12.3
26,115,Monroe,2010,74925,66399,8526,11.4
26,117,Montcalm,2010,27524,23755,3769,13.7
26,119,Montmorency,2010,3507,2820,687,19.6
26,121,Muskegon,2010,76905,66050,10855,14.1
26,123,Newaygo,2010,22762,19965,2797,12.3
26,125,Oakland,2010,617349,547238,70111,11.4
26,127,Oceana,2010,13232,11155,2077,15.7
26,129,Ogemaw,2010,8987,7723,1264,14.1
26,131,Ontonagon,2010,3042,2546,496,16.3
26,133,Osceola,2010,10278,8920,1358,13.2
26,135,Oscoda,2010,3275,2652,623,19.0
26,137,Otsego,2010,11748,10123,1625,13.8
26,139,Ottawa,2010,139321,125410,13911,10.0
26,141,Presque Isle,2010,5688,4724,964,16.9
26,143,Roscommon,2010,8556,7172,1384,16.2
26,145,Saginaw,2010,89791,79123,10668,11.9
26,147,St. Clair,2010,76956,64761,12195,15.8
26,149,St. Joseph,2010,27837,24448,3389,12.2
26,151,Sanilac,2010,19790,16828,2962,15.0
26,153,Schoolcraft,2010,3759,3262,497,13.2
26,155,Shiawassee,2010,34314,30015,4299,12.5
26,157,Tuscola,2010,25755,22061,3694,14.3
26,159,Van Buren,2010,37401,32504,4897,13.1
26,161,Washtenaw,2010,181304,167031,14273,7.9
26,163,Wayne,2010,795744,676615,119129,15.0
26,165,Wexford,2010,15059,12950,2109,14.0
27,1,Aitkin,2010,7315,6553,762,10.4
27,3,Anoka,2010,187507,172432,15075,8.0
27,5,Becker,2010,17614,16218,1396,7.9
27,7,Beltrami,2010,22609,20748,1861,8.2
27,9,Benton,2010,21119,19273,1846,8.7
27,11,Big Stone,2010,2912,2723,189,6.5
27,13,Blue Earth,2010,38142,35705,2437,6.4
27,15,Brown,2010,15114,14071,1043,6.9
27,17,Carlton,2010,17797,16312,1485,8.3
27,19,Carver,2010,51658,48173,3485,6.7
27,21,Cass,2010,14399,12872,1527,10.6
27,23,Chippewa,2010,7157,6631,526,7.3
27,25,Chisago,2010,29333,26721,2612,8.9
27,27,Clay,2010,33907,32025,1882,5.6
27,29,Clearwater,2010,4594,3990,604,13.1
27,31,Cook,2010,3059,2839,220,7.2
27,33,Cottonwood,2010,6232,5825,407,6.5
27,35,Crow Wing,2010,32059,28999,3060,9.5
27,37,Dakota,2010,227404,211524,15880,7.0
27,39,Dodge,2010,11315,10530,785,6.9
27,41,Douglas,2010,19833,18481,1352,6.8
27,43,Faribault,2010,7837,7211,626,8.0
27,45,Fillmore,2010,11256,10408,848,7.5
27,47,Freeborn,2010,17097,15775,1322,7.7
27,49,Goodhue,2010,26751,24866,1885,7.0
27,51,Grant,2010,3402,3131,271,8.0
27,53,Hennepin,2010,651084,605608,45476,7.0
27,55,Houston,2010,10840,10005,835,7.7
27,57,Hubbard,2010,9759,8789,970,9.9
27,59,Isanti,2010,20577,18592,1985,9.6
27,61,Itasca,2010,22514,20225,2289,10.2
27,63,Jackson,2010,6031,5677,354,5.9
27,65,Kanabec,2010,8793,7804,989,11.2
27,67,Kandiyohi,2010,23588,22009,1579,6.7
27,69,Kittson,2010,2579,2384,195,7.6
27,71,Koochiching,2010,6945,6340,605,8.7
27,73,Lac qui Parle,2010,4085,3812,273,6.7
27,75,Lake,2010,5802,5319,483,8.3
27,77,Lake of the Woods,2010,2283,2135,148,6.5
27,79,Le Sueur,2010,15722,14331,1391,8.8
27,81,Lincoln,2010,3448,3257,191,5.5
27,83,Lyon,2010,15237,14382,855,5.6
27,85,McLeod,2010,20320,18497,1823,9.0
27,87,Mahnomen,2010,2504,2297,207,8.3
27,89,Marshall,2010,5703,5172,531,9.3
27,91,Martin,2010,11513,10670,843,7.3
27,93,Meeker,2010,12821,11690,1131,8.8
27,95,Mille Lacs,2010,13165,11701,1464,11.1
27,97,Morrison,2010,18629,16858,1771,9.5
27,99,Mower,2010,20923,19644,1279,6.1
27,101,Murray,2010,5026,4680,346,6.9
27,103,Nicollet,2010,19796,18584,1212,6.1
27,105,Nobles,2010,11531,10882,649,5.6
27,107,Norman,2010,3607,3357,250,6.9
27,109,Olmsted,2010,81257,76408,4849,6.0
27,111,Otter Tail,2010,30896,28673,2223,7.2
27,113,Pennington,2010,8406,7643,763,9.1
27,115,Pine,2010,15371,13856,1515,9.9
27,117,Pipestone,2010,5152,4812,340,6.6
27,119,Polk,2010,17171,16028,1143,6.7
27,121,Pope,2010,5884,5464,420,7.1
27,123,Ramsey,2010,270269,250065,20204,7.5
27,125,Red Lake,2010,2421,2188,233,9.6
27,127,Redwood,2010,8587,8006,581,6.8
27,129,Renville,2010,8998,8274,724,8.0
27,131,Rice,2010,35007,32281,2726,7.8
27,133,Rock,2010,5380,5107,273,5.1
27,135,Roseau,2010,8692,8134,558,6.4
27,137,St. Louis,2010,103461,95040,8421,8.1
27,139,Scott,2010,74208,69100,5108,6.9
27,141,Sherburne,2010,49033,44890,4143,8.4
27,143,Sibley,2010,8516,7841,675,7.9
27,145,Stearns,2010,85722,79536,6186,7.2
27,147,Steele,2010,21080,19436,1644,7.8
27,149,Stevens,2010,5551,5241,310,5.6
27,151,Swift,2010,5244,4818,426,8.1
27,153,Todd,2010,13526,12477,1049,7.8
27,155,Traverse,2010,1882,1765,117,6.2
27,157,Wabasha,2010,12117,11249,868,7.2
27,159,Wadena,2010,6486,5825,661,10.2
27,161,Waseca,2010,10584,9791,793,7.5
27,163,Washington,2010,132144,123252,8892,6.7
27,165,Watonwan,2010,6316,5853,463,7.3
27,167,Wilkin,2010,3825,3615,210,5.5
27,169,Winona,2010,29234,27210,2024,6.9
27,171,Wright,2010,70146,64495,5651,8.1
27,173,Yellow Medicine,2010,5882,5511,371,6.3
28,1,Adams,2010,12630,11220,1410,11.2
28,3,Alcorn,2010,15745,13978,1767,11.2
28,5,Amite,2010,4987,4408,579,11.6
28,7,Attala,2010,7966,6994,972,12.2
28,9,Benton,2010,3278,2880,398,12.1
28,11,Bolivar,2010,14930,13280,1650,11.1
28,13,Calhoun,2010,7042,6409,633,9.0
28,15,Carroll,2010,3837,3347,490,12.8
28,17,Chickasaw,2010,7955,7025,930,11.7
28,19,Choctaw,2010,3772,3339,433,11.5
28,21,Claiborne,2010,3581,2998,583,16.3
28,23,Clarke,2010,6615,5806,809,12.2
28,25,Clay,2010,8684,7295,1389,16.0
28,27,Coahoma,2010,10489,9091,1398,13.3
28,29,Copiah,2010,12012,10677,1335,11.1
28,31,Covington,2010,8252,7440,812,9.8
28,33,DeSoto,2010,79838,74061,5777,7.2
28,35,Forrest,2010,34157,30915,3242,9.5
28,37,Franklin,2010,3240,2881,359,11.1
28,39,George,2010,8775,7793,982,11.2
28,41,Greene,2010,4587,4055,532,11.6
28,43,Grenada,2010,9447,8385,1062,11.2
28,45,Hancock,2010,19700,17980,1720,8.7
28,47,Harrison,2010,88949,81369,7580,8.5
28,49,Hinds,2010,114138,103236,10902,9.6
28,51,Holmes,2010,6842,5535,1307,19.1
28,53,Humphreys,2010,3481,2897,584,16.8
28,55,Issaquena,2010,524,442,82,15.6
28,57,Itawamba,2010,10373,9236,1137,11.0
28,59,Jackson,2010,64564,58594,5970,9.2
28,61,Jasper,2010,7024,6186,838,11.9
28,63,Jefferson,2010,2470,2017,453,18.3
28,65,Jefferson Davis,2010,4613,3982,631,13.7
28,67,Jones,2010,27996,25515,2481,8.9
28,69,Kemper,2010,3909,3348,561,14.4
28,71,Lafayette,2010,21700,19732,1968,9.1
28,73,Lamar,2010,27740,25805,1935,7.0
28,75,Lauderdale,2010,33113,29694,3419,10.3
28,77,Lawrence,2010,5156,4558,598,11.6
28,79,Leake,2010,9196,8332,864,9.4
28,81,Lee,2010,39265,35293,3972,10.1
28,83,Leflore,2010,11608,9876,1732,14.9
28,85,Lincoln,2010,14487,13007,1480,10.2
28,87,Lowndes,2010,26184,23166,3018,11.5
28,89,Madison,2010,48853,45347,3506,7.2
28,91,Marion,2010,10560,9307,1253,11.9
28,93,Marshall,2010,15519,13696,1823,11.7
28,95,Monroe,2010,16319,14231,2088,12.8
28,97,Montgomery,2010,4678,4051,627,13.4
28,99,Neshoba,2010,11829,10634,1195,10.1
28,101,Newton,2010,9221,8317,904,9.8
28,103,Noxubee,2010,4432,3751,681,15.4
28,105,Oktibbeha,2010,21743,19580,2163,9.9
28,107,Panola,2010,14422,12521,1901,13.2
28,109,Pearl River,2010,23474,21307,2167,9.2
28,111,Perry,2010,4642,4024,618,13.3
28,113,Pike,2010,15636,13871,1765,11.3
28,115,Pontotoc,2010,13700,12344,1356,9.9
28,117,Prentiss,2010,11621,10288,1333,11.5
28,119,Quitman,2010,3198,2735,463,14.5
28,121,Rankin,2010,71072,66343,4729,6.7
28,123,Scott,2010,13588,12534,1054,7.8
28,125,Sharkey,2010,2060,1769,291,14.1
28,127,Simpson,2010,11401,10358,1043,9.1
28,129,Smith,2010,7330,6684,646,8.8
28,131,Stone,2010,6855,6149,706,10.3
28,133,Sunflower,2010,9872,8391,1481,15.0
28,135,Tallahatchie,2010,5894,5193,701,11.9
28,137,Tate,2010,12654,11329,1325,10.5
28,139,Tippah,2010,8999,7817,1182,13.1
28,141,Tishomingo,2010,7821,6852,969,12.4
28,143,Tunica,2010,5031,4362,669,13.3
28,145,Union,2010,12159,10870,1289,10.6
28,147,Walthall,2010,5823,5087,736,12.6
28,149,Warren,2010,23373,20997,2376,10.2
28,151,Washington,2010,20957,17729,3228,15.4
28,153,Wayne,2010,8644,7628,1016,11.8
28,155,Webster,2010,4379,3889,490,11.2
28,157,Wilkinson,2010,3447,2983,464,13.5
28,159,Winston,2010,7944,6631,1313,16.5
28,161,Yalobusha,2010,5210,4522,688,13.2
28,163,Yazoo,2010,9928,8746,1182,11.9
29,1,Adair,2010,11036,10089,947,8.6
29,3,Andrew,2010,9857,9046,811,8.2
29,5,Atchison,2010,2987,2732,255,8.5
29,7,Audrain,2010,11090,10032,1058,9.5
29,9,Barry,2010,15549,14059,1490,9.6
29,11,Barton,2010,5732,5146,586,10.2
29,13,Bates,2010,8357,7447,910,10.9
29,15,Benton,2010,7260,6384,876,12.1
29,17,Bollinger,2010,5817,5236,581,10.0
29,19,Boone,2010,92186,86285,5901,6.4
29,21,Buchanan,2010,46465,42236,4229,9.1
29,23,Butler,2010,18687,16910,1777,9.5
29,25,Caldwell,2010,4541,4110,431,9.5
29,27,Callaway,2010,22284,20453,1831,8.2
29,29,Camden,2010,19373,17069,2304,11.9
29,31,Cape Girardeau,2010,40861,37890,2971,7.3
29,33,Carroll,2010,4774,4231,543,11.4
29,35,Carter,2010,2655,2351,304,11.5
29,37,Cass,2010,53137,48049,5088,9.6
29,39,Cedar,2010,6087,5511,576,9.5
29,41,Chariton,2010,4111,3723,388,9.4
29,43,Christian,2010,40687,37289,3398,8.4
29,45,Clark,2010,3447,3022,425,12.3
29,47,Clay,2010,124476,114132,10344,8.3
29,49,Clinton,2010,11020,9967,1053,9.6
29,51,Cole,2010,40520,37762,2758,6.8
29,53,Cooper,2010,7926,7159,767,9.7
29,55,Crawford,2010,10762,9406,1356,12.6
29,57,Dade,2010,3387,3060,327,9.7
29,59,Dallas,2010,7252,6347,905,12.5
29,61,Daviess,2010,3992,3604,388,9.7
29,63,DeKalb,2010,5002,4565,437,8.7
29,65,Dent,2010,6483,5817,666,10.3
29,67,Douglas,2010,5225,4596,629,12.0
29,69,Dunklin,2010,12234,10595,1639,13.4
29,71,Franklin,2010,53206,47232,5974,11.2
29,73,Gasconade,2010,7718,6919,799,10.4
29,75,Gentry,2010,3509,3234,275,7.8
29,77,Greene,2010,144128,132202,11926,8.3
29,79,Grundy,2010,4817,4434,383,8.0
29,81,Harrison,2010,4045,3663,382,9.4
29,83,Henry,2010,10095,9013,1082,10.7
29,85,Hickory,2010,3661,3202,459,12.5
29,87,Holt,2010,2681,2470,211,7.9
29,89,Howard,2010,4981,4549,432,8.7
29,91,Howell,2010,16990,15165,1825,10.7
29,93,Iron,2010,3554,2966,588,16.5
29,95,Jackson,2010,359453,321363,38090,10.6
29,97,Jasper,2010,58771,53830,4941,8.4
29,99,Jefferson,2010,117009,104981,12028,10.3
29,101,Johnson,2010,23393,21084,2309,9.9
29,103,Knox,2010,1999,1845,154,7.7
29,105,Laclede,2010,15846,13893,1953,12.3
29,107,Lafayette,2010,17474,15775,1699,9.7
29,109,Lawrence,2010,17483,15870,1613,9.2
29,111,Lewis,2010,5181,4742,439,8.5
29,113,Lincoln,2010,26581,23476,3105,11.7
29,115,Linn,2010,5425,4749,676,12.5
29,117,Livingston,2010,7118,6541,577,8.1
29,119,McDonald,2010,10316,9378,938,9.1
29,121,Macon,2010,7450,6765,685,9.2
29,123,Madison,2010,5433,4777,656,12.1
29,125,Maries,2010,4239,3840,399,9.4
29,127,Marion,2010,14707,13380,1327,9.0
29,129,Mercer,2010,1788,1640,148,8.3
29,131,Miller,2010,11804,10295,1509,12.8
29,133,Mississippi,2010,6081,5498,583,9.6
29,135,Moniteau,2010,7366,6749,617,8.4
29,137,Monroe,2010,4099,3600,499,12.2
29,139,Montgomery,2010,6018,5355,663,11.0
29,141,Morgan,2010,7947,6800,1147,14.4
29,143,New Madrid,2010,8190,7380,810,9.9
29,145,Newton,2010,28636,26083,2553,8.9
29,147,Nodaway,2010,11710,10871,839,7.2
29,149,Oregon,2010,4087,3638,449,11.0
29,151,Osage,2010,7436,6926,510,6.9
29,153,Ozark,2010,3587,3168,419,11.7
29,155,Pemiscot,2010,7187,6300,887,12.3
29,157,Perry,2010,9794,9090,704,7.2
29,159,Pettis,2010,19992,18155,1837,9.2
29,161,Phelps,2010,19731,17965,1766,9.0
29,163,Pike,2010,8203,7407,796,9.7
29,165,Platte,2010,51366,47425,3941,7.7
29,167,Polk,2010,14343,12879,1464,10.2
29,169,Pulaski,2010,16636,15186,1450,8.7
29,171,Putnam,2010,2378,2188,190,8.0
29,173,Ralls,2010,5611,5122,489,8.7
29,175,Randolph,2010,10745,9513,1232,11.5
29,177,Ray,2010,11519,10347,1172,10.2
29,179,Reynolds,2010,2372,2016,356,15.0
29,181,Ripley,2010,5370,4683,687,12.8
29,183,St. Charles,2010,204342,187742,16600,8.1
29,185,St. Clair,2010,4119,3659,460,11.2
29,186,Ste. Genevieve,2010,9363,8407,956,10.2
29,187,St. Francois,2010,27142,23847,3295,12.1
29,189,St. Louis,2010,532792,485674,47118,8.8
29,195,Saline,2010,10935,9969,966,8.8
29,197,Schuyler,2010,1952,1751,201,10.3
29,199,Scotland,2010,2296,2112,184,8.0
29,201,Scott,2010,18925,17101,1824,9.6
29,203,Shannon,2010,3227,2752,475,14.7
29,205,Shelby,2010,3228,2952,276,8.6
29,207,Stoddard,2010,13546,12144,1402,10.3
29,209,Stone,2010,14428,12448,1980,13.7
29,211,Sullivan,2010,2925,2669,256,8.8
29,213,Taney,2010,25956,22368,3588,13.8
29,215,Texas,2010,9798,8727,1071,10.9
29,217,Vernon,2010,9532,8750,782,8.2
29,219,Warren,2010,17179,15311,1868,10.9
29,221,Washington,2010,10208,8756,1452,14.2
29,223,Wayne,2010,5541,4948,593,10.7
29,225,Webster,2010,16314,14608,1706,10.5
29,227,Worth,2010,1244,1160,84,6.8
29,229,Wright,2010,7580,6683,897,11.8
29,510,St. Louis city,2010,164163,145451,18712,11.4
30,1,Beaverhead,2010,5014,4721,293,5.8
30,3,Big Horn,2010,5525,4928,597,10.8
30,5,Blaine,2010,2523,2358,165,6.5
30,7,Broadwater,2010,2508,2325,183,7.3
30,9,Carbon,2010,5333,4997,336,6.3
30,11,Carter,2010,725,698,27,3.7
30,13,Cascade,2010,38471,36059,2412,6.3
30,15,Chouteau,2010,2740,2622,118,4.3
30,17,Custer,2010,6407,6121,286,4.5
30,19,Daniels,2010,948,915,33,3.5
30,21,Dawson,2010,4518,4331,187,4.1
30,23,Deer Lodge,2010,5185,4873,312,6.0
30,25,Fallon,2010,1900,1843,57,3.0
30,27,Fergus,2010,6020,5640,380,6.3
30,29,Flathead,2010,43844,38579,5265,12.0
30,31,Gallatin,2010,50799,47397,3402,6.7
30,33,Garfield,2010,765,738,27,3.5
30,35,Glacier,2010,6264,5658,606,9.7
30,37,Golden Valley,2010,419,391,28,6.7
30,39,Granite,2010,1459,1326,133,9.1
30,41,Hill,2010,7987,7531,456,5.7
30,43,Jefferson,2010,5631,5283,348,6.2
30,45,Judith Basin,2010,1010,946,64,6.3
30,47,Lake,2010,12658,11532,1126,8.9
30,49,Lewis and Clark,2010,34339,32483,1856,5.4
30,51,Liberty,2010,1034,990,44,4.3
30,53,Lincoln,2010,8424,7180,1244,14.8
30,55,McCone,2010,1132,1100,32,2.8
30,57,Madison,2010,4158,3847,311,7.5
30,59,Meagher,2010,937,862,75,8.0
30,61,Mineral,2010,1792,1569,223,12.4
30,63,Missoula,2010,58566,54339,4227,7.2
30,65,Musselshell,2010,2383,2221,162,6.8
30,67,Park,2010,7895,7212,683,8.7
30,69,Petroleum,2010,299,284,15,5.0
30,71,Phillips,2010,2210,2062,148,6.7
30,73,Pondera,2010,2955,2785,170,5.8
30,75,Powder River,2010,1046,1007,39,3.7
30,77,Powell,2010,2964,2740,224,7.6
30,79,Prairie,2010,567,539,28,4.9
30,81,Ravalli,2010,18888,17125,1763,9.3
30,83,Richland,2010,5769,5555,214,3.7
30,85,Roosevelt,2010,4587,4276,311,6.8
30,87,Rosebud,2010,4361,4061,300,6.9
30,89,Sanders,2010,4997,4352,645,12.9
30,91,Sheridan,2010,1822,1756,66,3.6
30,93,Silver Bow,2010,16962,15874,1088,6.4
30,95,Stillwater,2010,4766,4492,274,5.7
30,97,Sweet Grass,2010,1740,1646,94,5.4
30,99,Teton,2010,3033,2854,179,5.9
30,101,Toole,2010,2450,2340,110,4.5
30,103,Treasure,2010,399,378,21,5.3
30,105,Valley,2010,3914,3726,188,4.8
30,107,Wheatland,2010,861,794,67,7.8
30,109,Wibaux,2010,530,508,22,4.2
30,111,Yellowstone,2010,76468,72045,4423,5.8
31,1,Adams,2010,16472,15677,795,4.8
31,3,Antelope,2010,3522,3393,129,3.7
31,5,Arthur,2010,225,207,18,8.0
31,7,Banner,2010,413,395,18,4.4
31,9,Blaine,2010,257,244,13,5.1
31,11,Boone,2010,2955,2849,106,3.6
31,13,Box Butte,2010,5844,5548,296,5.1
31,15,Boyd,2010,1105,1061,44,4.0
31,17,Brown,2010,1460,1390,70,4.8
31,19,Buffalo,2010,26344,25371,973,3.7
31,21,Burt,2010,3637,3417,220,6.0
31,23,Butler,2010,4643,4458,185,4.0
31,25,Cass,2010,13387,12620,767,5.7
31,27,Cedar,2010,4619,4452,167,3.6
31,29,Chase,2010,2289,2224,65,2.8
31,31,Cherry,2010,3378,3277,101,3.0
31,33,Cheyenne,2010,5549,5344,205,3.7
31,35,Clay,2010,3428,3279,149,4.3
31,37,Colfax,2010,5650,5423,227,4.0
31,39,Cuming,2010,4856,4675,181,3.7
31,41,Custer,2010,5977,5753,224,3.7
31,43,Dakota,2010,11290,10447,843,7.5
31,45,Dawes,2010,5490,5269,221,4.0
31,47,Dawson,2010,13192,12530,662,5.0
31,49,Deuel,2010,1030,989,41,4.0
31,51,Dixon,2010,3111,2959,152,4.9
31,53,Dodge,2010,18827,17814,1013,5.4
31,55,Douglas,2010,278916,264380,14536,5.2
31,57,Dundy,2010,1215,1176,39,3.2
31,59,Fillmore,2010,3235,3112,123,3.8
31,61,Franklin,2010,1633,1560,73,4.5
31,63,Frontier,2010,1594,1533,61,3.8
31,65,Furnas,2010,2656,2565,91,3.4
31,67,Gage,2010,11394,10727,667,5.9
31,69,Garden,2010,1265,1212,53,4.2
31,71,Garfield,2010,1200,1162,38,3.2
31,73,Gosper,2010,1145,1103,42,3.7
31,75,Grant,2010,420,404,16,3.8
31,77,Greeley,2010,1358,1308,50,3.7
31,79,Hall,2010,31476,29986,1490,4.7
31,81,Hamilton,2010,4799,4615,184,3.8
31,83,Harlan,2010,1890,1828,62,3.3
31,85,Hayes,2010,640,617,23,3.6
31,87,Hitchcock,2010,1398,1325,73,5.2
31,89,Holt,2010,5822,5608,214,3.7
31,91,Hooker,2010,409,388,21,5.1
31,93,Howard,2010,3342,3191,151,4.5
31,95,Jefferson,2010,4245,4041,204,4.8
31,97,Johnson,2010,2340,2229,111,4.7
31,99,Kearney,2010,3790,3655,135,3.6
31,101,Keith,2010,4578,4380,198,4.3
31,103,Keya Paha,2010,568,547,21,3.7
31,105,Kimball,2010,2120,2019,101,4.8
31,107,Knox,2010,4744,4544,200,4.2
31,109,Lancaster,2010,162326,155360,6966,4.3
31,111,Lincoln,2010,19374,18482,892,4.6
31,113,Logan,2010,492,469,23,4.7
31,115,Loup,2010,368,347,21,5.7
31,117,McPherson,2010,352,342,10,2.8
31,119,Madison,2010,18923,18110,813,4.3
31,121,Merrick,2010,4193,4001,192,4.6
31,123,Morrill,2010,2646,2536,110,4.2
31,125,Nance,2010,1977,1898,79,4.0
31,127,Nemaha,2010,3846,3638,208,5.4
31,129,Nuckolls,2010,2438,2336,102,4.2
31,131,Otoe,2010,8465,8030,435,5.1
31,133,Pawnee,2010,1583,1519,64,4.0
31,135,Perkins,2010,1766,1706,60,3.4
31,137,Phelps,2010,4950,4770,180,3.6
31,139,Pierce,2010,4169,4013,156,3.7
31,141,Platte,2010,17629,16871,758,4.3
31,143,Polk,2010,2954,2833,121,4.1
31,145,Red Willow,2010,6206,5975,231,3.7
31,147,Richardson,2010,4323,4049,274,6.3
31,149,Rock,2010,890,864,26,2.9
31,151,Saline,2010,7277,6930,347,4.8
31,153,Sarpy,2010,84801,80959,3842,4.5
31,155,Saunders,2010,11164,10618,546,4.9
31,157,Scotts Bluff,2010,19176,18103,1073,5.6
31,159,Seward,2010,8752,8395,357,4.1
31,161,Sheridan,2010,2817,2715,102,3.6
31,163,Sherman,2010,1727,1656,71,4.1
31,165,Sioux,2010,834,802,32,3.8
31,167,Stanton,2010,3579,3430,149,4.2
31,169,Thayer,2010,2799,2691,108,3.9
31,171,Thomas,2010,395,376,19,4.8
31,173,Thurston,2010,3053,2756,297,9.7
31,175,Valley,2010,2139,2043,96,4.5
31,177,Washington,2010,11217,10692,525,4.7
31,179,Wayne,2010,5662,5443,219,3.9
31,181,Webster,2010,1704,1620,84,4.9
31,183,Wheeler,2010,514,494,20,3.9
31,185,York,2010,7401,7051,350,4.7
32,1,Churchill,2010,11223,9817,1406,12.5
32,3,Clark,2010,984712,846856,137856,14.0
32,5,Douglas,2010,23127,19892,3235,14.0
32,7,Elko,2010,26539,24433,2106,7.9
32,9,Esmeralda,2010,382,344,38,9.9
32,11,Eureka,2010,1018,937,81,8.0
32,13,Humboldt,2010,8394,7658,736,8.8
32,15,Lander,2010,3042,2742,300,9.9
32,17,Lincoln,2010,2002,1785,217,10.8
32,19,Lyon,2010,22954,18858,4096,17.8
32,21,Mineral,2010,2206,1866,340,15.4
32,23,Nye,2010,16746,13805,2941,17.6
32,27,Pershing,2010,2321,2064,257,11.1
32,29,Storey,2010,2015,1673,342,17.0
32,31,Washoe,2010,220840,191887,28953,13.1
32,33,White Pine,2010,4636,4207,429,9.3
32,510,Carson City,2010,26706,23056,3650,13.7
33,1,Belknap,2010,32318,30163,2155,6.7
33,3,Carroll,2010,24976,23493,1483,5.9
33,5,Cheshire,2010,42678,40203,2475,5.8
33,7,Coos,2010,16624,15345,1279,7.7
33,9,Grafton,2010,48368,45937,2431,5.0
33,11,Hillsborough,2010,226514,211932,14582,6.4
33,13,Merrimack,2010,81501,76938,4563,5.6
33,15,Rockingham,2010,172626,161826,10800,6.3
33,17,Strafford,2010,69669,65535,4134,5.9
33,19,Sullivan,2010,24065,22759,1306,5.4
34,1,Atlantic,2010,140595,123056,17539,12.5
34,3,Bergen,2010,479771,440715,39056,8.1
34,5,Burlington,2010,237012,215372,21640,9.1
34,7,Camden,2010,264771,235349,29422,11.1
34,9,Cape May,2010,50245,43105,7140,14.2
34,11,Cumberland,2010,72681,63102,9579,13.2
34,13,Essex,2010,382855,340726,42129,11.0
34,15,Gloucester,2010,152554,136659,15895,10.4
34,17,Hudson,2010,353587,319315,34272,9.7
34,19,Hunterdon,2010,68388,63256,5132,7.5
34,21,Mercer,2010,193485,177105,16380,8.5
34,23,Middlesex,2010,423834,385271,38563,9.1
34,25,Monmouth,2010,329935,300605,29330,8.9
34,27,Morris,2010,265202,245258,19944,7.5
34,29,Ocean,2010,264294,236721,27573,10.4
34,31,Passaic,2010,253961,224727,29234,11.5
34,33,Salem,2010,32171,28367,3804,11.8
34,35,Somerset,2010,173723,160337,13386,7.7
34,37,Sussex,2010,82391,74512,7879,9.6
34,39,Union,2010,279659,252621,27038,9.7
34,41,Warren,2010,58665,52803,5862,10.0
35,1,Bernalillo,2010,324142,300114,24028,7.4
35,3,Catron,2010,1206,1066,140,11.6
35,5,Chaves,2010,27829,25820,2009,7.2
35,6,Cibola,2010,9246,8396,850,9.2
35,7,Colfax,2010,6314,5806,508,8.0
35,9,Curry,2010,21443,20344,1099,5.1
35,11,De Baca,2010,827,780,47,5.7
35,13,Dona Ana,2010,92896,85982,6914,7.4
35,15,Eddy,2010,25475,23916,1559,6.1
35,17,Grant,2010,12247,11110,1137,9.3
35,19,Guadalupe,2010,1637,1479,158,9.7
35,21,Harding,2010,293,276,17,5.8
35,23,Hidalgo,2010,2284,2097,187,8.2
35,25,Lea,2010,26101,24123,1978,7.6
35,27,Lincoln,2010,9314,8646,668,7.2
35,28,Los Alamos,2010,9405,9076,329,3.5
35,29,Luna,2010,11516,9288,2228,19.3
35,31,McKinley,2010,25221,22834,2387,9.5
35,33,Mora,2010,2410,2125,285,11.8
35,35,Otero,2010,24796,23075,1721,6.9
35,37,Quay,2010,3470,3157,313,9.0
35,39,Rio Arriba,2010,17861,16291,1570,8.8
35,41,Roosevelt,2010,8349,7850,499,6.0
35,43,Sandoval,2010,60446,55563,4883,8.1
35,45,San Juan,2010,54401,49509,4892,9.0
35,47,San Miguel,2010,11113,10089,1024,9.2
35,49,Santa Fe,2010,73742,68957,4785,6.5
35,51,Sierra,2010,3993,3641,352,8.8
35,53,Socorro,2010,6822,6314,508,7.4
35,55,Taos,2010,15266,13700,1566,10.3
35,57,Torrance,2010,5974,5309,665,11.1
35,59,Union,2010,1915,1801,114,6.0
35,61,Valencia,2010,30910,28071,2839,9.2
36,1,Albany,2010,161626,150137,11489,7.1
36,3,Allegany,2010,24270,22004,2266,9.3
36,5,Bronx,2010,586805,516105,70700,12.0
36,7,Broome,2010,97931,89241,8690,8.9
36,9,Cattaraugus,2010,39706,35851,3855,9.7
36,11,Cayuga,2010,39915,36448,3467,8.7
36,13,Chautauqua,2010,63976,58211,5765,9.0
36,15,Chemung,2010,41638,38073,3565,8.6
36,17,Chenango,2010,23717,21490,2227,9.4
36,19,Clinton,2010,39748,35778,3970,10.0
36,21,Columbia,2010,32162,29763,2399,7.5
36,23,Cortland,2010,24504,22286,2218,9.1
36,25,Delaware,2010,22450,20447,2003,8.9
36,27,Dutchess,2010,149288,137561,11727,7.9
36,29,Erie,2010,466015,426603,39412,8.5
36,31,Essex,2010,18753,17006,1747,9.3
36,33,Franklin,2010,22260,20232,2028,9.1
36,35,Fulton,2010,26148,23317,2831,10.8
36,37,Genesee,2010,31762,29163,2599,8.2
36,39,Greene,2010,22130,20080,2050,9.3
36,41,Hamilton,2010,2506,2254,252,10.1
36,43,Herkimer,2010,31587,28817,2770,8.8
36,45,Jefferson,2010,50335,45598,4737,9.4
36,47,Kings,2010,1172462,1055400,117062,10.0
36,49,Lewis,2010,12772,11582,1190,9.3
36,51,Livingston,2010,32783,30079,2704,8.2
36,53,Madison,2010,35610,32603,3007,8.4
36,55,Monroe,2010,378548,347553,30995,8.2
36,57,Montgomery,2010,23951,21488,2463,10.3
36,59,Nassau,2010,691973,641573,50400,7.3
36,61,New York,2010,887865,811259,76606,8.6
36,63,Niagara,2010,107989,97385,10604,9.8
36,65,Oneida,2010,112343,103595,8748,7.8
36,67,Onondaga,2010,237164,217786,19378,8.2
36,69,Ontario,2010,56411,52132,4279,7.6
36,71,Orange,2010,181433,166688,14745,8.1
36,73,Orleans,2010,19174,17299,1875,9.8
36,75,Oswego,2010,58976,52573,6403,10.9
36,77,Otsego,2010,31907,29443,2464,7.7
36,79,Putnam,2010,52633,48765,3868,7.3
36,81,Queens,2010,1114830,1018207,96623,8.7
36,83,Rensselaer,2010,84679,77980,6699,7.9
36,85,Richmond,2010,218630,197881,20749,9.5
36,87,Rockland,2010,150109,138686,11423,7.6
36,89,St. Lawrence,2010,50019,44765,5254,10.5
36,91,Saratoga,2010,118131,109818,8313,7.0
36,93,Schenectady,2010,79085,72913,6172,7.8
36,95,Schoharie,2010,15942,14492,1450,9.1
36,97,Schuyler,2010,9053,8213,840,9.3
36,99,Seneca,2010,16439,15065,1374,8.4
36,101,Steuben,2010,47365,42744,4621,9.8
36,103,Suffolk,2010,778551,716989,61562,7.9
36,105,Sullivan,2010,36509,33196,3313,9.1
36,107,Tioga,2010,26588,24427,2161,8.1
36,109,Tompkins,2010,54798,51355,3443,6.3
36,111,Ulster,2010,93679,86236,7443,7.9
36,113,Warren,2010,34192,31054,3138,9.2
36,115,Washington,2010,30265,27716,2549,8.4
36,117,Wayne,2010,47452,43191,4261,9.0
36,119,Westchester,2010,479056,443099,35957,7.5
36,121,Wyoming,2010,19470,17601,1869,9.6
36,123,Yates,2010,12239,11317,922,7.5
37,1,Alamance,2010,77083,68786,8297,10.8
37,3,Alexander,2010,18322,15955,2367,12.9
37,5,Alleghany,2010,4764,4199,565,11.9
37,7,Anson,2010,11217,9649,1568,14.0
37,9,Ashe,2010,13771,12159,1612,11.7
37,11,Avery,2010,7974,7124,850,10.7
37,13,Beaufort,2010,21252,18783,2469,11.6
37,15,Bertie,2010,9225,8148,1077,11.7
37,17,Bladen,2010,15244,13233,2011,13.2
37,19,Brunswick,2010,46692,40898,5794,12.4
37,21,Buncombe,2010,124191,113649,10542,8.5
37,23,Burke,2010,41829,36483,5346,12.8
37,25,Cabarrus,2010,89365,79159,10206,11.4
37,27,Caldwell,2010,38334,32701,5633,14.7
37,29,Camden,2010,4612,4230,382,8.3
37,31,Carteret,2010,31496,28511,2985,9.5
37,33,Caswell,2010,10102,8779,1323,13.1
37,35,Catawba,2010,78163,68058,10105,12.9
37,37,Chatham,2010,30780,28176,2604,8.5
37,39,Cherokee,2010,11694,10200,1494,12.8
37,41,Chowan,2010,6173,5440,733,11.9
37,43,Clay,2010,4257,3730,527,12.4
37,45,Cleveland,2010,45779,39084,6695,14.6
37,47,Columbus,2010,24265,21046,3219,13.3
37,49,Craven,2010,42438,37928,4510,10.6
37,51,Cumberland,2010,131605,118405,13200,10.0
37,53,Currituck,2010,12236,11158,1078,8.8
37,55,Dare,2010,19761,17382,2379,12.0
37,57,Davidson,2010,80902,71050,9852,12.2
37,59,Davie,2010,20338,17966,2372,11.7
37,61,Duplin,2010,25908,23531,2377,9.2
37,63,Durham,2010,143974,132237,11737,8.2
37,65,Edgecombe,2010,25579,21591,3988,15.6
37,67,Forsyth,2010,173644,156216,17428,10.0
37,69,Franklin,2010,28055,25029,3026,10.8
37,71,Gaston,2010,101585,87999,13586,13.4
37,73,Gates,2010,5481,5049,432,7.9
37,75,Graham,2010,3713,3067,646,17.4
37,77,Granville,2010,27483,24837,2646,9.6
37,79,Greene,2010,9464,8516,948,10.0
37,81,Guilford,2010,252937,225137,27800,11.0
37,83,Halifax,2010,22863,19530,3333,14.6
37,85,Harnett,2010,48948,43463,5485,11.2
37,87,Haywood,2010,27705,24883,2822,10.2
37,89,Henderson,2010,48487,44115,4372,9.0
37,91,Hertford,2010,9865,8830,1035,10.5
37,93,Hoke,2010,18649,16777,1872,10.0
37,95,Hyde,2010,2242,1996,246,11.0
37,97,Iredell,2010,78940,68868,10072,12.8
37,99,Jackson,2010,18503,16502,2001,10.8
37,101,Johnston,2010,82006,73951,8055,9.8
37,103,Jones,2010,4615,4103,512,11.1
37,105,Lee,2010,27188,23749,3439,12.6
37,107,Lenoir,2010,26968,23802,3166,11.7
37,109,Lincoln,2010,40121,35064,5057,12.6
37,111,McDowell,2010,20680,17952,2728,13.2
37,113,Macon,2010,15514,13745,1769,11.4
37,115,Madison,2010,9425,8456,969,10.3
37,117,Martin,2010,10519,9189,1330,12.6
37,119,Mecklenburg,2010,504346,451042,53304,10.6
37,121,Mitchell,2010,6831,5993,838,12.3
37,123,Montgomery,2010,11483,10081,1402,12.2
37,125,Moore,2010,36460,32810,3650,10.0
37,127,Nash,2010,47616,41699,5917,12.4
37,129,New Hanover,2010,107987,97615,10372,9.6
37,131,Northampton,2010,8733,7727,1006,11.5
37,133,Onslow,2010,63590,58387,5203,8.2
37,135,Orange,2010,70250,65665,4585,6.5
37,137,Pamlico,2010,5523,4966,557,10.1
37,139,Pasquotank,2010,18561,16739,1822,9.8
37,141,Pender,2010,24538,21756,2782,11.3
37,143,Perquimans,2010,5354,4790,564,10.5
37,145,Person,2010,18774,16466,2308,12.3
37,147,Pitt,2010,86234,77553,8681,10.1
37,149,Polk,2010,8593,7730,863,10.0
37,151,Randolph,2010,69669,61384,8285,11.9
37,153,Richmond,2010,18987,16192,2795,14.7
37,155,Robeson,2010,54029,46706,7323,13.6
37,157,Rockingham,2010,44359,38557,5802,13.1
37,159,Rowan,2010,64538,55548,8990,13.9
37,161,Rutherford,2010,27059,22574,4485,16.6
37,163,Sampson,2010,29675,26834,2841,9.6
37,165,Scotland,2010,13135,10842,2293,17.5
37,167,Stanly,2010,29162,25356,3806,13.1
37,169,Stokes,2010,22929,20343,2586,11.3
37,171,Surry,2010,34544,30438,4106,11.9
37,173,Swain,2010,6290,5371,919,14.6
37,175,Transylvania,2010,13856,12517,1339,9.7
37,177,Tyrrell,2010,1665,1421,244,14.7
37,179,Union,2010,101531,91462,10069,9.9
37,181,Vance,2010,19080,16412,2668,14.0
37,183,Wake,2010,482446,442867,39579,8.2
37,185,Warren,2010,7575,6546,1029,13.6
37,187,Washington,2010,5711,4904,807,14.1
37,189,Watauga,2010,26990,24894,2096,7.8
37,191,Wayne,2010,55030,50031,4999,9.1
37,193,Wilkes,2010,31185,27037,4148,13.3
37,195,Wilson,2010,38356,33079,5277,13.8
37,197,Yadkin,2010,18267,16282,1985,10.9
37,199,Yancey,2010,7837,6917,920,11.7
38,1,Adams,2010,1204,1170,34,2.8
38,3,Barnes,2010,6198,5927,271,4.4
38,5,Benson,2010,2919,2765,154,5.3
38,7,Billings,2010,426,413,13,3.1
38,9,Bottineau,2010,3403,3271,132,3.9
38,11,Bowman,2010,1775,1730,45,2.5
38,13,Burke,2010,1133,1102,31,2.7
38,15,Burleigh,2010,46427,44784,1643,3.5
38,17,Cass,2010,88997,85913,3084,3.5
38,19,Cavalier,2010,2265,2197,68,3.0
38,21,Dickey,2010,2862,2771,91,3.2
38,23,Divide,2010,1386,1358,28,2.0
38,25,Dunn,2010,2305,2233,72,3.1
38,27,Eddy,2010,1300,1239,61,4.7
38,29,Emmons,2010,1828,1705,123,6.7
38,31,Foster,2010,1806,1745,61,3.4
38,33,Golden Valley,2010,984,958,26,2.6
38,35,Grand Forks,2010,37939,36648,1291,3.4
38,37,Grant,2010,1426,1374,52,3.6
38,39,Griggs,2010,1323,1285,38,2.9
38,41,Hettinger,2010,1483,1438,45,3.0
38,43,Kidder,2010,1410,1337,73,5.2
38,45,LaMoure,2010,2485,2399,86,3.5
38,47,Logan,2010,1002,967,35,3.5
38,49,McHenry,2010,3288,3133,155,4.7
38,51,McIntosh,2010,1345,1287,58,4.3
38,53,McKenzie,2010,3594,3517,77,2.1
38,55,McLean,2010,5110,4857,253,5.0
38,57,Mercer,2010,4332,4109,223,5.1
38,59,Morton,2010,16021,15305,716,4.5
38,61,Mountrail,2010,5523,5381,142,2.6
38,63,Nelson,2010,1694,1627,67,4.0
38,65,Oliver,2010,928,876,52,5.6
38,67,Pembina,2010,4029,3778,251,6.2
38,69,Pierce,2010,2000,1896,104,5.2
38,71,Ramsey,2010,6053,5827,226,3.7
38,73,Ransom,2010,2861,2732,129,4.5
38,75,Renville,2010,1462,1422,40,2.7
38,77,Richland,2010,9077,8736,341,3.8
38,79,Rolette,2010,5295,4728,567,10.7
38,81,Sargent,2010,2050,1963,87,4.2
38,83,Sheridan,2010,812,781,31,3.8
38,85,Sioux,2010,1309,1244,65,5.0
38,87,Slope,2010,470,460,10,2.1
38,89,Stark,2010,14576,14180,396,2.7
38,91,Steele,2010,1103,1073,30,2.7
38,93,Stutsman,2010,11284,10826,458,4.1
38,95,Towner,2010,1399,1362,37,2.6
38,97,Traill,2010,4571,4405,166,3.6
38,99,Walsh,2010,6232,5921,311,5.0
38,101,Ward,2010,31588,30518,1070,3.4
38,103,Wells,2010,2333,2241,92,3.9
38,105,Williams,2010,14439,14129,310,2.1
39,1,Adams,2010,11899,9998,1901,16.0
39,3,Allen,2010,52085,46498,5587,10.7
39,5,Ashland,2010,26666,23489,3177,11.9
39,7,Ashtabula,2010,48478,42190,6288,13.0
39,9,Athens,2010,28676,25621,3055,10.7
39,11,Auglaize,2010,24596,22126,2470,10.0
39,13,Belmont,2010,33517,29717,3800,11.3
39,15,Brown,2010,21156,18337,2819,13.3
39,17,Butler,2010,191057,171808,19249,10.1
39,19,Carroll,2010,14393,12519,1874,13.0
39,21,Champaign,2010,20007,17694,2313,11.6
39,23,Clark,2010,68389,60809,7580,11.1
39,25,Clermont,2010,105031,94081,10950,10.4
39,27,Clinton,2010,19280,15992,3288,17.1
39,29,Columbiana,2010,52957,46274,6683,12.6
39,31,Coshocton,2010,17497,15278,2219,12.7
39,33,Crawford,2010,20992,18289,2703,12.9
39,35,Cuyahoga,2010,641986,586904,55082,8.6
39,37,Darke,2010,27089,24037,3052,11.3
39,39,Defiance,2010,19999,17560,2439,12.2
39,41,Delaware,2010,94360,87512,6848,7.3
39,43,Erie,2010,40234,35677,4557,11.3
39,45,Fairfield,2010,74397,67510,6887,9.3
39,47,Fayette,2010,14926,12966,1960,13.1
39,49,Franklin,2010,627864,571892,55972,8.9
39,51,Fulton,2010,23178,20430,2748,11.9
39,53,Gallia,2010,13606,11996,1610,11.8
39,55,Geauga,2010,49770,46323,3447,6.9
39,57,Greene,2010,82209,74344,7865,9.6
39,59,Guernsey,2010,18884,16472,2412,12.8
39,61,Hamilton,2010,414321,373434,40887,9.9
39,63,Hancock,2010,40514,36822,3692,9.1
39,65,Hardin,2010,15501,13762,1739,11.2
39,67,Harrison,2010,7251,6344,907,12.5
39,69,Henry,2010,14656,12740,1916,13.1
39,71,Highland,2010,19215,15888,3327,17.3
39,73,Hocking,2010,14062,12414,1648,11.7
39,75,Holmes,2010,19325,17841,1484,7.7
39,77,Huron,2010,30332,26322,4010,13.2
39,79,Jackson,2010,14324,12529,1795,12.5
39,81,Jefferson,2010,33385,28551,4834,14.5
39,83,Knox,2010,30962,27958,3004,9.7
39,85,Lake,2010,128330,118120,10210,8.0
39,87,Lawrence,2010,27745,24884,2861,10.3
39,89,Licking,2010,87674,79229,8445,9.6
39,91,Logan,2010,23380,20614,2766,11.8
39,93,Lorain,2010,153525,139440,14085,9.2
39,95,Lucas,2010,217735,192562,25173,11.6
39,97,Madison,2010,20699,18823,1876,9.1
39,99,Mahoning,2010,115263,101734,13529,11.7
39,101,Marion,2010,30301,26970,3331,11.0
39,103,Medina,2010,95541,88416,7125,7.5
39,105,Meigs,2010,10065,8590,1475,14.7
39,107,Mercer,2010,22358,20460,1898,8.5
39,109,Miami,2010,54478,48423,6055,11.1
39,111,Monroe,2010,6686,5865,821,12.3
39,113,Montgomery,2010,265741,235489,30252,11.4
39,115,Morgan,2010,6876,5957,919,13.4
39,117,Morrow,2010,17338,15352,1986,11.5
39,119,Muskingum,2010,41717,36461,5256,12.6
39,121,Noble,2010,5230,4392,838,16.0
39,123,Ottawa,2010,22711,19906,2805,12.4
39,125,Paulding,2010,9710,8487,1223,12.6
39,127,Perry,2010,16670,14431,2239,13.4
39,129,Pickaway,2010,26143,23366,2777,10.6
39,131,Pike,2010,11604,9881,1723,14.8
39,133,Portage,2010,90869,81455,9414,10.4
39,135,Preble,2010,22415,19941,2474,11.0
39,137,Putnam,2010,19362,17552,1810,9.3
39,139,Richland,2010,59163,51970,7193,12.2
39,141,Ross,2010,34133,30052,4081,12.0
39,143,Sandusky,2010,33253,29663,3590,10.8
39,145,Scioto,2010,32655,28294,4361,13.4
39,147,Seneca,2010,29503,25974,3529,12.0
39,149,Shelby,2010,25007,21892,3115,12.5
39,151,Stark,2010,192248,170423,21825,11.4
39,153,Summit,2010,281921,251986,29935,10.6
39,155,Trumbull,2010,99980,86729,13251,13.3
39,157,Tuscarawas,2010,46160,40939,5221,11.3
39,159,Union,2010,26706,24451,2255,8.4
39,161,Van Wert,2010,14974,13162,1812,12.1
39,163,Vinton,2010,5805,5021,784,13.5
39,165,Warren,2010,110296,100309,9987,9.1
39,167,Washington,2010,29845,26429,3416,11.4
39,169,Wayne,2010,60232,54612,5620,9.3
39,171,Williams,2010,19567,16988,2579,13.2
39,173,Wood,2010,68646,61828,6818,9.9
39,175,Wyandot,2010,12195,10837,1358,11.1
40,1,Adair,2010,8873,7980,893,10.1
40,3,Alfalfa,2010,2495,2378,117,4.7
40,5,Atoka,2010,5099,4608,491,9.6
40,7,Beaver,2010,2889,2779,110,3.8
40,9,Beckham,2010,10330,9757,573,5.5
40,11,Blaine,2010,4467,4192,275,6.2
40,13,Bryan,2010,18483,17387,1096,5.9
40,15,Caddo,2010,11816,11028,788,6.7
40,17,Canadian,2010,60041,57066,2975,5.0
40,19,Carter,2010,21156,19711,1445,6.8
40,21,Cherokee,2010,19431,18001,1430,7.4
40,23,Choctaw,2010,6109,5574,535,8.8
40,25,Cimarron,2010,1457,1408,49,3.4
40,27,Cleveland,2010,131026,124374,6652,5.1
40,29,Coal,2010,2289,2088,201,8.8
40,31,Comanche,2010,51446,48604,2842,5.5
40,33,Cotton,2010,3005,2812,193,6.4
40,35,Craig,2010,6583,6159,424,6.4
40,37,Creek,2010,31722,29118,2604,8.2
40,39,Custer,2010,14146,13446,700,4.9
40,41,Delaware,2010,17149,15833,1316,7.7
40,43,Dewey,2010,2308,2192,116,5.0
40,45,Ellis,2010,2060,1954,106,5.1
40,47,Garfield,2010,28495,26986,1509,5.3
40,49,Garvin,2010,12143,11264,879,7.2
40,51,Grady,2010,25352,23775,1577,6.2
40,53,Grant,2010,2572,2461,111,4.3
40,55,Greer,2010,2187,2026,161,7.4
40,57,Harmon,2010,1313,1239,74,5.6
40,59,Harper,2010,1865,1784,81,4.3
40,61,Haskell,2010,4777,4328,449,9.4
40,63,Hughes,2010,5554,4971,583,10.5
40,65,Jackson,2010,11453,10802,651,5.7
40,67,Jefferson,2010,2677,2483,194,7.2
40,69,Johnston,2010,3736,3364,372,10.0
40,71,Kay,2010,20887,19034,1853,8.9
40,73,Kingfisher,2010,7375,7016,359,4.9
40,75,Kiowa,2010,4312,4062,250,5.8
40,77,Latimer,2010,4562,4121,441,9.7
40,79,Le Flore,2010,20690,18831,1859,9.0
40,81,Lincoln,2010,15636,14656,980,6.3
40,83,Logan,2010,19787,18711,1076,5.4
40,85,Love,2010,4768,4507,261,5.5
40,87,McClain,2010,17165,16246,919,5.4
40,89,McCurtain,2010,14495,12901,1594,11.0
40,91,McIntosh,2010,7378,6602,776,10.5
40,93,Major,2010,3938,3748,190,4.8
40,95,Marshall,2010,6500,6051,449,6.9
40,97,Mayes,2010,18069,16540,1529,8.5
40,99,Murray,2010,6312,5937,375,5.9
40,101,Muskogee,2010,29804,27450,2354,7.9
40,103,Noble,2010,5243,4901,342,6.5
40,105,Nowata,2010,4889,4456,433,8.9
40,107,Okfuskee,2010,4341,3934,407,9.4
40,109,Oklahoma,2010,353861,332961,20900,5.9
40,111,Okmulgee,2010,16839,15257,1582,9.4
40,113,Osage,2010,21202,19629,1573,7.4
40,115,Ottawa,2010,14533,13405,1128,7.8
40,117,Pawnee,2010,7656,6985,671,8.8
40,119,Payne,2010,36838,34808,2030,5.5
40,121,Pittsburg,2010,18892,17410,1482,7.8
40,123,Pontotoc,2010,17713,16661,1052,5.9
40,125,Pottawatomie,2010,30953,28886,2067,6.7
40,127,Pushmataha,2010,4972,4502,470,9.5
40,129,Roger Mills,2010,1796,1717,79,4.4
40,131,Rogers,2010,43313,40460,2853,6.6
40,133,Seminole,2010,9897,8987,910,9.2
40,135,Sequoyah,2010,18033,16387,1646,9.1
40,137,Stephens,2010,19935,18446,1489,7.5
40,139,Texas,2010,8595,8193,402,4.7
40,141,Tillman,2010,3402,3199,203,6.0
40,143,Tulsa,2010,306216,285527,20689,6.8
40,145,Wagoner,2010,35217,32924,2293,6.5
40,147,Washington,2010,24109,22554,1555,6.4
40,149,Washita,2010,5453,5134,319,5.8
40,151,Woods,2010,4287,4113,174,4.1
40,153,Woodward,2010,9343,8723,620,6.6
41,1,Baker,2010,7389,6625,764,10.3
41,3,Benton,2010,45229,41990,3239,7.2
41,5,Clackamas,2010,203414,182789,20625,10.1
41,7,Clatsop,2010,19149,17222,1927,10.1
41,9,Columbia,2010,23744,20657,3087,13.0
41,11,Coos,2010,27851,24282,3569,12.8
41,13,Crook,2010,9623,8078,1545,16.1
41,15,Curry,2010,9432,8232,1200,12.7
41,17,Deschutes,2010,81567,70190,11377,13.9
41,19,Douglas,2010,48075,41299,6776,14.1
41,21,Gilliam,2010,963,875,88,9.1
41,23,Grant,2010,3411,2941,470,13.8
41,25,Harney,2010,3851,3299,552,14.3
41,27,Hood River,2010,14246,13058,1188,8.3
41,29,Jackson,2010,101368,88638,12730,12.6
41,31,Jefferson,2010,9668,8337,1331,13.8
41,33,Josephine,2010,34633,29735,4898,14.1
41,35,Klamath,2010,31345,27262,4083,13.0
41,37,Lake,2010,3735,3228,507,13.6
41,39,Lane,2010,178988,159101,19887,11.1
41,41,Lincoln,2010,22207,19734,2473,11.1
41,43,Linn,2010,57300,49890,7410,12.9
41,45,Malheur,2010,13521,12206,1315,9.7
41,47,Marion,2010,155893,138412,17481,11.2
41,49,Morrow,2010,5748,5208,540,9.4
41,51,Multnomah,2010,420658,379568,41090,9.8
41,53,Polk,2010,36523,32940,3583,9.8
41,55,Sherman,2010,909,801,108,11.9
41,57,Tillamook,2010,11814,10568,1246,10.5
41,59,Umatilla,2010,36828,33008,3820,10.4
41,61,Union,2010,12534,11228,1306,10.4
41,63,Wallowa,2010,3518,3062,456,13.0
41,65,Wasco,2010,13734,12410,1324,9.6
41,67,Washington,2010,290691,264444,26247,9.0
41,69,Wheeler,2010,779,704,75,9.6
41,71,Yamhill,2010,51413,46014,5399,10.5
42,1,Adams,2010,54433,50354,4079,7.5
42,3,Allegheny,2010,634197,587633,46564,7.3
42,5,Armstrong,2010,33522,30565,2957,8.8
42,7,Beaver,2010,85349,78228,7121,8.3
42,9,Bedford,2010,25273,22800,2473,9.8
42,11,Berks,2010,209477,191835,17642,8.4
42,13,Blair,2010,61584,56807,4777,7.8
42,15,Bradford,2010,30731,28578,2153,7.0
42,17,Bucks,2010,336119,311287,24832,7.4
42,19,Butler,2010,95503,88686,6817,7.1
42,21,Cambria,2010,66525,60435,6090,9.2
42,23,Cameron,2010,2544,2232,312,12.3
42,25,Carbon,2010,31667,28417,3250,10.3
42,27,Centre,2010,77150,72708,4442,5.8
42,29,Chester,2010,268854,252589,16265,6.0
42,31,Clarion,2010,19508,17564,1944,10.0
42,33,Clearfield,2010,37933,34087,3846,10.1
42,35,Clinton,2010,18682,16980,1702,9.1
42,37,Columbia,2010,34620,31483,3137,9.1
42,39,Crawford,2010,41546,37732,3814,9.2
42,41,Cumberland,2010,124102,115889,8213,6.6
42,43,Dauphin,2010,140162,129234,10928,7.8
42,45,Delaware,2010,285260,263173,22087,7.7
42,47,Elk,2010,16624,15068,1556,9.4
42,49,Erie,2010,135877,123620,12257,9.0
42,51,Fayette,2010,59315,53111,6204,10.5
42,53,Forest,2010,2145,1910,235,11.0
42,55,Franklin,2010,75482,69227,6255,8.3
42,57,Fulton,2010,7401,6519,882,11.9
42,59,Greene,2010,17356,15947,1409,8.1
42,61,Huntingdon,2010,21034,18844,2190,10.4
42,63,Indiana,2010,43936,40233,3703,8.4
42,65,Jefferson,2010,21526,19421,2105,9.8
42,67,Juniata,2010,12050,11121,929,7.7
42,69,Lackawanna,2010,106644,97365,9279,8.7
42,71,Lancaster,2010,267223,247816,19407,7.3
42,73,Lawrence,2010,42983,39136,3847,9.0
42,75,Lebanon,2010,69857,64798,5059,7.2
42,77,Lehigh,2010,176593,160849,15744,8.9
42,79,Luzerne,2010,159212,143804,15408,9.7
42,81,Lycoming,2010,59284,54149,5135,8.7
42,83,McKean,2010,19979,18024,1955,9.8
42,85,Mercer,2010,53432,48497,4935,9.2
42,87,Mifflin,2010,21186,19079,2107,9.9
42,89,Monroe,2010,82414,74649,7765,9.4
42,91,Montgomery,2010,429193,400319,28874,6.7
42,93,Montour,2010,9055,8465,590,6.5
42,95,Northampton,2010,151401,138498,12903,8.5
42,97,Northumberland,2010,45204,40841,4363,9.7
42,99,Perry,2010,24908,22955,1953,7.8
42,101,Philadelphia/city,2010,685108,614806,70302,10.3
42,103,Pike,2010,26038,23585,2453,9.4
42,105,Potter,2010,7773,6988,785,10.1
42,107,Schuylkill,2010,70418,63170,7248,10.3
42,109,Snyder,2010,20045,18416,1629,8.1
42,111,Somerset,2010,37019,33580,3439,9.3
42,113,Sullivan,2010,2952,2722,230,7.8
42,115,Susquehanna,2010,21552,19729,1823,8.5
42,117,Tioga,2010,20127,18508,1619,8.0
42,119,Union,2010,19138,17704,1434,7.5
42,121,Venango,2010,26341,24172,2169,8.2
42,123,Warren,2010,20830,19162,1668,8.0
42,125,Washington,2010,104964,96722,8242,7.9
42,127,Wayne,2010,23541,21690,1851,7.9
42,129,Westmoreland,2010,184724,169950,14774,8.0
42,131,Wyoming,2010,14287,13072,1215,8.5
42,133,York,2010,229698,210966,18732,8.2
44,1,Bristol,2010,27168,24421,2747,10.1
44,3,Kent,2010,95049,84080,10969,11.5
44,5,Newport,2010,45416,40701,4715,10.4
44,7,Providence,2010,331761,291193,40568,12.2
44,9,Washington,2010,72112,64562,7550,10.5
45,1,Abbeville,2010,11026,9506,1520,13.8
45,3,Aiken,2010,72970,66098,6872,9.4
45,5,Allendale,2010,3352,2704,648,19.3
45,7,Anderson,2010,85992,75908,10084,11.7
45,9,Bamberg,2010,6573,5499,1074,16.3
45,11,Barnwell,2010,9582,7969,1613,16.8
45,13,Beaufort,2010,65881,60100,5781,8.8
45,15,Berkeley,2010,83455,74974,8481,10.2
45,17,Calhoun,2010,7108,6221,887,12.5
45,19,Charleston,2010,180349,164252,16097,8.9
45,21,Cherokee,2010,23910,20096,3814,16.0
45,23,Chester,2010,14837,11943,2894,19.5
45,25,Chesterfield,2010,21487,18356,3131,14.6
45,27,Clarendon,2010,14010,12020,1990,14.2
45,29,Colleton,2010,16983,14614,2369,13.9
45,31,Darlington,2010,30872,26741,4131,13.4
45,33,Dillon,2010,14148,11865,2283,16.1
45,35,Dorchester,2010,66125,59736,6389,9.7
45,37,Edgefield,2010,11081,9962,1119,10.1
45,39,Fairfield,2010,10773,9177,1596,14.8
45,41,Florence,2010,64740,57303,7437,11.5
45,43,Georgetown,2010,26289,22427,3862,14.7
45,45,Greenville,2010,222091,200398,21693,9.8
45,47,Greenwood,2010,32154,28288,3866,12.0
45,49,Hampton,2010,8865,7713,1152,13.0
45,51,Horry,2010,132121,115661,16460,12.5
45,53,Jasper,2010,10990,9892,1098,10.0
45,55,Kershaw,2010,28384,25072,3312,11.7
45,57,Lancaster,2010,34271,29158,5113,14.9
45,59,Laurens,2010,30465,26667,3798,12.5
45,61,Lee,2010,7021,5867,1154,16.4
45,63,Lexington,2010,134049,122886,11163,8.3
45,65,McCormick,2010,3658,3137,521,14.2
45,67,Marion,2010,14552,11857,2695,18.5
45,69,Marlboro,2010,10983,8626,2357,21.5
45,71,Newberry,2010,18738,16687,2051,10.9
45,73,Oconee,2010,33610,29729,3881,11.5
45,75,Orangeburg,2010,40490,33958,6532,16.1
45,77,Pickens,2010,54910,48849,6061,11.0
45,79,Richland,2010,186378,168729,17649,9.5
45,81,Saluda,2010,8759,7868,891,10.2
45,83,Spartanburg,2010,133003,117019,15984,12.0
45,85,Sumter,2010,44822,39159,5663,12.6
45,87,Union,2010,12514,10273,2241,17.9
45,89,Williamsburg,2010,13483,11126,2357,17.5
45,91,York,2010,116684,102355,14329,12.3
46,3,Aurora,2010,1685,1627,58,3.4
46,5,Beadle,2010,9477,9086,391,4.1
46,7,Bennett,2010,1201,1115,86,7.2
46,9,Bon Homme,2010,3206,3073,133,4.1
46,11,Brookings,2010,17941,17113,828,4.6
46,13,Brown,2010,20994,20196,798,3.8
46,15,Brule,2010,2748,2647,101,3.7
46,17,Buffalo,2010,695,618,77,11.1
46,19,Butte,2010,5136,4879,257,5.0
46,21,Campbell,2010,912,873,39,4.3
46,23,Charles Mix,2010,4166,3964,202,4.8
46,25,Clark,2010,1986,1885,101,5.1
46,27,Clay,2010,7427,7117,310,4.2
46,29,Codington,2010,15128,14356,772,5.1
46,31,Corson,2010,1550,1443,107,6.9
46,33,Custer,2010,4089,3854,235,5.7
46,35,Davison,2010,10978,10499,479,4.4
46,37,Day,2010,3088,2885,203,6.6
46,39,Deuel,2010,2489,2324,165,6.6
46,41,Dewey,2010,2367,2018,349,14.7
46,43,Douglas,2010,1770,1693,77,4.4
46,45,Edmunds,2010,2396,2323,73,3.0
46,47,Fall River,2010,3277,3077,200,6.1
46,49,Faulk,2010,1180,1134,46,3.9
46,51,Grant,2010,4821,4600,221,4.6
46,53,Gregory,2010,2192,2098,94,4.3
46,55,Haakon,2010,1129,1091,38,3.4
46,57,Hamlin,2010,3149,2994,155,4.9
46,59,Hand,2010,1914,1852,62,3.2
46,61,Hanson,2010,1777,1685,92,5.2
46,63,Harding,2010,801,773,28,3.5
46,65,Hughes,2010,10104,9758,346,3.4
46,67,Hutchinson,2010,3824,3673,151,3.9
46,69,Hyde,2010,799,769,30,3.8
46,71,Jackson,2010,1399,1305,94,6.7
46,73,Jerauld,2010,1204,1161,43,3.6
46,75,Jones,2010,681,661,20,2.9
46,77,Kingsbury,2010,2882,2729,153,5.3
46,79,Lake,2010,6189,5844,345,5.6
46,81,Lawrence,2010,13224,12607,617,4.7
46,83,Lincoln,2010,26457,25435,1022,3.9
46,85,Lyman,2010,1957,1832,125,6.4
46,87,McCook,2010,3257,3099,158,4.9
46,89,McPherson,2010,1214,1155,59,4.9
46,91,Marshall,2010,2479,2348,131,5.3
46,93,Meade,2010,13215,12530,685,5.2
46,95,Mellette,2010,877,822,55,6.3
46,97,Miner,2010,1379,1310,69,5.0
46,99,Minnehaha,2010,99686,94792,4894,4.9
46,101,Moody,2010,4175,3886,289,6.9
46,102,Oglala Lakota,2010,3731,3253,478,12.8
46,103,Pennington,2010,53112,50376,2736,5.2
46,105,Perkins,2010,1620,1554,66,4.1
46,107,Potter,2010,1282,1221,61,4.8
46,109,Roberts,2010,5075,4785,290,5.7
46,111,Sanborn,2010,1353,1297,56,4.1
46,115,Spink,2010,3609,3476,133,3.7
46,117,Stanley,2010,1965,1892,73,3.7
46,119,Sully,2010,891,859,32,3.6
46,121,Todd,2010,3403,3145,258,7.6
46,123,Tripp,2010,3302,3184,118,3.6
46,125,Turner,2010,4875,4656,219,4.5
46,127,Union,2010,7782,7338,444,5.7
46,129,Walworth,2010,2404,2242,162,6.7
46,135,Yankton,2010,11487,10932,555,4.8
46,137,Ziebach,2010,1060,999,61,5.8
47,1,Anderson,2010,34950,31642,3308,9.5
47,3,Bedford,2010,21113,18417,2696,12.8
47,5,Benton,2010,7210,6308,902,12.5
47,7,Bledsoe,2010,4477,3875,602,13.4
47,9,Blount,2010,61439,55766,5673,9.2
47,11,Bradley,2010,46481,42041,4440,9.6
47,13,Campbell,2010,16153,14100,2053,12.7
47,15,Cannon,2010,6089,5399,690,11.3
47,17,Carroll,2010,13861,11800,2061,14.9
47,19,Carter,2010,26253,23334,2919,11.1
47,21,Cheatham,2010,20221,18380,1841,9.1
47,23,Chester,2010,8370,7521,849,10.1
47,25,Claiborne,2010,13633,12136,1497,11.0
47,27,Clay,2010,3317,2909,408,12.3
47,29,Cocke,2010,15904,13702,2202,13.8
47,31,Coffee,2010,24290,21624,2666,11.0
47,33,Crockett,2010,7287,6428,859,11.8
47,35,Cumberland,2010,23106,20583,2523,10.9
47,37,Davidson,2010,342568,314127,28441,8.3
47,39,Decatur,2010,5306,4598,708,13.3
47,41,DeKalb,2010,8169,7198,971,11.9
47,43,Dickson,2010,23981,21488,2493,10.4
47,45,Dyer,2010,17852,15659,2193,12.3
47,47,Fayette,2010,18845,16941,1904,10.1
47,49,Fentress,2010,7417,6482,935,12.6
47,51,Franklin,2010,19324,17338,1986,10.3
47,53,Gibson,2010,23773,20868,2905,12.2
47,55,Giles,2010,14262,12512,1750,12.3
47,57,Grainger,2010,10054,8751,1303,13.0
47,59,Greene,2010,31031,26983,4048,13.0
47,61,Grundy,2010,5643,4918,725,12.8
47,63,Hamblen,2010,28438,25093,3345,11.8
47,65,Hamilton,2010,169124,154795,14329,8.5
47,67,Hancock,2010,2580,2165,415,16.1
47,69,Hardeman,2010,10366,8972,1394,13.4
47,71,Hardin,2010,11444,10043,1401,12.2
47,73,Hawkins,2010,25587,22757,2830,11.1
47,75,Haywood,2010,8978,7554,1424,15.9
47,77,Henderson,2010,13018,11133,1885,14.5
47,79,Henry,2010,14483,12806,1677,11.6
47,81,Hickman,2010,10993,9747,1246,11.3
47,83,Houston,2010,3540,3109,431,12.2
47,85,Humphreys,2010,8892,7881,1011,11.4
47,87,Jackson,2010,4795,4180,615,12.8
47,89,Jefferson,2010,24442,21589,2853,11.7
47,91,Johnson,2010,7456,6484,972,13.0
47,93,Knox,2010,229895,212529,17366,7.6
47,95,Lake,2010,2177,1932,245,11.3
47,97,Lauderdale,2010,10800,9241,1559,14.4
47,99,Lawrence,2010,19366,16944,2422,12.5
47,101,Lewis,2010,5418,4591,827,15.3
47,103,Lincoln,2010,15710,14566,1144,7.3
47,105,Loudon,2010,22372,20259,2113,9.4
47,107,McMinn,2010,22871,19957,2914,12.7
47,109,McNairy,2010,10513,9140,1373,13.1
47,111,Macon,2010,10256,9085,1171,11.4
47,113,Madison,2010,48244,43316,4928,10.2
47,115,Marion,2010,12556,11133,1423,11.3
47,117,Marshall,2010,14424,12369,2055,14.2
47,119,Maury,2010,41524,36334,5190,12.5
47,121,Meigs,2010,4979,4316,663,13.3
47,123,Monroe,2010,19520,16996,2524,12.9
47,125,Montgomery,2010,75676,69106,6570,8.7
47,127,Moore,2010,3258,2996,262,8.0
47,129,Morgan,2010,8413,7440,973,11.6
47,131,Obion,2010,15561,14036,1525,9.8
47,133,Overton,2010,10255,9141,1114,10.9
47,135,Perry,2010,3169,2735,434,13.7
47,137,Pickett,2010,2410,2137,273,11.3
47,139,Polk,2010,7344,6507,837,11.4
47,141,Putnam,2010,34037,30785,3252,9.6
47,143,Rhea,2010,13580,11879,1701,12.5
47,145,Roane,2010,24340,22065,2275,9.3
47,147,Robertson,2010,33789,30620,3169,9.4
47,149,Rutherford,2010,140300,127659,12641,9.0
47,151,Scott,2010,9275,7671,1604,17.3
47,153,Sequatchie,2010,6108,5358,750,12.3
47,155,Sevier,2010,49116,43917,5199,10.6
47,157,Shelby,2010,449117,404611,44506,9.9
47,159,Smith,2010,8945,7829,1116,12.5
47,161,Stewart,2010,5677,4961,716,12.6
47,163,Sullivan,2010,73678,66902,6776,9.2
47,165,Sumner,2010,83281,75786,7495,9.0
47,167,Tipton,2010,29087,25733,3354,11.5
47,169,Trousdale,2010,3746,3332,414,11.1
47,171,Unicoi,2010,7929,6966,963,12.1
47,173,Union,2010,7770,6920,850,10.9
47,175,Van Buren,2010,2345,2031,314,13.4
47,177,Warren,2010,17769,15798,1971,11.1
47,179,Washington,2010,60716,55334,5382,8.9
47,181,Wayne,2010,6942,6137,805,11.6
47,183,Weakley,2010,16950,15056,1894,11.2
47,185,White,2010,12344,11024,1320,10.7
47,187,Williamson,2010,94512,88189,6323,6.7
47,189,Wilson,2010,58550,53558,4992,8.5
48,1,Anderson,2010,21744,19975,1769,8.1
48,3,Andrews,2010,7130,6687,443,6.2
48,5,Angelina,2010,38119,34858,3261,8.6
48,7,Aransas,2010,9701,8805,896,9.2
48,9,Archer,2010,4607,4299,308,6.7
48,11,Armstrong,2010,1013,963,50,4.9
48,13,Atascosa,2010,19661,18047,1614,8.2
48,15,Austin,2010,13939,12813,1126,8.1
48,17,Bailey,2010,3262,3004,258,7.9
48,19,Bandera,2010,9188,8468,720,7.8
48,21,Bastrop,2010,35338,32413,2925,8.3
48,23,Baylor,2010,1736,1613,123,7.1
48,25,Bee,2010,10543,9592,951,9.0
48,27,Bell,2010,132031,121787,10244,7.8
48,29,Bexar,2010,813648,754040,59608,7.3
48,31,Blanco,2010,5426,5101,325,6.0
48,33,Borden,2010,359,335,24,6.7
48,35,Bosque,2010,8462,7714,748,8.8
48,37,Bowie,2010,42269,38685,3584,8.5
48,39,Brazoria,2010,155443,142179,13264,8.5
48,41,Brazos,2010,100145,93813,6332,6.3
48,43,Brewster,2010,4919,4649,270,5.5
48,45,Briscoe,2010,735,690,45,6.1
48,47,Brooks,2010,2597,2285,312,12.0
48,49,Brown,2010,16457,15098,1359,8.3
48,51,Burleson,2010,7881,7258,623,7.9
48,53,Burnet,2010,20316,18933,1383,6.8
48,55,Caldwell,2010,16684,15239,1445,8.7
48,57,Calhoun,2010,10196,9294,902,8.8
48,59,Callahan,2010,6010,5572,438,7.3
48,61,Cameron,2010,162522,144310,18212,11.2
48,63,Camp,2010,5709,5186,523,9.2
48,65,Carson,2010,3356,3173,183,5.5
48,67,Cass,2010,13358,11855,1503,11.3
48,69,Castro,2010,4143,3919,224,5.4
48,71,Chambers,2010,16632,15013,1619,9.7
48,73,Cherokee,2010,21925,19980,1945,8.9
48,75,Childress,2010,3162,2982,180,5.7
48,77,Clay,2010,5546,5129,417,7.5
48,79,Cochran,2010,1526,1401,125,8.2
48,81,Coke,2010,1576,1480,96,6.1
48,83,Coleman,2010,3488,3171,317,9.1
48,85,Collin,2010,425945,394975,30970,7.3
48,87,Collingsworth,2010,1342,1267,75,5.6
48,89,Colorado,2010,9610,8824,786,8.2
48,91,Comal,2010,53559,49771,3788,7.1
48,93,Comanche,2010,6033,5575,458,7.6
48,95,Concho,2010,1568,1477,91,5.8
48,97,Cooke,2010,19568,18137,1431,7.3
48,99,Coryell,2010,25372,23464,1908,7.5
48,101,Cottle,2010,669,622,47,7.0
48,103,Crane,2010,1822,1682,140,7.7
48,105,Crockett,2010,1725,1576,149,8.6
48,107,Crosby,2010,2955,2718,237,8.0
48,109,Culberson,2010,1034,960,74,7.2
48,111,Dallam,2010,3885,3677,208,5.4
48,113,Dallas,2010,1195683,1092540,103143,8.6
48,115,Dawson,2010,5143,4746,397,7.7
48,117,Deaf Smith,2010,9515,8965,550,5.8
48,119,Delta,2010,2601,2394,207,8.0
48,121,Denton,2010,369649,343301,26348,7.1
48,123,DeWitt,2010,9089,8379,710,7.8
48,125,Dickens,2010,873,774,99,11.3
48,127,Dimmit,2010,3861,3453,408,10.6
48,129,Donley,2010,1811,1686,125,6.9
48,131,Duval,2010,5047,4457,590,11.7
48,133,Eastland,2010,8124,7419,705,8.7
48,135,Ector,2010,68321,62584,5737,8.4
48,137,Edwards,2010,1038,964,74,7.1
48,139,Ellis,2010,75778,69678,6100,8.0
48,141,El Paso,2010,341489,309927,31562,9.2
48,143,Erath,2010,20527,19197,1330,6.5
48,145,Falls,2010,7254,6633,621,8.6
48,147,Fannin,2010,15368,14106,1262,8.2
48,149,Fayette,2010,12044,11305,739,6.1
48,151,Fisher,2010,1928,1792,136,7.1
48,153,Floyd,2010,3377,3108,269,8.0
48,155,Foard,2010,664,619,45,6.8
48,157,Fort Bend,2010,298655,275718,22937,7.7
48,159,Franklin,2010,4818,4401,417,8.7
48,161,Freestone,2010,8161,7485,676,8.3
48,163,Frio,2010,7595,7038,557,7.3
48,165,Gaines,2010,7945,7471,474,6.0
48,167,Galveston,2010,147531,133996,13535,9.2
48,169,Garza,2010,2146,2019,127,5.9
48,171,Gillespie,2010,12214,11544,670,5.5
48,173,Glasscock,2010,705,670,35,5.0
48,175,Goliad,2010,3361,3111,250,7.4
48,177,Gonzales,2010,9316,8678,638,6.8
48,179,Gray,2010,9299,8493,806,8.7
48,181,Grayson,2010,59571,54673,4898,8.2
48,183,Gregg,2010,60467,55621,4846,8.0
48,185,Grimes,2010,11349,10322,1027,9.0
48,187,Guadalupe,2010,65009,60619,4390,6.8
48,189,Hale,2010,16201,14996,1205,7.4
48,191,Hall,2010,1423,1293,130,9.1
48,193,Hamilton,2010,3945,3675,270,6.8
48,195,Hansford,2010,3034,2902,132,4.4
48,197,Hardeman,2010,1944,1781,163,8.4
48,199,Hardin,2010,25901,23305,2596,10.0
48,201,Harris,2010,2067209,1894670,172539,8.3
48,203,Harrison,2010,30878,27961,2917,9.4
48,205,Hartley,2010,2698,2586,112,4.2
48,207,Haskell,2010,2998,2834,164,5.5
48,209,Hays,2010,80494,74809,5685,7.1
48,211,Hemphill,2010,2132,2048,84,3.9
48,213,Henderson,2010,34802,31722,3080,8.9
48,215,Hidalgo,2010,318793,281155,37638,11.8
48,217,Hill,2010,15962,14618,1344,8.4
48,219,Hockley,2010,11046,10261,785,7.1
48,221,Hood,2010,23390,21384,2006,8.6
48,223,Hopkins,2010,16647,15401,1246,7.5
48,225,Houston,2010,10552,9739,813,7.7
48,227,Howard,2010,13244,12287,957,7.2
48,229,Hudspeth,2010,1415,1302,113,8.0
48,231,Hunt,2010,38184,34765,3419,9.0
48,233,Hutchinson,2010,9723,8895,828,8.5
48,235,Irion,2010,874,828,46,5.3
48,237,Jack,2010,3669,3380,289,7.9
48,239,Jackson,2010,7141,6635,506,7.1
48,241,Jasper,2010,14864,13017,1847,12.4
48,243,Jeff Davis,2010,1274,1211,63,4.9
48,245,Jefferson,2010,113365,100468,12897,11.4
48,247,Jim Hogg,2010,2332,2091,241,10.3
48,249,Jim Wells,2010,18292,16453,1839,10.1
48,251,Johnson,2010,72051,65766,6285,8.7
48,253,Jones,2010,6169,5626,543,8.8
48,255,Karnes,2010,4878,4431,447,9.2
48,257,Kaufman,2010,50877,46540,4337,8.5
48,259,Kendall,2010,16433,15406,1027,6.2
48,261,Kenedy,2010,220,205,15,6.8
48,263,Kent,2010,559,532,27,4.8
48,265,Kerr,2010,21948,20477,1471,6.7
48,267,Kimble,2010,2279,2142,137,6.0
48,269,King,2010,279,267,12,4.3
48,271,Kinney,2010,1272,1129,143,11.2
48,273,Kleberg,2010,15055,13787,1268,8.4
48,275,Knox,2010,1912,1799,113,5.9
48,277,Lamar,2010,23334,21156,2178,9.3
48,279,Lamb,2010,6806,6289,517,7.6
48,281,Lampasas,2010,9032,8387,645,7.1
48,283,La Salle,2010,2728,2481,247,9.1
48,285,Lavaca,2010,9715,9041,674,6.9
48,287,Lee,2010,8237,7637,600,7.3
48,289,Leon,2010,7275,6626,649,8.9
48,291,Liberty,2010,30668,27066,3602,11.7
48,293,Limestone,2010,9953,9164,789,7.9
48,295,Lipscomb,2010,1667,1569,98,5.9
48,297,Live Oak,2010,4638,4296,342,7.4
48,299,Llano,2010,8005,7357,648,8.1
48,301,Loving,2010,71,67,4,5.6
48,303,Lubbock,2010,143521,134500,9021,6.3
48,305,Lynn,2010,3073,2870,203,6.6
48,307,McCulloch,2010,4102,3813,289,7.0
48,309,McLennan,2010,113062,104694,8368,7.4
48,311,McMullen,2010,488,467,21,4.3
48,313,Madison,2010,4759,4357,402,8.4
48,315,Marion,2010,4510,3975,535,11.9
48,317,Martin,2010,2199,2066,133,6.0
48,319,Mason,2010,1994,1868,126,6.3
48,321,Matagorda,2010,18186,16091,2095,11.5
48,323,Maverick,2010,23566,19979,3587,15.2
48,325,Medina,2010,20045,18526,1519,7.6
48,327,Menard,2010,1006,931,75,7.5
48,329,Midland,2010,71420,67219,4201,5.9
48,331,Milam,2010,10561,9372,1189,11.3
48,333,Mills,2010,2193,2053,140,6.4
48,335,Mitchell,2010,2976,2729,247,8.3
48,337,Montague,2010,9439,8678,761,8.1
48,339,Montgomery,2010,224728,207696,17032,7.6
48,341,Moore,2010,11563,10940,623,5.4
48,343,Morris,2010,5779,4980,799,13.8
48,345,Motley,2010,624,585,39,6.3
48,347,Nacogdoches,2010,30824,28621,2203,7.1
48,349,Navarro,2010,22807,20898,1909,8.4
48,351,Newton,2010,5950,5190,760,12.8
48,353,Nolan,2010,7341,6788,553,7.5
48,355,Nueces,2010,162751,149458,13293,8.2
48,357,Ochiltree,2010,4873,4584,289,5.9
48,359,Oldham,2010,962,917,45,4.7
48,361,Orange,2010,38523,34016,4507,11.7
48,363,Palo Pinto,2010,13274,12123,1151,8.7
48,365,Panola,2010,11421,10383,1038,9.1
48,367,Parker,2010,56484,52163,4321,7.6
48,369,Parmer,2010,5359,5122,237,4.4
48,371,Pecos,2010,7187,6659,528,7.3
48,373,Polk,2010,17598,15877,1721,9.8
48,375,Potter,2010,58112,54437,3675,6.3
48,377,Presidio,2010,3750,3055,695,18.5
48,379,Rains,2010,5173,4716,457,8.8
48,381,Randall,2010,66327,62880,3447,5.2
48,383,Reagan,2010,1914,1807,107,5.6
48,385,Real,2010,1138,1034,104,9.1
48,387,Red River,2010,5591,4941,650,11.6
48,389,Reeves,2010,5754,5244,510,8.9
48,391,Refugio,2010,3333,3040,293,8.8
48,393,Roberts,2010,481,455,26,5.4
48,395,Robertson,2010,7572,6871,701,9.3
48,397,Rockwall,2010,39496,36559,2937,7.4
48,399,Runnels,2010,5136,4707,429,8.4
48,401,Rusk,2010,23996,22112,1884,7.9
48,403,Sabine,2010,3661,3061,600,16.4
48,405,San Augustine,2010,3201,2782,419,13.1
48,407,San Jacinto,2010,11248,10120,1128,10.0
48,409,San Patricio,2010,30497,27270,3227,10.6
48,411,San Saba,2010,2563,2403,160,6.2
48,413,Schleicher,2010,1637,1511,126,7.7
48,415,Scurry,2010,7111,6625,486,6.8
48,417,Shackelford,2010,1907,1800,107,5.6
48,419,Shelby,2010,11857,10848,1009,8.5
48,421,Sherman,2010,1557,1485,72,4.6
48,423,Smith,2010,101316,93200,8116,8.0
48,425,Somervell,2010,4050,3725,325,8.0
48,427,Starr,2010,26122,21586,4536,17.4
48,429,Stephens,2010,4251,3932,319,7.5
48,431,Sterling,2010,677,644,33,4.9
48,433,Stonewall,2010,747,704,43,5.8
48,435,Sutton,2010,1997,1801,196,9.8
48,437,Swisher,2010,3186,2976,210,6.6
48,439,Tarrant,2010,926222,850393,75829,8.2
48,441,Taylor,2010,64370,59989,4381,6.8
48,443,Terrell,2010,501,467,34,6.8
48,445,Terry,2010,5764,5333,431,7.5
48,447,Throckmorton,2010,878,825,53,6.0
48,449,Titus,2010,14009,12808,1201,8.6
48,451,Tom Green,2010,52663,49196,3467,6.6
48,453,Travis,2010,576411,537174,39237,6.8
48,455,Trinity,2010,5792,5237,555,9.6
48,457,Tyler,2010,7914,6980,934,11.8
48,459,Upshur,2010,18309,16691,1618,8.8
48,461,Upton,2010,1555,1459,96,6.2
48,463,Uvalde,2010,11844,10779,1065,9.0
48,465,Val Verde,2010,20650,18722,1928,9.3
48,467,Van Zandt,2010,23634,21641,1993,8.4
48,469,Victoria,2010,43147,39816,3331,7.7
48,471,Walker,2010,23273,21456,1817,7.8
48,473,Waller,2010,19989,18252,1737,8.7
48,475,Ward,2010,4637,4243,394,8.5
48,477,Washington,2010,15581,14453,1128,7.2
48,479,Webb,2010,105189,96457,8732,8.3
48,481,Wharton,2010,21309,19450,1859,8.7
48,483,Wheeler,2010,2736,2568,168,6.1
48,485,Wichita,2010,59360,54733,4627,7.8
48,487,Wilbarger,2010,6149,5663,486,7.9
48,489,Willacy,2010,7794,6662,1132,14.5
48,491,Williamson,2010,222974,206656,16318,7.3
48,493,Wilson,2010,21262,19804,1458,6.9
48,495,Winkler,2010,2903,2634,269,9.3
48,497,Wise,2010,27713,25293,2420,8.7
48,499,Wood,2010,16993,15447,1546,9.1
48,501,Yoakum,2010,3695,3436,259,7.0
48,503,Young,2010,8658,7990,668,7.7
48,505,Zapata,2010,5769,5167,602,10.4
48,507,Zavala,2010,4564,3928,636,13.9
49,1,Beaver,2010,3145,2827,318,10.1
49,3,Box Elder,2010,23543,21520,2023,8.6
49,5,Cache,2010,56996,53470,3526,6.2
49,7,Carbon,2010,9868,9007,861,8.7
49,9,Daggett,2010,492,456,36,7.3
49,11,Davis,2010,146307,135943,10364,7.1
49,13,Duchesne,2010,8121,7343,778,9.6
49,15,Emery,2010,5265,4878,387,7.4
49,17,Garfield,2010,3062,2744,318,10.4
49,19,Grand,2010,5304,4737,567,10.7
49,21,Iron,2010,20319,18355,1964,9.7
49,23,Juab,2010,4592,4167,425,9.3
49,25,Kane,2010,3545,3259,286,8.1
49,27,Millard,2010,6392,5989,403,6.3
49,29,Morgan,2010,4255,3958,297,7.0
49,31,Piute,2010,568,511,57,10.0
49,33,Rich,2010,1034,958,76,7.4
49,35,Salt Lake,2010,546019,503514,42505,7.8
49,37,San Juan,2010,6065,5394,671,11.1
49,39,Sanpete,2010,11411,10369,1042,9.1
49,41,Sevier,2010,9680,8867,813,8.4
49,43,Summit,2010,20773,19209,1564,7.5
49,45,Tooele,2010,27338,25024,2314,8.5
49,47,Uintah,2010,15119,13819,1300,8.6
49,49,Utah,2010,228807,211554,17253,7.5
49,51,Wasatch,2010,11310,10348,962,8.5
49,53,Washington,2010,56551,50540,6011,10.6
49,55,Wayne,2010,1570,1433,137,8.7
49,57,Weber,2010,112727,102717,10010,8.9
50,1,Addison,2010,21257,19973,1284,6.0
50,3,Bennington,2010,20359,18896,1463,7.2
50,5,Caledonia,2010,16805,15624,1181,7.0
50,7,Chittenden,2010,94608,89890,4718,5.0
50,9,Essex,2010,3180,2851,329,10.3
50,11,Franklin,2010,27704,26063,1641,5.9
50,13,Grand Isle,2010,4139,3841,298,7.2
50,15,Lamoille,2010,14518,13371,1147,7.9
50,17,Orange,2010,16739,15718,1021,6.1
50,19,Orleans,2010,14240,12926,1314,9.2
50,21,Rutland,2010,33635,31053,2582,7.7
50,23,Washington,2010,35143,32995,2148,6.1
50,25,Windham,2010,25456,23833,1623,6.4
50,27,Windsor,2010,31913,29891,2022,6.3
51,1,Accomack,2010,16831,15471,1360,8.1
51,3,Albemarle,2010,51043,47912,3131,6.1
51,5,Alleghany,2010,7964,7261,703,8.8
51,7,Amelia,2010,6238,5697,541,8.7
51,9,Amherst,2010,16372,15022,1350,8.2
51,11,Appomattox,2010,7354,6707,647,8.8
51,13,Arlington,2010,137453,131635,5818,4.2
51,15,Augusta,2010,37184,34464,2720,7.3
51,17,Bath,2010,2513,2319,194,7.7
51,19,Bedford,2010,39107,36284,2823,7.2
51,21,Bland,2010,2899,2645,254,8.8
51,23,Botetourt,2010,17722,16551,1171,6.6
51,25,Brunswick,2010,6968,6165,803,11.5
51,27,Buchanan,2010,8339,7493,846,10.1
51,29,Buckingham,2010,6583,5866,717,10.9
51,31,Campbell,2010,27793,25601,2192,7.9
51,33,Caroline,2010,14363,12966,1397,9.7
51,35,Carroll,2010,14032,12382,1650,11.8
51,36,Charles City,2010,3908,3525,383,9.8
51,37,Charlotte,2010,5368,4818,550,10.2
51,41,Chesterfield,2010,168850,156230,12620,7.5
51,43,Clarke,2010,7705,7178,527,6.8
51,45,Craig,2010,2444,2245,199,8.1
51,47,Culpeper,2010,23289,21580,1709,7.3
51,49,Cumberland,2010,4530,4139,391,8.6
51,51,Dickenson,2010,5524,4931,593,10.7
51,53,Dinwiddie,2010,13591,12361,1230,9.1
51,57,Essex,2010,5727,5194,533,9.3
51,59,Fairfax,2010,611055,579209,31846,5.2
51,61,Fauquier,2010,35805,33536,2269,6.3
51,63,Floyd,2010,8143,7563,580,7.1
51,65,Fluvanna,2010,13093,12246,847,6.5
51,67,Franklin,2010,27664,25204,2460,8.9
51,69,Frederick,2010,42027,38812,3215,7.6
51,71,Giles,2010,8317,7504,813,9.8
51,73,Gloucester,2010,19578,18210,1368,7.0
51,75,Goochland,2010,10499,9728,771,7.3
51,77,Grayson,2010,7388,6452,936,12.7
51,79,Greene,2010,9667,9002,665,6.9
51,81,Greensville,2010,4569,4122,447,9.8
51,83,Halifax,2010,16727,14644,2083,12.5
51,85,Hanover,2010,54500,50830,3670,6.7
51,87,Henrico,2010,167948,155376,12572,7.5
51,89,Henry,2010,24091,20457,3634,15.1
51,91,Highland,2010,1447,1355,92,6.4
51,93,Isle of Wight,2010,18826,17449,1377,7.3
51,95,James City,2010,32282,30190,2092,6.5
51,97,King and Queen,2010,3597,3301,296,8.2
51,99,King George,2010,11429,10568,861,7.5
51,101,King William,2010,8669,8007,662,7.6
51,103,Lancaster,2010,5579,5021,558,10.0
51,105,Lee,2010,10143,9320,823,8.1
51,107,Loudoun,2010,175593,166403,9190,5.2
51,109,Louisa,2010,17879,16505,1374,7.7
51,111,Lunenburg,2010,5558,5018,540,9.7
51,113,Madison,2010,7178,6714,464,6.5
51,115,Mathews,2010,4229,3954,275,6.5
51,117,Mecklenburg,2010,14183,12546,1637,11.5
51,119,Middlesex,2010,5167,4787,380,7.4
51,121,Montgomery,2010,47555,44117,3438,7.2
51,125,Nelson,2010,7586,7031,555,7.3
51,127,New Kent,2010,10310,9546,764,7.4
51,131,Northampton,2010,6346,5796,550,8.7
51,133,Northumberland,2010,6161,5614,547,8.9
51,135,Nottoway,2010,6869,6335,534,7.8
51,137,Orange,2010,15478,14171,1307,8.4
51,139,Page,2010,12360,10894,1466,11.9
51,141,Patrick,2010,8346,7262,1084,13.0
51,143,Pittsylvania,2010,30963,27529,3434,11.1
51,145,Powhatan,2010,13529,12550,979,7.2
51,147,Prince Edward,2010,10298,9280,1018,9.9
51,149,Prince George,2010,13985,12832,1153,8.2
51,153,Prince William,2010,218644,204995,13649,6.2
51,155,Pulaski,2010,17011,15083,1928,11.3
51,157,Rappahannock,2010,4030,3769,261,6.5
51,159,Richmond,2010,4371,4056,315,7.2
51,161,Roanoke,2010,49317,46114,3203,6.5
51,163,Rockbridge,2010,11158,10297,861,7.7
51,165,Rockingham,2010,40427,37637,2790,6.9
51,167,Russell,2010,12109,10839,1270,10.5
51,169,Scott,2010,10086,9214,872,8.6
51,171,Shenandoah,2010,20865,19108,1757,8.4
51,173,Smyth,2010,13740,12040,1700,12.4
51,175,Southampton,2010,9510,8675,835,8.8
51,177,Spotsylvania,2010,63445,58892,4553,7.2
51,179,Stafford,2010,63985,59719,4266,6.7
51,181,Surry,2010,3700,3361,339,9.2
51,183,Sussex,2010,4291,3791,500,11.7
51,185,Tazewell,2010,18427,16771,1656,9.0
51,187,Warren,2010,20137,18471,1666,8.3
51,191,Washington,2010,27455,25226,2229,8.1
51,193,Westmoreland,2010,9193,8432,761,8.3
51,195,Wise,2010,17005,15553,1452,8.5
51,197,Wythe,2010,14302,12681,1621,11.3
51,199,York,2010,31326,29363,1963,6.3
51,510,Alexandria city,2010,90436,85872,4564,5.0
51,520,Bristol city,2010,7991,7270,721,9.0
51,530,Buena Vista city,2010,3255,2923,332,10.2
51,540,Charlottesville city,2010,23229,21779,1450,6.2
51,550,Chesapeake city,2010,113482,105121,8361,7.4
51,570,Colonial Heights city,2010,8548,7824,724,8.5
51,580,Covington city,2010,2694,2402,292,10.8
51,590,Danville city,2010,20163,17382,2781,13.8
51,595,Emporia city,2010,2576,2250,326,12.7
51,600,Fairfax city,2010,12674,11967,707,5.6
51,610,Falls Church city,2010,7388,7018,370,5.0
51,620,Franklin city,2010,3719,3239,480,12.9
51,630,Fredericksburg city,2010,12446,11298,1148,9.2
51,640,Galax city,2010,3179,2824,355,11.2
51,650,Hampton city,2010,66782,60658,6124,9.2
51,660,Harrisonburg city,2010,23202,21240,1962,8.5
51,670,Hopewell city,2010,9884,8717,1167,11.8
51,678,Lexington city,2010,2304,2085,219,9.5
51,680,Lynchburg city,2010,35899,32781,3118,8.7
51,683,Manassas city,2010,21004,19494,1510,7.2
51,685,Manassas Park city,2010,8076,7559,517,6.4
51,690,Martinsville city,2010,6161,5063,1098,17.8
51,700,Newport News city,2010,90822,83062,7760,8.5
51,710,Norfolk city,2010,112640,102555,10085,9.0
51,720,Norton city,2010,2082,1927,155,7.4
51,730,Petersburg city,2010,13922,11933,1989,14.3
51,735,Poquoson city,2010,6402,6004,398,6.2
51,740,Portsmouth city,2010,45555,41082,4473,9.8
51,750,Radford city,2010,7802,7057,745,9.5
51,760,Richmond city,2010,106682,96300,10382,9.7
51,770,Roanoke city,2010,49374,45000,4374,8.9
51,775,Salem city,2010,12806,11904,902,7.0
51,790,Staunton city,2010,11864,10915,949,8.0
51,800,Suffolk city,2010,41816,38562,3254,7.8
51,810,Virginia Beach city,2010,227179,212040,15139,6.7
51,820,Waynesboro city,2010,10189,9250,939,9.2
51,830,Williamsburg city,2010,6530,5853,677,10.4
51,840,Winchester city,2010,13705,12545,1160,8.5
53,1,Adams,2010,8265,7480,785,9.5
53,3,Asotin,2010,10133,9269,864,8.5
53,5,Benton,2010,92564,85997,6567,7.1
53,7,Chelan,2010,41300,37974,3326,8.1
53,9,Clallam,2010,29006,26094,2912,10.0
53,11,Clark,2010,211568,186782,24786,11.7
53,13,Columbia,2010,1919,1756,163,8.5
53,15,Cowlitz,2010,45349,40039,5310,11.7
53,17,Douglas,2010,19478,17769,1709,8.8
53,19,Ferry,2010,2571,2160,411,16.0
53,21,Franklin,2010,37530,34543,2987,8.0
53,23,Garfield,2010,1041,964,77,7.4
53,25,Grant,2010,42318,38144,4174,9.9
53,27,Grays Harbor,2010,30288,26460,3828,12.6
53,29,Island,2010,33158,30364,2794,8.4
53,31,Jefferson,2010,12492,11324,1168,9.3
53,33,King,2010,1097736,1005539,92197,8.4
53,35,Kitsap,2010,118347,109149,9198,7.8
53,37,Kittitas,2010,20882,19034,1848,8.8
53,39,Klickitat,2010,10094,8980,1114,11.0
53,41,Lewis,2010,33162,29213,3949,11.9
53,43,Lincoln,2010,5226,4832,394,7.5
53,45,Mason,2010,24392,21748,2644,10.8
53,47,Okanogan,2010,21876,19753,2123,9.7
53,49,Pacific,2010,8574,7483,1091,12.7
53,51,Pend Oreille,2010,5014,4316,698,13.9
53,53,Pierce,2010,387830,351104,36726,9.5
53,55,San Juan,2010,8302,7754,548,6.6
53,57,Skagit,2010,57861,52141,5720,9.9
53,59,Skamania,2010,5059,4470,589,11.6
53,61,Snohomish,2010,383222,345153,38069,9.9
53,63,Spokane,2010,233321,212013,21308,9.1
53,65,Stevens,2010,18655,16441,2214,11.9
53,67,Thurston,2010,124535,114417,10118,8.1
53,69,Wahkiakum,2010,1434,1235,199,13.9
53,71,Walla Walla,2010,29975,27811,2164,7.2
53,73,Whatcom,2010,102301,93541,8760,8.6
53,75,Whitman,2010,22111,20772,1339,6.1
53,77,Yakima,2010,119568,108095,11473,9.6
54,1,Barbour,2010,6863,6171,692,10.1
54,3,Berkeley,2010,50958,46578,4380,8.6
54,5,Boone,2010,8800,8024,776,8.8
54,7,Braxton,2010,5679,5049,630,11.1
54,9,Brooke,2010,10909,9659,1250,11.5
54,11,Cabell,2010,43230,40108,3122,7.2
54,13,Calhoun,2010,2904,2496,408,14.0
54,15,Clay,2010,3643,3127,516,14.2
54,17,Doddridge,2010,3311,3074,237,7.2
54,19,Fayette,2010,17545,15795,1750,10.0
54,21,Gilmer,2010,2772,2525,247,8.9
54,23,Grant,2010,6116,5517,599,9.8
54,25,Greenbrier,2010,15416,14061,1355,8.8
54,27,Hampshire,2010,9752,8864,888,9.1
54,29,Hancock,2010,14160,12439,1721,12.2
54,31,Hardy,2010,5703,5041,662,11.6
54,33,Harrison,2010,31213,28833,2380,7.6
54,35,Jackson,2010,12298,10896,1402,11.4
54,37,Jefferson,2010,26832,25043,1789,6.7
54,39,Kanawha,2010,92476,85647,6829,7.4
54,41,Lewis,2010,6983,6368,615,8.8
54,43,Lincoln,2010,7866,6938,928,11.8
54,45,Logan,2010,12675,11388,1287,10.2
54,47,McDowell,2010,6353,5513,840,13.2
54,49,Marion,2010,26605,24669,1936,7.3
54,51,Marshall,2010,14660,13242,1418,9.7
54,53,Mason,2010,11266,9966,1300,11.5
54,55,Mercer,2010,24041,22003,2038,8.5
54,57,Mineral,2010,12349,11192,1157,9.4
54,59,Mingo,2010,9157,8255,902,9.9
54,61,Monongalia,2010,48286,45590,2696,5.6
54,63,Monroe,2010,5757,5296,461,8.0
54,65,Morgan,2010,7667,6966,701,9.1
54,67,Nicholas,2010,10927,9828,1099,10.1
54,69,Ohio,2010,21796,20065,1731,7.9
54,71,Pendleton,2010,3655,3339,316,8.6
54,73,Pleasants,2010,2934,2623,311,10.6
54,75,Pocahontas,2010,3795,3358,437,11.5
54,77,Preston,2010,14917,13668,1249,8.4
54,79,Putnam,2010,26356,24356,2000,7.6
54,81,Raleigh,2010,32428,29784,2644,8.2
54,83,Randolph,2010,12193,10912,1281,10.5
54,85,Ritchie,2010,4290,3873,417,9.7
54,87,Roane,2010,5504,4753,751,13.6
54,89,Summers,2010,4778,4325,453,9.5
54,91,Taylor,2010,7436,6863,573,7.7
54,93,Tucker,2010,3297,2933,364,11.0
54,95,Tyler,2010,3547,3141,406,11.4
54,97,Upshur,2010,10356,9396,960,9.3
54,99,Wayne,2010,16916,15472,1444,8.5
54,101,Webster,2010,3736,3356,380,10.2
54,103,Wetzel,2010,7009,6184,825,11.8
54,105,Wirt,2010,2290,2003,287,12.5
54,107,Wood,2010,39296,35800,3496,8.9
54,109,Wyoming,2010,8406,7530,876,10.4
55,1,Adams,2010,9135,8022,1113,12.2
55,3,Ashland,2010,8409,7495,914,10.9
55,5,Barron,2010,23801,21635,2166,9.1
55,7,Bayfield,2010,7687,6852,835,10.9
55,9,Brown,2010,137237,126621,10616,7.7
55,11,Buffalo,2010,7203,6654,549,7.6
55,13,Burnett,2010,7576,6752,824,10.9
55,15,Calumet,2010,27315,25477,1838,6.7
55,17,Chippewa,2010,33193,30454,2739,8.3
55,19,Clark,2010,17265,15514,1751,10.1
55,21,Columbia,2010,32089,29428,2661,8.3
55,23,Crawford,2010,8367,7506,861,10.3
55,25,Dane,2010,293554,276445,17109,5.8
55,27,Dodge,2010,47372,43170,4202,8.9
55,29,Door,2010,15760,14017,1743,11.1
55,31,Douglas,2010,23748,21809,1939,8.2
55,33,Dunn,2010,23262,21457,1805,7.8
55,35,Eau Claire,2010,57161,53258,3903,6.8
55,37,Florence,2010,2248,2019,229,10.2
55,39,Fond du Lac,2010,56550,51832,4718,8.3
55,41,Forest,2010,4253,3764,489,11.5
55,43,Grant,2010,27797,25721,2076,7.5
55,45,Green,2010,21288,19617,1671,7.8
55,47,Green Lake,2010,10311,9368,943,9.1
55,49,Iowa,2010,13779,12665,1114,8.1
55,51,Iron,2010,2882,2560,322,11.2
55,53,Jackson,2010,10128,9259,869,8.6
55,55,Jefferson,2010,46492,42510,3982,8.6
55,57,Juneau,2010,13697,12359,1338,9.8
55,59,Kenosha,2010,85715,77060,8655,10.1
55,61,Kewaunee,2010,11183,10285,898,8.0
55,63,La Crosse,2010,65661,61376,4285,6.5
55,65,Lafayette,2010,9498,8830,668,7.0
55,67,Langlade,2010,10180,9083,1097,10.8
55,69,Lincoln,2010,15664,13920,1744,11.1
55,71,Manitowoc,2010,44618,40294,4324,9.7
55,73,Marathon,2010,73558,66842,6716,9.1
55,75,Marinette,2010,21383,19056,2327,10.9
55,77,Marquette,2010,7685,6870,815,10.6
55,78,Menominee,2010,1548,1282,266,17.2
55,79,Milwaukee,2010,476599,429808,46791,9.8
55,81,Monroe,2010,23140,21330,1810,7.8
55,83,Oconto,2010,21337,19085,2252,10.6
55,85,Oneida,2010,19067,17161,1906,10.0
55,87,Outagamie,2010,100664,92663,8001,7.9
55,89,Ozaukee,2010,47460,44157,3303,7.0
55,91,Pepin,2010,4098,3798,300,7.3
55,93,Pierce,2010,24002,22368,1634,6.8
55,95,Polk,2010,24054,21702,2352,9.8
55,97,Portage,2010,39885,36752,3133,7.9
55,99,Price,2010,7564,6751,813,10.7
55,101,Racine,2010,100315,90325,9990,10.0
55,103,Richland,2010,9637,8784,853,8.9
55,105,Rock,2010,82708,73550,9158,11.1
55,107,Rusk,2010,7140,6278,862,12.1
55,109,St. Croix,2010,47093,43566,3527,7.5
55,111,Sauk,2010,35869,32906,2963,8.3
55,113,Sawyer,2010,8394,7463,931,11.1
55,115,Shawano,2010,21892,19689,2203,10.1
55,117,Sheboygan,2010,62269,56584,5685,9.1
55,119,Taylor,2010,11450,10296,1154,10.1
55,121,Trempealeau,2010,15998,14810,1188,7.4
55,123,Vernon,2010,15173,13997,1176,7.8
55,125,Vilas,2010,10343,9197,1146,11.1
55,127,Walworth,2010,56391,51392,4999,8.9
55,129,Washburn,2010,8046,7278,768,9.5
55,131,Washington,2010,75652,69648,6004,7.9
55,133,Waukesha,2010,218197,202455,15742,7.2
55,135,Waupaca,2010,27748,25180,2568,9.3
55,137,Waushara,2010,12028,10755,1273,10.6
55,139,Winnebago,2010,92492,85419,7073,7.6
55,141,Wood,2010,39985,36337,3648,9.1
56,1,Albany,2010,21248,20224,1024,4.8
56,3,Big Horn,2010,5606,5203,403,7.2
56,5,Campbell,2010,26165,24466,1699,6.5
56,7,Carbon,2010,8218,7623,595,7.2
56,9,Converse,2010,7528,7085,443,5.9
56,11,Crook,2010,3887,3678,209,5.4
56,13,Fremont,2010,20890,19321,1569,7.5
56,15,Goshen,2010,7456,7062,394,5.3
56,17,Hot Springs,2010,2555,2411,144,5.6
56,19,Johnson,2010,4516,4184,332,7.4
56,21,Laramie,2010,45971,42668,3303,7.2
56,23,Lincoln,2010,8652,7869,783,9.0
56,25,Natrona,2010,39724,36745,2979,7.5
56,27,Niobrara,2010,1379,1311,68,4.9
56,29,Park,2010,15772,14730,1042,6.6
56,31,Platte,2010,4938,4644,294,6.0
56,33,Sheridan,2010,16066,14804,1262,7.9
56,35,Sublette,2010,5662,5305,357,6.3
56,37,Sweetwater,2010,23023,21395,1628,7.1
56,39,Teton,2010,13568,12446,1122,8.3
56,41,Uinta,2010,10512,9718,794,7.6
56,43,Washakie,2010,4566,4276,290,6.4
56,45,Weston,2010,3992,3784,208,5.2
72,1,Adjuntas Municipio,2010,5185,4169,1016,19.6
72,3,Aguada Municipio,2010,13495,10869,2626,19.5
72,5,Aguadilla Municipio,2010,17420,13863,3557,20.4
72,7,Aguas Buenas Municipio,2010,7969,6202,1767,22.2
72,9,Aibonito Municipio,2010,7548,6080,1468,19.4
72,11,Anasco Municipio,2010,9997,8064,1933,19.3
72,13,Arecibo Municipio,2010,27909,22893,5016,18.0
72,15,Arroyo Municipio,2010,6189,4766,1423,23.0
72,17,Barceloneta Municipio,2010,6632,5007,1625,24.5
72,19,Barranquitas Municipio,2010,8137,6694,1443,17.7
72,21,Bayamon Municipio,2010,76814,66891,9923,12.9
72,23,Cabo Rojo Municipio,2010,15463,12898,2565,16.6
72,25,Caguas Municipio,2010,54813,46287,8526,15.6
72,27,Camuy Municipio,2010,10858,9067,1791,16.5
72,29,Canovanas Municipio,2010,17700,14543,3157,17.8
72,31,Carolina Municipio,2010,71412,62139,9273,13.0
72,33,Catano Municipio,2010,9287,7879,1408,15.2
72,35,Cayey Municipio,2010,18187,15305,2882,15.8
72,37,Ceiba Municipio,2010,4676,3706,970,20.7
72,39,Ciales Municipio,2010,4792,3500,1292,27.0
72,41,Cidra Municipio,2010,17487,14742,2745,15.7
72,43,Coamo Municipio,2010,12175,9506,2669,21.9
72,45,Comerio Municipio,2010,5863,4560,1303,22.2
72,47,Corozal Municipio,2010,10186,8424,1762,17.3
72,49,Culebra Municipio,2010,815,733,82,10.1
72,51,Dorado Municipio,2010,13548,11926,1622,12.0
72,53,Fajardo Municipio,2010,13682,10938,2744,20.1
72,54,Florida Municipio,2010,3851,3000,851,22.1
72,55,Guanica Municipio,2010,5116,3808,1308,25.6
72,57,Guayama Municipio,2010,15004,11483,3521,23.5
72,59,Guayanilla Municipio,2010,6275,4744,1531,24.4
72,61,Guaynabo Municipio,2010,41248,37746,3502,8.5
72,63,Gurabo Municipio,2010,17667,15191,2476,14.0
72,65,Hatillo Municipio,2010,14037,11738,2299,16.4
72,67,Hormigueros Municipio,2010,6255,5232,1023,16.4
72,69,Humacao Municipio,2010,20231,15958,4273,21.1
72,71,Isabela Municipio,2010,13405,10725,2680,20.0
72,73,Jayuya Municipio,2010,5099,4103,996,19.5
72,75,Juana Diaz Municipio,2010,17199,14100,3099,18.0
72,77,Juncos Municipio,2010,13390,10882,2508,18.7
72,79,Lajas Municipio,2010,6571,5070,1501,22.8
72,81,Lares Municipio,2010,8052,6446,1606,19.9
72,83,Las Marias Municipio,2010,3670,2997,673,18.3
72,85,Las Piedras Municipio,2010,12272,9883,2389,19.5
72,87,Loiza Municipio,2010,10240,8523,1717,16.8
72,89,Luquillo Municipio,2010,7256,5767,1489,20.5
72,91,Manati Municipio,2010,13527,10982,2545,18.8
72,93,Maricao Municipio,2010,2324,1898,426,18.3
72,95,Maunabo Municipio,2010,3547,2671,876,24.7
72,97,Mayaguez Municipio,2010,27840,22633,5207,18.7
72,99,Moca Municipio,2010,12051,9598,2453,20.4
72,101,Morovis Municipio,2010,9288,7168,2120,22.8
72,103,Naguabo Municipio,2010,9099,7152,1947,21.4
72,105,Naranjito Municipio,2010,8240,6570,1670,20.3
72,107,Orocovis Municipio,2010,6089,4728,1361,22.4
72,109,Patillas Municipio,2010,6024,4441,1583,26.3
72,111,Penuelas Municipio,2010,7505,5686,1819,24.2
72,113,Ponce Municipio,2010,55613,46076,9537,17.1
72,115,Quebradillas Municipio,2010,6840,5499,1341,19.6
72,117,Rincon Municipio,2010,4986,4066,920,18.5
72,119,Rio Grande Municipio,2010,18875,15999,2876,15.2
72,121,Sabana Grande Municipio,2010,7532,5908,1624,21.6
72,123,Salinas Municipio,2010,9174,6787,2387,26.0
72,125,San German Municipio,2010,11980,9773,2207,18.4
72,127,San Juan Municipio,2010,155395,139469,15926,10.2
72,129,San Lorenzo Municipio,2010,13328,11002,2326,17.5
72,131,San Sebastian Municipio,2010,11856,9218,2638,22.3
72,133,Santa Isabel Municipio,2010,10394,8241,2153,20.7
72,135,Toa Alta Municipio,2010,27298,24016,3282,12.0
72,137,Toa Baja Municipio,2010,33982,29678,4304,12.7
72,139,Trujillo Alto Municipio,2010,30302,27126,3176,10.5
72,141,Utuado Municipio,2010,8114,6422,1692,20.9
72,143,Vega Alta Municipio,2010,10823,8963,1860,17.2
72,145,Vega Baja Municipio,2010,16229,12856,3373,20.8
72,147,Vieques Municipio,2010,3401,2767,634,18.6
72,149,Villalba Municipio,2010,8841,6892,1949,22.0
72,151,Yabucoa Municipio,2010,11004,8210,2794,25.4
72,153,Yauco Municipio,2010,12098,9514,2584,21.4
1,1,Autauga,2011,25845,23688,2157,8.3
1,3,Baldwin,2011,85077,77459,7618,9.0
1,5,Barbour,2011,9843,8716,1127,11.4
1,7,Bibb,2011,8932,8000,932,10.4
1,9,Blount,2011,25124,22951,2173,8.6
1,11,Bullock,2011,4829,4274,555,11.5
1,13,Butler,2011,9180,8046,1134,12.4
1,15,Calhoun,2011,51271,45986,5285,10.3
1,17,Chambers,2011,15185,13386,1799,11.8
1,19,Cherokee,2011,11473,10369,1104,9.6
1,21,Chilton,2011,19536,17761,1775,9.1
1,23,Choctaw,2011,4760,4140,620,13.0
1,25,Clarke,2011,8827,7185,1642,18.6
1,27,Clay,2011,5593,4937,656,11.7
1,29,Cleburne,2011,5939,5367,572,9.6
1,31,Coffee,2011,20745,19068,1677,8.1
1,33,Colbert,2011,24385,21915,2470,10.1
1,35,Conecuh,2011,4778,4059,719,15.0
1,37,Coosa,2011,4472,3920,552,12.3
1,39,Covington,2011,16372,14772,1600,9.8
1,41,Crenshaw,2011,6432,5801,631,9.8
1,43,Cullman,2011,35673,32295,3378,9.5
1,45,Dale,2011,22020,20197,1823,8.3
1,47,Dallas,2011,17493,14874,2619,15.0
1,49,DeKalb,2011,29778,26292,3486,11.7
1,51,Elmore,2011,36611,33538,3073,8.4
1,53,Escambia,2011,14967,13361,1606,10.7
1,55,Etowah,2011,44723,40258,4465,10.0
1,57,Fayette,2011,6627,5899,728,11.0
1,59,Franklin,2011,14351,12992,1359,9.5
1,61,Geneva,2011,11485,10434,1051,9.2
1,63,Greene,2011,3220,2669,551,17.1
1,65,Hale,2011,6288,5428,860,13.7
1,67,Henry,2011,7269,6566,703,9.7
1,69,Houston,2011,46794,42767,4027,8.6
1,71,Jackson,2011,24160,21692,2468,10.2
1,73,Jefferson,2011,319586,290057,29529,9.2
1,75,Lamar,2011,5821,5262,559,9.6
1,77,Lauderdale,2011,44046,40045,4001,9.1
1,79,Lawrence,2011,14775,13183,1592,10.8
1,81,Lee,2011,68331,62842,5489,8.0
1,83,Limestone,2011,38994,35648,3346,8.6
1,85,Lowndes,2011,4233,3491,742,17.5
1,87,Macon,2011,8502,7321,1181,13.9
1,89,Madison,2011,171679,157588,14091,8.2
1,91,Marengo,2011,7867,6888,979,12.4
1,93,Marion,2011,12546,11155,1391,11.1
1,95,Marshall,2011,41097,37235,3862,9.4
1,97,Mobile,2011,193845,173055,20790,10.7
1,99,Monroe,2011,8312,7020,1292,15.5
1,101,Montgomery,2011,109098,98539,10559,9.7
1,103,Morgan,2011,58319,52836,5483,9.4
1,105,Perry,2011,3860,3229,631,16.3
1,107,Pickens,2011,7564,6666,898,11.9
1,109,Pike,2011,15447,14077,1370,8.9
1,111,Randolph,2011,9440,8378,1062,11.3
1,113,Russell,2011,24601,22088,2513,10.2
1,115,St. Clair,2011,38508,35152,3356,8.7
1,117,Shelby,2011,104209,97774,6435,6.2
1,119,Sumter,2011,5555,4832,723,13.0
1,121,Talladega,2011,35260,31207,4053,11.5
1,123,Tallapoosa,2011,18350,16274,2076,11.3
1,125,Tuscaloosa,2011,95489,87574,7915,8.3
1,127,Walker,2011,27076,24045,3031,11.2
1,129,Washington,2011,7097,6073,1024,14.4
1,131,Wilcox,2011,2971,2290,681,22.9
1,133,Winston,2011,9806,8496,1310,13.4
2,13,Aleutians East Borough,2011,2174,2036,138,6.3
2,16,Aleutians West Census Area,2011,4238,3985,253,6.0
2,20,Anchorage Borough/municipality,2011,158382,148731,9651,6.1
2,50,Bethel Census Area,2011,7208,6104,1104,15.3
2,60,Bristol Bay Borough,2011,516,469,47,9.1
2,68,Denali Borough,2011,1016,874,142,14.0
2,70,Dillingham Census Area,2011,2100,1873,227,10.8
2,90,Fairbanks North Star Borough,2011,48167,44992,3175,6.6
2,100,Haines Borough,2011,1163,1044,119,10.2
2,105,Hoonah-Angoon Census Area,2011,1097,928,169,15.4
2,110,Juneau Borough/city,2011,17833,16821,1012,5.7
2,122,Kenai Peninsula Borough,2011,27184,24538,2646,9.7
2,130,Ketchikan Gateway Borough,2011,7155,6523,632,8.8
2,150,Kodiak Island Borough,2011,6757,6246,511,7.6
2,158,Kusilvak Census Area,2011,2758,2165,593,21.5
2,164,Lake and Peninsula Borough,2011,637,539,98,15.4
2,170,Matanuska-Susitna Borough,2011,43238,39177,4061,9.4
2,180,Nome Census Area,2011,4117,3599,518,12.6
2,185,North Slope Borough,2011,3980,3670,310,7.8
2,188,Northwest Arctic Borough,2011,2980,2510,470,15.8
2,195,Petersburg Borough,2011,1849,1691,158,8.5
2,198,Prince of Wales-Hyder Census Area,2011,2565,2241,324,12.6
2,220,Sitka Borough/city,2011,4611,4323,288,6.2
2,230,Skagway Municipality,2011,714,596,118,16.5
2,240,Southeast Fairbanks Census Area,2011,3194,2789,405,12.7
2,261,Valdez-Cordova Census Area,2011,4921,4423,498,10.1
2,275,Wrangell Borough/city,2011,1048,967,81,7.7
2,282,Yakutat Borough/city,2011,300,267,33,11.0
2,290,Yukon-Koyukuk Census Area,2011,2703,2196,507,18.8
4,1,Apache,2011,23137,18893,4244,18.3
4,3,Cochise,2011,56190,50870,5320,9.5
4,5,Coconino,2011,72036,65208,6828,9.5
4,7,Gila,2011,21274,18830,2444,11.5
4,9,Graham,2011,14415,12988,1427,9.9
4,11,Greenlee,2011,3369,2999,370,11.0
4,12,La Paz,2011,7864,7096,768,9.8
4,13,Maricopa,2011,1904041,1742147,161894,8.5
4,15,Mohave,2011,79969,70211,9758,12.2
4,17,Navajo,2011,43540,37120,6420,14.7
4,19,Pima,2011,469332,429711,39621,8.4
4,21,Pinal,2011,150364,135795,14569,9.7
4,23,Santa Cruz,2011,20567,17407,3160,15.4
4,25,Yavapai,2011,93580,84420,9160,9.8
4,27,Yuma,2011,92260,70065,22195,24.1
5,1,Arkansas,2011,10509,9286,1223,11.6
5,3,Ashley,2011,10004,8953,1051,10.5
5,5,Baxter,2011,16523,15057,1466,8.9
5,7,Benton,2011,109127,102361,6766,6.2
5,9,Boone,2011,16613,15354,1259,7.6
5,11,Bradley,2011,4695,4153,542,11.5
5,13,Calhoun,2011,2642,2402,240,9.1
5,15,Carroll,2011,12852,11968,884,6.9
5,17,Chicot,2011,4261,3726,535,12.6
5,19,Clark,2011,10411,9392,1019,9.8
5,21,Clay,2011,7263,6420,843,11.6
5,23,Cleburne,2011,10531,9609,922,8.8
5,25,Cleveland,2011,3867,3551,316,8.2
5,27,Columbia,2011,10386,9390,996,9.6
5,29,Conway,2011,8995,8146,849,9.4
5,31,Craighead,2011,48963,45520,3443,7.0
5,33,Crawford,2011,27874,25519,2355,8.4
5,35,Crittenden,2011,22636,20277,2359,10.4
5,37,Cross,2011,8785,8084,701,8.0
5,39,Dallas,2011,3409,3017,392,11.5
5,41,Desha,2011,6132,5481,651,10.6
5,43,Drew,2011,8754,7800,954,10.9
5,45,Faulkner,2011,59201,55162,4039,6.8
5,47,Franklin,2011,7769,7201,568,7.3
5,49,Fulton,2011,5105,4727,378,7.4
5,51,Garland,2011,41566,38097,3469,8.3
5,53,Grant,2011,8522,7922,600,7.0
5,55,Greene,2011,20021,18169,1852,9.3
5,57,Hempstead,2011,11003,10080,923,8.4
5,59,Hot Spring,2011,14581,13434,1147,7.9
5,61,Howard,2011,6746,6265,481,7.1
5,63,Independence,2011,16639,15154,1485,8.9
5,65,Izard,2011,5203,4710,493,9.5
5,67,Jackson,2011,6674,5931,743,11.1
5,69,Jefferson,2011,33538,29954,3584,10.7
5,71,Johnson,2011,11107,10274,833,7.5
5,73,Lafayette,2011,3017,2742,275,9.1
5,75,Lawrence,2011,7474,6772,702,9.4
5,77,Lee,2011,3675,3342,333,9.1
5,79,Lincoln,2011,4756,4331,425,8.9
5,81,Little River,2011,6114,5658,456,7.5
5,83,Logan,2011,9616,8809,807,8.4
5,85,Lonoke,2011,33304,31099,2205,6.6
5,87,Madison,2011,7213,6748,465,6.4
5,89,Marion,2011,6721,6118,603,9.0
5,91,Miller,2011,20723,19468,1255,6.1
5,93,Mississippi,2011,20852,18453,2399,11.5
5,95,Monroe,2011,3381,3075,306,9.1
5,97,Montgomery,2011,3832,3493,339,8.8
5,99,Nevada,2011,4172,3796,376,9.0
5,101,Newton,2011,3785,3515,270,7.1
5,103,Ouachita,2011,11090,9982,1108,10.0
5,105,Perry,2011,4495,4095,400,8.9
5,107,Phillips,2011,8391,7415,976,11.6
5,109,Pike,2011,4691,4248,443,9.4
5,111,Poinsett,2011,10755,9775,980,9.1
5,113,Polk,2011,8929,8246,683,7.6
5,115,Pope,2011,30519,28246,2273,7.4
5,117,Prairie,2011,3916,3591,325,8.3
5,119,Pulaski,2011,189186,175745,13441,7.1
5,121,Randolph,2011,7146,6376,770,10.8
5,123,St. Francis,2011,9789,8747,1042,10.6
5,125,Saline,2011,53987,50565,3422,6.3
5,127,Scott,2011,4855,4529,326,6.7
5,129,Searcy,2011,3318,3028,290,8.7
5,131,Sebastian,2011,59300,54399,4901,8.3
5,133,Sevier,2011,6402,5842,560,8.7
5,135,Sharp,2011,6259,5617,642,10.3
5,137,Stone,2011,5372,4916,456,8.5
5,139,Union,2011,16952,15234,1718,10.1
5,141,Van Buren,2011,6735,6021,714,10.6
5,143,Washington,2011,104405,98139,6266,6.0
5,145,White,2011,36645,33620,3025,8.3
5,147,Woodruff,2011,3540,3170,370,10.5
5,149,Yell,2011,9604,8921,683,7.1
6,1,Alameda,2011,785124,704596,80528,10.3
6,3,Alpine,2011,591,515,76,12.9
6,5,Amador,2011,15075,12988,2087,13.8
6,7,Butte,2011,100530,86549,13981,13.9
6,9,Calaveras,2011,20645,17699,2946,14.3
6,11,Colusa,2011,11380,8924,2456,21.6
6,13,Contra Costa,2011,528506,473141,55365,10.5
6,15,Del Norte,2011,10882,9409,1473,13.5
6,17,El Dorado,2011,89550,78876,10674,11.9
6,19,Fresno,2011,443250,368767,74483,16.8
6,21,Glenn,2011,13157,11080,2077,15.8
6,23,Humboldt,2011,64954,57998,6956,10.7
6,25,Imperial,2011,79611,56301,23310,29.3
6,27,Inyo,2011,9663,8707,956,9.9
6,29,Kern,2011,382013,324431,57582,15.1
6,31,Kings,2011,59082,49523,9559,16.2
6,33,Lake,2011,29582,25210,4372,14.8
6,35,Lassen,2011,11771,10150,1621,13.8
6,37,Los Angeles,2011,4941667,4337370,604297,12.2
6,39,Madera,2011,61974,51786,10188,16.4
6,41,Marin,2011,134245,124309,9936,7.4
6,43,Mariposa,2011,8649,7490,1159,13.4
6,45,Mendocino,2011,40874,36141,4733,11.6
6,47,Merced,2011,114693,94128,20565,17.9
6,49,Modoc,2011,3617,3030,587,16.2
6,51,Mono,2011,8814,7913,901,10.2
6,53,Monterey,2011,216257,188401,27856,12.9
6,55,Napa,2011,70628,63595,7033,10.0
6,57,Nevada,2011,48941,43418,5523,11.3
6,59,Orange,2011,1543784,1400874,142910,9.3
6,61,Placer,2011,173470,154313,19157,11.0
6,63,Plumas,2011,8886,7297,1589,17.9
6,65,Riverside,2011,977288,846288,131000,13.4
6,67,Sacramento,2011,678994,595329,83665,12.3
6,69,San Benito,2011,28253,24084,4169,14.8
6,71,San Bernardino,2011,887345,771117,116228,13.1
6,73,San Diego,2011,1521745,1361865,159880,10.5
6,75,San Francisco/city,2011,493437,453071,40366,8.2
6,77,San Joaquin,2011,311159,259969,51190,16.5
6,79,San Luis Obispo,2011,134066,121031,13035,9.7
6,81,San Mateo,2011,398892,368371,30521,7.7
6,83,Santa Barbara,2011,212557,192261,20296,9.5
6,85,Santa Clara,2011,937871,849070,88801,9.5
6,87,Santa Cruz,2011,141147,122382,18765,13.3
6,89,Shasta,2011,76990,64507,12483,16.2
6,91,Sierra,2011,1599,1357,242,15.1
6,93,Siskiyou,2011,19425,16070,3355,17.3
6,95,Solano,2011,201909,176920,24989,12.4
6,97,Sonoma,2011,245618,220088,25530,10.4
6,99,Stanislaus,2011,242178,201564,40614,16.8
6,101,Sutter,2011,45926,37447,8479,18.5
6,103,Tehama,2011,25551,21659,3892,15.2
6,105,Trinity,2011,5382,4469,913,17.0
6,107,Tulare,2011,203378,168022,35356,17.4
6,109,Tuolumne,2011,22701,19363,3338,14.7
6,111,Ventura,2011,430917,385967,44950,10.4
6,113,Yolo,2011,101633,89464,12169,12.0
6,115,Yuba,2011,28933,23940,4993,17.3
8,1,Adams,2011,236016,211759,24257,10.3
8,3,Alamosa,2011,7676,6904,772,10.1
8,5,Arapahoe,2011,318595,291255,27340,8.6
8,7,Archuleta,2011,5739,5140,599,10.4
8,9,Baca,2011,2061,1958,103,5.0
8,11,Bent,2011,1925,1760,165,8.6
8,13,Boulder,2011,171585,160020,11565,6.7
8,14,Broomfield/city,2011,31684,29377,2307,7.3
8,15,Chaffee,2011,8282,7659,623,7.5
8,17,Cheyenne,2011,1047,1001,46,4.4
8,19,Clear Creek,2011,5485,5066,419,7.6
8,21,Conejos,2011,3723,3319,404,10.9
8,23,Costilla,2011,1580,1389,191,12.1
8,25,Crowley,2011,1486,1349,137,9.2
8,27,Custer,2011,2012,1879,133,6.6
8,29,Delta,2011,14388,12834,1554,10.8
8,31,Denver/city,2011,351436,320182,31254,8.9
8,33,Dolores,2011,947,821,126,13.3
8,35,Douglas,2011,157884,147339,10545,6.7
8,37,Eagle,2011,32072,29461,2611,8.1
8,39,Elbert,2011,12645,11660,985,7.8
8,41,El Paso,2011,306825,278004,28821,9.4
8,43,Fremont,2011,15913,13928,1985,12.5
8,45,Garfield,2011,31320,28248,3072,9.8
8,47,Gilpin,2011,3262,3017,245,7.5
8,49,Grand,2011,8777,8042,735,8.4
8,51,Gunnison,2011,9906,9284,622,6.3
8,53,Hinsdale,2011,471,446,25,5.3
8,55,Huerfano,2011,2659,2285,374,14.1
8,57,Jackson,2011,891,834,57,6.4
8,59,Jefferson,2011,301767,276822,24945,8.3
8,61,Kiowa,2011,833,790,43,5.2
8,63,Kit Carson,2011,4250,4042,208,4.9
8,65,Lake,2011,4370,3914,456,10.4
8,67,La Plata,2011,29402,27257,2145,7.3
8,69,Larimer,2011,170527,157831,12696,7.4
8,71,Las Animas,2011,6973,6174,799,11.5
8,73,Lincoln,2011,2187,2043,144,6.6
8,75,Logan,2011,11052,10331,721,6.5
8,77,Mesa,2011,75347,67366,7981,10.6
8,79,Mineral,2011,425,401,24,5.6
8,81,Moffat,2011,7851,7091,760,9.7
8,83,Montezuma,2011,12962,11785,1177,9.1
8,85,Montrose,2011,19990,17706,2284,11.4
8,87,Morgan,2011,15005,13963,1042,6.9
8,89,Otero,2011,8463,7587,876,10.4
8,91,Ouray,2011,2022,1807,215,10.6
8,93,Park,2011,9377,8636,741,7.9
8,95,Phillips,2011,2148,2028,120,5.6
8,97,Pitkin,2011,10904,10016,888,8.1
8,99,Prowers,2011,6228,5797,431,6.9
8,101,Pueblo,2011,75046,66842,8204,10.9
8,103,Rio Blanco,2011,3114,2858,256,8.2
8,105,Rio Grande,2011,5153,4494,659,12.8
8,107,Routt,2011,14255,13039,1216,8.5
8,109,Saguache,2011,3012,2664,348,11.6
8,111,San Juan,2011,521,458,63,12.1
8,113,San Miguel,2011,4873,4467,406,8.3
8,115,Sedgwick,2011,1094,1003,91,8.3
8,117,Summit,2011,19205,17904,1301,6.8
8,119,Teller,2011,12129,10964,1165,9.6
8,121,Washington,2011,2580,2434,146,5.7
8,123,Weld,2011,133960,122063,11897,8.9
8,125,Yuma,2011,4946,4675,271,5.5
9,1,Fairfield,2011,476820,436819,40001,8.4
9,3,Hartford,2011,479660,435309,44351,9.2
9,5,Litchfield,2011,107911,98937,8974,8.3
9,7,Middlesex,2011,93616,86315,7301,7.8
9,9,New Haven,2011,462617,416895,45722,9.9
9,11,New London,2011,143082,130112,12970,9.1
9,13,Tolland,2011,86299,79650,6649,7.7
9,15,Windham,2011,64441,57931,6510,10.1
10,1,Kent,2011,74196,68023,6173,8.3
10,3,New Castle,2011,277758,257356,20402,7.3
10,5,Sussex,2011,92017,84850,7167,7.8
11,1,District of Colu,2011,352193,316372,35821,10.2
12,1,Alachua,2011,128282,118574,9708,7.6
12,3,Baker,2011,11441,10274,1167,10.2
12,5,Bay,2011,86727,77872,8855,10.2
12,7,Bradford,2011,11439,10403,1036,9.1
12,9,Brevard,2011,263679,235001,28678,10.9
12,11,Broward,2011,946171,856799,89372,9.4
12,13,Calhoun,2011,5212,4672,540,10.4
12,15,Charlotte,2011,65342,57979,7363,11.3
12,17,Citrus,2011,51756,45289,6467,12.5
12,19,Clay,2011,95595,86914,8681,9.1
12,21,Collier,2011,147941,132970,14971,10.1
12,23,Columbia,2011,28080,25194,2886,10.3
12,27,DeSoto,2011,13811,12378,1433,10.4
12,29,Dixie,2011,5720,5018,702,12.3
12,31,Duval,2011,453697,407240,46457,10.2
12,33,Escambia,2011,139891,126413,13478,9.6
12,35,Flagler,2011,41691,36957,4734,11.4
12,37,Franklin,2011,5022,4639,383,7.6
12,39,Gadsden,2011,19500,17244,2256,11.6
12,41,Gilchrist,2011,6817,6116,701,10.3
12,43,Glades,2011,5261,4761,500,9.5
12,45,Gulf,2011,6203,5606,597,9.6
12,47,Hamilton,2011,4869,4364,505,10.4
12,49,Hardee,2011,11851,10658,1193,10.1
12,51,Hendry,2011,17853,15394,2459,13.8
12,53,Hernando,2011,65807,57597,8210,12.5
12,55,Highlands,2011,37930,33583,4347,11.5
12,57,Hillsborough,2011,657569,594729,62840,9.6
12,59,Holmes,2011,7156,6452,704,9.8
12,61,Indian River,2011,61573,53791,7782,12.6
12,63,Jackson,2011,18151,16438,1713,9.4
12,65,Jefferson,2011,5884,5293,591,10.0
12,67,Lafayette,2011,3615,3390,225,6.2
12,69,Lake,2011,133044,118993,14051,10.6
12,71,Lee,2011,285363,254435,30928,10.8
12,73,Leon,2011,149095,137538,11557,7.8
12,75,Levy,2011,16872,15039,1833,10.9
12,77,Liberty,2011,2846,2586,260,9.1
12,79,Madison,2011,8029,7262,767,9.6
12,81,Manatee,2011,147279,132628,14651,9.9
12,83,Marion,2011,130254,114256,15998,12.3
12,85,Martin,2011,66410,59867,6543,9.9
12,86,Miami-Dade,2011,1261955,1140476,121479,9.6
12,87,Monroe,2011,42535,39566,2969,7.0
12,89,Nassau,2011,35806,32372,3434,9.6
12,91,Okaloosa,2011,90385,83334,7051,7.8
12,93,Okeechobee,2011,17718,15607,2111,11.9
12,95,Orange,2011,638380,575967,62413,9.8
12,97,Osceola,2011,139454,123764,15690,11.3
12,99,Palm Beach,2011,648941,583845,65096,10.0
12,101,Pasco,2011,205503,183302,22201,10.8
12,103,Pinellas,2011,461249,416575,44674,9.7
12,105,Polk,2011,275294,244352,30942,11.2
12,107,Putnam,2011,29603,25822,3781,12.8
12,109,St. Johns,2011,100810,93024,7786,7.7
12,111,St. Lucie,2011,127910,111837,16073,12.6
12,113,Santa Rosa,2011,72241,66024,6217,8.6
12,115,Sarasota,2011,165867,148948,16919,10.2
12,117,Seminole,2011,229263,207265,21998,9.6
12,119,Sumter,2011,25901,22746,3155,12.2
12,121,Suwannee,2011,18751,17028,1723,9.2
12,123,Taylor,2011,9388,8445,943,10.0
12,125,Union,2011,5148,4727,421,8.2
12,127,Volusia,2011,236526,209938,26588,11.2
12,129,Wakulla,2011,14518,13322,1196,8.2
12,131,Walton,2011,26136,23914,2222,8.5
12,133,Washington,2011,10348,9316,1032,10.0
13,1,Appling,2011,8854,7770,1084,12.2
13,3,Atkinson,2011,3487,3044,443,12.7
13,5,Bacon,2011,4499,4030,469,10.4
13,7,Baker,2011,1170,1035,135,11.5
13,9,Baldwin,2011,18572,16037,2535,13.6
13,11,Banks,2011,8490,7712,778,9.2
13,13,Barrow,2011,34550,31141,3409,9.9
13,15,Bartow,2011,47656,42235,5421,11.4
13,17,Ben Hill,2011,6237,5273,964,15.5
13,19,Berrien,2011,7850,6879,971,12.4
13,21,Bibb,2011,71063,62969,8094,11.4
13,23,Bleckley,2011,5478,4754,724,13.2
13,25,Brantley,2011,7450,6474,976,13.1
13,27,Brooks,2011,7053,6353,700,9.9
13,29,Bryan,2011,14691,13329,1362,9.3
13,31,Bulloch,2011,33430,29946,3484,10.4
13,33,Burke,2011,9930,8681,1249,12.6
13,35,Butts,2011,10434,9260,1174,11.3
13,37,Calhoun,2011,2515,2307,208,8.3
13,39,Camden,2011,21111,19112,1999,9.5
13,43,Candler,2011,5021,4544,477,9.5
13,45,Carroll,2011,51829,45973,5856,11.3
13,47,Catoosa,2011,32002,29402,2600,8.1
13,49,Charlton,2011,4955,4433,522,10.5
13,51,Chatham,2011,129417,116527,12890,10.0
13,53,Chattahoochee,2011,2363,2093,270,11.4
13,55,Chattooga,2011,10554,9401,1153,10.9
13,57,Cherokee,2011,113630,104432,9198,8.1
13,59,Clarke,2011,57069,51801,5268,9.2
13,61,Clay,2011,1063,934,129,12.1
13,63,Clayton,2011,126710,109832,16878,13.3
13,65,Clinch,2011,2882,2569,313,10.9
13,67,Cobb,2011,383975,350357,33618,8.8
13,69,Coffee,2011,17563,15320,2243,12.8
13,71,Colquitt,2011,21189,19197,1992,9.4
13,73,Columbia,2011,63212,58606,4606,7.3
13,75,Cook,2011,7584,6739,845,11.1
13,77,Coweta,2011,64884,59061,5823,9.0
13,79,Crawford,2011,5798,5175,623,10.7
13,81,Crisp,2011,9180,7915,1265,13.8
13,83,Dade,2011,8349,7689,660,7.9
13,85,Dawson,2011,10863,9769,1094,10.1
13,87,Decatur,2011,12039,10608,1431,11.9
13,89,DeKalb,2011,365804,327592,38212,10.4
13,91,Dodge,2011,8275,7266,1009,12.2
13,93,Dooly,2011,4778,4160,618,12.9
13,95,Dougherty,2011,41182,36196,4986,12.1
13,97,Douglas,2011,66842,59644,7198,10.8
13,99,Early,2011,4440,3934,506,11.4
13,101,Echols,2011,1875,1725,150,8.0
13,103,Effingham,2011,25592,23227,2365,9.2
13,105,Elbert,2011,8772,7370,1402,16.0
13,107,Emanuel,2011,9147,7936,1211,13.2
13,109,Evans,2011,4800,4365,435,9.1
13,111,Fannin,2011,10252,9103,1149,11.2
13,113,Fayette,2011,53127,48908,4219,7.9
13,115,Floyd,2011,44760,39398,5362,12.0
13,117,Forsyth,2011,90893,84225,6668,7.3
13,119,Franklin,2011,9728,8557,1171,12.0
13,121,Fulton,2011,497801,447564,50237,10.1
13,123,Gilmer,2011,12343,10905,1438,11.7
13,125,Glascock,2011,1333,1192,141,10.6
13,127,Glynn,2011,38179,34231,3948,10.3
13,129,Gordon,2011,26207,23174,3033,11.6
13,131,Grady,2011,10831,9807,1024,9.5
13,133,Greene,2011,6365,5586,779,12.2
13,135,Gwinnett,2011,426386,389527,36859,8.6
13,137,Habersham,2011,18297,16393,1904,10.4
13,139,Hall,2011,87580,79868,7712,8.8
13,141,Hancock,2011,2952,2372,580,19.6
13,143,Haralson,2011,12233,10822,1411,11.5
13,145,Harris,2011,16370,15168,1202,7.3
13,147,Hart,2011,11120,9887,1233,11.1
13,149,Heard,2011,5157,4579,578,11.2
13,151,Henry,2011,102488,91988,10500,10.2
13,153,Houston,2011,68223,62446,5777,8.5
13,155,Irwin,2011,3532,3051,481,13.6
13,157,Jackson,2011,28848,26108,2740,9.5
13,159,Jasper,2011,6781,6041,740,10.9
13,161,Jeff Davis,2011,6496,5686,810,12.5
13,163,Jefferson,2011,7104,6171,933,13.1
13,165,Jenkins,2011,3198,2743,455,14.2
13,167,Johnson,2011,4153,3699,454,10.9
13,169,Jones,2011,13787,12530,1257,9.1
13,171,Lamar,2011,8097,6995,1102,13.6
13,173,Lanier,2011,3944,3533,411,10.4
13,175,Laurens,2011,20258,17475,2783,13.7
13,177,Lee,2011,14302,13105,1197,8.4
13,179,Liberty,2011,27536,24989,2547,9.2
13,181,Lincoln,2011,3629,3212,417,11.5
13,183,Long,2011,6364,5803,561,8.8
13,185,Lowndes,2011,51276,46228,5048,9.8
13,187,Lumpkin,2011,14850,13415,1435,9.7
13,189,McDuffie,2011,9384,8142,1242,13.2
13,191,McIntosh,2011,6175,5525,650,10.5
13,193,Macon,2011,5267,4545,722,13.7
13,195,Madison,2011,13206,11873,1333,10.1
13,197,Marion,2011,3674,3294,380,10.3
13,199,Meriwether,2011,9221,8001,1220,13.2
13,201,Miller,2011,2735,2484,251,9.2
13,205,Mitchell,2011,9502,8559,943,9.9
13,207,Monroe,2011,12718,11490,1228,9.7
13,209,Montgomery,2011,3905,3393,512,13.1
13,211,Morgan,2011,8622,7763,859,10.0
13,213,Murray,2011,17017,14676,2341,13.8
13,215,Muscogee,2011,82742,74480,8262,10.0
13,217,Newton,2011,48301,42380,5921,12.3
13,219,Oconee,2011,16879,15710,1169,6.9
13,221,Oglethorpe,2011,6990,6313,677,9.7
13,223,Paulding,2011,74145,67149,6996,9.4
13,225,Peach,2011,12663,11178,1485,11.7
13,227,Pickens,2011,14039,12569,1470,10.5
13,229,Pierce,2011,8083,7228,855,10.6
13,231,Pike,2011,8420,7569,851,10.1
13,233,Polk,2011,18655,16514,2141,11.5
13,235,Pulaski,2011,4480,4051,429,9.6
13,237,Putnam,2011,8650,7533,1117,12.9
13,239,Quitman,2011,977,878,99,10.1
13,241,Rabun,2011,7018,6156,862,12.3
13,243,Randolph,2011,2937,2566,371,12.6
13,245,Richmond,2011,88308,78477,9831,11.1
13,247,Rockdale,2011,42157,37477,4680,11.1
13,249,Schley,2011,2157,1912,245,11.4
13,251,Screven,2011,5752,4852,900,15.6
13,253,Seminole,2011,3268,2857,411,12.6
13,255,Spalding,2011,28500,24543,3957,13.9
13,257,Stephens,2011,11722,10329,1393,11.9
13,259,Stewart,2011,2329,2106,223,9.6
13,261,Sumter,2011,13899,12170,1729,12.4
13,263,Talbot,2011,2915,2609,306,10.5
13,265,Taliaferro,2011,617,521,96,15.6
13,267,Tattnall,2011,9853,8996,857,8.7
13,269,Taylor,2011,3171,2718,453,14.3
13,271,Telfair,2011,5268,4579,689,13.1
13,273,Terrell,2011,3842,3385,457,11.9
13,275,Thomas,2011,18314,16420,1894,10.3
13,277,Tift,2011,18901,16635,2266,12.0
13,279,Toombs,2011,12407,10755,1652,13.3
13,281,Towns,2011,4349,3807,542,12.5
13,283,Treutlen,2011,2981,2589,392,13.1
13,285,Troup,2011,34427,30672,3755,10.9
13,287,Turner,2011,3589,3081,508,14.2
13,289,Twiggs,2011,3246,2748,498,15.3
13,291,Union,2011,9467,8508,959,10.1
13,293,Upson,2011,11986,10610,1376,11.5
13,295,Walker,2011,31016,27996,3020,9.7
13,297,Walton,2011,41135,36890,4245,10.3
13,299,Ware,2011,15244,13542,1702,11.2
13,301,Warren,2011,2640,2206,434,16.4
13,303,Washington,2011,8097,7075,1022,12.6
13,305,Wayne,2011,12470,10973,1497,12.0
13,307,Webster,2011,1066,944,122,11.4
13,309,Wheeler,2011,1978,1688,290,14.7
13,311,White,2011,13142,11848,1294,9.8
13,313,Whitfield,2011,47341,41802,5539,11.7
13,315,Wilcox,2011,2926,2555,371,12.7
13,317,Wilkes,2011,3922,3381,541,13.8
13,319,Wilkinson,2011,3768,3285,483,12.8
13,321,Worth,2011,9777,8660,1117,11.4
15,1,Hawaii,2011,89478,80752,8726,9.8
15,3,Honolulu/city,2011,454249,427287,26962,5.9
15,7,Kauai,2011,35588,32535,3053,8.6
15,9,Maui,2011,81320,74896,6424,7.9
16,1,Ada,2011,200106,185656,14450,7.2
16,3,Adams,2011,1737,1433,304,17.5
16,5,Bannock,2011,41010,37992,3018,7.4
16,7,Bear Lake,2011,2919,2745,174,6.0
16,9,Benewah,2011,4140,3601,539,13.0
16,11,Bingham,2011,22816,21226,1590,7.0
16,13,Blaine,2011,11870,10850,1020,8.6
16,15,Boise,2011,3059,2749,310,10.1
16,17,Bonner,2011,19012,16700,2312,12.2
16,19,Bonneville,2011,49274,45938,3336,6.8
16,21,Boundary,2011,5375,4764,611,11.4
16,23,Butte,2011,1322,1217,105,7.9
16,25,Camas,2011,638,560,78,12.2
16,27,Canyon,2011,85454,76517,8937,10.5
16,29,Caribou,2011,3879,3596,283,7.3
16,31,Cassia,2011,11182,10462,720,6.4
16,33,Clark,2011,515,470,45,8.7
16,35,Clearwater,2011,3344,2897,447,13.4
16,37,Custer,2011,2297,2119,178,7.7
16,39,Elmore,2011,10994,10095,899,8.2
16,41,Franklin,2011,6244,5914,330,5.3
16,43,Fremont,2011,6700,6190,510,7.6
16,45,Gem,2011,7699,6877,822,10.7
16,47,Gooding,2011,8345,7793,552,6.6
16,49,Idaho,2011,6670,5863,807,12.1
16,51,Jefferson,2011,12494,11648,846,6.8
16,53,Jerome,2011,11012,10200,812,7.4
16,55,Kootenai,2011,69223,62318,6905,10.0
16,57,Latah,2011,19231,18050,1181,6.1
16,59,Lemhi,2011,3661,3292,369,10.1
16,61,Lewis,2011,1553,1458,95,6.1
16,63,Lincoln,2011,2678,2362,316,11.8
16,65,Madison,2011,17887,16965,922,5.2
16,67,Minidoka,2011,10549,9834,715,6.8
16,69,Nez Perce,2011,20069,18822,1247,6.2
16,71,Oneida,2011,2015,1901,114,5.7
16,73,Owyhee,2011,4883,4676,207,4.2
16,75,Payette,2011,11156,10165,991,8.9
16,77,Power,2011,3923,3585,338,8.6
16,79,Shoshone,2011,5496,4716,780,14.2
16,81,Teton,2011,5322,4970,352,6.6
16,83,Twin Falls,2011,37082,34201,2881,7.8
16,85,Valley,2011,4644,3999,645,13.9
16,87,Washington,2011,4729,4275,454,9.6
17,1,Adams,2011,34376,32000,2376,6.9
17,3,Alexander,2011,2889,2516,373,12.9
17,5,Bond,2011,8488,7694,794,9.4
17,7,Boone,2011,27128,23924,3204,11.8
17,9,Brown,2011,2589,2428,161,6.2
17,11,Bureau,2011,18740,16880,1860,9.9
17,13,Calhoun,2011,2497,2253,244,9.8
17,15,Carroll,2011,8302,7553,749,9.0
17,17,Cass,2011,6893,6327,566,8.2
17,19,Champaign,2011,108163,99976,8187,7.6
17,21,Christian,2011,16845,15223,1622,9.6
17,23,Clark,2011,8114,7271,843,10.4
17,25,Clay,2011,6689,5977,712,10.6
17,27,Clinton,2011,20695,19300,1395,6.7
17,29,Coles,2011,24787,22449,2338,9.4
17,31,Cook,2011,2622338,2345151,277187,10.6
17,33,Crawford,2011,10816,10027,789,7.3
17,35,Cumberland,2011,5938,5425,513,8.6
17,37,DeKalb,2011,55778,50556,5222,9.4
17,39,De Witt,2011,8737,7996,741,8.5
17,41,Douglas,2011,10191,9370,821,8.1
17,43,DuPage,2011,499322,457774,41548,8.3
17,45,Edgar,2011,9329,8348,981,10.5
17,47,Edwards,2011,3135,2880,255,8.1
17,49,Effingham,2011,18646,17361,1285,6.9
17,51,Fayette,2011,11155,10124,1031,9.2
17,53,Ford,2011,7129,6519,610,8.6
17,55,Franklin,2011,17609,15637,1972,11.2
17,57,Fulton,2011,17424,15589,1835,10.5
17,59,Gallatin,2011,2576,2347,229,8.9
17,61,Greene,2011,6701,6116,585,8.7
17,63,Grundy,2011,25612,22320,3292,12.9
17,65,Hamilton,2011,3914,3575,339,8.7
17,67,Hancock,2011,9623,8739,884,9.2
17,69,Hardin,2011,1749,1560,189,10.8
17,71,Henderson,2011,3854,3546,308,8.0
17,73,Henry,2011,26593,24508,2085,7.8
17,75,Iroquois,2011,15644,14192,1452,9.3
17,77,Jackson,2011,29629,27260,2369,8.0
17,79,Jasper,2011,4997,4607,390,7.8
17,81,Jefferson,2011,18172,16473,1699,9.3
17,83,Jersey,2011,11582,10544,1038,9.0
17,85,Jo Daviess,2011,12130,11166,964,7.9
17,87,Johnson,2011,4393,3877,516,11.7
17,89,Kane,2011,267705,241479,26226,9.8
17,91,Kankakee,2011,55846,49322,6524,11.7
17,93,Kendall,2011,62274,56414,5860,9.4
17,95,Knox,2011,24846,22658,2188,8.8
17,97,Lake,2011,367799,335081,32718,8.9
17,99,LaSalle,2011,60850,54331,6519,10.7
17,101,Lawrence,2011,6575,5871,704,10.7
17,103,Lee,2011,18826,17118,1708,9.1
17,105,Livingston,2011,18841,17242,1599,8.5
17,107,Logan,2011,13696,12629,1067,7.8
17,109,McDonough,2011,15139,13940,1199,7.9
17,111,McHenry,2011,165889,149281,16608,10.0
17,113,McLean,2011,95765,89448,6317,6.6
17,115,Macon,2011,55219,49724,5495,10.0
17,117,Macoupin,2011,24754,22344,2410,9.7
17,119,Madison,2011,137700,125357,12343,9.0
17,121,Marion,2011,19117,17196,1921,10.0
17,123,Marshall,2011,6339,5774,565,8.9
17,125,Mason,2011,7168,6404,764,10.7
17,127,Massac,2011,7118,6486,632,8.9
17,129,Menard,2011,7039,6524,515,7.3
17,131,Mercer,2011,8868,8125,743,8.4
17,133,Monroe,2011,18111,16892,1219,6.7
17,135,Montgomery,2011,13637,12007,1630,12.0
17,137,Morgan,2011,18086,16629,1457,8.1
17,139,Moultrie,2011,7461,6894,567,7.6
17,141,Ogle,2011,27416,24270,3146,11.5
17,143,Peoria,2011,96158,87252,8906,9.3
17,145,Perry,2011,9462,8496,966,10.2
17,147,Piatt,2011,9014,8392,622,6.9
17,149,Pike,2011,7914,7276,638,8.1
17,151,Pope,2011,1970,1796,174,8.8
17,153,Pulaski,2011,2357,2075,282,12.0
17,155,Putnam,2011,3199,2869,330,10.3
17,157,Randolph,2011,14799,13572,1227,8.3
17,159,Richland,2011,7802,7160,642,8.2
17,161,Rock Island,2011,76237,69763,6474,8.5
17,163,St. Clair,2011,132746,119838,12908,9.7
17,165,Saline,2011,11651,10542,1109,9.5
17,167,Sangamon,2011,107363,99273,8090,7.5
17,169,Schuyler,2011,3769,3466,303,8.0
17,171,Scott,2011,2843,2608,235,8.3
17,173,Shelby,2011,11029,10024,1005,9.1
17,175,Stark,2011,2973,2711,262,8.8
17,177,Stephenson,2011,24198,21822,2376,9.8
17,179,Tazewell,2011,71499,65546,5953,8.3
17,181,Union,2011,7756,6851,905,11.7
17,183,Vermilion,2011,37405,33669,3736,10.0
17,185,Wabash,2011,5809,5292,517,8.9
17,187,Warren,2011,9123,8464,659,7.2
17,189,Washington,2011,8714,8137,577,6.6
17,191,Wayne,2011,8205,7546,659,8.0
17,193,White,2011,7420,6833,587,7.9
17,195,Whiteside,2011,29647,26843,2804,9.5
17,197,Will,2011,352460,314639,37821,10.7
17,199,Williamson,2011,32317,29384,2933,9.1
17,201,Winnebago,2011,147218,129684,17534,11.9
17,203,Woodford,2011,20487,19167,1320,6.4
18,1,Adams,2011,16192,14955,1237,7.6
18,3,Allen,2011,176618,160474,16144,9.1
18,5,Bartholomew,2011,40123,37140,2983,7.4
18,7,Benton,2011,4654,4295,359,7.7
18,9,Blackford,2011,5632,4954,678,12.0
18,11,Boone,2011,29896,27932,1964,6.6
18,13,Brown,2011,7446,6775,671,9.0
18,15,Carroll,2011,10149,9322,827,8.1
18,17,Cass,2011,18219,16538,1681,9.2
18,19,Clark,2011,55676,50825,4851,8.7
18,21,Clay,2011,13023,11696,1327,10.2
18,23,Clinton,2011,16788,15370,1418,8.4
18,25,Crawford,2011,4875,4308,567,11.6
18,27,Daviess,2011,14930,14039,891,6.0
18,29,Dearborn,2011,25399,22997,2402,9.5
18,31,Decatur,2011,13041,11791,1250,9.6
18,33,DeKalb,2011,20531,18581,1950,9.5
18,35,Delaware,2011,54745,49312,5433,9.9
18,37,Dubois,2011,22002,20695,1307,5.9
18,39,Elkhart,2011,95546,85490,10056,10.5
18,41,Fayette,2011,9526,8353,1173,12.3
18,43,Floyd,2011,37854,34902,2952,7.8
18,45,Fountain,2011,8642,7830,812,9.4
18,47,Franklin,2011,11241,10137,1104,9.8
18,49,Fulton,2011,10223,9298,925,9.0
18,51,Gibson,2011,17326,16084,1242,7.2
18,53,Grant,2011,33504,30096,3408,10.2
18,55,Greene,2011,14212,12764,1448,10.2
18,57,Hamilton,2011,148561,140111,8450,5.7
18,59,Hancock,2011,35871,32988,2883,8.0
18,61,Harrison,2011,18818,17169,1649,8.8
18,63,Hendricks,2011,76220,71016,5204,6.8
18,65,Henry,2011,21323,18919,2404,11.3
18,67,Howard,2011,36120,32428,3692,10.2
18,69,Huntington,2011,19190,17344,1846,9.6
18,71,Jackson,2011,20601,18833,1768,8.6
18,73,Jasper,2011,16131,14698,1433,8.9
18,75,Jay,2011,10555,9624,931,8.8
18,77,Jefferson,2011,15210,13746,1464,9.6
18,79,Jennings,2011,13362,11854,1508,11.3
18,81,Johnson,2011,72215,66756,5459,7.6
18,83,Knox,2011,18508,17157,1351,7.3
18,85,Kosciusko,2011,39067,35643,3424,8.8
18,87,LaGrange,2011,16703,15233,1470,8.8
18,89,Lake,2011,229759,208263,21496,9.4
18,91,LaPorte,2011,50555,45414,5141,10.2
18,93,Lawrence,2011,20824,18454,2370,11.4
18,95,Madison,2011,58924,52634,6290,10.7
18,97,Marion,2011,456896,412726,44170,9.7
18,99,Marshall,2011,23503,21322,2181,9.3
18,101,Martin,2011,5361,4965,396,7.4
18,103,Miami,2011,15968,14334,1634,10.2
18,105,Monroe,2011,67738,62739,4999,7.4
18,107,Montgomery,2011,18750,17128,1622,8.7
18,109,Morgan,2011,34966,31773,3193,9.1
18,111,Newton,2011,7005,6327,678,9.7
18,113,Noble,2011,23179,20891,2288,9.9
18,115,Ohio,2011,3218,2918,300,9.3
18,117,Orange,2011,8877,7850,1027,11.6
18,119,Owen,2011,10159,9037,1122,11.0
18,121,Parke,2011,7208,6470,738,10.2
18,123,Perry,2011,9086,8273,813,8.9
18,125,Pike,2011,6250,5769,481,7.7
18,127,Porter,2011,82497,75892,6605,8.0
18,129,Posey,2011,13457,12552,905,6.7
18,131,Pulaski,2011,6417,5909,508,7.9
18,133,Putnam,2011,16626,14863,1763,10.6
18,135,Randolph,2011,13049,11722,1327,10.2
18,137,Ripley,2011,14968,13585,1383,9.2
18,139,Rush,2011,8605,7800,805,9.4
18,141,St. Joseph,2011,130857,117889,12968,9.9
18,143,Scott,2011,10394,9186,1208,11.6
18,145,Shelby,2011,22563,20468,2095,9.3
18,147,Spencer,2011,11060,10230,830,7.5
18,149,Starke,2011,10350,9193,1157,11.2
18,151,Steuben,2011,18608,16975,1633,8.8
18,153,Sullivan,2011,8909,8098,811,9.1
18,155,Switzerland,2011,5001,4600,401,8.0
18,157,Tippecanoe,2011,87661,81267,6394,7.3
18,159,Tipton,2011,7974,7271,703,8.8
18,161,Union,2011,3674,3358,316,8.6
18,163,Vanderburgh,2011,92968,85708,7260,7.8
18,165,Vermillion,2011,7659,6778,881,11.5
18,167,Vigo,2011,50629,45505,5124,10.1
18,169,Wabash,2011,15739,14266,1473,9.4
18,171,Warren,2011,4286,3941,345,8.0
18,173,Warrick,2011,31201,29035,2166,6.9
18,175,Washington,2011,13540,12133,1407,10.4
18,177,Wayne,2011,31046,27666,3380,10.9
18,179,Wells,2011,14084,12948,1136,8.1
18,181,White,2011,13142,12027,1115,8.5
18,183,Whitley,2011,17362,15777,1585,9.1
19,1,Adair,2011,4113,3910,203,4.9
19,3,Adams,2011,2218,2118,100,4.5
19,5,Allamakee,2011,7781,7213,568,7.3
19,7,Appanoose,2011,6080,5652,428,7.0
19,9,Audubon,2011,3378,3181,197,5.8
19,11,Benton,2011,14179,13343,836,5.9
19,13,Black Hawk,2011,71234,67006,4228,5.9
19,15,Boone,2011,14720,13977,743,5.0
19,17,Bremer,2011,13901,13283,618,4.4
19,19,Buchanan,2011,11215,10570,645,5.8
19,21,Buena Vista,2011,11385,10862,523,4.6
19,23,Butler,2011,8206,7786,420,5.1
19,25,Calhoun,2011,4528,4266,262,5.8
19,27,Carroll,2011,11659,11180,479,4.1
19,29,Cass,2011,7321,6877,444,6.1
19,31,Cedar,2011,10920,10346,574,5.3
19,33,Cerro Gordo,2011,24266,22754,1512,6.2
19,35,Cherokee,2011,6965,6628,337,4.8
19,37,Chickasaw,2011,6520,6104,416,6.4
19,39,Clarke,2011,4707,4371,336,7.1
19,41,Clay,2011,9293,8778,515,5.5
19,43,Clayton,2011,10386,9735,651,6.3
19,45,Clinton,2011,25977,24224,1753,6.7
19,47,Crawford,2011,8856,8429,427,4.8
19,49,Dallas,2011,38374,36706,1668,4.3
19,51,Davis,2011,4207,3945,262,6.2
19,53,Decatur,2011,4361,4140,221,5.1
19,55,Delaware,2011,10298,9725,573,5.6
19,57,Des Moines,2011,20398,18998,1400,6.9
19,59,Dickinson,2011,9298,8702,596,6.4
19,61,Dubuque,2011,54611,51803,2808,5.1
19,63,Emmet,2011,5813,5481,332,5.7
19,65,Fayette,2011,11088,10388,700,6.3
19,67,Floyd,2011,8330,7780,550,6.6
19,69,Franklin,2011,5995,5683,312,5.2
19,71,Fremont,2011,3986,3751,235,5.9
19,73,Greene,2011,5211,4915,296,5.7
19,75,Grundy,2011,6731,6390,341,5.1
19,77,Guthrie,2011,5715,5360,355,6.2
19,79,Hamilton,2011,7507,6833,674,9.0
19,81,Hancock,2011,5963,5624,339,5.7
19,83,Hardin,2011,9025,8486,539,6.0
19,85,Harrison,2011,7852,7409,443,5.6
19,87,Henry,2011,9874,9192,682,6.9
19,89,Howard,2011,5345,5053,292,5.5
19,91,Humboldt,2011,5192,4926,266,5.1
19,93,Ida,2011,3809,3621,188,4.9
19,95,Iowa,2011,9648,9158,490,5.1
19,97,Jackson,2011,11044,10311,733,6.6
19,99,Jasper,2011,18693,17416,1277,6.8
19,101,Jefferson,2011,8856,8316,540,6.1
19,103,Johnson,2011,80001,76712,3289,4.1
19,105,Jones,2011,10963,10315,648,5.9
19,107,Keokuk,2011,5496,5154,342,6.2
19,109,Kossuth,2011,8388,8016,372,4.4
19,111,Lee,2011,17518,16073,1445,8.2
19,113,Linn,2011,119906,112974,6932,5.8
19,115,Louisa,2011,5931,5563,368,6.2
19,117,Lucas,2011,4203,3977,226,5.4
19,119,Lyon,2011,6802,6586,216,3.2
19,121,Madison,2011,8310,7807,503,6.1
19,123,Mahaska,2011,11886,11181,705,5.9
19,125,Marion,2011,17236,16283,953,5.5
19,127,Marshall,2011,20138,18791,1347,6.7
19,129,Mills,2011,7478,7102,376,5.0
19,131,Mitchell,2011,5676,5402,274,4.8
19,133,Monona,2011,4796,4458,338,7.0
19,135,Monroe,2011,4052,3775,277,6.8
19,137,Montgomery,2011,5055,4754,301,6.0
19,139,Muscatine,2011,21512,20068,1444,6.7
19,141,O'Brien,2011,8137,7791,346,4.3
19,143,Osceola,2011,3543,3382,161,4.5
19,145,Page,2011,6889,6487,402,5.8
19,147,Palo Alto,2011,4795,4565,230,4.8
19,149,Plymouth,2011,14307,13658,649,4.5
19,151,Pocahontas,2011,4098,3915,183,4.5
19,153,Polk,2011,244046,229969,14077,5.8
19,155,Pottawattamie,2011,49755,46925,2830,5.7
19,157,Poweshiek,2011,10442,9850,592,5.7
19,159,Ringgold,2011,2611,2489,122,4.7
19,161,Sac,2011,5641,5387,254,4.5
19,163,Scott,2011,87484,82023,5461,6.2
19,165,Shelby,2011,6744,6448,296,4.4
19,167,Sioux,2011,19609,18873,736,3.8
19,169,Story,2011,53428,51283,2145,4.0
19,171,Tama,2011,9230,8657,573,6.2
19,173,Taylor,2011,3165,3012,153,4.8
19,175,Union,2011,6988,6614,374,5.4
19,177,Van Buren,2011,3867,3618,249,6.4
19,179,Wapello,2011,18209,16877,1332,7.3
19,181,Warren,2011,26064,24689,1375,5.3
19,183,Washington,2011,12365,11775,590,4.8
19,185,Wayne,2011,2836,2676,160,5.6
19,187,Webster,2011,19871,18458,1413,7.1
19,189,Winnebago,2011,5469,5133,336,6.1
19,191,Winneshiek,2011,12164,11548,616,5.1
19,193,Woodbury,2011,54800,51601,3199,5.8
19,195,Worth,2011,4307,4027,280,6.5
19,197,Wright,2011,6819,6343,476,7.0
20,1,Allen,2011,7062,6505,557,7.9
20,3,Anderson,2011,4510,4172,338,7.5
20,5,Atchison,2011,7960,7251,709,8.9
20,7,Barber,2011,2792,2682,110,3.9
20,9,Barton,2011,15110,14335,775,5.1
20,11,Bourbon,2011,6906,6296,610,8.8
20,13,Brown,2011,5211,4905,306,5.9
20,15,Butler,2011,32591,30346,2245,6.9
20,17,Chase,2011,1344,1272,72,5.4
20,19,Chautauqua,2011,1706,1568,138,8.1
20,21,Cherokee,2011,10851,9982,869,8.0
20,23,Cheyenne,2011,1354,1296,58,4.3
20,25,Clark,2011,1218,1172,46,3.8
20,27,Clay,2011,4410,4165,245,5.6
20,29,Cloud,2011,4549,4304,245,5.4
20,31,Coffey,2011,4670,4309,361,7.7
20,33,Comanche,2011,985,943,42,4.3
20,35,Cowley,2011,17176,15989,1187,6.9
20,37,Crawford,2011,19253,17755,1498,7.8
20,39,Decatur,2011,1423,1355,68,4.8
20,41,Dickinson,2011,10157,9497,660,6.5
20,43,Doniphan,2011,4473,4129,344,7.7
20,45,Douglas,2011,64059,60492,3567,5.6
20,47,Edwards,2011,1673,1599,74,4.4
20,49,Elk,2011,1388,1284,104,7.5
20,51,Ellis,2011,17935,17310,625,3.5
20,53,Ellsworth,2011,3508,3368,140,4.0
20,55,Finney,2011,20848,19972,876,4.2
20,57,Ford,2011,18365,17585,780,4.2
20,59,Franklin,2011,14041,12891,1150,8.2
20,61,Geary,2011,13231,12034,1197,9.0
20,63,Gove,2011,1505,1456,49,3.3
20,65,Graham,2011,1423,1365,58,4.1
20,67,Grant,2011,4124,3954,170,4.1
20,69,Gray,2011,3603,3486,117,3.2
20,71,Greeley,2011,847,821,26,3.1
20,73,Greenwood,2011,3481,3254,227,6.5
20,75,Hamilton,2011,1756,1707,49,2.8
20,77,Harper,2011,2909,2747,162,5.6
20,79,Harvey,2011,17468,16425,1043,6.0
20,81,Haskell,2011,2427,2343,84,3.5
20,83,Hodgeman,2011,1115,1073,42,3.8
20,85,Jackson,2011,7455,7014,441,5.9
20,87,Jefferson,2011,10498,9763,735,7.0
20,89,Jewell,2011,1535,1464,71,4.6
20,91,Johnson,2011,309822,293473,16349,5.3
20,93,Kearny,2011,2190,2095,95,4.3
20,95,Kingman,2011,3842,3600,242,6.3
20,97,Kiowa,2011,1351,1294,57,4.2
20,99,Labette,2011,11081,10097,984,8.9
20,101,Lane,2011,964,920,44,4.6
20,103,Leavenworth,2011,34579,32103,2476,7.2
20,105,Lincoln,2011,1886,1790,96,5.1
20,107,Linn,2011,4519,4023,496,11.0
20,109,Logan,2011,1783,1726,57,3.2
20,111,Lyon,2011,17415,16316,1099,6.3
20,113,McPherson,2011,16737,15985,752,4.5
20,115,Marion,2011,6503,6140,363,5.6
20,117,Marshall,2011,6022,5746,276,4.6
20,119,Meade,2011,2547,2454,93,3.7
20,121,Miami,2011,16993,15788,1205,7.1
20,123,Mitchell,2011,3913,3774,139,3.6
20,125,Montgomery,2011,18348,16554,1794,9.8
20,127,Morris,2011,3304,3087,217,6.6
20,129,Morton,2011,1683,1622,61,3.6
20,131,Nemaha,2011,5931,5705,226,3.8
20,133,Neosho,2011,7435,6752,683,9.2
20,135,Ness,2011,1631,1577,54,3.3
20,137,Norton,2011,3154,3045,109,3.5
20,139,Osage,2011,8602,7903,699,8.1
20,141,Osborne,2011,2272,2172,100,4.4
20,143,Ottawa,2011,3286,3100,186,5.7
20,145,Pawnee,2011,3499,3341,158,4.5
20,147,Phillips,2011,3034,2883,151,5.0
20,149,Pottawatomie,2011,11622,11051,571,4.9
20,151,Pratt,2011,5390,5121,269,5.0
20,153,Rawlins,2011,1527,1474,53,3.5
20,155,Reno,2011,32794,30843,1951,5.9
20,157,Republic,2011,2697,2595,102,3.8
20,159,Rice,2011,5415,5139,276,5.1
20,161,Riley,2011,35606,33921,1685,4.7
20,163,Rooks,2011,2740,2596,144,5.3
20,165,Rush,2011,1850,1770,80,4.3
20,167,Russell,2011,3803,3628,175,4.6
20,169,Saline,2011,30909,29059,1850,6.0
20,171,Scott,2011,2739,2638,101,3.7
20,173,Sedgwick,2011,250260,230687,19573,7.8
20,175,Seward,2011,10875,10381,494,4.5
20,177,Shawnee,2011,93368,87134,6234,6.7
20,179,Sheridan,2011,1534,1486,48,3.1
20,181,Sherman,2011,3221,3093,128,4.0
20,183,Smith,2011,2277,2187,90,4.0
20,185,Stafford,2011,2328,2211,117,5.0
20,187,Stanton,2011,1069,1027,42,3.9
20,189,Stevens,2011,2780,2669,111,4.0
20,191,Sumner,2011,11624,10749,875,7.5
20,193,Thomas,2011,4624,4457,167,3.6
20,195,Trego,2011,1501,1432,69,4.6
20,197,Wabaunsee,2011,3854,3617,237,6.1
20,199,Wallace,2011,886,838,48,5.4
20,201,Washington,2011,3325,3176,149,4.5
20,203,Wichita,2011,1336,1285,51,3.8
20,205,Wilson,2011,4286,3803,483,11.3
20,207,Woodson,2011,1726,1611,115,6.7
20,209,Wyandotte,2011,74813,67823,6990,9.3
21,1,Adair,2011,7766,6854,912,11.7
21,3,Allen,2011,9133,8238,895,9.8
21,5,Anderson,2011,11596,10633,963,8.3
21,7,Ballard,2011,3894,3507,387,9.9
21,9,Barren,2011,19939,17991,1948,9.8
21,11,Bath,2011,4846,4236,610,12.6
21,13,Bell,2011,10214,9001,1213,11.9
21,15,Boone,2011,64380,59345,5035,7.8
21,17,Bourbon,2011,10071,9224,847,8.4
21,19,Boyd,2011,20304,18214,2090,10.3
21,21,Boyle,2011,13192,11776,1416,10.7
21,23,Bracken,2011,3990,3563,427,10.7
21,25,Breathitt,2011,4421,3858,563,12.7
21,27,Breckinridge,2011,8299,7343,956,11.5
21,29,Bullitt,2011,39048,35177,3871,9.9
21,31,Butler,2011,5464,4880,584,10.7
21,33,Caldwell,2011,5712,5164,548,9.6
21,35,Calloway,2011,19067,17643,1424,7.5
21,37,Campbell,2011,48928,44884,4044,8.3
21,39,Carlisle,2011,2312,2107,205,8.9
21,41,Carroll,2011,5122,4500,622,12.1
21,43,Carter,2011,11723,10108,1615,13.8
21,45,Casey,2011,6997,6300,697,10.0
21,47,Christian,2011,26876,23983,2893,10.8
21,49,Clark,2011,17579,15849,1730,9.8
21,51,Clay,2011,6066,5157,909,15.0
21,53,Clinton,2011,4292,3804,488,11.4
21,55,Crittenden,2011,4183,3829,354,8.5
21,57,Cumberland,2011,3126,2783,343,11.0
21,59,Daviess,2011,47868,43877,3991,8.3
21,61,Edmonson,2011,5134,4535,599,11.7
21,63,Elliott,2011,2337,1969,368,15.7
21,65,Estill,2011,5620,4924,696,12.4
21,67,Fayette,2011,165355,154034,11321,6.8
21,69,Fleming,2011,6482,5796,686,10.6
21,71,Floyd,2011,13750,12217,1533,11.1
21,73,Franklin,2011,24675,22728,1947,7.9
21,75,Fulton,2011,2662,2333,329,12.4
21,77,Gallatin,2011,4014,3584,430,10.7
21,79,Garrard,2011,7829,7046,783,10.0
21,81,Grant,2011,11652,10415,1237,10.6
21,83,Graves,2011,16945,15410,1535,9.1
21,85,Grayson,2011,11423,10027,1396,12.2
21,87,Green,2011,5465,4939,526,9.6
21,89,Greenup,2011,15247,13540,1707,11.2
21,91,Hancock,2011,4089,3748,341,8.3
21,93,Hardin,2011,47563,43199,4364,9.2
21,95,Harlan,2011,10049,8929,1120,11.1
21,97,Harrison,2011,8976,8073,903,10.1
21,99,Hart,2011,8217,7408,809,9.8
21,101,Henderson,2011,22923,20868,2055,9.0
21,103,Henry,2011,7770,7090,680,8.8
21,105,Hickman,2011,2288,2084,204,8.9
21,107,Hopkins,2011,21594,19775,1819,8.4
21,109,Jackson,2011,5306,4589,717,13.5
21,111,Jefferson,2011,379699,343900,35799,9.4
21,113,Jessamine,2011,24712,22796,1916,7.8
21,115,Johnson,2011,8711,7769,942,10.8
21,117,Kenton,2011,83991,76588,7403,8.8
21,119,Knott,2011,5862,5171,691,11.8
21,121,Knox,2011,10659,9246,1413,13.3
21,123,Larue,2011,6062,5456,606,10.0
21,125,Laurel,2011,25043,22176,2867,11.4
21,127,Lawrence,2011,5787,5111,676,11.7
21,129,Lee,2011,2518,2201,317,12.6
21,131,Leslie,2011,3641,3182,459,12.6
21,133,Letcher,2011,8906,7997,909,10.2
21,135,Lewis,2011,5529,4812,717,13.0
21,137,Lincoln,2011,10430,9155,1275,12.2
21,139,Livingston,2011,4033,3593,440,10.9
21,141,Logan,2011,12471,11359,1112,8.9
21,143,Lyon,2011,3086,2767,319,10.3
21,145,McCracken,2011,31056,28378,2678,8.6
21,147,McCreary,2011,5704,4872,832,14.6
21,149,McLean,2011,4576,4170,406,8.9
21,151,Madison,2011,44166,40700,3466,7.8
21,153,Magoffin,2011,4160,3449,711,17.1
21,155,Marion,2011,9222,8226,996,10.8
21,157,Marshall,2011,15480,14051,1429,9.2
21,159,Martin,2011,3877,3531,346,8.9
21,161,Mason,2011,7685,6890,795,10.3
21,163,Meade,2011,12845,11402,1443,11.2
21,165,Menifee,2011,2548,2191,357,14.0
21,167,Mercer,2011,10257,9199,1058,10.3
21,169,Metcalfe,2011,4621,4104,517,11.2
21,171,Monroe,2011,4846,4411,435,9.0
21,173,Montgomery,2011,12108,10757,1351,11.2
21,175,Morgan,2011,5244,4669,575,11.0
21,177,Muhlenberg,2011,12979,11647,1332,10.3
21,179,Nelson,2011,21859,19543,2316,10.6
21,181,Nicholas,2011,3591,3269,322,9.0
21,183,Ohio,2011,10380,9358,1022,9.8
21,185,Oldham,2011,29331,27302,2029,6.9
21,187,Owen,2011,5713,5281,432,7.6
21,189,Owsley,2011,1394,1209,185,13.3
21,191,Pendleton,2011,7218,6439,779,10.8
21,193,Perry,2011,11047,9903,1144,10.4
21,195,Pike,2011,24385,22156,2229,9.1
21,197,Powell,2011,5164,4499,665,12.9
21,199,Pulaski,2011,27597,24661,2936,10.6
21,201,Robertson,2011,862,766,96,11.1
21,203,Rockcastle,2011,7210,6387,823,11.4
21,205,Rowan,2011,11266,10196,1070,9.5
21,207,Russell,2011,7368,6506,862,11.7
21,209,Scott,2011,25605,23577,2028,7.9
21,211,Shelby,2011,22024,20279,1745,7.9
21,213,Simpson,2011,8632,7683,949,11.0
21,215,Spencer,2011,9267,8434,833,9.0
21,217,Taylor,2011,11958,10664,1294,10.8
21,219,Todd,2011,5721,5224,497,8.7
21,221,Trigg,2011,6204,5502,702,11.3
21,223,Trimble,2011,4025,3569,456,11.3
21,225,Union,2011,7617,6933,684,9.0
21,227,Warren,2011,59109,54246,4863,8.2
21,229,Washington,2011,6138,5572,566,9.2
21,231,Wayne,2011,7905,6782,1123,14.2
21,233,Webster,2011,6227,5728,499,8.0
21,235,Whitley,2011,13933,12262,1671,12.0
21,237,Wolfe,2011,2109,1796,313,14.8
21,239,Woodford,2011,14360,13430,930,6.5
22,1,Acadia Parish,2011,25897,24257,1640,6.3
22,3,Allen Parish,2011,9242,8440,802,8.7
22,5,Ascension Parish,2011,54154,50536,3618,6.7
22,7,Assumption Parish,2011,9991,8839,1152,11.5
22,9,Avoyelles Parish,2011,16691,15360,1331,8.0
22,11,Beauregard Parish,2011,14314,13201,1113,7.8
22,13,Bienville Parish,2011,5875,5307,568,9.7
22,15,Bossier Parish,2011,57162,53981,3181,5.6
22,17,Caddo Parish,2011,116019,107261,8758,7.5
22,19,Calcasieu Parish,2011,87313,80948,6365,7.3
22,21,Caldwell Parish,2011,4115,3722,393,9.6
22,23,Cameron Parish,2011,3265,3087,178,5.5
22,25,Catahoula Parish,2011,4069,3669,400,9.8
22,27,Claiborne Parish,2011,6893,6345,548,8.0
22,29,Concordia Parish,2011,7832,7118,714,9.1
22,31,De Soto Parish,2011,11265,10359,906,8.0
22,33,East Baton Rouge Parish,2011,221868,205945,15923,7.2
22,35,East Carroll Parish,2011,2337,1933,404,17.3
22,37,East Feliciana Parish,2011,8074,7424,650,8.1
22,39,Evangeline Parish,2011,13070,12024,1046,8.0
22,41,Franklin Parish,2011,7973,7088,885,11.1
22,43,Grant Parish,2011,8385,7715,670,8.0
22,45,Iberia Parish,2011,31993,29588,2405,7.5
22,47,Iberville Parish,2011,14008,12627,1381,9.9
22,49,Jackson Parish,2011,6972,6482,490,7.0
22,51,Jefferson Parish,2011,213834,199220,14614,6.8
22,53,Jefferson Davis Parish,2011,12957,12070,887,6.8
22,55,Lafayette Parish,2011,114387,107958,6429,5.6
22,57,Lafourche Parish,2011,44577,41990,2587,5.8
22,59,LaSalle Parish,2011,6720,6355,365,5.4
22,61,Lincoln Parish,2011,20142,18372,1770,8.8
22,63,Livingston Parish,2011,61688,57415,4273,6.9
22,65,Madison Parish,2011,3984,3503,481,12.1
22,67,Morehouse Parish,2011,11059,9540,1519,13.7
22,69,Natchitoches Parish,2011,16188,14766,1422,8.8
22,71,Orleans Parish,2011,166238,152605,13633,8.2
22,73,Ouachita Parish,2011,70080,64533,5547,7.9
22,75,Plaquemines Parish,2011,10130,9522,608,6.0
22,77,Pointe Coupee Parish,2011,10008,9139,869,8.7
22,79,Rapides Parish,2011,58413,54175,4238,7.3
22,81,Red River Parish,2011,4063,3766,297,7.3
22,83,Richland Parish,2011,8819,7900,919,10.4
22,85,Sabine Parish,2011,9498,8854,644,6.8
22,87,St. Bernard Parish,2011,16908,15545,1363,8.1
22,89,St. Charles Parish,2011,24932,23225,1707,6.8
22,91,St. Helena Parish,2011,4639,4034,605,13.0
22,93,St. James Parish,2011,9960,8807,1153,11.6
22,95,St. John the Baptist Parish,2011,20989,18883,2106,10.0
22,97,St. Landry Parish,2011,33736,30710,3026,9.0
22,99,St. Martin Parish,2011,24172,22484,1688,7.0
22,101,St. Mary Parish,2011,25206,23077,2129,8.4
22,103,St. Tammany Parish,2011,108436,101971,6465,6.0
22,105,Tangipahoa Parish,2011,53422,48547,4875,9.1
22,107,Tensas Parish,2011,1980,1736,244,12.3
22,109,Terrebonne Parish,2011,50120,47165,2955,5.9
22,111,Union Parish,2011,9376,8530,846,9.0
22,113,Vermilion Parish,2011,25464,23870,1594,6.3
22,115,Vernon Parish,2011,19291,17638,1653,8.6
22,117,Washington Parish,2011,16660,15158,1502,9.0
22,119,Webster Parish,2011,16611,15017,1594,9.6
22,121,West Baton Rouge Parish,2011,11969,11086,883,7.4
22,123,West Carroll Parish,2011,4263,3618,645,15.1
22,125,West Feliciana Parish,2011,5160,4837,323,6.3
22,127,Winn Parish,2011,5666,5159,507,8.9
23,1,Androscoggin,2011,56017,51570,4447,7.9
23,3,Aroostook,2011,34506,31191,3315,9.6
23,5,Cumberland,2011,158112,148311,9801,6.2
23,7,Franklin,2011,15467,14096,1371,8.9
23,9,Hancock,2011,30072,27465,2607,8.7
23,11,Kennebec,2011,63259,58620,4639,7.3
23,13,Knox,2011,20443,18973,1470,7.2
23,15,Lincoln,2011,17122,15818,1304,7.6
23,17,Oxford,2011,27837,24977,2860,10.3
23,19,Penobscot,2011,79527,73076,6451,8.1
23,21,Piscataquis,2011,7934,7146,788,9.9
23,23,Sagadahoc,2011,19142,17875,1267,6.6
23,25,Somerset,2011,24663,22038,2625,10.6
23,27,Waldo,2011,20386,18734,1652,8.1
23,29,Washington,2011,14867,13330,1537,10.3
23,31,York,2011,109629,101749,7880,7.2
24,1,Allegany,2011,34102,30990,3112,9.1
24,3,Anne Arundel,2011,289406,270942,18464,6.4
24,5,Baltimore,2011,435678,401906,33772,7.8
24,9,Calvert,2011,47730,44595,3135,6.6
24,11,Caroline,2011,17493,15967,1526,8.7
24,13,Carroll,2011,92864,87107,5757,6.2
24,15,Cecil,2011,52121,47454,4667,9.0
24,17,Charles,2011,79025,73669,5356,6.8
24,19,Dorchester,2011,16534,14679,1855,11.2
24,21,Frederick,2011,128615,120249,8366,6.5
24,23,Garrett,2011,15821,14477,1344,8.5
24,25,Harford,2011,133875,124122,9753,7.3
24,27,Howard,2011,163979,155375,8604,5.2
24,29,Kent,2011,10775,9895,880,8.2
24,31,Montgomery,2011,536947,508359,28588,5.3
24,33,Prince George's,2011,483094,446690,36404,7.5
24,35,Queen Anne's,2011,26616,24790,1826,6.9
24,37,St. Mary's,2011,54283,50823,3460,6.4
24,39,Somerset,2011,9881,8716,1165,11.8
24,41,Talbot,2011,19457,17994,1463,7.5
24,43,Washington,2011,76499,69745,6754,8.8
24,45,Wicomico,2011,50558,45559,4999,9.9
24,47,Worcester,2011,26378,22718,3660,13.9
24,510,Baltimore city,2011,295569,264036,31533,10.7
25,1,Barnstable,2011,110136,100188,9948,9.0
25,3,Berkshire,2011,66980,61729,5251,7.8
25,5,Bristol,2011,286147,259251,26896,9.4
25,7,Dukes,2011,9195,8340,855,9.3
25,9,Essex,2011,394218,364245,29973,7.6
25,11,Franklin,2011,39706,37117,2589,6.5
25,13,Hampden,2011,220071,199637,20434,9.3
25,15,Hampshire,2011,85352,80106,5246,6.1
25,17,Middlesex,2011,827581,778927,48654,5.9
25,19,Nantucket/town,2011,6235,5700,535,8.6
25,21,Norfolk,2011,358835,336352,22483,6.3
25,23,Plymouth,2011,261913,241642,20271,7.7
25,25,Suffolk,2011,398003,371693,26310,6.6
25,27,Worcester,2011,419765,387531,32234,7.7
26,1,Alcona,2011,3791,3269,522,13.8
26,3,Alger,2011,3463,3042,421,12.2
26,5,Allegan,2011,56723,51967,4756,8.4
26,7,Alpena,2011,13648,12228,1420,10.4
26,9,Antrim,2011,10130,8838,1292,12.8
26,11,Arenac,2011,6662,5761,901,13.5
26,13,Baraga,2011,3643,3067,576,15.8
26,15,Barry,2011,28836,26577,2259,7.8
26,17,Bay,2011,53200,48174,5026,9.4
26,19,Benzie,2011,8667,7664,1003,11.6
26,21,Berrien,2011,74383,67126,7257,9.8
26,23,Branch,2011,19125,17204,1921,10.0
26,25,Calhoun,2011,63082,57150,5932,9.4
26,27,Cass,2011,24374,22108,2266,9.3
26,29,Charlevoix,2011,12886,11379,1507,11.7
26,31,Cheboygan,2011,10808,9530,1278,11.8
26,33,Chippewa,2011,17348,15539,1809,10.4
26,35,Clare,2011,12126,10588,1538,12.7
26,37,Clinton,2011,38900,36314,2586,6.6
26,39,Crawford,2011,5480,4804,676,12.3
26,41,Delta,2011,17769,15933,1836,10.3
26,43,Dickinson,2011,12783,11607,1176,9.2
26,45,Eaton,2011,55596,51306,4290,7.7
26,47,Emmet,2011,17982,15721,2261,12.6
26,49,Genesee,2011,180273,160278,19995,11.1
26,51,Gladwin,2011,10080,8819,1261,12.5
26,53,Gogebic,2011,6926,6136,790,11.4
26,55,Grand Traverse,2011,46562,42181,4381,9.4
26,57,Gratiot,2011,19032,17201,1831,9.6
26,59,Hillsdale,2011,20600,18496,2104,10.2
26,61,Houghton,2011,17286,15697,1589,9.2
26,63,Huron,2011,16377,14849,1528,9.3
26,65,Ingham,2011,144888,132587,12301,8.5
26,67,Ionia,2011,29045,26321,2724,9.4
26,69,Iosco,2011,10095,8850,1245,12.3
26,71,Iron,2011,5158,4645,513,9.9
26,73,Isabella,2011,34865,32059,2806,8.0
26,75,Jackson,2011,72456,65573,6883,9.5
26,77,Kalamazoo,2011,126001,115812,10189,8.1
26,79,Kalkaska,2011,7568,6621,947,12.5
26,81,Kent,2011,314702,289956,24746,7.9
26,83,Keweenaw,2011,1013,879,134,13.2
26,85,Lake,2011,3844,3339,505,13.1
26,87,Lapeer,2011,39663,34589,5074,12.8
26,89,Leelanau,2011,10307,9400,907,8.8
26,91,Lenawee,2011,48152,43359,4793,10.0
26,93,Livingston,2011,92312,84291,8021,8.7
26,95,Luce,2011,2404,2122,282,11.7
26,97,Mackinac,2011,5274,4607,667,12.6
26,99,Macomb,2011,407342,363502,43840,10.8
26,101,Manistee,2011,10652,9428,1224,11.5
26,103,Marquette,2011,33886,30993,2893,8.5
26,105,Mason,2011,14226,12723,1503,10.6
26,107,Mecosta,2011,19083,17012,2071,10.9
26,109,Menominee,2011,11793,10760,1033,8.8
26,111,Midland,2011,40821,37535,3286,8.0
26,113,Missaukee,2011,7018,6286,732,10.4
26,115,Monroe,2011,73512,66833,6679,9.1
26,117,Montcalm,2011,27220,24195,3025,11.1
26,119,Montmorency,2011,3327,2748,579,17.4
26,121,Muskegon,2011,75451,67161,8290,11.0
26,123,Newaygo,2011,22407,20120,2287,10.2
26,125,Oakland,2011,608692,552687,56005,9.2
26,127,Oceana,2011,12938,11191,1747,13.5
26,129,Ogemaw,2011,8755,7680,1075,12.3
26,131,Ontonagon,2011,2763,2331,432,15.6
26,133,Osceola,2011,10140,9032,1108,10.9
26,135,Oscoda,2011,3132,2595,537,17.1
26,137,Otsego,2011,11417,10081,1336,11.7
26,139,Ottawa,2011,139393,128745,10648,7.6
26,141,Presque Isle,2011,5542,4684,858,15.5
26,143,Roscommon,2011,8347,7159,1188,14.2
26,145,Saginaw,2011,89529,80762,8767,9.8
26,147,St. Clair,2011,73843,64512,9331,12.6
26,149,St. Joseph,2011,27536,24661,2875,10.4
26,151,Sanilac,2011,19442,17158,2284,11.7
26,153,Schoolcraft,2011,3664,3196,468,12.8
26,155,Shiawassee,2011,33488,30032,3456,10.3
26,157,Tuscola,2011,25054,22162,2892,11.5
26,159,Van Buren,2011,36340,32314,4026,11.1
26,161,Washtenaw,2011,180647,168847,11800,6.5
26,163,Wayne,2011,770687,674201,96486,12.5
26,165,Wexford,2011,14610,12900,1710,11.7
27,1,Aitkin,2011,7128,6443,685,9.6
27,3,Anoka,2011,187418,174542,12876,6.9
27,5,Becker,2011,17753,16481,1272,7.2
27,7,Beltrami,2011,22543,20688,1855,8.2
27,9,Benton,2011,21298,19681,1617,7.6
27,11,Big Stone,2011,2909,2721,188,6.5
27,13,Blue Earth,2011,38398,36313,2085,5.4
27,15,Brown,2011,15075,14184,891,5.9
27,17,Carlton,2011,17659,16316,1343,7.6
27,19,Carver,2011,52236,49344,2892,5.5
27,21,Cass,2011,14183,12754,1429,10.1
27,23,Chippewa,2011,7199,6743,456,6.3
27,25,Chisago,2011,29046,26827,2219,7.6
27,27,Clay,2011,34698,32764,1934,5.6
27,29,Clearwater,2011,4583,4037,546,11.9
27,31,Cook,2011,3058,2848,210,6.9
27,33,Cottonwood,2011,6153,5773,380,6.2
27,35,Crow Wing,2011,31635,28852,2783,8.8
27,37,Dakota,2011,228418,214573,13845,6.1
27,39,Dodge,2011,11259,10578,681,6.0
27,41,Douglas,2011,19823,18618,1205,6.1
27,43,Faribault,2011,7811,7255,556,7.1
27,45,Fillmore,2011,11249,10499,750,6.7
27,47,Freeborn,2011,17088,15949,1139,6.7
27,49,Goodhue,2011,26988,25365,1623,6.0
27,51,Grant,2011,3383,3148,235,6.9
27,53,Hennepin,2011,657377,617481,39896,6.1
27,55,Houston,2011,10688,9948,740,6.9
27,57,Hubbard,2011,9532,8654,878,9.2
27,59,Isanti,2011,20631,18910,1721,8.3
27,61,Itasca,2011,22573,20516,2057,9.1
27,63,Jackson,2011,6103,5771,332,5.4
27,65,Kanabec,2011,8730,7849,881,10.1
27,67,Kandiyohi,2011,23694,22270,1424,6.0
27,69,Kittson,2011,2609,2430,179,6.9
27,71,Koochiching,2011,6826,6253,573,8.4
27,73,Lac qui Parle,2011,3982,3740,242,6.1
27,75,Lake,2011,5827,5424,403,6.9
27,77,Lake of the Woods,2011,2345,2199,146,6.2
27,79,Le Sueur,2011,15713,14521,1192,7.6
27,81,Lincoln,2011,3455,3276,179,5.2
27,83,Lyon,2011,15429,14613,816,5.3
27,85,McLeod,2011,20386,18824,1562,7.7
27,87,Mahnomen,2011,2499,2309,190,7.6
27,89,Marshall,2011,5800,5314,486,8.4
27,91,Martin,2011,11236,10488,748,6.7
27,93,Meeker,2011,12873,11875,998,7.8
27,95,Mille Lacs,2011,12955,11705,1250,9.6
27,97,Morrison,2011,18793,17242,1551,8.3
27,99,Mower,2011,20863,19677,1186,5.7
27,101,Murray,2011,5050,4734,316,6.3
27,103,Nicollet,2011,19981,18959,1022,5.1
27,105,Nobles,2011,11509,10900,609,5.3
27,107,Norman,2011,3657,3411,246,6.7
27,109,Olmsted,2011,81487,77180,4307,5.3
27,111,Otter Tail,2011,30957,28969,1988,6.4
27,113,Pennington,2011,8579,7917,662,7.7
27,115,Pine,2011,15186,13843,1343,8.8
27,117,Pipestone,2011,5041,4712,329,6.5
27,119,Polk,2011,17461,16227,1234,7.1
27,121,Pope,2011,5873,5526,347,5.9
27,123,Ramsey,2011,273002,254784,18218,6.7
27,125,Red Lake,2011,2428,2232,196,8.1
27,127,Redwood,2011,8403,7892,511,6.1
27,129,Renville,2011,8565,7934,631,7.4
27,131,Rice,2011,34848,32525,2323,6.7
27,133,Rock,2011,5628,5390,238,4.2
27,135,Roseau,2011,8547,8087,460,5.4
27,137,St. Louis,2011,102503,94935,7568,7.4
27,139,Scott,2011,75059,70709,4350,5.8
27,141,Sherburne,2011,48983,45468,3515,7.2
27,143,Sibley,2011,8519,7929,590,6.9
27,145,Stearns,2011,86172,80762,5410,6.3
27,147,Steele,2011,21165,19790,1375,6.5
27,149,Stevens,2011,5599,5325,274,4.9
27,151,Swift,2011,5205,4832,373,7.2
27,153,Todd,2011,13323,12417,906,6.8
27,155,Traverse,2011,1847,1736,111,6.0
27,157,Wabasha,2011,11980,11238,742,6.2
27,159,Wadena,2011,6332,5760,572,9.0
27,161,Waseca,2011,10605,9935,670,6.3
27,163,Washington,2011,133346,125454,7892,5.9
27,165,Watonwan,2011,6281,5882,399,6.4
27,167,Wilkin,2011,3827,3612,215,5.6
27,169,Winona,2011,29498,27773,1725,5.8
27,171,Wright,2011,70427,65617,4810,6.8
27,173,Yellow Medicine,2011,5755,5425,330,5.7
28,1,Adams,2011,12948,11579,1369,10.6
28,3,Alcorn,2011,16227,14506,1721,10.6
28,5,Amite,2011,5003,4443,560,11.2
28,7,Attala,2011,7999,7124,875,10.9
28,9,Benton,2011,3394,2984,410,12.1
28,11,Bolivar,2011,15051,13413,1638,10.9
28,13,Calhoun,2011,7133,6527,606,8.5
28,15,Carroll,2011,3812,3358,454,11.9
28,17,Chickasaw,2011,8271,7347,924,11.2
28,19,Choctaw,2011,3817,3436,381,10.0
28,21,Claiborne,2011,3693,3117,576,15.6
28,23,Clarke,2011,6767,5987,780,11.5
28,25,Clay,2011,8707,7437,1270,14.6
28,27,Coahoma,2011,10701,9251,1450,13.6
28,29,Copiah,2011,12279,10893,1386,11.3
28,31,Covington,2011,8558,7775,783,9.1
28,33,DeSoto,2011,83395,77539,5856,7.0
28,35,Forrest,2011,35146,31676,3470,9.9
28,37,Franklin,2011,3225,2884,341,10.6
28,39,George,2011,9071,7993,1078,11.9
28,41,Greene,2011,4701,4145,556,11.8
28,43,Grenada,2011,9731,8757,974,10.0
28,45,Hancock,2011,20111,18246,1865,9.3
28,47,Harrison,2011,90808,82898,7910,8.7
28,49,Hinds,2011,118621,107566,11055,9.3
28,51,Holmes,2011,6897,5688,1209,17.5
28,53,Humphreys,2011,3424,2803,621,18.1
28,55,Issaquena,2011,516,414,102,19.8
28,57,Itawamba,2011,10597,9563,1034,9.8
28,59,Jackson,2011,65709,59024,6685,10.2
28,61,Jasper,2011,7199,6390,809,11.2
28,63,Jefferson,2011,2540,2077,463,18.2
28,65,Jefferson Davis,2011,4644,4011,633,13.6
28,67,Jones,2011,29204,26760,2444,8.4
28,69,Kemper,2011,3922,3374,548,14.0
28,71,Lafayette,2011,22995,21063,1932,8.4
28,73,Lamar,2011,28595,26602,1993,7.0
28,75,Lauderdale,2011,34452,31008,3444,10.0
28,77,Lawrence,2011,5087,4509,578,11.4
28,79,Leake,2011,8890,8046,844,9.5
28,81,Lee,2011,41168,37285,3883,9.4
28,83,Leflore,2011,11639,9943,1696,14.6
28,85,Lincoln,2011,14865,13448,1417,9.5
28,87,Lowndes,2011,27382,24565,2817,10.3
28,89,Madison,2011,50872,47452,3420,6.7
28,91,Marion,2011,10948,9804,1144,10.4
28,93,Marshall,2011,15803,13995,1808,11.4
28,95,Monroe,2011,16607,14651,1956,11.8
28,97,Montgomery,2011,4685,4117,568,12.1
28,99,Neshoba,2011,12001,10908,1093,9.1
28,101,Newton,2011,9418,8568,850,9.0
28,103,Noxubee,2011,4384,3760,624,14.2
28,105,Oktibbeha,2011,22826,20694,2132,9.3
28,107,Panola,2011,14731,12830,1901,12.9
28,109,Pearl River,2011,24373,22152,2221,9.1
28,111,Perry,2011,4680,4074,606,12.9
28,113,Pike,2011,15795,14010,1785,11.3
28,115,Pontotoc,2011,14052,12772,1280,9.1
28,117,Prentiss,2011,11758,10562,1196,10.2
28,119,Quitman,2011,3126,2671,455,14.6
28,121,Rankin,2011,73738,69149,4589,6.2
28,123,Scott,2011,13706,12574,1132,8.3
28,125,Sharkey,2011,2027,1738,289,14.3
28,127,Simpson,2011,11610,10574,1036,8.9
28,129,Smith,2011,7419,6825,594,8.0
28,131,Stone,2011,7056,6314,742,10.5
28,133,Sunflower,2011,9858,8403,1455,14.8
28,135,Tallahatchie,2011,6090,5367,723,11.9
28,137,Tate,2011,12863,11560,1303,10.1
28,139,Tippah,2011,9307,8231,1076,11.6
28,141,Tishomingo,2011,8084,7131,953,11.8
28,143,Tunica,2011,5146,4418,728,14.1
28,145,Union,2011,13325,12039,1286,9.7
28,147,Walthall,2011,5839,5149,690,11.8
28,149,Warren,2011,23586,21251,2335,9.9
28,151,Washington,2011,21203,17981,3222,15.2
28,153,Wayne,2011,8761,7783,978,11.2
28,155,Webster,2011,4409,3960,449,10.2
28,157,Wilkinson,2011,3463,3023,440,12.7
28,159,Winston,2011,8015,6970,1045,13.0
28,161,Yalobusha,2011,5382,4763,619,11.5
28,163,Yazoo,2011,10159,8963,1196,11.8
29,1,Adair,2011,10866,9914,952,8.8
29,3,Andrew,2011,9703,9017,686,7.1
29,5,Atchison,2011,2880,2639,241,8.4
29,7,Audrain,2011,11241,10299,942,8.4
29,9,Barry,2011,15191,13802,1389,9.1
29,11,Barton,2011,5609,5106,503,9.0
29,13,Bates,2011,8346,7489,857,10.3
29,15,Benton,2011,7198,6396,802,11.1
29,17,Bollinger,2011,5730,5204,526,9.2
29,19,Boone,2011,93593,88143,5450,5.8
29,21,Buchanan,2011,46246,42429,3817,8.3
29,23,Butler,2011,18731,17008,1723,9.2
29,25,Caldwell,2011,4428,4037,391,8.8
29,27,Callaway,2011,21975,20270,1705,7.8
29,29,Camden,2011,19069,16904,2165,11.4
29,31,Cape Girardeau,2011,40474,37691,2783,6.9
29,33,Carroll,2011,4723,4218,505,10.7
29,35,Carter,2011,2628,2326,302,11.5
29,37,Cass,2011,52832,48262,4570,8.7
29,39,Cedar,2011,5974,5444,530,8.9
29,41,Chariton,2011,4079,3706,373,9.1
29,43,Christian,2011,40700,37617,3083,7.6
29,45,Clark,2011,3390,3044,346,10.2
29,47,Clay,2011,125008,115592,9416,7.5
29,49,Clinton,2011,10977,9983,994,9.1
29,51,Cole,2011,40167,37594,2573,6.4
29,53,Cooper,2011,7909,7183,726,9.2
29,55,Crawford,2011,10811,9612,1199,11.1
29,57,Dade,2011,3418,3093,325,9.5
29,59,Dallas,2011,7195,6386,809,11.2
29,61,Daviess,2011,4037,3671,366,9.1
29,63,DeKalb,2011,5007,4601,406,8.1
29,65,Dent,2011,6389,5757,632,9.9
29,67,Douglas,2011,5172,4635,537,10.4
29,69,Dunklin,2011,12304,10780,1524,12.4
29,71,Franklin,2011,52692,47646,5046,9.6
29,73,Gasconade,2011,7596,6911,685,9.0
29,75,Gentry,2011,3568,3315,253,7.1
29,77,Greene,2011,143671,132930,10741,7.5
29,79,Grundy,2011,4929,4573,356,7.2
29,81,Harrison,2011,4001,3654,347,8.7
29,83,Henry,2011,9879,8905,974,9.9
29,85,Hickory,2011,3557,3134,423,11.9
29,87,Holt,2011,2687,2489,198,7.4
29,89,Howard,2011,4842,4435,407,8.4
29,91,Howell,2011,16462,14849,1613,9.8
29,93,Iron,2011,3557,3048,509,14.3
29,95,Jackson,2011,356582,322012,34570,9.7
29,97,Jasper,2011,58548,54024,4524,7.7
29,99,Jefferson,2011,116363,105956,10407,8.9
29,101,Johnson,2011,23394,21214,2180,9.3
29,103,Knox,2011,1969,1825,144,7.3
29,105,Laclede,2011,15854,14028,1826,11.5
29,107,Lafayette,2011,17378,15770,1608,9.3
29,109,Lawrence,2011,17312,15842,1470,8.5
29,111,Lewis,2011,5115,4752,363,7.1
29,113,Lincoln,2011,26569,23843,2726,10.3
29,115,Linn,2011,5312,4669,643,12.1
29,117,Livingston,2011,7053,6509,544,7.7
29,119,McDonald,2011,10189,9322,867,8.5
29,121,Macon,2011,7454,6824,630,8.5
29,123,Madison,2011,5338,4771,567,10.6
29,125,Maries,2011,4186,3826,360,8.6
29,127,Marion,2011,14473,13369,1104,7.6
29,129,Mercer,2011,1828,1703,125,6.8
29,131,Miller,2011,11333,10010,1323,11.7
29,133,Mississippi,2011,6044,5451,593,9.8
29,135,Moniteau,2011,7337,6764,573,7.8
29,137,Monroe,2011,4074,3664,410,10.1
29,139,Montgomery,2011,5928,5328,600,10.1
29,141,Morgan,2011,7843,6832,1011,12.9
29,143,New Madrid,2011,8200,7386,814,9.9
29,145,Newton,2011,28836,26490,2346,8.1
29,147,Nodaway,2011,11541,10733,808,7.0
29,149,Oregon,2011,4045,3640,405,10.0
29,151,Osage,2011,7385,6919,466,6.3
29,153,Ozark,2011,3568,3136,432,12.1
29,155,Pemiscot,2011,7165,6314,851,11.9
29,157,Perry,2011,9820,9154,666,6.8
29,159,Pettis,2011,20072,18382,1690,8.4
29,161,Phelps,2011,19839,18131,1708,8.6
29,163,Pike,2011,8166,7473,693,8.5
29,165,Platte,2011,51765,48111,3654,7.1
29,167,Polk,2011,14263,12903,1360,9.5
29,169,Pulaski,2011,16592,15121,1471,8.9
29,171,Putnam,2011,2361,2196,165,7.0
29,173,Ralls,2011,5619,5190,429,7.6
29,175,Randolph,2011,10774,9618,1156,10.7
29,177,Ray,2011,11382,10307,1075,9.4
29,179,Reynolds,2011,2310,2000,310,13.4
29,181,Ripley,2011,5467,4799,668,12.2
29,183,St. Charles,2011,205217,190796,14421,7.0
29,185,St. Clair,2011,4006,3593,413,10.3
29,186,Ste. Genevieve,2011,9273,8398,875,9.4
29,187,St. Francois,2011,26674,23740,2934,11.0
29,189,St. Louis,2011,531565,489054,42511,8.0
29,195,Saline,2011,11066,10163,903,8.2
29,197,Schuyler,2011,1899,1722,177,9.3
29,199,Scotland,2011,2320,2164,156,6.7
29,201,Scott,2011,19587,17831,1756,9.0
29,203,Shannon,2011,3122,2704,418,13.4
29,205,Shelby,2011,3188,2955,233,7.3
29,207,Stoddard,2011,13639,12244,1395,10.2
29,209,Stone,2011,14125,12318,1807,12.8
29,211,Sullivan,2011,2823,2583,240,8.5
29,213,Taney,2011,26039,22549,3490,13.4
29,215,Texas,2011,9723,8758,965,9.9
29,217,Vernon,2011,9548,8844,704,7.4
29,219,Warren,2011,17031,15456,1575,9.2
29,221,Washington,2011,10098,8842,1256,12.4
29,223,Wayne,2011,5475,4909,566,10.3
29,225,Webster,2011,16104,14638,1466,9.1
29,227,Worth,2011,1234,1162,72,5.8
29,229,Wright,2011,7573,6813,760,10.0
29,510,St. Louis city,2011,163556,146378,17178,10.5
30,1,Beaverhead,2011,4933,4646,287,5.8
30,3,Big Horn,2011,5624,4976,648,11.5
30,5,Blaine,2011,2483,2316,167,6.7
30,7,Broadwater,2011,2491,2316,175,7.0
30,9,Carbon,2011,5293,5003,290,5.5
30,11,Carter,2011,685,659,26,3.8
30,13,Cascade,2011,38329,35990,2339,6.1
30,15,Chouteau,2011,2654,2539,115,4.3
30,17,Custer,2011,6374,6126,248,3.9
30,19,Daniels,2011,945,913,32,3.4
30,21,Dawson,2011,4552,4394,158,3.5
30,23,Deer Lodge,2011,5155,4851,304,5.9
30,25,Fallon,2011,1956,1907,49,2.5
30,27,Fergus,2011,5907,5563,344,5.8
30,29,Flathead,2011,43506,38933,4573,10.5
30,31,Gallatin,2011,51555,48602,2953,5.7
30,33,Garfield,2011,778,749,29,3.7
30,35,Glacier,2011,6050,5388,662,10.9
30,37,Golden Valley,2011,391,372,19,4.9
30,39,Granite,2011,1456,1329,127,8.7
30,41,Hill,2011,7986,7509,477,6.0
30,43,Jefferson,2011,5619,5283,336,6.0
30,45,Judith Basin,2011,968,911,57,5.9
30,47,Lake,2011,12539,11443,1096,8.7
30,49,Lewis and Clark,2011,34515,32764,1751,5.1
30,51,Liberty,2011,1018,979,39,3.8
30,53,Lincoln,2011,8177,7017,1160,14.2
30,55,McCone,2011,1100,1068,32,2.9
30,57,Madison,2011,4177,3884,293,7.0
30,59,Meagher,2011,910,845,65,7.1
30,61,Mineral,2011,1786,1578,208,11.6
30,63,Missoula,2011,58776,54980,3796,6.5
30,65,Musselshell,2011,2329,2182,147,6.3
30,67,Park,2011,7877,7250,627,8.0
30,69,Petroleum,2011,280,265,15,5.4
30,71,Phillips,2011,2125,1985,140,6.6
30,73,Pondera,2011,2929,2761,168,5.7
30,75,Powder River,2011,1059,1011,48,4.5
30,77,Powell,2011,2988,2769,219,7.3
30,79,Prairie,2011,531,504,27,5.1
30,81,Ravalli,2011,18640,17036,1604,8.6
30,83,Richland,2011,6159,5978,181,2.9
30,85,Roosevelt,2011,4627,4314,313,6.8
30,87,Rosebud,2011,4442,4133,309,7.0
30,89,Sanders,2011,4843,4224,619,12.8
30,91,Sheridan,2011,1887,1823,64,3.4
30,93,Silver Bow,2011,16952,15885,1067,6.3
30,95,Stillwater,2011,4825,4586,239,5.0
30,97,Sweet Grass,2011,1704,1628,76,4.5
30,99,Teton,2011,2941,2782,159,5.4
30,101,Toole,2011,2388,2283,105,4.4
30,103,Treasure,2011,378,358,20,5.3
30,105,Valley,2011,3940,3763,177,4.5
30,107,Wheatland,2011,836,772,64,7.7
30,109,Wibaux,2011,526,505,21,4.0
30,111,Yellowstone,2011,77170,73155,4015,5.2
31,1,Adams,2011,16493,15781,712,4.3
31,3,Antelope,2011,3599,3468,131,3.6
31,5,Arthur,2011,231,217,14,6.1
31,7,Banner,2011,433,413,20,4.6
31,9,Blaine,2011,280,265,15,5.4
31,11,Boone,2011,3041,2930,111,3.7
31,13,Box Butte,2011,5983,5730,253,4.2
31,15,Boyd,2011,1149,1105,44,3.8
31,17,Brown,2011,1465,1398,67,4.6
31,19,Buffalo,2011,26875,25930,945,3.5
31,21,Burt,2011,3639,3430,209,5.7
31,23,Butler,2011,4747,4567,180,3.8
31,25,Cass,2011,13385,12682,703,5.3
31,27,Cedar,2011,4710,4555,155,3.3
31,29,Chase,2011,2348,2290,58,2.5
31,31,Cherry,2011,3454,3349,105,3.0
31,33,Cheyenne,2011,5685,5512,173,3.0
31,35,Clay,2011,3485,3340,145,4.2
31,37,Colfax,2011,5686,5465,221,3.9
31,39,Cuming,2011,4925,4757,168,3.4
31,41,Custer,2011,6050,5843,207,3.4
31,43,Dakota,2011,11018,10369,649,5.9
31,45,Dawes,2011,5476,5263,213,3.9
31,47,Dawson,2011,13194,12534,660,5.0
31,49,Deuel,2011,1069,1032,37,3.5
31,51,Dixon,2011,3162,3018,144,4.6
31,53,Dodge,2011,19138,18195,943,4.9
31,55,Douglas,2011,282153,268311,13842,4.9
31,57,Dundy,2011,1275,1238,37,2.9
31,59,Fillmore,2011,3325,3210,115,3.5
31,61,Franklin,2011,1671,1601,70,4.2
31,63,Frontier,2011,1603,1546,57,3.6
31,65,Furnas,2011,2713,2614,99,3.6
31,67,Gage,2011,11196,10547,649,5.8
31,69,Garden,2011,1260,1215,45,3.6
31,71,Garfield,2011,1206,1165,41,3.4
31,73,Gosper,2011,1131,1091,40,3.5
31,75,Grant,2011,454,439,15,3.3
31,77,Greeley,2011,1362,1309,53,3.9
31,79,Hall,2011,32025,30589,1436,4.5
31,81,Hamilton,2011,4834,4651,183,3.8
31,83,Harlan,2011,1895,1833,62,3.3
31,85,Hayes,2011,679,658,21,3.1
31,87,Hitchcock,2011,1377,1310,67,4.9
31,89,Holt,2011,5942,5738,204,3.4
31,91,Hooker,2011,446,426,20,4.5
31,93,Howard,2011,3396,3258,138,4.1
31,95,Jefferson,2011,4377,4187,190,4.3
31,97,Johnson,2011,2216,2109,107,4.8
31,99,Kearney,2011,3906,3779,127,3.3
31,101,Keith,2011,4656,4466,190,4.1
31,103,Keya Paha,2011,602,584,18,3.0
31,105,Kimball,2011,2181,2102,79,3.6
31,107,Knox,2011,4765,4579,186,3.9
31,109,Lancaster,2011,164218,157636,6582,4.0
31,111,Lincoln,2011,19429,18576,853,4.4
31,113,Logan,2011,509,491,18,3.5
31,115,Loup,2011,379,361,18,4.7
31,117,McPherson,2011,366,357,9,2.5
31,119,Madison,2011,19098,18319,779,4.1
31,121,Merrick,2011,4175,3997,178,4.3
31,123,Morrill,2011,2659,2569,90,3.4
31,125,Nance,2011,2064,1988,76,3.7
31,127,Nemaha,2011,3963,3765,198,5.0
31,129,Nuckolls,2011,2497,2407,90,3.6
31,131,Otoe,2011,8558,8123,435,5.1
31,133,Pawnee,2011,1654,1592,62,3.7
31,135,Perkins,2011,1803,1751,52,2.9
31,137,Phelps,2011,5015,4831,184,3.7
31,139,Pierce,2011,4213,4064,149,3.5
31,141,Platte,2011,17832,17088,744,4.2
31,143,Polk,2011,3001,2898,103,3.4
31,145,Red Willow,2011,6290,6071,219,3.5
31,147,Richardson,2011,4406,4140,266,6.0
31,149,Rock,2011,900,876,24,2.7
31,151,Saline,2011,7346,7000,346,4.7
31,153,Sarpy,2011,86383,82715,3668,4.2
31,155,Saunders,2011,11206,10691,515,4.6
31,157,Scotts Bluff,2011,19216,18250,966,5.0
31,159,Seward,2011,8770,8432,338,3.9
31,161,Sheridan,2011,2833,2731,102,3.6
31,163,Sherman,2011,1759,1683,76,4.3
31,165,Sioux,2011,844,815,29,3.4
31,167,Stanton,2011,3630,3494,136,3.7
31,169,Thayer,2011,2927,2831,96,3.3
31,171,Thomas,2011,426,404,22,5.2
31,173,Thurston,2011,3124,2805,319,10.2
31,175,Valley,2011,2149,2063,86,4.0
31,177,Washington,2011,11245,10755,490,4.4
31,179,Wayne,2011,5610,5416,194,3.5
31,181,Webster,2011,1736,1656,80,4.6
31,183,Wheeler,2011,524,507,17,3.2
31,185,York,2011,7518,7191,327,4.3
32,1,Churchill,2011,11139,9716,1423,12.8
32,3,Clark,2011,986302,852943,133359,13.5
32,5,Douglas,2011,23026,19919,3107,13.5
32,7,Elko,2011,27895,25833,2062,7.4
32,9,Esmeralda,2011,417,383,34,8.2
32,11,Eureka,2011,1061,986,75,7.1
32,13,Humboldt,2011,8643,7953,690,8.0
32,15,Lander,2011,3192,2900,292,9.1
32,17,Lincoln,2011,2060,1826,234,11.4
32,19,Lyon,2011,22753,18857,3896,17.1
32,21,Mineral,2011,2174,1860,314,14.4
32,23,Nye,2011,16781,13915,2866,17.1
32,27,Pershing,2011,2455,2185,270,11.0
32,29,Storey,2011,1958,1644,314,16.0
32,31,Washoe,2011,219619,191407,28212,12.8
32,33,White Pine,2011,5041,4593,448,8.9
32,510,Carson City,2011,26275,22734,3541,13.5
33,1,Belknap,2011,32070,30286,1784,5.6
33,3,Carroll,2011,24777,23415,1362,5.5
33,5,Cheshire,2011,42571,40413,2158,5.1
33,7,Coos,2011,16360,15157,1203,7.4
33,9,Grafton,2011,48761,46566,2195,4.5
33,11,Hillsborough,2011,225231,212361,12870,5.7
33,13,Merrimack,2011,81147,77111,4036,5.0
33,15,Rockingham,2011,172243,162494,9749,5.7
33,17,Strafford,2011,69659,65933,3726,5.3
33,19,Sullivan,2011,23965,22857,1108,4.6
34,1,Atlantic,2011,139265,121791,17474,12.5
34,3,Bergen,2011,481712,444579,37133,7.7
34,5,Burlington,2011,235492,214917,20575,8.7
34,7,Camden,2011,262568,234026,28542,10.9
34,9,Cape May,2011,49513,42155,7358,14.9
34,11,Cumberland,2011,71775,62461,9314,13.0
34,13,Essex,2011,383035,341551,41484,10.8
34,15,Gloucester,2011,151738,136285,15453,10.2
34,17,Hudson,2011,357269,324654,32615,9.1
34,19,Hunterdon,2011,67753,63067,4686,6.9
34,21,Mercer,2011,193945,177897,16048,8.3
34,23,Middlesex,2011,426013,388648,37365,8.8
34,25,Monmouth,2011,329158,300862,28296,8.6
34,27,Morris,2011,265523,246762,18761,7.1
34,29,Ocean,2011,265521,237771,27750,10.5
34,31,Passaic,2011,253686,225744,27942,11.0
34,33,Salem,2011,32389,28614,3775,11.7
34,35,Somerset,2011,174371,161488,12883,7.4
34,37,Sussex,2011,81767,74204,7563,9.2
34,39,Union,2011,280582,253857,26725,9.5
34,41,Warren,2011,58710,53375,5335,9.1
35,1,Bernalillo,2011,321894,299644,22250,6.9
35,3,Catron,2011,1155,1030,125,10.8
35,5,Chaves,2011,27447,25668,1779,6.5
35,6,Cibola,2011,9216,8376,840,9.1
35,7,Colfax,2011,6281,5790,491,7.8
35,9,Curry,2011,21379,20337,1042,4.9
35,11,De Baca,2011,814,774,40,4.9
35,13,Dona Ana,2011,92873,86124,6749,7.3
35,15,Eddy,2011,26368,25081,1287,4.9
35,17,Grant,2011,12705,11816,889,7.0
35,19,Guadalupe,2011,1644,1478,166,10.1
35,21,Harding,2011,295,277,18,6.1
35,23,Hidalgo,2011,2272,2107,165,7.3
35,25,Lea,2011,27121,25666,1455,5.4
35,27,Lincoln,2011,9062,8471,591,6.5
35,28,Los Alamos,2011,9240,8927,313,3.4
35,29,Luna,2011,11366,9146,2220,19.5
35,31,McKinley,2011,24810,22440,2370,9.6
35,33,Mora,2011,2359,2080,279,11.8
35,35,Otero,2011,24557,22947,1610,6.6
35,37,Quay,2011,3371,3058,313,9.3
35,39,Rio Arriba,2011,17143,15614,1529,8.9
35,41,Roosevelt,2011,8285,7830,455,5.5
35,43,Sandoval,2011,60480,55796,4684,7.7
35,45,San Juan,2011,54710,50576,4134,7.6
35,47,San Miguel,2011,11027,10018,1009,9.2
35,49,Santa Fe,2011,73251,68875,4376,6.0
35,51,Sierra,2011,3865,3497,368,9.5
35,53,Socorro,2011,6801,6302,499,7.3
35,55,Taos,2011,15076,13546,1530,10.1
35,57,Torrance,2011,5836,5189,647,11.1
35,59,Union,2011,1933,1846,87,4.5
35,61,Valencia,2011,30472,27840,2632,8.6
36,1,Albany,2011,158506,147443,11063,7.0
36,3,Allegany,2011,23692,21561,2131,9.0
36,5,Bronx,2011,586219,516013,70206,12.0
36,7,Broome,2011,94855,86646,8209,8.7
36,9,Cattaraugus,2011,38612,34970,3642,9.4
36,11,Cayuga,2011,39121,35927,3194,8.2
36,13,Chautauqua,2011,61754,56660,5094,8.2
36,15,Chemung,2011,40863,37636,3227,7.9
36,17,Chenango,2011,23865,21777,2088,8.7
36,19,Clinton,2011,38468,34756,3712,9.6
36,21,Columbia,2011,31498,29238,2260,7.2
36,23,Cortland,2011,24380,22301,2079,8.5
36,25,Delaware,2011,21748,19848,1900,8.7
36,27,Dutchess,2011,146498,135428,11070,7.6
36,29,Erie,2011,459408,422449,36959,8.0
36,31,Essex,2011,18227,16559,1668,9.2
36,33,Franklin,2011,21754,19759,1995,9.2
36,35,Fulton,2011,25603,22871,2732,10.7
36,37,Genesee,2011,30974,28539,2435,7.9
36,39,Greene,2011,21619,19568,2051,9.5
36,41,Hamilton,2011,2448,2203,245,10.0
36,43,Herkimer,2011,30770,28070,2700,8.8
36,45,Jefferson,2011,48994,44189,4805,9.8
36,47,Kings,2011,1174299,1061492,112807,9.6
36,49,Lewis,2011,12413,11206,1207,9.7
36,51,Livingston,2011,32043,29583,2460,7.7
36,53,Madison,2011,34777,31921,2856,8.2
36,55,Monroe,2011,374302,345365,28937,7.7
36,57,Montgomery,2011,23472,21051,2421,10.3
36,59,Nassau,2011,684374,637173,47201,6.9
36,61,New York,2011,884930,815453,69477,7.9
36,63,Niagara,2011,105772,96025,9747,9.2
36,65,Oneida,2011,109138,100348,8790,8.1
36,67,Onondaga,2011,232929,214840,18089,7.8
36,69,Ontario,2011,55834,51845,3989,7.1
36,71,Orange,2011,179117,165198,13919,7.8
36,73,Orleans,2011,18842,17088,1754,9.3
36,75,Oswego,2011,58096,51792,6304,10.9
36,77,Otsego,2011,31420,28972,2448,7.8
36,79,Putnam,2011,51682,48016,3666,7.1
36,81,Queens,2011,1112280,1021978,90302,8.1
36,83,Rensselaer,2011,82885,76538,6347,7.7
36,85,Richmond,2011,217461,197400,20061,9.2
36,87,Rockland,2011,149100,138351,10749,7.2
36,89,St. Lawrence,2011,48973,43858,5115,10.4
36,91,Saratoga,2011,115824,108056,7768,6.7
36,93,Schenectady,2011,77178,71348,5830,7.6
36,95,Schoharie,2011,15582,14174,1408,9.0
36,97,Schuyler,2011,9022,8219,803,8.9
36,99,Seneca,2011,16127,14840,1287,8.0
36,101,Steuben,2011,46196,41952,4244,9.2
36,103,Suffolk,2011,771638,712479,59159,7.7
36,105,Sullivan,2011,35535,32361,3174,8.9
36,107,Tioga,2011,25853,23851,2002,7.7
36,109,Tompkins,2011,54259,50948,3311,6.1
36,111,Ulster,2011,91417,84188,7229,7.9
36,113,Warren,2011,33672,30644,3028,9.0
36,115,Washington,2011,29772,27340,2432,8.2
36,117,Wayne,2011,46497,42565,3932,8.5
36,119,Westchester,2011,474161,440360,33801,7.1
36,121,Wyoming,2011,18909,17246,1663,8.8
36,123,Yates,2011,12104,11190,914,7.6
37,1,Alamance,2011,77660,70181,7479,9.6
37,3,Alexander,2011,17989,15961,2028,11.3
37,5,Alleghany,2011,4655,4086,569,12.2
37,7,Anson,2011,11157,9787,1370,12.3
37,9,Ashe,2011,13318,11859,1459,11.0
37,11,Avery,2011,7808,6941,867,11.1
37,13,Beaufort,2011,21592,19189,2403,11.1
37,15,Bertie,2011,9115,8019,1096,12.0
37,17,Bladen,2011,14941,12941,2000,13.4
37,19,Brunswick,2011,47271,41500,5771,12.2
37,21,Buncombe,2011,125337,115383,9954,7.9
37,23,Burke,2011,41414,36680,4734,11.4
37,25,Cabarrus,2011,90307,80923,9384,10.4
37,27,Caldwell,2011,37542,32571,4971,13.2
37,29,Camden,2011,4614,4221,393,8.5
37,31,Carteret,2011,31130,28112,3018,9.7
37,33,Caswell,2011,10162,8966,1196,11.8
37,35,Catawba,2011,77222,68220,9002,11.7
37,37,Chatham,2011,31285,28750,2535,8.1
37,39,Cherokee,2011,11657,10277,1380,11.8
37,41,Chowan,2011,5989,5261,728,12.2
37,43,Clay,2011,4168,3687,481,11.5
37,45,Cleveland,2011,46118,40419,5699,12.4
37,47,Columbus,2011,24067,20847,3220,13.4
37,49,Craven,2011,42148,37703,4445,10.5
37,51,Cumberland,2011,133317,119247,14070,10.6
37,53,Currituck,2011,12417,11293,1124,9.1
37,55,Dare,2011,20174,17541,2633,13.1
37,57,Davidson,2011,79829,71042,8787,11.0
37,59,Davie,2011,20101,17973,2128,10.6
37,61,Duplin,2011,26368,23879,2489,9.4
37,63,Durham,2011,146063,134256,11807,8.1
37,65,Edgecombe,2011,25056,21171,3885,15.5
37,67,Forsyth,2011,174540,157407,17133,9.8
37,69,Franklin,2011,28089,25099,2990,10.6
37,71,Gaston,2011,101008,89038,11970,11.9
37,73,Gates,2011,5455,5008,447,8.2
37,75,Graham,2011,3638,2981,657,18.1
37,77,Granville,2011,28005,25518,2487,8.9
37,79,Greene,2011,9609,8687,922,9.6
37,81,Guilford,2011,254485,227869,26616,10.5
37,83,Halifax,2011,22462,19188,3274,14.6
37,85,Harnett,2011,49398,43788,5610,11.4
37,87,Haywood,2011,27661,24871,2790,10.1
37,89,Henderson,2011,48668,44531,4137,8.5
37,91,Hertford,2011,9682,8585,1097,11.3
37,93,Hoke,2011,19560,17429,2131,10.9
37,95,Hyde,2011,2127,1841,286,13.4
37,97,Iredell,2011,78947,69966,8981,11.4
37,99,Jackson,2011,18176,16147,2029,11.2
37,101,Johnston,2011,82890,75033,7857,9.5
37,103,Jones,2011,4607,4118,489,10.6
37,105,Lee,2011,27373,24003,3370,12.3
37,107,Lenoir,2011,27747,24729,3018,10.9
37,109,Lincoln,2011,40014,35545,4469,11.2
37,111,McDowell,2011,20703,18146,2557,12.4
37,113,Macon,2011,15566,13804,1762,11.3
37,115,Madison,2011,9487,8513,974,10.3
37,117,Martin,2011,10698,9366,1332,12.5
37,119,Mecklenburg,2011,516486,465317,51169,9.9
37,121,Mitchell,2011,6774,5970,804,11.9
37,123,Montgomery,2011,11565,10203,1362,11.8
37,125,Moore,2011,37277,33725,3552,9.5
37,127,Nash,2011,47164,41286,5878,12.5
37,129,New Hanover,2011,108073,97757,10316,9.5
37,131,Northampton,2011,8676,7615,1061,12.2
37,133,Onslow,2011,63019,57804,5215,8.3
37,135,Orange,2011,70542,65937,4605,6.5
37,137,Pamlico,2011,5510,4975,535,9.7
37,139,Pasquotank,2011,18362,16472,1890,10.3
37,141,Pender,2011,24756,21949,2807,11.3
37,143,Perquimans,2011,5332,4747,585,11.0
37,145,Person,2011,18662,16436,2226,11.9
37,147,Pitt,2011,86228,77504,8724,10.1
37,149,Polk,2011,8490,7699,791,9.3
37,151,Randolph,2011,69084,61522,7562,10.9
37,153,Richmond,2011,18382,15700,2682,14.6
37,155,Robeson,2011,53753,46111,7642,14.2
37,157,Rockingham,2011,43798,38417,5381,12.3
37,159,Rowan,2011,63842,55898,7944,12.4
37,161,Rutherford,2011,26623,22748,3875,14.6
37,163,Sampson,2011,29863,26932,2931,9.8
37,165,Scotland,2011,12922,10594,2328,18.0
37,167,Stanly,2011,28985,25578,3407,11.8
37,169,Stokes,2011,22631,20272,2359,10.4
37,171,Surry,2011,34013,30342,3671,10.8
37,173,Swain,2011,6519,5500,1019,15.6
37,175,Transylvania,2011,13462,12196,1266,9.4
37,177,Tyrrell,2011,1642,1397,245,14.9
37,179,Union,2011,102947,93573,9374,9.1
37,181,Vance,2011,18742,15952,2790,14.9
37,183,Wake,2011,490446,451953,38493,7.8
37,185,Warren,2011,7680,6610,1070,13.9
37,187,Washington,2011,5017,4169,848,16.9
37,189,Watauga,2011,27147,25010,2137,7.9
37,191,Wayne,2011,55181,50194,4987,9.0
37,193,Wilkes,2011,31260,27583,3677,11.8
37,195,Wilson,2011,38457,33114,5343,13.9
37,197,Yadkin,2011,18067,16201,1866,10.3
37,199,Yancey,2011,7916,7019,897,11.3
38,1,Adams,2011,1160,1129,31,2.7
38,3,Barnes,2011,6026,5797,229,3.8
38,5,Benson,2011,2918,2748,170,5.8
38,7,Billings,2011,438,422,16,3.7
38,9,Bottineau,2011,3425,3301,124,3.6
38,11,Bowman,2011,1871,1832,39,2.1
38,13,Burke,2011,1232,1204,28,2.3
38,15,Burleigh,2011,46584,45124,1460,3.1
38,17,Cass,2011,89339,86532,2807,3.1
38,19,Cavalier,2011,2242,2177,65,2.9
38,21,Dickey,2011,2815,2736,79,2.8
38,23,Divide,2011,1575,1548,27,1.7
38,25,Dunn,2011,2920,2862,58,2.0
38,27,Eddy,2011,1268,1208,60,4.7
38,29,Emmons,2011,1764,1661,103,5.8
38,31,Foster,2011,1761,1707,54,3.1
38,33,Golden Valley,2011,979,955,24,2.5
38,35,Grand Forks,2011,37608,36274,1334,3.5
38,37,Grant,2011,1389,1341,48,3.5
38,39,Griggs,2011,1263,1227,36,2.9
38,41,Hettinger,2011,1484,1443,41,2.8
38,43,Kidder,2011,1351,1283,68,5.0
38,45,LaMoure,2011,2391,2322,69,2.9
38,47,Logan,2011,975,946,29,3.0
38,49,McHenry,2011,3313,3166,147,4.4
38,51,McIntosh,2011,1305,1258,47,3.6
38,53,McKenzie,2011,4606,4527,79,1.7
38,55,McLean,2011,4963,4737,226,4.6
38,57,Mercer,2011,4125,3910,215,5.2
38,59,Morton,2011,15779,15168,611,3.9
38,61,Mountrail,2011,6482,6347,135,2.1
38,63,Nelson,2011,1659,1589,70,4.2
38,65,Oliver,2011,920,866,54,5.9
38,67,Pembina,2011,3913,3652,261,6.7
38,69,Pierce,2011,1929,1840,89,4.6
38,71,Ramsey,2011,6053,5830,223,3.7
38,73,Ransom,2011,2871,2772,99,3.4
38,75,Renville,2011,1442,1403,39,2.7
38,77,Richland,2011,8853,8528,325,3.7
38,79,Rolette,2011,5126,4582,544,10.6
38,81,Sargent,2011,2104,2042,62,2.9
38,83,Sheridan,2011,797,766,31,3.9
38,85,Sioux,2011,1324,1255,69,5.2
38,87,Slope,2011,492,482,10,2.0
38,89,Stark,2011,16027,15688,339,2.1
38,91,Steele,2011,1111,1083,28,2.5
38,93,Stutsman,2011,10805,10409,396,3.7
38,95,Towner,2011,1345,1306,39,2.9
38,97,Traill,2011,4592,4430,162,3.5
38,99,Walsh,2011,5945,5657,288,4.8
38,101,Ward,2011,32390,31394,996,3.1
38,103,Wells,2011,2303,2206,97,4.2
38,105,Williams,2011,20040,19767,273,1.4
39,1,Adams,2011,11489,9845,1644,14.3
39,3,Allen,2011,50812,45984,4828,9.5
39,5,Ashland,2011,26067,23497,2570,9.9
39,7,Ashtabula,2011,47442,42292,5150,10.9
39,9,Athens,2011,27780,25022,2758,9.9
39,11,Auglaize,2011,24060,22116,1944,8.1
39,13,Belmont,2011,32198,29125,3073,9.5
39,15,Brown,2011,20598,18162,2436,11.8
39,17,Butler,2011,188430,171329,17101,9.1
39,19,Carroll,2011,14069,12638,1431,10.2
39,21,Champaign,2011,19469,17635,1834,9.4
39,23,Clark,2011,67369,60968,6401,9.5
39,25,Clermont,2011,103364,93892,9472,9.2
39,27,Clinton,2011,17993,15570,2423,13.5
39,29,Columbiana,2011,51706,46470,5236,10.1
39,31,Coshocton,2011,16748,14832,1916,11.4
39,33,Crawford,2011,20738,18351,2387,11.5
39,35,Cuyahoga,2011,632371,584368,48003,7.6
39,37,Darke,2011,26577,24123,2454,9.2
39,39,Defiance,2011,19190,17343,1847,9.6
39,41,Delaware,2011,94934,89026,5908,6.2
39,43,Erie,2011,39703,35929,3774,9.5
39,45,Fairfield,2011,73783,67835,5948,8.1
39,47,Fayette,2011,14326,12823,1503,10.5
39,49,Franklin,2011,625753,577243,48510,7.8
39,51,Fulton,2011,22571,20402,2169,9.6
39,53,Gallia,2011,12996,11542,1454,11.2
39,55,Geauga,2011,49369,46384,2985,6.0
39,57,Greene,2011,81574,74846,6728,8.2
39,59,Guernsey,2011,18421,16432,1989,10.8
39,61,Hamilton,2011,406356,370436,35920,8.8
39,63,Hancock,2011,39966,36861,3105,7.8
39,65,Hardin,2011,15059,13626,1433,9.5
39,67,Harrison,2011,7005,6261,744,10.6
39,69,Henry,2011,14356,12821,1535,10.7
39,71,Highland,2011,18056,15633,2423,13.4
39,73,Hocking,2011,13765,12397,1368,9.9
39,75,Holmes,2011,19537,18306,1231,6.3
39,77,Huron,2011,29621,26259,3362,11.4
39,79,Jackson,2011,13927,12280,1647,11.8
39,81,Jefferson,2011,31907,28081,3826,12.0
39,83,Knox,2011,30418,27767,2651,8.7
39,85,Lake,2011,127021,118337,8684,6.8
39,87,Lawrence,2011,27017,24452,2565,9.5
39,89,Licking,2011,86585,79337,7248,8.4
39,91,Logan,2011,22784,20566,2218,9.7
39,93,Lorain,2011,151886,139980,11906,7.8
39,95,Lucas,2011,212751,191763,20988,9.9
39,97,Madison,2011,20276,18673,1603,7.9
39,99,Mahoning,2011,112624,101590,11034,9.8
39,101,Marion,2011,29501,26591,2910,9.9
39,103,Medina,2011,95163,89095,6068,6.4
39,105,Meigs,2011,9785,8502,1283,13.1
39,107,Mercer,2011,22122,20628,1494,6.8
39,109,Miami,2011,53318,48455,4863,9.1
39,111,Monroe,2011,6579,5932,647,9.8
39,113,Montgomery,2011,259391,234202,25189,9.7
39,115,Morgan,2011,6768,6000,768,11.3
39,117,Morrow,2011,17091,15361,1730,10.1
39,119,Muskingum,2011,41192,36712,4480,10.9
39,121,Noble,2011,4974,4311,663,13.3
39,123,Ottawa,2011,22410,19934,2476,11.0
39,125,Paulding,2011,9430,8512,918,9.7
39,127,Perry,2011,16378,14485,1893,11.6
39,129,Pickaway,2011,25809,23442,2367,9.2
39,131,Pike,2011,11001,9332,1669,15.2
39,133,Portage,2011,89145,81246,7899,8.9
39,135,Preble,2011,21665,19596,2069,9.5
39,137,Putnam,2011,19198,17772,1426,7.4
39,139,Richland,2011,57968,51826,6142,10.6
39,141,Ross,2011,34216,30817,3399,9.9
39,143,Sandusky,2011,32627,29644,2983,9.1
39,145,Scioto,2011,31738,27769,3969,12.5
39,147,Seneca,2011,28722,25960,2762,9.6
39,149,Shelby,2011,24168,21837,2331,9.6
39,151,Stark,2011,188690,171099,17591,9.3
39,153,Summit,2011,275855,250799,25056,9.1
39,155,Trumbull,2011,97155,86802,10353,10.7
39,157,Tuscarawas,2011,45281,41079,4202,9.3
39,159,Union,2011,26653,24741,1912,7.2
39,161,Van Wert,2011,14498,13153,1345,9.3
39,163,Vinton,2011,5717,5037,680,11.9
39,165,Warren,2011,109330,100699,8631,7.9
39,167,Washington,2011,28966,26053,2913,10.1
39,169,Wayne,2011,59028,54508,4520,7.7
39,171,Williams,2011,18875,16850,2025,10.7
39,173,Wood,2011,68178,62529,5649,8.3
39,175,Wyandot,2011,12085,10973,1112,9.2
40,1,Adair,2011,8806,8038,768,8.7
40,3,Alfalfa,2011,2552,2453,99,3.9
40,5,Atoka,2011,4991,4585,406,8.1
40,7,Beaver,2011,2946,2845,101,3.4
40,9,Beckham,2011,11313,10916,397,3.5
40,11,Blaine,2011,4342,4122,220,5.1
40,13,Bryan,2011,17454,16469,985,5.6
40,15,Caddo,2011,11576,10794,782,6.8
40,17,Canadian,2011,61377,58821,2556,4.2
40,19,Carter,2011,21580,20262,1318,6.1
40,21,Cherokee,2011,19164,17833,1331,6.9
40,23,Choctaw,2011,6000,5485,515,8.6
40,25,Cimarron,2011,1369,1325,44,3.2
40,27,Cleveland,2011,132862,127115,5747,4.3
40,29,Coal,2011,2342,2154,188,8.0
40,31,Comanche,2011,50541,47782,2759,5.5
40,33,Cotton,2011,2905,2737,168,5.8
40,35,Craig,2011,6327,5947,380,6.0
40,37,Creek,2011,31174,29101,2073,6.6
40,39,Custer,2011,15148,14569,579,3.8
40,41,Delaware,2011,17255,16078,1177,6.8
40,43,Dewey,2011,2465,2374,91,3.7
40,45,Ellis,2011,2109,2033,76,3.6
40,47,Garfield,2011,28754,27543,1211,4.2
40,49,Garvin,2011,12169,11493,676,5.6
40,51,Grady,2011,25204,23940,1264,5.0
40,53,Grant,2011,2540,2450,90,3.5
40,55,Greer,2011,2137,2008,129,6.0
40,57,Harmon,2011,1315,1248,67,5.1
40,59,Harper,2011,1866,1800,66,3.5
40,61,Haskell,2011,4658,4262,396,8.5
40,63,Hughes,2011,5447,4961,486,8.9
40,65,Jackson,2011,11316,10726,590,5.2
40,67,Jefferson,2011,2650,2496,154,5.8
40,69,Johnston,2011,3699,3397,302,8.2
40,71,Kay,2011,20559,19040,1519,7.4
40,73,Kingfisher,2011,7564,7285,279,3.7
40,75,Kiowa,2011,4255,4047,208,4.9
40,77,Latimer,2011,4412,3994,418,9.5
40,79,Le Flore,2011,20026,18338,1688,8.4
40,81,Lincoln,2011,15458,14657,801,5.2
40,83,Logan,2011,20160,19226,934,4.6
40,85,Love,2011,4902,4667,235,4.8
40,87,McClain,2011,17213,16440,773,4.5
40,89,McCurtain,2011,14676,13245,1431,9.8
40,91,McIntosh,2011,7355,6610,745,10.1
40,93,Major,2011,4043,3889,154,3.8
40,95,Marshall,2011,6665,6284,381,5.7
40,97,Mayes,2011,18068,16766,1302,7.2
40,99,Murray,2011,6467,6164,303,4.7
40,101,Muskogee,2011,29772,27677,2095,7.0
40,103,Noble,2011,5328,5066,262,4.9
40,105,Nowata,2011,4886,4517,369,7.6
40,107,Okfuskee,2011,4399,4041,358,8.1
40,109,Oklahoma,2011,356348,338412,17936,5.0
40,111,Okmulgee,2011,16460,15043,1417,8.6
40,113,Osage,2011,21186,19822,1364,6.4
40,115,Ottawa,2011,14260,13233,1027,7.2
40,117,Pawnee,2011,7571,7009,562,7.4
40,119,Payne,2011,36728,34985,1743,4.7
40,121,Pittsburg,2011,18979,17651,1328,7.0
40,123,Pontotoc,2011,18073,17140,933,5.2
40,125,Pottawatomie,2011,31266,29488,1778,5.7
40,127,Pushmataha,2011,4932,4523,409,8.3
40,129,Roger Mills,2011,1899,1841,58,3.1
40,131,Rogers,2011,42932,40590,2342,5.5
40,133,Seminole,2011,9930,9143,787,7.9
40,135,Sequoyah,2011,17382,15870,1512,8.7
40,137,Stephens,2011,20341,19212,1129,5.6
40,139,Texas,2011,8817,8447,370,4.2
40,141,Tillman,2011,3345,3159,186,5.6
40,143,Tulsa,2011,303026,285623,17403,5.7
40,145,Wagoner,2011,35022,33066,1956,5.6
40,147,Washington,2011,24130,22812,1318,5.5
40,149,Washita,2011,5499,5264,235,4.3
40,151,Woods,2011,4481,4335,146,3.3
40,153,Woodward,2011,9895,9456,439,4.4
41,1,Baker,2011,7326,6523,803,11.0
41,3,Benton,2011,45986,43019,2967,6.5
41,5,Clackamas,2011,204322,186042,18280,8.9
41,7,Clatsop,2011,19057,17242,1815,9.5
41,9,Columbia,2011,23600,20905,2695,11.4
41,11,Coos,2011,28003,24725,3278,11.7
41,13,Crook,2011,9465,8101,1364,14.4
41,15,Curry,2011,9225,8105,1120,12.1
41,17,Deschutes,2011,80665,70653,10012,12.4
41,19,Douglas,2011,47551,41451,6100,12.8
41,21,Gilliam,2011,974,879,95,9.8
41,23,Grant,2011,3426,2949,477,13.9
41,25,Harney,2011,3731,3230,501,13.4
41,27,Hood River,2011,14343,13194,1149,8.0
41,29,Jackson,2011,100599,88691,11908,11.8
41,31,Jefferson,2011,9612,8375,1237,12.9
41,33,Josephine,2011,34537,30132,4405,12.8
41,35,Klamath,2011,31331,27532,3799,12.1
41,37,Lake,2011,3758,3260,498,13.3
41,39,Lane,2011,177663,160310,17353,9.8
41,41,Lincoln,2011,21966,19649,2317,10.5
41,43,Linn,2011,56710,50195,6515,11.5
41,45,Malheur,2011,13385,12111,1274,9.5
41,47,Marion,2011,154728,138373,16355,10.6
41,49,Morrow,2011,5798,5316,482,8.3
41,51,Multnomah,2011,425218,389284,35934,8.5
41,53,Polk,2011,36331,32928,3403,9.4
41,55,Sherman,2011,921,818,103,11.2
41,57,Tillamook,2011,11661,10492,1169,10.0
41,59,Umatilla,2011,37422,33817,3605,9.6
41,61,Union,2011,12471,11215,1256,10.1
41,63,Wallowa,2011,3492,3061,431,12.3
41,65,Wasco,2011,13916,12677,1239,8.9
41,67,Washington,2011,294534,271637,22897,7.8
41,69,Wheeler,2011,768,702,66,8.6
41,71,Yamhill,2011,51439,46666,4773,9.3
42,1,Adams,2011,53982,50453,3529,6.5
42,3,Allegheny,2011,641827,597225,44602,6.9
42,5,Armstrong,2011,33560,30864,2696,8.0
42,7,Beaver,2011,85754,79183,6571,7.7
42,9,Bedford,2011,24910,22697,2213,8.9
42,11,Berks,2011,209654,193518,16136,7.7
42,13,Blair,2011,61398,57020,4378,7.1
42,15,Bradford,2011,31954,29932,2022,6.3
42,17,Bucks,2011,335647,311668,23979,7.1
42,19,Butler,2011,96463,90171,6292,6.5
42,21,Cambria,2011,66038,60407,5631,8.5
42,23,Cameron,2011,2503,2241,262,10.5
42,25,Carbon,2011,31792,28667,3125,9.8
42,27,Centre,2011,77275,73171,4104,5.3
42,29,Chester,2011,269597,254367,15230,5.6
42,31,Clarion,2011,19058,17202,1856,9.7
42,33,Clearfield,2011,37962,34462,3500,9.2
42,35,Clinton,2011,19136,17569,1567,8.2
42,37,Columbia,2011,34709,31768,2941,8.5
42,39,Crawford,2011,41438,38193,3245,7.8
42,41,Cumberland,2011,124189,116484,7705,6.2
42,43,Dauphin,2011,140192,129789,10403,7.4
42,45,Delaware,2011,286263,264559,21704,7.6
42,47,Elk,2011,16833,15615,1218,7.2
42,49,Erie,2011,136976,126054,10922,8.0
42,51,Fayette,2011,59530,53657,5873,9.9
42,53,Forest,2011,2030,1842,188,9.3
42,55,Franklin,2011,75388,69972,5416,7.2
42,57,Fulton,2011,7333,6607,726,9.9
42,59,Greene,2011,18155,16796,1359,7.5
42,61,Huntingdon,2011,20953,18879,2074,9.9
42,63,Indiana,2011,43940,40556,3384,7.7
42,65,Jefferson,2011,21743,19882,1861,8.6
42,67,Juniata,2011,11987,11122,865,7.2
42,69,Lackawanna,2011,107016,97780,9236,8.6
42,71,Lancaster,2011,265492,247641,17851,6.7
42,73,Lawrence,2011,42945,39420,3525,8.2
42,75,Lebanon,2011,69709,64980,4729,6.8
42,77,Lehigh,2011,179081,163923,15158,8.5
42,79,Luzerne,2011,159444,144450,14994,9.4
42,81,Lycoming,2011,60963,56344,4619,7.6
42,83,McKean,2011,20067,18350,1717,8.6
42,85,Mercer,2011,53227,49126,4101,7.7
42,87,Mifflin,2011,20952,19122,1830,8.7
42,89,Monroe,2011,81997,74214,7783,9.5
42,91,Montgomery,2011,429511,402275,27236,6.3
42,93,Montour,2011,9175,8614,561,6.1
42,95,Northampton,2011,152320,140012,12308,8.1
42,97,Northumberland,2011,44850,40820,4030,9.0
42,99,Perry,2011,24668,22887,1781,7.2
42,101,Philadelphia/city,2011,689005,616991,72014,10.5
42,103,Pike,2011,26033,23508,2525,9.7
42,105,Potter,2011,7815,7115,700,9.0
42,107,Schuylkill,2011,69888,63197,6691,9.6
42,109,Snyder,2011,19769,18281,1488,7.5
42,111,Somerset,2011,36857,33641,3216,8.7
42,113,Sullivan,2011,3034,2817,217,7.2
42,115,Susquehanna,2011,21884,20178,1706,7.8
42,117,Tioga,2011,21153,19704,1449,6.9
42,119,Union,2011,19026,17768,1258,6.6
42,121,Venango,2011,26344,24439,1905,7.2
42,123,Warren,2011,20403,18904,1499,7.3
42,125,Washington,2011,105684,98073,7611,7.2
42,127,Wayne,2011,23227,21384,1843,7.9
42,129,Westmoreland,2011,185548,171833,13715,7.4
42,131,Wyoming,2011,14296,13065,1231,8.6
42,133,York,2011,230193,213294,16899,7.3
44,1,Bristol,2011,26383,23852,2531,9.6
44,3,Kent,2011,93057,83176,9881,10.6
44,5,Newport,2011,44606,40127,4479,10.0
44,7,Providence,2011,327303,289337,37966,11.6
44,9,Washington,2011,70715,63618,7097,10.0
45,1,Abbeville,2011,10825,9493,1332,12.3
45,3,Aiken,2011,73635,66901,6734,9.1
45,5,Allendale,2011,3290,2693,597,18.1
45,7,Anderson,2011,86285,77496,8789,10.2
45,9,Bamberg,2011,6338,5322,1016,16.0
45,11,Barnwell,2011,9237,7848,1389,15.0
45,13,Beaufort,2011,65765,60131,5634,8.6
45,15,Berkeley,2011,86190,78035,8155,9.5
45,17,Calhoun,2011,7123,6252,871,12.2
45,19,Charleston,2011,183865,168779,15086,8.2
45,21,Cherokee,2011,23736,20283,3453,14.5
45,23,Chester,2011,14462,11985,2477,17.1
45,25,Chesterfield,2011,21251,18553,2698,12.7
45,27,Clarendon,2011,13693,11731,1962,14.3
45,29,Colleton,2011,16727,14394,2333,13.9
45,31,Darlington,2011,30575,26675,3900,12.8
45,33,Dillon,2011,13705,11564,2141,15.6
45,35,Dorchester,2011,67330,61361,5969,8.9
45,37,Edgefield,2011,10962,9888,1074,9.8
45,39,Fairfield,2011,10588,9070,1518,14.3
45,41,Florence,2011,64700,57539,7161,11.1
45,43,Georgetown,2011,25634,22194,3440,13.4
45,45,Greenville,2011,225288,206016,19272,8.6
45,47,Greenwood,2011,32178,28573,3605,11.2
45,49,Hampton,2011,8670,7561,1109,12.8
45,51,Horry,2011,132897,117260,15637,11.8
45,53,Jasper,2011,11041,9962,1079,9.8
45,55,Kershaw,2011,28313,25224,3089,10.9
45,57,Lancaster,2011,34292,29777,4515,13.2
45,59,Laurens,2011,30490,26983,3507,11.5
45,61,Lee,2011,6905,5800,1105,16.0
45,63,Lexington,2011,134996,124359,10637,7.9
45,65,McCormick,2011,3647,3156,491,13.5
45,67,Marion,2011,14213,11724,2489,17.5
45,69,Marlboro,2011,10781,8683,2098,19.5
45,71,Newberry,2011,18660,16752,1908,10.2
45,73,Oconee,2011,33425,30114,3311,9.9
45,75,Orangeburg,2011,40384,34079,6305,15.6
45,77,Pickens,2011,54987,49620,5367,9.8
45,79,Richland,2011,187224,170293,16931,9.0
45,81,Saluda,2011,8712,7872,840,9.6
45,83,Spartanburg,2011,133878,119426,14452,10.8
45,85,Sumter,2011,45003,39640,5363,11.9
45,87,Union,2011,12277,10333,1944,15.8
45,89,Williamsburg,2011,13473,11251,2222,16.5
45,91,York,2011,117525,104847,12678,10.8
46,3,Aurora,2011,1685,1634,51,3.0
46,5,Beadle,2011,9594,9241,353,3.7
46,7,Bennett,2011,1190,1106,84,7.1
46,9,Bon Homme,2011,3149,2997,152,4.8
46,11,Brookings,2011,18074,17296,778,4.3
46,13,Brown,2011,20989,20204,785,3.7
46,15,Brule,2011,2740,2633,107,3.9
46,17,Buffalo,2011,741,667,74,10.0
46,19,Butte,2011,5073,4832,241,4.8
46,21,Campbell,2011,880,847,33,3.8
46,23,Charles Mix,2011,4171,3969,202,4.8
46,25,Clark,2011,1966,1875,91,4.6
46,27,Clay,2011,7568,7270,298,3.9
46,29,Codington,2011,15509,14823,686,4.4
46,31,Corson,2011,1549,1436,113,7.3
46,33,Custer,2011,4118,3894,224,5.4
46,35,Davison,2011,11174,10745,429,3.8
46,37,Day,2011,3078,2883,195,6.3
46,39,Deuel,2011,2541,2390,151,5.9
46,41,Dewey,2011,2428,2044,384,15.8
46,43,Douglas,2011,1771,1701,70,4.0
46,45,Edmunds,2011,2380,2303,77,3.2
46,47,Fall River,2011,3220,3033,187,5.8
46,49,Faulk,2011,1183,1135,48,4.1
46,51,Grant,2011,4666,4448,218,4.7
46,53,Gregory,2011,2183,2085,98,4.5
46,55,Haakon,2011,1123,1082,41,3.7
46,57,Hamlin,2011,3129,2994,135,4.3
46,59,Hand,2011,1882,1821,61,3.2
46,61,Hanson,2011,1819,1733,86,4.7
46,63,Harding,2011,829,797,32,3.9
46,65,Hughes,2011,10076,9720,356,3.5
46,67,Hutchinson,2011,3822,3680,142,3.7
46,69,Hyde,2011,793,765,28,3.5
46,71,Jackson,2011,1398,1296,102,7.3
46,73,Jerauld,2011,1244,1201,43,3.5
46,75,Jones,2011,678,657,21,3.1
46,77,Kingsbury,2011,2907,2782,125,4.3
46,79,Lake,2011,6255,5953,302,4.8
46,81,Lawrence,2011,12950,12342,608,4.7
46,83,Lincoln,2011,27242,26291,951,3.5
46,85,Lyman,2011,1925,1805,120,6.2
46,87,McCook,2011,3214,3076,138,4.3
46,89,McPherson,2011,1175,1124,51,4.3
46,91,Marshall,2011,2522,2385,137,5.4
46,93,Meade,2011,13222,12598,624,4.7
46,95,Mellette,2011,871,817,54,6.2
46,97,Miner,2011,1307,1251,56,4.3
46,99,Minnehaha,2011,100479,96100,4379,4.4
46,101,Moody,2011,4169,3909,260,6.2
46,102,Oglala Lakota,2011,3754,3238,516,13.7
46,103,Pennington,2011,53574,51058,2516,4.7
46,105,Perkins,2011,1586,1520,66,4.2
46,107,Potter,2011,1251,1186,65,5.2
46,109,Roberts,2011,5083,4751,332,6.5
46,111,Sanborn,2011,1347,1292,55,4.1
46,115,Spink,2011,3525,3383,142,4.0
46,117,Stanley,2011,1937,1862,75,3.9
46,119,Sully,2011,884,851,33,3.7
46,121,Todd,2011,3403,3120,283,8.3
46,123,Tripp,2011,3283,3163,120,3.7
46,125,Turner,2011,4866,4672,194,4.0
46,127,Union,2011,7728,7338,390,5.0
46,129,Walworth,2011,2385,2222,163,6.8
46,135,Yankton,2011,11540,11040,500,4.3
46,137,Ziebach,2011,1071,1004,67,6.3
47,1,Anderson,2011,35083,31965,3118,8.9
47,3,Bedford,2011,20862,18479,2383,11.4
47,5,Benton,2011,7116,6294,822,11.6
47,7,Bledsoe,2011,4487,3973,514,11.5
47,9,Blount,2011,61583,56476,5107,8.3
47,11,Bradley,2011,47320,43049,4271,9.0
47,13,Campbell,2011,16089,14176,1913,11.9
47,15,Cannon,2011,6081,5443,638,10.5
47,17,Carroll,2011,13658,11979,1679,12.3
47,19,Carter,2011,26229,23549,2680,10.2
47,21,Cheatham,2011,20274,18533,1741,8.6
47,23,Chester,2011,8510,7725,785,9.2
47,25,Claiborne,2011,13656,12125,1531,11.2
47,27,Clay,2011,3409,3042,367,10.8
47,29,Cocke,2011,15751,13645,2106,13.4
47,31,Coffee,2011,24662,22175,2487,10.1
47,33,Crockett,2011,7310,6529,781,10.7
47,35,Cumberland,2011,23777,21328,2449,10.3
47,37,Davidson,2011,349110,322412,26698,7.6
47,39,Decatur,2011,5320,4692,628,11.8
47,41,DeKalb,2011,8210,7282,928,11.3
47,43,Dickson,2011,24270,21913,2357,9.7
47,45,Dyer,2011,17665,15438,2227,12.6
47,47,Fayette,2011,18726,16919,1807,9.6
47,49,Fentress,2011,7488,6621,867,11.6
47,51,Franklin,2011,19245,17416,1829,9.5
47,53,Gibson,2011,23802,21044,2758,11.6
47,55,Giles,2011,14280,12834,1446,10.1
47,57,Grainger,2011,9984,8802,1182,11.8
47,59,Greene,2011,30645,27100,3545,11.6
47,61,Grundy,2011,5524,4828,696,12.6
47,63,Hamblen,2011,28257,25144,3113,11.0
47,65,Hamilton,2011,171245,157758,13487,7.9
47,67,Hancock,2011,2425,2084,341,14.1
47,69,Hardeman,2011,10156,8910,1246,12.3
47,71,Hardin,2011,11431,10126,1305,11.4
47,73,Hawkins,2011,25685,23098,2587,10.1
47,75,Haywood,2011,8489,7298,1191,14.0
47,77,Henderson,2011,13555,12022,1533,11.3
47,79,Henry,2011,14417,12833,1584,11.0
47,81,Hickman,2011,10869,9738,1131,10.4
47,83,Houston,2011,3560,3157,403,11.3
47,85,Humphreys,2011,8830,7892,938,10.6
47,87,Jackson,2011,4739,4177,562,11.9
47,89,Jefferson,2011,24259,21678,2581,10.6
47,91,Johnson,2011,7513,6634,879,11.7
47,93,Knox,2011,232694,216377,16317,7.0
47,95,Lake,2011,2194,1926,268,12.2
47,97,Lauderdale,2011,10627,9287,1340,12.6
47,99,Lawrence,2011,19210,17176,2034,10.6
47,101,Lewis,2011,5244,4557,687,13.1
47,103,Lincoln,2011,15727,14663,1064,6.8
47,105,Loudon,2011,22541,20551,1990,8.8
47,107,McMinn,2011,23017,20409,2608,11.3
47,109,McNairy,2011,10381,9189,1192,11.5
47,111,Macon,2011,10316,9240,1076,10.4
47,113,Madison,2011,48949,44320,4629,9.5
47,115,Marion,2011,12487,11160,1327,10.6
47,117,Marshall,2011,14399,12729,1670,11.6
47,119,Maury,2011,41219,36932,4287,10.4
47,121,Meigs,2011,4974,4371,603,12.1
47,123,Monroe,2011,19549,17276,2273,11.6
47,125,Montgomery,2011,77069,70384,6685,8.7
47,127,Moore,2011,3330,3098,232,7.0
47,129,Morgan,2011,8457,7530,927,11.0
47,131,Obion,2011,15262,13381,1881,12.3
47,133,Overton,2011,9993,8956,1037,10.4
47,135,Perry,2011,3023,2665,358,11.8
47,137,Pickett,2011,2428,2150,278,11.4
47,139,Polk,2011,7411,6573,838,11.3
47,141,Putnam,2011,34301,31202,3099,9.0
47,143,Rhea,2011,13825,12245,1580,11.4
47,145,Roane,2011,24391,22144,2247,9.2
47,147,Robertson,2011,34042,31137,2905,8.5
47,149,Rutherford,2011,143716,132121,11595,8.1
47,151,Scott,2011,9133,7508,1625,17.8
47,153,Sequatchie,2011,6079,5449,630,10.4
47,155,Sevier,2011,49602,44566,5036,10.2
47,157,Shelby,2011,450228,406712,43516,9.7
47,159,Smith,2011,8841,7922,919,10.4
47,161,Stewart,2011,5646,4935,711,12.6
47,163,Sullivan,2011,74441,68171,6270,8.4
47,165,Sumner,2011,84684,77922,6762,8.0
47,167,Tipton,2011,28790,25775,3015,10.5
47,169,Trousdale,2011,3753,3356,397,10.6
47,171,Unicoi,2011,7887,7003,884,11.2
47,173,Union,2011,7828,7020,808,10.3
47,175,Van Buren,2011,2293,2020,273,11.9
47,177,Warren,2011,17893,16038,1855,10.4
47,179,Washington,2011,61139,56140,4999,8.2
47,181,Wayne,2011,6797,6056,741,10.9
47,183,Weakley,2011,16674,14747,1927,11.6
47,185,White,2011,12454,11209,1245,10.0
47,187,Williamson,2011,97109,91345,5764,5.9
47,189,Wilson,2011,59897,55302,4595,7.7
48,1,Anderson,2011,22178,20506,1672,7.5
48,3,Andrews,2011,7784,7382,402,5.2
48,5,Angelina,2011,38103,34997,3106,8.2
48,7,Aransas,2011,9814,8926,888,9.0
48,9,Archer,2011,4480,4199,281,6.3
48,11,Armstrong,2011,1035,984,51,4.9
48,13,Atascosa,2011,19884,18246,1638,8.2
48,15,Austin,2011,14147,12995,1152,8.1
48,17,Bailey,2011,3287,3034,253,7.7
48,19,Bandera,2011,9176,8465,711,7.7
48,21,Bastrop,2011,35705,32781,2924,8.2
48,23,Baylor,2011,1861,1746,115,6.2
48,25,Bee,2011,10593,9652,941,8.9
48,27,Bell,2011,133430,122377,11053,8.3
48,29,Bexar,2011,829332,767720,61612,7.4
48,31,Blanco,2011,5414,5096,318,5.9
48,33,Borden,2011,388,367,21,5.4
48,35,Bosque,2011,8406,7685,721,8.6
48,37,Bowie,2011,42325,38711,3614,8.5
48,39,Brazoria,2011,158522,145399,13123,8.3
48,41,Brazos,2011,99668,93461,6207,6.2
48,43,Brewster,2011,4856,4577,279,5.7
48,45,Briscoe,2011,722,676,46,6.4
48,47,Brooks,2011,2693,2397,296,11.0
48,49,Brown,2011,16377,15019,1358,8.3
48,51,Burleson,2011,7762,7177,585,7.5
48,53,Burnet,2011,20642,19204,1438,7.0
48,55,Caldwell,2011,16853,15388,1465,8.7
48,57,Calhoun,2011,10599,9667,932,8.8
48,59,Callahan,2011,6014,5569,445,7.4
48,61,Cameron,2011,165944,146311,19633,11.8
48,63,Camp,2011,5680,5154,526,9.3
48,65,Carson,2011,3420,3244,176,5.1
48,67,Cass,2011,13316,11851,1465,11.0
48,69,Castro,2011,4086,3874,212,5.2
48,71,Chambers,2011,16806,15194,1612,9.6
48,73,Cherokee,2011,22202,20340,1862,8.4
48,75,Childress,2011,3080,2916,164,5.3
48,77,Clay,2011,5511,5142,369,6.7
48,79,Cochran,2011,1497,1366,131,8.8
48,81,Coke,2011,1534,1444,90,5.9
48,83,Coleman,2011,3400,3091,309,9.1
48,85,Collin,2011,438356,407778,30578,7.0
48,87,Collingsworth,2011,1305,1227,78,6.0
48,89,Colorado,2011,10107,9297,810,8.0
48,91,Comal,2011,54600,50722,3878,7.1
48,93,Comanche,2011,5943,5487,456,7.7
48,95,Concho,2011,1573,1498,75,4.8
48,97,Cooke,2011,20350,19077,1273,6.3
48,99,Coryell,2011,25647,23613,2034,7.9
48,101,Cottle,2011,668,616,52,7.8
48,103,Crane,2011,1918,1786,132,6.9
48,105,Crockett,2011,1715,1597,118,6.9
48,107,Crosby,2011,3004,2744,260,8.7
48,109,Culberson,2011,1018,945,73,7.2
48,111,Dallam,2011,4048,3865,183,4.5
48,113,Dallas,2011,1211940,1110079,101861,8.4
48,115,Dawson,2011,5220,4817,403,7.7
48,117,Deaf Smith,2011,9621,9081,540,5.6
48,119,Delta,2011,2631,2412,219,8.3
48,121,Denton,2011,379268,353534,25734,6.8
48,123,DeWitt,2011,9467,8836,631,6.7
48,125,Dickens,2011,912,769,143,15.7
48,127,Dimmit,2011,4911,4519,392,8.0
48,129,Donley,2011,1811,1691,120,6.6
48,131,Duval,2011,5213,4706,507,9.7
48,133,Eastland,2011,8417,7751,666,7.9
48,135,Ector,2011,72757,68142,4615,6.3
48,137,Edwards,2011,990,923,67,6.8
48,139,Ellis,2011,76840,70690,6150,8.0
48,141,El Paso,2011,346916,312917,33999,9.8
48,143,Erath,2011,20668,19377,1291,6.2
48,145,Falls,2011,7184,6571,613,8.5
48,147,Fannin,2011,15275,13972,1303,8.5
48,149,Fayette,2011,12495,11750,745,6.0
48,151,Fisher,2011,1940,1807,133,6.9
48,153,Floyd,2011,3327,3063,264,7.9
48,155,Foard,2011,667,616,51,7.6
48,157,Fort Bend,2011,308200,285580,22620,7.3
48,159,Franklin,2011,4756,4355,401,8.4
48,161,Freestone,2011,8077,7423,654,8.1
48,163,Frio,2011,7966,7432,534,6.7
48,165,Gaines,2011,8497,8051,446,5.2
48,167,Galveston,2011,149843,136198,13645,9.1
48,169,Garza,2011,2222,2084,138,6.2
48,171,Gillespie,2011,12431,11748,683,5.5
48,173,Glasscock,2011,746,713,33,4.4
48,175,Goliad,2011,3374,3148,226,6.7
48,177,Gonzales,2011,9465,8864,601,6.3
48,179,Gray,2011,9631,8951,680,7.1
48,181,Grayson,2011,60151,55262,4889,8.1
48,183,Gregg,2011,61052,56543,4509,7.4
48,185,Grimes,2011,11622,10681,941,8.1
48,187,Guadalupe,2011,66706,62243,4463,6.7
48,189,Hale,2011,16230,14976,1254,7.7
48,191,Hall,2011,1400,1275,125,8.9
48,193,Hamilton,2011,3876,3622,254,6.6
48,195,Hansford,2011,3041,2913,128,4.2
48,197,Hardeman,2011,1874,1737,137,7.3
48,199,Hardin,2011,26284,23691,2593,9.9
48,201,Harris,2011,2109727,1938837,170890,8.1
48,203,Harrison,2011,31536,28758,2778,8.8
48,205,Hartley,2011,2809,2694,115,4.1
48,207,Haskell,2011,3035,2867,168,5.5
48,209,Hays,2011,83264,77502,5762,6.9
48,211,Hemphill,2011,2386,2300,86,3.6
48,213,Henderson,2011,35046,31967,3079,8.8
48,215,Hidalgo,2011,326643,287651,38992,11.9
48,217,Hill,2011,15887,14537,1350,8.5
48,219,Hockley,2011,11352,10607,745,6.6
48,221,Hood,2011,23621,21683,1938,8.2
48,223,Hopkins,2011,16853,15575,1278,7.6
48,225,Houston,2011,10651,9799,852,8.0
48,227,Howard,2011,13245,12351,894,6.7
48,229,Hudspeth,2011,1388,1272,116,8.4
48,231,Hunt,2011,38438,34930,3508,9.1
48,233,Hutchinson,2011,9915,9104,811,8.2
48,235,Irion,2011,876,827,49,5.6
48,237,Jack,2011,3712,3446,266,7.2
48,239,Jackson,2011,7348,6875,473,6.4
48,241,Jasper,2011,15056,13139,1917,12.7
48,243,Jeff Davis,2011,1249,1185,64,5.1
48,245,Jefferson,2011,115547,101984,13563,11.7
48,247,Jim Hogg,2011,2330,2122,208,8.9
48,249,Jim Wells,2011,19767,18144,1623,8.2
48,251,Johnson,2011,72738,66895,5843,8.0
48,253,Jones,2011,6137,5613,524,8.5
48,255,Karnes,2011,4887,4494,393,8.0
48,257,Kaufman,2011,51508,47242,4266,8.3
48,259,Kendall,2011,16905,15845,1060,6.3
48,261,Kenedy,2011,239,223,16,6.7
48,263,Kent,2011,554,527,27,4.9
48,265,Kerr,2011,21812,20311,1501,6.9
48,267,Kimble,2011,2231,2088,143,6.4
48,269,King,2011,288,276,12,4.2
48,271,Kinney,2011,1272,1139,133,10.5
48,273,Kleberg,2011,15388,14112,1276,8.3
48,275,Knox,2011,1905,1791,114,6.0
48,277,Lamar,2011,23388,21028,2360,10.1
48,279,Lamb,2011,6727,6202,525,7.8
48,281,Lampasas,2011,9134,8421,713,7.8
48,283,La Salle,2011,3136,2917,219,7.0
48,285,Lavaca,2011,9611,9021,590,6.1
48,287,Lee,2011,8863,8271,592,6.7
48,289,Leon,2011,7159,6517,642,9.0
48,291,Liberty,2011,30816,27286,3530,11.5
48,293,Limestone,2011,9575,8755,820,8.6
48,295,Lipscomb,2011,1740,1658,82,4.7
48,297,Live Oak,2011,5231,4908,323,6.2
48,299,Llano,2011,8011,7371,640,8.0
48,301,Loving,2011,66,62,4,6.1
48,303,Lubbock,2011,145666,136634,9032,6.2
48,305,Lynn,2011,3082,2872,210,6.8
48,307,McCulloch,2011,4356,4089,267,6.1
48,309,McLennan,2011,113321,104616,8705,7.7
48,311,McMullen,2011,659,638,21,3.2
48,313,Madison,2011,4682,4281,401,8.6
48,315,Marion,2011,4425,3949,476,10.8
48,317,Martin,2011,2348,2213,135,5.7
48,319,Mason,2011,1963,1841,122,6.2
48,321,Matagorda,2011,17813,15683,2130,12.0
48,323,Maverick,2011,23955,20495,3460,14.4
48,325,Medina,2011,20235,18674,1561,7.7
48,327,Menard,2011,944,874,70,7.4
48,329,Midland,2011,76562,72801,3761,4.9
48,331,Milam,2011,10416,9321,1095,10.5
48,333,Mills,2011,2170,2029,141,6.5
48,335,Mitchell,2011,2941,2713,228,7.8
48,337,Montague,2011,9596,8950,646,6.7
48,339,Montgomery,2011,231622,214730,16892,7.3
48,341,Moore,2011,11742,11157,585,5.0
48,343,Morris,2011,5820,5100,720,12.4
48,345,Motley,2011,593,551,42,7.1
48,347,Nacogdoches,2011,30605,28398,2207,7.2
48,349,Navarro,2011,23078,21149,1929,8.4
48,351,Newton,2011,6050,5255,795,13.1
48,353,Nolan,2011,7350,6816,534,7.3
48,355,Nueces,2011,164259,150752,13507,8.2
48,357,Ochiltree,2011,5101,4847,254,5.0
48,359,Oldham,2011,979,935,44,4.5
48,361,Orange,2011,39227,34566,4661,11.9
48,363,Palo Pinto,2011,13476,12375,1101,8.2
48,365,Panola,2011,11942,10933,1009,8.4
48,367,Parker,2011,57311,53236,4075,7.1
48,369,Parmer,2011,5283,5040,243,4.6
48,371,Pecos,2011,7192,6746,446,6.2
48,373,Polk,2011,17660,15954,1706,9.7
48,375,Potter,2011,58694,55092,3602,6.1
48,377,Presidio,2011,3789,3197,592,15.6
48,379,Rains,2011,5166,4729,437,8.5
48,381,Randall,2011,68026,64545,3481,5.1
48,383,Reagan,2011,2014,1923,91,4.5
48,385,Real,2011,1135,1020,115,10.1
48,387,Red River,2011,5500,4814,686,12.5
48,389,Reeves,2011,5538,5082,456,8.2
48,391,Refugio,2011,3418,3150,268,7.8
48,393,Roberts,2011,479,455,24,5.0
48,395,Robertson,2011,7544,6829,715,9.5
48,397,Rockwall,2011,40591,37619,2972,7.3
48,399,Runnels,2011,5106,4719,387,7.6
48,401,Rusk,2011,24273,22505,1768,7.3
48,403,Sabine,2011,3470,2908,562,16.2
48,405,San Augustine,2011,3160,2699,461,14.6
48,407,San Jacinto,2011,11370,10238,1132,10.0
48,409,San Patricio,2011,30246,27210,3036,10.0
48,411,San Saba,2011,2519,2362,157,6.2
48,413,Schleicher,2011,1699,1598,101,5.9
48,415,Scurry,2011,7398,6965,433,5.9
48,417,Shackelford,2011,2004,1906,98,4.9
48,419,Shelby,2011,11976,10918,1058,8.8
48,421,Sherman,2011,1576,1502,74,4.7
48,423,Smith,2011,102096,93893,8203,8.0
48,425,Somervell,2011,4085,3756,329,8.1
48,427,Starr,2011,26232,21862,4370,16.7
48,429,Stephens,2011,4440,4082,358,8.1
48,431,Sterling,2011,681,647,34,5.0
48,433,Stonewall,2011,745,703,42,5.6
48,435,Sutton,2011,1948,1809,139,7.1
48,437,Swisher,2011,3149,2930,219,7.0
48,439,Tarrant,2011,950017,875968,74049,7.8
48,441,Taylor,2011,64622,60239,4383,6.8
48,443,Terrell,2011,517,484,33,6.4
48,445,Terry,2011,5849,5420,429,7.3
48,447,Throckmorton,2011,872,809,63,7.2
48,449,Titus,2011,13716,12551,1165,8.5
48,451,Tom Green,2011,53211,49775,3436,6.5
48,453,Travis,2011,593506,554438,39068,6.6
48,455,Trinity,2011,5723,5157,566,9.9
48,457,Tyler,2011,7850,6876,974,12.4
48,459,Upshur,2011,18607,17079,1528,8.2
48,461,Upton,2011,1569,1483,86,5.5
48,463,Uvalde,2011,12144,11031,1113,9.2
48,465,Val Verde,2011,20466,18566,1900,9.3
48,467,Van Zandt,2011,23734,21779,1955,8.2
48,469,Victoria,2011,43711,40664,3047,7.0
48,471,Walker,2011,23164,21285,1879,8.1
48,473,Waller,2011,20339,18619,1720,8.5
48,475,Ward,2011,4936,4604,332,6.7
48,477,Washington,2011,15671,14600,1071,6.8
48,479,Webb,2011,107844,99571,8273,7.7
48,481,Wharton,2011,21492,19661,1831,8.5
48,483,Wheeler,2011,2852,2706,146,5.1
48,485,Wichita,2011,58982,54788,4194,7.1
48,487,Wilbarger,2011,6036,5584,452,7.5
48,489,Willacy,2011,7740,6429,1311,16.9
48,491,Williamson,2011,230756,214564,16192,7.0
48,493,Wilson,2011,21529,20079,1450,6.7
48,495,Winkler,2011,3051,2825,226,7.4
48,497,Wise,2011,28142,25940,2202,7.8
48,499,Wood,2011,16969,15457,1512,8.9
48,501,Yoakum,2011,4161,3936,225,5.4
48,503,Young,2011,8589,7953,636,7.4
48,505,Zapata,2011,6465,5925,540,8.4
48,507,Zavala,2011,4598,3932,666,14.5
49,1,Beaver,2011,3026,2772,254,8.4
49,3,Box Elder,2011,23033,21230,1803,7.8
49,5,Cache,2011,56206,53105,3101,5.5
49,7,Carbon,2011,9490,8737,753,7.9
49,9,Daggett,2011,468,438,30,6.4
49,11,Davis,2011,145592,136414,9178,6.3
49,13,Duchesne,2011,8382,7803,579,6.9
49,15,Emery,2011,5037,4651,386,7.7
49,17,Garfield,2011,2946,2619,327,11.1
49,19,Grand,2011,5284,4749,535,10.1
49,21,Iron,2011,19742,18046,1696,8.6
49,23,Juab,2011,4568,4177,391,8.6
49,25,Kane,2011,3469,3199,270,7.8
49,27,Millard,2011,6124,5784,340,5.6
49,29,Morgan,2011,4215,3963,252,6.0
49,31,Piute,2011,527,472,55,10.4
49,33,Rich,2011,976,902,74,7.6
49,35,Salt Lake,2011,542664,505036,37628,6.9
49,37,San Juan,2011,5924,5306,618,10.4
49,39,Sanpete,2011,11041,10134,907,8.2
49,41,Sevier,2011,9436,8708,728,7.7
49,43,Summit,2011,21066,19715,1351,6.4
49,45,Tooele,2011,27103,25077,2026,7.5
49,47,Uintah,2011,15409,14439,970,6.3
49,49,Utah,2011,229612,214480,15132,6.6
49,51,Wasatch,2011,11303,10479,824,7.3
49,53,Washington,2011,55677,50517,5160,9.3
49,55,Wayne,2011,1421,1273,148,10.4
49,57,Weber,2011,111692,102575,9117,8.2
50,1,Addison,2011,21072,20017,1055,5.0
50,3,Bennington,2011,19933,18643,1290,6.5
50,5,Caledonia,2011,16579,15520,1059,6.4
50,7,Chittenden,2011,95373,91300,4073,4.3
50,9,Essex,2011,3058,2798,260,8.5
50,11,Franklin,2011,27866,26409,1457,5.2
50,13,Grand Isle,2011,4162,3894,268,6.4
50,15,Lamoille,2011,14537,13513,1024,7.0
50,17,Orange,2011,16577,15679,898,5.4
50,19,Orleans,2011,14158,12948,1210,8.5
50,21,Rutland,2011,33254,30962,2292,6.9
50,23,Washington,2011,34819,32962,1857,5.3
50,25,Windham,2011,24953,23534,1419,5.7
50,27,Windsor,2011,31333,29600,1733,5.5
51,1,Accomack,2011,16564,15177,1387,8.4
51,3,Albemarle,2011,52080,49185,2895,5.6
51,5,Alleghany,2011,7893,7276,617,7.8
51,7,Amelia,2011,6251,5785,466,7.5
51,9,Amherst,2011,16153,14983,1170,7.2
51,11,Appomattox,2011,7250,6675,575,7.9
51,13,Arlington,2011,141644,136334,5310,3.7
51,15,Augusta,2011,37375,35012,2363,6.3
51,17,Bath,2011,2572,2410,162,6.3
51,19,Bedford,2011,38759,36258,2501,6.5
51,21,Bland,2011,2854,2644,210,7.4
51,23,Botetourt,2011,17703,16667,1036,5.9
51,25,Brunswick,2011,6806,6089,717,10.5
51,27,Buchanan,2011,8458,7740,718,8.5
51,29,Buckingham,2011,6583,5955,628,9.5
51,31,Campbell,2011,27560,25594,1966,7.1
51,33,Caroline,2011,14450,13157,1293,8.9
51,35,Carroll,2011,13602,12267,1335,9.8
51,36,Charles City,2011,3930,3578,352,9.0
51,37,Charlotte,2011,5391,4865,526,9.8
51,41,Chesterfield,2011,171269,159724,11545,6.7
51,43,Clarke,2011,7761,7318,443,5.7
51,45,Craig,2011,2477,2291,186,7.5
51,47,Culpeper,2011,23359,21878,1481,6.3
51,49,Cumberland,2011,4552,4206,346,7.6
51,51,Dickenson,2011,5451,4913,538,9.9
51,53,Dinwiddie,2011,13622,12538,1084,8.0
51,57,Essex,2011,5690,5219,471,8.3
51,59,Fairfax,2011,619259,589888,29371,4.7
51,61,Fauquier,2011,36073,34092,1981,5.5
51,63,Floyd,2011,8321,7796,525,6.3
51,65,Fluvanna,2011,13245,12477,768,5.8
51,67,Franklin,2011,27639,25573,2066,7.5
51,69,Frederick,2011,43128,40343,2785,6.5
51,71,Giles,2011,8259,7603,656,7.9
51,73,Gloucester,2011,19521,18298,1223,6.3
51,75,Goochland,2011,10360,9703,657,6.3
51,77,Grayson,2011,7191,6415,776,10.8
51,79,Greene,2011,9778,9189,589,6.0
51,81,Greensville,2011,4572,4173,399,8.7
51,83,Halifax,2011,16332,14544,1788,10.9
51,85,Hanover,2011,54872,51605,3267,6.0
51,87,Henrico,2011,170265,158821,11444,6.7
51,89,Henry,2011,22781,19921,2860,12.6
51,91,Highland,2011,1457,1376,81,5.6
51,93,Isle of Wight,2011,18850,17546,1304,6.9
51,95,James City,2011,32554,30577,1977,6.1
51,97,King and Queen,2011,3657,3389,268,7.3
51,99,King George,2011,11704,10890,814,7.0
51,101,King William,2011,8689,8093,596,6.9
51,103,Lancaster,2011,5581,5065,516,9.2
51,105,Lee,2011,10214,9439,775,7.6
51,107,Loudoun,2011,181241,172808,8433,4.7
51,109,Louisa,2011,17913,16695,1218,6.8
51,111,Lunenburg,2011,5500,5032,468,8.5
51,113,Madison,2011,7211,6834,377,5.2
51,115,Mathews,2011,4238,3962,276,6.5
51,117,Mecklenburg,2011,14031,12582,1449,10.3
51,119,Middlesex,2011,5131,4799,332,6.5
51,121,Montgomery,2011,48292,45247,3045,6.3
51,125,Nelson,2011,7593,7113,480,6.3
51,127,New Kent,2011,10423,9757,666,6.4
51,131,Northampton,2011,6354,5791,563,8.9
51,133,Northumberland,2011,6022,5482,540,9.0
51,135,Nottoway,2011,6882,6391,491,7.1
51,137,Orange,2011,15762,14587,1175,7.5
51,139,Page,2011,12466,11091,1375,11.0
51,141,Patrick,2011,8036,7169,867,10.8
51,143,Pittsylvania,2011,31113,28290,2823,9.1
51,145,Powhatan,2011,13533,12691,842,6.2
51,147,Prince Edward,2011,10368,9437,931,9.0
51,149,Prince George,2011,14507,13378,1129,7.8
51,153,Prince William,2011,224848,212158,12690,5.6
51,155,Pulaski,2011,16855,15392,1463,8.7
51,157,Rappahannock,2011,3997,3773,224,5.6
51,159,Richmond,2011,4259,3977,282,6.6
51,161,Roanoke,2011,49648,46833,2815,5.7
51,163,Rockbridge,2011,10993,10249,744,6.8
51,165,Rockingham,2011,41252,38769,2483,6.0
51,167,Russell,2011,11924,10794,1130,9.5
51,169,Scott,2011,10135,9398,737,7.3
51,171,Shenandoah,2011,21047,19571,1476,7.0
51,173,Smyth,2011,13728,12234,1494,10.9
51,175,Southampton,2011,9426,8704,722,7.7
51,177,Spotsylvania,2011,64187,59890,4297,6.7
51,179,Stafford,2011,65045,61043,4002,6.2
51,181,Surry,2011,3753,3437,316,8.4
51,183,Sussex,2011,4375,3917,458,10.5
51,185,Tazewell,2011,18172,16726,1446,8.0
51,187,Warren,2011,20087,18604,1483,7.4
51,191,Washington,2011,27852,25878,1974,7.1
51,193,Westmoreland,2011,9388,8684,704,7.5
51,195,Wise,2011,17229,15911,1318,7.6
51,197,Wythe,2011,14360,13045,1315,9.2
51,199,York,2011,31856,29904,1952,6.1
51,510,Alexandria city,2011,92366,88257,4109,4.4
51,520,Bristol city,2011,8084,7416,668,8.3
51,530,Buena Vista city,2011,3235,2940,295,9.1
51,540,Charlottesville city,2011,23212,21918,1294,5.6
51,550,Chesapeake city,2011,114467,106576,7891,6.9
51,570,Colonial Heights city,2011,8547,7904,643,7.5
51,580,Covington city,2011,2658,2409,249,9.4
51,590,Danville city,2011,20246,17894,2352,11.6
51,595,Emporia city,2011,2553,2277,276,10.8
51,600,Fairfax city,2011,12692,12070,622,4.9
51,610,Falls Church city,2011,7506,7188,318,4.2
51,620,Franklin city,2011,3668,3251,417,11.4
51,630,Fredericksburg city,2011,13052,12006,1046,8.0
51,640,Galax city,2011,3099,2781,318,10.3
51,650,Hampton city,2011,66340,60425,5915,8.9
51,660,Harrisonburg city,2011,23747,21903,1844,7.8
51,670,Hopewell city,2011,9895,8779,1116,11.3
51,678,Lexington city,2011,2289,2080,209,9.1
51,680,Lynchburg city,2011,35703,32834,2869,8.0
51,683,Manassas city,2011,21377,20072,1305,6.1
51,685,Manassas Park city,2011,8621,8140,481,5.6
51,690,Martinsville city,2011,5892,4998,894,15.2
51,700,Newport News city,2011,90550,83192,7358,8.1
51,710,Norfolk city,2011,112742,103387,9355,8.3
51,720,Norton city,2011,2109,1964,145,6.9
51,730,Petersburg city,2011,13690,11934,1756,12.8
51,735,Poquoson city,2011,6360,5998,362,5.7
51,740,Portsmouth city,2011,45701,41440,4261,9.3
51,750,Radford city,2011,8069,7391,678,8.4
51,760,Richmond city,2011,107496,98386,9110,8.5
51,770,Roanoke city,2011,49394,45430,3964,8.0
51,775,Salem city,2011,12814,12001,813,6.3
51,790,Staunton city,2011,11985,11139,846,7.1
51,800,Suffolk city,2011,41842,38738,3104,7.4
51,810,Virginia Beach city,2011,228853,214828,14025,6.1
51,820,Waynesboro city,2011,10161,9342,819,8.1
51,830,Williamsburg city,2011,6733,6130,603,9.0
51,840,Winchester city,2011,14053,13014,1039,7.4
53,1,Adams,2011,8173,7431,742,9.1
53,3,Asotin,2011,9964,9166,798,8.0
53,5,Benton,2011,92110,85344,6766,7.3
53,7,Chelan,2011,41049,37941,3108,7.6
53,9,Clallam,2011,28173,25391,2782,9.9
53,11,Clark,2011,208902,186966,21936,10.5
53,13,Columbia,2011,1836,1682,154,8.4
53,15,Cowlitz,2011,44216,39466,4750,10.7
53,17,Douglas,2011,19104,17487,1617,8.5
53,19,Ferry,2011,2481,2090,391,15.8
53,21,Franklin,2011,38342,35227,3115,8.1
53,23,Garfield,2011,1023,953,70,6.8
53,25,Grant,2011,42352,38492,3860,9.1
53,27,Grays Harbor,2011,29276,25687,3589,12.3
53,29,Island,2011,32336,29702,2634,8.1
53,31,Jefferson,2011,11945,10819,1126,9.4
53,33,King,2011,1106635,1023172,83463,7.5
53,35,Kitsap,2011,116334,107556,8778,7.5
53,37,Kittitas,2011,20569,18856,1713,8.3
53,39,Klickitat,2011,10033,8966,1067,10.6
53,41,Lewis,2011,32103,28412,3691,11.5
53,43,Lincoln,2011,5253,4872,381,7.3
53,45,Mason,2011,23508,21022,2486,10.6
53,47,Okanogan,2011,21111,19160,1951,9.2
53,49,Pacific,2011,8103,7119,984,12.1
53,51,Pend Oreille,2011,4790,4184,606,12.7
53,53,Pierce,2011,382903,348050,34853,9.1
53,55,San Juan,2011,8005,7485,520,6.5
53,57,Skagit,2011,56527,51172,5355,9.5
53,59,Skamania,2011,5018,4466,552,11.0
53,61,Snohomish,2011,383026,348470,34556,9.0
53,63,Spokane,2011,228524,208676,19848,8.7
53,65,Stevens,2011,18060,16049,2011,11.1
53,67,Thurston,2011,122196,112328,9868,8.1
53,69,Wahkiakum,2011,1407,1225,182,12.9
53,71,Walla Walla,2011,29382,27274,2108,7.2
53,73,Whatcom,2011,101769,93557,8212,8.1
53,75,Whitman,2011,22366,21068,1298,5.8
53,77,Yakima,2011,118970,107479,11491,9.7
54,1,Barbour,2011,6771,6153,618,9.1
54,3,Berkeley,2011,51171,47346,3825,7.5
54,5,Boone,2011,8676,7995,681,7.8
54,7,Braxton,2011,5488,4894,594,10.8
54,9,Brooke,2011,10703,9685,1018,9.5
54,11,Cabell,2011,42907,39927,2980,6.9
54,13,Calhoun,2011,2862,2509,353,12.3
54,15,Clay,2011,3566,3137,429,12.0
54,17,Doddridge,2011,3324,3094,230,6.9
54,19,Fayette,2011,17719,16176,1543,8.7
54,21,Gilmer,2011,2814,2591,223,7.9
54,23,Grant,2011,6184,5644,540,8.7
54,25,Greenbrier,2011,15558,14294,1264,8.1
54,27,Hampshire,2011,9789,8950,839,8.6
54,29,Hancock,2011,13877,12443,1434,10.3
54,31,Hardy,2011,5685,5104,581,10.2
54,33,Harrison,2011,31375,29197,2178,6.9
54,35,Jackson,2011,12004,10803,1201,10.0
54,37,Jefferson,2011,27219,25570,1649,6.1
54,39,Kanawha,2011,91648,85319,6329,6.9
54,41,Lewis,2011,7169,6648,521,7.3
54,43,Lincoln,2011,7669,6872,797,10.4
54,45,Logan,2011,12907,11786,1121,8.7
54,47,McDowell,2011,6663,5886,777,11.7
54,49,Marion,2011,26735,24948,1787,6.7
54,51,Marshall,2011,14326,13080,1246,8.7
54,53,Mason,2011,11034,9864,1170,10.6
54,55,Mercer,2011,23715,21734,1981,8.4
54,57,Mineral,2011,12178,11126,1052,8.6
54,59,Mingo,2011,9195,8426,769,8.4
54,61,Monongalia,2011,48559,45935,2624,5.4
54,63,Monroe,2011,5778,5332,446,7.7
54,65,Morgan,2011,7582,6971,611,8.1
54,67,Nicholas,2011,10943,9973,970,8.9
54,69,Ohio,2011,21317,19800,1517,7.1
54,71,Pendleton,2011,3647,3391,256,7.0
54,73,Pleasants,2011,2915,2638,277,9.5
54,75,Pocahontas,2011,3677,3280,397,10.8
54,77,Preston,2011,14630,13544,1086,7.4
54,79,Putnam,2011,26285,24411,1874,7.1
54,81,Raleigh,2011,33011,30701,2310,7.0
54,83,Randolph,2011,12069,10926,1143,9.5
54,85,Ritchie,2011,4307,3926,381,8.8
54,87,Roane,2011,5401,4721,680,12.6
54,89,Summers,2011,4689,4266,423,9.0
54,91,Taylor,2011,7427,6890,537,7.2
54,93,Tucker,2011,3221,2927,294,9.1
54,95,Tyler,2011,3597,3228,369,10.3
54,97,Upshur,2011,10234,9368,866,8.5
54,99,Wayne,2011,16492,15185,1307,7.9
54,101,Webster,2011,3627,3295,332,9.2
54,103,Wetzel,2011,7036,6309,727,10.3
54,105,Wirt,2011,2275,2019,256,11.3
54,107,Wood,2011,38617,35517,3100,8.0
54,109,Wyoming,2011,8308,7595,713,8.6
55,1,Adams,2011,9029,7990,1039,11.5
55,3,Ashland,2011,8281,7463,818,9.9
55,5,Barron,2011,23690,21730,1960,8.3
55,7,Bayfield,2011,7720,6909,811,10.5
55,9,Brown,2011,137281,127649,9632,7.0
55,11,Buffalo,2011,6941,6472,469,6.8
55,13,Burnett,2011,7560,6802,758,10.0
55,15,Calumet,2011,27464,25878,1586,5.8
55,17,Chippewa,2011,33303,30787,2516,7.6
55,19,Clark,2011,17276,15861,1415,8.2
55,21,Columbia,2011,31710,29271,2439,7.7
55,23,Crawford,2011,8431,7672,759,9.0
55,25,Dane,2011,294807,279539,15268,5.2
55,27,Dodge,2011,47513,43897,3616,7.6
55,29,Door,2011,15555,13736,1819,11.7
55,31,Douglas,2011,23563,21833,1730,7.3
55,33,Dunn,2011,23323,21656,1667,7.1
55,35,Eau Claire,2011,57621,54016,3605,6.3
55,37,Florence,2011,2204,1990,214,9.7
55,39,Fond du Lac,2011,56084,52087,3997,7.1
55,41,Forest,2011,4173,3700,473,11.3
55,43,Grant,2011,27864,26019,1845,6.6
55,45,Green,2011,21076,19667,1409,6.7
55,47,Green Lake,2011,10357,9531,826,8.0
55,49,Iowa,2011,13721,12738,983,7.2
55,51,Iron,2011,2746,2459,287,10.5
55,53,Jackson,2011,10200,9405,795,7.8
55,55,Jefferson,2011,46326,42905,3421,7.4
55,57,Juneau,2011,13671,12446,1225,9.0
55,59,Kenosha,2011,85958,78378,7580,8.8
55,61,Kewaunee,2011,11152,10347,805,7.2
55,63,La Crosse,2011,65443,61620,3823,5.8
55,65,Lafayette,2011,9461,8872,589,6.2
55,67,Langlade,2011,10032,9042,990,9.9
55,69,Lincoln,2011,15287,13819,1468,9.6
55,71,Manitowoc,2011,44389,40740,3649,8.2
55,73,Marathon,2011,72541,66963,5578,7.7
55,75,Marinette,2011,21464,19434,2030,9.5
55,77,Marquette,2011,7583,6850,733,9.7
55,78,Menominee,2011,1595,1327,268,16.8
55,79,Milwaukee,2011,476301,433145,43156,9.1
55,81,Monroe,2011,23132,21473,1659,7.2
55,83,Oconto,2011,21058,19086,1972,9.4
55,85,Oneida,2011,18839,17111,1728,9.2
55,87,Outagamie,2011,100142,93255,6887,6.9
55,89,Ozaukee,2011,47356,44532,2824,6.0
55,91,Pepin,2011,4092,3838,254,6.2
55,93,Pierce,2011,23950,22542,1408,5.9
55,95,Polk,2011,24083,22063,2020,8.4
55,97,Portage,2011,38920,36062,2858,7.3
55,99,Price,2011,7208,6579,629,8.7
55,101,Racine,2011,100238,91402,8836,8.8
55,103,Richland,2011,9652,8952,700,7.3
55,105,Rock,2011,80950,73427,7523,9.3
55,107,Rusk,2011,6865,6125,740,10.8
55,109,St. Croix,2011,47418,44459,2959,6.2
55,111,Sauk,2011,35923,33260,2663,7.4
55,113,Sawyer,2011,8156,7272,884,10.8
55,115,Shawano,2011,21718,19784,1934,8.9
55,117,Sheboygan,2011,60899,56044,4855,8.0
55,119,Taylor,2011,11266,10337,929,8.2
55,121,Trempealeau,2011,16165,15119,1046,6.5
55,123,Vernon,2011,15146,14117,1029,6.8
55,125,Vilas,2011,10126,9045,1081,10.7
55,127,Walworth,2011,56124,51754,4370,7.8
55,129,Washburn,2011,7963,7271,692,8.7
55,131,Washington,2011,75115,70108,5007,6.7
55,133,Waukesha,2011,217340,203655,13685,6.3
55,135,Waupaca,2011,27635,25392,2243,8.1
55,137,Waushara,2011,11884,10749,1135,9.6
55,139,Winnebago,2011,92192,85864,6328,6.9
55,141,Wood,2011,39906,36663,3243,8.1
56,1,Albany,2011,21536,20574,962,4.5
56,3,Big Horn,2011,5669,5303,366,6.5
56,5,Campbell,2011,25536,24202,1334,5.2
56,7,Carbon,2011,8054,7544,510,6.3
56,9,Converse,2011,7558,7170,388,5.1
56,11,Crook,2011,3834,3636,198,5.2
56,13,Fremont,2011,20955,19519,1436,6.9
56,15,Goshen,2011,7540,7156,384,5.1
56,17,Hot Springs,2011,2565,2427,138,5.4
56,19,Johnson,2011,4458,4163,295,6.6
56,21,Laramie,2011,46585,43522,3063,6.6
56,23,Lincoln,2011,8641,7921,720,8.3
56,25,Natrona,2011,40613,37995,2618,6.4
56,27,Niobrara,2011,1375,1315,60,4.4
56,29,Park,2011,15888,14913,975,6.1
56,31,Platte,2011,4898,4637,261,5.3
56,33,Sheridan,2011,15869,14706,1163,7.3
56,35,Sublette,2011,5823,5540,283,4.9
56,37,Sweetwater,2011,23578,22261,1317,5.6
56,39,Teton,2011,13476,12404,1072,8.0
56,41,Uinta,2011,10041,9380,661,6.6
56,43,Washakie,2011,4530,4263,267,5.9
56,45,Weston,2011,3911,3723,188,4.8
72,1,Adjuntas Municipio,2011,5084,4009,1075,21.1
72,3,Aguada Municipio,2011,13119,10516,2603,19.8
72,5,Aguadilla Municipio,2011,16681,13369,3312,19.9
72,7,Aguas Buenas Municipio,2011,7570,5990,1580,20.9
72,9,Aibonito Municipio,2011,7346,5879,1467,20.0
72,11,Anasco Municipio,2011,9609,7828,1781,18.5
72,13,Arecibo Municipio,2011,26615,21888,4727,17.8
72,15,Arroyo Municipio,2011,5946,4561,1385,23.3
72,17,Barceloneta Municipio,2011,6339,4909,1430,22.6
72,19,Barranquitas Municipio,2011,7952,6574,1378,17.3
72,21,Bayamon Municipio,2011,73800,64479,9321,12.6
72,23,Cabo Rojo Municipio,2011,14929,12452,2477,16.6
72,25,Caguas Municipio,2011,52923,44964,7959,15.0
72,27,Camuy Municipio,2011,10345,8695,1650,15.9
72,29,Canovanas Municipio,2011,17013,14218,2795,16.4
72,31,Carolina Municipio,2011,68178,59923,8255,12.1
72,33,Catano Municipio,2011,8930,7578,1352,15.1
72,35,Cayey Municipio,2011,17622,14826,2796,15.9
72,37,Ceiba Municipio,2011,4490,3559,931,20.7
72,39,Ciales Municipio,2011,4473,3382,1091,24.4
72,41,Cidra Municipio,2011,16958,14318,2640,15.6
72,43,Coamo Municipio,2011,12181,9471,2710,22.2
72,45,Comerio Municipio,2011,5612,4421,1191,21.2
72,47,Corozal Municipio,2011,10047,8267,1780,17.7
72,49,Culebra Municipio,2011,766,705,61,8.0
72,51,Dorado Municipio,2011,13079,11672,1407,10.8
72,53,Fajardo Municipio,2011,13187,10512,2675,20.3
72,54,Florida Municipio,2011,3680,2918,762,20.7
72,55,Guanica Municipio,2011,4929,3671,1258,25.5
72,57,Guayama Municipio,2011,14058,10882,3176,22.6
72,59,Guayanilla Municipio,2011,5910,4568,1342,22.7
72,61,Guaynabo Municipio,2011,39566,36423,3143,7.9
72,63,Gurabo Municipio,2011,17303,15026,2277,13.2
72,65,Hatillo Municipio,2011,13700,11388,2312,16.9
72,67,Hormigueros Municipio,2011,5950,5019,931,15.6
72,69,Humacao Municipio,2011,19630,15429,4201,21.4
72,71,Isabela Municipio,2011,12944,10411,2533,19.6
72,73,Jayuya Municipio,2011,4733,3820,913,19.3
72,75,Juana Diaz Municipio,2011,16786,13807,2979,17.7
72,77,Juncos Municipio,2011,13056,10653,2403,18.4
72,79,Lajas Municipio,2011,6259,4797,1462,23.4
72,81,Lares Municipio,2011,7920,6278,1642,20.7
72,83,Las Marias Municipio,2011,3928,3269,659,16.8
72,85,Las Piedras Municipio,2011,11998,9691,2307,19.2
72,87,Loiza Municipio,2011,9657,8200,1457,15.1
72,89,Luquillo Municipio,2011,7072,5600,1472,20.8
72,91,Manati Municipio,2011,12834,10595,2239,17.4
72,93,Maricao Municipio,2011,2201,1794,407,18.5
72,95,Maunabo Municipio,2011,3444,2577,867,25.2
72,97,Mayaguez Municipio,2011,26410,21525,4885,18.5
72,99,Moca Municipio,2011,11687,9294,2393,20.5
72,101,Morovis Municipio,2011,8854,7013,1841,20.8
72,103,Naguabo Municipio,2011,8709,7033,1676,19.2
72,105,Naranjito Municipio,2011,7935,6415,1520,19.2
72,107,Orocovis Municipio,2011,5788,4591,1197,20.7
72,109,Patillas Municipio,2011,5693,4222,1471,25.8
72,111,Penuelas Municipio,2011,7126,5514,1612,22.6
72,113,Ponce Municipio,2011,53630,44602,9028,16.8
72,115,Quebradillas Municipio,2011,6548,5273,1275,19.5
72,117,Rincon Municipio,2011,4908,3942,966,19.7
72,119,Rio Grande Municipio,2011,18181,15547,2634,14.5
72,121,Sabana Grande Municipio,2011,7234,5661,1573,21.7
72,123,Salinas Municipio,2011,9070,6704,2366,26.1
72,125,San German Municipio,2011,11456,9321,2135,18.6
72,127,San Juan Municipio,2011,148359,133606,14753,9.9
72,129,San Lorenzo Municipio,2011,12965,10677,2288,17.6
72,131,San Sebastian Municipio,2011,11582,8911,2671,23.1
72,133,Santa Isabel Municipio,2011,9784,7633,2151,22.0
72,135,Toa Alta Municipio,2011,26679,23589,3090,11.6
72,137,Toa Baja Municipio,2011,32618,28600,4018,12.3
72,139,Trujillo Alto Municipio,2011,29103,26226,2877,9.9
72,141,Utuado Municipio,2011,7720,6159,1561,20.2
72,143,Vega Alta Municipio,2011,10506,8752,1754,16.7
72,145,Vega Baja Municipio,2011,15294,12430,2864,18.7
72,147,Vieques Municipio,2011,3175,2671,504,15.9
72,149,Villalba Municipio,2011,8485,6681,1804,21.3
72,151,Yabucoa Municipio,2011,10631,7924,2707,25.5
72,153,Yauco Municipio,2011,11761,9263,2498,21.2
1,1,Autauga,2012,25762,23932,1830,7.1
1,3,Baldwin,2012,84507,77973,6534,7.7
1,5,Barbour,2012,9377,8273,1104,11.8
1,7,Bibb,2012,8808,8037,771,8.8
1,9,Blount,2012,24978,23216,1762,7.1
1,11,Bullock,2012,4742,4240,502,10.6
1,13,Butler,2012,9103,8029,1074,11.8
1,15,Calhoun,2012,49717,45196,4521,9.1
1,17,Chambers,2012,15160,13630,1530,10.1
1,19,Cherokee,2012,11278,10350,928,8.2
1,21,Chilton,2012,19396,17960,1436,7.4
1,23,Choctaw,2012,4798,4292,506,10.5
1,25,Clarke,2012,8397,7107,1290,15.4
1,27,Clay,2012,5419,4899,520,9.6
1,29,Cleburne,2012,5842,5351,491,8.4
1,31,Coffee,2012,20625,19135,1490,7.2
1,33,Colbert,2012,24057,21895,2162,9.0
1,35,Conecuh,2012,4643,4077,566,12.2
1,37,Coosa,2012,4451,4025,426,9.6
1,39,Covington,2012,16364,14960,1404,8.6
1,41,Crenshaw,2012,6257,5725,532,8.5
1,43,Cullman,2012,35607,32795,2812,7.9
1,45,Dale,2012,21388,19757,1631,7.6
1,47,Dallas,2012,16780,14565,2215,13.2
1,49,DeKalb,2012,28868,26193,2675,9.3
1,51,Elmore,2012,36657,34045,2612,7.1
1,53,Escambia,2012,14749,13358,1391,9.4
1,55,Etowah,2012,44283,40540,3743,8.5
1,57,Fayette,2012,6511,5936,575,8.8
1,59,Franklin,2012,13989,12790,1199,8.6
1,61,Geneva,2012,11283,10408,875,7.8
1,63,Greene,2012,3132,2698,434,13.9
1,65,Hale,2012,6223,5492,731,11.7
1,67,Henry,2012,7037,6439,598,8.5
1,69,Houston,2012,46100,42525,3575,7.8
1,71,Jackson,2012,23760,21669,2091,8.8
1,73,Jefferson,2012,316771,292662,24109,7.6
1,75,Lamar,2012,5810,5363,447,7.7
1,77,Lauderdale,2012,43451,40035,3416,7.9
1,79,Lawrence,2012,14408,13078,1330,9.2
1,81,Lee,2012,68967,64169,4798,7.0
1,83,Limestone,2012,39017,36267,2750,7.0
1,85,Lowndes,2012,4093,3448,645,15.8
1,87,Macon,2012,8299,7388,911,11.0
1,89,Madison,2012,170324,158207,12117,7.1
1,91,Marengo,2012,7661,6865,796,10.4
1,93,Marion,2012,12465,11326,1139,9.1
1,95,Marshall,2012,40730,37477,3253,8.0
1,97,Mobile,2012,188890,171102,17788,9.4
1,99,Monroe,2012,7988,6963,1025,12.8
1,101,Montgomery,2012,107436,98546,8890,8.3
1,103,Morgan,2012,57472,52866,4606,8.0
1,105,Perry,2012,3691,3188,503,13.6
1,107,Pickens,2012,7477,6701,776,10.4
1,109,Pike,2012,15034,13802,1232,8.2
1,111,Randolph,2012,9154,8294,860,9.4
1,113,Russell,2012,24945,22697,2248,9.0
1,115,St. Clair,2012,38544,35827,2717,7.0
1,117,Shelby,2012,105474,100036,5438,5.2
1,119,Sumter,2012,5425,4842,583,10.7
1,121,Talladega,2012,35056,31693,3363,9.6
1,123,Tallapoosa,2012,18461,16830,1631,8.8
1,125,Tuscaloosa,2012,95418,88575,6843,7.2
1,127,Walker,2012,26608,24107,2501,9.4
1,129,Washington,2012,6887,6046,841,12.2
1,131,Wilcox,2012,2894,2305,589,20.4
1,133,Winston,2012,9621,8637,984,10.2
2,13,Aleutians East Borough,2012,2130,1983,147,6.9
2,16,Aleutians West Census Area,2012,4252,3953,299,7.0
2,20,Anchorage Borough/municipality,2012,157748,149177,8571,5.4
2,50,Bethel Census Area,2012,7193,6074,1119,15.6
2,60,Bristol Bay Borough,2012,479,431,48,10.0
2,68,Denali Borough,2012,1043,898,145,13.9
2,70,Dillingham Census Area,2012,2124,1911,213,10.0
2,90,Fairbanks North Star Borough,2012,48009,45047,2962,6.2
2,100,Haines Borough,2012,1104,992,112,10.1
2,105,Hoonah-Angoon Census Area,2012,1106,945,161,14.6
2,110,Juneau Borough/city,2012,17831,16909,922,5.2
2,122,Kenai Peninsula Borough,2012,27270,24881,2389,8.8
2,130,Ketchikan Gateway Borough,2012,7151,6561,590,8.3
2,150,Kodiak Island Borough,2012,6691,6237,454,6.8
2,158,Kusilvak Census Area,2012,2764,2146,618,22.4
2,164,Lake and Peninsula Borough,2012,635,537,98,15.4
2,170,Matanuska-Susitna Borough,2012,43610,39776,3834,8.8
2,180,Nome Census Area,2012,4166,3673,493,11.8
2,185,North Slope Borough,2012,4012,3697,315,7.9
2,188,Northwest Arctic Borough,2012,3024,2542,482,15.9
2,195,Petersburg Borough,2012,1870,1716,154,8.2
2,198,Prince of Wales-Hyder Census Area,2012,2583,2236,347,13.4
2,220,Sitka Borough/city,2012,4627,4362,265,5.7
2,230,Skagway Municipality,2012,752,645,107,14.2
2,240,Southeast Fairbanks Census Area,2012,3029,2634,395,13.0
2,261,Valdez-Cordova Census Area,2012,4877,4397,480,9.8
2,275,Wrangell Borough/city,2012,1022,937,85,8.3
2,282,Yakutat Borough/city,2012,287,259,28,9.8
2,290,Yukon-Koyukuk Census Area,2012,2766,2280,486,17.6
4,1,Apache,2012,23001,18637,4364,19.0
4,3,Cochise,2012,54343,49438,4905,9.0
4,5,Coconino,2012,71626,65467,6159,8.6
4,7,Gila,2012,21100,18943,2157,10.2
4,9,Graham,2012,14594,13353,1241,8.5
4,11,Greenlee,2012,3584,3289,295,8.2
4,12,La Paz,2012,8205,7503,702,8.6
4,13,Maricopa,2012,1911529,1772341,139188,7.3
4,15,Mohave,2012,78227,69600,8627,11.0
4,17,Navajo,2012,43323,37200,6123,14.1
4,19,Pima,2012,466804,432392,34412,7.4
4,21,Pinal,2012,149940,137136,12804,8.5
4,23,Santa Cruz,2012,20293,17157,3136,15.5
4,25,Yavapai,2012,93162,85150,8012,8.6
4,27,Yuma,2012,94613,72028,22585,23.9
5,1,Arkansas,2012,9958,9120,838,8.4
5,3,Ashley,2012,9490,8394,1096,11.5
5,5,Baxter,2012,16446,15116,1330,8.1
5,7,Benton,2012,111298,104879,6419,5.8
5,9,Boone,2012,16590,15376,1214,7.3
5,11,Bradley,2012,4531,4062,469,10.4
5,13,Calhoun,2012,2536,2317,219,8.6
5,15,Carroll,2012,12539,11778,761,6.1
5,17,Chicot,2012,4074,3628,446,10.9
5,19,Clark,2012,10341,9355,986,9.5
5,21,Clay,2012,6884,6156,728,10.6
5,23,Cleburne,2012,10456,9603,853,8.2
5,25,Cleveland,2012,3767,3500,267,7.1
5,27,Columbia,2012,10162,9282,880,8.7
5,29,Conway,2012,8739,7968,771,8.8
5,31,Craighead,2012,49275,46024,3251,6.6
5,33,Crawford,2012,27720,25599,2121,7.7
5,35,Crittenden,2012,22176,20135,2041,9.2
5,37,Cross,2012,8566,7913,653,7.6
5,39,Dallas,2012,3303,2951,352,10.7
5,41,Desha,2012,5958,5392,566,9.5
5,43,Drew,2012,8517,7656,861,10.1
5,45,Faulkner,2012,59986,56177,3809,6.3
5,47,Franklin,2012,7703,7178,525,6.8
5,49,Fulton,2012,5130,4775,355,6.9
5,51,Garland,2012,41366,38227,3139,7.6
5,53,Grant,2012,8462,7909,553,6.5
5,55,Greene,2012,20077,18413,1664,8.3
5,57,Hempstead,2012,10925,10162,763,7.0
5,59,Hot Spring,2012,14600,13592,1008,6.9
5,61,Howard,2012,6496,6080,416,6.4
5,63,Independence,2012,16133,14708,1425,8.8
5,65,Izard,2012,5186,4748,438,8.4
5,67,Jackson,2012,6492,5819,673,10.4
5,69,Jefferson,2012,32576,29435,3141,9.6
5,71,Johnson,2012,10879,10111,768,7.1
5,73,Lafayette,2012,2925,2662,263,9.0
5,75,Lawrence,2012,7300,6664,636,8.7
5,77,Lee,2012,3532,3212,320,9.1
5,79,Lincoln,2012,4602,4215,387,8.4
5,81,Little River,2012,6005,5584,421,7.0
5,83,Logan,2012,9664,8922,742,7.7
5,85,Lonoke,2012,33234,31210,2024,6.1
5,87,Madison,2012,7005,6611,394,5.6
5,89,Marion,2012,6633,6109,524,7.9
5,91,Miller,2012,20358,19195,1163,5.7
5,93,Mississippi,2012,20319,18179,2140,10.5
5,95,Monroe,2012,3284,3000,284,8.6
5,97,Montgomery,2012,3620,3326,294,8.1
5,99,Nevada,2012,4156,3847,309,7.4
5,101,Newton,2012,3644,3387,257,7.1
5,103,Ouachita,2012,10614,9550,1064,10.0
5,105,Perry,2012,4429,4044,385,8.7
5,107,Phillips,2012,7990,7100,890,11.1
5,109,Pike,2012,4433,4052,381,8.6
5,111,Poinsett,2012,10423,9556,867,8.3
5,113,Polk,2012,8772,8148,624,7.1
5,115,Pope,2012,30198,28091,2107,7.0
5,117,Prairie,2012,3842,3563,279,7.3
5,119,Pulaski,2012,189310,176846,12464,6.6
5,121,Randolph,2012,6891,6175,716,10.4
5,123,St. Francis,2012,9527,8536,991,10.4
5,125,Saline,2012,54644,51443,3201,5.9
5,127,Scott,2012,4710,4409,301,6.4
5,129,Searcy,2012,3232,2977,255,7.9
5,131,Sebastian,2012,59261,54791,4470,7.5
5,133,Sevier,2012,6224,5706,518,8.3
5,135,Sharp,2012,6127,5529,598,9.8
5,137,Stone,2012,5071,4670,401,7.9
5,139,Union,2012,16879,15383,1496,8.9
5,141,Van Buren,2012,6629,5980,649,9.8
5,143,Washington,2012,105913,100201,5712,5.4
5,145,White,2012,36432,33682,2750,7.5
5,147,Woodruff,2012,3393,3061,332,9.8
5,149,Yell,2012,9326,8725,601,6.4
6,1,Alameda,2012,796456,726131,70325,8.8
6,3,Alpine,2012,543,482,61,11.2
6,5,Amador,2012,14646,12822,1824,12.5
6,7,Butte,2012,100812,88363,12449,12.3
6,9,Calaveras,2012,20166,17634,2532,12.6
6,11,Colusa,2012,11270,8900,2370,21.0
6,13,Contra Costa,2012,534520,485934,48586,9.1
6,15,Del Norte,2012,10481,9040,1441,13.7
6,17,El Dorado,2012,88866,79638,9228,10.4
6,19,Fresno,2012,439492,371963,67529,15.4
6,21,Glenn,2012,13129,11237,1892,14.4
6,23,Humboldt,2012,64128,57888,6240,9.7
6,25,Imperial,2012,79347,57355,21992,27.7
6,27,Inyo,2012,9536,8656,880,9.2
6,29,Kern,2012,391269,338995,52274,13.4
6,31,Kings,2012,58733,49849,8884,15.1
6,33,Lake,2012,29460,25635,3825,13.0
6,35,Lassen,2012,11451,10002,1449,12.7
6,37,Los Angeles,2012,4904883,4365690,539193,11.0
6,39,Madera,2012,62446,53282,9164,14.7
6,41,Marin,2012,136522,127796,8726,6.4
6,43,Mariposa,2012,8361,7323,1038,12.4
6,45,Mendocino,2012,40860,36693,4167,10.2
6,47,Merced,2012,114901,95852,19049,16.6
6,49,Modoc,2012,3607,3080,527,14.6
6,51,Mono,2012,8383,7502,881,10.5
6,53,Monterey,2012,217399,191832,25567,11.8
6,55,Napa,2012,71645,65492,6153,8.6
6,57,Nevada,2012,48257,43474,4783,9.9
6,59,Orange,2012,1558477,1433508,124969,8.0
6,61,Placer,2012,174534,157910,16624,9.5
6,63,Plumas,2012,8477,7087,1390,16.4
6,65,Riverside,2012,985244,868757,116487,11.8
6,67,Sacramento,2012,679873,607250,72623,10.7
6,69,San Benito,2012,28632,24837,3795,13.3
6,71,San Bernardino,2012,890518,787254,103264,11.6
6,73,San Diego,2012,1536925,1394274,142651,9.3
6,75,San Francisco/city,2012,508011,473033,34978,6.9
6,77,San Joaquin,2012,311393,265990,45403,14.6
6,79,San Luis Obispo,2012,137013,125533,11480,8.4
6,81,San Mateo,2012,410898,384118,26780,6.5
6,83,Santa Barbara,2012,215485,197127,18358,8.5
6,85,Santa Clara,2012,955979,879447,76532,8.0
6,87,Santa Cruz,2012,141801,124756,17045,12.0
6,89,Shasta,2012,75904,64968,10936,14.4
6,91,Sierra,2012,1467,1253,214,14.6
6,93,Siskiyou,2012,18854,15865,2989,15.9
6,95,Solano,2012,202237,180260,21977,10.9
6,97,Sonoma,2012,245671,223564,22107,9.0
6,99,Stanislaus,2012,241659,205116,36543,15.1
6,101,Sutter,2012,45516,37750,7766,17.1
6,103,Tehama,2012,25211,21693,3518,14.0
6,105,Trinity,2012,5323,4532,791,14.9
6,107,Tulare,2012,201078,168088,32990,16.4
6,109,Tuolumne,2012,22278,19341,2937,13.2
6,111,Ventura,2012,433668,393575,40093,9.2
6,113,Yolo,2012,102397,91322,11075,10.8
6,115,Yuba,2012,28798,24297,4501,15.6
8,1,Adams,2012,238797,216056,22741,9.5
8,3,Alamosa,2012,7737,6915,822,10.6
8,5,Arapahoe,2012,321927,296756,25171,7.8
8,7,Archuleta,2012,5722,5140,582,10.2
8,9,Baca,2012,2008,1916,92,4.6
8,11,Bent,2012,1717,1571,146,8.5
8,13,Boulder,2012,173808,162818,10990,6.3
8,14,Broomfield/city,2012,32175,30009,2166,6.7
8,15,Chaffee,2012,8343,7765,578,6.9
8,17,Cheyenne,2012,1006,960,46,4.6
8,19,Clear Creek,2012,5470,5080,390,7.1
8,21,Conejos,2012,3703,3304,399,10.8
8,23,Costilla,2012,1599,1414,185,11.6
8,25,Crowley,2012,1358,1247,111,8.2
8,27,Custer,2012,1981,1853,128,6.5
8,29,Delta,2012,14365,12958,1407,9.8
8,31,Denver/city,2012,356577,328259,28318,7.9
8,33,Dolores,2012,947,849,98,10.3
8,35,Douglas,2012,160408,150643,9765,6.1
8,37,Eagle,2012,32251,29912,2339,7.3
8,39,Elbert,2012,12654,11742,912,7.2
8,41,El Paso,2012,306176,278707,27469,9.0
8,43,Fremont,2012,15596,13755,1841,11.8
8,45,Garfield,2012,31397,28698,2699,8.6
8,47,Gilpin,2012,3257,3037,220,6.8
8,49,Grand,2012,8722,8081,641,7.3
8,51,Gunnison,2012,9801,9207,594,6.1
8,53,Hinsdale,2012,435,414,21,4.8
8,55,Huerfano,2012,2629,2250,379,14.4
8,57,Jackson,2012,824,780,44,5.3
8,59,Jefferson,2012,303422,280682,22740,7.5
8,61,Kiowa,2012,815,777,38,4.7
8,63,Kit Carson,2012,4214,4025,189,4.5
8,65,Lake,2012,4511,4117,394,8.7
8,67,La Plata,2012,29577,27583,1994,6.7
8,69,Larimer,2012,172358,160643,11715,6.8
8,71,Las Animas,2012,6947,6102,845,12.2
8,73,Lincoln,2012,2150,2009,141,6.6
8,75,Logan,2012,11033,10363,670,6.1
8,77,Mesa,2012,74728,67409,7319,9.8
8,79,Mineral,2012,443,419,24,5.4
8,81,Moffat,2012,7723,7076,647,8.4
8,83,Montezuma,2012,12881,11766,1115,8.7
8,85,Montrose,2012,19785,17716,2069,10.5
8,87,Morgan,2012,14937,13911,1026,6.9
8,89,Otero,2012,8379,7508,871,10.4
8,91,Ouray,2012,2079,1882,197,9.5
8,93,Park,2012,9270,8627,643,6.9
8,95,Phillips,2012,2134,2022,112,5.2
8,97,Pitkin,2012,10877,10085,792,7.3
8,99,Prowers,2012,6081,5649,432,7.1
8,101,Pueblo,2012,74301,66256,8045,10.8
8,103,Rio Blanco,2012,3084,2822,262,8.5
8,105,Rio Grande,2012,5093,4463,630,12.4
8,107,Routt,2012,14329,13285,1044,7.3
8,109,Saguache,2012,3047,2705,342,11.2
8,111,San Juan,2012,534,480,54,10.1
8,113,San Miguel,2012,4844,4457,387,8.0
8,115,Sedgwick,2012,1116,1037,79,7.1
8,117,Summit,2012,19265,18085,1180,6.1
8,119,Teller,2012,11879,10869,1010,8.5
8,121,Washington,2012,2627,2497,130,4.9
8,123,Weld,2012,136480,125752,10728,7.9
8,125,Yuma,2012,4868,4614,254,5.2
9,1,Fairfield,2012,472533,435685,36848,7.8
9,3,Hartford,2012,472532,432133,40399,8.5
9,5,Litchfield,2012,106065,97981,8084,7.6
9,7,Middlesex,2012,92041,85447,6594,7.2
9,9,New Haven,2012,456952,415352,41600,9.1
9,11,New London,2012,139606,127495,12111,8.7
9,13,Tolland,2012,84693,78466,6227,7.4
9,15,Windham,2012,63125,57129,5996,9.5
10,1,Kent,2012,74346,68567,5779,7.8
10,3,New Castle,2012,278591,259505,19086,6.9
10,5,Sussex,2012,93026,86418,6608,7.1
11,1,District of Colu,2012,365176,332412,32764,9.0
12,1,Alachua,2012,129079,120238,8841,6.8
12,3,Baker,2012,11275,10277,998,8.9
12,5,Bay,2012,86154,78467,7687,8.9
12,7,Bradford,2012,11074,10210,864,7.8
12,9,Brevard,2012,261046,235751,25295,9.7
12,11,Broward,2012,957268,878506,78762,8.2
12,13,Calhoun,2012,5060,4583,477,9.4
12,15,Charlotte,2012,65484,59064,6420,9.8
12,17,Citrus,2012,51257,45575,5682,11.1
12,19,Clay,2012,95686,88172,7514,7.9
12,21,Collier,2012,151770,138572,13198,8.7
12,23,Columbia,2012,27864,25329,2535,9.1
12,27,DeSoto,2012,12823,11507,1316,10.3
12,29,Dixie,2012,5774,5166,608,10.5
12,31,Duval,2012,453464,412793,40671,9.0
12,33,Escambia,2012,138780,126754,12026,8.7
12,35,Flagler,2012,41902,37643,4259,10.2
12,37,Franklin,2012,5015,4680,335,6.7
12,39,Gadsden,2012,18790,16794,1996,10.6
12,41,Gilchrist,2012,6675,6051,624,9.3
12,43,Glades,2012,5663,5213,450,7.9
12,45,Gulf,2012,6050,5546,504,8.3
12,47,Hamilton,2012,5142,4673,469,9.1
12,49,Hardee,2012,11769,10690,1079,9.2
12,51,Hendry,2012,16911,14690,2221,13.1
12,53,Hernando,2012,65910,58728,7182,10.9
12,55,Highlands,2012,37162,33227,3935,10.6
12,57,Hillsborough,2012,664074,609993,54081,8.1
12,59,Holmes,2012,7122,6473,649,9.1
12,61,Indian River,2012,61660,54700,6960,11.3
12,63,Jackson,2012,17949,16348,1601,8.9
12,65,Jefferson,2012,5472,4950,522,9.5
12,67,Lafayette,2012,3460,3256,204,5.9
12,69,Lake,2012,133178,121063,12115,9.1
12,71,Lee,2012,290468,264043,26425,9.1
12,73,Leon,2012,148301,137606,10695,7.2
12,75,Levy,2012,16630,15035,1595,9.6
12,77,Liberty,2012,2729,2505,224,8.2
12,79,Madison,2012,7947,7245,702,8.8
12,81,Manatee,2012,149768,137215,12553,8.4
12,83,Marion,2012,129686,116046,13640,10.5
12,85,Martin,2012,66705,60993,5712,8.6
12,86,Miami-Dade,2012,1287313,1185974,101339,7.9
12,87,Monroe,2012,43603,41044,2559,5.9
12,89,Nassau,2012,35715,32750,2965,8.3
12,91,Okaloosa,2012,90810,84517,6293,6.9
12,93,Okeechobee,2012,18211,16341,1870,10.3
12,95,Orange,2012,649668,594652,55016,8.5
12,97,Osceola,2012,142662,128766,13896,9.7
12,99,Palm Beach,2012,656413,598903,57510,8.8
12,101,Pasco,2012,207412,188053,19359,9.3
12,103,Pinellas,2012,463951,425850,38101,8.2
12,105,Polk,2012,275402,248119,27283,9.9
12,107,Putnam,2012,28775,25274,3501,12.2
12,109,St. Johns,2012,103312,96348,6964,6.7
12,111,St. Lucie,2012,128364,113893,14471,11.3
12,113,Santa Rosa,2012,72170,66565,5605,7.8
12,115,Sarasota,2012,166931,152422,14509,8.7
12,117,Seminole,2012,229622,210480,19142,8.3
12,119,Sumter,2012,26712,23804,2908,10.9
12,121,Suwannee,2012,18220,16714,1506,8.3
12,123,Taylor,2012,9350,8484,866,9.3
12,125,Union,2012,5052,4676,376,7.4
12,127,Volusia,2012,235956,212873,23083,9.8
12,129,Wakulla,2012,14025,12970,1055,7.5
12,131,Walton,2012,26092,24133,1959,7.5
12,133,Washington,2012,9999,9090,909,9.1
13,1,Appling,2012,8947,7959,988,11.0
13,3,Atkinson,2012,3433,3042,391,11.4
13,5,Bacon,2012,4542,4108,434,9.6
13,7,Baker,2012,1168,1041,127,10.9
13,9,Baldwin,2012,18806,16655,2151,11.4
13,11,Banks,2012,8562,7869,693,8.1
13,13,Barrow,2012,34445,31517,2928,8.5
13,15,Bartow,2012,47254,42631,4623,9.8
13,17,Ben Hill,2012,6156,5310,846,13.7
13,19,Berrien,2012,7830,7040,790,10.1
13,21,Bibb,2012,71469,64047,7422,10.4
13,23,Bleckley,2012,5260,4608,652,12.4
13,25,Brantley,2012,7411,6532,879,11.9
13,27,Brooks,2012,6784,6172,612,9.0
13,29,Bryan,2012,15103,13869,1234,8.2
13,31,Bulloch,2012,33801,30541,3260,9.6
13,33,Burke,2012,9678,8500,1178,12.2
13,35,Butts,2012,10336,9292,1044,10.1
13,37,Calhoun,2012,2367,2185,182,7.7
13,39,Camden,2012,21807,19963,1844,8.5
13,43,Candler,2012,5168,4727,441,8.5
13,45,Carroll,2012,51829,46582,5247,10.1
13,47,Catoosa,2012,32145,29780,2365,7.4
13,49,Charlton,2012,4962,4506,456,9.2
13,51,Chatham,2012,131535,119558,11977,9.1
13,53,Chattahoochee,2012,2591,2292,299,11.5
13,55,Chattooga,2012,10602,9533,1069,10.1
13,57,Cherokee,2012,114682,106681,8001,7.0
13,59,Clarke,2012,57948,52974,4974,8.6
13,61,Clay,2012,1005,881,124,12.3
13,63,Clayton,2012,127159,112073,15086,11.9
13,65,Clinch,2012,2906,2628,278,9.6
13,67,Cobb,2012,387385,357927,29458,7.6
13,69,Coffee,2012,17408,15452,1956,11.2
13,71,Colquitt,2012,20933,19123,1810,8.6
13,73,Columbia,2012,64503,60067,4436,6.9
13,75,Cook,2012,7507,6807,700,9.3
13,77,Coweta,2012,65278,60150,5128,7.9
13,79,Crawford,2012,5810,5248,562,9.7
13,81,Crisp,2012,9139,8013,1126,12.3
13,83,Dade,2012,8358,7731,627,7.5
13,85,Dawson,2012,10822,9908,914,8.4
13,87,Decatur,2012,12201,10984,1217,10.0
13,89,DeKalb,2012,368814,334647,34167,9.3
13,91,Dodge,2012,8121,7198,923,11.4
13,93,Dooly,2012,4795,4252,543,11.3
13,95,Dougherty,2012,40755,36216,4539,11.1
13,97,Douglas,2012,66743,60426,6317,9.5
13,99,Early,2012,4472,4025,447,10.0
13,101,Echols,2012,1801,1670,131,7.3
13,103,Effingham,2012,25871,23739,2132,8.2
13,105,Elbert,2012,8522,7466,1056,12.4
13,107,Emanuel,2012,9057,7951,1106,12.2
13,109,Evans,2012,4787,4384,403,8.4
13,111,Fannin,2012,9982,8977,1005,10.1
13,113,Fayette,2012,53324,49359,3965,7.4
13,115,Floyd,2012,44642,39833,4809,10.8
13,117,Forsyth,2012,93459,87366,6093,6.5
13,119,Franklin,2012,9506,8449,1057,11.1
13,121,Fulton,2012,509382,463742,45640,9.0
13,123,Gilmer,2012,12112,10852,1260,10.4
13,125,Glascock,2012,1318,1192,126,9.6
13,127,Glynn,2012,38656,35044,3612,9.3
13,129,Gordon,2012,26748,24167,2581,9.6
13,131,Grady,2012,10797,9882,915,8.5
13,133,Greene,2012,6396,5697,699,10.9
13,135,Gwinnett,2012,432720,399656,33064,7.6
13,137,Habersham,2012,18359,16639,1720,9.4
13,139,Hall,2012,88828,82015,6813,7.7
13,141,Hancock,2012,2745,2285,460,16.8
13,143,Haralson,2012,12058,10841,1217,10.1
13,145,Harris,2012,16223,15072,1151,7.1
13,147,Hart,2012,10783,9690,1093,10.1
13,149,Heard,2012,5103,4584,519,10.2
13,151,Henry,2012,102845,93325,9520,9.3
13,153,Houston,2012,68515,63085,5430,7.9
13,155,Irwin,2012,3529,3121,408,11.6
13,157,Jackson,2012,29313,26941,2372,8.1
13,159,Jasper,2012,6641,6001,640,9.6
13,161,Jeff Davis,2012,6357,5634,723,11.4
13,163,Jefferson,2012,7055,6136,919,13.0
13,165,Jenkins,2012,3350,2896,454,13.6
13,167,Johnson,2012,4050,3652,398,9.8
13,169,Jones,2012,13830,12674,1156,8.4
13,171,Lamar,2012,7936,6991,945,11.9
13,173,Lanier,2012,3896,3537,359,9.2
13,175,Laurens,2012,19721,17338,2383,12.1
13,177,Lee,2012,14277,13201,1076,7.5
13,179,Liberty,2012,27061,24686,2375,8.8
13,181,Lincoln,2012,3525,3150,375,10.6
13,183,Long,2012,6625,6067,558,8.4
13,185,Lowndes,2012,52282,47580,4702,9.0
13,187,Lumpkin,2012,15126,13882,1244,8.2
13,189,McDuffie,2012,9293,8137,1156,12.4
13,191,McIntosh,2012,6010,5433,577,9.6
13,193,Macon,2012,5151,4476,675,13.1
13,195,Madison,2012,13084,11931,1153,8.8
13,197,Marion,2012,3599,3244,355,9.9
13,199,Meriwether,2012,8995,7930,1065,11.8
13,201,Miller,2012,2691,2474,217,8.1
13,205,Mitchell,2012,9581,8743,838,8.7
13,207,Monroe,2012,12779,11689,1090,8.5
13,209,Montgomery,2012,3886,3440,446,11.5
13,211,Morgan,2012,8511,7754,757,8.9
13,213,Murray,2012,16338,14277,2061,12.6
13,215,Muscogee,2012,83331,75280,8051,9.7
13,217,Newton,2012,48130,42907,5223,10.9
13,219,Oconee,2012,17016,15960,1056,6.2
13,221,Oglethorpe,2012,6871,6292,579,8.4
13,223,Paulding,2012,74215,68145,6070,8.2
13,225,Peach,2012,12499,11127,1372,11.0
13,227,Pickens,2012,13851,12611,1240,9.0
13,229,Pierce,2012,8307,7534,773,9.3
13,231,Pike,2012,8392,7628,764,9.1
13,233,Polk,2012,18730,16883,1847,9.9
13,235,Pulaski,2012,4367,3979,388,8.9
13,237,Putnam,2012,8259,7321,938,11.4
13,239,Quitman,2012,940,852,88,9.4
13,241,Rabun,2012,6912,6131,781,11.3
13,243,Randolph,2012,2824,2476,348,12.3
13,245,Richmond,2012,88115,78891,9224,10.5
13,247,Rockdale,2012,41985,37768,4217,10.0
13,249,Schley,2012,2168,1945,223,10.3
13,251,Screven,2012,5670,4898,772,13.6
13,253,Seminole,2012,3242,2893,349,10.8
13,255,Spalding,2012,28080,24608,3472,12.4
13,257,Stephens,2012,11721,10507,1214,10.4
13,259,Stewart,2012,2309,2101,208,9.0
13,261,Sumter,2012,13905,12276,1629,11.7
13,263,Talbot,2012,2911,2623,288,9.9
13,265,Taliaferro,2012,604,519,85,14.1
13,267,Tattnall,2012,9780,8979,801,8.2
13,269,Taylor,2012,3103,2694,409,13.2
13,271,Telfair,2012,5324,4706,618,11.6
13,273,Terrell,2012,3741,3339,402,10.7
13,275,Thomas,2012,18422,16662,1760,9.6
13,277,Tift,2012,19088,17191,1897,9.9
13,279,Toombs,2012,12469,11023,1446,11.6
13,281,Towns,2012,4425,3931,494,11.2
13,283,Treutlen,2012,2893,2509,384,13.3
13,285,Troup,2012,35480,32046,3434,9.7
13,287,Turner,2012,3446,3049,397,11.5
13,289,Twiggs,2012,3160,2697,463,14.7
13,291,Union,2012,9630,8790,840,8.7
13,293,Upson,2012,11949,10692,1257,10.5
13,295,Walker,2012,30820,28089,2731,8.9
13,297,Walton,2012,40998,37325,3673,9.0
13,299,Ware,2012,15426,13887,1539,10.0
13,301,Warren,2012,2641,2252,389,14.7
13,303,Washington,2012,8054,7233,821,10.2
13,305,Wayne,2012,12561,11239,1322,10.5
13,307,Webster,2012,1058,954,104,9.8
13,309,Wheeler,2012,1951,1694,257,13.2
13,311,White,2012,13524,12371,1153,8.5
13,313,Whitfield,2012,45579,40804,4775,10.5
13,315,Wilcox,2012,2856,2528,328,11.5
13,317,Wilkes,2012,3826,3366,460,12.0
13,319,Wilkinson,2012,3724,3302,422,11.3
13,321,Worth,2012,9586,8625,961,10.0
15,1,Hawaii,2012,87293,80231,7062,8.1
15,3,Honolulu/city,2012,447994,424107,23887,5.3
15,7,Kauai,2012,34727,32275,2452,7.1
15,9,Maui,2012,80401,75371,5030,6.3
16,1,Ada,2012,205064,192057,13007,6.3
16,3,Adams,2012,1752,1485,267,15.2
16,5,Bannock,2012,41349,38418,2931,7.1
16,7,Bear Lake,2012,2891,2726,165,5.7
16,9,Benewah,2012,4180,3660,520,12.4
16,11,Bingham,2012,22849,21357,1492,6.5
16,13,Blaine,2012,11770,10922,848,7.2
16,15,Boise,2012,2980,2690,290,9.7
16,17,Bonner,2012,18696,16691,2005,10.7
16,19,Bonneville,2012,49290,46104,3186,6.5
16,21,Boundary,2012,5243,4737,506,9.7
16,23,Butte,2012,1341,1229,112,8.4
16,25,Camas,2012,673,609,64,9.5
16,27,Canyon,2012,87374,79199,8175,9.4
16,29,Caribou,2012,3986,3738,248,6.2
16,31,Cassia,2012,11151,10491,660,5.9
16,33,Clark,2012,426,393,33,7.7
16,35,Clearwater,2012,3287,2865,422,12.8
16,37,Custer,2012,2345,2150,195,8.3
16,39,Elmore,2012,10720,9891,829,7.7
16,41,Franklin,2012,6330,6031,299,4.7
16,43,Fremont,2012,6952,6511,441,6.3
16,45,Gem,2012,7650,6910,740,9.7
16,47,Gooding,2012,8119,7645,474,5.8
16,49,Idaho,2012,6679,5932,747,11.2
16,51,Jefferson,2012,12238,11468,770,6.3
16,53,Jerome,2012,10914,10191,723,6.6
16,55,Kootenai,2012,68936,62746,6190,9.0
16,57,Latah,2012,19696,18522,1174,6.0
16,59,Lemhi,2012,3584,3223,361,10.1
16,61,Lewis,2012,1602,1513,89,5.6
16,63,Lincoln,2012,2713,2456,257,9.5
16,65,Madison,2012,18488,17624,864,4.7
16,67,Minidoka,2012,10416,9769,647,6.2
16,69,Nez Perce,2012,19945,18770,1175,5.9
16,71,Oneida,2012,2099,1993,106,5.1
16,73,Owyhee,2012,5118,4901,217,4.2
16,75,Payette,2012,10886,10009,877,8.1
16,77,Power,2012,4106,3778,328,8.0
16,79,Shoshone,2012,5637,4881,756,13.4
16,81,Teton,2012,5333,5010,323,6.1
16,83,Twin Falls,2012,37806,35126,2680,7.1
16,85,Valley,2012,4694,4156,538,11.5
16,87,Washington,2012,4807,4391,416,8.7
17,1,Adams,2012,33731,31518,2213,6.6
17,3,Alexander,2012,2748,2418,330,12.0
17,5,Bond,2012,8242,7499,743,9.0
17,7,Boone,2012,26721,23921,2800,10.5
17,9,Brown,2012,2617,2460,157,6.0
17,11,Bureau,2012,18128,16451,1677,9.3
17,13,Calhoun,2012,2435,2191,244,10.0
17,15,Carroll,2012,8027,7366,661,8.2
17,17,Cass,2012,6574,6014,560,8.5
17,19,Champaign,2012,107160,99565,7595,7.1
17,21,Christian,2012,16434,14887,1547,9.4
17,23,Clark,2012,7998,7226,772,9.7
17,25,Clay,2012,6623,5981,642,9.7
17,27,Clinton,2012,20275,18920,1355,6.7
17,29,Coles,2012,24739,22555,2184,8.8
17,31,Cook,2012,2663370,2406145,257225,9.7
17,33,Crawford,2012,10396,9591,805,7.7
17,35,Cumberland,2012,5936,5472,464,7.8
17,37,DeKalb,2012,55461,50748,4713,8.5
17,39,De Witt,2012,8481,7794,687,8.1
17,41,Douglas,2012,9980,9260,720,7.2
17,43,DuPage,2012,508341,470119,38222,7.5
17,45,Edgar,2012,9086,8202,884,9.7
17,47,Edwards,2012,3046,2806,240,7.9
17,49,Effingham,2012,18435,17221,1214,6.6
17,51,Fayette,2012,10645,9687,958,9.0
17,53,Ford,2012,6957,6437,520,7.5
17,55,Franklin,2012,17330,15475,1855,10.7
17,57,Fulton,2012,16881,15196,1685,10.0
17,59,Gallatin,2012,2515,2302,213,8.5
17,61,Greene,2012,6452,5907,545,8.4
17,63,Grundy,2012,25851,22876,2975,11.5
17,65,Hamilton,2012,3907,3594,313,8.0
17,67,Hancock,2012,9235,8465,770,8.3
17,69,Hardin,2012,1728,1545,183,10.6
17,71,Henderson,2012,3713,3416,297,8.0
17,73,Henry,2012,26141,24196,1945,7.4
17,75,Iroquois,2012,15168,13860,1308,8.6
17,77,Jackson,2012,29070,26781,2289,7.9
17,79,Jasper,2012,4918,4540,378,7.7
17,81,Jefferson,2012,17816,16167,1649,9.3
17,83,Jersey,2012,11350,10320,1030,9.1
17,85,Jo Daviess,2012,11831,10930,901,7.6
17,87,Johnson,2012,4287,3788,499,11.6
17,89,Kane,2012,266912,243009,23903,9.0
17,91,Kankakee,2012,55378,49470,5908,10.7
17,93,Kendall,2012,63731,58382,5349,8.4
17,95,Knox,2012,24291,22258,2033,8.4
17,97,Lake,2012,365531,335653,29878,8.2
17,99,LaSalle,2012,59300,53306,5994,10.1
17,101,Lawrence,2012,6453,5791,662,10.3
17,103,Lee,2012,18149,16640,1509,8.3
17,105,Livingston,2012,18146,16731,1415,7.8
17,107,Logan,2012,13450,12435,1015,7.5
17,109,McDonough,2012,14948,13797,1151,7.7
17,111,McHenry,2012,167661,152545,15116,9.0
17,113,McLean,2012,94493,88452,6041,6.4
17,115,Macon,2012,54340,48944,5396,9.9
17,117,Macoupin,2012,23961,21674,2287,9.5
17,119,Madison,2012,135081,123107,11974,8.9
17,121,Marion,2012,18590,16760,1830,9.8
17,123,Marshall,2012,6194,5675,519,8.4
17,125,Mason,2012,6982,6278,704,10.1
17,127,Massac,2012,6545,5913,632,9.7
17,129,Menard,2012,6851,6359,492,7.2
17,131,Mercer,2012,8632,7961,671,7.8
17,133,Monroe,2012,17855,16650,1205,6.7
17,135,Montgomery,2012,13115,11635,1480,11.3
17,137,Morgan,2012,17650,16280,1370,7.8
17,139,Moultrie,2012,7363,6837,526,7.1
17,141,Ogle,2012,26528,23831,2697,10.2
17,143,Peoria,2012,95751,87671,8080,8.4
17,145,Perry,2012,9191,8211,980,10.7
17,147,Piatt,2012,8806,8212,594,6.7
17,149,Pike,2012,7763,7173,590,7.6
17,151,Pope,2012,1883,1721,162,8.6
17,153,Pulaski,2012,2367,2096,271,11.4
17,155,Putnam,2012,3123,2830,293,9.4
17,157,Randolph,2012,14550,13322,1228,8.4
17,159,Richland,2012,7515,6909,606,8.1
17,161,Rock Island,2012,75306,69246,6060,8.0
17,163,St. Clair,2012,129815,117358,12457,9.6
17,165,Saline,2012,11601,10541,1060,9.1
17,167,Sangamon,2012,104950,97124,7826,7.5
17,169,Schuyler,2012,3611,3325,286,7.9
17,171,Scott,2012,2694,2458,236,8.8
17,173,Shelby,2012,10757,9829,928,8.6
17,175,Stark,2012,2989,2744,245,8.2
17,177,Stephenson,2012,23413,21285,2128,9.1
17,179,Tazewell,2012,71145,65789,5356,7.5
17,181,Union,2012,7550,6720,830,11.0
17,183,Vermilion,2012,36797,33364,3433,9.3
17,185,Wabash,2012,5748,5289,459,8.0
17,187,Warren,2012,8892,8258,634,7.1
17,189,Washington,2012,9109,8528,581,6.4
17,191,Wayne,2012,7996,7379,617,7.7
17,193,White,2012,7246,6695,551,7.6
17,195,Whiteside,2012,29369,26773,2596,8.8
17,197,Will,2012,357443,322411,35032,9.8
17,199,Williamson,2012,31721,28964,2757,8.7
17,201,Winnebago,2012,145295,129872,15423,10.6
17,203,Woodford,2012,20400,19176,1224,6.0
18,1,Adams,2012,15901,14797,1104,6.9
18,3,Allen,2012,173981,159595,14386,8.3
18,5,Bartholomew,2012,41457,38847,2610,6.3
18,7,Benton,2012,4554,4220,334,7.3
18,9,Blackford,2012,5463,4847,616,11.3
18,11,Boone,2012,30262,28450,1812,6.0
18,13,Brown,2012,7329,6751,578,7.9
18,15,Carroll,2012,9995,9271,724,7.2
18,17,Cass,2012,17792,16285,1507,8.5
18,19,Clark,2012,55457,51182,4275,7.7
18,21,Clay,2012,12815,11570,1245,9.7
18,23,Clinton,2012,16584,15273,1311,7.9
18,25,Crawford,2012,4793,4291,502,10.5
18,27,Daviess,2012,14807,13930,877,5.9
18,29,Dearborn,2012,24998,22805,2193,8.8
18,31,Decatur,2012,13593,12508,1085,8.0
18,33,DeKalb,2012,20589,18894,1695,8.2
18,35,Delaware,2012,54933,49864,5069,9.2
18,37,Dubois,2012,21611,20396,1215,5.6
18,39,Elkhart,2012,96921,88387,8534,8.8
18,41,Fayette,2012,9170,8162,1008,11.0
18,43,Floyd,2012,37820,35171,2649,7.0
18,45,Fountain,2012,8538,7832,706,8.3
18,47,Franklin,2012,10564,9574,990,9.4
18,49,Fulton,2012,10090,9258,832,8.2
18,51,Gibson,2012,17415,16240,1175,6.7
18,53,Grant,2012,32357,29253,3104,9.6
18,55,Greene,2012,13819,12394,1425,10.3
18,57,Hamilton,2012,151320,143404,7916,5.2
18,59,Hancock,2012,35763,33179,2584,7.2
18,61,Harrison,2012,18575,17161,1414,7.6
18,63,Hendricks,2012,76982,72185,4797,6.2
18,65,Henry,2012,21156,19059,2097,9.9
18,67,Howard,2012,35941,32729,3212,8.9
18,69,Huntington,2012,18601,16987,1614,8.7
18,71,Jackson,2012,20506,18998,1508,7.4
18,73,Jasper,2012,15985,14706,1279,8.0
18,75,Jay,2012,10094,9306,788,7.8
18,77,Jefferson,2012,15237,13960,1277,8.4
18,79,Jennings,2012,13118,11786,1332,10.2
18,81,Johnson,2012,72616,67639,4977,6.9
18,83,Knox,2012,18740,17420,1320,7.0
18,85,Kosciusko,2012,38780,35836,2944,7.6
18,87,LaGrange,2012,17019,15826,1193,7.0
18,89,Lake,2012,229040,208488,20552,9.0
18,91,LaPorte,2012,49730,44948,4782,9.6
18,93,Lawrence,2012,20563,18341,2222,10.8
18,95,Madison,2012,58025,52315,5710,9.8
18,97,Marion,2012,458702,416997,41705,9.1
18,99,Marshall,2012,22978,21120,1858,8.1
18,101,Martin,2012,5085,4728,357,7.0
18,103,Miami,2012,15645,14145,1500,9.6
18,105,Monroe,2012,66823,62036,4787,7.2
18,107,Montgomery,2012,18608,17110,1498,8.1
18,109,Morgan,2012,34705,31838,2867,8.3
18,111,Newton,2012,6926,6272,654,9.4
18,113,Noble,2012,22638,20717,1921,8.5
18,115,Ohio,2012,3182,2904,278,8.7
18,117,Orange,2012,8780,7848,932,10.6
18,119,Owen,2012,9836,8782,1054,10.7
18,121,Parke,2012,6994,6288,706,10.1
18,123,Perry,2012,8882,8146,736,8.3
18,125,Pike,2012,6137,5691,446,7.3
18,127,Porter,2012,82465,76282,6183,7.5
18,129,Posey,2012,13205,12326,879,6.7
18,131,Pulaski,2012,6277,5821,456,7.3
18,133,Putnam,2012,16348,14753,1595,9.8
18,135,Randolph,2012,12768,11567,1201,9.4
18,137,Ripley,2012,13856,12630,1226,8.8
18,139,Rush,2012,8384,7682,702,8.4
18,141,St. Joseph,2012,127863,115943,11920,9.3
18,143,Scott,2012,10187,9153,1034,10.2
18,145,Shelby,2012,22336,20498,1838,8.2
18,147,Spencer,2012,10803,10035,768,7.1
18,149,Starke,2012,10113,9056,1057,10.5
18,151,Steuben,2012,18934,17574,1360,7.2
18,153,Sullivan,2012,8807,7999,808,9.2
18,155,Switzerland,2012,4895,4522,373,7.6
18,157,Tippecanoe,2012,88542,82474,6068,6.9
18,159,Tipton,2012,8017,7403,614,7.7
18,161,Union,2012,3559,3277,282,7.9
18,163,Vanderburgh,2012,91909,84972,6937,7.5
18,165,Vermillion,2012,7471,6632,839,11.2
18,167,Vigo,2012,50169,45259,4910,9.8
18,169,Wabash,2012,15707,14393,1314,8.4
18,171,Warren,2012,4202,3896,306,7.3
18,173,Warrick,2012,30846,28781,2065,6.7
18,175,Washington,2012,13184,11956,1228,9.3
18,177,Wayne,2012,30711,27716,2995,9.8
18,179,Wells,2012,13725,12755,970,7.1
18,181,White,2012,13042,12039,1003,7.7
18,183,Whitley,2012,16916,15591,1325,7.8
19,1,Adair,2012,4064,3885,179,4.4
19,3,Adams,2012,2191,2104,87,4.0
19,5,Allamakee,2012,7626,7133,493,6.5
19,7,Appanoose,2012,6013,5619,394,6.6
19,9,Audubon,2012,3229,3074,155,4.8
19,11,Benton,2012,13830,13093,737,5.3
19,13,Black Hawk,2012,71516,67615,3901,5.5
19,15,Boone,2012,14630,13994,636,4.3
19,17,Bremer,2012,13922,13386,536,3.9
19,19,Buchanan,2012,11069,10535,534,4.8
19,21,Buena Vista,2012,11272,10801,471,4.2
19,23,Butler,2012,8245,7871,374,4.5
19,25,Calhoun,2012,4446,4200,246,5.5
19,27,Carroll,2012,11382,10954,428,3.8
19,29,Cass,2012,7222,6846,376,5.2
19,31,Cedar,2012,10707,10218,489,4.6
19,33,Cerro Gordo,2012,23816,22484,1332,5.6
19,35,Cherokee,2012,6885,6585,300,4.4
19,37,Chickasaw,2012,6321,5991,330,5.2
19,39,Clarke,2012,4629,4350,279,6.0
19,41,Clay,2012,8920,8468,452,5.1
19,43,Clayton,2012,10207,9625,582,5.7
19,45,Clinton,2012,25201,23642,1559,6.2
19,47,Crawford,2012,8792,8398,394,4.5
19,49,Dallas,2012,39323,37779,1544,3.9
19,51,Davis,2012,4107,3870,237,5.8
19,53,Decatur,2012,4261,4071,190,4.5
19,55,Delaware,2012,10298,9835,463,4.5
19,57,Des Moines,2012,20175,18929,1246,6.2
19,59,Dickinson,2012,9217,8694,523,5.7
19,61,Dubuque,2012,54844,52350,2494,4.5
19,63,Emmet,2012,5736,5479,257,4.5
19,65,Fayette,2012,10837,10247,590,5.4
19,67,Floyd,2012,8158,7647,511,6.3
19,69,Franklin,2012,5836,5574,262,4.5
19,71,Fremont,2012,4026,3819,207,5.1
19,73,Greene,2012,5138,4882,256,5.0
19,75,Grundy,2012,6679,6373,306,4.6
19,77,Guthrie,2012,5578,5263,315,5.6
19,79,Hamilton,2012,7078,6587,491,6.9
19,81,Hancock,2012,6005,5730,275,4.6
19,83,Hardin,2012,8793,8321,472,5.4
19,85,Harrison,2012,7568,7185,383,5.1
19,87,Henry,2012,9661,9084,577,6.0
19,89,Howard,2012,5221,4979,242,4.6
19,91,Humboldt,2012,5178,4958,220,4.2
19,93,Ida,2012,3788,3635,153,4.0
19,95,Iowa,2012,9633,9198,435,4.5
19,97,Jackson,2012,10863,10266,597,5.5
19,99,Jasper,2012,18620,17507,1113,6.0
19,101,Jefferson,2012,8797,8333,464,5.3
19,103,Johnson,2012,80618,77638,2980,3.7
19,105,Jones,2012,10719,10153,566,5.3
19,107,Keokuk,2012,5446,5146,300,5.5
19,109,Kossuth,2012,8418,8090,328,3.9
19,111,Lee,2012,17550,16284,1266,7.2
19,113,Linn,2012,119371,113117,6254,5.2
19,115,Louisa,2012,5812,5492,320,5.5
19,117,Lucas,2012,4200,3999,201,4.8
19,119,Lyon,2012,6861,6657,204,3.0
19,121,Madison,2012,8169,7712,457,5.6
19,123,Mahaska,2012,11685,11077,608,5.2
19,125,Marion,2012,17132,16307,825,4.8
19,127,Marshall,2012,19881,18600,1281,6.4
19,129,Mills,2012,7294,6957,337,4.6
19,131,Mitchell,2012,5575,5320,255,4.6
19,133,Monona,2012,4553,4261,292,6.4
19,135,Monroe,2012,3996,3764,232,5.8
19,137,Montgomery,2012,5052,4794,258,5.1
19,139,Muscatine,2012,21326,20099,1227,5.8
19,141,O'Brien,2012,8073,7765,308,3.8
19,143,Osceola,2012,3398,3256,142,4.2
19,145,Page,2012,6703,6340,363,5.4
19,147,Palo Alto,2012,4776,4571,205,4.3
19,149,Plymouth,2012,14248,13663,585,4.1
19,151,Pocahontas,2012,4179,4010,169,4.0
19,153,Polk,2012,245132,232379,12753,5.2
19,155,Pottawattamie,2012,48657,46186,2471,5.1
19,157,Poweshiek,2012,10199,9700,499,4.9
19,159,Ringgold,2012,2548,2435,113,4.4
19,161,Sac,2012,5525,5290,235,4.3
19,163,Scott,2012,87600,82565,5035,5.7
19,165,Shelby,2012,7019,6754,265,3.8
19,167,Sioux,2012,19452,18778,674,3.5
19,169,Story,2012,53543,51624,1919,3.6
19,171,Tama,2012,9126,8576,550,6.0
19,173,Taylor,2012,3156,3026,130,4.1
19,175,Union,2012,6880,6531,349,5.1
19,177,Van Buren,2012,3814,3593,221,5.8
19,179,Wapello,2012,17967,16712,1255,7.0
19,181,Warren,2012,25989,24744,1245,4.8
19,183,Washington,2012,12199,11684,515,4.2
19,185,Wayne,2012,2804,2651,153,5.5
19,187,Webster,2012,19360,18129,1231,6.4
19,189,Winnebago,2012,5138,4862,276,5.4
19,191,Winneshiek,2012,11934,11382,552,4.6
19,193,Woodbury,2012,54503,51644,2859,5.2
19,195,Worth,2012,4238,4006,232,5.5
19,197,Wright,2012,6819,6452,367,5.4
20,1,Allen,2012,6888,6397,491,7.1
20,3,Anderson,2012,4316,4035,281,6.5
20,5,Atchison,2012,7864,7257,607,7.7
20,7,Barber,2012,2740,2634,106,3.9
20,9,Barton,2012,15020,14345,675,4.5
20,11,Bourbon,2012,6739,6224,515,7.6
20,13,Brown,2012,5256,4975,281,5.3
20,15,Butler,2012,32114,30120,1994,6.2
20,17,Chase,2012,1330,1260,70,5.3
20,19,Chautauqua,2012,1701,1590,111,6.5
20,21,Cherokee,2012,10611,9783,828,7.8
20,23,Cheyenne,2012,1335,1287,48,3.6
20,25,Clark,2012,1205,1163,42,3.5
20,27,Clay,2012,4263,4043,220,5.2
20,29,Cloud,2012,4590,4362,228,5.0
20,31,Coffey,2012,4538,4220,318,7.0
20,33,Comanche,2012,1003,964,39,3.9
20,35,Cowley,2012,17281,16216,1065,6.2
20,37,Crawford,2012,19357,18075,1282,6.6
20,39,Decatur,2012,1406,1344,62,4.4
20,41,Dickinson,2012,10099,9489,610,6.0
20,43,Doniphan,2012,4410,4134,276,6.3
20,45,Douglas,2012,63740,60473,3267,5.1
20,47,Edwards,2012,1648,1582,66,4.0
20,49,Elk,2012,1352,1260,92,6.8
20,51,Ellis,2012,18089,17471,618,3.4
20,53,Ellsworth,2012,3500,3378,122,3.5
20,55,Finney,2012,20232,19330,902,4.5
20,57,Ford,2012,18896,18167,729,3.9
20,59,Franklin,2012,14026,13011,1015,7.2
20,61,Geary,2012,12855,11743,1112,8.7
20,63,Gove,2012,1518,1473,45,3.0
20,65,Graham,2012,1391,1344,47,3.4
20,67,Grant,2012,4003,3847,156,3.9
20,69,Gray,2012,3576,3465,111,3.1
20,71,Greeley,2012,887,860,27,3.0
20,73,Greenwood,2012,3439,3247,192,5.6
20,75,Hamilton,2012,1832,1783,49,2.7
20,77,Harper,2012,3119,2984,135,4.3
20,79,Harvey,2012,17314,16376,938,5.4
20,81,Haskell,2012,2471,2388,83,3.4
20,83,Hodgeman,2012,1115,1077,38,3.4
20,85,Jackson,2012,7373,6959,414,5.6
20,87,Jefferson,2012,10279,9658,621,6.0
20,89,Jewell,2012,1455,1393,62,4.3
20,91,Johnson,2012,311453,297179,14274,4.6
20,93,Kearny,2012,2178,2092,86,3.9
20,95,Kingman,2012,3783,3551,232,6.1
20,97,Kiowa,2012,1412,1359,53,3.8
20,99,Labette,2012,10749,9897,852,7.9
20,101,Lane,2012,904,862,42,4.6
20,103,Leavenworth,2012,34573,32367,2206,6.4
20,105,Lincoln,2012,1854,1764,90,4.9
20,107,Linn,2012,4398,3964,434,9.9
20,109,Logan,2012,1761,1708,53,3.0
20,111,Lyon,2012,17293,16291,1002,5.8
20,113,McPherson,2012,16718,16032,686,4.1
20,115,Marion,2012,6369,6043,326,5.1
20,117,Marshall,2012,6107,5853,254,4.2
20,119,Meade,2012,2480,2397,83,3.3
20,121,Miami,2012,16816,15756,1060,6.3
20,123,Mitchell,2012,3883,3767,116,3.0
20,125,Montgomery,2012,18474,17050,1424,7.7
20,127,Morris,2012,3215,3019,196,6.1
20,129,Morton,2012,1663,1601,62,3.7
20,131,Nemaha,2012,6020,5803,217,3.6
20,133,Neosho,2012,6922,6313,609,8.8
20,135,Ness,2012,1632,1579,53,3.2
20,137,Norton,2012,3156,3058,98,3.1
20,139,Osage,2012,8371,7769,602,7.2
20,141,Osborne,2012,2180,2087,93,4.3
20,143,Ottawa,2012,3232,3058,174,5.4
20,145,Pawnee,2012,3434,3294,140,4.1
20,147,Phillips,2012,3023,2888,135,4.5
20,149,Pottawatomie,2012,11626,11081,545,4.7
20,151,Pratt,2012,5457,5212,245,4.5
20,153,Rawlins,2012,1574,1532,42,2.7
20,155,Reno,2012,32190,30438,1752,5.4
20,157,Republic,2012,2621,2521,100,3.8
20,159,Rice,2012,5424,5183,241,4.4
20,161,Riley,2012,36386,34803,1583,4.4
20,163,Rooks,2012,2778,2649,129,4.6
20,165,Rush,2012,1898,1810,88,4.6
20,167,Russell,2012,3823,3667,156,4.1
20,169,Saline,2012,30824,29054,1770,5.7
20,171,Scott,2012,2785,2700,85,3.1
20,173,Sedgwick,2012,247647,230665,16982,6.9
20,175,Seward,2012,10870,10424,446,4.1
20,177,Shawnee,2012,92329,86629,5700,6.2
20,179,Sheridan,2012,1552,1509,43,2.8
20,181,Sherman,2012,3229,3106,123,3.8
20,183,Smith,2012,2223,2136,87,3.9
20,185,Stafford,2012,2226,2123,103,4.6
20,187,Stanton,2012,1052,1015,37,3.5
20,189,Stevens,2012,2897,2795,102,3.5
20,191,Sumner,2012,11341,10620,721,6.4
20,193,Thomas,2012,4559,4402,157,3.4
20,195,Trego,2012,1515,1450,65,4.3
20,197,Wabaunsee,2012,3802,3596,206,5.4
20,199,Wallace,2012,876,839,37,4.2
20,201,Washington,2012,3260,3125,135,4.1
20,203,Wichita,2012,1337,1267,70,5.2
20,205,Wilson,2012,4204,3787,417,9.9
20,207,Woodson,2012,1650,1548,102,6.2
20,209,Wyandotte,2012,74632,68370,6262,8.4
21,1,Adair,2012,7829,7082,747,9.5
21,3,Allen,2012,9028,8302,726,8.0
21,5,Anderson,2012,11543,10743,800,6.9
21,7,Ballard,2012,3883,3527,356,9.2
21,9,Barren,2012,19842,18273,1569,7.9
21,11,Bath,2012,4894,4382,512,10.5
21,13,Bell,2012,10276,9043,1233,12.0
21,15,Boone,2012,65423,60922,4501,6.9
21,17,Bourbon,2012,9851,9132,719,7.3
21,19,Boyd,2012,20096,18210,1886,9.4
21,21,Boyle,2012,13082,11899,1183,9.0
21,23,Bracken,2012,3952,3577,375,9.5
21,25,Breathitt,2012,4541,3881,660,14.5
21,27,Breckinridge,2012,8286,7482,804,9.7
21,29,Bullitt,2012,39284,36099,3185,8.1
21,31,Butler,2012,5414,4925,489,9.0
21,33,Caldwell,2012,5681,5205,476,8.4
21,35,Calloway,2012,18313,17013,1300,7.1
21,37,Campbell,2012,48832,45436,3396,7.0
21,39,Carlisle,2012,2341,2154,187,8.0
21,41,Carroll,2012,5068,4547,521,10.3
21,43,Carter,2012,11500,10056,1444,12.6
21,45,Casey,2012,6865,6287,578,8.4
21,47,Christian,2012,26755,24248,2507,9.4
21,49,Clark,2012,17424,15997,1427,8.2
21,51,Clay,2012,5961,5123,838,14.1
21,53,Clinton,2012,4254,3788,466,11.0
21,55,Crittenden,2012,4160,3839,321,7.7
21,57,Cumberland,2012,3121,2783,338,10.8
21,59,Daviess,2012,48275,44880,3395,7.0
21,61,Edmonson,2012,5036,4532,504,10.0
21,63,Elliott,2012,2306,1973,333,14.4
21,65,Estill,2012,5622,5057,565,10.0
21,67,Fayette,2012,166321,156575,9746,5.9
21,69,Fleming,2012,6482,5892,590,9.1
21,71,Floyd,2012,13744,12142,1602,11.7
21,73,Franklin,2012,24565,22913,1652,6.7
21,75,Fulton,2012,2483,2202,281,11.3
21,77,Gallatin,2012,3946,3576,370,9.4
21,79,Garrard,2012,7756,7098,658,8.5
21,81,Grant,2012,11508,10462,1046,9.1
21,83,Graves,2012,16674,15292,1382,8.3
21,85,Grayson,2012,11318,10149,1169,10.3
21,87,Green,2012,5456,5000,456,8.4
21,89,Greenup,2012,15050,13552,1498,10.0
21,91,Hancock,2012,4152,3853,299,7.2
21,93,Hardin,2012,47599,43681,3918,8.2
21,95,Harlan,2012,9932,8526,1406,14.2
21,97,Harrison,2012,8905,8199,706,7.9
21,99,Hart,2012,8142,7464,678,8.3
21,101,Henderson,2012,22644,20931,1713,7.6
21,103,Henry,2012,7703,7138,565,7.3
21,105,Hickman,2012,2166,1990,176,8.1
21,107,Hopkins,2012,21591,19917,1674,7.8
21,109,Jackson,2012,5181,4568,613,11.8
21,111,Jefferson,2012,382783,352232,30551,8.0
21,113,Jessamine,2012,24822,23151,1671,6.7
21,115,Johnson,2012,8602,7724,878,10.2
21,117,Kenton,2012,84419,78148,6271,7.4
21,119,Knott,2012,5832,5024,808,13.9
21,121,Knox,2012,10561,9200,1361,12.9
21,123,Larue,2012,5952,5439,513,8.6
21,125,Laurel,2012,24912,22360,2552,10.2
21,127,Lawrence,2012,5639,5039,600,10.6
21,129,Lee,2012,2432,2123,309,12.7
21,131,Leslie,2012,3596,3081,515,14.3
21,133,Letcher,2012,8586,7424,1162,13.5
21,135,Lewis,2012,5385,4755,630,11.7
21,137,Lincoln,2012,10107,9061,1046,10.3
21,139,Livingston,2012,3976,3588,388,9.8
21,141,Logan,2012,12198,11271,927,7.6
21,143,Lyon,2012,3104,2817,287,9.2
21,145,McCracken,2012,30926,28450,2476,8.0
21,147,McCreary,2012,5479,4753,726,13.3
21,149,McLean,2012,4562,4212,350,7.7
21,151,Madison,2012,44645,41616,3029,6.8
21,153,Magoffin,2012,4040,3343,697,17.3
21,155,Marion,2012,9179,8363,816,8.9
21,157,Marshall,2012,15376,14124,1252,8.1
21,159,Martin,2012,3769,3424,345,9.2
21,161,Mason,2012,7626,6901,725,9.5
21,163,Meade,2012,12639,11398,1241,9.8
21,165,Menifee,2012,2547,2249,298,11.7
21,167,Mercer,2012,10249,9400,849,8.3
21,169,Metcalfe,2012,4428,4074,354,8.0
21,171,Monroe,2012,4802,4453,349,7.3
21,173,Montgomery,2012,12332,11237,1095,8.9
21,175,Morgan,2012,5224,4666,558,10.7
21,177,Muhlenberg,2012,12421,11197,1224,9.9
21,179,Nelson,2012,21909,20086,1823,8.3
21,181,Nicholas,2012,3537,3244,293,8.3
21,183,Ohio,2012,10390,9482,908,8.7
21,185,Oldham,2012,29802,28045,1757,5.9
21,187,Owen,2012,5751,5373,378,6.6
21,189,Owsley,2012,1328,1157,171,12.9
21,191,Pendleton,2012,7068,6440,628,8.9
21,193,Perry,2012,10961,9580,1381,12.6
21,195,Pike,2012,24209,21853,2356,9.7
21,197,Powell,2012,5073,4516,557,11.0
21,199,Pulaski,2012,27322,24724,2598,9.5
21,201,Robertson,2012,851,762,89,10.5
21,203,Rockcastle,2012,7195,6457,738,10.3
21,205,Rowan,2012,11195,10257,938,8.4
21,207,Russell,2012,7229,6478,751,10.4
21,209,Scott,2012,25820,24123,1697,6.6
21,211,Shelby,2012,22285,20887,1398,6.3
21,213,Simpson,2012,8968,8199,769,8.6
21,215,Spencer,2012,9267,8611,656,7.1
21,217,Taylor,2012,11693,10565,1128,9.6
21,219,Todd,2012,5676,5242,434,7.6
21,221,Trigg,2012,6037,5469,568,9.4
21,223,Trimble,2012,3990,3628,362,9.1
21,225,Union,2012,7026,6475,551,7.8
21,227,Warren,2012,59982,55793,4189,7.0
21,229,Washington,2012,6214,5746,468,7.5
21,231,Wayne,2012,7739,6730,1009,13.0
21,233,Webster,2012,6255,5808,447,7.1
21,235,Whitley,2012,13887,12400,1487,10.7
21,237,Wolfe,2012,2104,1803,301,14.3
21,239,Woodford,2012,14129,13369,760,5.4
22,1,Acadia Parish,2012,26267,24767,1500,5.7
22,3,Allen Parish,2012,9136,8439,697,7.6
22,5,Ascension Parish,2012,55119,51915,3204,5.8
22,7,Assumption Parish,2012,9984,9059,925,9.3
22,9,Avoyelles Parish,2012,16437,15250,1187,7.2
22,11,Beauregard Parish,2012,14475,13434,1041,7.2
22,13,Bienville Parish,2012,5974,5460,514,8.6
22,15,Bossier Parish,2012,57612,54441,3171,5.5
22,17,Caddo Parish,2012,114019,105631,8388,7.4
22,19,Calcasieu Parish,2012,88306,82494,5812,6.6
22,21,Caldwell Parish,2012,4017,3682,335,8.3
22,23,Cameron Parish,2012,3243,3081,162,5.0
22,25,Catahoula Parish,2012,3931,3596,335,8.5
22,27,Claiborne Parish,2012,7054,6550,504,7.1
22,29,Concordia Parish,2012,7856,7194,662,8.4
22,31,De Soto Parish,2012,11235,10270,965,8.6
22,33,East Baton Rouge Parish,2012,223279,208946,14333,6.4
22,35,East Carroll Parish,2012,2186,1765,421,19.3
22,37,East Feliciana Parish,2012,7994,7420,574,7.2
22,39,Evangeline Parish,2012,12889,11977,912,7.1
22,41,Franklin Parish,2012,7719,6951,768,9.9
22,43,Grant Parish,2012,8259,7635,624,7.6
22,45,Iberia Parish,2012,32388,30297,2091,6.5
22,47,Iberville Parish,2012,13938,12690,1248,9.0
22,49,Jackson Parish,2012,6863,6417,446,6.5
22,51,Jefferson Parish,2012,213213,199607,13606,6.4
22,53,Jefferson Davis Parish,2012,13037,12228,809,6.2
22,55,Lafayette Parish,2012,117238,111620,5618,4.8
22,57,Lafourche Parish,2012,45668,43369,2299,5.0
22,59,LaSalle Parish,2012,6775,6447,328,4.8
22,61,Lincoln Parish,2012,19558,17948,1610,8.2
22,63,Livingston Parish,2012,62446,58633,3813,6.1
22,65,Madison Parish,2012,3899,3449,450,11.5
22,67,Morehouse Parish,2012,11260,9856,1404,12.5
22,69,Natchitoches Parish,2012,16092,14718,1374,8.5
22,71,Orleans Parish,2012,169480,156736,12744,7.5
22,73,Ouachita Parish,2012,71006,65785,5221,7.4
22,75,Plaquemines Parish,2012,10179,9602,577,5.7
22,77,Pointe Coupee Parish,2012,9921,9146,775,7.8
22,79,Rapides Parish,2012,57491,53634,3857,6.7
22,81,Red River Parish,2012,3963,3686,277,7.0
22,83,Richland Parish,2012,8698,7886,812,9.3
22,85,Sabine Parish,2012,9255,8641,614,6.6
22,87,St. Bernard Parish,2012,17712,16365,1347,7.6
22,89,St. Charles Parish,2012,24833,23279,1554,6.3
22,91,St. Helena Parish,2012,4610,4078,532,11.5
22,93,St. James Parish,2012,9691,8753,938,9.7
22,95,St. John the Baptist Parish,2012,20580,18761,1819,8.8
22,97,St. Landry Parish,2012,33532,30872,2660,7.9
22,99,St. Martin Parish,2012,24341,22897,1444,5.9
22,101,St. Mary Parish,2012,25521,23697,1824,7.1
22,103,St. Tammany Parish,2012,109310,103152,6158,5.6
22,105,Tangipahoa Parish,2012,53222,48894,4328,8.1
22,107,Tensas Parish,2012,1819,1631,188,10.3
22,109,Terrebonne Parish,2012,51289,48690,2599,5.1
22,111,Union Parish,2012,9259,8525,734,7.9
22,113,Vermilion Parish,2012,25941,24521,1420,5.5
22,115,Vernon Parish,2012,18956,17460,1496,7.9
22,117,Washington Parish,2012,16539,15147,1392,8.4
22,119,Webster Parish,2012,16137,14653,1484,9.2
22,121,West Baton Rouge Parish,2012,11963,11177,786,6.6
22,123,West Carroll Parish,2012,4166,3623,543,13.0
22,125,West Feliciana Parish,2012,5156,4858,298,5.8
22,127,Winn Parish,2012,5711,5246,465,8.1
23,1,Androscoggin,2012,56231,52037,4194,7.5
23,3,Aroostook,2012,34077,31019,3058,9.0
23,5,Cumberland,2012,159472,150299,9173,5.8
23,7,Franklin,2012,15439,14150,1289,8.3
23,9,Hancock,2012,29865,27383,2482,8.3
23,11,Kennebec,2012,63002,58655,4347,6.9
23,13,Knox,2012,20561,19195,1366,6.6
23,15,Lincoln,2012,17208,15997,1211,7.0
23,17,Oxford,2012,27804,25205,2599,9.3
23,19,Penobscot,2012,79700,73746,5954,7.5
23,21,Piscataquis,2012,7850,7134,716,9.1
23,23,Sagadahoc,2012,19163,17946,1217,6.4
23,25,Somerset,2012,24534,22167,2367,9.6
23,27,Waldo,2012,20622,18983,1639,7.9
23,29,Washington,2012,14686,13230,1456,9.9
23,31,York,2012,110523,103173,7350,6.7
24,1,Allegany,2012,33850,30875,2975,8.8
24,3,Anne Arundel,2012,293879,276469,17410,5.9
24,5,Baltimore,2012,440412,408491,31921,7.2
24,9,Calvert,2012,47732,44781,2951,6.2
24,11,Caroline,2012,17617,16272,1345,7.6
24,13,Carroll,2012,93319,87885,5434,5.8
24,15,Cecil,2012,51898,47630,4268,8.2
24,17,Charles,2012,79594,74359,5235,6.6
24,19,Dorchester,2012,16171,14441,1730,10.7
24,21,Frederick,2012,128681,120933,7748,6.0
24,23,Garrett,2012,15833,14538,1295,8.2
24,25,Harford,2012,135618,126328,9290,6.9
24,27,Howard,2012,168338,160013,8325,4.9
24,29,Kent,2012,10634,9833,801,7.5
24,31,Montgomery,2012,540810,513193,27617,5.1
24,33,Prince George's,2012,485215,450330,34885,7.2
24,35,Queen Anne's,2012,26746,25078,1668,6.2
24,37,St. Mary's,2012,54521,51177,3344,6.1
24,39,Somerset,2012,9737,8655,1082,11.1
24,41,Talbot,2012,19420,18042,1378,7.1
24,43,Washington,2012,77183,71224,5959,7.7
24,45,Wicomico,2012,50480,45799,4681,9.3
24,47,Worcester,2012,26108,22776,3332,12.8
24,510,Baltimore city,2012,297153,267396,29757,10.0
25,1,Barnstable,2012,108890,99630,9260,8.5
25,3,Berkshire,2012,66486,61576,4910,7.4
25,5,Bristol,2012,287158,262008,25150,8.8
25,7,Dukes,2012,9384,8550,834,8.9
25,9,Essex,2012,397902,369616,28286,7.1
25,11,Franklin,2012,39834,37403,2431,6.1
25,13,Hampden,2012,220559,201593,18966,8.6
25,15,Hampshire,2012,85790,80790,5000,5.8
25,17,Middlesex,2012,836757,791229,45528,5.4
25,19,Nantucket/town,2012,6423,5919,504,7.8
25,21,Norfolk,2012,361009,340355,20654,5.7
25,23,Plymouth,2012,261935,243499,18436,7.0
25,25,Suffolk,2012,403811,378924,24887,6.2
25,27,Worcester,2012,420520,390164,30356,7.2
26,1,Alcona,2012,3724,3257,467,12.5
26,3,Alger,2012,3446,3040,406,11.8
26,5,Allegan,2012,56883,52752,4131,7.3
26,7,Alpena,2012,13436,12146,1290,9.6
26,9,Antrim,2012,10038,8894,1144,11.4
26,11,Arenac,2012,6551,5723,828,12.6
26,13,Baraga,2012,3545,3052,493,13.9
26,15,Barry,2012,29072,27107,1965,6.8
26,17,Bay,2012,53057,48478,4579,8.6
26,19,Benzie,2012,8555,7670,885,10.3
26,21,Berrien,2012,73574,67007,6567,8.9
26,23,Branch,2012,18715,17079,1636,8.7
26,25,Calhoun,2012,62460,57308,5152,8.2
26,27,Cass,2012,23841,21855,1986,8.3
26,29,Charlevoix,2012,12959,11575,1384,10.7
26,31,Cheboygan,2012,10542,9304,1238,11.7
26,33,Chippewa,2012,17169,15465,1704,9.9
26,35,Clare,2012,12004,10599,1405,11.7
26,37,Clinton,2012,38665,36337,2328,6.0
26,39,Crawford,2012,5388,4761,627,11.6
26,41,Delta,2012,17572,15858,1714,9.8
26,43,Dickinson,2012,12682,11625,1057,8.3
26,45,Eaton,2012,55109,51340,3769,6.8
26,47,Emmet,2012,17860,15748,2112,11.8
26,49,Genesee,2012,179625,161660,17965,10.0
26,51,Gladwin,2012,9962,8797,1165,11.7
26,53,Gogebic,2012,6811,6064,747,11.0
26,55,Grand Traverse,2012,46544,42750,3794,8.2
26,57,Gratiot,2012,18646,16991,1655,8.9
26,59,Hillsdale,2012,20537,18681,1856,9.0
26,61,Houghton,2012,16969,15469,1500,8.8
26,63,Huron,2012,16453,15146,1307,7.9
26,65,Ingham,2012,143745,132626,11119,7.7
26,67,Ionia,2012,28731,26325,2406,8.4
26,69,Iosco,2012,10187,9057,1130,11.1
26,71,Iron,2012,5099,4618,481,9.4
26,73,Isabella,2012,34843,32301,2542,7.3
26,75,Jackson,2012,71833,65789,6044,8.4
26,77,Kalamazoo,2012,125104,116156,8948,7.2
26,79,Kalkaska,2012,7456,6622,834,11.2
26,81,Kent,2012,321042,299448,21594,6.7
26,83,Keweenaw,2012,988,863,125,12.7
26,85,Lake,2012,3674,3200,474,12.9
26,87,Lapeer,2012,39806,35196,4610,11.6
26,89,Leelanau,2012,10205,9395,810,7.9
26,91,Lenawee,2012,47688,43745,3943,8.3
26,93,Livingston,2012,93382,86053,7329,7.8
26,95,Luce,2012,2375,2118,257,10.8
26,97,Mackinac,2012,5211,4586,625,12.0
26,99,Macomb,2012,412673,372357,40316,9.8
26,101,Manistee,2012,10533,9408,1125,10.7
26,103,Marquette,2012,34119,31400,2719,8.0
26,105,Mason,2012,14395,13020,1375,9.6
26,107,Mecosta,2012,18892,17002,1890,10.0
26,109,Menominee,2012,11800,10864,936,7.9
26,111,Midland,2012,40838,37700,3138,7.7
26,113,Missaukee,2012,6937,6275,662,9.5
26,115,Monroe,2012,73897,68251,5646,7.6
26,117,Montcalm,2012,27352,24598,2754,10.1
26,119,Montmorency,2012,3245,2723,522,16.1
26,121,Muskegon,2012,75915,68384,7531,9.9
26,123,Newaygo,2012,22099,20096,2003,9.1
26,125,Oakland,2012,617642,567085,50557,8.2
26,127,Oceana,2012,12872,11261,1611,12.5
26,129,Ogemaw,2012,8655,7679,976,11.3
26,131,Ontonagon,2012,2588,2245,343,13.3
26,133,Osceola,2012,10006,9021,985,9.8
26,135,Oscoda,2012,2994,2531,463,15.5
26,137,Otsego,2012,11229,10040,1189,10.6
26,139,Ottawa,2012,142161,132919,9242,6.5
26,141,Presque Isle,2012,5554,4758,796,14.3
26,143,Roscommon,2012,8128,7048,1080,13.3
26,145,Saginaw,2012,89033,80916,8117,9.1
26,147,St. Clair,2012,73906,65253,8653,11.7
26,149,St. Joseph,2012,27545,25117,2428,8.8
26,151,Sanilac,2012,19373,17363,2010,10.4
26,153,Schoolcraft,2012,3547,3106,441,12.4
26,155,Shiawassee,2012,33217,30073,3144,9.5
26,157,Tuscola,2012,24738,22154,2584,10.4
26,159,Van Buren,2012,35338,31658,3680,10.4
26,161,Washtenaw,2012,182378,171675,10703,5.9
26,163,Wayne,2012,773587,683411,90176,11.7
26,165,Wexford,2012,14523,12943,1580,10.9
27,1,Aitkin,2012,6913,6350,563,8.1
27,3,Anoka,2012,187476,176355,11121,5.9
27,5,Becker,2012,17894,16848,1046,5.8
27,7,Beltrami,2012,22872,21261,1611,7.0
27,9,Benton,2012,21224,19859,1365,6.4
27,11,Big Stone,2012,2834,2684,150,5.3
27,13,Blue Earth,2012,38360,36507,1853,4.8
27,15,Brown,2012,14834,13992,842,5.7
27,17,Carlton,2012,17491,16283,1208,6.9
27,19,Carver,2012,52484,49934,2550,4.9
27,21,Cass,2012,13872,12632,1240,8.9
27,23,Chippewa,2012,7067,6690,377,5.3
27,25,Chisago,2012,28593,26703,1890,6.6
27,27,Clay,2012,35061,33358,1703,4.9
27,29,Clearwater,2012,4416,3947,469,10.6
27,31,Cook,2012,3052,2860,192,6.3
27,33,Cottonwood,2012,5954,5565,389,6.5
27,35,Crow Wing,2012,30955,28558,2397,7.7
27,37,Dakota,2012,228280,216288,11992,5.3
27,39,Dodge,2012,11352,10776,576,5.1
27,41,Douglas,2012,19831,18825,1006,5.1
27,43,Faribault,2012,7780,7323,457,5.9
27,45,Fillmore,2012,11287,10658,629,5.6
27,47,Freeborn,2012,16695,15719,976,5.8
27,49,Goodhue,2012,26740,25351,1389,5.2
27,51,Grant,2012,3341,3135,206,6.2
27,53,Hennepin,2012,660564,625770,34794,5.3
27,55,Houston,2012,10583,9964,619,5.8
27,57,Hubbard,2012,9551,8779,772,8.1
27,59,Isanti,2012,20376,18942,1434,7.0
27,61,Itasca,2012,22279,20517,1762,7.9
27,63,Jackson,2012,6212,5928,284,4.6
27,65,Kanabec,2012,8744,7952,792,9.1
27,67,Kandiyohi,2012,23520,22283,1237,5.3
27,69,Kittson,2012,2565,2415,150,5.8
27,71,Koochiching,2012,6710,6171,539,8.0
27,73,Lac qui Parle,2012,3860,3665,195,5.1
27,75,Lake,2012,5835,5482,353,6.0
27,77,Lake of the Woods,2012,2350,2206,144,6.1
27,79,Le Sueur,2012,15506,14492,1014,6.5
27,81,Lincoln,2012,3425,3262,163,4.8
27,83,Lyon,2012,15245,14568,677,4.4
27,85,McLeod,2012,19954,18593,1361,6.8
27,87,Mahnomen,2012,2480,2307,173,7.0
27,89,Marshall,2012,5754,5310,444,7.7
27,91,Martin,2012,10886,10271,615,5.6
27,93,Meeker,2012,12752,11906,846,6.6
27,95,Mille Lacs,2012,12709,11643,1066,8.4
27,97,Morrison,2012,17958,16682,1276,7.1
27,99,Mower,2012,20684,19644,1040,5.0
27,101,Murray,2012,5001,4739,262,5.2
27,103,Nicollet,2012,19760,18853,907,4.6
27,105,Nobles,2012,11302,10807,495,4.4
27,107,Norman,2012,3527,3317,210,6.0
27,109,Olmsted,2012,82629,78949,3680,4.5
27,111,Otter Tail,2012,30810,29088,1722,5.6
27,113,Pennington,2012,8601,8028,573,6.7
27,115,Pine,2012,14901,13771,1130,7.6
27,117,Pipestone,2012,4911,4665,246,5.0
27,119,Polk,2012,17527,16430,1097,6.3
27,121,Pope,2012,5951,5671,280,4.7
27,123,Ramsey,2012,273270,257449,15821,5.8
27,125,Red Lake,2012,2344,2173,171,7.3
27,127,Redwood,2012,8215,7758,457,5.6
27,129,Renville,2012,8438,7861,577,6.8
27,131,Rice,2012,34904,32860,2044,5.9
27,133,Rock,2012,5552,5348,204,3.7
27,135,Roseau,2012,8547,8140,407,4.8
27,137,St. Louis,2012,101690,95033,6657,6.5
27,139,Scott,2012,75885,72077,3808,5.0
27,141,Sherburne,2012,48680,45645,3035,6.2
27,143,Sibley,2012,8428,7921,507,6.0
27,145,Stearns,2012,86366,81673,4693,5.4
27,147,Steele,2012,21595,20415,1180,5.5
27,149,Stevens,2012,5612,5373,239,4.3
27,151,Swift,2012,5090,4775,315,6.2
27,153,Todd,2012,13047,12286,761,5.8
27,155,Traverse,2012,1777,1687,90,5.1
27,157,Wabasha,2012,11972,11348,624,5.2
27,159,Wadena,2012,6238,5748,490,7.9
27,161,Waseca,2012,10225,9632,593,5.8
27,163,Washington,2012,133838,126905,6933,5.2
27,165,Watonwan,2012,6292,5936,356,5.7
27,167,Wilkin,2012,3785,3605,180,4.8
27,169,Winona,2012,29856,28384,1472,4.9
27,171,Wright,2012,70365,66223,4142,5.9
27,173,Yellow Medicine,2012,5686,5398,288,5.1
28,1,Adams,2012,12496,11281,1215,9.7
28,3,Alcorn,2012,16169,14789,1380,8.5
28,5,Amite,2012,4812,4338,474,9.9
28,7,Attala,2012,7664,6927,737,9.6
28,9,Benton,2012,3324,2978,346,10.4
28,11,Bolivar,2012,14545,13033,1512,10.4
28,13,Calhoun,2012,6820,6263,557,8.2
28,15,Carroll,2012,3714,3312,402,10.8
28,17,Chickasaw,2012,8073,7263,810,10.0
28,19,Choctaw,2012,3766,3429,337,8.9
28,21,Claiborne,2012,3562,3023,539,15.1
28,23,Clarke,2012,6798,6081,717,10.5
28,25,Clay,2012,8668,7472,1196,13.8
28,27,Coahoma,2012,10317,9043,1274,12.3
28,29,Copiah,2012,11993,10695,1298,10.8
28,31,Covington,2012,8449,7748,701,8.3
28,33,DeSoto,2012,84039,78719,5320,6.3
28,35,Forrest,2012,34775,31709,3066,8.8
28,37,Franklin,2012,3103,2806,297,9.6
28,39,George,2012,8913,8018,895,10.0
28,41,Greene,2012,4615,4106,509,11.0
28,43,Grenada,2012,9713,8835,878,9.0
28,45,Hancock,2012,19807,18167,1640,8.3
28,47,Harrison,2012,89926,82714,7212,8.0
28,49,Hinds,2012,116938,106870,10068,8.6
28,51,Holmes,2012,6677,5593,1084,16.2
28,53,Humphreys,2012,3198,2599,599,18.7
28,55,Issaquena,2012,475,393,82,17.3
28,57,Itawamba,2012,10526,9660,866,8.2
28,59,Jackson,2012,63893,57974,5919,9.3
28,61,Jasper,2012,6964,6270,694,10.0
28,63,Jefferson,2012,2539,2106,433,17.1
28,65,Jefferson Davis,2012,4502,3931,571,12.7
28,67,Jones,2012,29047,26893,2154,7.4
28,69,Kemper,2012,4011,3494,517,12.9
28,71,Lafayette,2012,23608,21823,1785,7.6
28,73,Lamar,2012,28456,26659,1797,6.3
28,75,Lauderdale,2012,34940,31846,3094,8.9
28,77,Lawrence,2012,4993,4489,504,10.1
28,79,Leake,2012,8492,7724,768,9.0
28,81,Lee,2012,41488,38101,3387,8.2
28,83,Leflore,2012,11315,9757,1558,13.8
28,85,Lincoln,2012,14564,13334,1230,8.4
28,87,Lowndes,2012,27811,25319,2492,9.0
28,89,Madison,2012,50971,47856,3115,6.1
28,91,Marion,2012,10440,9391,1049,10.0
28,93,Marshall,2012,15553,13898,1655,10.6
28,95,Monroe,2012,16305,14536,1769,10.8
28,97,Montgomery,2012,4589,4064,525,11.4
28,99,Neshoba,2012,11777,10813,964,8.2
28,101,Newton,2012,9361,8631,730,7.8
28,103,Noxubee,2012,4252,3705,547,12.9
28,105,Oktibbeha,2012,23029,21137,1892,8.2
28,107,Panola,2012,14449,12728,1721,11.9
28,109,Pearl River,2012,24032,22093,1939,8.1
28,111,Perry,2012,4483,3977,506,11.3
28,113,Pike,2012,15426,13834,1592,10.3
28,115,Pontotoc,2012,14230,13143,1087,7.6
28,117,Prentiss,2012,11543,10568,975,8.4
28,119,Quitman,2012,2999,2589,410,13.7
28,121,Rankin,2012,73608,69466,4142,5.6
28,123,Scott,2012,13235,12248,987,7.5
28,125,Sharkey,2012,1956,1696,260,13.3
28,127,Simpson,2012,11407,10485,922,8.1
28,129,Smith,2012,7173,6662,511,7.1
28,131,Stone,2012,6763,6079,684,10.1
28,133,Sunflower,2012,9574,8225,1349,14.1
28,135,Tallahatchie,2012,5833,5188,645,11.1
28,137,Tate,2012,12560,11423,1137,9.1
28,139,Tippah,2012,9131,8229,902,9.9
28,141,Tishomingo,2012,7970,7164,806,10.1
28,143,Tunica,2012,4949,4351,598,12.1
28,145,Union,2012,13693,12616,1077,7.9
28,147,Walthall,2012,5631,5010,621,11.0
28,149,Warren,2012,23493,21421,2072,8.8
28,151,Washington,2012,20215,17333,2882,14.3
28,153,Wayne,2012,8528,7597,931,10.9
28,155,Webster,2012,4277,3894,383,9.0
28,157,Wilkinson,2012,3295,2898,397,12.0
28,159,Winston,2012,7802,6923,879,11.3
28,161,Yalobusha,2012,5488,4946,542,9.9
28,163,Yazoo,2012,9943,8848,1095,11.0
29,1,Adair,2012,10675,9900,775,7.3
29,3,Andrew,2012,9835,9291,544,5.5
29,5,Atchison,2012,2858,2670,188,6.6
29,7,Audrain,2012,11275,10517,758,6.7
29,9,Barry,2012,15025,13928,1097,7.3
29,11,Barton,2012,5507,5085,422,7.7
29,13,Bates,2012,8130,7440,690,8.5
29,15,Benton,2012,7102,6438,664,9.3
29,17,Bollinger,2012,5685,5273,412,7.2
29,19,Boone,2012,95695,91218,4477,4.7
29,21,Buchanan,2012,46410,43401,3009,6.5
29,23,Butler,2012,18569,16997,1572,8.5
29,25,Caldwell,2012,4370,4055,315,7.2
29,27,Callaway,2012,21677,20291,1386,6.4
29,29,Camden,2012,18854,16996,1858,9.9
29,31,Cape Girardeau,2012,40512,38199,2313,5.7
29,33,Carroll,2012,4570,4176,394,8.6
29,35,Carter,2012,2532,2285,247,9.8
29,37,Cass,2012,52456,48846,3610,6.9
29,39,Cedar,2012,5760,5318,442,7.7
29,41,Chariton,2012,4005,3734,271,6.8
29,43,Christian,2012,40518,38083,2435,6.0
29,45,Clark,2012,3324,3047,277,8.3
29,47,Clay,2012,125609,117708,7901,6.3
29,49,Clinton,2012,10780,10000,780,7.2
29,51,Cole,2012,39597,37493,2104,5.3
29,53,Cooper,2012,7760,7188,572,7.4
29,55,Crawford,2012,10672,9703,969,9.1
29,57,Dade,2012,3344,3086,258,7.7
29,59,Dallas,2012,7066,6403,663,9.4
29,61,Daviess,2012,4039,3750,289,7.2
29,63,DeKalb,2012,5017,4710,307,6.1
29,65,Dent,2012,5971,5468,503,8.4
29,67,Douglas,2012,5121,4602,519,10.1
29,69,Dunklin,2012,12131,10829,1302,10.7
29,71,Franklin,2012,51673,47472,4201,8.1
29,73,Gasconade,2012,7489,6944,545,7.3
29,75,Gentry,2012,3567,3371,196,5.5
29,77,Greene,2012,142979,134238,8741,6.1
29,79,Grundy,2012,4913,4586,327,6.7
29,81,Harrison,2012,3942,3647,295,7.5
29,83,Henry,2012,9785,8999,786,8.0
29,85,Hickory,2012,3603,3158,445,12.4
29,87,Holt,2012,2675,2529,146,5.5
29,89,Howard,2012,4809,4473,336,7.0
29,91,Howell,2012,16448,15064,1384,8.4
29,93,Iron,2012,3728,3290,438,11.7
29,95,Jackson,2012,353502,325131,28371,8.0
29,97,Jasper,2012,57832,54307,3525,6.1
29,99,Jefferson,2012,114493,106005,8488,7.4
29,101,Johnson,2012,22925,21112,1813,7.9
29,103,Knox,2012,1956,1842,114,5.8
29,105,Laclede,2012,15697,14200,1497,9.5
29,107,Lafayette,2012,17130,15875,1255,7.3
29,109,Lawrence,2012,17194,16037,1157,6.7
29,111,Lewis,2012,5128,4836,292,5.7
29,113,Lincoln,2012,26193,23944,2249,8.6
29,115,Linn,2012,5149,4656,493,9.6
29,117,Livingston,2012,7175,6716,459,6.4
29,119,McDonald,2012,10115,9418,697,6.9
29,121,Macon,2012,7455,6938,517,6.9
29,123,Madison,2012,5345,4889,456,8.5
29,125,Maries,2012,4123,3816,307,7.4
29,127,Marion,2012,14389,13484,905,6.3
29,129,Mercer,2012,1821,1724,97,5.3
29,131,Miller,2012,11302,10249,1053,9.3
29,133,Mississippi,2012,6114,5614,500,8.2
29,135,Moniteau,2012,7273,6777,496,6.8
29,137,Monroe,2012,4032,3714,318,7.9
29,139,Montgomery,2012,5767,5300,467,8.1
29,141,Morgan,2012,7764,6968,796,10.3
29,143,New Madrid,2012,8084,7409,675,8.3
29,145,Newton,2012,29188,27332,1856,6.4
29,147,Nodaway,2012,11644,10973,671,5.8
29,149,Oregon,2012,4025,3698,327,8.1
29,151,Osage,2012,7278,6900,378,5.2
29,153,Ozark,2012,3575,3200,375,10.5
29,155,Pemiscot,2012,7067,6365,702,9.9
29,157,Perry,2012,9932,9407,525,5.3
29,159,Pettis,2012,19858,18411,1447,7.3
29,161,Phelps,2012,19541,18115,1426,7.3
29,163,Pike,2012,8080,7508,572,7.1
29,165,Platte,2012,52098,49141,2957,5.7
29,167,Polk,2012,13990,12876,1114,8.0
29,169,Pulaski,2012,15781,14455,1326,8.4
29,171,Putnam,2012,2336,2192,144,6.2
29,173,Ralls,2012,5591,5222,369,6.6
29,175,Randolph,2012,10609,9653,956,9.0
29,177,Ray,2012,11237,10286,951,8.5
29,179,Reynolds,2012,2256,2001,255,11.3
29,181,Ripley,2012,5479,4889,590,10.8
29,183,St. Charles,2012,204183,192394,11789,5.8
29,185,St. Clair,2012,3892,3574,318,8.2
29,186,Ste. Genevieve,2012,8973,8297,676,7.5
29,187,St. Francois,2012,25844,23474,2370,9.2
29,189,St. Louis,2012,523796,488787,35009,6.7
29,195,Saline,2012,10952,10206,746,6.8
29,197,Schuyler,2012,1879,1736,143,7.6
29,199,Scotland,2012,2329,2208,121,5.2
29,201,Scott,2012,19721,18301,1420,7.2
29,203,Shannon,2012,3046,2700,346,11.4
29,205,Shelby,2012,3103,2910,193,6.2
29,207,Stoddard,2012,13403,12203,1200,9.0
29,209,Stone,2012,13618,12052,1566,11.5
29,211,Sullivan,2012,2761,2566,195,7.1
29,213,Taney,2012,25341,22392,2949,11.6
29,215,Texas,2012,9586,8776,810,8.4
29,217,Vernon,2012,9551,8974,577,6.0
29,219,Warren,2012,16831,15532,1299,7.7
29,221,Washington,2012,9924,8841,1083,10.9
29,223,Wayne,2012,5296,4803,493,9.3
29,225,Webster,2012,15836,14674,1162,7.3
29,227,Worth,2012,1236,1183,53,4.3
29,229,Wright,2012,7540,6885,655,8.7
29,510,St. Louis city,2012,160128,146076,14052,8.8
30,1,Beaverhead,2012,4908,4651,257,5.2
30,3,Big Horn,2012,5518,4871,647,11.7
30,5,Blaine,2012,2484,2331,153,6.2
30,7,Broadwater,2012,2479,2299,180,7.3
30,9,Carbon,2012,5332,5090,242,4.5
30,11,Carter,2012,687,665,22,3.2
30,13,Cascade,2012,38380,36314,2066,5.4
30,15,Chouteau,2012,2669,2568,101,3.8
30,17,Custer,2012,6543,6316,227,3.5
30,19,Daniels,2012,941,912,29,3.1
30,21,Dawson,2012,4652,4503,149,3.2
30,23,Deer Lodge,2012,5189,4910,279,5.4
30,25,Fallon,2012,2035,1995,40,2.0
30,27,Fergus,2012,5856,5552,304,5.2
30,29,Flathead,2012,43283,39490,3793,8.8
30,31,Gallatin,2012,52494,49895,2599,5.0
30,33,Garfield,2012,769,746,23,3.0
30,35,Glacier,2012,6340,5730,610,9.6
30,37,Golden Valley,2012,391,373,18,4.6
30,39,Granite,2012,1473,1356,117,7.9
30,41,Hill,2012,8034,7581,453,5.6
30,43,Jefferson,2012,5601,5301,300,5.4
30,45,Judith Basin,2012,991,941,50,5.0
30,47,Lake,2012,12430,11501,929,7.5
30,49,Lewis and Clark,2012,34929,33287,1642,4.7
30,51,Liberty,2012,1035,994,41,4.0
30,53,Lincoln,2012,8191,7194,997,12.2
30,55,McCone,2012,1090,1059,31,2.8
30,57,Madison,2012,4113,3863,250,6.1
30,59,Meagher,2012,930,881,49,5.3
30,61,Mineral,2012,1766,1578,188,10.6
30,63,Missoula,2012,59138,55772,3366,5.7
30,65,Musselshell,2012,2416,2291,125,5.2
30,67,Park,2012,8021,7479,542,6.8
30,69,Petroleum,2012,300,287,13,4.3
30,71,Phillips,2012,2059,1940,119,5.8
30,73,Pondera,2012,2941,2801,140,4.8
30,75,Powder River,2012,1078,1039,39,3.6
30,77,Powell,2012,3014,2825,189,6.3
30,79,Prairie,2012,529,507,22,4.2
30,81,Ravalli,2012,18705,17322,1383,7.4
30,83,Richland,2012,6720,6538,182,2.7
30,85,Roosevelt,2012,4820,4512,308,6.4
30,87,Rosebud,2012,4453,4160,293,6.6
30,89,Sanders,2012,4786,4252,534,11.2
30,91,Sheridan,2012,2061,2002,59,2.9
30,93,Silver Bow,2012,17213,16200,1013,5.9
30,95,Stillwater,2012,4956,4741,215,4.3
30,97,Sweet Grass,2012,1748,1682,66,3.8
30,99,Teton,2012,2942,2803,139,4.7
30,101,Toole,2012,2501,2399,102,4.1
30,103,Treasure,2012,379,361,18,4.7
30,105,Valley,2012,4025,3864,161,4.0
30,107,Wheatland,2012,838,787,51,6.1
30,109,Wibaux,2012,561,544,17,3.0
30,111,Yellowstone,2012,78709,75206,3503,4.5
31,1,Adams,2012,16851,16225,626,3.7
31,3,Antelope,2012,3573,3460,113,3.2
31,5,Arthur,2012,230,215,15,6.5
31,7,Banner,2012,436,417,19,4.4
31,9,Blaine,2012,283,268,15,5.3
31,11,Boone,2012,3036,2945,91,3.0
31,13,Box Butte,2012,5964,5731,233,3.9
31,15,Boyd,2012,1145,1101,44,3.8
31,17,Brown,2012,1449,1392,57,3.9
31,19,Buffalo,2012,27253,26378,875,3.2
31,21,Burt,2012,3670,3501,169,4.6
31,23,Butler,2012,4734,4581,153,3.2
31,25,Cass,2012,13282,12681,601,4.5
31,27,Cedar,2012,4732,4598,134,2.8
31,29,Chase,2012,2369,2314,55,2.3
31,31,Cherry,2012,3476,3379,97,2.8
31,33,Cheyenne,2012,5778,5622,156,2.7
31,35,Clay,2012,3479,3353,126,3.6
31,37,Colfax,2012,5653,5458,195,3.4
31,39,Cuming,2012,4905,4758,147,3.0
31,41,Custer,2012,6098,5928,170,2.8
31,43,Dakota,2012,11167,10539,628,5.6
31,45,Dawes,2012,5405,5213,192,3.6
31,47,Dawson,2012,13248,12685,563,4.2
31,49,Deuel,2012,1190,1152,38,3.2
31,51,Dixon,2012,3134,3008,126,4.0
31,53,Dodge,2012,19229,18382,847,4.4
31,55,Douglas,2012,285026,272639,12387,4.3
31,57,Dundy,2012,1279,1243,36,2.8
31,59,Fillmore,2012,3314,3209,105,3.2
31,61,Franklin,2012,1641,1583,58,3.5
31,63,Frontier,2012,1609,1559,50,3.1
31,65,Furnas,2012,2683,2591,92,3.4
31,67,Gage,2012,11152,10613,539,4.8
31,69,Garden,2012,1258,1219,39,3.1
31,71,Garfield,2012,1218,1182,36,3.0
31,73,Gosper,2012,1143,1110,33,2.9
31,75,Grant,2012,439,424,15,3.4
31,77,Greeley,2012,1296,1250,46,3.5
31,79,Hall,2012,32587,31326,1261,3.9
31,81,Hamilton,2012,4834,4677,157,3.2
31,83,Harlan,2012,1874,1815,59,3.1
31,85,Hayes,2012,663,644,19,2.9
31,87,Hitchcock,2012,1356,1302,54,4.0
31,89,Holt,2012,5960,5775,185,3.1
31,91,Hooker,2012,438,418,20,4.6
31,93,Howard,2012,3416,3296,120,3.5
31,95,Jefferson,2012,4313,4154,159,3.7
31,97,Johnson,2012,2188,2096,92,4.2
31,99,Kearney,2012,3927,3817,110,2.8
31,101,Keith,2012,4655,4487,168,3.6
31,103,Keya Paha,2012,605,587,18,3.0
31,105,Kimball,2012,2218,2147,71,3.2
31,107,Knox,2012,4781,4625,156,3.3
31,109,Lancaster,2012,167268,161395,5873,3.5
31,111,Lincoln,2012,19236,18499,737,3.8
31,113,Logan,2012,504,489,15,3.0
31,115,Loup,2012,391,377,14,3.6
31,117,McPherson,2012,359,347,12,3.3
31,119,Madison,2012,19170,18482,688,3.6
31,121,Merrick,2012,4224,4073,151,3.6
31,123,Morrill,2012,2698,2614,84,3.1
31,125,Nance,2012,2094,2026,68,3.2
31,127,Nemaha,2012,3877,3694,183,4.7
31,129,Nuckolls,2012,2471,2388,83,3.4
31,131,Otoe,2012,8493,8120,373,4.4
31,133,Pawnee,2012,1638,1585,53,3.2
31,135,Perkins,2012,1826,1779,47,2.6
31,137,Phelps,2012,5040,4893,147,2.9
31,139,Pierce,2012,4188,4052,136,3.2
31,141,Platte,2012,18009,17369,640,3.6
31,143,Polk,2012,2987,2898,89,3.0
31,145,Red Willow,2012,6345,6144,201,3.2
31,147,Richardson,2012,4396,4177,219,5.0
31,149,Rock,2012,879,857,22,2.5
31,151,Saline,2012,7348,7037,311,4.2
31,153,Sarpy,2012,87890,84588,3302,3.8
31,155,Saunders,2012,11167,10706,461,4.1
31,157,Scotts Bluff,2012,19192,18316,876,4.6
31,159,Seward,2012,8939,8633,306,3.4
31,161,Sheridan,2012,2801,2704,97,3.5
31,163,Sherman,2012,1747,1683,64,3.7
31,165,Sioux,2012,840,811,29,3.5
31,167,Stanton,2012,3667,3543,124,3.4
31,169,Thayer,2012,3003,2913,90,3.0
31,171,Thomas,2012,426,410,16,3.8
31,173,Thurston,2012,3135,2869,266,8.5
31,175,Valley,2012,2148,2075,73,3.4
31,177,Washington,2012,11206,10795,411,3.7
31,179,Wayne,2012,5717,5538,179,3.1
31,181,Webster,2012,1743,1681,62,3.6
31,183,Wheeler,2012,521,504,17,3.3
31,185,York,2012,7585,7312,273,3.6
32,1,Churchill,2012,11030,9768,1262,11.4
32,3,Clark,2012,992000,875964,116036,11.7
32,5,Douglas,2012,22609,19919,2690,11.9
32,7,Elko,2012,28840,26932,1908,6.6
32,9,Esmeralda,2012,472,438,34,7.2
32,11,Eureka,2012,1091,1022,69,6.3
32,13,Humboldt,2012,9045,8426,619,6.8
32,15,Lander,2012,3409,3142,267,7.8
32,17,Lincoln,2012,2089,1863,226,10.8
32,19,Lyon,2012,22423,18995,3428,15.3
32,21,Mineral,2012,1893,1627,266,14.1
32,23,Nye,2012,16611,14128,2483,14.9
32,27,Pershing,2012,2589,2329,260,10.0
32,29,Storey,2012,1904,1641,263,13.8
32,31,Washoe,2012,219463,194330,25133,11.5
32,33,White Pine,2012,5019,4620,399,7.9
32,510,Carson City,2012,25720,22588,3132,12.2
33,1,Belknap,2012,32042,30321,1721,5.4
33,3,Carroll,2012,24657,23372,1285,5.2
33,5,Cheshire,2012,42599,40454,2145,5.0
33,7,Coos,2012,16081,14904,1177,7.3
33,9,Grafton,2012,48717,46569,2148,4.4
33,11,Hillsborough,2012,226813,213812,13001,5.7
33,13,Merrimack,2012,81130,77152,3978,4.9
33,15,Rockingham,2012,174697,164625,10072,5.8
33,17,Strafford,2012,70029,66274,3755,5.4
33,19,Sullivan,2012,24035,22966,1069,4.4
34,1,Atlantic,2012,140213,122313,17900,12.8
34,3,Bergen,2012,483678,446356,37322,7.7
34,5,Burlington,2012,235011,214509,20502,8.7
34,7,Camden,2012,261404,233177,28227,10.8
34,9,Cape May,2012,49821,42094,7727,15.5
34,11,Cumberland,2012,71149,61753,9396,13.2
34,13,Essex,2012,383565,342168,41397,10.8
34,15,Gloucester,2012,151319,135938,15381,10.2
34,17,Hudson,2012,359943,327828,32115,8.9
34,19,Hunterdon,2012,67425,62786,4639,6.9
34,21,Mercer,2012,194443,178346,16097,8.3
34,23,Middlesex,2012,429807,392530,37277,8.7
34,25,Monmouth,2012,330184,301216,28968,8.8
34,27,Morris,2012,267024,247949,19075,7.1
34,29,Ocean,2012,267698,239067,28631,10.7
34,31,Passaic,2012,253528,225360,28168,11.1
34,33,Salem,2012,32119,28305,3814,11.9
34,35,Somerset,2012,175626,162497,13129,7.5
34,37,Sussex,2012,81122,73778,7344,9.1
34,39,Union,2012,282660,255852,26808,9.5
34,41,Warren,2012,58546,53399,5147,8.8
35,1,Bernalillo,2012,321332,300007,21325,6.6
35,3,Catron,2012,1249,1132,117,9.4
35,5,Chaves,2012,27003,25287,1716,6.4
35,6,Cibola,2012,9302,8516,786,8.4
35,7,Colfax,2012,6136,5664,472,7.7
35,9,Curry,2012,21614,20565,1049,4.9
35,11,De Baca,2012,824,789,35,4.2
35,13,Dona Ana,2012,93870,87140,6730,7.2
35,15,Eddy,2012,26874,25644,1230,4.6
35,17,Grant,2012,13023,12174,849,6.5
35,19,Guadalupe,2012,1646,1485,161,9.8
35,21,Harding,2012,293,275,18,6.1
35,23,Hidalgo,2012,2340,2172,168,7.2
35,25,Lea,2012,28373,27061,1312,4.6
35,27,Lincoln,2012,8975,8401,574,6.4
35,28,Los Alamos,2012,9016,8672,344,3.8
35,29,Luna,2012,11438,9195,2243,19.6
35,31,McKinley,2012,24929,22584,2345,9.4
35,33,Mora,2012,2315,2066,249,10.8
35,35,Otero,2012,25081,23482,1599,6.4
35,37,Quay,2012,3393,3123,270,8.0
35,39,Rio Arriba,2012,16870,15332,1538,9.1
35,41,Roosevelt,2012,8358,7900,458,5.5
35,43,Sandoval,2012,60586,55966,4620,7.6
35,45,San Juan,2012,55371,51522,3849,7.0
35,47,San Miguel,2012,11108,10142,966,8.7
35,49,Santa Fe,2012,73761,69587,4174,5.7
35,51,Sierra,2012,3975,3593,382,9.6
35,53,Socorro,2012,6826,6360,466,6.8
35,55,Taos,2012,15012,13470,1542,10.3
35,57,Torrance,2012,5767,5166,601,10.4
35,59,Union,2012,1875,1795,80,4.3
35,61,Valencia,2012,30227,27669,2558,8.5
36,1,Albany,2012,160401,148855,11546,7.2
36,3,Allegany,2012,23658,21638,2020,8.5
36,5,Bronx,2012,594885,520367,74518,12.5
36,7,Broome,2012,93879,85603,8276,8.8
36,9,Cattaraugus,2012,38264,34639,3625,9.5
36,11,Cayuga,2012,39056,35787,3269,8.4
36,13,Chautauqua,2012,61194,55903,5291,8.6
36,15,Chemung,2012,40497,37041,3456,8.5
36,17,Chenango,2012,24093,21984,2109,8.8
36,19,Clinton,2012,37952,34331,3621,9.5
36,21,Columbia,2012,31633,29371,2262,7.2
36,23,Cortland,2012,24444,22305,2139,8.8
36,25,Delaware,2012,21560,19649,1911,8.9
36,27,Dutchess,2012,146160,134622,11538,7.9
36,29,Erie,2012,461103,422256,38847,8.4
36,31,Essex,2012,18152,16392,1760,9.7
36,33,Franklin,2012,21768,19658,2110,9.7
36,35,Fulton,2012,25370,22534,2836,11.2
36,37,Genesee,2012,30841,28365,2476,8.0
36,39,Greene,2012,21525,19354,2171,10.1
36,41,Hamilton,2012,2448,2181,267,10.9
36,43,Herkimer,2012,30496,27786,2710,8.9
36,45,Jefferson,2012,48359,43529,4830,10.0
36,47,Kings,2012,1189756,1072483,117273,9.9
36,49,Lewis,2012,12254,11013,1241,10.1
36,51,Livingston,2012,32096,29545,2551,7.9
36,53,Madison,2012,34568,31589,2979,8.6
36,55,Monroe,2012,375735,345696,30039,8.0
36,57,Montgomery,2012,23424,20954,2470,10.5
36,59,Nassau,2012,692547,643054,49493,7.1
36,61,New York,2012,894573,822146,72427,8.1
36,63,Niagara,2012,105621,95634,9987,9.5
36,65,Oneida,2012,108406,99345,9061,8.4
36,67,Onondaga,2012,232618,214042,18576,8.0
36,69,Ontario,2012,55960,51830,4130,7.4
36,71,Orange,2012,179353,164966,14387,8.0
36,73,Orleans,2012,18852,16999,1853,9.8
36,75,Oswego,2012,57885,51445,6440,11.1
36,77,Otsego,2012,31411,28909,2502,8.0
36,79,Putnam,2012,51525,47769,3756,7.3
36,81,Queens,2012,1123639,1029794,93845,8.4
36,83,Rensselaer,2012,83475,76917,6558,7.9
36,85,Richmond,2012,218185,197348,20837,9.6
36,87,Rockland,2012,150225,139075,11150,7.4
36,89,St. Lawrence,2012,48530,43508,5022,10.3
36,91,Saratoga,2012,117330,109223,8107,6.9
36,93,Schenectady,2012,77934,71862,6072,7.8
36,95,Schoharie,2012,15435,13996,1439,9.3
36,97,Schuyler,2012,9021,8162,859,9.5
36,99,Seneca,2012,16217,14905,1312,8.1
36,101,Steuben,2012,45766,41432,4334,9.5
36,103,Suffolk,2012,778227,716784,61443,7.9
36,105,Sullivan,2012,35265,32006,3259,9.2
36,107,Tioga,2012,25429,23394,2035,8.0
36,109,Tompkins,2012,54976,51558,3418,6.2
36,111,Ulster,2012,90914,83282,7632,8.4
36,113,Warren,2012,33716,30577,3139,9.3
36,115,Washington,2012,29857,27351,2506,8.4
36,117,Wayne,2012,46460,42421,4039,8.7
36,119,Westchester,2012,476735,441625,35110,7.4
36,121,Wyoming,2012,18876,17183,1693,9.0
36,123,Yates,2012,12071,11116,955,7.9
37,1,Alamance,2012,78641,71776,6865,8.7
37,3,Alexander,2012,17826,16078,1748,9.8
37,5,Alleghany,2012,4643,4148,495,10.7
37,7,Anson,2012,11158,9910,1248,11.2
37,9,Ashe,2012,13302,11881,1421,10.7
37,11,Avery,2012,7812,6962,850,10.9
37,13,Beaufort,2012,21237,18934,2303,10.8
37,15,Bertie,2012,8746,7726,1020,11.7
37,17,Bladen,2012,14587,12691,1896,13.0
37,19,Brunswick,2012,47781,42283,5498,11.5
37,21,Buncombe,2012,127452,117988,9464,7.4
37,23,Burke,2012,41048,36909,4139,10.1
37,25,Cabarrus,2012,92135,83642,8493,9.2
37,27,Caldwell,2012,37235,32811,4424,11.9
37,29,Camden,2012,4557,4191,366,8.0
37,31,Carteret,2012,31763,28859,2904,9.1
37,33,Caswell,2012,10050,8954,1096,10.9
37,35,Catawba,2012,77247,69223,8024,10.4
37,37,Chatham,2012,31875,29313,2562,8.0
37,39,Cherokee,2012,11525,10232,1293,11.2
37,41,Chowan,2012,5958,5294,664,11.1
37,43,Clay,2012,4204,3758,446,10.6
37,45,Cleveland,2012,46165,40947,5218,11.3
37,47,Columbus,2012,23400,20464,2936,12.5
37,49,Craven,2012,42237,38135,4102,9.7
37,51,Cumberland,2012,133635,119256,14379,10.8
37,53,Currituck,2012,12566,11464,1102,8.8
37,55,Dare,2012,20913,18268,2645,12.6
37,57,Davidson,2012,80304,72328,7976,9.9
37,59,Davie,2012,20166,18293,1873,9.3
37,61,Duplin,2012,26646,24156,2490,9.3
37,63,Durham,2012,149901,138530,11371,7.6
37,65,Edgecombe,2012,24601,20997,3604,14.6
37,67,Forsyth,2012,177910,161767,16143,9.1
37,69,Franklin,2012,28408,25590,2818,9.9
37,71,Gaston,2012,101897,90989,10908,10.7
37,73,Gates,2012,5400,4976,424,7.9
37,75,Graham,2012,3615,2962,653,18.1
37,77,Granville,2012,28529,26194,2335,8.2
37,79,Greene,2012,9733,8875,858,8.8
37,81,Guilford,2012,256943,231822,25121,9.8
37,83,Halifax,2012,22156,19086,3070,13.9
37,85,Harnett,2012,50163,44712,5451,10.9
37,87,Haywood,2012,27752,25160,2592,9.3
37,89,Henderson,2012,48982,45221,3761,7.7
37,91,Hertford,2012,9660,8595,1065,11.0
37,93,Hoke,2012,20011,17822,2189,10.9
37,95,Hyde,2012,2152,1856,296,13.8
37,97,Iredell,2012,79950,71826,8124,10.2
37,99,Jackson,2012,18234,16258,1976,10.8
37,101,Johnston,2012,84222,76949,7273,8.6
37,103,Jones,2012,4629,4159,470,10.2
37,105,Lee,2012,27342,24159,3183,11.6
37,107,Lenoir,2012,28740,25852,2888,10.0
37,109,Lincoln,2012,40285,36321,3964,9.8
37,111,McDowell,2012,20782,18478,2304,11.1
37,113,Macon,2012,15623,13924,1699,10.9
37,115,Madison,2012,9572,8615,957,10.0
37,117,Martin,2012,10528,9234,1294,12.3
37,119,Mecklenburg,2012,532231,484538,47693,9.0
37,121,Mitchell,2012,6711,5871,840,12.5
37,123,Montgomery,2012,11656,10393,1263,10.8
37,125,Moore,2012,37789,34388,3401,9.0
37,127,Nash,2012,46530,41042,5488,11.8
37,129,New Hanover,2012,109761,100052,9709,8.8
37,131,Northampton,2012,8374,7390,984,11.8
37,133,Onslow,2012,64123,58859,5264,8.2
37,135,Orange,2012,72628,68085,4543,6.3
37,137,Pamlico,2012,5418,4917,501,9.2
37,139,Pasquotank,2012,18282,16402,1880,10.3
37,141,Pender,2012,25101,22419,2682,10.7
37,143,Perquimans,2012,5312,4745,567,10.7
37,145,Person,2012,18561,16464,2097,11.3
37,147,Pitt,2012,88465,80207,8258,9.3
37,149,Polk,2012,8417,7686,731,8.7
37,151,Randolph,2012,69079,62045,7034,10.2
37,153,Richmond,2012,18104,15625,2479,13.7
37,155,Robeson,2012,53328,46099,7229,13.6
37,157,Rockingham,2012,43424,38417,5007,11.5
37,159,Rowan,2012,63882,56768,7114,11.1
37,161,Rutherford,2012,27038,23385,3653,13.5
37,163,Sampson,2012,29958,27095,2863,9.6
37,165,Scotland,2012,12596,10387,2209,17.5
37,167,Stanly,2012,29003,26050,2953,10.2
37,169,Stokes,2012,22586,20433,2153,9.5
37,171,Surry,2012,33943,30594,3349,9.9
37,173,Swain,2012,6587,5596,991,15.0
37,175,Transylvania,2012,13568,12360,1208,8.9
37,177,Tyrrell,2012,1599,1376,223,13.9
37,179,Union,2012,105081,96627,8454,8.0
37,181,Vance,2012,18665,16081,2584,13.8
37,183,Wake,2012,506466,469451,37015,7.3
37,185,Warren,2012,7650,6675,975,12.7
37,187,Washington,2012,4922,4149,773,15.7
37,189,Watauga,2012,27276,25213,2063,7.6
37,191,Wayne,2012,55842,50996,4846,8.7
37,193,Wilkes,2012,30856,27577,3279,10.6
37,195,Wilson,2012,38694,33547,5147,13.3
37,197,Yadkin,2012,18121,16414,1707,9.4
37,199,Yancey,2012,8046,7166,880,10.9
38,1,Adams,2012,1105,1075,30,2.7
38,3,Barnes,2012,5719,5531,188,3.3
38,5,Benson,2012,2753,2569,184,6.7
38,7,Billings,2012,471,456,15,3.2
38,9,Bottineau,2012,3389,3279,110,3.2
38,11,Bowman,2012,1908,1874,34,1.8
38,13,Burke,2012,1368,1342,26,1.9
38,15,Burleigh,2012,46335,45084,1251,2.7
38,17,Cass,2012,89079,86578,2501,2.8
38,19,Cavalier,2012,2136,2071,65,3.0
38,21,Dickey,2012,2693,2623,70,2.6
38,23,Divide,2012,1778,1752,26,1.5
38,25,Dunn,2012,3659,3605,54,1.5
38,27,Eddy,2012,1242,1181,61,4.9
38,29,Emmons,2012,1636,1552,84,5.1
38,31,Foster,2012,1674,1624,50,3.0
38,33,Golden Valley,2012,976,953,23,2.4
38,35,Grand Forks,2012,37080,35877,1203,3.2
38,37,Grant,2012,1293,1254,39,3.0
38,39,Griggs,2012,1217,1186,31,2.5
38,41,Hettinger,2012,1446,1409,37,2.6
38,43,Kidder,2012,1255,1194,61,4.9
38,45,LaMoure,2012,2265,2210,55,2.4
38,47,Logan,2012,903,877,26,2.9
38,49,McHenry,2012,3262,3128,134,4.1
38,51,McIntosh,2012,1240,1202,38,3.1
38,53,McKenzie,2012,6064,5976,88,1.5
38,55,McLean,2012,4724,4525,199,4.2
38,57,Mercer,2012,4008,3804,204,5.1
38,59,Morton,2012,15410,14881,529,3.4
38,61,Mountrail,2012,7372,7257,115,1.6
38,63,Nelson,2012,1537,1476,61,4.0
38,65,Oliver,2012,884,827,57,6.4
38,67,Pembina,2012,3681,3455,226,6.1
38,69,Pierce,2012,1863,1786,77,4.1
38,71,Ramsey,2012,5790,5561,229,4.0
38,73,Ransom,2012,2783,2703,80,2.9
38,75,Renville,2012,1437,1406,31,2.2
38,77,Richland,2012,8512,8215,297,3.5
38,79,Rolette,2012,4978,4473,505,10.1
38,81,Sargent,2012,2135,2081,54,2.5
38,83,Sheridan,2012,733,707,26,3.5
38,85,Sioux,2012,1298,1234,64,4.9
38,87,Slope,2012,526,515,11,2.1
38,89,Stark,2012,18163,17846,317,1.7
38,91,Steele,2012,1043,1016,27,2.6
38,93,Stutsman,2012,10362,10021,341,3.3
38,95,Towner,2012,1252,1212,40,3.2
38,97,Traill,2012,4504,4368,136,3.0
38,99,Walsh,2012,5628,5364,264,4.7
38,101,Ward,2012,33758,32902,856,2.5
38,103,Wells,2012,2213,2129,84,3.8
38,105,Williams,2012,26956,26668,288,1.1
39,1,Adams,2012,10773,9421,1352,12.5
39,3,Allen,2012,49967,46117,3850,7.7
39,5,Ashland,2012,25832,23760,2072,8.0
39,7,Ashtabula,2012,46455,42089,4366,9.4
39,9,Athens,2012,27602,25250,2352,8.5
39,11,Auglaize,2012,23958,22479,1479,6.2
39,13,Belmont,2012,31743,29129,2614,8.2
39,15,Brown,2012,20153,18141,2012,10.0
39,17,Butler,2012,186571,172291,14280,7.7
39,19,Carroll,2012,13798,12704,1094,7.9
39,21,Champaign,2012,19382,17953,1429,7.4
39,23,Clark,2012,65897,60768,5129,7.8
39,25,Clermont,2012,102152,94544,7608,7.4
39,27,Clinton,2012,17289,15434,1855,10.7
39,29,Columbiana,2012,50915,46723,4192,8.2
39,31,Coshocton,2012,16212,14584,1628,10.0
39,33,Crawford,2012,20314,18478,1836,9.0
39,35,Cuyahoga,2012,621812,579379,42433,6.8
39,37,Darke,2012,26574,24654,1920,7.2
39,39,Defiance,2012,18996,17542,1454,7.7
39,41,Delaware,2012,95998,91025,4973,5.2
39,43,Erie,2012,38645,35554,3091,8.0
39,45,Fairfield,2012,73353,68486,4867,6.6
39,47,Fayette,2012,14118,12950,1168,8.3
39,49,Franklin,2012,630411,589946,40465,6.4
39,51,Fulton,2012,22431,20698,1733,7.7
39,53,Gallia,2012,12652,11431,1221,9.7
39,55,Geauga,2012,49043,46410,2633,5.4
39,57,Greene,2012,80663,75114,5549,6.9
39,59,Guernsey,2012,18235,16602,1633,9.0
39,61,Hamilton,2012,402186,372577,29609,7.4
39,63,Hancock,2012,39807,37264,2543,6.4
39,65,Hardin,2012,14895,13785,1110,7.5
39,67,Harrison,2012,6977,6381,596,8.5
39,69,Henry,2012,14125,12890,1235,8.7
39,71,Highland,2012,17613,15781,1832,10.4
39,73,Hocking,2012,13555,12434,1121,8.3
39,75,Holmes,2012,19755,18741,1014,5.1
39,77,Huron,2012,28959,26096,2863,9.9
39,79,Jackson,2012,13724,12308,1416,10.3
39,81,Jefferson,2012,31271,27881,3390,10.8
39,83,Knox,2012,30156,28064,2092,6.9
39,85,Lake,2012,125033,117536,7497,6.0
39,87,Lawrence,2012,26514,24266,2248,8.5
39,89,Licking,2012,86045,80235,5810,6.8
39,91,Logan,2012,22606,20992,1614,7.1
39,93,Lorain,2012,149803,139170,10633,7.1
39,95,Lucas,2012,210469,192955,17514,8.3
39,97,Madison,2012,20094,18812,1282,6.4
39,99,Mahoning,2012,110756,101578,9178,8.3
39,101,Marion,2012,28896,26611,2285,7.9
39,103,Medina,2012,94011,88817,5194,5.5
39,105,Meigs,2012,9505,8409,1096,11.5
39,107,Mercer,2012,22144,21013,1131,5.1
39,109,Miami,2012,52342,48540,3802,7.3
39,111,Monroe,2012,6495,5951,544,8.4
39,113,Montgomery,2012,254590,233721,20869,8.2
39,115,Morgan,2012,6702,6038,664,9.9
39,117,Morrow,2012,16904,15530,1374,8.1
39,119,Muskingum,2012,40377,36680,3697,9.2
39,121,Noble,2012,4781,4256,525,11.0
39,123,Ottawa,2012,22004,19910,2094,9.5
39,125,Paulding,2012,9217,8508,709,7.7
39,127,Perry,2012,16094,14521,1573,9.8
39,129,Pickaway,2012,25705,23794,1911,7.4
39,131,Pike,2012,10571,9194,1377,13.0
39,133,Portage,2012,88000,81596,6404,7.3
39,135,Preble,2012,21484,19824,1660,7.7
39,137,Putnam,2012,18800,17710,1090,5.8
39,139,Richland,2012,55884,51019,4865,8.7
39,141,Ross,2012,34054,31195,2859,8.4
39,143,Sandusky,2012,31773,29386,2387,7.5
39,145,Scioto,2012,31093,27584,3509,11.3
39,147,Seneca,2012,27802,25591,2211,8.0
39,149,Shelby,2012,23846,22111,1735,7.3
39,151,Stark,2012,187968,173932,14036,7.5
39,153,Summit,2012,272453,252147,20306,7.5
39,155,Trumbull,2012,95344,86735,8609,9.0
39,157,Tuscarawas,2012,45001,41691,3310,7.4
39,159,Union,2012,26346,24831,1515,5.8
39,161,Van Wert,2012,14157,13090,1067,7.5
39,163,Vinton,2012,5550,4951,599,10.8
39,165,Warren,2012,109086,101993,7093,6.5
39,167,Washington,2012,28429,25970,2459,8.6
39,169,Wayne,2012,59078,55467,3611,6.1
39,171,Williams,2012,18863,17374,1489,7.9
39,173,Wood,2012,68703,63991,4712,6.9
39,175,Wyandot,2012,12139,11310,829,6.8
40,1,Adair,2012,8450,7701,749,8.9
40,3,Alfalfa,2012,2908,2827,81,2.8
40,5,Atoka,2012,4977,4650,327,6.6
40,7,Beaver,2012,3115,3025,90,2.9
40,9,Beckham,2012,12507,12140,367,2.9
40,11,Blaine,2012,4358,4194,164,3.8
40,13,Bryan,2012,17542,16629,913,5.2
40,15,Caddo,2012,11653,10977,676,5.8
40,17,Canadian,2012,63242,60849,2393,3.8
40,19,Carter,2012,21829,20659,1170,5.4
40,21,Cherokee,2012,18883,17593,1290,6.8
40,23,Choctaw,2012,5799,5324,475,8.2
40,25,Cimarron,2012,1286,1246,40,3.1
40,27,Cleveland,2012,135737,130292,5445,4.0
40,29,Coal,2012,2355,2193,162,6.9
40,31,Comanche,2012,50600,47687,2913,5.8
40,33,Cotton,2012,2872,2715,157,5.5
40,35,Craig,2012,6334,5987,347,5.5
40,37,Creek,2012,31442,29614,1828,5.8
40,39,Custer,2012,15623,15083,540,3.5
40,41,Delaware,2012,17046,15957,1089,6.4
40,43,Dewey,2012,2374,2300,74,3.1
40,45,Ellis,2012,2272,2209,63,2.8
40,47,Garfield,2012,29420,28264,1156,3.9
40,49,Garvin,2012,12467,11865,602,4.8
40,51,Grady,2012,25461,24287,1174,4.6
40,53,Grant,2012,2641,2554,87,3.3
40,55,Greer,2012,2065,1958,107,5.2
40,57,Harmon,2012,1409,1345,64,4.5
40,59,Harper,2012,1912,1853,59,3.1
40,61,Haskell,2012,4595,4199,396,8.6
40,63,Hughes,2012,5743,5296,447,7.8
40,65,Jackson,2012,11030,10482,548,5.0
40,67,Jefferson,2012,2593,2469,124,4.8
40,69,Johnston,2012,3632,3357,275,7.6
40,71,Kay,2012,20202,18811,1391,6.9
40,73,Kingfisher,2012,7671,7422,249,3.2
40,75,Kiowa,2012,4255,4061,194,4.6
40,77,Latimer,2012,4526,4154,372,8.2
40,79,Le Flore,2012,19991,18323,1668,8.3
40,81,Lincoln,2012,15493,14747,746,4.8
40,83,Logan,2012,20523,19653,870,4.2
40,85,Love,2012,5092,4883,209,4.1
40,87,McClain,2012,17508,16797,711,4.1
40,89,McCurtain,2012,14380,13053,1327,9.2
40,91,McIntosh,2012,7385,6656,729,9.9
40,93,Major,2012,4060,3922,138,3.4
40,95,Marshall,2012,6785,6402,383,5.6
40,97,Mayes,2012,18397,17310,1087,5.9
40,99,Murray,2012,6651,6353,298,4.5
40,101,Muskogee,2012,29972,28023,1949,6.5
40,103,Noble,2012,5472,5237,235,4.3
40,105,Nowata,2012,4893,4570,323,6.6
40,107,Okfuskee,2012,4391,4066,325,7.4
40,109,Oklahoma,2012,364140,347251,16889,4.6
40,111,Okmulgee,2012,16459,15194,1265,7.7
40,113,Osage,2012,21225,20023,1202,5.7
40,115,Ottawa,2012,14490,13385,1105,7.6
40,117,Pawnee,2012,7467,6991,476,6.4
40,119,Payne,2012,37750,36030,1720,4.6
40,121,Pittsburg,2012,18948,17661,1287,6.8
40,123,Pontotoc,2012,18190,17294,896,4.9
40,125,Pottawatomie,2012,31914,30271,1643,5.1
40,127,Pushmataha,2012,4841,4500,341,7.0
40,129,Roger Mills,2012,2098,2040,58,2.8
40,131,Rogers,2012,43618,41514,2104,4.8
40,133,Seminole,2012,9945,9189,756,7.6
40,135,Sequoyah,2012,17137,15756,1381,8.1
40,137,Stephens,2012,20492,19516,976,4.8
40,139,Texas,2012,8950,8589,361,4.0
40,141,Tillman,2012,3399,3240,159,4.7
40,143,Tulsa,2012,308472,293070,15402,5.0
40,145,Wagoner,2012,35835,34035,1800,5.0
40,147,Washington,2012,24484,23339,1145,4.7
40,149,Washita,2012,5626,5409,217,3.9
40,151,Woods,2012,5054,4918,136,2.7
40,153,Woodward,2012,10551,10191,360,3.4
41,1,Baker,2012,7136,6384,752,10.5
41,3,Benton,2012,45224,42512,2712,6.0
41,5,Clackamas,2012,201578,185371,16207,8.0
41,7,Clatsop,2012,18647,17017,1630,8.7
41,9,Columbia,2012,23053,20584,2469,10.7
41,11,Coos,2012,27251,24232,3019,11.1
41,13,Crook,2012,9278,8022,1256,13.5
41,15,Curry,2012,9003,7944,1059,11.8
41,17,Deschutes,2012,79176,70282,8894,11.2
41,19,Douglas,2012,45963,40478,5485,11.9
41,21,Gilliam,2012,942,847,95,10.1
41,23,Grant,2012,3324,2860,464,14.0
41,25,Harney,2012,3536,3120,416,11.8
41,27,Hood River,2012,14119,13097,1022,7.2
41,29,Jackson,2012,98945,87981,10964,11.1
41,31,Jefferson,2012,9642,8506,1136,11.8
41,33,Josephine,2012,33545,29471,4074,12.1
41,35,Klamath,2012,30148,26620,3528,11.7
41,37,Lake,2012,3647,3175,472,12.9
41,39,Lane,2012,173244,157828,15416,8.9
41,41,Lincoln,2012,21465,19338,2127,9.9
41,43,Linn,2012,55605,49637,5968,10.7
41,45,Malheur,2012,12899,11692,1207,9.4
41,47,Marion,2012,151415,136344,15071,10.0
41,49,Morrow,2012,5675,5216,459,8.1
41,51,Multnomah,2012,421947,389862,32085,7.6
41,53,Polk,2012,35430,32281,3149,8.9
41,55,Sherman,2012,901,804,97,10.8
41,57,Tillamook,2012,11232,10144,1088,9.7
41,59,Umatilla,2012,36889,33549,3340,9.1
41,61,Union,2012,12281,11125,1156,9.4
41,63,Wallowa,2012,3369,2983,386,11.5
41,65,Wasco,2012,13880,12711,1169,8.4
41,67,Washington,2012,292667,271984,20683,7.1
41,69,Wheeler,2012,785,731,54,6.9
41,71,Yamhill,2012,50827,46519,4308,8.5
42,1,Adams,2012,54651,51235,3416,6.3
42,3,Allegheny,2012,651926,607613,44313,6.8
42,5,Armstrong,2012,33830,31171,2659,7.9
42,7,Beaver,2012,86713,80320,6393,7.4
42,9,Bedford,2012,25020,22907,2113,8.4
42,11,Berks,2012,211336,195497,15839,7.5
42,13,Blair,2012,61716,57230,4486,7.3
42,15,Bradford,2012,32571,30383,2188,6.7
42,17,Bucks,2012,338068,314322,23746,7.0
42,19,Butler,2012,97815,91658,6157,6.3
42,21,Cambria,2012,65820,60165,5655,8.6
42,23,Cameron,2012,2446,2201,245,10.0
42,25,Carbon,2012,32231,29075,3156,9.8
42,27,Centre,2012,77441,73287,4154,5.4
42,29,Chester,2012,272533,257539,14994,5.5
42,31,Clarion,2012,18956,17290,1666,8.8
42,33,Clearfield,2012,38138,34646,3492,9.2
42,35,Clinton,2012,19415,17736,1679,8.6
42,37,Columbia,2012,35433,32540,2893,8.2
42,39,Crawford,2012,41896,38769,3127,7.5
42,41,Cumberland,2012,125535,117951,7584,6.0
42,43,Dauphin,2012,140870,130640,10230,7.3
42,45,Delaware,2012,288958,267200,21758,7.5
42,47,Elk,2012,16854,15706,1148,6.8
42,49,Erie,2012,137128,126665,10463,7.6
42,51,Fayette,2012,60095,54255,5840,9.7
42,53,Forest,2012,2008,1816,192,9.6
42,55,Franklin,2012,76186,70958,5228,6.9
42,57,Fulton,2012,7423,6753,670,9.0
42,59,Greene,2012,19037,17677,1360,7.1
42,61,Huntingdon,2012,20718,18704,2014,9.7
42,63,Indiana,2012,44662,41117,3545,7.9
42,65,Jefferson,2012,21707,19939,1768,8.1
42,67,Juniata,2012,12024,11170,854,7.1
42,69,Lackawanna,2012,107371,98089,9282,8.6
42,71,Lancaster,2012,268700,251573,17127,6.4
42,73,Lawrence,2012,43235,39892,3343,7.7
42,75,Lebanon,2012,70778,66154,4624,6.5
42,77,Lehigh,2012,182454,167310,15144,8.3
42,79,Luzerne,2012,160422,145056,15366,9.6
42,81,Lycoming,2012,62618,57796,4822,7.7
42,83,McKean,2012,20223,18564,1659,8.2
42,85,Mercer,2012,53825,49847,3978,7.4
42,87,Mifflin,2012,21083,19296,1787,8.5
42,89,Monroe,2012,82207,74353,7854,9.6
42,91,Montgomery,2012,434777,407767,27010,6.2
42,93,Montour,2012,9427,8891,536,5.7
42,95,Northampton,2012,155096,142791,12305,7.9
42,97,Northumberland,2012,44973,40967,4006,8.9
42,99,Perry,2012,24609,22863,1746,7.1
42,101,Philadelphia/city,2012,697305,623043,74262,10.6
42,103,Pike,2012,25997,23425,2572,9.9
42,105,Potter,2012,7909,7204,705,8.9
42,107,Schuylkill,2012,70802,64056,6746,9.5
42,109,Snyder,2012,19793,18322,1471,7.4
42,111,Somerset,2012,36496,33332,3164,8.7
42,113,Sullivan,2012,3096,2859,237,7.7
42,115,Susquehanna,2012,22462,20790,1672,7.4
42,117,Tioga,2012,21682,20065,1617,7.5
42,119,Union,2012,19096,17895,1201,6.3
42,121,Venango,2012,26245,24276,1969,7.5
42,123,Warren,2012,20548,19173,1375,6.7
42,125,Washington,2012,107225,99685,7540,7.0
42,127,Wayne,2012,23073,21254,1819,7.9
42,129,Westmoreland,2012,187256,173746,13510,7.2
42,131,Wyoming,2012,14360,13102,1258,8.8
42,133,York,2012,232731,215842,16889,7.3
44,1,Bristol,2012,26281,23960,2321,8.8
44,3,Kent,2012,92497,83445,9052,9.8
44,5,Newport,2012,44361,40313,4048,9.1
44,7,Providence,2012,326755,291552,35203,10.8
44,9,Washington,2012,70310,63628,6682,9.5
45,1,Abbeville,2012,10697,9584,1113,10.4
45,3,Aiken,2012,73077,66929,6148,8.4
45,5,Allendale,2012,3132,2612,520,16.6
45,7,Anderson,2012,85717,78287,7430,8.7
45,9,Bamberg,2012,5799,4895,904,15.6
45,11,Barnwell,2012,8963,7744,1219,13.6
45,13,Beaufort,2012,66043,61164,4879,7.4
45,15,Berkeley,2012,88556,81276,7280,8.2
45,17,Calhoun,2012,6958,6195,763,11.0
45,19,Charleston,2012,186874,173805,13069,7.0
45,21,Cherokee,2012,23768,20782,2986,12.6
45,23,Chester,2012,14039,12005,2034,14.5
45,25,Chesterfield,2012,21069,18724,2345,11.1
45,27,Clarendon,2012,13292,11621,1671,12.6
45,29,Colleton,2012,16470,14519,1951,11.8
45,31,Darlington,2012,30446,27148,3298,10.8
45,33,Dillon,2012,13208,11379,1829,13.8
45,35,Dorchester,2012,68327,63096,5231,7.7
45,37,Edgefield,2012,10658,9674,984,9.2
45,39,Fairfield,2012,10399,9072,1327,12.8
45,41,Florence,2012,65058,58914,6144,9.4
45,43,Georgetown,2012,24696,21799,2897,11.7
45,45,Greenville,2012,227402,210863,16539,7.3
45,47,Greenwood,2012,32093,28905,3188,9.9
45,49,Hampton,2012,8431,7508,923,10.9
45,51,Horry,2012,132855,119373,13482,10.1
45,53,Jasper,2012,10979,10070,909,8.3
45,55,Kershaw,2012,28168,25542,2626,9.3
45,57,Lancaster,2012,34386,30590,3796,11.0
45,59,Laurens,2012,30071,27038,3033,10.1
45,61,Lee,2012,6731,5804,927,13.8
45,63,Lexington,2012,136865,127490,9375,6.8
45,65,McCormick,2012,3574,3162,412,11.5
45,67,Marion,2012,13509,11403,2106,15.6
45,69,Marlboro,2012,10794,8933,1861,17.2
45,71,Newberry,2012,18261,16683,1578,8.6
45,73,Oconee,2012,33441,30565,2876,8.6
45,75,Orangeburg,2012,39392,33886,5506,14.0
45,77,Pickens,2012,54840,50028,4812,8.8
45,79,Richland,2012,189636,174505,15131,8.0
45,81,Saluda,2012,8609,7895,714,8.3
45,83,Spartanburg,2012,134988,122526,12462,9.2
45,85,Sumter,2012,44784,40111,4673,10.4
45,87,Union,2012,11968,10370,1598,13.4
45,89,Williamsburg,2012,12434,10509,1925,15.5
45,91,York,2012,118749,107974,10775,9.1
46,3,Aurora,2012,1701,1654,47,2.8
46,5,Beadle,2012,9671,9353,318,3.3
46,7,Bennett,2012,1209,1132,77,6.4
46,9,Bon Homme,2012,3069,2955,114,3.7
46,11,Brookings,2012,17872,17209,663,3.7
46,13,Brown,2012,21086,20374,712,3.4
46,15,Brule,2012,2676,2584,92,3.4
46,17,Buffalo,2012,751,682,69,9.2
46,19,Butte,2012,5025,4803,222,4.4
46,21,Campbell,2012,870,840,30,3.4
46,23,Charles Mix,2012,4096,3904,192,4.7
46,25,Clark,2012,1942,1862,80,4.1
46,27,Clay,2012,7507,7235,272,3.6
46,29,Codington,2012,15652,15076,576,3.7
46,31,Corson,2012,1525,1409,116,7.6
46,33,Custer,2012,4056,3850,206,5.1
46,35,Davison,2012,11327,10969,358,3.2
46,37,Day,2012,2977,2814,163,5.5
46,39,Deuel,2012,2503,2362,141,5.6
46,41,Dewey,2012,2423,2053,370,15.3
46,43,Douglas,2012,1712,1657,55,3.2
46,45,Edmunds,2012,2331,2265,66,2.8
46,47,Fall River,2012,3151,2981,170,5.4
46,49,Faulk,2012,1156,1112,44,3.8
46,51,Grant,2012,4564,4373,191,4.2
46,53,Gregory,2012,2153,2064,89,4.1
46,55,Haakon,2012,1109,1076,33,3.0
46,57,Hamlin,2012,3159,3041,118,3.7
46,59,Hand,2012,1853,1799,54,2.9
46,61,Hanson,2012,1829,1748,81,4.4
46,63,Harding,2012,815,787,28,3.4
46,65,Hughes,2012,10024,9711,313,3.1
46,67,Hutchinson,2012,3753,3630,123,3.3
46,69,Hyde,2012,773,747,26,3.4
46,71,Jackson,2012,1352,1262,90,6.7
46,73,Jerauld,2012,1229,1193,36,2.9
46,75,Jones,2012,633,610,23,3.6
46,77,Kingsbury,2012,3003,2902,101,3.4
46,79,Lake,2012,6329,6075,254,4.0
46,81,Lawrence,2012,12773,12230,543,4.3
46,83,Lincoln,2012,28118,27258,860,3.1
46,85,Lyman,2012,1898,1791,107,5.6
46,87,McCook,2012,3203,3088,115,3.6
46,89,McPherson,2012,1156,1105,51,4.4
46,91,Marshall,2012,2524,2410,114,4.5
46,93,Meade,2012,13310,12757,553,4.2
46,95,Mellette,2012,863,799,64,7.4
46,97,Miner,2012,1272,1229,43,3.4
46,99,Minnehaha,2012,101974,98148,3826,3.8
46,101,Moody,2012,4044,3834,210,5.2
46,102,Oglala Lakota,2012,3774,3263,511,13.5
46,103,Pennington,2012,53841,51602,2239,4.2
46,105,Perkins,2012,1550,1491,59,3.8
46,107,Potter,2012,1223,1176,47,3.8
46,109,Roberts,2012,4970,4700,270,5.4
46,111,Sanborn,2012,1309,1266,43,3.3
46,115,Spink,2012,3433,3300,133,3.9
46,117,Stanley,2012,1879,1825,54,2.9
46,119,Sully,2012,890,864,26,2.9
46,121,Todd,2012,3254,2954,300,9.2
46,123,Tripp,2012,3179,3067,112,3.5
46,125,Turner,2012,4782,4624,158,3.3
46,127,Union,2012,7883,7528,355,4.5
46,129,Walworth,2012,2347,2210,137,5.8
46,135,Yankton,2012,11692,11285,407,3.5
46,137,Ziebach,2012,1065,995,70,6.6
47,1,Anderson,2012,34465,31690,2775,8.1
47,3,Bedford,2012,20275,18260,2015,9.9
47,5,Benton,2012,6956,6262,694,10.0
47,7,Bledsoe,2012,4307,3851,456,10.6
47,9,Blount,2012,60341,56001,4340,7.2
47,11,Bradley,2012,48700,45054,3646,7.5
47,13,Campbell,2012,15723,13955,1768,11.2
47,15,Cannon,2012,6021,5501,520,8.6
47,17,Carroll,2012,13371,11885,1486,11.1
47,19,Carter,2012,25473,23158,2315,9.1
47,21,Cheatham,2012,20144,18667,1477,7.3
47,23,Chester,2012,8364,7697,667,8.0
47,25,Claiborne,2012,13319,11985,1334,10.0
47,27,Clay,2012,3318,2980,338,10.2
47,29,Cocke,2012,15458,13657,1801,11.7
47,31,Coffee,2012,24620,22558,2062,8.4
47,33,Crockett,2012,7208,6535,673,9.3
47,35,Cumberland,2012,23807,21627,2180,9.2
47,37,Davidson,2012,352777,330509,22268,6.3
47,39,Decatur,2012,5209,4663,546,10.5
47,41,DeKalb,2012,8037,7251,786,9.8
47,43,Dickson,2012,24166,22121,2045,8.5
47,45,Dyer,2012,17472,15519,1953,11.2
47,47,Fayette,2012,18394,16809,1585,8.6
47,49,Fentress,2012,7467,6727,740,9.9
47,51,Franklin,2012,19448,17910,1538,7.9
47,53,Gibson,2012,22865,20473,2392,10.5
47,55,Giles,2012,14020,12819,1201,8.6
47,57,Grainger,2012,9678,8665,1013,10.5
47,59,Greene,2012,30051,26948,3103,10.3
47,61,Grundy,2012,5527,4962,565,10.2
47,63,Hamblen,2012,27574,24935,2639,9.6
47,65,Hamilton,2012,170750,158780,11970,7.0
47,67,Hancock,2012,2255,1985,270,12.0
47,69,Hardeman,2012,9989,8883,1106,11.1
47,71,Hardin,2012,11139,9999,1140,10.2
47,73,Hawkins,2012,25064,22816,2248,9.0
47,75,Haywood,2012,8223,7258,965,11.7
47,77,Henderson,2012,13192,11895,1297,9.8
47,79,Henry,2012,14280,12913,1367,9.6
47,81,Hickman,2012,10640,9679,961,9.0
47,83,Houston,2012,3515,3116,399,11.4
47,85,Humphreys,2012,8651,7815,836,9.7
47,87,Jackson,2012,4583,4096,487,10.6
47,89,Jefferson,2012,23972,21689,2283,9.5
47,91,Johnson,2012,7345,6639,706,9.6
47,93,Knox,2012,230548,216171,14377,6.2
47,95,Lake,2012,2206,1972,234,10.6
47,97,Lauderdale,2012,10515,9349,1166,11.1
47,99,Lawrence,2012,18690,16878,1812,9.7
47,101,Lewis,2012,5042,4488,554,11.0
47,103,Lincoln,2012,15569,14602,967,6.2
47,105,Loudon,2012,22306,20587,1719,7.7
47,107,McMinn,2012,23595,21400,2195,9.3
47,109,McNairy,2012,9758,8740,1018,10.4
47,111,Macon,2012,10129,9272,857,8.5
47,113,Madison,2012,48464,44456,4008,8.3
47,115,Marion,2012,12266,11130,1136,9.3
47,117,Marshall,2012,14285,12922,1363,9.5
47,119,Maury,2012,40617,37379,3238,8.0
47,121,Meigs,2012,5058,4529,529,10.5
47,123,Monroe,2012,19458,17489,1969,10.1
47,125,Montgomery,2012,77933,71919,6014,7.7
47,127,Moore,2012,3389,3189,200,5.9
47,129,Morgan,2012,8317,7451,866,10.4
47,131,Obion,2012,14343,12386,1957,13.6
47,133,Overton,2012,9726,8844,882,9.1
47,135,Perry,2012,3111,2802,309,9.9
47,137,Pickett,2012,2444,2211,233,9.5
47,139,Polk,2012,7479,6733,746,10.0
47,141,Putnam,2012,32879,30192,2687,8.2
47,143,Rhea,2012,13489,12085,1404,10.4
47,145,Roane,2012,23866,21772,2094,8.8
47,147,Robertson,2012,33692,31281,2411,7.2
47,149,Rutherford,2012,144928,135335,9593,6.6
47,151,Scott,2012,8773,7389,1384,15.8
47,153,Sequatchie,2012,5952,5444,508,8.5
47,155,Sevier,2012,49440,45030,4410,8.9
47,157,Shelby,2012,445583,406551,39032,8.8
47,159,Smith,2012,8659,7940,719,8.3
47,161,Stewart,2012,5537,4917,620,11.2
47,163,Sullivan,2012,72833,67252,5581,7.7
47,165,Sumner,2012,84887,79265,5622,6.6
47,167,Tipton,2012,28284,25736,2548,9.0
47,169,Trousdale,2012,3679,3356,323,8.8
47,171,Unicoi,2012,7703,6896,807,10.5
47,173,Union,2012,7618,6887,731,9.6
47,175,Van Buren,2012,2243,1981,262,11.7
47,177,Warren,2012,17478,15918,1560,8.9
47,179,Washington,2012,60212,55872,4340,7.2
47,181,Wayne,2012,6653,6013,640,9.6
47,183,Weakley,2012,16928,15051,1877,11.1
47,185,White,2012,12199,10988,1211,9.9
47,187,Williamson,2012,98818,93837,4981,5.0
47,189,Wilson,2012,60587,56643,3944,6.5
48,1,Anderson,2012,22334,20932,1402,6.3
48,3,Andrews,2012,8524,8186,338,4.0
48,5,Angelina,2012,37778,35187,2591,6.9
48,7,Aransas,2012,9919,9233,686,6.9
48,9,Archer,2012,4361,4123,238,5.5
48,11,Armstrong,2012,1025,980,45,4.4
48,13,Atascosa,2012,20022,18681,1341,6.7
48,15,Austin,2012,14060,13166,894,6.4
48,17,Bailey,2012,3175,2957,218,6.9
48,19,Bandera,2012,9106,8513,593,6.5
48,21,Bastrop,2012,35216,32878,2338,6.6
48,23,Baylor,2012,1862,1767,95,5.1
48,25,Bee,2012,10827,10070,757,7.0
48,27,Bell,2012,133801,123945,9856,7.4
48,29,Bexar,2012,838357,785636,52721,6.3
48,31,Blanco,2012,5480,5199,281,5.1
48,33,Borden,2012,417,400,17,4.1
48,35,Bosque,2012,8169,7583,586,7.2
48,37,Bowie,2012,41452,38388,3064,7.4
48,39,Brazoria,2012,160811,150155,10656,6.6
48,41,Brazos,2012,99598,94375,5223,5.2
48,43,Brewster,2012,4552,4322,230,5.1
48,45,Briscoe,2012,642,607,35,5.5
48,47,Brooks,2012,2715,2479,236,8.7
48,49,Brown,2012,16032,14951,1081,6.7
48,51,Burleson,2012,7648,7170,478,6.3
48,53,Burnet,2012,20377,19171,1206,5.9
48,55,Caldwell,2012,16803,15605,1198,7.1
48,57,Calhoun,2012,10397,9638,759,7.3
48,59,Callahan,2012,5919,5561,358,6.0
48,61,Cameron,2012,165860,148873,16987,10.2
48,63,Camp,2012,5491,5054,437,8.0
48,65,Carson,2012,3283,3135,148,4.5
48,67,Cass,2012,12795,11627,1168,9.1
48,69,Castro,2012,4050,3874,176,4.3
48,71,Chambers,2012,17110,15740,1370,8.0
48,73,Cherokee,2012,21925,20347,1578,7.2
48,75,Childress,2012,2962,2832,130,4.4
48,77,Clay,2012,5307,5011,296,5.6
48,79,Cochran,2012,1443,1335,108,7.5
48,81,Coke,2012,1469,1395,74,5.0
48,83,Coleman,2012,3308,3061,247,7.5
48,85,Collin,2012,445697,419576,26121,5.9
48,87,Collingsworth,2012,1244,1183,61,4.9
48,89,Colorado,2012,10160,9517,643,6.3
48,91,Comal,2012,55784,52429,3355,6.0
48,93,Comanche,2012,5775,5410,365,6.3
48,95,Concho,2012,1508,1445,63,4.2
48,97,Cooke,2012,20645,19614,1031,5.0
48,99,Coryell,2012,25331,23481,1850,7.3
48,101,Cottle,2012,664,615,49,7.4
48,103,Crane,2012,2056,1956,100,4.9
48,105,Crockett,2012,1769,1681,88,5.0
48,107,Crosby,2012,2904,2697,207,7.1
48,109,Culberson,2012,987,928,59,6.0
48,111,Dallam,2012,4012,3865,147,3.7
48,113,Dallas,2012,1220310,1133951,86359,7.1
48,115,Dawson,2012,5068,4745,323,6.4
48,117,Deaf Smith,2012,9304,8869,435,4.7
48,119,Delta,2012,2618,2443,175,6.7
48,121,Denton,2012,387634,365619,22015,5.7
48,123,DeWitt,2012,9718,9256,462,4.8
48,125,Dickens,2012,831,743,88,10.6
48,127,Dimmit,2012,5751,5418,333,5.8
48,129,Donley,2012,1705,1605,100,5.9
48,131,Duval,2012,5419,5040,379,7.0
48,133,Eastland,2012,8247,7701,546,6.6
48,135,Ector,2012,76887,73375,3512,4.6
48,137,Edwards,2012,925,866,59,6.4
48,139,Ellis,2012,76603,71457,5146,6.7
48,141,El Paso,2012,346680,317204,29476,8.5
48,143,Erath,2012,20010,18904,1106,5.5
48,145,Falls,2012,6900,6397,503,7.3
48,147,Fannin,2012,15032,13976,1056,7.0
48,149,Fayette,2012,12495,11895,600,4.8
48,151,Fisher,2012,1903,1801,102,5.4
48,153,Floyd,2012,3190,2986,204,6.4
48,155,Foard,2012,621,585,36,5.8
48,157,Fort Bend,2012,318351,299516,18835,5.9
48,159,Franklin,2012,4619,4279,340,7.4
48,161,Freestone,2012,8042,7504,538,6.7
48,163,Frio,2012,8652,8219,433,5.0
48,165,Gaines,2012,8765,8395,370,4.2
48,167,Galveston,2012,152764,141167,11597,7.6
48,169,Garza,2012,2189,2082,107,4.9
48,171,Gillespie,2012,12302,11728,574,4.7
48,173,Glasscock,2012,761,731,30,3.9
48,175,Goliad,2012,3472,3282,190,5.5
48,177,Gonzales,2012,9435,8959,476,5.0
48,179,Gray,2012,9678,9137,541,5.6
48,181,Grayson,2012,59875,55801,4074,6.8
48,183,Gregg,2012,61496,57708,3788,6.2
48,185,Grimes,2012,11788,11032,756,6.4
48,187,Guadalupe,2012,68150,64306,3844,5.6
48,189,Hale,2012,15822,14735,1087,6.9
48,191,Hall,2012,1340,1236,104,7.8
48,193,Hamilton,2012,3742,3525,217,5.8
48,195,Hansford,2012,3048,2945,103,3.4
48,197,Hardeman,2012,1759,1656,103,5.9
48,199,Hardin,2012,25822,23653,2169,8.4
48,201,Harris,2012,2151642,2009784,141858,6.6
48,203,Harrison,2012,31902,29549,2353,7.4
48,205,Hartley,2012,2896,2800,96,3.3
48,207,Haskell,2012,2768,2622,146,5.3
48,209,Hays,2012,85610,80647,4963,5.8
48,211,Hemphill,2012,2542,2468,74,2.9
48,213,Henderson,2012,34462,31868,2594,7.5
48,215,Hidalgo,2012,327192,292711,34481,10.5
48,217,Hill,2012,15766,14681,1085,6.9
48,219,Hockley,2012,11764,11145,619,5.3
48,221,Hood,2012,23725,22188,1537,6.5
48,223,Hopkins,2012,17045,15949,1096,6.4
48,225,Houston,2012,10052,9347,705,7.0
48,227,Howard,2012,13370,12625,745,5.6
48,229,Hudspeth,2012,1323,1225,98,7.4
48,231,Hunt,2012,38327,35173,3154,8.2
48,233,Hutchinson,2012,9805,9171,634,6.5
48,235,Irion,2012,849,811,38,4.5
48,237,Jack,2012,3795,3578,217,5.7
48,239,Jackson,2012,7421,7044,377,5.1
48,241,Jasper,2012,14877,13302,1575,10.6
48,243,Jeff Davis,2012,1213,1154,59,4.9
48,245,Jefferson,2012,113297,100854,12443,11.0
48,247,Jim Hogg,2012,2344,2191,153,6.5
48,249,Jim Wells,2012,20606,19339,1267,6.1
48,251,Johnson,2012,72986,68168,4818,6.6
48,253,Jones,2012,5891,5469,422,7.2
48,255,Karnes,2012,5275,4956,319,6.0
48,257,Kaufman,2012,51497,47941,3556,6.9
48,259,Kendall,2012,17435,16498,937,5.4
48,261,Kenedy,2012,253,240,13,5.1
48,263,Kent,2012,550,529,21,3.8
48,265,Kerr,2012,21647,20392,1255,5.8
48,267,Kimble,2012,2184,2078,106,4.9
48,269,King,2012,247,236,11,4.5
48,271,Kinney,2012,1260,1150,110,8.7
48,273,Kleberg,2012,15384,14330,1054,6.9
48,275,Knox,2012,1814,1719,95,5.2
48,277,Lamar,2012,22588,20520,2068,9.2
48,279,Lamb,2012,6449,5939,510,7.9
48,281,Lampasas,2012,9072,8428,644,7.1
48,283,La Salle,2012,3663,3500,163,4.4
48,285,Lavaca,2012,9460,9006,454,4.8
48,287,Lee,2012,9116,8628,488,5.4
48,289,Leon,2012,6938,6429,509,7.3
48,291,Liberty,2012,30803,27868,2935,9.5
48,293,Limestone,2012,9583,8927,656,6.8
48,295,Lipscomb,2012,1754,1687,67,3.8
48,297,Live Oak,2012,5756,5494,262,4.6
48,299,Llano,2012,8047,7504,543,6.7
48,301,Loving,2012,67,63,4,6.0
48,303,Lubbock,2012,145281,137565,7716,5.3
48,305,Lynn,2012,2948,2770,178,6.0
48,307,McCulloch,2012,4392,4157,235,5.4
48,309,McLennan,2012,112098,104700,7398,6.6
48,311,McMullen,2012,742,725,17,2.3
48,313,Madison,2012,4642,4316,326,7.0
48,315,Marion,2012,4341,3947,394,9.1
48,317,Martin,2012,2410,2302,108,4.5
48,319,Mason,2012,1965,1863,102,5.2
48,321,Matagorda,2012,17062,15343,1719,10.1
48,323,Maverick,2012,23305,20404,2901,12.4
48,325,Medina,2012,20158,18846,1312,6.5
48,327,Menard,2012,970,909,61,6.3
48,329,Midland,2012,82031,78867,3164,3.9
48,331,Milam,2012,10255,9380,875,8.5
48,333,Mills,2012,2096,1983,113,5.4
48,335,Mitchell,2012,2870,2700,170,5.9
48,337,Montague,2012,9828,9300,528,5.4
48,339,Montgomery,2012,238639,224554,14085,5.9
48,341,Moore,2012,11563,11066,497,4.3
48,343,Morris,2012,5821,5257,564,9.7
48,345,Motley,2012,521,490,31,6.0
48,347,Nacogdoches,2012,29501,27554,1947,6.6
48,349,Navarro,2012,23191,21517,1674,7.2
48,351,Newton,2012,5789,5153,636,11.0
48,353,Nolan,2012,7077,6659,418,5.9
48,355,Nueces,2012,166630,155750,10880,6.5
48,357,Ochiltree,2012,5308,5105,203,3.8
48,359,Oldham,2012,949,909,40,4.2
48,361,Orange,2012,38780,34749,4031,10.4
48,363,Palo Pinto,2012,13385,12489,896,6.7
48,365,Panola,2012,12292,11454,838,6.8
48,367,Parker,2012,57783,54376,3407,5.9
48,369,Parmer,2012,4994,4790,204,4.1
48,371,Pecos,2012,6978,6622,356,5.1
48,373,Polk,2012,17500,16103,1397,8.0
48,375,Potter,2012,58200,55107,3093,5.3
48,377,Presidio,2012,3816,3312,504,13.2
48,379,Rains,2012,5218,4856,362,6.9
48,381,Randall,2012,67968,64982,2986,4.4
48,383,Reagan,2012,2073,2003,70,3.4
48,385,Real,2012,1064,965,99,9.3
48,387,Red River,2012,5248,4690,558,10.6
48,389,Reeves,2012,5330,4974,356,6.7
48,391,Refugio,2012,3501,3291,210,6.0
48,393,Roberts,2012,470,447,23,4.9
48,395,Robertson,2012,7272,6691,581,8.0
48,397,Rockwall,2012,41096,38572,2524,6.1
48,399,Runnels,2012,5048,4771,277,5.5
48,401,Rusk,2012,24532,23000,1532,6.2
48,403,Sabine,2012,3378,2890,488,14.4
48,405,San Augustine,2012,3017,2654,363,12.0
48,407,San Jacinto,2012,11444,10508,936,8.2
48,409,San Patricio,2012,30362,28073,2289,7.5
48,411,San Saba,2012,2290,2148,142,6.2
48,413,Schleicher,2012,1777,1706,71,4.0
48,415,Scurry,2012,8100,7740,360,4.4
48,417,Shackelford,2012,2208,2131,77,3.5
48,419,Shelby,2012,12097,11224,873,7.2
48,421,Sherman,2012,1500,1438,62,4.1
48,423,Smith,2012,101520,94425,7095,7.0
48,425,Somervell,2012,4134,3862,272,6.6
48,427,Starr,2012,25957,22207,3750,14.4
48,429,Stephens,2012,4373,4116,257,5.9
48,431,Sterling,2012,718,693,25,3.5
48,433,Stonewall,2012,746,714,32,4.3
48,435,Sutton,2012,2010,1913,97,4.8
48,437,Swisher,2012,3043,2863,180,5.9
48,439,Tarrant,2012,963879,901503,62376,6.5
48,441,Taylor,2012,64331,60712,3619,5.6
48,443,Terrell,2012,547,522,25,4.6
48,445,Terry,2012,5651,5284,367,6.5
48,447,Throckmorton,2012,829,785,44,5.3
48,449,Titus,2012,13236,12248,988,7.5
48,451,Tom Green,2012,53663,50819,2844,5.3
48,453,Travis,2012,610842,577445,33397,5.5
48,455,Trinity,2012,5562,5108,454,8.2
48,457,Tyler,2012,7560,6757,803,10.6
48,459,Upshur,2012,18681,17430,1251,6.7
48,461,Upton,2012,1588,1524,64,4.0
48,463,Uvalde,2012,11924,10982,942,7.9
48,465,Val Verde,2012,19965,18452,1513,7.6
48,467,Van Zandt,2012,23562,21938,1624,6.9
48,469,Victoria,2012,45145,42637,2508,5.6
48,471,Walker,2012,23098,21501,1597,6.9
48,473,Waller,2012,20450,19026,1424,7.0
48,475,Ward,2012,5343,5087,256,4.8
48,477,Washington,2012,15608,14736,872,5.6
48,479,Webb,2012,108879,101867,7012,6.4
48,481,Wharton,2012,21384,19946,1438,6.7
48,483,Wheeler,2012,2888,2763,125,4.3
48,485,Wichita,2012,58331,54805,3526,6.0
48,487,Wilbarger,2012,5910,5556,354,6.0
48,489,Willacy,2012,7404,6241,1163,15.7
48,491,Williamson,2012,236866,223136,13730,5.8
48,493,Wilson,2012,21681,20487,1194,5.5
48,495,Winkler,2012,3179,3000,179,5.6
48,497,Wise,2012,28186,26379,1807,6.4
48,499,Wood,2012,16693,15389,1304,7.8
48,501,Yoakum,2012,4326,4153,173,4.0
48,503,Young,2012,8550,8065,485,5.7
48,505,Zapata,2012,6802,6374,428,6.3
48,507,Zavala,2012,4378,3790,588,13.4
49,1,Beaver,2012,2847,2694,153,5.4
49,3,Box Elder,2012,22526,21382,1144,5.1
49,5,Cache,2012,56022,53809,2213,4.0
49,7,Carbon,2012,9079,8512,567,6.2
49,9,Daggett,2012,428,409,19,4.4
49,11,Davis,2012,146077,139776,6301,4.3
49,13,Duchesne,2012,8994,8622,372,4.1
49,15,Emery,2012,4651,4356,295,6.3
49,17,Garfield,2012,2792,2557,235,8.4
49,19,Grand,2012,5293,4898,395,7.5
49,21,Iron,2012,19089,17936,1153,6.0
49,23,Juab,2012,4537,4293,244,5.4
49,25,Kane,2012,3395,3196,199,5.9
49,27,Millard,2012,5837,5596,241,4.1
49,29,Morgan,2012,4258,4074,184,4.3
49,31,Piute,2012,482,446,36,7.5
49,33,Rich,2012,929,885,44,4.7
49,35,Salt Lake,2012,546710,521300,25410,4.6
49,37,San Juan,2012,5570,5134,436,7.8
49,39,Sanpete,2012,11038,10413,625,5.7
49,41,Sevier,2012,9243,8744,499,5.4
49,43,Summit,2012,21156,20233,923,4.4
49,45,Tooele,2012,27233,25793,1440,5.3
49,47,Uintah,2012,15715,15099,616,3.9
49,49,Utah,2012,234640,224333,10307,4.4
49,51,Wasatch,2012,11438,10858,580,5.1
49,53,Washington,2012,56098,52679,3419,6.1
49,55,Wayne,2012,1321,1195,126,9.5
49,57,Weber,2012,111161,104929,6232,5.6
50,1,Addison,2012,20815,19903,912,4.4
50,3,Bennington,2012,19608,18484,1124,5.7
50,5,Caledonia,2012,16087,15113,974,6.1
50,7,Chittenden,2012,95623,92113,3510,3.7
50,9,Essex,2012,2923,2694,229,7.8
50,11,Franklin,2012,27787,26578,1209,4.4
50,13,Grand Isle,2012,4121,3904,217,5.3
50,15,Lamoille,2012,13997,13132,865,6.2
50,17,Orange,2012,16409,15658,751,4.6
50,19,Orleans,2012,14071,13013,1058,7.5
50,21,Rutland,2012,32706,30720,1986,6.1
50,23,Washington,2012,34544,32961,1583,4.6
50,25,Windham,2012,24604,23366,1238,5.0
50,27,Windsor,2012,30650,29261,1389,4.5
51,1,Accomack,2012,16388,15123,1265,7.7
51,3,Albemarle,2012,52571,49877,2694,5.1
51,5,Alleghany,2012,7788,7248,540,6.9
51,7,Amelia,2012,6208,5811,397,6.4
51,9,Amherst,2012,16043,14990,1053,6.6
51,11,Appomattox,2012,7211,6684,527,7.3
51,13,Arlington,2012,143875,138982,4893,3.4
51,15,Augusta,2012,36990,34890,2100,5.7
51,17,Bath,2012,2582,2435,147,5.7
51,19,Bedford,2012,38267,36030,2237,5.8
51,21,Bland,2012,2871,2673,198,6.9
51,23,Botetourt,2012,17702,16752,950,5.4
51,25,Brunswick,2012,6717,6051,666,9.9
51,27,Buchanan,2012,8569,7805,764,8.9
51,29,Buckingham,2012,6460,5920,540,8.4
51,31,Campbell,2012,27044,25331,1713,6.3
51,33,Caroline,2012,14477,13370,1107,7.6
51,35,Carroll,2012,13467,12341,1126,8.4
51,36,Charles City,2012,3847,3551,296,7.7
51,37,Charlotte,2012,5354,4897,457,8.5
51,41,Chesterfield,2012,172730,162399,10331,6.0
51,43,Clarke,2012,7728,7331,397,5.1
51,45,Craig,2012,2461,2292,169,6.9
51,47,Culpeper,2012,23329,22029,1300,5.6
51,49,Cumberland,2012,4520,4204,316,7.0
51,51,Dickenson,2012,5204,4660,544,10.5
51,53,Dinwiddie,2012,13612,12600,1012,7.4
51,57,Essex,2012,5733,5320,413,7.2
51,59,Fairfax,2012,623114,595562,27552,4.4
51,61,Fauquier,2012,35975,34162,1813,5.0
51,63,Floyd,2012,8366,7901,465,5.6
51,65,Fluvanna,2012,13160,12483,677,5.1
51,67,Franklin,2012,27384,25618,1766,6.4
51,69,Frederick,2012,43416,40959,2457,5.7
51,71,Giles,2012,8227,7641,586,7.1
51,73,Gloucester,2012,19348,18278,1070,5.5
51,75,Goochland,2012,10267,9705,562,5.5
51,77,Grayson,2012,6984,6329,655,9.4
51,79,Greene,2012,9786,9254,532,5.4
51,81,Greensville,2012,4459,4082,377,8.5
51,83,Halifax,2012,16016,14525,1491,9.3
51,85,Hanover,2012,55076,52100,2976,5.4
51,87,Henrico,2012,172338,162124,10214,5.9
51,89,Henry,2012,22698,20347,2351,10.4
51,91,Highland,2012,1460,1390,70,4.8
51,93,Isle of Wight,2012,18738,17575,1163,6.2
51,95,James City,2012,32942,31095,1847,5.6
51,97,King and Queen,2012,3668,3430,238,6.5
51,99,King George,2012,11715,10971,744,6.4
51,101,King William,2012,8673,8135,538,6.2
51,103,Lancaster,2012,5512,5081,431,7.8
51,105,Lee,2012,9774,8983,791,8.1
51,107,Loudoun,2012,185858,177761,8097,4.4
51,109,Louisa,2012,17936,16842,1094,6.1
51,111,Lunenburg,2012,5375,4977,398,7.4
51,113,Madison,2012,7252,6911,341,4.7
51,115,Mathews,2012,4170,3937,233,5.6
51,117,Mecklenburg,2012,13508,12260,1248,9.2
51,119,Middlesex,2012,5128,4823,305,5.9
51,121,Montgomery,2012,49090,46231,2859,5.8
51,125,Nelson,2012,7453,7028,425,5.7
51,127,New Kent,2012,10600,10021,579,5.5
51,131,Northampton,2012,6184,5623,561,9.1
51,133,Northumberland,2012,5882,5411,471,8.0
51,135,Nottoway,2012,6869,6440,429,6.2
51,137,Orange,2012,15852,14814,1038,6.5
51,139,Page,2012,12172,10955,1217,10.0
51,141,Patrick,2012,7968,7255,713,8.9
51,143,Pittsylvania,2012,30684,28344,2340,7.6
51,145,Powhatan,2012,13540,12791,749,5.5
51,147,Prince Edward,2012,10263,9408,855,8.3
51,149,Prince George,2012,14638,13574,1064,7.3
51,153,Prince William,2012,228525,216702,11823,5.2
51,155,Pulaski,2012,16857,15628,1229,7.3
51,157,Rappahannock,2012,3958,3748,210,5.3
51,159,Richmond,2012,3920,3674,246,6.3
51,161,Roanoke,2012,49504,46965,2539,5.1
51,163,Rockbridge,2012,10752,10110,642,6.0
51,165,Rockingham,2012,40816,38549,2267,5.6
51,167,Russell,2012,11758,10760,998,8.5
51,169,Scott,2012,10069,9324,745,7.4
51,171,Shenandoah,2012,20800,19504,1296,6.2
51,173,Smyth,2012,13486,12218,1268,9.4
51,175,Southampton,2012,9479,8896,583,6.2
51,177,Spotsylvania,2012,64049,60219,3830,6.0
51,179,Stafford,2012,65422,61712,3710,5.7
51,181,Surry,2012,3682,3401,281,7.6
51,183,Sussex,2012,4270,3860,410,9.6
51,185,Tazewell,2012,17940,16485,1455,8.1
51,187,Warren,2012,20028,18712,1316,6.6
51,191,Washington,2012,27726,25896,1830,6.6
51,193,Westmoreland,2012,9136,8485,651,7.1
51,195,Wise,2012,15979,14580,1399,8.8
51,197,Wythe,2012,14096,13028,1068,7.6
51,199,York,2012,31672,29876,1796,5.7
51,510,Alexandria city,2012,93156,89424,3732,4.0
51,520,Bristol city,2012,7988,7417,571,7.1
51,530,Buena Vista city,2012,3255,3004,251,7.7
51,540,Charlottesville city,2012,23400,22225,1175,5.0
51,550,Chesapeake city,2012,115007,107776,7231,6.3
51,570,Colonial Heights city,2012,8602,8016,586,6.8
51,580,Covington city,2012,2639,2407,232,8.8
51,590,Danville city,2012,19924,17902,2022,10.1
51,595,Emporia city,2012,2464,2209,255,10.3
51,600,Fairfax city,2012,12918,12373,545,4.2
51,610,Falls Church city,2012,7719,7417,302,3.9
51,620,Franklin city,2012,3721,3356,365,9.8
51,630,Fredericksburg city,2012,13577,12638,939,6.9
51,640,Galax city,2012,3051,2786,265,8.7
51,650,Hampton city,2012,65857,60530,5327,8.1
51,660,Harrisonburg city,2012,24084,22345,1739,7.2
51,670,Hopewell city,2012,9719,8760,959,9.9
51,678,Lexington city,2012,2279,2083,196,8.6
51,680,Lynchburg city,2012,35536,32933,2603,7.3
51,683,Manassas city,2012,21898,20695,1203,5.5
51,685,Manassas Park city,2012,8743,8290,453,5.2
51,690,Martinsville city,2012,5729,5009,720,12.6
51,700,Newport News city,2012,89872,83269,6603,7.3
51,710,Norfolk city,2012,112642,104230,8412,7.5
51,720,Norton city,2012,1990,1841,149,7.5
51,730,Petersburg city,2012,13585,11992,1593,11.7
51,735,Poquoson city,2012,6353,6016,337,5.3
51,740,Portsmouth city,2012,45630,41689,3941,8.6
51,750,Radford city,2012,8092,7463,629,7.8
51,760,Richmond city,2012,109135,101114,8021,7.3
51,770,Roanoke city,2012,49563,46064,3499,7.1
51,775,Salem city,2012,12896,12145,751,5.8
51,790,Staunton city,2012,11807,11064,743,6.3
51,800,Suffolk city,2012,41732,38861,2871,6.9
51,810,Virginia Beach city,2012,228708,215847,12861,5.6
51,820,Waynesboro city,2012,10024,9333,691,6.9
51,830,Williamsburg city,2012,6832,6273,559,8.2
51,840,Winchester city,2012,14223,13292,931,6.5
53,1,Adams,2012,8195,7512,683,8.3
53,3,Asotin,2012,9733,9038,695,7.1
53,5,Benton,2012,91611,83800,7811,8.5
53,7,Chelan,2012,41248,38238,3010,7.3
53,9,Clallam,2012,27997,25310,2687,9.6
53,11,Clark,2012,208427,190460,17967,8.6
53,13,Columbia,2012,1813,1676,137,7.6
53,15,Cowlitz,2012,44297,39950,4347,9.8
53,17,Douglas,2012,19181,17583,1598,8.3
53,19,Ferry,2012,2418,2069,349,14.4
53,21,Franklin,2012,38976,35508,3468,8.9
53,23,Garfield,2012,1017,946,71,7.0
53,25,Grant,2012,43708,39903,3805,8.7
53,27,Grays Harbor,2012,28650,25229,3421,11.9
53,29,Island,2012,32416,29998,2418,7.5
53,31,Jefferson,2012,11867,10783,1084,9.1
53,33,King,2012,1127689,1056990,70699,6.3
53,35,Kitsap,2012,115743,107371,8372,7.2
53,37,Kittitas,2012,20499,18848,1651,8.1
53,39,Klickitat,2012,9884,8957,927,9.4
53,41,Lewis,2012,32009,28485,3524,11.0
53,43,Lincoln,2012,5229,4882,347,6.6
53,45,Mason,2012,23413,21067,2346,10.0
53,47,Okanogan,2012,21045,19218,1827,8.7
53,49,Pacific,2012,8136,7235,901,11.1
53,51,Pend Oreille,2012,4776,4216,560,11.7
53,53,Pierce,2012,385098,352308,32790,8.5
53,55,San Juan,2012,8089,7614,475,5.9
53,57,Skagit,2012,56829,51805,5024,8.8
53,59,Skamania,2012,5005,4520,485,9.7
53,61,Snohomish,2012,387127,358508,28619,7.4
53,63,Spokane,2012,229378,210343,19035,8.3
53,65,Stevens,2012,18099,16143,1956,10.8
53,67,Thurston,2012,122762,113263,9499,7.7
53,69,Wahkiakum,2012,1366,1206,160,11.7
53,71,Walla Walla,2012,29483,27472,2011,6.8
53,73,Whatcom,2012,102772,95113,7659,7.5
53,75,Whitman,2012,22372,21024,1348,6.0
53,77,Yakima,2012,120381,108705,11676,9.7
54,1,Barbour,2012,6727,6186,541,8.0
54,3,Berkeley,2012,52283,48918,3365,6.4
54,5,Boone,2012,8914,8018,896,10.1
54,7,Braxton,2012,5404,4840,564,10.4
54,9,Brooke,2012,10646,9747,899,8.4
54,11,Cabell,2012,43059,40347,2712,6.3
54,13,Calhoun,2012,2839,2535,304,10.7
54,15,Clay,2012,3525,3114,411,11.7
54,17,Doddridge,2012,3406,3199,207,6.1
54,19,Fayette,2012,17570,16101,1469,8.4
54,21,Gilmer,2012,2771,2563,208,7.5
54,23,Grant,2012,6169,5644,525,8.5
54,25,Greenbrier,2012,15488,14295,1193,7.7
54,27,Hampshire,2012,9734,8989,745,7.7
54,29,Hancock,2012,13743,12512,1231,9.0
54,31,Hardy,2012,5565,4994,571,10.3
54,33,Harrison,2012,31424,29445,1979,6.3
54,35,Jackson,2012,12011,11020,991,8.3
54,37,Jefferson,2012,27531,26095,1436,5.2
54,39,Kanawha,2012,91383,85560,5823,6.4
54,41,Lewis,2012,7384,6882,502,6.8
54,43,Lincoln,2012,7699,6931,768,10.0
54,45,Logan,2012,12896,11680,1216,9.4
54,47,McDowell,2012,6589,5819,770,11.7
54,49,Marion,2012,26848,25177,1671,6.2
54,51,Marshall,2012,14324,13209,1115,7.8
54,53,Mason,2012,10894,9855,1039,9.5
54,55,Mercer,2012,23427,21534,1893,8.1
54,57,Mineral,2012,12093,11104,989,8.2
54,59,Mingo,2012,8983,8139,844,9.4
54,61,Monongalia,2012,49746,47253,2493,5.0
54,63,Monroe,2012,5735,5334,401,7.0
54,65,Morgan,2012,7589,7053,536,7.1
54,67,Nicholas,2012,10826,9856,970,9.0
54,69,Ohio,2012,21367,20053,1314,6.1
54,71,Pendleton,2012,3638,3399,239,6.6
54,73,Pleasants,2012,2878,2635,243,8.4
54,75,Pocahontas,2012,3619,3264,355,9.8
54,77,Preston,2012,14784,13776,1008,6.8
54,79,Putnam,2012,26387,24751,1636,6.2
54,81,Raleigh,2012,32851,30546,2305,7.0
54,83,Randolph,2012,12073,11056,1017,8.4
54,85,Ritchie,2012,4383,4071,312,7.1
54,87,Roane,2012,5319,4734,585,11.0
54,89,Summers,2012,4634,4238,396,8.5
54,91,Taylor,2012,7566,7066,500,6.6
54,93,Tucker,2012,3192,2943,249,7.8
54,95,Tyler,2012,3657,3334,323,8.8
54,97,Upshur,2012,9987,9233,754,7.5
54,99,Wayne,2012,16390,15187,1203,7.3
54,101,Webster,2012,3598,3227,371,10.3
54,103,Wetzel,2012,7259,6602,657,9.1
54,105,Wirt,2012,2294,2051,243,10.6
54,107,Wood,2012,38551,35845,2706,7.0
54,109,Wyoming,2012,8377,7633,744,8.9
55,1,Adams,2012,8967,8002,965,10.8
55,3,Ashland,2012,8221,7473,748,9.1
55,5,Barron,2012,23679,21838,1841,7.8
55,7,Bayfield,2012,7781,6955,826,10.6
55,9,Brown,2012,137514,128632,8882,6.5
55,11,Buffalo,2012,6631,6222,409,6.2
55,13,Burnett,2012,7528,6859,669,8.9
55,15,Calumet,2012,27271,25837,1434,5.3
55,17,Chippewa,2012,33225,31011,2214,6.7
55,19,Clark,2012,17077,15829,1248,7.3
55,21,Columbia,2012,31289,29056,2233,7.1
55,23,Crawford,2012,8288,7598,690,8.3
55,25,Dane,2012,297195,282929,14266,4.8
55,27,Dodge,2012,47681,44325,3356,7.0
55,29,Door,2012,15735,14145,1590,10.1
55,31,Douglas,2012,23405,21825,1580,6.8
55,33,Dunn,2012,23405,21890,1515,6.5
55,35,Eau Claire,2012,58200,54878,3322,5.7
55,37,Florence,2012,2208,2027,181,8.2
55,39,Fond du Lac,2012,56061,52476,3585,6.4
55,41,Forest,2012,4135,3687,448,10.8
55,43,Grant,2012,27669,26042,1627,5.9
55,45,Green,2012,20806,19530,1276,6.1
55,47,Green Lake,2012,10300,9539,761,7.4
55,49,Iowa,2012,13534,12646,888,6.6
55,51,Iron,2012,2778,2492,286,10.3
55,53,Jackson,2012,10302,9562,740,7.2
55,55,Jefferson,2012,46162,43132,3030,6.6
55,57,Juneau,2012,13564,12444,1120,8.3
55,59,Kenosha,2012,86713,79739,6974,8.0
55,61,Kewaunee,2012,11005,10296,709,6.4
55,63,La Crosse,2012,66357,62801,3556,5.4
55,65,Lafayette,2012,9390,8872,518,5.5
55,67,Langlade,2012,9957,9046,911,9.1
55,69,Lincoln,2012,15087,13730,1357,9.0
55,71,Manitowoc,2012,43634,40297,3337,7.6
55,73,Marathon,2012,71558,66398,5160,7.2
55,75,Marinette,2012,21419,19658,1761,8.2
55,77,Marquette,2012,7564,6910,654,8.6
55,78,Menominee,2012,1585,1330,255,16.1
55,79,Milwaukee,2012,475758,435411,40347,8.5
55,81,Monroe,2012,22759,21126,1633,7.2
55,83,Oconto,2012,20629,18927,1702,8.3
55,85,Oneida,2012,19109,17473,1636,8.6
55,87,Outagamie,2012,100212,93883,6329,6.3
55,89,Ozaukee,2012,47334,44774,2560,5.4
55,91,Pepin,2012,4073,3844,229,5.6
55,93,Pierce,2012,23874,22576,1298,5.4
55,95,Polk,2012,23969,22070,1899,7.9
55,97,Portage,2012,38872,36071,2801,7.2
55,99,Price,2012,7040,6519,521,7.4
55,101,Racine,2012,100290,92031,8259,8.2
55,103,Richland,2012,9699,9102,597,6.2
55,105,Rock,2012,81306,74650,6656,8.2
55,107,Rusk,2012,6772,6169,603,8.9
55,109,St. Croix,2012,47437,44756,2681,5.7
55,111,Sauk,2012,35592,33177,2415,6.8
55,113,Sawyer,2012,8261,7386,875,10.6
55,115,Shawano,2012,21593,19894,1699,7.9
55,117,Sheboygan,2012,60238,56175,4063,6.7
55,119,Taylor,2012,11065,10283,782,7.1
55,121,Trempealeau,2012,16350,15432,918,5.6
55,123,Vernon,2012,15026,14083,943,6.3
55,125,Vilas,2012,10080,9087,993,9.9
55,127,Walworth,2012,55965,51974,3991,7.1
55,129,Washburn,2012,8077,7449,628,7.8
55,131,Washington,2012,74981,70463,4518,6.0
55,133,Waukesha,2012,217385,205067,12318,5.7
55,135,Waupaca,2012,27351,25310,2041,7.5
55,137,Waushara,2012,12000,10968,1032,8.6
55,139,Winnebago,2012,92400,86346,6054,6.6
55,141,Wood,2012,39666,36722,2944,7.4
56,1,Albany,2012,20493,19586,907,4.4
56,3,Big Horn,2012,5573,5250,323,5.8
56,5,Campbell,2012,25814,24580,1234,4.8
56,7,Carbon,2012,8120,7687,433,5.3
56,9,Converse,2012,7883,7534,349,4.4
56,11,Crook,2012,3769,3580,189,5.0
56,13,Fremont,2012,21034,19726,1308,6.2
56,15,Goshen,2012,7424,7066,358,4.8
56,17,Hot Springs,2012,2548,2424,124,4.9
56,19,Johnson,2012,4420,4178,242,5.5
56,21,Laramie,2012,47168,44376,2792,5.9
56,23,Lincoln,2012,8186,7583,603,7.4
56,25,Natrona,2012,41901,39714,2187,5.2
56,27,Niobrara,2012,1365,1311,54,4.0
56,29,Park,2012,16075,15157,918,5.7
56,31,Platte,2012,4732,4493,239,5.1
56,33,Sheridan,2012,15726,14720,1006,6.4
56,35,Sublette,2012,5507,5230,277,5.0
56,37,Sweetwater,2012,23856,22684,1172,4.9
56,39,Teton,2012,13650,12710,940,6.9
56,41,Uinta,2012,10146,9562,584,5.8
56,43,Washakie,2012,4435,4198,237,5.3
56,45,Weston,2012,3925,3761,164,4.2
72,1,Adjuntas Municipio,2012,4977,3898,1079,21.7
72,3,Aguada Municipio,2012,12717,10387,2330,18.3
72,5,Aguadilla Municipio,2012,16155,13142,3013,18.7
72,7,Aguas Buenas Municipio,2012,7364,5995,1369,18.6
72,9,Aibonito Municipio,2012,7232,5856,1376,19.0
72,11,Anasco Municipio,2012,9355,7765,1590,17.0
72,13,Arecibo Municipio,2012,25540,21489,4051,15.9
72,15,Arroyo Municipio,2012,5724,4428,1296,22.6
72,17,Barceloneta Municipio,2012,6194,4995,1199,19.4
72,19,Barranquitas Municipio,2012,7863,6589,1274,16.2
72,21,Bayamon Municipio,2012,72109,64165,7944,11.0
72,23,Cabo Rojo Municipio,2012,14583,12333,2250,15.4
72,25,Caguas Municipio,2012,52231,45171,7060,13.5
72,27,Camuy Municipio,2012,9980,8551,1429,14.3
72,29,Canovanas Municipio,2012,16727,14402,2325,13.9
72,31,Carolina Municipio,2012,66783,59747,7036,10.5
72,33,Catano Municipio,2012,8713,7539,1174,13.5
72,35,Cayey Municipio,2012,17454,14860,2594,14.9
72,37,Ceiba Municipio,2012,4356,3527,829,19.0
72,39,Ciales Municipio,2012,4285,3356,929,21.7
72,41,Cidra Municipio,2012,16862,14413,2449,14.5
72,43,Coamo Municipio,2012,11817,9339,2478,21.0
72,45,Comerio Municipio,2012,5568,4434,1134,20.4
72,47,Corozal Municipio,2012,9832,8260,1572,16.0
72,49,Culebra Municipio,2012,840,792,48,5.7
72,51,Dorado Municipio,2012,12968,11790,1178,9.1
72,53,Fajardo Municipio,2012,12720,10430,2290,18.0
72,54,Florida Municipio,2012,3666,2962,704,19.2
72,55,Guanica Municipio,2012,4759,3577,1182,24.8
72,57,Guayama Municipio,2012,13372,10581,2791,20.9
72,59,Guayanilla Municipio,2012,5766,4532,1234,21.4
72,61,Guaynabo Municipio,2012,38884,36304,2580,6.6
72,63,Gurabo Municipio,2012,17314,15360,1954,11.3
72,65,Hatillo Municipio,2012,13435,11252,2183,16.2
72,67,Hormigueros Municipio,2012,5916,5036,880,14.9
72,69,Humacao Municipio,2012,19212,15422,3790,19.7
72,71,Isabela Municipio,2012,12597,10302,2295,18.2
72,73,Jayuya Municipio,2012,4569,3799,770,16.9
72,75,Juana Diaz Municipio,2012,16439,13747,2692,16.4
72,77,Juncos Municipio,2012,12888,10785,2103,16.3
72,79,Lajas Municipio,2012,6134,4715,1419,23.1
72,81,Lares Municipio,2012,7729,6217,1512,19.6
72,83,Las Marias Municipio,2012,3709,3108,601,16.2
72,85,Las Piedras Municipio,2012,12064,9790,2274,18.8
72,87,Loiza Municipio,2012,9377,8171,1206,12.9
72,89,Luquillo Municipio,2012,6981,5609,1372,19.7
72,91,Manati Municipio,2012,12481,10606,1875,15.0
72,93,Maricao Municipio,2012,2165,1765,400,18.5
72,95,Maunabo Municipio,2012,3339,2574,765,22.9
72,97,Mayaguez Municipio,2012,25685,21396,4289,16.7
72,99,Moca Municipio,2012,11403,9200,2203,19.3
72,101,Morovis Municipio,2012,8677,7088,1589,18.3
72,103,Naguabo Municipio,2012,8566,7105,1461,17.1
72,105,Naranjito Municipio,2012,7774,6460,1314,16.9
72,107,Orocovis Municipio,2012,5726,4588,1138,19.9
72,109,Patillas Municipio,2012,5462,4090,1372,25.1
72,111,Penuelas Municipio,2012,6844,5444,1400,20.5
72,113,Ponce Municipio,2012,52180,43880,8300,15.9
72,115,Quebradillas Municipio,2012,6372,5194,1178,18.5
72,117,Rincon Municipio,2012,4811,3912,899,18.7
72,119,Rio Grande Municipio,2012,17927,15704,2223,12.4
72,121,Sabana Grande Municipio,2012,7032,5563,1469,20.9
72,123,Salinas Municipio,2012,8979,6741,2238,24.9
72,125,San German Municipio,2012,11171,9128,2043,18.3
72,127,San Juan Municipio,2012,145015,132233,12782,8.8
72,129,San Lorenzo Municipio,2012,12713,10710,2003,15.8
72,131,San Sebastian Municipio,2012,11318,8813,2505,22.1
72,133,Santa Isabel Municipio,2012,9892,7914,1978,20.0
72,135,Toa Alta Municipio,2012,26631,23951,2680,10.1
72,137,Toa Baja Municipio,2012,31909,28534,3375,10.6
72,139,Trujillo Alto Municipio,2012,28626,26231,2395,8.4
72,141,Utuado Municipio,2012,7551,6088,1463,19.4
72,143,Vega Alta Municipio,2012,10301,8845,1456,14.1
72,145,Vega Baja Municipio,2012,14796,12435,2361,16.0
72,147,Vieques Municipio,2012,3043,2651,392,12.9
72,149,Villalba Municipio,2012,8309,6584,1725,20.8
72,151,Yabucoa Municipio,2012,10302,7903,2399,23.3
72,153,Yauco Municipio,2012,11532,9140,2392,20.7
1,1,Autauga,2013,25783,24155,1628,6.3
1,3,Baldwin,2013,85206,79466,5740,6.7
1,5,Barbour,2013,9096,8152,944,10.4
1,7,Bibb,2013,8699,8000,699,8.0
1,9,Blount,2013,24860,23277,1583,6.4
1,11,Bullock,2013,4774,4322,452,9.5
1,13,Butler,2013,9144,8189,955,10.4
1,15,Calhoun,2013,48381,44068,4313,8.9
1,17,Chambers,2013,15263,14028,1235,8.1
1,19,Cherokee,2013,11392,10627,765,6.7
1,21,Chilton,2013,19339,18052,1287,6.7
1,23,Choctaw,2013,4701,4261,440,9.4
1,25,Clarke,2013,8286,7130,1156,14.0
1,27,Clay,2013,5390,4933,457,8.5
1,29,Cleburne,2013,5825,5372,453,7.8
1,31,Coffee,2013,20495,19065,1430,7.0
1,33,Colbert,2013,23879,21891,1988,8.3
1,35,Conecuh,2013,4694,4183,511,10.9
1,37,Coosa,2013,4449,4036,413,9.3
1,39,Covington,2013,16055,14737,1318,8.2
1,41,Crenshaw,2013,6306,5817,489,7.8
1,43,Cullman,2013,35750,33333,2417,6.8
1,45,Dale,2013,20732,19180,1552,7.5
1,47,Dallas,2013,16290,14270,2020,12.4
1,49,DeKalb,2013,29011,26768,2243,7.7
1,51,Elmore,2013,36888,34585,2303,6.2
1,53,Escambia,2013,14281,13037,1244,8.7
1,55,Etowah,2013,43830,40453,3377,7.7
1,57,Fayette,2013,6401,5862,539,8.4
1,59,Franklin,2013,13668,12552,1116,8.2
1,61,Geneva,2013,11035,10255,780,7.1
1,63,Greene,2013,2996,2608,388,13.0
1,65,Hale,2013,6206,5475,731,11.8
1,67,Henry,2013,6950,6407,543,7.8
1,69,Houston,2013,45669,42463,3206,7.0
1,71,Jackson,2013,23669,21776,1893,8.0
1,73,Jefferson,2013,315102,293809,21293,6.8
1,75,Lamar,2013,5795,5383,412,7.1
1,77,Lauderdale,2013,43109,39999,3110,7.2
1,79,Lawrence,2013,14273,13066,1207,8.5
1,81,Lee,2013,70447,66242,4205,6.0
1,83,Limestone,2013,39391,36891,2500,6.3
1,85,Lowndes,2013,4010,3436,574,14.3
1,87,Macon,2013,8410,7587,823,9.8
1,89,Madison,2013,171178,160213,10965,6.4
1,91,Marengo,2013,7628,6940,688,9.0
1,93,Marion,2013,12477,11475,1002,8.0
1,95,Marshall,2013,40573,37762,2811,6.9
1,97,Mobile,2013,186932,170729,16203,8.7
1,99,Monroe,2013,7764,6829,935,12.0
1,101,Montgomery,2013,106274,98405,7869,7.4
1,103,Morgan,2013,56951,52979,3972,7.0
1,105,Perry,2013,3566,3077,489,13.7
1,107,Pickens,2013,7415,6713,702,9.5
1,109,Pike,2013,14911,13755,1156,7.8
1,111,Randolph,2013,9205,8480,725,7.9
1,113,Russell,2013,24999,23160,1839,7.4
1,115,St. Clair,2013,38792,36379,2413,6.2
1,117,Shelby,2013,106861,101840,5021,4.7
1,119,Sumter,2013,5459,4959,500,9.2
1,121,Talladega,2013,35747,32632,3115,8.7
1,123,Tallapoosa,2013,18384,16874,1510,8.2
1,125,Tuscaloosa,2013,95579,89414,6165,6.5
1,127,Walker,2013,26347,24086,2261,8.6
1,129,Washington,2013,6711,5972,739,11.0
1,131,Wilcox,2013,2782,2239,543,19.5
1,133,Winston,2013,9638,8719,919,9.5
2,13,Aleutians East Borough,2013,2207,2073,134,6.1
2,16,Aleutians West Census Area,2013,4252,3957,295,6.9
2,20,Anchorage Borough/municipality,2013,157637,149423,8214,5.2
2,50,Bethel Census Area,2013,7390,6193,1197,16.2
2,60,Bristol Bay Borough,2013,489,445,44,9.0
2,68,Denali Borough,2013,1072,937,135,12.6
2,70,Dillingham Census Area,2013,2123,1906,217,10.2
2,90,Fairbanks North Star Borough,2013,47057,44292,2765,5.9
2,100,Haines Borough,2013,1136,1021,115,10.1
2,105,Hoonah-Angoon Census Area,2013,1119,954,165,14.7
2,110,Juneau Borough/city,2013,17504,16619,885,5.1
2,122,Kenai Peninsula Borough,2013,27699,25463,2236,8.1
2,130,Ketchikan Gateway Borough,2013,7132,6572,560,7.9
2,150,Kodiak Island Borough,2013,6563,6153,410,6.2
2,158,Kusilvak Census Area,2013,2771,2114,657,23.7
2,164,Lake and Peninsula Borough,2013,635,536,99,15.6
2,170,Matanuska-Susitna Borough,2013,43718,40053,3665,8.4
2,180,Nome Census Area,2013,4123,3613,510,12.4
2,185,North Slope Borough,2013,4052,3753,299,7.4
2,188,Northwest Arctic Borough,2013,3054,2551,503,16.5
2,195,Petersburg Borough,2013,1650,1507,143,8.7
2,198,Prince of Wales-Hyder Census Area,2013,2799,2456,343,12.3
2,220,Sitka Borough/city,2013,4601,4348,253,5.5
2,230,Skagway Municipality,2013,790,692,98,12.4
2,240,Southeast Fairbanks Census Area,2013,2999,2604,395,13.2
2,261,Valdez-Cordova Census Area,2013,4910,4421,489,10.0
2,275,Wrangell Borough/city,2013,1054,969,85,8.1
2,282,Yakutat Borough/city,2013,284,257,27,9.5
2,290,Yukon-Koyukuk Census Area,2013,2723,2223,500,18.4
4,1,Apache,2013,22104,18009,4095,18.5
4,3,Cochise,2013,51900,47097,4803,9.3
4,5,Coconino,2013,71698,65825,5873,8.2
4,7,Gila,2013,21148,19098,2050,9.7
4,9,Graham,2013,14441,13317,1124,7.8
4,11,Greenlee,2013,4632,4358,274,5.9
4,12,La Paz,2013,8121,7453,668,8.2
4,13,Maricopa,2013,1929092,1801272,127820,6.6
4,15,Mohave,2013,77748,69643,8105,10.4
4,17,Navajo,2013,42434,36681,5753,13.6
4,19,Pima,2013,462267,430789,31478,6.8
4,21,Pinal,2013,150007,137820,12187,8.1
4,23,Santa Cruz,2013,20355,17210,3145,15.5
4,25,Yavapai,2013,92659,85427,7232,7.8
4,27,Yuma,2013,95948,71342,24606,25.6
5,1,Arkansas,2013,9647,8959,688,7.1
5,3,Ashley,2013,9154,8204,950,10.4
5,5,Baxter,2013,16158,14890,1268,7.8
5,7,Benton,2013,112548,106367,6181,5.5
5,9,Boone,2013,16140,15037,1103,6.8
5,11,Bradley,2013,4298,3900,398,9.3
5,13,Calhoun,2013,2453,2259,194,7.9
5,15,Carroll,2013,12360,11637,723,5.8
5,17,Chicot,2013,3863,3425,438,11.3
5,19,Clark,2013,10155,9280,875,8.6
5,21,Clay,2013,6562,5938,624,9.5
5,23,Cleburne,2013,10093,9253,840,8.3
5,25,Cleveland,2013,3620,3353,267,7.4
5,27,Columbia,2013,9755,8920,835,8.6
5,29,Conway,2013,8698,7917,781,9.0
5,31,Craighead,2013,49628,46453,3175,6.4
5,33,Crawford,2013,27208,25179,2029,7.5
5,35,Crittenden,2013,21653,19886,1767,8.2
5,37,Cross,2013,8254,7645,609,7.4
5,39,Dallas,2013,3054,2742,312,10.2
5,41,Desha,2013,5682,5147,535,9.4
5,43,Drew,2013,8340,7556,784,9.4
5,45,Faulkner,2013,59652,55878,3774,6.3
5,47,Franklin,2013,7466,6965,501,6.7
5,49,Fulton,2013,4946,4613,333,6.7
5,51,Garland,2013,41064,38029,3035,7.4
5,53,Grant,2013,8322,7791,531,6.4
5,55,Greene,2013,19525,18024,1501,7.7
5,57,Hempstead,2013,10184,9466,718,7.1
5,59,Hot Spring,2013,14238,13228,1010,7.1
5,61,Howard,2013,6295,5903,392,6.2
5,63,Independence,2013,15889,14492,1397,8.8
5,65,Izard,2013,5029,4606,423,8.4
5,67,Jackson,2013,6309,5638,671,10.6
5,69,Jefferson,2013,31183,28041,3142,10.1
5,71,Johnson,2013,10631,9839,792,7.4
5,73,Lafayette,2013,2790,2531,259,9.3
5,75,Lawrence,2013,7188,6567,621,8.6
5,77,Lee,2013,3330,3028,302,9.1
5,79,Lincoln,2013,4378,4023,355,8.1
5,81,Little River,2013,5741,5315,426,7.4
5,83,Logan,2013,9298,8593,705,7.6
5,85,Lonoke,2013,32996,31033,1963,5.9
5,87,Madison,2013,6900,6510,390,5.7
5,89,Marion,2013,6549,6059,490,7.5
5,91,Miller,2013,19673,18441,1232,6.3
5,93,Mississippi,2013,19088,16978,2110,11.1
5,95,Monroe,2013,3141,2873,268,8.5
5,97,Montgomery,2013,3459,3177,282,8.2
5,99,Nevada,2013,3812,3526,286,7.5
5,101,Newton,2013,3511,3274,237,6.8
5,103,Ouachita,2013,10380,9406,974,9.4
5,105,Perry,2013,4385,3986,399,9.1
5,107,Phillips,2013,7633,6785,848,11.1
5,109,Pike,2013,4260,3898,362,8.5
5,111,Poinsett,2013,10198,9360,838,8.2
5,113,Polk,2013,8545,7950,595,7.0
5,115,Pope,2013,29901,27768,2133,7.1
5,117,Prairie,2013,3827,3564,263,6.9
5,119,Pulaski,2013,187838,175881,11957,6.4
5,121,Randolph,2013,6727,6103,624,9.3
5,123,St. Francis,2013,9220,8284,936,10.2
5,125,Saline,2013,55120,52011,3109,5.6
5,127,Scott,2013,4656,4373,283,6.1
5,129,Searcy,2013,3143,2899,244,7.8
5,131,Sebastian,2013,58482,54232,4250,7.3
5,133,Sevier,2013,6018,5533,485,8.1
5,135,Sharp,2013,6050,5475,575,9.5
5,137,Stone,2013,4826,4430,396,8.2
5,139,Union,2013,16740,15338,1402,8.4
5,141,Van Buren,2013,6530,5910,620,9.5
5,143,Washington,2013,107521,101904,5617,5.2
5,145,White,2013,35304,32619,2685,7.6
5,147,Woodruff,2013,3254,2953,301,9.3
5,149,Yell,2013,9142,8559,583,6.4
6,1,Alameda,2013,799847,741222,58625,7.3
6,3,Alpine,2013,523,472,51,9.8
6,5,Amador,2013,14400,12897,1503,10.4
6,7,Butte,2013,101408,90829,10579,10.4
6,9,Calaveras,2013,20187,18157,2030,10.1
6,11,Colusa,2013,11268,9113,2155,19.1
6,13,Contra Costa,2013,536032,495293,40739,7.6
6,15,Del Norte,2013,10298,9064,1234,12.0
6,17,El Dorado,2013,88281,80677,7604,8.6
6,19,Fresno,2013,436620,378042,58578,13.4
6,21,Glenn,2013,12950,11364,1586,12.2
6,23,Humboldt,2013,62830,57671,5159,8.2
6,25,Imperial,2013,78165,58391,19774,25.3
6,27,Inyo,2013,9356,8613,743,7.9
6,29,Kern,2013,392205,345564,46641,11.9
6,31,Kings,2013,58029,50148,7881,13.6
6,33,Lake,2013,29163,25944,3219,11.0
6,35,Lassen,2013,10968,9791,1177,10.7
6,37,Los Angeles,2013,4955806,4471400,484406,9.8
6,39,Madera,2013,62073,54168,7905,12.7
6,41,Marin,2013,137807,130592,7215,5.2
6,43,Mariposa,2013,8201,7328,873,10.6
6,45,Mendocino,2013,40690,37246,3444,8.5
6,47,Merced,2013,114311,97543,16768,14.7
6,49,Modoc,2013,3492,3058,434,12.4
6,51,Mono,2013,8338,7619,719,8.6
6,53,Monterey,2013,215676,193153,22523,10.4
6,55,Napa,2013,72539,67444,5095,7.0
6,57,Nevada,2013,47994,44056,3938,8.2
6,59,Orange,2013,1559480,1455311,104169,6.7
6,61,Placer,2013,175189,161492,13697,7.8
6,63,Plumas,2013,8232,7080,1152,14.0
6,65,Riverside,2013,993023,893454,99569,10.0
6,67,Sacramento,2013,677831,616885,60946,9.0
6,69,San Benito,2013,28811,25574,3237,11.2
6,71,San Bernardino,2013,893610,805211,88399,9.9
6,73,San Diego,2013,1537644,1415625,122019,7.9
6,75,San Francisco/city,2013,514231,485801,28430,5.5
6,77,San Joaquin,2013,312140,273256,38884,12.5
6,79,San Luis Obispo,2013,137727,128206,9521,6.9
6,81,San Mateo,2013,416399,394209,22190,5.3
6,83,Santa Barbara,2013,216531,200720,15811,7.3
6,85,Santa Clara,2013,968154,904718,63436,6.6
6,87,Santa Cruz,2013,141591,126860,14731,10.4
6,89,Shasta,2013,75049,66069,8980,12.0
6,91,Sierra,2013,1448,1261,187,12.9
6,93,Siskiyou,2013,18239,15812,2427,13.3
6,95,Solano,2013,202338,183752,18586,9.2
6,97,Sonoma,2013,249019,231095,17924,7.2
6,99,Stanislaus,2013,240268,208783,31485,13.1
6,101,Sutter,2013,44669,38061,6608,14.8
6,103,Tehama,2013,25006,22065,2941,11.8
6,105,Trinity,2013,5175,4550,625,12.1
6,107,Tulare,2013,200490,171350,29140,14.5
6,109,Tuolumne,2013,21678,19314,2364,10.9
6,111,Ventura,2013,432345,397865,34480,8.0
6,113,Yolo,2013,101475,92218,9257,9.1
6,115,Yuba,2013,28166,24414,3752,13.3
8,1,Adams,2013,241599,222280,19319,8.0
8,3,Alamosa,2013,7555,6832,723,9.6
8,5,Arapahoe,2013,326164,304991,21173,6.5
8,7,Archuleta,2013,5696,5204,492,8.6
8,9,Baca,2013,1895,1818,77,4.1
8,11,Bent,2013,1645,1520,125,7.6
8,13,Boulder,2013,174766,165314,9452,5.4
8,14,Broomfield/city,2013,32769,30895,1874,5.7
8,15,Chaffee,2013,8298,7796,502,6.0
8,17,Cheyenne,2013,969,929,40,4.1
8,19,Clear Creek,2013,5440,5104,336,6.2
8,21,Conejos,2013,3606,3228,378,10.5
8,23,Costilla,2013,1594,1418,176,11.0
8,25,Crowley,2013,1321,1228,93,7.0
8,27,Custer,2013,1920,1799,121,6.3
8,29,Delta,2013,13842,12627,1215,8.8
8,31,Denver/city,2013,362629,338950,23679,6.5
8,33,Dolores,2013,1014,931,83,8.2
8,35,Douglas,2013,164423,155829,8594,5.2
8,37,Eagle,2013,31864,29970,1894,5.9
8,39,Elbert,2013,12691,11956,735,5.8
8,41,El Paso,2013,306626,282804,23822,7.8
8,43,Fremont,2013,14929,13359,1570,10.5
8,45,Garfield,2013,30923,28657,2266,7.3
8,47,Gilpin,2013,3313,3118,195,5.9
8,49,Grand,2013,8768,8264,504,5.7
8,51,Gunnison,2013,9633,9115,518,5.4
8,53,Hinsdale,2013,432,412,20,4.6
8,55,Huerfano,2013,2536,2194,342,13.5
8,57,Jackson,2013,792,755,37,4.7
8,59,Jefferson,2013,305164,286333,18831,6.2
8,61,Kiowa,2013,763,730,33,4.3
8,63,Kit Carson,2013,4082,3924,158,3.9
8,65,Lake,2013,4437,4123,314,7.1
8,67,La Plata,2013,29552,27894,1658,5.6
8,69,Larimer,2013,174130,164174,9956,5.7
8,71,Las Animas,2013,6727,5988,739,11.0
8,73,Lincoln,2013,2105,1984,121,5.7
8,75,Logan,2013,10797,10253,544,5.0
8,77,Mesa,2013,73481,67161,6320,8.6
8,79,Mineral,2013,425,400,25,5.9
8,81,Moffat,2013,7532,7019,513,6.8
8,83,Montezuma,2013,12705,11739,966,7.6
8,85,Montrose,2013,19279,17487,1792,9.3
8,87,Morgan,2013,14655,13713,942,6.4
8,89,Otero,2013,8199,7405,794,9.7
8,91,Ouray,2013,2126,1967,159,7.5
8,93,Park,2013,9249,8698,551,6.0
8,95,Phillips,2013,2124,2028,96,4.5
8,97,Pitkin,2013,10779,10092,687,6.4
8,99,Prowers,2013,5856,5493,363,6.2
8,101,Pueblo,2013,73270,66166,7104,9.7
8,103,Rio Blanco,2013,3071,2833,238,7.7
8,105,Rio Grande,2013,4873,4317,556,11.4
8,107,Routt,2013,14488,13642,846,5.8
8,109,Saguache,2013,2949,2622,327,11.1
8,111,San Juan,2013,477,436,41,8.6
8,113,San Miguel,2013,4776,4462,314,6.6
8,115,Sedgwick,2013,1090,1023,67,6.1
8,117,Summit,2013,19349,18394,955,4.9
8,119,Teller,2013,11706,10806,900,7.7
8,121,Washington,2013,2549,2434,115,4.5
8,123,Weld,2013,138995,130021,8974,6.5
8,125,Yuma,2013,4737,4515,222,4.7
9,1,Fairfield,2013,468669,433959,34710,7.4
9,3,Hartford,2013,467848,429836,38012,8.1
9,5,Litchfield,2013,104631,97043,7588,7.3
9,7,Middlesex,2013,91177,84956,6221,6.8
9,9,New Haven,2013,452110,412905,39205,8.7
9,11,New London,2013,137126,125764,11362,8.3
9,13,Tolland,2013,83554,77709,5845,7.0
9,15,Windham,2013,62262,56663,5599,9.0
10,1,Kent,2013,73955,68587,5368,7.3
10,3,New Castle,2013,277211,259476,17735,6.4
10,5,Sussex,2013,92384,86152,6232,6.7
11,1,District of Colu,2013,374199,342609,31590,8.4
12,1,Alachua,2013,129007,121314,7693,6.0
12,3,Baker,2013,11246,10377,869,7.7
12,5,Bay,2013,86210,79650,6560,7.6
12,7,Bradford,2013,10951,10232,719,6.6
12,9,Brevard,2013,258158,235821,22337,8.7
12,11,Broward,2013,971733,903073,68660,7.1
12,13,Calhoun,2013,4906,4503,403,8.2
12,15,Charlotte,2013,66055,60527,5528,8.4
12,17,Citrus,2013,49302,44323,4979,10.1
12,19,Clay,2013,96658,90255,6403,6.6
12,21,Collier,2013,155187,143731,11456,7.4
12,23,Columbia,2013,27805,25607,2198,7.9
12,27,DeSoto,2013,13106,11984,1122,8.6
12,29,Dixie,2013,5834,5316,518,8.9
12,31,Duval,2013,456507,420747,35760,7.8
12,33,Escambia,2013,138641,128161,10480,7.6
12,35,Flagler,2013,43931,40101,3830,8.7
12,37,Franklin,2013,4975,4688,287,5.8
12,39,Gadsden,2013,18835,17037,1798,9.5
12,41,Gilchrist,2013,6608,6066,542,8.2
12,43,Glades,2013,5455,5032,423,7.8
12,45,Gulf,2013,6145,5712,433,7.0
12,47,Hamilton,2013,4625,4211,414,9.0
12,49,Hardee,2013,11028,10080,948,8.6
12,51,Hendry,2013,16644,14574,2070,12.4
12,53,Hernando,2013,66220,60023,6197,9.4
12,55,Highlands,2013,36075,32494,3581,9.9
12,57,Hillsborough,2013,671504,625343,46161,6.9
12,59,Holmes,2013,6996,6422,574,8.2
12,61,Indian River,2013,61401,55238,6163,10.0
12,63,Jackson,2013,17735,16340,1395,7.9
12,65,Jefferson,2013,5456,5015,441,8.1
12,67,Lafayette,2013,3489,3300,189,5.4
12,69,Lake,2013,135123,124697,10426,7.7
12,71,Lee,2013,298348,275689,22659,7.6
12,73,Leon,2013,147808,138410,9398,6.4
12,75,Levy,2013,16299,14911,1388,8.5
12,77,Liberty,2013,2838,2638,200,7.0
12,79,Madison,2013,7893,7252,641,8.1
12,81,Manatee,2013,154900,144059,10841,7.0
12,83,Marion,2013,130783,119141,11642,8.9
12,85,Martin,2013,67316,62256,5060,7.5
12,86,Miami-Dade,2013,1272817,1176128,96689,7.6
12,87,Monroe,2013,44153,41922,2231,5.1
12,89,Nassau,2013,36074,33542,2532,7.0
12,91,Okaloosa,2013,91866,86383,5483,6.0
12,93,Okeechobee,2013,18066,16421,1645,9.1
12,95,Orange,2013,661332,614487,46845,7.1
12,97,Osceola,2013,147566,135390,12176,8.3
12,99,Palm Beach,2013,670585,620621,49964,7.5
12,101,Pasco,2013,209918,193095,16823,8.0
12,103,Pinellas,2013,468883,436393,32490,6.9
12,105,Polk,2013,278126,254278,23848,8.6
12,107,Putnam,2013,28179,25124,3055,10.8
12,109,St. Johns,2013,107005,100940,6065,5.7
12,111,St. Lucie,2013,129041,115651,13390,10.4
12,113,Santa Rosa,2013,72833,67968,4865,6.7
12,115,Sarasota,2013,170288,157879,12409,7.3
12,117,Seminole,2013,232309,216145,16164,7.0
12,119,Sumter,2013,27530,24872,2658,9.7
12,121,Suwannee,2013,18028,16726,1302,7.2
12,123,Taylor,2013,9464,8690,774,8.2
12,125,Union,2013,4968,4641,327,6.6
12,127,Volusia,2013,235149,215040,20109,8.6
12,129,Wakulla,2013,14036,13160,876,6.2
12,131,Walton,2013,26890,25178,1712,6.4
12,133,Washington,2013,9830,9040,790,8.0
13,1,Appling,2013,8661,7736,925,10.7
13,3,Atkinson,2013,3480,3157,323,9.3
13,5,Bacon,2013,4622,4234,388,8.4
13,7,Baker,2013,1128,1010,118,10.5
13,9,Baldwin,2013,18502,16637,1865,10.1
13,11,Banks,2013,7985,7360,625,7.8
13,13,Barrow,2013,34638,32095,2543,7.3
13,15,Bartow,2013,46991,42946,4045,8.6
13,17,Ben Hill,2013,5767,5052,715,12.4
13,19,Berrien,2013,7400,6698,702,9.5
13,21,Bibb,2013,69796,63362,6434,9.2
13,23,Bleckley,2013,4780,4115,665,13.9
13,25,Brantley,2013,7027,6283,744,10.6
13,27,Brooks,2013,6673,6121,552,8.3
13,29,Bryan,2013,15398,14260,1138,7.4
13,31,Bulloch,2013,34129,31186,2943,8.6
13,33,Burke,2013,9470,8342,1128,11.9
13,35,Butts,2013,10183,9243,940,9.2
13,37,Calhoun,2013,2103,1933,170,8.1
13,39,Camden,2013,21550,19890,1660,7.7
13,43,Candler,2013,5095,4682,413,8.1
13,45,Carroll,2013,51788,46833,4955,9.6
13,47,Catoosa,2013,31608,29495,2113,6.7
13,49,Charlton,2013,4912,4500,412,8.4
13,51,Chatham,2013,131196,120414,10782,8.2
13,53,Chattahoochee,2013,2457,2189,268,10.9
13,55,Chattooga,2013,10522,9583,939,8.9
13,57,Cherokee,2013,115546,108491,7055,6.1
13,59,Clarke,2013,57805,53315,4490,7.8
13,61,Clay,2013,954,846,108,11.3
13,63,Clayton,2013,124846,111468,13378,10.7
13,65,Clinch,2013,2826,2569,257,9.1
13,67,Cobb,2013,388328,362523,25805,6.6
13,69,Coffee,2013,17486,15761,1725,9.9
13,71,Colquitt,2013,20299,18532,1767,8.7
13,73,Columbia,2013,65488,61274,4214,6.4
13,75,Cook,2013,7428,6798,630,8.5
13,77,Coweta,2013,65734,61173,4561,6.9
13,79,Crawford,2013,5681,5181,500,8.8
13,81,Crisp,2013,9660,8588,1072,11.1
13,83,Dade,2013,8117,7543,574,7.1
13,85,Dawson,2013,10769,9979,790,7.3
13,87,Decatur,2013,11560,10469,1091,9.4
13,89,DeKalb,2013,368157,337355,30802,8.4
13,91,Dodge,2013,7772,6892,880,11.3
13,93,Dooly,2013,4508,3993,515,11.4
13,95,Dougherty,2013,39661,35585,4076,10.3
13,97,Douglas,2013,67225,61482,5743,8.5
13,99,Early,2013,4369,3972,397,9.1
13,101,Echols,2013,1778,1666,112,6.3
13,103,Effingham,2013,26146,24286,1860,7.1
13,105,Elbert,2013,8357,7458,899,10.8
13,107,Emanuel,2013,8832,7732,1100,12.5
13,109,Evans,2013,4721,4364,357,7.6
13,111,Fannin,2013,9750,8878,872,8.9
13,113,Fayette,2013,53343,49791,3552,6.7
13,115,Floyd,2013,43712,39586,4126,9.4
13,117,Forsyth,2013,96381,90753,5628,5.8
13,119,Franklin,2013,9318,8414,904,9.7
13,121,Fulton,2013,507565,466867,40698,8.0
13,123,Gilmer,2013,11891,10829,1062,8.9
13,125,Glascock,2013,1288,1167,121,9.4
13,127,Glynn,2013,38010,34797,3213,8.5
13,129,Gordon,2013,26160,23859,2301,8.8
13,131,Grady,2013,10470,9666,804,7.7
13,133,Greene,2013,6343,5718,625,9.9
13,135,Gwinnett,2013,437728,407841,29887,6.8
13,137,Habersham,2013,19292,17756,1536,8.0
13,139,Hall,2013,89392,83308,6084,6.8
13,141,Hancock,2013,2637,2252,385,14.6
13,143,Haralson,2013,11952,10851,1101,9.2
13,145,Harris,2013,15792,14766,1026,6.5
13,147,Hart,2013,10485,9527,958,9.1
13,149,Heard,2013,5004,4536,468,9.4
13,151,Henry,2013,103297,94630,8667,8.4
13,153,Houston,2013,67381,62345,5036,7.5
13,155,Irwin,2013,3366,3011,355,10.5
13,157,Jackson,2013,29565,27538,2027,6.9
13,159,Jasper,2013,6506,5971,535,8.2
13,161,Jeff Davis,2013,6374,5745,629,9.9
13,163,Jefferson,2013,6830,5881,949,13.9
13,165,Jenkins,2013,3318,2911,407,12.3
13,167,Johnson,2013,3994,3604,390,9.8
13,169,Jones,2013,13592,12610,982,7.2
13,171,Lamar,2013,7810,6934,876,11.2
13,173,Lanier,2013,3837,3511,326,8.5
13,175,Laurens,2013,19395,17319,2076,10.7
13,177,Lee,2013,14279,13304,975,6.8
13,179,Liberty,2013,26166,23961,2205,8.4
13,181,Lincoln,2013,3446,3103,343,10.0
13,183,Long,2013,6688,6148,540,8.1
13,185,Lowndes,2013,51035,46965,4070,8.0
13,187,Lumpkin,2013,15122,14015,1107,7.3
13,189,McDuffie,2013,9065,8047,1018,11.2
13,191,McIntosh,2013,5923,5395,528,8.9
13,193,Macon,2013,4955,4327,628,12.7
13,195,Madison,2013,12893,11922,971,7.5
13,197,Marion,2013,3449,3146,303,8.8
13,199,Meriwether,2013,8802,7861,941,10.7
13,201,Miller,2013,2651,2460,191,7.2
13,205,Mitchell,2013,9005,8236,769,8.5
13,207,Monroe,2013,12751,11733,1018,8.0
13,209,Montgomery,2013,4043,3584,459,11.4
13,211,Morgan,2013,8336,7669,667,8.0
13,213,Murray,2013,15864,14092,1772,11.2
13,215,Muscogee,2013,83025,75322,7703,9.3
13,217,Newton,2013,48002,43372,4630,9.6
13,219,Oconee,2013,17076,16125,951,5.6
13,221,Oglethorpe,2013,6731,6225,506,7.5
13,223,Paulding,2013,74440,69117,5323,7.2
13,225,Peach,2013,11873,10615,1258,10.6
13,227,Pickens,2013,13793,12701,1092,7.9
13,229,Pierce,2013,8149,7458,691,8.5
13,231,Pike,2013,8292,7594,698,8.4
13,233,Polk,2013,18483,16848,1635,8.8
13,235,Pulaski,2013,4193,3823,370,8.8
13,237,Putnam,2013,8132,7298,834,10.3
13,239,Quitman,2013,901,828,73,8.1
13,241,Rabun,2013,6813,6142,671,9.8
13,243,Randolph,2013,2787,2501,286,10.3
13,245,Richmond,2013,86594,78136,8458,9.8
13,247,Rockdale,2013,42123,38294,3829,9.1
13,249,Schley,2013,2129,1933,196,9.2
13,251,Screven,2013,5555,4860,695,12.5
13,253,Seminole,2013,3135,2816,319,10.2
13,255,Spalding,2013,27737,24570,3167,11.4
13,257,Stephens,2013,11497,10450,1047,9.1
13,259,Stewart,2013,2283,2086,197,8.6
13,261,Sumter,2013,13397,11897,1500,11.2
13,263,Talbot,2013,2857,2594,263,9.2
13,265,Taliaferro,2013,589,519,70,11.9
13,267,Tattnall,2013,9550,8795,755,7.9
13,269,Taylor,2013,3169,2801,368,11.6
13,271,Telfair,2013,5288,4688,600,11.3
13,273,Terrell,2013,3659,3304,355,9.7
13,275,Thomas,2013,17780,16187,1593,9.0
13,277,Tift,2013,18669,17094,1575,8.4
13,279,Toombs,2013,12771,11375,1396,10.9
13,281,Towns,2013,4155,3717,438,10.5
13,283,Treutlen,2013,2823,2478,345,12.2
13,285,Troup,2013,36113,33025,3088,8.6
13,287,Turner,2013,3331,3001,330,9.9
13,289,Twiggs,2013,3117,2691,426,13.7
13,291,Union,2013,9317,8587,730,7.8
13,293,Upson,2013,11907,10745,1162,9.8
13,295,Walker,2013,30120,27705,2415,8.0
13,297,Walton,2013,40999,37833,3166,7.7
13,299,Ware,2013,15078,13675,1403,9.3
13,301,Warren,2013,2723,2398,325,11.9
13,303,Washington,2013,7677,6942,735,9.6
13,305,Wayne,2013,12273,11083,1190,9.7
13,307,Webster,2013,1034,939,95,9.2
13,309,Wheeler,2013,1893,1655,238,12.6
13,311,White,2013,13777,12766,1011,7.3
13,313,Whitfield,2013,44598,40363,4235,9.5
13,315,Wilcox,2013,2815,2504,311,11.0
13,317,Wilkes,2013,3732,3317,415,11.1
13,319,Wilkinson,2013,3712,3331,381,10.3
13,321,Worth,2013,9232,8387,845,9.2
15,1,Hawaii,2013,86854,81283,5571,6.4
15,3,Honolulu/city,2013,448716,429206,19510,4.3
15,7,Kauai,2013,34675,32813,1862,5.4
15,9,Maui,2013,80734,76704,4030,5.0
16,1,Ada,2013,208167,196090,12077,5.8
16,3,Adams,2013,1738,1478,260,15.0
16,5,Bannock,2013,41765,39047,2718,6.5
16,7,Bear Lake,2013,2905,2739,166,5.7
16,9,Benewah,2013,4043,3593,450,11.1
16,11,Bingham,2013,22488,21020,1468,6.5
16,13,Blaine,2013,11684,10940,744,6.4
16,15,Boise,2013,2954,2687,267,9.0
16,17,Bonner,2013,18497,16695,1802,9.7
16,19,Bonneville,2013,49346,46351,2995,6.1
16,21,Boundary,2013,4960,4522,438,8.8
16,23,Butte,2013,1309,1209,100,7.6
16,25,Camas,2013,640,594,46,7.2
16,27,Canyon,2013,88688,81246,7442,8.4
16,29,Caribou,2013,3928,3697,231,5.9
16,31,Cassia,2013,11203,10551,652,5.8
16,33,Clark,2013,428,398,30,7.0
16,35,Clearwater,2013,3235,2832,403,12.5
16,37,Custer,2013,2234,2027,207,9.3
16,39,Elmore,2013,10885,10072,813,7.5
16,41,Franklin,2013,6305,6013,292,4.6
16,43,Fremont,2013,6968,6560,408,5.9
16,45,Gem,2013,7581,6921,660,8.7
16,47,Gooding,2013,8091,7647,444,5.5
16,49,Idaho,2013,6670,5938,732,11.0
16,51,Jefferson,2013,12233,11536,697,5.7
16,53,Jerome,2013,10913,10263,650,6.0
16,55,Kootenai,2013,69959,64285,5674,8.1
16,57,Latah,2013,19564,18492,1072,5.5
16,59,Lemhi,2013,3480,3119,361,10.4
16,61,Lewis,2013,1624,1533,91,5.6
16,63,Lincoln,2013,2675,2449,226,8.4
16,65,Madison,2013,18563,17717,846,4.6
16,67,Minidoka,2013,10466,9821,645,6.2
16,69,Nez Perce,2013,20372,19242,1130,5.5
16,71,Oneida,2013,2109,2008,101,4.8
16,73,Owyhee,2013,5152,4930,222,4.3
16,75,Payette,2013,10917,10128,789,7.2
16,77,Power,2013,4016,3723,293,7.3
16,79,Shoshone,2013,5582,4834,748,13.4
16,81,Teton,2013,5495,5189,306,5.6
16,83,Twin Falls,2013,38360,35908,2452,6.4
16,85,Valley,2013,4603,4084,519,11.3
16,87,Washington,2013,4813,4419,394,8.2
17,1,Adams,2013,32927,30704,2223,6.8
17,3,Alexander,2013,2687,2348,339,12.6
17,5,Bond,2013,8028,7334,694,8.6
17,7,Boone,2013,26351,23689,2662,10.1
17,9,Brown,2013,2612,2452,160,6.1
17,11,Bureau,2013,17715,16096,1619,9.1
17,13,Calhoun,2013,2414,2178,236,9.8
17,15,Carroll,2013,7873,7249,624,7.9
17,17,Cass,2013,6426,5841,585,9.1
17,19,Champaign,2013,106157,98539,7618,7.2
17,21,Christian,2013,15971,14421,1550,9.7
17,23,Clark,2013,7933,7198,735,9.3
17,25,Clay,2013,6313,5689,624,9.9
17,27,Clinton,2013,19929,18583,1346,6.8
17,29,Coles,2013,24398,22260,2138,8.8
17,31,Cook,2013,2677937,2418142,259795,9.7
17,33,Crawford,2013,9954,9130,824,8.3
17,35,Cumberland,2013,5813,5360,453,7.8
17,37,DeKalb,2013,54877,50409,4468,8.1
17,39,De Witt,2013,8176,7497,679,8.3
17,41,Douglas,2013,9855,9178,677,6.9
17,43,DuPage,2013,511692,473708,37984,7.4
17,45,Edgar,2013,9024,8174,850,9.4
17,47,Edwards,2013,2865,2621,244,8.5
17,49,Effingham,2013,18053,16810,1243,6.9
17,51,Fayette,2013,10118,9192,926,9.2
17,53,Ford,2013,6726,6232,494,7.3
17,55,Franklin,2013,16909,14906,2003,11.8
17,57,Fulton,2013,16194,14432,1762,10.9
17,59,Gallatin,2013,2478,2245,233,9.4
17,61,Greene,2013,6313,5769,544,8.6
17,63,Grundy,2013,25968,22930,3038,11.7
17,65,Hamilton,2013,4084,3767,317,7.8
17,67,Hancock,2013,8889,8138,751,8.4
17,69,Hardin,2013,1732,1536,196,11.3
17,71,Henderson,2013,3669,3380,289,7.9
17,73,Henry,2013,25491,23526,1965,7.7
17,75,Iroquois,2013,14932,13670,1262,8.5
17,77,Jackson,2013,28507,26251,2256,7.9
17,79,Jasper,2013,4723,4351,372,7.9
17,81,Jefferson,2013,17815,16125,1690,9.5
17,83,Jersey,2013,11142,10147,995,8.9
17,85,Jo Daviess,2013,11584,10703,881,7.6
17,87,Johnson,2013,4282,3762,520,12.1
17,89,Kane,2013,265252,242313,22939,8.6
17,91,Kankakee,2013,55118,49328,5790,10.5
17,93,Kendall,2013,64591,59137,5454,8.4
17,95,Knox,2013,23650,21562,2088,8.8
17,97,Lake,2013,363470,334752,28718,7.9
17,99,LaSalle,2013,58068,52085,5983,10.3
17,101,Lawrence,2013,6323,5679,644,10.2
17,103,Lee,2013,18074,16635,1439,8.0
17,105,Livingston,2013,17684,16261,1423,8.0
17,107,Logan,2013,13052,12000,1052,8.1
17,109,McDonough,2013,14622,13414,1208,8.3
17,111,McHenry,2013,167315,152728,14587,8.7
17,113,McLean,2013,92664,86595,6069,6.5
17,115,Macon,2013,52688,46762,5926,11.2
17,117,Macoupin,2013,23450,21241,2209,9.4
17,119,Madison,2013,133115,121325,11790,8.9
17,121,Marion,2013,18096,16282,1814,10.0
17,123,Marshall,2013,5899,5362,537,9.1
17,125,Mason,2013,6728,5994,734,10.9
17,127,Massac,2013,6401,5776,625,9.8
17,129,Menard,2013,6588,6115,473,7.2
17,131,Mercer,2013,8420,7763,657,7.8
17,133,Monroe,2013,17715,16536,1179,6.7
17,135,Montgomery,2013,12563,11194,1369,10.9
17,137,Morgan,2013,17328,15971,1357,7.8
17,139,Moultrie,2013,7095,6588,507,7.1
17,141,Ogle,2013,25747,23219,2528,9.8
17,143,Peoria,2013,93391,84411,8980,9.6
17,145,Perry,2013,9014,8023,991,11.0
17,147,Piatt,2013,8616,8019,597,6.9
17,149,Pike,2013,7687,7111,576,7.5
17,151,Pope,2013,1830,1661,169,9.2
17,153,Pulaski,2013,2216,1939,277,12.5
17,155,Putnam,2013,3052,2750,302,9.9
17,157,Randolph,2013,14368,13167,1201,8.4
17,159,Richland,2013,7367,6754,613,8.3
17,161,Rock Island,2013,73808,67713,6095,8.3
17,163,St. Clair,2013,127666,115207,12459,9.8
17,165,Saline,2013,11269,10081,1188,10.5
17,167,Sangamon,2013,101749,94098,7651,7.5
17,169,Schuyler,2013,3472,3184,288,8.3
17,171,Scott,2013,2598,2367,231,8.9
17,173,Shelby,2013,10302,9403,899,8.7
17,175,Stark,2013,2881,2606,275,9.5
17,177,Stephenson,2013,22717,20587,2130,9.4
17,179,Tazewell,2013,68998,63046,5952,8.6
17,181,Union,2013,7406,6578,828,11.2
17,183,Vermilion,2013,35837,32046,3791,10.6
17,185,Wabash,2013,5635,5215,420,7.5
17,187,Warren,2013,8813,8169,644,7.3
17,189,Washington,2013,8912,8361,551,6.2
17,191,Wayne,2013,7875,7266,609,7.7
17,193,White,2013,7022,6485,537,7.6
17,195,Whiteside,2013,29360,26809,2551,8.7
17,197,Will,2013,359245,323807,35438,9.9
17,199,Williamson,2013,31456,28631,2825,9.0
17,201,Winnebago,2013,142881,127922,14959,10.5
17,203,Woodford,2013,19898,18492,1406,7.1
18,1,Adams,2013,15919,14969,950,6.0
18,3,Allen,2013,174458,161561,12897,7.4
18,5,Bartholomew,2013,41670,39227,2443,5.9
18,7,Benton,2013,4469,4160,309,6.9
18,9,Blackford,2013,5447,4918,529,9.7
18,11,Boone,2013,31144,29402,1742,5.6
18,13,Brown,2013,7329,6795,534,7.3
18,15,Carroll,2013,9923,9238,685,6.9
18,17,Cass,2013,17695,16361,1334,7.5
18,19,Clark,2013,56329,52510,3819,6.8
18,21,Clay,2013,12598,11495,1103,8.8
18,23,Clinton,2013,16449,15304,1145,7.0
18,25,Crawford,2013,4846,4370,476,9.8
18,27,Daviess,2013,14898,14072,826,5.5
18,29,Dearborn,2013,25212,23117,2095,8.3
18,31,Decatur,2013,13885,12974,911,6.6
18,33,DeKalb,2013,20979,19505,1474,7.0
18,35,Delaware,2013,54238,49652,4586,8.5
18,37,Dubois,2013,21676,20545,1131,5.2
18,39,Elkhart,2013,99135,92097,7038,7.1
18,41,Fayette,2013,9033,8117,916,10.1
18,43,Floyd,2013,38575,36176,2399,6.2
18,45,Fountain,2013,8322,7521,801,9.6
18,47,Franklin,2013,10783,9867,916,8.5
18,49,Fulton,2013,9898,9096,802,8.1
18,51,Gibson,2013,18050,17013,1037,5.7
18,53,Grant,2013,32508,29625,2883,8.9
18,55,Greene,2013,13774,12391,1383,10.0
18,57,Hamilton,2013,156093,148370,7723,4.9
18,59,Hancock,2013,36133,33780,2353,6.5
18,61,Harrison,2013,18738,17454,1284,6.9
18,63,Hendricks,2013,78810,74332,4478,5.7
18,65,Henry,2013,21341,19489,1852,8.7
18,67,Howard,2013,36467,33555,2912,8.0
18,69,Huntington,2013,18551,17146,1405,7.6
18,71,Jackson,2013,20887,19556,1331,6.4
18,73,Jasper,2013,15965,14752,1213,7.6
18,75,Jay,2013,10063,9300,763,7.6
18,77,Jefferson,2013,15335,14146,1189,7.8
18,79,Jennings,2013,13048,11872,1176,9.0
18,81,Johnson,2013,73806,69288,4518,6.1
18,83,Knox,2013,18663,17427,1236,6.6
18,85,Kosciusko,2013,39804,37230,2574,6.5
18,87,LaGrange,2013,17646,16623,1023,5.8
18,89,Lake,2013,230264,209792,20472,8.9
18,91,LaPorte,2013,48999,44520,4479,9.1
18,93,Lawrence,2013,20681,18630,2051,9.9
18,95,Madison,2013,58141,52821,5320,9.2
18,97,Marion,2013,464051,425318,38733,8.3
18,99,Marshall,2013,23128,21453,1675,7.2
18,101,Martin,2013,4960,4652,308,6.2
18,103,Miami,2013,15628,14296,1332,8.5
18,105,Monroe,2013,66779,62293,4486,6.7
18,107,Montgomery,2013,18427,17133,1294,7.0
18,109,Morgan,2013,34880,32296,2584,7.4
18,111,Newton,2013,6916,6309,607,8.8
18,113,Noble,2013,22655,21027,1628,7.2
18,115,Ohio,2013,3169,2911,258,8.1
18,117,Orange,2013,8766,7912,854,9.7
18,119,Owen,2013,9649,8695,954,9.9
18,121,Parke,2013,6941,6312,629,9.1
18,123,Perry,2013,8947,8264,683,7.6
18,125,Pike,2013,6273,5855,418,6.7
18,127,Porter,2013,83317,77418,5899,7.1
18,129,Posey,2013,12970,12164,806,6.2
18,131,Pulaski,2013,6127,5705,422,6.9
18,133,Putnam,2013,16183,14808,1375,8.5
18,135,Randolph,2013,12593,11525,1068,8.5
18,137,Ripley,2013,13653,12504,1149,8.4
18,139,Rush,2013,8349,7742,607,7.3
18,141,St. Joseph,2013,127277,116405,10872,8.5
18,143,Scott,2013,10253,9354,899,8.8
18,145,Shelby,2013,22382,20771,1611,7.2
18,147,Spencer,2013,10709,10009,700,6.5
18,149,Starke,2013,10226,9276,950,9.3
18,151,Steuben,2013,19357,18167,1190,6.1
18,153,Sullivan,2013,8716,7943,773,8.9
18,155,Switzerland,2013,4891,4533,358,7.3
18,157,Tippecanoe,2013,89799,83941,5858,6.5
18,159,Tipton,2013,7974,7446,528,6.6
18,161,Union,2013,3525,3276,249,7.1
18,163,Vanderburgh,2013,91056,84680,6376,7.0
18,165,Vermillion,2013,7332,6558,774,10.6
18,167,Vigo,2013,49588,45021,4567,9.2
18,169,Wabash,2013,15478,14320,1158,7.5
18,171,Warren,2013,4158,3799,359,8.6
18,173,Warrick,2013,30769,28869,1900,6.2
18,175,Washington,2013,13161,12032,1129,8.6
18,177,Wayne,2013,30578,27976,2602,8.5
18,179,Wells,2013,13676,12825,851,6.2
18,181,White,2013,12955,12081,874,6.7
18,183,Whitley,2013,16790,15640,1150,6.8
19,1,Adair,2013,4078,3906,172,4.2
19,3,Adams,2013,2153,2074,79,3.7
19,5,Allamakee,2013,7662,7177,485,6.3
19,7,Appanoose,2013,5935,5556,379,6.4
19,9,Audubon,2013,3241,3083,158,4.9
19,11,Benton,2013,13741,13042,699,5.1
19,13,Black Hawk,2013,71842,68173,3669,5.1
19,15,Boone,2013,14902,14298,604,4.1
19,17,Bremer,2013,14017,13486,531,3.8
19,19,Buchanan,2013,11182,10652,530,4.7
19,21,Buena Vista,2013,11323,10875,448,4.0
19,23,Butler,2013,8273,7898,375,4.5
19,25,Calhoun,2013,4367,4140,227,5.2
19,27,Carroll,2013,11286,10907,379,3.4
19,29,Cass,2013,7300,6932,368,5.0
19,31,Cedar,2013,10827,10361,466,4.3
19,33,Cerro Gordo,2013,23365,22103,1262,5.4
19,35,Cherokee,2013,6850,6555,295,4.3
19,37,Chickasaw,2013,6375,6057,318,5.0
19,39,Clarke,2013,4591,4338,253,5.5
19,41,Clay,2013,8827,8429,398,4.5
19,43,Clayton,2013,10088,9519,569,5.6
19,45,Clinton,2013,24957,23520,1437,5.8
19,47,Crawford,2013,8781,8398,383,4.4
19,49,Dallas,2013,40955,39477,1478,3.6
19,51,Davis,2013,4127,3899,228,5.5
19,53,Decatur,2013,4307,4113,194,4.5
19,55,Delaware,2013,10402,9955,447,4.3
19,57,Des Moines,2013,20524,19284,1240,6.0
19,59,Dickinson,2013,9349,8851,498,5.3
19,61,Dubuque,2013,55126,52622,2504,4.5
19,63,Emmet,2013,5691,5458,233,4.1
19,65,Fayette,2013,10681,10118,563,5.3
19,67,Floyd,2013,8285,7827,458,5.5
19,69,Franklin,2013,5923,5659,264,4.5
19,71,Fremont,2013,4133,3959,174,4.2
19,73,Greene,2013,5130,4890,240,4.7
19,75,Grundy,2013,6608,6320,288,4.4
19,77,Guthrie,2013,5540,5255,285,5.1
19,79,Hamilton,2013,7049,6664,385,5.5
19,81,Hancock,2013,6218,5969,249,4.0
19,83,Hardin,2013,8708,8264,444,5.1
19,85,Harrison,2013,7518,7179,339,4.5
19,87,Henry,2013,9561,9055,506,5.3
19,89,Howard,2013,5237,4995,242,4.6
19,91,Humboldt,2013,5223,5010,213,4.1
19,93,Ida,2013,3818,3666,152,4.0
19,95,Iowa,2013,9941,9529,412,4.1
19,97,Jackson,2013,10859,10275,584,5.4
19,99,Jasper,2013,19079,18110,969,5.1
19,101,Jefferson,2013,8936,8493,443,5.0
19,103,Johnson,2013,82852,80025,2827,3.4
19,105,Jones,2013,10746,10176,570,5.3
19,107,Keokuk,2013,5484,5206,278,5.1
19,109,Kossuth,2013,8485,8183,302,3.6
19,111,Lee,2013,17149,15926,1223,7.1
19,113,Linn,2013,119830,113828,6002,5.0
19,115,Louisa,2013,5858,5562,296,5.1
19,117,Lucas,2013,4252,4052,200,4.7
19,119,Lyon,2013,6864,6665,199,2.9
19,121,Madison,2013,8101,7690,411,5.1
19,123,Mahaska,2013,11667,11105,562,4.8
19,125,Marion,2013,17342,16570,772,4.5
19,127,Marshall,2013,19825,18633,1192,6.0
19,129,Mills,2013,7336,7014,322,4.4
19,131,Mitchell,2013,5515,5278,237,4.3
19,133,Monona,2013,4630,4365,265,5.7
19,135,Monroe,2013,4032,3801,231,5.7
19,137,Montgomery,2013,5129,4878,251,4.9
19,139,Muscatine,2013,21725,20591,1134,5.2
19,141,O'Brien,2013,8053,7760,293,3.6
19,143,Osceola,2013,3414,3283,131,3.8
19,145,Page,2013,6563,6216,347,5.3
19,147,Palo Alto,2013,4783,4604,179,3.7
19,149,Plymouth,2013,14509,13928,581,4.0
19,151,Pocahontas,2013,4198,4038,160,3.8
19,153,Polk,2013,250729,238664,12065,4.8
19,155,Pottawattamie,2013,48696,46470,2226,4.6
19,157,Poweshiek,2013,10358,9878,480,4.6
19,159,Ringgold,2013,2518,2410,108,4.3
19,161,Sac,2013,5522,5290,232,4.2
19,163,Scott,2013,88245,83316,4929,5.6
19,165,Shelby,2013,6950,6689,261,3.8
19,167,Sioux,2013,19593,18916,677,3.5
19,169,Story,2013,54826,52998,1828,3.3
19,171,Tama,2013,9120,8613,507,5.6
19,173,Taylor,2013,3172,3050,122,3.8
19,175,Union,2013,6905,6568,337,4.9
19,177,Van Buren,2013,3838,3627,211,5.5
19,179,Wapello,2013,18158,17009,1149,6.3
19,181,Warren,2013,26374,25189,1185,4.5
19,183,Washington,2013,12289,11826,463,3.8
19,185,Wayne,2013,2854,2706,148,5.2
19,187,Webster,2013,19784,18730,1054,5.3
19,189,Winnebago,2013,5173,4925,248,4.8
19,191,Winneshiek,2013,11906,11355,551,4.6
19,193,Woodbury,2013,55288,52641,2647,4.8
19,195,Worth,2013,4190,3974,216,5.2
19,197,Wright,2013,6854,6547,307,4.5
20,1,Allen,2013,6906,6486,420,6.1
20,3,Anderson,2013,4249,4002,247,5.8
20,5,Atchison,2013,7794,7126,668,8.6
20,7,Barber,2013,2768,2657,111,4.0
20,9,Barton,2013,15133,14519,614,4.1
20,11,Bourbon,2013,6884,6438,446,6.5
20,13,Brown,2013,5467,5193,274,5.0
20,15,Butler,2013,31897,30132,1765,5.5
20,17,Chase,2013,1253,1183,70,5.6
20,19,Chautauqua,2013,1623,1523,100,6.2
20,21,Cherokee,2013,10523,9851,672,6.4
20,23,Cheyenne,2013,1312,1267,45,3.4
20,25,Clark,2013,1191,1154,37,3.1
20,27,Clay,2013,4204,3992,212,5.0
20,29,Cloud,2013,4462,4268,194,4.3
20,31,Coffey,2013,4954,4661,293,5.9
20,33,Comanche,2013,1036,1000,36,3.5
20,35,Cowley,2013,17204,16204,1000,5.8
20,37,Crawford,2013,19327,18186,1141,5.9
20,39,Decatur,2013,1364,1310,54,4.0
20,41,Dickinson,2013,9882,9299,583,5.9
20,43,Doniphan,2013,4347,4111,236,5.4
20,45,Douglas,2013,63686,60620,3066,4.8
20,47,Edwards,2013,1611,1551,60,3.7
20,49,Elk,2013,1326,1251,75,5.7
20,51,Ellis,2013,18086,17517,569,3.1
20,53,Ellsworth,2013,3454,3339,115,3.3
20,55,Finney,2013,20026,19168,858,4.3
20,57,Ford,2013,18672,17924,748,4.0
20,59,Franklin,2013,13997,13139,858,6.1
20,61,Geary,2013,12694,11593,1101,8.7
20,63,Gove,2013,1492,1442,50,3.4
20,65,Graham,2013,1355,1298,57,4.2
20,67,Grant,2013,4000,3856,144,3.6
20,69,Gray,2013,3496,3391,105,3.0
20,71,Greeley,2013,910,888,22,2.4
20,73,Greenwood,2013,3366,3186,180,5.3
20,75,Hamilton,2013,1719,1670,49,2.9
20,77,Harper,2013,3111,2986,125,4.0
20,79,Harvey,2013,17150,16315,835,4.9
20,81,Haskell,2013,2395,2325,70,2.9
20,83,Hodgeman,2013,1118,1075,43,3.8
20,85,Jackson,2013,7303,6932,371,5.1
20,87,Jefferson,2013,10211,9626,585,5.7
20,89,Jewell,2013,1425,1373,52,3.6
20,91,Johnson,2013,314912,301328,13584,4.3
20,93,Kearny,2013,2103,2027,76,3.6
20,95,Kingman,2013,3725,3522,203,5.4
20,97,Kiowa,2013,1426,1378,48,3.4
20,99,Labette,2013,10751,9982,769,7.2
20,101,Lane,2013,885,854,31,3.5
20,103,Leavenworth,2013,34677,32604,2073,6.0
20,105,Lincoln,2013,1781,1699,82,4.6
20,107,Linn,2013,4345,3968,377,8.7
20,109,Logan,2013,1747,1698,49,2.8
20,111,Lyon,2013,16466,15283,1183,7.2
20,113,McPherson,2013,16618,15974,644,3.9
20,115,Marion,2013,6225,5934,291,4.7
20,117,Marshall,2013,6056,5823,233,3.8
20,119,Meade,2013,2356,2282,74,3.1
20,121,Miami,2013,16822,15884,938,5.6
20,123,Mitchell,2013,3885,3772,113,2.9
20,125,Montgomery,2013,17879,16669,1210,6.8
20,127,Morris,2013,3107,2938,169,5.4
20,129,Morton,2013,1597,1534,63,3.9
20,131,Nemaha,2013,5836,5635,201,3.4
20,133,Neosho,2013,6749,6174,575,8.5
20,135,Ness,2013,1605,1556,49,3.1
20,137,Norton,2013,3092,3006,86,2.8
20,139,Osage,2013,8294,7744,550,6.6
20,141,Osborne,2013,2126,2036,90,4.2
20,143,Ottawa,2013,3245,3099,146,4.5
20,145,Pawnee,2013,3422,3273,149,4.4
20,147,Phillips,2013,2971,2845,126,4.2
20,149,Pottawatomie,2013,11951,11401,550,4.6
20,151,Pratt,2013,5451,5235,216,4.0
20,153,Rawlins,2013,1554,1511,43,2.8
20,155,Reno,2013,31663,30000,1663,5.3
20,157,Republic,2013,2656,2566,90,3.4
20,159,Rice,2013,5454,5221,233,4.3
20,161,Riley,2013,36657,35111,1546,4.2
20,163,Rooks,2013,2785,2669,116,4.2
20,165,Rush,2013,1814,1736,78,4.3
20,167,Russell,2013,3858,3705,153,4.0
20,169,Saline,2013,31172,29619,1553,5.0
20,171,Scott,2013,2844,2762,82,2.9
20,173,Sedgwick,2013,246820,231648,15172,6.1
20,175,Seward,2013,11107,10652,455,4.1
20,177,Shawnee,2013,92251,86921,5330,5.8
20,179,Sheridan,2013,1501,1460,41,2.7
20,181,Sherman,2013,3136,3010,126,4.0
20,183,Smith,2013,2162,2085,77,3.6
20,185,Stafford,2013,2222,2124,98,4.4
20,187,Stanton,2013,1048,1009,39,3.7
20,189,Stevens,2013,3321,3222,99,3.0
20,191,Sumner,2013,11171,10541,630,5.6
20,193,Thomas,2013,4475,4319,156,3.5
20,195,Trego,2013,1494,1439,55,3.7
20,197,Wabaunsee,2013,3777,3587,190,5.0
20,199,Wallace,2013,854,827,27,3.2
20,201,Washington,2013,3134,3017,117,3.7
20,203,Wichita,2013,1291,1246,45,3.5
20,205,Wilson,2013,4119,3754,365,8.9
20,207,Woodson,2013,1631,1529,102,6.3
20,209,Wyandotte,2013,74946,68999,5947,7.9
21,1,Adair,2013,7559,6799,760,10.1
21,3,Allen,2013,8953,8292,661,7.4
21,5,Anderson,2013,11536,10799,737,6.4
21,7,Ballard,2013,3825,3477,348,9.1
21,9,Barren,2013,19579,18088,1491,7.6
21,11,Bath,2013,4829,4335,494,10.2
21,13,Bell,2013,9863,8561,1302,13.2
21,15,Boone,2013,66044,61712,4332,6.6
21,17,Bourbon,2013,9828,9146,682,6.9
21,19,Boyd,2013,19706,17863,1843,9.4
21,21,Boyle,2013,12816,11695,1121,8.7
21,23,Bracken,2013,3932,3550,382,9.7
21,25,Breathitt,2013,4482,3820,662,14.8
21,27,Breckinridge,2013,8244,7495,749,9.1
21,29,Bullitt,2013,39682,36777,2905,7.3
21,31,Butler,2013,5375,4888,487,9.1
21,33,Caldwell,2013,5633,5176,457,8.1
21,35,Calloway,2013,18147,16842,1305,7.2
21,37,Campbell,2013,48769,45596,3173,6.5
21,39,Carlisle,2013,2377,2208,169,7.1
21,41,Carroll,2013,5168,4700,468,9.1
21,43,Carter,2013,11031,9647,1384,12.5
21,45,Casey,2013,6813,6231,582,8.5
21,47,Christian,2013,26605,24122,2483,9.3
21,49,Clark,2013,17272,15984,1288,7.5
21,51,Clay,2013,5748,4934,814,14.2
21,53,Clinton,2013,4113,3687,426,10.4
21,55,Crittenden,2013,4100,3799,301,7.3
21,57,Cumberland,2013,3038,2717,321,10.6
21,59,Daviess,2013,47652,44408,3244,6.8
21,61,Edmonson,2013,4996,4500,496,9.9
21,63,Elliott,2013,2254,1930,324,14.4
21,65,Estill,2013,5536,5002,534,9.6
21,67,Fayette,2013,168491,158808,9683,5.7
21,69,Fleming,2013,6522,5909,613,9.4
21,71,Floyd,2013,13130,11404,1726,13.1
21,73,Franklin,2013,24581,22981,1600,6.5
21,75,Fulton,2013,2387,2132,255,10.7
21,77,Gallatin,2013,3953,3588,365,9.2
21,79,Garrard,2013,7747,7118,629,8.1
21,81,Grant,2013,11506,10559,947,8.2
21,83,Graves,2013,16482,15100,1382,8.4
21,85,Grayson,2013,11241,10095,1146,10.2
21,87,Green,2013,5320,4885,435,8.2
21,89,Greenup,2013,14793,13297,1496,10.1
21,91,Hancock,2013,4101,3807,294,7.2
21,93,Hardin,2013,47830,44198,3632,7.6
21,95,Harlan,2013,9503,7801,1702,17.9
21,97,Harrison,2013,8747,8092,655,7.5
21,99,Hart,2013,8059,7427,632,7.8
21,101,Henderson,2013,22136,20495,1641,7.4
21,103,Henry,2013,7764,7209,555,7.1
21,105,Hickman,2013,2161,2008,153,7.1
21,107,Hopkins,2013,21510,19827,1683,7.8
21,109,Jackson,2013,4833,4278,555,11.5
21,111,Jefferson,2013,385399,356840,28559,7.4
21,113,Jessamine,2013,25094,23479,1615,6.4
21,115,Johnson,2013,8362,7448,914,10.9
21,117,Kenton,2013,85096,79184,5912,6.9
21,119,Knott,2013,5586,4733,853,15.3
21,121,Knox,2013,10524,9171,1353,12.9
21,123,Larue,2013,5891,5413,478,8.1
21,125,Laurel,2013,24645,22266,2379,9.7
21,127,Lawrence,2013,5578,4957,621,11.1
21,129,Lee,2013,2371,2078,293,12.4
21,131,Leslie,2013,3492,2883,609,17.4
21,133,Letcher,2013,8041,6709,1332,16.6
21,135,Lewis,2013,5293,4655,638,12.1
21,137,Lincoln,2013,9918,8869,1049,10.6
21,139,Livingston,2013,3888,3507,381,9.8
21,141,Logan,2013,12137,11282,855,7.0
21,143,Lyon,2013,3093,2841,252,8.1
21,145,McCracken,2013,30287,27920,2367,7.8
21,147,McCreary,2013,5341,4648,693,13.0
21,149,McLean,2013,4481,4141,340,7.6
21,151,Madison,2013,45764,42783,2981,6.5
21,153,Magoffin,2013,3999,3302,697,17.4
21,155,Marion,2013,9297,8548,749,8.1
21,157,Marshall,2013,15326,14093,1233,8.0
21,159,Martin,2013,3642,3290,352,9.7
21,161,Mason,2013,7793,7020,773,9.9
21,163,Meade,2013,12535,11420,1115,8.9
21,165,Menifee,2013,2489,2191,298,12.0
21,167,Mercer,2013,10192,9399,793,7.8
21,169,Metcalfe,2013,4334,3999,335,7.7
21,171,Monroe,2013,4745,4409,336,7.1
21,173,Montgomery,2013,12140,11121,1019,8.4
21,175,Morgan,2013,5056,4524,532,10.5
21,177,Muhlenberg,2013,12966,11760,1206,9.3
21,179,Nelson,2013,21688,20066,1622,7.5
21,181,Nicholas,2013,3531,3229,302,8.6
21,183,Ohio,2013,9902,8991,911,9.2
21,185,Oldham,2013,30321,28611,1710,5.6
21,187,Owen,2013,5683,5327,356,6.3
21,189,Owsley,2013,1290,1129,161,12.5
21,191,Pendleton,2013,7017,6434,583,8.3
21,193,Perry,2013,10400,8966,1434,13.8
21,195,Pike,2013,23290,20548,2742,11.8
21,197,Powell,2013,5056,4517,539,10.7
21,199,Pulaski,2013,27246,24766,2480,9.1
21,201,Robertson,2013,848,756,92,10.8
21,203,Rockcastle,2013,7085,6434,651,9.2
21,205,Rowan,2013,10931,10031,900,8.2
21,207,Russell,2013,7028,6223,805,11.5
21,209,Scott,2013,26275,24692,1583,6.0
21,211,Shelby,2013,22632,21271,1361,6.0
21,213,Simpson,2013,8856,8197,659,7.4
21,215,Spencer,2013,9344,8749,595,6.4
21,217,Taylor,2013,11390,10323,1067,9.4
21,219,Todd,2013,5635,5220,415,7.4
21,221,Trigg,2013,6048,5506,542,9.0
21,223,Trimble,2013,3967,3640,327,8.2
21,225,Union,2013,6858,6334,524,7.6
21,227,Warren,2013,60493,56378,4115,6.8
21,229,Washington,2013,6141,5722,419,6.8
21,231,Wayne,2013,7460,6579,881,11.8
21,233,Webster,2013,6185,5748,437,7.1
21,235,Whitley,2013,13848,12395,1453,10.5
21,237,Wolfe,2013,2110,1813,297,14.1
21,239,Woodford,2013,14256,13508,748,5.2
22,1,Acadia Parish,2013,26346,24838,1508,5.7
22,3,Allen Parish,2013,8743,8111,632,7.2
22,5,Ascension Parish,2013,56822,53778,3044,5.4
22,7,Assumption Parish,2013,9910,9119,791,8.0
22,9,Avoyelles Parish,2013,16000,14855,1145,7.2
22,11,Beauregard Parish,2013,14444,13423,1021,7.1
22,13,Bienville Parish,2013,5942,5448,494,8.3
22,15,Bossier Parish,2013,56900,53608,3292,5.8
22,17,Caddo Parish,2013,110892,102502,8390,7.6
22,19,Calcasieu Parish,2013,89392,83855,5537,6.2
22,21,Caldwell Parish,2013,3959,3647,312,7.9
22,23,Cameron Parish,2013,3316,3146,170,5.1
22,25,Catahoula Parish,2013,3897,3582,315,8.1
22,27,Claiborne Parish,2013,6524,6056,468,7.2
22,29,Concordia Parish,2013,7802,7166,636,8.2
22,31,De Soto Parish,2013,11005,10071,934,8.5
22,33,East Baton Rouge Parish,2013,226071,212613,13458,6.0
22,35,East Carroll Parish,2013,2263,1894,369,16.3
22,37,East Feliciana Parish,2013,7954,7430,524,6.6
22,39,Evangeline Parish,2013,12866,12029,837,6.5
22,41,Franklin Parish,2013,7694,6949,745,9.7
22,43,Grant Parish,2013,8147,7574,573,7.0
22,45,Iberia Parish,2013,32297,30296,2001,6.2
22,47,Iberville Parish,2013,14031,12909,1122,8.0
22,49,Jackson Parish,2013,7027,6588,439,6.2
22,51,Jefferson Parish,2013,213738,200869,12869,6.0
22,53,Jefferson Davis Parish,2013,13169,12385,784,6.0
22,55,Lafayette Parish,2013,119001,113366,5635,4.7
22,57,Lafourche Parish,2013,46873,44662,2211,4.7
22,59,LaSalle Parish,2013,6982,6648,334,4.8
22,61,Lincoln Parish,2013,20544,18997,1547,7.5
22,63,Livingston Parish,2013,64110,60514,3596,5.6
22,65,Madison Parish,2013,3953,3533,420,10.6
22,67,Morehouse Parish,2013,11093,9769,1324,11.9
22,69,Natchitoches Parish,2013,16816,15474,1342,8.0
22,71,Orleans Parish,2013,173459,161251,12208,7.0
22,73,Ouachita Parish,2013,70976,66065,4911,6.9
22,75,Plaquemines Parish,2013,10065,9516,549,5.5
22,77,Pointe Coupee Parish,2013,9909,9187,722,7.3
22,79,Rapides Parish,2013,57222,53455,3767,6.6
22,81,Red River Parish,2013,3858,3578,280,7.3
22,83,Richland Parish,2013,8654,7853,801,9.3
22,85,Sabine Parish,2013,9192,8596,596,6.5
22,87,St. Bernard Parish,2013,18513,17202,1311,7.1
22,89,St. Charles Parish,2013,24943,23442,1501,6.0
22,91,St. Helena Parish,2013,4567,4069,498,10.9
22,93,St. James Parish,2013,9671,8809,862,8.9
22,95,St. John the Baptist Parish,2013,20087,18419,1668,8.3
22,97,St. Landry Parish,2013,33700,31175,2525,7.5
22,99,St. Martin Parish,2013,24319,22945,1374,5.6
22,101,St. Mary Parish,2013,24991,23417,1574,6.3
22,103,St. Tammany Parish,2013,111147,105012,6135,5.5
22,105,Tangipahoa Parish,2013,52908,48836,4072,7.7
22,107,Tensas Parish,2013,1765,1606,159,9.0
22,109,Terrebonne Parish,2013,53086,50521,2565,4.8
22,111,Union Parish,2013,9162,8477,685,7.5
22,113,Vermilion Parish,2013,26133,24730,1403,5.4
22,115,Vernon Parish,2013,17866,16353,1513,8.5
22,117,Washington Parish,2013,16415,15098,1317,8.0
22,119,Webster Parish,2013,15700,14255,1445,9.2
22,121,West Baton Rouge Parish,2013,12300,11576,724,5.9
22,123,West Carroll Parish,2013,4238,3719,519,12.2
22,125,West Feliciana Parish,2013,5233,4935,298,5.7
22,127,Winn Parish,2013,5375,4953,422,7.9
23,1,Androscoggin,2013,56367,52579,3788,6.7
23,3,Aroostook,2013,33819,30887,2932,8.7
23,5,Cumberland,2013,160650,152056,8594,5.3
23,7,Franklin,2013,15374,14179,1195,7.8
23,9,Hancock,2013,30047,27666,2381,7.9
23,11,Kennebec,2013,63761,59751,4010,6.3
23,13,Knox,2013,20745,19509,1236,6.0
23,15,Lincoln,2013,17337,16149,1188,6.9
23,17,Oxford,2013,27725,25412,2313,8.3
23,19,Penobscot,2013,79954,74438,5516,6.9
23,21,Piscataquis,2013,7881,7182,699,8.9
23,23,Sagadahoc,2013,19092,18010,1082,5.7
23,25,Somerset,2013,24776,22489,2287,9.2
23,27,Waldo,2013,20975,19459,1516,7.2
23,29,Washington,2013,14609,13250,1359,9.3
23,31,York,2013,111135,104047,7088,6.4
24,1,Allegany,2013,33614,30785,2829,8.4
24,3,Anne Arundel,2013,296534,279785,16749,5.6
24,5,Baltimore,2013,442142,411999,30143,6.8
24,9,Calvert,2013,47757,44952,2805,5.9
24,11,Caroline,2013,17678,16464,1214,6.9
24,13,Carroll,2013,93054,87988,5066,5.4
24,15,Cecil,2013,52235,48243,3992,7.6
24,17,Charles,2013,80247,75103,5144,6.4
24,19,Dorchester,2013,15949,14405,1544,9.7
24,21,Frederick,2013,128447,121130,7317,5.7
24,23,Garrett,2013,15741,14485,1256,8.0
24,25,Harford,2013,135674,126915,8759,6.5
24,27,Howard,2013,171324,163135,8189,4.8
24,29,Kent,2013,10346,9609,737,7.1
24,31,Montgomery,2013,543134,516469,26665,4.9
24,33,Prince George's,2013,485941,452620,33321,6.9
24,35,Queen Anne's,2013,26465,24932,1533,5.8
24,37,St. Mary's,2013,54258,51049,3209,5.9
24,39,Somerset,2013,9573,8558,1015,10.6
24,41,Talbot,2013,19158,17941,1217,6.4
24,43,Washington,2013,77209,71601,5608,7.3
24,45,Wicomico,2013,50121,45800,4321,8.6
24,47,Worcester,2013,25888,22663,3225,12.5
24,510,Baltimore city,2013,296422,267999,28423,9.6
25,1,Barnstable,2013,108580,99518,9062,8.3
25,3,Berkshire,2013,65603,60784,4819,7.3
25,5,Bristol,2013,286817,262095,24722,8.6
25,7,Dukes,2013,9410,8561,849,9.0
25,9,Essex,2013,399708,371862,27846,7.0
25,11,Franklin,2013,39345,36951,2394,6.1
25,13,Hampden,2013,220374,201493,18881,8.6
25,15,Hampshire,2013,85523,80405,5118,6.0
25,17,Middlesex,2013,840635,795124,45511,5.4
25,19,Nantucket/town,2013,6599,6122,477,7.2
25,21,Norfolk,2013,362889,342047,20842,5.7
25,23,Plymouth,2013,262992,244834,18158,6.9
25,25,Suffolk,2013,407299,382353,24946,6.1
25,27,Worcester,2013,420916,390996,29920,7.1
26,1,Alcona,2013,3808,3304,504,13.2
26,3,Alger,2013,3386,2993,393,11.6
26,5,Allegan,2013,58171,54330,3841,6.6
26,7,Alpena,2013,13418,12134,1284,9.6
26,9,Antrim,2013,10013,8879,1134,11.3
26,11,Arenac,2013,6507,5669,838,12.9
26,13,Baraga,2013,3552,3043,509,14.3
26,15,Barry,2013,29364,27508,1856,6.3
26,17,Bay,2013,53217,48622,4595,8.6
26,19,Benzie,2013,8625,7745,880,10.2
26,21,Berrien,2013,72701,66456,6245,8.6
26,23,Branch,2013,19080,17489,1591,8.3
26,25,Calhoun,2013,63003,58086,4917,7.8
26,27,Cass,2013,23608,21688,1920,8.1
26,29,Charlevoix,2013,13039,11656,1383,10.6
26,31,Cheboygan,2013,10537,9331,1206,11.4
26,33,Chippewa,2013,17052,15286,1766,10.4
26,35,Clare,2013,11913,10530,1383,11.6
26,37,Clinton,2013,39171,36827,2344,6.0
26,39,Crawford,2013,5395,4783,612,11.3
26,41,Delta,2013,17551,15767,1784,10.2
26,43,Dickinson,2013,12662,11622,1040,8.2
26,45,Eaton,2013,55521,51854,3667,6.6
26,47,Emmet,2013,18179,16047,2132,11.7
26,49,Genesee,2013,182045,164277,17768,9.8
26,51,Gladwin,2013,10048,8885,1163,11.6
26,53,Gogebic,2013,6733,6010,723,10.7
26,55,Grand Traverse,2013,47225,43658,3567,7.6
26,57,Gratiot,2013,18489,16861,1628,8.8
26,59,Hillsdale,2013,20585,18771,1814,8.8
26,61,Houghton,2013,16888,15408,1480,8.8
26,63,Huron,2013,16388,15031,1357,8.3
26,65,Ingham,2013,144696,133742,10954,7.6
26,67,Ionia,2013,28878,26603,2275,7.9
26,69,Iosco,2013,10226,9067,1159,11.3
26,71,Iron,2013,5087,4575,512,10.1
26,73,Isabella,2013,35005,32502,2503,7.2
26,75,Jackson,2013,72368,66462,5906,8.2
26,77,Kalamazoo,2013,125414,116902,8512,6.8
26,79,Kalkaska,2013,7586,6746,840,11.1
26,81,Kent,2013,327984,307705,20279,6.2
26,83,Keweenaw,2013,989,856,133,13.4
26,85,Lake,2013,3632,3154,478,13.2
26,87,Lapeer,2013,40377,35796,4581,11.3
26,89,Leelanau,2013,10301,9518,783,7.6
26,91,Lenawee,2013,47776,44072,3704,7.8
26,93,Livingston,2013,95059,88055,7004,7.4
26,95,Luce,2013,2406,2159,247,10.3
26,97,Mackinac,2013,5258,4619,639,12.2
26,99,Macomb,2013,421344,381732,39612,9.4
26,101,Manistee,2013,10523,9417,1106,10.5
26,103,Marquette,2013,34063,31305,2758,8.1
26,105,Mason,2013,14522,13204,1318,9.1
26,107,Mecosta,2013,18775,16912,1863,9.9
26,109,Menominee,2013,11792,10887,905,7.7
26,111,Midland,2013,40942,37814,3128,7.6
26,113,Missaukee,2013,6964,6327,637,9.1
26,115,Monroe,2013,74666,69210,5456,7.3
26,117,Montcalm,2013,27557,24940,2617,9.5
26,119,Montmorency,2013,3209,2698,511,15.9
26,121,Muskegon,2013,76458,68958,7500,9.8
26,123,Newaygo,2013,22101,20165,1936,8.8
26,125,Oakland,2013,630193,581499,48694,7.7
26,127,Oceana,2013,12765,11200,1565,12.3
26,129,Ogemaw,2013,8630,7623,1007,11.7
26,131,Ontonagon,2013,2453,2117,336,13.7
26,133,Osceola,2013,10053,9060,993,9.9
26,135,Oscoda,2013,2969,2510,459,15.5
26,137,Otsego,2013,11256,10094,1162,10.3
26,139,Ottawa,2013,145244,136483,8761,6.0
26,141,Presque Isle,2013,5478,4679,799,14.6
26,143,Roscommon,2013,8106,6991,1115,13.8
26,145,Saginaw,2013,89110,81122,7988,9.0
26,147,St. Clair,2013,74753,66203,8550,11.4
26,149,St. Joseph,2013,28262,26090,2172,7.7
26,151,Sanilac,2013,19441,17421,2020,10.4
26,153,Schoolcraft,2013,3571,3117,454,12.7
26,155,Shiawassee,2013,33103,30022,3081,9.3
26,157,Tuscola,2013,25087,22467,2620,10.4
26,159,Van Buren,2013,35114,31607,3507,10.0
26,161,Washtenaw,2013,184506,173862,10644,5.8
26,163,Wayne,2013,778327,689531,88796,11.4
26,165,Wexford,2013,14675,13063,1612,11.0
27,1,Aitkin,2013,6812,6297,515,7.6
27,3,Anoka,2013,188571,178948,9623,5.1
27,5,Becker,2013,17989,16988,1001,5.6
27,7,Beltrami,2013,23055,21593,1462,6.3
27,9,Benton,2013,21463,20172,1291,6.0
27,11,Big Stone,2013,2560,2420,140,5.5
27,13,Blue Earth,2013,38655,37026,1629,4.2
27,15,Brown,2013,14539,13772,767,5.3
27,17,Carlton,2013,17531,16466,1065,6.1
27,19,Carver,2013,53369,51033,2336,4.4
27,21,Cass,2013,14012,12844,1168,8.3
27,23,Chippewa,2013,6953,6590,363,5.2
27,25,Chisago,2013,28557,26939,1618,5.7
27,27,Clay,2013,34862,33345,1517,4.4
27,29,Clearwater,2013,4481,3998,483,10.8
27,31,Cook,2013,3058,2878,180,5.9
27,33,Cottonwood,2013,5763,5423,340,5.9
27,35,Crow Wing,2013,31476,29262,2214,7.0
27,37,Dakota,2013,229949,219363,10586,4.6
27,39,Dodge,2013,11342,10797,545,4.8
27,41,Douglas,2013,19892,18996,896,4.5
27,43,Faribault,2013,7503,7092,411,5.5
27,45,Fillmore,2013,11117,10551,566,5.1
27,47,Freeborn,2013,16476,15643,833,5.1
27,49,Goodhue,2013,26849,25571,1278,4.8
27,51,Grant,2013,3286,3095,191,5.8
27,53,Hennepin,2013,667509,636456,31053,4.7
27,55,Houston,2013,10488,9955,533,5.1
27,57,Hubbard,2013,9545,8847,698,7.3
27,59,Isanti,2013,20226,18994,1232,6.1
27,61,Itasca,2013,21954,20243,1711,7.8
27,63,Jackson,2013,6234,5972,262,4.2
27,65,Kanabec,2013,8807,8079,728,8.3
27,67,Kandiyohi,2013,23495,22362,1133,4.8
27,69,Kittson,2013,2421,2274,147,6.1
27,71,Koochiching,2013,6737,6170,567,8.4
27,73,Lac qui Parle,2013,3670,3462,208,5.7
27,75,Lake,2013,5782,5418,364,6.3
27,77,Lake of the Woods,2013,2377,2240,137,5.8
27,79,Le Sueur,2013,15517,14557,960,6.2
27,81,Lincoln,2013,3313,3158,155,4.7
27,83,Lyon,2013,15295,14653,642,4.2
27,85,McLeod,2013,20041,18903,1138,5.7
27,87,Mahnomen,2013,2400,2259,141,5.9
27,89,Marshall,2013,5577,5144,433,7.8
27,91,Martin,2013,10346,9793,553,5.3
27,93,Meeker,2013,12756,12039,717,5.6
27,95,Mille Lacs,2013,12695,11730,965,7.6
27,97,Morrison,2013,17702,16490,1212,6.8
27,99,Mower,2013,20494,19562,932,4.5
27,101,Murray,2013,4842,4580,262,5.4
27,103,Nicollet,2013,19732,18983,749,3.8
27,105,Nobles,2013,11071,10618,453,4.1
27,107,Norman,2013,3316,3123,193,5.8
27,109,Olmsted,2013,83450,80055,3395,4.1
27,111,Otter Tail,2013,30899,29252,1647,5.3
27,113,Pennington,2013,8667,8111,556,6.4
27,115,Pine,2013,14851,13808,1043,7.0
27,117,Pipestone,2013,4693,4474,219,4.7
27,119,Polk,2013,17119,16184,935,5.5
27,121,Pope,2013,5969,5711,258,4.3
27,123,Ramsey,2013,275512,261780,13732,5.0
27,125,Red Lake,2013,2258,2104,154,6.8
27,127,Redwood,2013,8059,7611,448,5.6
27,129,Renville,2013,8249,7704,545,6.6
27,131,Rice,2013,35028,33269,1759,5.0
27,133,Rock,2013,5631,5448,183,3.2
27,135,Roseau,2013,8622,8237,385,4.5
27,137,St. Louis,2013,102344,96053,6291,6.1
27,139,Scott,2013,77045,73616,3429,4.5
27,141,Sherburne,2013,48841,46196,2645,5.4
27,143,Sibley,2013,8329,7865,464,5.6
27,145,Stearns,2013,86778,82466,4312,5.0
27,147,Steele,2013,21415,20423,992,4.6
27,149,Stevens,2013,5514,5304,210,3.8
27,151,Swift,2013,4900,4611,289,5.9
27,153,Todd,2013,12864,12169,695,5.4
27,155,Traverse,2013,1661,1576,85,5.1
27,157,Wabasha,2013,11841,11287,554,4.7
27,159,Wadena,2013,6174,5737,437,7.1
27,161,Waseca,2013,9937,9382,555,5.6
27,163,Washington,2013,135014,128944,6070,4.5
27,165,Watonwan,2013,6186,5855,331,5.4
27,167,Wilkin,2013,3628,3475,153,4.2
27,169,Winona,2013,29609,28295,1314,4.4
27,171,Wright,2013,70633,67015,3618,5.1
27,173,Yellow Medicine,2013,5546,5270,276,5.0
28,1,Adams,2013,11841,10742,1099,9.3
28,3,Alcorn,2013,15387,14198,1189,7.7
28,5,Amite,2013,4552,4138,414,9.1
28,7,Attala,2013,7253,6578,675,9.3
28,9,Benton,2013,3138,2811,327,10.4
28,11,Bolivar,2013,13800,12332,1468,10.6
28,13,Calhoun,2013,6406,5870,536,8.4
28,15,Carroll,2013,3474,3109,365,10.5
28,17,Chickasaw,2013,7615,6805,810,10.6
28,19,Choctaw,2013,3749,3431,318,8.5
28,21,Claiborne,2013,3299,2741,558,16.9
28,23,Clarke,2013,6658,5998,660,9.9
28,25,Clay,2013,8390,7101,1289,15.4
28,27,Coahoma,2013,9815,8555,1260,12.8
28,29,Copiah,2013,11478,10278,1200,10.5
28,31,Covington,2013,7960,7336,624,7.8
28,33,DeSoto,2013,81152,76379,4773,5.9
28,35,Forrest,2013,33107,30338,2769,8.4
28,37,Franklin,2013,2956,2684,272,9.2
28,39,George,2013,8568,7764,804,9.4
28,41,Greene,2013,4438,3988,450,10.1
28,43,Grenada,2013,9337,8517,820,8.8
28,45,Hancock,2013,18939,17461,1478,7.8
28,47,Harrison,2013,86667,80193,6474,7.5
28,49,Hinds,2013,110799,101471,9328,8.4
28,51,Holmes,2013,6302,5252,1050,16.7
28,53,Humphreys,2013,3052,2531,521,17.1
28,55,Issaquena,2013,446,355,91,20.4
28,57,Itawamba,2013,10033,9232,801,8.0
28,59,Jackson,2013,60970,55587,5383,8.8
28,61,Jasper,2013,6516,5872,644,9.9
28,63,Jefferson,2013,2480,2005,475,19.2
28,65,Jefferson Davis,2013,4220,3690,530,12.6
28,67,Jones,2013,27362,25441,1921,7.0
28,69,Kemper,2013,3957,3450,507,12.8
28,71,Lafayette,2013,23049,21408,1641,7.1
28,73,Lamar,2013,27548,25929,1619,5.9
28,75,Lauderdale,2013,34600,31730,2870,8.3
28,77,Lawrence,2013,4719,4285,434,9.2
28,79,Leake,2013,8112,7422,690,8.5
28,81,Lee,2013,39576,36430,3146,7.9
28,83,Leflore,2013,10740,9215,1525,14.2
28,85,Lincoln,2013,13924,12859,1065,7.6
28,87,Lowndes,2013,26987,24493,2494,9.2
28,89,Madison,2013,49794,46896,2898,5.8
28,91,Marion,2013,9940,9008,932,9.4
28,93,Marshall,2013,14812,13316,1496,10.1
28,95,Monroe,2013,15510,13693,1817,11.7
28,97,Montgomery,2013,4376,3884,492,11.2
28,99,Neshoba,2013,10964,10114,850,7.8
28,101,Newton,2013,8985,8319,666,7.4
28,103,Noxubee,2013,4089,3543,546,13.4
28,105,Oktibbeha,2013,22220,20463,1757,7.9
28,107,Panola,2013,13679,12058,1621,11.9
28,109,Pearl River,2013,22838,21155,1683,7.4
28,111,Perry,2013,4251,3811,440,10.4
28,113,Pike,2013,14650,13219,1431,9.8
28,115,Pontotoc,2013,13676,12671,1005,7.3
28,117,Prentiss,2013,10952,10032,920,8.4
28,119,Quitman,2013,2858,2436,422,14.8
28,121,Rankin,2013,71275,67569,3706,5.2
28,123,Scott,2013,12748,11911,837,6.6
28,125,Sharkey,2013,1844,1605,239,13.0
28,127,Simpson,2013,10954,10147,807,7.4
28,129,Smith,2013,6844,6386,458,6.7
28,131,Stone,2013,6464,5851,613,9.5
28,133,Sunflower,2013,8996,7751,1245,13.8
28,135,Tallahatchie,2013,5810,5166,644,11.1
28,137,Tate,2013,11972,10912,1060,8.9
28,139,Tippah,2013,8738,7886,852,9.8
28,141,Tishomingo,2013,7698,6991,707,9.2
28,143,Tunica,2013,4793,4200,593,12.4
28,145,Union,2013,13084,12160,924,7.1
28,147,Walthall,2013,5297,4734,563,10.6
28,149,Warren,2013,21643,19707,1936,8.9
28,151,Washington,2013,19122,16358,2764,14.5
28,153,Wayne,2013,7896,7055,841,10.7
28,155,Webster,2013,4070,3685,385,9.5
28,157,Wilkinson,2013,2985,2616,369,12.4
28,159,Winston,2013,7391,6581,810,11.0
28,161,Yalobusha,2013,5026,4527,499,9.9
28,163,Yazoo,2013,9446,8412,1034,10.9
29,1,Adair,2013,10745,10001,744,6.9
29,3,Andrew,2013,9864,9331,533,5.4
29,5,Atchison,2013,2872,2703,169,5.9
29,7,Audrain,2013,11203,10487,716,6.4
29,9,Barry,2013,14860,13837,1023,6.9
29,11,Barton,2013,5474,5078,396,7.2
29,13,Bates,2013,7978,7363,615,7.7
29,15,Benton,2013,7237,6616,621,8.6
29,17,Bollinger,2013,5735,5325,410,7.1
29,19,Boone,2013,97230,92812,4418,4.5
29,21,Buchanan,2013,46447,43537,2910,6.3
29,23,Butler,2013,18656,17173,1483,7.9
29,25,Caldwell,2013,4335,4042,293,6.8
29,27,Callaway,2013,21563,20254,1309,6.1
29,29,Camden,2013,18757,17009,1748,9.3
29,31,Cape Girardeau,2013,40786,38417,2369,5.8
29,33,Carroll,2013,4665,4320,345,7.4
29,35,Carter,2013,2541,2296,245,9.6
29,37,Cass,2013,52126,48813,3313,6.4
29,39,Cedar,2013,5861,5445,416,7.1
29,41,Chariton,2013,3729,3493,236,6.3
29,43,Christian,2013,40907,38654,2253,5.5
29,45,Clark,2013,3351,3083,268,8.0
29,47,Clay,2013,126423,118669,7754,6.1
29,49,Clinton,2013,10721,10005,716,6.7
29,51,Cole,2013,39626,37530,2096,5.3
29,53,Cooper,2013,7668,7131,537,7.0
29,55,Crawford,2013,10869,9931,938,8.6
29,57,Dade,2013,3440,3203,237,6.9
29,59,Dallas,2013,6941,6336,605,8.7
29,61,Daviess,2013,4061,3806,255,6.3
29,63,DeKalb,2013,5025,4720,305,6.1
29,65,Dent,2013,6237,5762,475,7.6
29,67,Douglas,2013,5058,4579,479,9.5
29,69,Dunklin,2013,12973,11675,1298,10.0
29,71,Franklin,2013,51494,47750,3744,7.3
29,73,Gasconade,2013,7518,7038,480,6.4
29,75,Gentry,2013,3587,3397,190,5.3
29,77,Greene,2013,144083,136072,8011,5.6
29,79,Grundy,2013,4906,4617,289,5.9
29,81,Harrison,2013,3955,3663,292,7.4
29,83,Henry,2013,9839,9129,710,7.2
29,85,Hickory,2013,3679,3310,369,10.0
29,87,Holt,2013,2734,2585,149,5.4
29,89,Howard,2013,4912,4592,320,6.5
29,91,Howell,2013,16369,15075,1294,7.9
29,93,Iron,2013,3921,3501,420,10.7
29,95,Jackson,2013,352116,324929,27187,7.7
29,97,Jasper,2013,57802,54396,3406,5.9
29,99,Jefferson,2013,114506,106651,7855,6.9
29,101,Johnson,2013,22876,21203,1673,7.3
29,103,Knox,2013,1979,1869,110,5.6
29,105,Laclede,2013,15555,14048,1507,9.7
29,107,Lafayette,2013,16869,15773,1096,6.5
29,109,Lawrence,2013,17373,16216,1157,6.7
29,111,Lewis,2013,5066,4782,284,5.6
29,113,Lincoln,2013,26241,24232,2009,7.7
29,115,Linn,2013,5303,4831,472,8.9
29,117,Livingston,2013,7247,6834,413,5.7
29,119,McDonald,2013,9949,9304,645,6.5
29,121,Macon,2013,7403,6915,488,6.6
29,123,Madison,2013,5550,5120,430,7.7
29,125,Maries,2013,4166,3889,277,6.6
29,127,Marion,2013,14592,13706,886,6.1
29,129,Mercer,2013,1803,1704,99,5.5
29,131,Miller,2013,11466,10454,1012,8.8
29,133,Mississippi,2013,6285,5790,495,7.9
29,135,Moniteau,2013,7296,6828,468,6.4
29,137,Monroe,2013,4100,3796,304,7.4
29,139,Montgomery,2013,5703,5288,415,7.3
29,141,Morgan,2013,7830,7082,748,9.6
29,143,New Madrid,2013,8266,7610,656,7.9
29,145,Newton,2013,28851,27098,1753,6.1
29,147,Nodaway,2013,11323,10575,748,6.6
29,149,Oregon,2013,4125,3794,331,8.0
29,151,Osage,2013,7184,6823,361,5.0
29,153,Ozark,2013,3668,3285,383,10.4
29,155,Pemiscot,2013,7083,6344,739,10.4
29,157,Perry,2013,10106,9552,554,5.5
29,159,Pettis,2013,20021,18693,1328,6.6
29,161,Phelps,2013,19297,17929,1368,7.1
29,163,Pike,2013,8073,7542,531,6.6
29,165,Platte,2013,52579,49573,3006,5.7
29,167,Polk,2013,13878,12880,998,7.2
29,169,Pulaski,2013,15581,14333,1248,8.0
29,171,Putnam,2013,2443,2297,146,6.0
29,173,Ralls,2013,5588,5261,327,5.9
29,175,Randolph,2013,10505,9637,868,8.3
29,177,Ray,2013,11098,10234,864,7.8
29,179,Reynolds,2013,2515,2276,239,9.5
29,181,Ripley,2013,5538,5021,517,9.3
29,183,St. Charles,2013,206401,195328,11073,5.4
29,185,St. Clair,2013,3907,3600,307,7.9
29,186,Ste. Genevieve,2013,8996,8340,656,7.3
29,187,St. Francois,2013,26222,23957,2265,8.6
29,189,St. Louis,2013,522762,489821,32941,6.3
29,195,Saline,2013,11056,10389,667,6.0
29,197,Schuyler,2013,1897,1747,150,7.9
29,199,Scotland,2013,2368,2240,128,5.4
29,201,Scott,2013,19767,18345,1422,7.2
29,203,Shannon,2013,3359,3036,323,9.6
29,205,Shelby,2013,3053,2881,172,5.6
29,207,Stoddard,2013,13192,12015,1177,8.9
29,209,Stone,2013,13563,12125,1438,10.6
29,211,Sullivan,2013,2707,2530,177,6.5
29,213,Taney,2013,25773,23004,2769,10.7
29,215,Texas,2013,9680,8879,801,8.3
29,217,Vernon,2013,9750,9168,582,6.0
29,219,Warren,2013,16817,15656,1161,6.9
29,221,Washington,2013,10445,9420,1025,9.8
29,223,Wayne,2013,5624,5155,469,8.3
29,225,Webster,2013,15866,14784,1082,6.8
29,227,Worth,2013,1314,1260,54,4.1
29,229,Wright,2013,7579,6936,643,8.5
29,510,St. Louis city,2013,159342,145939,13403,8.4
30,1,Beaverhead,2013,4845,4619,226,4.7
30,3,Big Horn,2013,5700,4908,792,13.9
30,5,Blaine,2013,2473,2323,150,6.1
30,7,Broadwater,2013,2509,2351,158,6.3
30,9,Carbon,2013,5401,5162,239,4.4
30,11,Carter,2013,673,652,21,3.1
30,13,Cascade,2013,38421,36478,1943,5.1
30,15,Chouteau,2013,2588,2494,94,3.6
30,17,Custer,2013,6639,6419,220,3.3
30,19,Daniels,2013,934,904,30,3.2
30,21,Dawson,2013,4812,4662,150,3.1
30,23,Deer Lodge,2013,5213,4959,254,4.9
30,25,Fallon,2013,2041,2001,40,2.0
30,27,Fergus,2013,5876,5591,285,4.9
30,29,Flathead,2013,43860,40529,3331,7.6
30,31,Gallatin,2013,54837,52604,2233,4.1
30,33,Garfield,2013,762,738,24,3.1
30,35,Glacier,2013,6342,5709,633,10.0
30,37,Golden Valley,2013,397,377,20,5.0
30,39,Granite,2013,1502,1389,113,7.5
30,41,Hill,2013,7944,7427,517,6.5
30,43,Jefferson,2013,5613,5341,272,4.8
30,45,Judith Basin,2013,978,931,47,4.8
30,47,Lake,2013,12378,11583,795,6.4
30,49,Lewis and Clark,2013,35098,33587,1511,4.3
30,51,Liberty,2013,993,959,34,3.4
30,53,Lincoln,2013,8120,7079,1041,12.8
30,55,McCone,2013,1097,1071,26,2.4
30,57,Madison,2013,4164,3937,227,5.5
30,59,Meagher,2013,933,884,49,5.3
30,61,Mineral,2013,1781,1597,184,10.3
30,63,Missoula,2013,59447,56397,3050,5.1
30,65,Musselshell,2013,2377,2259,118,5.0
30,67,Park,2013,8016,7513,503,6.3
30,69,Petroleum,2013,293,280,13,4.4
30,71,Phillips,2013,2059,1939,120,5.8
30,73,Pondera,2013,2904,2762,142,4.9
30,75,Powder River,2013,1126,1089,37,3.3
30,77,Powell,2013,2948,2786,162,5.5
30,79,Prairie,2013,521,498,23,4.4
30,81,Ravalli,2013,18759,17510,1249,6.7
30,83,Richland,2013,7078,6895,183,2.6
30,85,Roosevelt,2013,4925,4657,268,5.4
30,87,Rosebud,2013,4203,3937,266,6.3
30,89,Sanders,2013,4740,4249,491,10.4
30,91,Sheridan,2013,2174,2114,60,2.8
30,93,Silver Bow,2013,17190,16262,928,5.4
30,95,Stillwater,2013,5069,4867,202,4.0
30,97,Sweet Grass,2013,1770,1705,65,3.7
30,99,Teton,2013,2956,2830,126,4.3
30,101,Toole,2013,2389,2298,91,3.8
30,103,Treasure,2013,355,339,16,4.5
30,105,Valley,2013,4248,4089,159,3.7
30,107,Wheatland,2013,826,775,51,6.2
30,109,Wibaux,2013,559,540,19,3.4
30,111,Yellowstone,2013,79347,75946,3401,4.3
31,1,Adams,2013,16906,16305,601,3.6
31,3,Antelope,2013,3607,3494,113,3.1
31,5,Arthur,2013,219,203,16,7.3
31,7,Banner,2013,435,416,19,4.4
31,9,Blaine,2013,272,258,14,5.1
31,11,Boone,2013,3049,2952,97,3.2
31,13,Box Butte,2013,5967,5742,225,3.8
31,15,Boyd,2013,1125,1087,38,3.4
31,17,Brown,2013,1432,1377,55,3.8
31,19,Buffalo,2013,27351,26486,865,3.2
31,21,Burt,2013,3645,3483,162,4.4
31,23,Butler,2013,4775,4617,158,3.3
31,25,Cass,2013,13274,12711,563,4.2
31,27,Cedar,2013,4718,4582,136,2.9
31,29,Chase,2013,2399,2343,56,2.3
31,31,Cherry,2013,3480,3386,94,2.7
31,33,Cheyenne,2013,5801,5641,160,2.8
31,35,Clay,2013,3492,3375,117,3.4
31,37,Colfax,2013,5607,5414,193,3.4
31,39,Cuming,2013,4945,4798,147,3.0
31,41,Custer,2013,6143,5976,167,2.7
31,43,Dakota,2013,11174,10661,513,4.6
31,45,Dawes,2013,5411,5221,190,3.5
31,47,Dawson,2013,13230,12737,493,3.7
31,49,Deuel,2013,1130,1093,37,3.3
31,51,Dixon,2013,3112,2998,114,3.7
31,53,Dodge,2013,19192,18403,789,4.1
31,55,Douglas,2013,285565,273993,11572,4.1
31,57,Dundy,2013,1300,1265,35,2.7
31,59,Fillmore,2013,3296,3199,97,2.9
31,61,Franklin,2013,1595,1540,55,3.4
31,63,Frontier,2013,1593,1540,53,3.3
31,65,Furnas,2013,2722,2629,93,3.4
31,67,Gage,2013,11088,10590,498,4.5
31,69,Garden,2013,1233,1199,34,2.8
31,71,Garfield,2013,1228,1191,37,3.0
31,73,Gosper,2013,1162,1123,39,3.4
31,75,Grant,2013,419,405,14,3.3
31,77,Greeley,2013,1296,1252,44,3.4
31,79,Hall,2013,32476,31297,1179,3.6
31,81,Hamilton,2013,4838,4687,151,3.1
31,83,Harlan,2013,1857,1801,56,3.0
31,85,Hayes,2013,645,624,21,3.3
31,87,Hitchcock,2013,1359,1305,54,4.0
31,89,Holt,2013,5995,5811,184,3.1
31,91,Hooker,2013,433,413,20,4.6
31,93,Howard,2013,3413,3291,122,3.6
31,95,Jefferson,2013,4332,4175,157,3.6
31,97,Johnson,2013,2178,2086,92,4.2
31,99,Kearney,2013,3893,3786,107,2.7
31,101,Keith,2013,4697,4532,165,3.5
31,103,Keya Paha,2013,609,589,20,3.3
31,105,Kimball,2013,2192,2121,71,3.2
31,107,Knox,2013,4792,4627,165,3.4
31,109,Lancaster,2013,168376,162683,5693,3.4
31,111,Lincoln,2013,19181,18471,710,3.7
31,113,Logan,2013,502,486,16,3.2
31,115,Loup,2013,377,360,17,4.5
31,117,McPherson,2013,371,357,14,3.8
31,119,Madison,2013,19293,18634,659,3.4
31,121,Merrick,2013,4195,4043,152,3.6
31,123,Morrill,2013,2746,2660,86,3.1
31,125,Nance,2013,2072,2007,65,3.1
31,127,Nemaha,2013,3810,3624,186,4.9
31,129,Nuckolls,2013,2450,2373,77,3.1
31,131,Otoe,2013,8409,8058,351,4.2
31,133,Pawnee,2013,1679,1628,51,3.0
31,135,Perkins,2013,1817,1772,45,2.5
31,137,Phelps,2013,5077,4930,147,2.9
31,139,Pierce,2013,4210,4072,138,3.3
31,141,Platte,2013,17693,17093,600,3.4
31,143,Polk,2013,2991,2891,100,3.3
31,145,Red Willow,2013,6418,6233,185,2.9
31,147,Richardson,2013,4351,4160,191,4.4
31,149,Rock,2013,884,857,27,3.1
31,151,Saline,2013,7374,7067,307,4.2
31,153,Sarpy,2013,88979,85854,3125,3.5
31,155,Saunders,2013,11139,10700,439,3.9
31,157,Scotts Bluff,2013,19093,18309,784,4.1
31,159,Seward,2013,8992,8668,324,3.6
31,161,Sheridan,2013,2792,2703,89,3.2
31,163,Sherman,2013,1735,1678,57,3.3
31,165,Sioux,2013,803,777,26,3.2
31,167,Stanton,2013,3681,3561,120,3.3
31,169,Thayer,2013,3048,2965,83,2.7
31,171,Thomas,2013,453,436,17,3.8
31,173,Thurston,2013,3091,2860,231,7.5
31,175,Valley,2013,2136,2067,69,3.2
31,177,Washington,2013,11103,10704,399,3.6
31,179,Wayne,2013,5671,5495,176,3.1
31,181,Webster,2013,1741,1675,66,3.8
31,183,Wheeler,2013,524,507,17,3.2
31,185,York,2013,7481,7218,263,3.5
32,1,Churchill,2013,10832,9768,1064,9.8
32,3,Clark,2013,998095,898037,100058,10.0
32,5,Douglas,2013,22466,20199,2267,10.1
32,7,Elko,2013,28506,26670,1836,6.4
32,9,Esmeralda,2013,537,510,27,5.0
32,11,Eureka,2013,1080,1012,68,6.3
32,13,Humboldt,2013,8997,8400,597,6.6
32,15,Lander,2013,3488,3221,267,7.7
32,17,Lincoln,2013,2001,1802,199,9.9
32,19,Lyon,2013,22209,19274,2935,13.2
32,21,Mineral,2013,1829,1592,237,13.0
32,23,Nye,2013,16244,14199,2045,12.6
32,27,Pershing,2013,2598,2357,241,9.3
32,29,Storey,2013,1883,1657,226,12.0
32,31,Washoe,2013,219924,198371,21553,9.8
32,33,White Pine,2013,4824,4455,369,7.6
32,510,Carson City,2013,25214,22498,2716,10.8
33,1,Belknap,2013,32065,30409,1656,5.2
33,3,Carroll,2013,24484,23244,1240,5.1
33,5,Cheshire,2013,42041,39986,2055,4.9
33,7,Coos,2013,15968,14970,998,6.3
33,9,Grafton,2013,48468,46354,2114,4.4
33,11,Hillsborough,2013,228328,215682,12646,5.5
33,13,Merrimack,2013,81058,77194,3864,4.8
33,15,Rockingham,2013,176171,166293,9878,5.6
33,17,Strafford,2013,70313,66775,3538,5.0
33,19,Sullivan,2013,24141,23116,1025,4.2
34,1,Atlantic,2013,137026,120708,16318,11.9
34,3,Bergen,2013,479206,446419,32787,6.8
34,5,Burlington,2013,231401,213204,18197,7.9
34,7,Camden,2013,256437,231814,24623,9.6
34,9,Cape May,2013,49197,42045,7152,14.5
34,11,Cumberland,2013,69400,61091,8309,12.0
34,13,Essex,2013,378822,341431,37391,9.9
34,15,Gloucester,2013,149336,135597,13739,9.2
34,17,Hudson,2013,357976,329267,28709,8.0
34,19,Hunterdon,2013,66335,62381,3954,6.0
34,21,Mercer,2013,193802,179449,14353,7.4
34,23,Middlesex,2013,429609,396541,33068,7.7
34,25,Monmouth,2013,326889,301750,25139,7.7
34,27,Morris,2013,264055,247450,16605,6.3
34,29,Ocean,2013,265507,240364,25143,9.5
34,31,Passaic,2013,250056,224660,25396,10.2
34,33,Salem,2013,31660,28292,3368,10.6
34,35,Somerset,2013,174071,162820,11251,6.5
34,37,Sussex,2013,79141,72740,6401,8.1
34,39,Union,2013,280500,256537,23963,8.5
34,41,Warren,2013,57592,53100,4492,7.8
35,1,Bernalillo,2013,321539,300844,20695,6.4
35,3,Catron,2013,1248,1137,111,8.9
35,5,Chaves,2013,26792,25117,1675,6.3
35,6,Cibola,2013,9173,8383,790,8.6
35,7,Colfax,2013,6210,5772,438,7.1
35,9,Curry,2013,21556,20457,1099,5.1
35,11,De Baca,2013,814,777,37,4.5
35,13,Dona Ana,2013,94284,87259,7025,7.5
35,15,Eddy,2013,27837,26565,1272,4.6
35,17,Grant,2013,12919,12048,871,6.7
35,19,Guadalupe,2013,1641,1499,142,8.7
35,21,Harding,2013,286,271,15,5.2
35,23,Hidalgo,2013,2187,2023,164,7.5
35,25,Lea,2013,29488,28173,1315,4.5
35,27,Lincoln,2013,8858,8290,568,6.4
35,28,Los Alamos,2013,8673,8308,365,4.2
35,29,Luna,2013,11362,9210,2152,18.9
35,31,McKinley,2013,24447,21984,2463,10.1
35,33,Mora,2013,2267,2003,264,11.6
35,35,Otero,2013,25397,23784,1613,6.4
35,37,Quay,2013,3326,3085,241,7.2
35,39,Rio Arriba,2013,16738,15148,1590,9.5
35,41,Roosevelt,2013,8392,7926,466,5.6
35,43,Sandoval,2013,60938,56417,4521,7.4
35,45,San Juan,2013,54873,51165,3708,6.8
35,47,San Miguel,2013,11155,10230,925,8.3
35,49,Santa Fe,2013,73660,69565,4095,5.6
35,51,Sierra,2013,4013,3623,390,9.7
35,53,Socorro,2013,6652,6163,489,7.4
35,55,Taos,2013,15135,13577,1558,10.3
35,57,Torrance,2013,5629,5056,573,10.2
35,59,Union,2013,1876,1790,86,4.6
35,61,Valencia,2013,30046,27560,2486,8.3
36,1,Albany,2013,160574,150583,9991,6.2
36,3,Allegany,2013,23773,21945,1828,7.7
36,5,Bronx,2013,600525,530049,70476,11.7
36,7,Broome,2013,91828,84512,7316,8.0
36,9,Cattaraugus,2013,38072,34742,3330,8.7
36,11,Cayuga,2013,38810,35875,2935,7.6
36,13,Chautauqua,2013,60159,55211,4948,8.2
36,15,Chemung,2013,39572,36364,3208,8.1
36,17,Chenango,2013,24071,22265,1806,7.5
36,19,Clinton,2013,37145,33977,3168,8.5
36,21,Columbia,2013,31801,29841,1960,6.2
36,23,Cortland,2013,24285,22356,1929,7.9
36,25,Delaware,2013,21030,19333,1697,8.1
36,27,Dutchess,2013,145403,135453,9950,6.8
36,29,Erie,2013,459781,424800,34981,7.6
36,31,Essex,2013,18095,16561,1534,8.5
36,33,Franklin,2013,21529,19578,1951,9.1
36,35,Fulton,2013,24724,22323,2401,9.7
36,37,Genesee,2013,30500,28357,2143,7.0
36,39,Greene,2013,21339,19422,1917,9.0
36,41,Hamilton,2013,2430,2191,239,9.8
36,43,Herkimer,2013,29975,27569,2406,8.0
36,45,Jefferson,2013,48298,43729,4569,9.5
36,47,Kings,2013,1206307,1093739,112568,9.3
36,49,Lewis,2013,12239,11052,1187,9.7
36,51,Livingston,2013,31843,29547,2296,7.2
36,53,Madison,2013,34385,31702,2683,7.8
36,55,Monroe,2013,374202,347423,26779,7.2
36,57,Montgomery,2013,23163,20982,2181,9.4
36,59,Nassau,2013,696036,653821,42215,6.1
36,61,New York,2013,900600,833170,67430,7.5
36,63,Niagara,2013,104967,95856,9111,8.7
36,65,Oneida,2013,107128,98964,8164,7.6
36,67,Onondaga,2013,231423,215189,16234,7.0
36,69,Ontario,2013,55834,52231,3603,6.5
36,71,Orange,2013,178723,166198,12525,7.0
36,73,Orleans,2013,18699,16956,1743,9.3
36,75,Oswego,2013,57193,51407,5786,10.1
36,77,Otsego,2013,31094,28920,2174,7.0
36,79,Putnam,2013,51300,48099,3201,6.2
36,81,Queens,2013,1137783,1049995,87788,7.7
36,83,Rensselaer,2013,83391,77684,5707,6.8
36,85,Richmond,2013,220021,200334,19687,8.9
36,87,Rockland,2013,150571,140889,9682,6.4
36,89,St. Lawrence,2013,48468,43931,4537,9.4
36,91,Saratoga,2013,117926,110894,7032,6.0
36,93,Schenectady,2013,77957,72602,5355,6.9
36,95,Schoharie,2013,15287,14013,1274,8.3
36,97,Schuyler,2013,8873,8073,800,9.0
36,99,Seneca,2013,15901,14770,1131,7.1
36,101,Steuben,2013,45649,41698,3951,8.7
36,103,Suffolk,2013,780519,727742,52777,6.8
36,105,Sullivan,2013,34561,31677,2884,8.3
36,107,Tioga,2013,24943,23121,1822,7.3
36,109,Tompkins,2013,55830,52848,2982,5.3
36,111,Ulster,2013,90249,83635,6614,7.3
36,113,Warren,2013,33115,30340,2775,8.4
36,115,Washington,2013,29383,27135,2248,7.7
36,117,Wayne,2013,45916,42348,3568,7.8
36,119,Westchester,2013,476999,446382,30617,6.4
36,121,Wyoming,2013,18800,17272,1528,8.1
36,123,Yates,2013,11961,11122,839,7.0
37,1,Alamance,2013,77398,71939,5459,7.1
37,3,Alexander,2013,17513,16189,1324,7.6
37,5,Alleghany,2013,4425,4047,378,8.5
37,7,Anson,2013,10934,9928,1006,9.2
37,9,Ashe,2013,12877,11725,1152,8.9
37,11,Avery,2013,7699,7029,670,8.7
37,13,Beaufort,2013,20483,18592,1891,9.2
37,15,Bertie,2013,8470,7641,829,9.8
37,17,Bladen,2013,14356,12746,1610,11.2
37,19,Brunswick,2013,47749,43204,4545,9.5
37,21,Buncombe,2013,127980,120533,7447,5.8
37,23,Burke,2013,40173,36937,3236,8.1
37,25,Cabarrus,2013,92401,85569,6832,7.4
37,27,Caldwell,2013,36422,33027,3395,9.3
37,29,Camden,2013,4531,4218,313,6.9
37,31,Carteret,2013,31237,28867,2370,7.6
37,33,Caswell,2013,9873,9009,864,8.8
37,35,Catawba,2013,76133,69845,6288,8.3
37,37,Chatham,2013,31632,29700,1932,6.1
37,39,Cherokee,2013,11281,10269,1012,9.0
37,41,Chowan,2013,5728,5180,548,9.6
37,43,Clay,2013,4061,3715,346,8.5
37,45,Cleveland,2013,46592,42291,4301,9.2
37,47,Columbus,2013,24109,21695,2414,10.0
37,49,Craven,2013,41528,38026,3502,8.4
37,51,Cumberland,2013,130999,118696,12303,9.4
37,53,Currituck,2013,12628,11660,968,7.7
37,55,Dare,2013,20555,18323,2232,10.9
37,57,Davidson,2013,79435,73107,6328,8.0
37,59,Davie,2013,20000,18542,1458,7.3
37,61,Duplin,2013,26494,24439,2055,7.8
37,63,Durham,2013,150701,141530,9171,6.1
37,65,Edgecombe,2013,23964,20937,3027,12.6
37,67,Forsyth,2013,177824,164762,13062,7.3
37,69,Franklin,2013,28284,26014,2270,8.0
37,71,Gaston,2013,100951,92165,8786,8.7
37,73,Gates,2013,5266,4910,356,6.8
37,75,Graham,2013,3517,2993,524,14.9
37,77,Granville,2013,28396,26507,1889,6.7
37,79,Greene,2013,9426,8705,721,7.6
37,81,Guilford,2013,255657,235225,20432,8.0
37,83,Halifax,2013,21772,19276,2496,11.5
37,85,Harnett,2013,49742,45276,4466,9.0
37,87,Haywood,2013,27641,25536,2105,7.6
37,89,Henderson,2013,49173,46201,2972,6.0
37,91,Hertford,2013,9515,8646,869,9.1
37,93,Hoke,2013,19778,17883,1895,9.6
37,95,Hyde,2013,2164,1919,245,11.3
37,97,Iredell,2013,79556,73084,6472,8.1
37,99,Jackson,2013,18456,16875,1581,8.6
37,101,Johnston,2013,84615,78785,5830,6.9
37,103,Jones,2013,4547,4174,373,8.2
37,105,Lee,2013,26107,23532,2575,9.9
37,107,Lenoir,2013,28544,26133,2411,8.4
37,109,Lincoln,2013,39944,36739,3205,8.0
37,111,McDowell,2013,20459,18672,1787,8.7
37,113,Macon,2013,15229,13871,1358,8.9
37,115,Madison,2013,9504,8747,757,8.0
37,117,Martin,2013,10116,9087,1029,10.2
37,119,Mecklenburg,2013,538164,498854,39310,7.3
37,121,Mitchell,2013,6679,5961,718,10.8
37,123,Montgomery,2013,11699,10757,942,8.1
37,125,Moore,2013,37972,35104,2868,7.6
37,127,Nash,2013,45378,40816,4562,10.1
37,129,New Hanover,2013,109725,101673,8052,7.3
37,131,Northampton,2013,8168,7375,793,9.7
37,133,Onslow,2013,64175,59787,4388,6.8
37,135,Orange,2013,72832,69076,3756,5.2
37,137,Pamlico,2013,5339,4903,436,8.2
37,139,Pasquotank,2013,17696,16041,1655,9.4
37,141,Pender,2013,25062,22861,2201,8.8
37,143,Perquimans,2013,5230,4743,487,9.3
37,145,Person,2013,18310,16515,1795,9.8
37,147,Pitt,2013,88034,81135,6899,7.8
37,149,Polk,2013,8686,8126,560,6.4
37,151,Randolph,2013,68069,62344,5725,8.4
37,153,Richmond,2013,17446,15451,1995,11.4
37,155,Robeson,2013,52139,46133,6006,11.5
37,157,Rockingham,2013,42210,38236,3974,9.4
37,159,Rowan,2013,62906,57235,5671,9.0
37,161,Rutherford,2013,25961,23137,2824,10.9
37,163,Sampson,2013,29714,27381,2333,7.9
37,165,Scotland,2013,12242,10448,1794,14.7
37,167,Stanly,2013,28907,26610,2297,7.9
37,169,Stokes,2013,22222,20524,1698,7.6
37,171,Surry,2013,33339,30636,2703,8.1
37,173,Swain,2013,6607,5807,800,12.1
37,175,Transylvania,2013,13427,12458,969,7.2
37,177,Tyrrell,2013,1563,1366,197,12.6
37,179,Union,2013,105927,99180,6747,6.4
37,181,Vance,2013,18140,16114,2026,11.2
37,183,Wake,2013,512481,482605,29876,5.8
37,185,Warren,2013,7307,6529,778,10.6
37,187,Washington,2013,5303,4660,643,12.1
37,189,Watauga,2013,27019,25339,1680,6.2
37,191,Wayne,2013,54876,50734,4142,7.5
37,193,Wilkes,2013,30000,27393,2607,8.7
37,195,Wilson,2013,38163,33805,4358,11.4
37,197,Yadkin,2013,17916,16567,1349,7.5
37,199,Yancey,2013,7821,7094,727,9.3
38,1,Adams,2013,1097,1070,27,2.5
38,3,Barnes,2013,5646,5467,179,3.2
38,5,Benson,2013,2518,2328,190,7.5
38,7,Billings,2013,469,456,13,2.8
38,9,Bottineau,2013,3222,3098,124,3.8
38,11,Bowman,2013,1975,1936,39,2.0
38,13,Burke,2013,1372,1342,30,2.2
38,15,Burleigh,2013,46801,45644,1157,2.5
38,17,Cass,2013,90391,87915,2476,2.7
38,19,Cavalier,2013,2053,1986,67,3.3
38,21,Dickey,2013,2631,2570,61,2.3
38,23,Divide,2013,1753,1729,24,1.4
38,25,Dunn,2013,4060,4003,57,1.4
38,27,Eddy,2013,1256,1181,75,6.0
38,29,Emmons,2013,1572,1489,83,5.3
38,31,Foster,2013,1615,1560,55,3.4
38,33,Golden Valley,2013,961,940,21,2.2
38,35,Grand Forks,2013,36788,35675,1113,3.0
38,37,Grant,2013,1261,1224,37,2.9
38,39,Griggs,2013,1189,1161,28,2.4
38,41,Hettinger,2013,1463,1424,39,2.7
38,43,Kidder,2013,1241,1183,58,4.7
38,45,LaMoure,2013,2212,2162,50,2.3
38,47,Logan,2013,908,880,28,3.1
38,49,McHenry,2013,3253,3119,134,4.1
38,51,McIntosh,2013,1236,1199,37,3.0
38,53,McKenzie,2013,7473,7362,111,1.5
38,55,McLean,2013,4769,4570,199,4.2
38,57,Mercer,2013,4122,3933,189,4.6
38,59,Morton,2013,15598,15085,513,3.3
38,61,Mountrail,2013,7916,7795,121,1.5
38,63,Nelson,2013,1537,1471,66,4.3
38,65,Oliver,2013,882,828,54,6.1
38,67,Pembina,2013,3585,3369,216,6.0
38,69,Pierce,2013,1809,1733,76,4.2
38,71,Ramsey,2013,5686,5473,213,3.7
38,73,Ransom,2013,2735,2657,78,2.9
38,75,Renville,2013,1388,1354,34,2.4
38,77,Richland,2013,8481,8197,284,3.3
38,79,Rolette,2013,4837,4243,594,12.3
38,81,Sargent,2013,2115,2062,53,2.5
38,83,Sheridan,2013,709,681,28,3.9
38,85,Sioux,2013,1300,1240,60,4.6
38,87,Slope,2013,517,506,11,2.1
38,89,Stark,2013,19255,18931,324,1.7
38,91,Steele,2013,1030,1005,25,2.4
38,93,Stutsman,2013,10382,10059,323,3.1
38,95,Towner,2013,1200,1154,46,3.8
38,97,Traill,2013,4450,4322,128,2.9
38,99,Walsh,2013,5561,5287,274,4.9
38,101,Ward,2013,34096,33178,918,2.7
38,103,Wells,2013,2188,2094,94,4.3
38,105,Williams,2013,28948,28593,355,1.2
39,1,Adams,2013,10684,9329,1355,12.7
39,3,Allen,2013,49437,45572,3865,7.8
39,5,Ashland,2013,25506,23448,2058,8.1
39,7,Ashtabula,2013,45988,41634,4354,9.5
39,9,Athens,2013,27486,25014,2472,9.0
39,11,Auglaize,2013,23948,22537,1411,5.9
39,13,Belmont,2013,31938,29315,2623,8.2
39,15,Brown,2013,20069,18034,2035,10.1
39,17,Butler,2013,186175,172260,13915,7.5
39,19,Carroll,2013,13691,12612,1079,7.9
39,21,Champaign,2013,20001,18623,1378,6.9
39,23,Clark,2013,65907,60952,4955,7.5
39,25,Clermont,2013,102435,94913,7522,7.3
39,27,Clinton,2013,17078,15299,1779,10.4
39,29,Columbiana,2013,50530,46381,4149,8.2
39,31,Coshocton,2013,16342,14750,1592,9.7
39,33,Crawford,2013,19702,17901,1801,9.1
39,35,Cuyahoga,2013,617919,574381,43538,7.0
39,37,Darke,2013,26381,24539,1842,7.0
39,39,Defiance,2013,18926,17510,1416,7.5
39,41,Delaware,2013,98027,92813,5214,5.3
39,43,Erie,2013,38526,35408,3118,8.1
39,45,Fairfield,2013,73998,69090,4908,6.6
39,47,Fayette,2013,14369,13270,1099,7.6
39,49,Franklin,2013,638429,597401,41028,6.4
39,51,Fulton,2013,22435,20659,1776,7.9
39,53,Gallia,2013,12504,11296,1208,9.7
39,55,Geauga,2013,48934,46113,2821,5.8
39,57,Greene,2013,79358,73833,5525,7.0
39,59,Guernsey,2013,18533,16930,1603,8.6
39,61,Hamilton,2013,402152,372904,29248,7.3
39,63,Hancock,2013,40172,37680,2492,6.2
39,65,Hardin,2013,14924,13776,1148,7.7
39,67,Harrison,2013,7285,6709,576,7.9
39,69,Henry,2013,14016,12781,1235,8.8
39,71,Highland,2013,17496,15667,1829,10.5
39,73,Hocking,2013,13191,12124,1067,8.1
39,75,Holmes,2013,20034,18991,1043,5.2
39,77,Huron,2013,28640,25718,2922,10.2
39,79,Jackson,2013,13594,12168,1426,10.5
39,81,Jefferson,2013,30577,27255,3322,10.9
39,83,Knox,2013,30368,28280,2088,6.9
39,85,Lake,2013,124869,116992,7877,6.3
39,87,Lawrence,2013,26106,23820,2286,8.8
39,89,Licking,2013,86432,80469,5963,6.9
39,91,Logan,2013,23031,21459,1572,6.8
39,93,Lorain,2013,150065,138932,11133,7.4
39,95,Lucas,2013,210574,192357,18217,8.7
39,97,Madison,2013,20222,18959,1263,6.2
39,99,Mahoning,2013,109469,100150,9319,8.5
39,101,Marion,2013,28112,25897,2215,7.9
39,103,Medina,2013,94391,88883,5508,5.8
39,105,Meigs,2013,9407,8293,1114,11.8
39,107,Mercer,2013,22380,21238,1142,5.1
39,109,Miami,2013,51827,48099,3728,7.2
39,111,Monroe,2013,6480,5833,647,10.0
39,113,Montgomery,2013,251135,230358,20777,8.3
39,115,Morgan,2013,6687,6014,673,10.1
39,117,Morrow,2013,16886,15532,1354,8.0
39,119,Muskingum,2013,39928,36291,3637,9.1
39,121,Noble,2013,5285,4777,508,9.6
39,123,Ottawa,2013,21952,19828,2124,9.7
39,125,Paulding,2013,9016,8328,688,7.6
39,127,Perry,2013,16056,14520,1536,9.6
39,129,Pickaway,2013,25642,23771,1871,7.3
39,131,Pike,2013,10758,9446,1312,12.2
39,133,Portage,2013,87651,80915,6736,7.7
39,135,Preble,2013,21292,19690,1602,7.5
39,137,Putnam,2013,18804,17676,1128,6.0
39,139,Richland,2013,54903,50190,4713,8.6
39,141,Ross,2013,33481,30579,2902,8.7
39,143,Sandusky,2013,31540,29160,2380,7.5
39,145,Scioto,2013,30324,26717,3607,11.9
39,147,Seneca,2013,27393,25273,2120,7.7
39,149,Shelby,2013,23745,22159,1586,6.7
39,151,Stark,2013,188921,174666,14255,7.5
39,153,Summit,2013,270976,250368,20608,7.6
39,155,Trumbull,2013,94482,85671,8811,9.3
39,157,Tuscarawas,2013,45020,41749,3271,7.3
39,159,Union,2013,26611,25064,1547,5.8
39,161,Van Wert,2013,14202,13217,985,6.9
39,163,Vinton,2013,5573,4981,592,10.6
39,165,Warren,2013,109788,102723,7065,6.4
39,167,Washington,2013,28347,25915,2432,8.6
39,169,Wayne,2013,59284,55600,3684,6.2
39,171,Williams,2013,18643,17256,1387,7.4
39,173,Wood,2013,69045,64210,4835,7.0
39,175,Wyandot,2013,12350,11571,779,6.3
40,1,Adair,2013,8243,7459,784,9.5
40,3,Alfalfa,2013,2933,2840,93,3.2
40,5,Atoka,2013,4903,4576,327,6.7
40,7,Beaver,2013,3023,2924,99,3.3
40,9,Beckham,2013,12582,12181,401,3.2
40,11,Blaine,2013,4315,4147,168,3.9
40,13,Bryan,2013,17712,16774,938,5.3
40,15,Caddo,2013,11362,10670,692,6.1
40,17,Canadian,2013,64697,62113,2584,4.0
40,19,Carter,2013,22003,20868,1135,5.2
40,21,Cherokee,2013,18696,17433,1263,6.8
40,23,Choctaw,2013,5961,5469,492,8.3
40,25,Cimarron,2013,1233,1194,39,3.2
40,27,Cleveland,2013,136894,131213,5681,4.1
40,29,Coal,2013,2249,2083,166,7.4
40,31,Comanche,2013,50042,47238,2804,5.6
40,33,Cotton,2013,2858,2702,156,5.5
40,35,Craig,2013,6234,5841,393,6.3
40,37,Creek,2013,31193,29373,1820,5.8
40,39,Custer,2013,16006,15434,572,3.6
40,41,Delaware,2013,16957,15820,1137,6.7
40,43,Dewey,2013,2593,2505,88,3.4
40,45,Ellis,2013,2330,2260,70,3.0
40,47,Garfield,2013,29405,28231,1174,4.0
40,49,Garvin,2013,12439,11837,602,4.8
40,51,Grady,2013,25500,24322,1178,4.6
40,53,Grant,2013,2659,2573,86,3.2
40,55,Greer,2013,1996,1892,104,5.2
40,57,Harmon,2013,1348,1291,57,4.2
40,59,Harper,2013,1918,1856,62,3.2
40,61,Haskell,2013,4462,4064,398,8.9
40,63,Hughes,2013,5726,5281,445,7.8
40,65,Jackson,2013,10814,10249,565,5.2
40,67,Jefferson,2013,2578,2446,132,5.1
40,69,Johnston,2013,3578,3295,283,7.9
40,71,Kay,2013,19948,18611,1337,6.7
40,73,Kingfisher,2013,7780,7519,261,3.4
40,75,Kiowa,2013,4144,3948,196,4.7
40,77,Latimer,2013,4133,3778,355,8.6
40,79,Le Flore,2013,19712,18013,1699,8.6
40,81,Lincoln,2013,15446,14675,771,5.0
40,83,Logan,2013,20725,19811,914,4.4
40,85,Love,2013,5245,5023,222,4.2
40,87,McClain,2013,17809,17054,755,4.2
40,89,McCurtain,2013,14300,12995,1305,9.1
40,91,McIntosh,2013,7375,6671,704,9.5
40,93,Major,2013,4127,3992,135,3.3
40,95,Marshall,2013,6945,6556,389,5.6
40,97,Mayes,2013,18824,17768,1056,5.6
40,99,Murray,2013,6466,6151,315,4.9
40,101,Muskogee,2013,29658,27796,1862,6.3
40,103,Noble,2013,5468,5233,235,4.3
40,105,Nowata,2013,4811,4495,316,6.6
40,107,Okfuskee,2013,4414,4111,303,6.9
40,109,Oklahoma,2013,368083,350800,17283,4.7
40,111,Okmulgee,2013,16212,15021,1191,7.3
40,113,Osage,2013,21081,19889,1192,5.7
40,115,Ottawa,2013,14110,13008,1102,7.8
40,117,Pawnee,2013,7377,6943,434,5.9
40,119,Payne,2013,37496,35885,1611,4.3
40,121,Pittsburg,2013,17951,16678,1273,7.1
40,123,Pontotoc,2013,17742,16800,942,5.3
40,125,Pottawatomie,2013,32074,30376,1698,5.3
40,127,Pushmataha,2013,4700,4293,407,8.7
40,129,Roger Mills,2013,1877,1819,58,3.1
40,131,Rogers,2013,43768,41603,2165,4.9
40,133,Seminole,2013,9716,8945,771,7.9
40,135,Sequoyah,2013,16822,15457,1365,8.1
40,137,Stephens,2013,20577,19497,1080,5.2
40,139,Texas,2013,9279,8884,395,4.3
40,141,Tillman,2013,3363,3187,176,5.2
40,143,Tulsa,2013,310617,295245,15372,4.9
40,145,Wagoner,2013,35880,34115,1765,4.9
40,147,Washington,2013,24598,23447,1151,4.7
40,149,Washita,2013,5569,5343,226,4.1
40,151,Woods,2013,5137,4975,162,3.2
40,153,Woodward,2013,10726,10357,369,3.4
41,1,Baker,2013,6846,6194,652,9.5
41,3,Benton,2013,44197,41705,2492,5.6
41,5,Clackamas,2013,198316,184482,13834,7.0
41,7,Clatsop,2013,17991,16608,1383,7.7
41,9,Columbia,2013,22456,20320,2136,9.5
41,11,Coos,2013,26520,23839,2681,10.1
41,13,Crook,2013,8968,7896,1072,12.0
41,15,Curry,2013,8699,7787,912,10.5
41,17,Deschutes,2013,78781,71376,7405,9.4
41,19,Douglas,2013,44427,39796,4631,10.4
41,21,Gilliam,2013,856,775,81,9.5
41,23,Grant,2013,3209,2817,392,12.2
41,25,Harney,2013,3346,2964,382,11.4
41,27,Hood River,2013,13831,12967,864,6.2
41,29,Jackson,2013,96623,87325,9298,9.6
41,31,Jefferson,2013,9279,8322,957,10.3
41,33,Josephine,2013,32423,28878,3545,10.9
41,35,Klamath,2013,29047,25957,3090,10.6
41,37,Lake,2013,3490,3099,391,11.2
41,39,Lane,2013,168771,155425,13346,7.9
41,41,Lincoln,2013,20755,18950,1805,8.7
41,43,Linn,2013,53908,48763,5145,9.5
41,45,Malheur,2013,12419,11379,1040,8.4
41,47,Marion,2013,148377,135439,12938,8.7
41,49,Morrow,2013,5571,5148,423,7.6
41,51,Multnomah,2013,414728,387011,27717,6.7
41,53,Polk,2013,34944,32158,2786,8.0
41,55,Sherman,2013,871,791,80,9.2
41,57,Tillamook,2013,11002,10094,908,8.3
41,59,Umatilla,2013,35468,32378,3090,8.7
41,61,Union,2013,11819,10835,984,8.3
41,63,Wallowa,2013,3243,2887,356,11.0
41,65,Wasco,2013,13789,12760,1029,7.5
41,67,Washington,2013,289282,271317,17965,6.2
41,69,Wheeler,2013,737,691,46,6.2
41,71,Yamhill,2013,49707,46009,3698,7.4
42,1,Adams,2013,55215,52086,3129,5.7
42,3,Allegheny,2013,649324,608249,41075,6.3
42,5,Armstrong,2013,33494,31005,2489,7.4
42,7,Beaver,2013,86249,80214,6035,7.0
42,9,Bedford,2013,24622,22624,1998,8.1
42,11,Berks,2013,210607,196083,14524,6.9
42,13,Blair,2013,61320,57184,4136,6.7
42,15,Bradford,2013,31749,29510,2239,7.1
42,17,Bucks,2013,336071,314645,21426,6.4
42,19,Butler,2013,97579,91763,5816,6.0
42,21,Cambria,2013,64380,58948,5432,8.4
42,23,Cameron,2013,2345,2125,220,9.4
42,25,Carbon,2013,32096,29202,2894,9.0
42,27,Centre,2013,77806,73840,3966,5.1
42,29,Chester,2013,272790,258850,13940,5.1
42,31,Clarion,2013,18610,17150,1460,7.8
42,33,Clearfield,2013,37639,34350,3289,8.7
42,35,Clinton,2013,19212,17528,1684,8.8
42,37,Columbia,2013,35209,32588,2621,7.4
42,39,Crawford,2013,41647,38735,2912,7.0
42,41,Cumberland,2013,125406,118482,6924,5.5
42,43,Dauphin,2013,140007,130764,9243,6.6
42,45,Delaware,2013,289498,269747,19751,6.8
42,47,Elk,2013,16412,15327,1085,6.6
42,49,Erie,2013,135527,125776,9751,7.2
42,51,Fayette,2013,59477,53934,5543,9.3
42,53,Forest,2013,1966,1778,188,9.6
42,55,Franklin,2013,76372,71489,4883,6.4
42,57,Fulton,2013,7375,6716,659,8.9
42,59,Greene,2013,18701,17395,1306,7.0
42,61,Huntingdon,2013,20252,18323,1929,9.5
42,63,Indiana,2013,43936,40647,3289,7.5
42,65,Jefferson,2013,21017,19347,1670,7.9
42,67,Juniata,2013,11991,11164,827,6.9
42,69,Lackawanna,2013,107214,98616,8598,8.0
42,71,Lancaster,2013,269656,253946,15710,5.8
42,73,Lawrence,2013,42896,39771,3125,7.3
42,75,Lebanon,2013,70521,66279,4242,6.0
42,77,Lehigh,2013,182642,168805,13837,7.6
42,79,Luzerne,2013,160094,145551,14543,9.1
42,81,Lycoming,2013,61644,56975,4669,7.6
42,83,McKean,2013,19620,18069,1551,7.9
42,85,Mercer,2013,53551,49806,3745,7.0
42,87,Mifflin,2013,21309,19625,1684,7.9
42,89,Monroe,2013,81248,73888,7360,9.1
42,91,Montgomery,2013,434320,409693,24627,5.7
42,93,Montour,2013,9436,8938,498,5.3
42,95,Northampton,2013,155252,144134,11118,7.2
42,97,Northumberland,2013,44551,40780,3771,8.5
42,99,Perry,2013,24181,22652,1529,6.3
42,101,Philadelphia/city,2013,695194,625828,69366,10.0
42,103,Pike,2013,25781,23374,2407,9.3
42,105,Potter,2013,7716,7022,694,9.0
42,107,Schuylkill,2013,69954,63724,6230,8.9
42,109,Snyder,2013,19679,18371,1308,6.6
42,111,Somerset,2013,35663,32472,3191,8.9
42,113,Sullivan,2013,3047,2802,245,8.0
42,115,Susquehanna,2013,22264,20730,1534,6.9
42,117,Tioga,2013,21184,19426,1758,8.3
42,119,Union,2013,19090,17919,1171,6.1
42,121,Venango,2013,25180,23285,1895,7.5
42,123,Warren,2013,20361,19107,1254,6.2
42,125,Washington,2013,106642,99487,7155,6.7
42,127,Wayne,2013,22635,20911,1724,7.6
42,129,Westmoreland,2013,185755,173182,12573,6.8
42,131,Wyoming,2013,14271,13079,1192,8.4
42,133,York,2013,231382,216313,15069,6.5
44,1,Bristol,2013,26338,24205,2133,8.1
44,3,Kent,2013,92146,83894,8252,9.0
44,5,Newport,2013,44463,40598,3865,8.7
44,7,Providence,2013,325702,293165,32537,10.0
44,9,Washington,2013,70098,63914,6184,8.8
45,1,Abbeville,2013,10570,9590,980,9.3
45,3,Aiken,2013,72889,67531,5358,7.4
45,5,Allendale,2013,3096,2672,424,13.7
45,7,Anderson,2013,86082,80126,5956,6.9
45,9,Bamberg,2013,5589,4853,736,13.2
45,11,Barnwell,2013,8733,7700,1033,11.8
45,13,Beaufort,2013,67472,63279,4193,6.2
45,15,Berkeley,2013,89180,83118,6062,6.8
45,17,Calhoun,2013,6948,6299,649,9.3
45,19,Charleston,2013,188255,177472,10783,5.7
45,21,Cherokee,2013,23787,21355,2432,10.2
45,23,Chester,2013,13703,12069,1634,11.9
45,25,Chesterfield,2013,21050,19167,1883,8.9
45,27,Clarendon,2013,13014,11705,1309,10.1
45,29,Colleton,2013,16382,14795,1587,9.7
45,31,Darlington,2013,30167,27421,2746,9.1
45,33,Dillon,2013,12784,11308,1476,11.5
45,35,Dorchester,2013,68858,64419,4439,6.4
45,37,Edgefield,2013,10550,9723,827,7.8
45,39,Fairfield,2013,10120,9059,1061,10.5
45,41,Florence,2013,65096,59864,5232,8.0
45,43,Georgetown,2013,24432,22013,2419,9.9
45,45,Greenville,2013,231560,217819,13741,5.9
45,47,Greenwood,2013,31636,28979,2657,8.4
45,49,Hampton,2013,8369,7611,758,9.1
45,51,Horry,2013,133217,122022,11195,8.4
45,53,Jasper,2013,11214,10460,754,6.7
45,55,Kershaw,2013,28021,25889,2132,7.6
45,57,Lancaster,2013,34399,31284,3115,9.1
45,59,Laurens,2013,29977,27475,2502,8.3
45,61,Lee,2013,6577,5869,708,10.8
45,63,Lexington,2013,137982,130217,7765,5.6
45,65,McCormick,2013,3515,3178,337,9.6
45,67,Marion,2013,13072,11403,1669,12.8
45,69,Marlboro,2013,10526,9109,1417,13.5
45,71,Newberry,2013,17993,16721,1272,7.1
45,73,Oconee,2013,33294,30810,2484,7.5
45,75,Orangeburg,2013,38600,33944,4656,12.1
45,77,Pickens,2013,54825,50883,3942,7.2
45,79,Richland,2013,191182,178448,12734,6.7
45,81,Saluda,2013,8596,8018,578,6.7
45,83,Spartanburg,2013,135982,125746,10236,7.5
45,85,Sumter,2013,44323,40545,3778,8.5
45,87,Union,2013,11758,10462,1296,11.0
45,89,Williamsburg,2013,12699,11149,1550,12.2
45,91,York,2013,119806,110828,8978,7.5
46,3,Aurora,2013,1657,1613,44,2.7
46,5,Beadle,2013,9542,9208,334,3.5
46,7,Bennett,2013,1142,1071,71,6.2
46,9,Bon Homme,2013,3024,2928,96,3.2
46,11,Brookings,2013,17888,17289,599,3.3
46,13,Brown,2013,21095,20422,673,3.2
46,15,Brule,2013,2622,2534,88,3.4
46,17,Buffalo,2013,745,680,65,8.7
46,19,Butte,2013,5073,4880,193,3.8
46,21,Campbell,2013,848,818,30,3.5
46,23,Charles Mix,2013,4022,3851,171,4.3
46,25,Clark,2013,1992,1915,77,3.9
46,27,Clay,2013,7132,6874,258,3.6
46,29,Codington,2013,15556,15010,546,3.5
46,31,Corson,2013,1518,1415,103,6.8
46,33,Custer,2013,4051,3849,202,5.0
46,35,Davison,2013,11309,10963,346,3.1
46,37,Day,2013,2939,2788,151,5.1
46,39,Deuel,2013,2397,2265,132,5.5
46,41,Dewey,2013,2432,2061,371,15.3
46,43,Douglas,2013,1715,1662,53,3.1
46,45,Edmunds,2013,2299,2236,63,2.7
46,47,Fall River,2013,3058,2908,150,4.9
46,49,Faulk,2013,1170,1132,38,3.2
46,51,Grant,2013,4675,4483,192,4.1
46,53,Gregory,2013,2113,2032,81,3.8
46,55,Haakon,2013,1088,1057,31,2.8
46,57,Hamlin,2013,3137,3031,106,3.4
46,59,Hand,2013,1840,1790,50,2.7
46,61,Hanson,2013,1816,1742,74,4.1
46,63,Harding,2013,779,757,22,2.8
46,65,Hughes,2013,9971,9686,285,2.9
46,67,Hutchinson,2013,3690,3573,117,3.2
46,69,Hyde,2013,723,699,24,3.3
46,71,Jackson,2013,1318,1238,80,6.1
46,73,Jerauld,2013,1203,1167,36,3.0
46,75,Jones,2013,624,602,22,3.5
46,77,Kingsbury,2013,2902,2810,92,3.2
46,79,Lake,2013,6355,6114,241,3.8
46,81,Lawrence,2013,12768,12274,494,3.9
46,83,Lincoln,2013,28795,28029,766,2.7
46,85,Lyman,2013,1872,1784,88,4.7
46,87,McCook,2013,3193,3092,101,3.2
46,89,McPherson,2013,1142,1100,42,3.7
46,91,Marshall,2013,2559,2449,110,4.3
46,93,Meade,2013,13653,13143,510,3.7
46,95,Mellette,2013,839,777,62,7.4
46,97,Miner,2013,1243,1199,44,3.5
46,99,Minnehaha,2013,103466,100107,3359,3.2
46,101,Moody,2013,4025,3843,182,4.5
46,102,Oglala Lakota,2013,3694,3202,492,13.3
46,103,Pennington,2013,53706,51654,2052,3.8
46,105,Perkins,2013,1546,1490,56,3.6
46,107,Potter,2013,1211,1165,46,3.8
46,109,Roberts,2013,4869,4621,248,5.1
46,111,Sanborn,2013,1301,1262,39,3.0
46,115,Spink,2013,3361,3243,118,3.5
46,117,Stanley,2013,1870,1819,51,2.7
46,119,Sully,2013,888,863,25,2.8
46,121,Todd,2013,3203,2894,309,9.6
46,123,Tripp,2013,3118,3012,106,3.4
46,125,Turner,2013,4754,4612,142,3.0
46,127,Union,2013,7938,7614,324,4.1
46,129,Walworth,2013,2373,2246,127,5.4
46,135,Yankton,2013,11594,11214,380,3.3
46,137,Ziebach,2013,1037,974,63,6.1
47,1,Anderson,2013,33798,31128,2670,7.9
47,3,Bedford,2013,20080,18241,1839,9.2
47,5,Benton,2013,6905,6232,673,9.7
47,7,Bledsoe,2013,4356,3899,457,10.5
47,9,Blount,2013,59469,55351,4118,6.9
47,11,Bradley,2013,49653,46138,3515,7.1
47,13,Campbell,2013,15295,13607,1688,11.0
47,15,Cannon,2013,5923,5457,466,7.9
47,17,Carroll,2013,13149,11593,1556,11.8
47,19,Carter,2013,24864,22580,2284,9.2
47,21,Cheatham,2013,20007,18692,1315,6.6
47,23,Chester,2013,8293,7623,670,8.1
47,25,Claiborne,2013,13052,11656,1396,10.7
47,27,Clay,2013,3106,2773,333,10.7
47,29,Cocke,2013,15029,13397,1632,10.9
47,31,Coffee,2013,24530,22618,1912,7.8
47,33,Crockett,2013,7035,6395,640,9.1
47,35,Cumberland,2013,23517,21340,2177,9.3
47,37,Davidson,2013,355490,334535,20955,5.9
47,39,Decatur,2013,5101,4561,540,10.6
47,41,DeKalb,2013,7731,6951,780,10.1
47,43,Dickson,2013,23876,22048,1828,7.7
47,45,Dyer,2013,17119,15339,1780,10.4
47,47,Fayette,2013,18196,16630,1566,8.6
47,49,Fentress,2013,7438,6714,724,9.7
47,51,Franklin,2013,19672,18252,1420,7.2
47,53,Gibson,2013,22141,19710,2431,11.0
47,55,Giles,2013,14107,12960,1147,8.1
47,57,Grainger,2013,9445,8503,942,10.0
47,59,Greene,2013,30465,27536,2929,9.6
47,61,Grundy,2013,5337,4802,535,10.0
47,63,Hamblen,2013,27056,24599,2457,9.1
47,65,Hamilton,2013,168976,156817,12159,7.2
47,67,Hancock,2013,2153,1899,254,11.8
47,69,Hardeman,2013,9814,8728,1086,11.1
47,71,Hardin,2013,11015,9879,1136,10.3
47,73,Hawkins,2013,24758,22593,2165,8.7
47,75,Haywood,2013,8127,7172,955,11.8
47,77,Henderson,2013,12710,11381,1329,10.5
47,79,Henry,2013,14349,12995,1354,9.4
47,81,Hickman,2013,10523,9653,870,8.3
47,83,Houston,2013,3377,3008,369,10.9
47,85,Humphreys,2013,8676,7915,761,8.8
47,87,Jackson,2013,4586,4115,471,10.3
47,89,Jefferson,2013,23382,21271,2111,9.0
47,91,Johnson,2013,7357,6696,661,9.0
47,93,Knox,2013,227983,213611,14372,6.3
47,95,Lake,2013,2188,1968,220,10.1
47,97,Lauderdale,2013,10260,9065,1195,11.6
47,99,Lawrence,2013,18166,16381,1785,9.8
47,101,Lewis,2013,5007,4478,529,10.6
47,103,Lincoln,2013,15609,14637,972,6.2
47,105,Loudon,2013,22159,20442,1717,7.7
47,107,McMinn,2013,22928,20860,2068,9.0
47,109,McNairy,2013,9360,8267,1093,11.7
47,111,Macon,2013,10094,9271,823,8.2
47,113,Madison,2013,47671,43839,3832,8.0
47,115,Marion,2013,12039,10945,1094,9.1
47,117,Marshall,2013,14371,13202,1169,8.1
47,119,Maury,2013,40928,38029,2899,7.1
47,121,Meigs,2013,5047,4532,515,10.2
47,123,Monroe,2013,19305,17423,1882,9.7
47,125,Montgomery,2013,77615,71766,5849,7.5
47,127,Moore,2013,3336,3136,200,6.0
47,129,Morgan,2013,8080,7259,821,10.2
47,131,Obion,2013,13706,12121,1585,11.6
47,133,Overton,2013,9526,8671,855,9.0
47,135,Perry,2013,3124,2832,292,9.3
47,137,Pickett,2013,2327,2106,221,9.5
47,139,Polk,2013,7560,6867,693,9.2
47,141,Putnam,2013,32583,29982,2601,8.0
47,143,Rhea,2013,13399,11972,1427,10.7
47,145,Roane,2013,23260,21166,2094,9.0
47,147,Robertson,2013,33695,31425,2270,6.7
47,149,Rutherford,2013,147539,138387,9152,6.2
47,151,Scott,2013,8611,7369,1242,14.4
47,153,Sequatchie,2013,5930,5421,509,8.6
47,155,Sevier,2013,49151,45012,4139,8.4
47,157,Shelby,2013,440270,401636,38634,8.8
47,159,Smith,2013,8544,7880,664,7.8
47,161,Stewart,2013,5357,4773,584,10.9
47,163,Sullivan,2013,71779,66347,5432,7.6
47,165,Sumner,2013,85694,80413,5281,6.2
47,167,Tipton,2013,28049,25398,2651,9.5
47,169,Trousdale,2013,3662,3353,309,8.4
47,171,Unicoi,2013,7432,6652,780,10.5
47,173,Union,2013,7439,6725,714,9.6
47,175,Van Buren,2013,2199,1947,252,11.5
47,177,Warren,2013,17586,16088,1498,8.5
47,179,Washington,2013,58999,54756,4243,7.2
47,181,Wayne,2013,6555,5924,631,9.6
47,183,Weakley,2013,16573,14861,1712,10.3
47,185,White,2013,11908,10784,1124,9.4
47,187,Williamson,2013,101563,96348,5215,5.1
47,189,Wilson,2013,61697,57825,3872,6.3
48,1,Anderson,2013,21997,20711,1286,5.8
48,3,Andrews,2013,9152,8800,352,3.8
48,5,Angelina,2013,37892,35420,2472,6.5
48,7,Aransas,2013,10049,9384,665,6.6
48,9,Archer,2013,4222,3999,223,5.3
48,11,Armstrong,2013,1004,964,40,4.0
48,13,Atascosa,2013,20206,18937,1269,6.3
48,15,Austin,2013,14110,13274,836,5.9
48,17,Bailey,2013,3042,2823,219,7.2
48,19,Bandera,2013,9054,8504,550,6.1
48,21,Bastrop,2013,35837,33615,2222,6.2
48,23,Baylor,2013,1669,1580,89,5.3
48,25,Bee,2013,11298,10550,748,6.6
48,27,Bell,2013,135078,125664,9414,7.0
48,29,Bexar,2013,852897,802913,49984,5.9
48,31,Blanco,2013,5528,5267,261,4.7
48,33,Borden,2013,416,399,17,4.1
48,35,Bosque,2013,8065,7539,526,6.5
48,37,Bowie,2013,40481,37371,3110,7.7
48,39,Brazoria,2013,164015,153913,10102,6.2
48,41,Brazos,2013,102594,97521,5073,4.9
48,43,Brewster,2013,4146,3914,232,5.6
48,45,Briscoe,2013,628,592,36,5.7
48,47,Brooks,2013,2761,2510,251,9.1
48,49,Brown,2013,15904,14868,1036,6.5
48,51,Burleson,2013,7682,7204,478,6.2
48,53,Burnet,2013,20758,19613,1145,5.5
48,55,Caldwell,2013,17092,15961,1131,6.6
48,57,Calhoun,2013,10822,10146,676,6.2
48,59,Callahan,2013,5905,5564,341,5.8
48,61,Cameron,2013,166810,150060,16750,10.0
48,63,Camp,2013,5506,5098,408,7.4
48,65,Carson,2013,3171,3029,142,4.5
48,67,Cass,2013,12574,11408,1166,9.3
48,69,Castro,2013,3777,3598,179,4.7
48,71,Chambers,2013,17451,16161,1290,7.4
48,73,Cherokee,2013,21493,19991,1502,7.0
48,75,Childress,2013,2930,2804,126,4.3
48,77,Clay,2013,5131,4845,286,5.6
48,79,Cochran,2013,1400,1306,94,6.7
48,81,Coke,2013,1456,1382,74,5.1
48,83,Coleman,2013,3150,2912,238,7.6
48,85,Collin,2013,456917,431462,25455,5.6
48,87,Collingsworth,2013,1214,1151,63,5.2
48,89,Colorado,2013,10082,9496,586,5.8
48,91,Comal,2013,57807,54335,3472,6.0
48,93,Comanche,2013,5643,5310,333,5.9
48,95,Concho,2013,1452,1394,58,4.0
48,97,Cooke,2013,20443,19414,1029,5.0
48,99,Coryell,2013,25173,23352,1821,7.2
48,101,Cottle,2013,624,581,43,6.9
48,103,Crane,2013,2083,1989,94,4.5
48,105,Crockett,2013,1880,1783,97,5.2
48,107,Crosby,2013,2761,2596,165,6.0
48,109,Culberson,2013,1017,965,52,5.1
48,111,Dallam,2013,3890,3753,137,3.5
48,113,Dallas,2013,1232512,1150663,81849,6.6
48,115,Dawson,2013,4991,4670,321,6.4
48,117,Deaf Smith,2013,9136,8726,410,4.5
48,119,Delta,2013,2631,2463,168,6.4
48,121,Denton,2013,399562,378005,21557,5.4
48,123,DeWitt,2013,9682,9221,461,4.8
48,125,Dickens,2013,770,698,72,9.4
48,127,Dimmit,2013,6769,6427,342,5.1
48,129,Donley,2013,1984,1882,102,5.1
48,131,Duval,2013,5531,5175,356,6.4
48,133,Eastland,2013,8513,7994,519,6.1
48,135,Ector,2013,78582,75148,3434,4.4
48,137,Edwards,2013,902,849,53,5.9
48,139,Ellis,2013,77521,72696,4825,6.2
48,141,El Paso,2013,346619,318975,27644,8.0
48,143,Erath,2013,19811,18733,1078,5.4
48,145,Falls,2013,6766,6283,483,7.1
48,147,Fannin,2013,15254,14181,1073,7.0
48,149,Fayette,2013,12634,12067,567,4.5
48,151,Fisher,2013,1882,1779,103,5.5
48,153,Floyd,2013,3117,2840,277,8.9
48,155,Foard,2013,577,547,30,5.2
48,157,Fort Bend,2013,332589,314182,18407,5.5
48,159,Franklin,2013,4681,4373,308,6.6
48,161,Freestone,2013,7845,7299,546,7.0
48,163,Frio,2013,9268,8831,437,4.7
48,165,Gaines,2013,8896,8522,374,4.2
48,167,Galveston,2013,155443,144677,10766,6.9
48,169,Garza,2013,2233,2131,102,4.6
48,171,Gillespie,2013,12399,11849,550,4.4
48,173,Glasscock,2013,742,715,27,3.6
48,175,Goliad,2013,3530,3345,185,5.2
48,177,Gonzales,2013,9497,9007,490,5.2
48,179,Gray,2013,9766,9259,507,5.2
48,181,Grayson,2013,60405,56592,3813,6.3
48,183,Gregg,2013,61434,57749,3685,6.0
48,185,Grimes,2013,11796,11082,714,6.1
48,187,Guadalupe,2013,69954,66086,3868,5.5
48,189,Hale,2013,14791,12811,1980,13.4
48,191,Hall,2013,1288,1196,92,7.1
48,193,Hamilton,2013,3615,3397,218,6.0
48,195,Hansford,2013,3122,3019,103,3.3
48,197,Hardeman,2013,1695,1596,99,5.8
48,199,Hardin,2013,25255,23208,2047,8.1
48,201,Harris,2013,2194931,2061042,133889,6.1
48,203,Harrison,2013,32263,30032,2231,6.9
48,205,Hartley,2013,2926,2833,93,3.2
48,207,Haskell,2013,2707,2572,135,5.0
48,209,Hays,2013,89718,84890,4828,5.4
48,211,Hemphill,2013,2470,2395,75,3.0
48,213,Henderson,2013,34496,32023,2473,7.2
48,215,Hidalgo,2013,330700,296229,34471,10.4
48,217,Hill,2013,15940,14908,1032,6.5
48,219,Hockley,2013,11900,11297,603,5.1
48,221,Hood,2013,23967,22504,1463,6.1
48,223,Hopkins,2013,17239,16238,1001,5.8
48,225,Houston,2013,9830,9215,615,6.3
48,227,Howard,2013,13543,12807,736,5.4
48,229,Hudspeth,2013,1292,1201,91,7.0
48,231,Hunt,2013,38109,35251,2858,7.5
48,233,Hutchinson,2013,9757,9149,608,6.2
48,235,Irion,2013,849,813,36,4.2
48,237,Jack,2013,4000,3786,214,5.4
48,239,Jackson,2013,7426,7052,374,5.0
48,241,Jasper,2013,14499,12970,1529,10.5
48,243,Jeff Davis,2013,1159,1111,48,4.1
48,245,Jefferson,2013,111085,98920,12165,11.0
48,247,Jim Hogg,2013,2321,2155,166,7.2
48,249,Jim Wells,2013,20102,18861,1241,6.2
48,251,Johnson,2013,73541,69006,4535,6.2
48,253,Jones,2013,5838,5442,396,6.8
48,255,Karnes,2013,5612,5309,303,5.4
48,257,Kaufman,2013,52345,48995,3350,6.4
48,259,Kendall,2013,18207,17277,930,5.1
48,261,Kenedy,2013,296,284,12,4.1
48,263,Kent,2013,530,509,21,4.0
48,265,Kerr,2013,21439,20248,1191,5.6
48,267,Kimble,2013,2156,2051,105,4.9
48,269,King,2013,238,227,11,4.6
48,271,Kinney,2013,1217,1100,117,9.6
48,273,Kleberg,2013,15414,14408,1006,6.5
48,275,Knox,2013,1749,1655,94,5.4
48,277,Lamar,2013,22264,20445,1819,8.2
48,279,Lamb,2013,6136,5713,423,6.9
48,281,Lampasas,2013,9114,8456,658,7.2
48,283,La Salle,2013,4168,4010,158,3.8
48,285,Lavaca,2013,9210,8775,435,4.7
48,287,Lee,2013,9121,8652,469,5.1
48,289,Leon,2013,6952,6468,484,7.0
48,291,Liberty,2013,30971,28194,2777,9.0
48,293,Limestone,2013,9465,8822,643,6.8
48,295,Lipscomb,2013,1717,1649,68,4.0
48,297,Live Oak,2013,6020,5755,265,4.4
48,299,Llano,2013,8094,7569,525,6.5
48,301,Loving,2013,75,71,4,5.3
48,303,Lubbock,2013,147137,139809,7328,5.0
48,305,Lynn,2013,2854,2702,152,5.3
48,307,McCulloch,2013,4264,4037,227,5.3
48,309,McLennan,2013,111970,104994,6976,6.2
48,311,McMullen,2013,881,857,24,2.7
48,313,Madison,2013,4811,4497,314,6.5
48,315,Marion,2013,4532,4164,368,8.1
48,317,Martin,2013,2546,2437,109,4.3
48,319,Mason,2013,1956,1848,108,5.5
48,321,Matagorda,2013,16822,15177,1645,9.8
48,323,Maverick,2013,23632,20659,2973,12.6
48,325,Medina,2013,20286,19043,1243,6.1
48,327,Menard,2013,917,863,54,5.9
48,329,Midland,2013,85874,82706,3168,3.7
48,331,Milam,2013,10109,9311,798,7.9
48,333,Mills,2013,2067,1957,110,5.3
48,335,Mitchell,2013,2873,2713,160,5.6
48,337,Montague,2013,10345,9832,513,5.0
48,339,Montgomery,2013,245832,232431,13401,5.5
48,341,Moore,2013,11416,10926,490,4.3
48,343,Morris,2013,5831,5268,563,9.7
48,345,Motley,2013,501,471,30,6.0
48,347,Nacogdoches,2013,29171,27256,1915,6.6
48,349,Navarro,2013,23345,21808,1537,6.6
48,351,Newton,2013,5596,4990,606,10.8
48,353,Nolan,2013,6953,6554,399,5.7
48,355,Nueces,2013,167975,157617,10358,6.2
48,357,Ochiltree,2013,5418,5212,206,3.8
48,359,Oldham,2013,959,916,43,4.5
48,361,Orange,2013,37915,33940,3975,10.5
48,363,Palo Pinto,2013,13359,12478,881,6.6
48,365,Panola,2013,12723,11930,793,6.2
48,367,Parker,2013,58566,55298,3268,5.6
48,369,Parmer,2013,5056,4859,197,3.9
48,371,Pecos,2013,6692,6327,365,5.5
48,373,Polk,2013,17341,15990,1351,7.8
48,375,Potter,2013,57418,54506,2912,5.1
48,377,Presidio,2013,3751,3265,486,13.0
48,379,Rains,2013,5328,4998,330,6.2
48,381,Randall,2013,68382,65414,2968,4.3
48,383,Reagan,2013,1954,1876,78,4.0
48,385,Real,2013,1061,975,86,8.1
48,387,Red River,2013,5132,4613,519,10.1
48,389,Reeves,2013,5618,5292,326,5.8
48,391,Refugio,2013,3555,3362,193,5.4
48,393,Roberts,2013,449,429,20,4.5
48,395,Robertson,2013,7274,6761,513,7.1
48,397,Rockwall,2013,42189,39743,2446,5.8
48,399,Runnels,2013,4969,4705,264,5.3
48,401,Rusk,2013,24263,22744,1519,6.3
48,403,Sabine,2013,3556,3093,463,13.0
48,405,San Augustine,2013,2931,2588,343,11.7
48,407,San Jacinto,2013,11431,10561,870,7.6
48,409,San Patricio,2013,30606,28390,2216,7.2
48,411,San Saba,2013,2269,2138,131,5.8
48,413,Schleicher,2013,1799,1735,64,3.6
48,415,Scurry,2013,8547,8189,358,4.2
48,417,Shackelford,2013,2292,2216,76,3.3
48,419,Shelby,2013,11610,10741,869,7.5
48,421,Sherman,2013,1477,1417,60,4.1
48,423,Smith,2013,101447,94758,6689,6.6
48,425,Somervell,2013,4139,3887,252,6.1
48,427,Starr,2013,26311,22345,3966,15.1
48,429,Stephens,2013,4199,3980,219,5.2
48,431,Sterling,2013,750,721,29,3.9
48,433,Stonewall,2013,707,673,34,4.8
48,435,Sutton,2013,2061,1966,95,4.6
48,437,Swisher,2013,2959,2707,252,8.5
48,439,Tarrant,2013,979558,919846,59712,6.1
48,441,Taylor,2013,64530,61099,3431,5.3
48,443,Terrell,2013,523,497,26,5.0
48,445,Terry,2013,5522,5192,330,6.0
48,447,Throckmorton,2013,794,754,40,5.0
48,449,Titus,2013,13055,12077,978,7.5
48,451,Tom Green,2013,54129,51314,2815,5.2
48,453,Travis,2013,628618,596682,31936,5.1
48,455,Trinity,2013,5559,5140,419,7.5
48,457,Tyler,2013,7589,6804,785,10.3
48,459,Upshur,2013,18502,17309,1193,6.4
48,461,Upton,2013,1707,1636,71,4.2
48,463,Uvalde,2013,11927,11086,841,7.1
48,465,Val Verde,2013,19594,18134,1460,7.5
48,467,Van Zandt,2013,23804,22239,1565,6.6
48,469,Victoria,2013,45743,43283,2460,5.4
48,471,Walker,2013,23077,21539,1538,6.7
48,473,Waller,2013,20798,19443,1355,6.5
48,475,Ward,2013,5508,5247,261,4.7
48,477,Washington,2013,15695,14829,866,5.5
48,479,Webb,2013,110145,103340,6805,6.2
48,481,Wharton,2013,21465,20175,1290,6.0
48,483,Wheeler,2013,3130,2994,136,4.3
48,485,Wichita,2013,57224,53848,3376,5.9
48,487,Wilbarger,2013,5767,5431,336,5.8
48,489,Willacy,2013,7427,6247,1180,15.9
48,491,Williamson,2013,246119,233019,13100,5.3
48,493,Wilson,2013,22166,20992,1174,5.3
48,495,Winkler,2013,3316,3140,176,5.3
48,497,Wise,2013,28351,26639,1712,6.0
48,499,Wood,2013,16693,15468,1225,7.3
48,501,Yoakum,2013,4204,4041,163,3.9
48,503,Young,2013,8556,8111,445,5.2
48,505,Zapata,2013,7050,6607,443,6.3
48,507,Zavala,2013,4006,3421,585,14.6
49,1,Beaver,2013,2979,2851,128,4.3
49,3,Box Elder,2013,22833,21840,993,4.3
49,5,Cache,2013,57002,54930,2072,3.6
49,7,Carbon,2013,8809,8298,511,5.8
49,9,Daggett,2013,423,404,19,4.5
49,11,Davis,2013,150480,144606,5874,3.9
49,13,Duchesne,2013,9170,8809,361,3.9
49,15,Emery,2013,4639,4381,258,5.6
49,17,Garfield,2013,2731,2500,231,8.5
49,19,Grand,2013,5365,4983,382,7.1
49,21,Iron,2013,19087,18115,972,5.1
49,23,Juab,2013,4629,4415,214,4.6
49,25,Kane,2013,3423,3255,168,4.9
49,27,Millard,2013,5822,5603,219,3.8
49,29,Morgan,2013,4444,4279,165,3.7
49,31,Piute,2013,477,443,34,7.1
49,33,Rich,2013,970,929,41,4.2
49,35,Salt Lake,2013,561750,539099,22651,4.0
49,37,San Juan,2013,5579,5170,409,7.3
49,39,Sanpete,2013,10892,10330,562,5.2
49,41,Sevier,2013,9127,8673,454,5.0
49,43,Summit,2013,21739,20909,830,3.8
49,45,Tooele,2013,28068,26667,1401,5.0
49,47,Uintah,2013,15453,14836,617,4.0
49,49,Utah,2013,245330,235773,9557,3.9
49,51,Wasatch,2013,12023,11508,515,4.3
49,53,Washington,2013,58465,55503,2962,5.1
49,55,Wayne,2013,1352,1216,136,10.1
49,57,Weber,2013,112850,107237,5613,5.0
50,1,Addison,2013,20770,19911,859,4.1
50,3,Bennington,2013,19260,18254,1006,5.2
50,5,Caledonia,2013,15744,14908,836,5.3
50,7,Chittenden,2013,95009,91747,3262,3.4
50,9,Essex,2013,2838,2647,191,6.7
50,11,Franklin,2013,27469,26318,1151,4.2
50,13,Grand Isle,2013,4051,3869,182,4.5
50,15,Lamoille,2013,13873,13084,789,5.7
50,17,Orange,2013,16164,15499,665,4.1
50,19,Orleans,2013,13813,12870,943,6.8
50,21,Rutland,2013,32256,30537,1719,5.3
50,23,Washington,2013,34555,33064,1491,4.3
50,25,Windham,2013,24075,22947,1128,4.7
50,27,Windsor,2013,30300,29029,1271,4.2
51,1,Accomack,2013,16226,15083,1143,7.0
51,3,Albemarle,2013,52554,50068,2486,4.7
51,5,Alleghany,2013,7515,7032,483,6.4
51,7,Amelia,2013,6173,5816,357,5.8
51,9,Amherst,2013,15801,14856,945,6.0
51,11,Appomattox,2013,7158,6707,451,6.3
51,13,Arlington,2013,145169,140275,4894,3.4
51,15,Augusta,2013,36905,35024,1881,5.1
51,17,Bath,2013,2578,2445,133,5.2
51,19,Bedford,2013,38242,36114,2128,5.6
51,21,Bland,2013,2877,2687,190,6.6
51,23,Botetourt,2013,17634,16731,903,5.1
51,25,Brunswick,2013,6656,6046,610,9.2
51,27,Buchanan,2013,8159,7281,878,10.8
51,29,Buckingham,2013,6406,5910,496,7.7
51,31,Campbell,2013,26942,25375,1567,5.8
51,33,Caroline,2013,14579,13573,1006,6.9
51,35,Carroll,2013,13256,12185,1071,8.1
51,36,Charles City,2013,3788,3538,250,6.6
51,37,Charlotte,2013,5312,4909,403,7.6
51,41,Chesterfield,2013,174719,165077,9642,5.5
51,43,Clarke,2013,7626,7273,353,4.6
51,45,Craig,2013,2456,2287,169,6.9
51,47,Culpeper,2013,23387,22161,1226,5.2
51,49,Cumberland,2013,4508,4215,293,6.5
51,51,Dickenson,2013,5341,4758,583,10.9
51,53,Dinwiddie,2013,13538,12565,973,7.2
51,57,Essex,2013,5686,5316,370,6.5
51,59,Fairfax,2013,624643,597713,26930,4.3
51,61,Fauquier,2013,35928,34198,1730,4.8
51,63,Floyd,2013,8389,7946,443,5.3
51,65,Fluvanna,2013,13038,12431,607,4.7
51,67,Franklin,2013,27216,25648,1568,5.8
51,69,Frederick,2013,44153,41871,2282,5.2
51,71,Giles,2013,8217,7656,561,6.8
51,73,Gloucester,2013,19327,18344,983,5.1
51,75,Goochland,2013,10376,9854,522,5.0
51,77,Grayson,2013,7006,6345,661,9.4
51,79,Greene,2013,9690,9234,456,4.7
51,81,Greensville,2013,4354,4025,329,7.6
51,83,Halifax,2013,15852,14434,1418,8.9
51,85,Hanover,2013,55429,52693,2736,4.9
51,87,Henrico,2013,174131,164651,9480,5.4
51,89,Henry,2013,23392,21311,2081,8.9
51,91,Highland,2013,1419,1360,59,4.2
51,93,Isle of Wight,2013,18861,17803,1058,5.6
51,95,James City,2013,33708,31951,1757,5.2
51,97,King and Queen,2013,3639,3422,217,6.0
51,99,King George,2013,11979,11301,678,5.7
51,101,King William,2013,8701,8222,479,5.5
51,103,Lancaster,2013,5399,5003,396,7.3
51,105,Lee,2013,9298,8502,796,8.6
51,107,Loudoun,2013,191165,182994,8171,4.3
51,109,Louisa,2013,18056,17057,999,5.5
51,111,Lunenburg,2013,5325,4958,367,6.9
51,113,Madison,2013,7229,6914,315,4.4
51,115,Mathews,2013,4165,3959,206,4.9
51,117,Mecklenburg,2013,12771,11608,1163,9.1
51,119,Middlesex,2013,5115,4839,276,5.4
51,121,Montgomery,2013,49678,46938,2740,5.5
51,125,Nelson,2013,7359,6963,396,5.4
51,127,New Kent,2013,10788,10257,531,4.9
51,131,Northampton,2013,6031,5494,537,8.9
51,133,Northumberland,2013,5689,5278,411,7.2
51,135,Nottoway,2013,7073,6656,417,5.9
51,137,Orange,2013,16118,15187,931,5.8
51,139,Page,2013,11934,10860,1074,9.0
51,141,Patrick,2013,7798,7166,632,8.1
51,143,Pittsylvania,2013,30437,28347,2090,6.9
51,145,Powhatan,2013,13567,12894,673,5.0
51,147,Prince Edward,2013,9985,9166,819,8.2
51,149,Prince George,2013,14740,13733,1007,6.8
51,153,Prince William,2013,231198,219435,11763,5.1
51,155,Pulaski,2013,16853,15605,1248,7.4
51,157,Rappahannock,2013,3918,3722,196,5.0
51,159,Richmond,2013,3940,3702,238,6.0
51,161,Roanoke,2013,49848,47408,2440,4.9
51,163,Rockbridge,2013,10419,9828,591,5.7
51,165,Rockingham,2013,40640,38627,2013,5.0
51,167,Russell,2013,11598,10638,960,8.3
51,169,Scott,2013,10003,9321,682,6.8
51,171,Shenandoah,2013,20945,19798,1147,5.5
51,173,Smyth,2013,13397,12210,1187,8.9
51,175,Southampton,2013,9244,8739,505,5.5
51,177,Spotsylvania,2013,64172,60530,3642,5.7
51,179,Stafford,2013,66106,62452,3654,5.5
51,181,Surry,2013,3633,3374,259,7.1
51,183,Sussex,2013,4183,3804,379,9.1
51,185,Tazewell,2013,17665,16174,1491,8.4
51,187,Warren,2013,20091,18887,1204,6.0
51,191,Washington,2013,27842,26111,1731,6.2
51,193,Westmoreland,2013,9099,8489,610,6.7
51,195,Wise,2013,15086,13561,1525,10.1
51,197,Wythe,2013,13995,12931,1064,7.6
51,199,York,2013,31847,30175,1672,5.3
51,510,Alexandria city,2013,93742,90037,3705,4.0
51,520,Bristol city,2013,7822,7289,533,6.8
51,530,Buena Vista city,2013,3314,3094,220,6.6
51,540,Charlottesville city,2013,23410,22340,1070,4.6
51,550,Chesapeake city,2013,116363,109643,6720,5.8
51,570,Colonial Heights city,2013,8662,8112,550,6.3
51,580,Covington city,2013,2560,2350,210,8.2
51,590,Danville city,2013,19789,17895,1894,9.6
51,595,Emporia city,2013,2380,2151,229,9.6
51,600,Fairfax city,2013,13118,12585,533,4.1
51,610,Falls Church city,2013,7846,7547,299,3.8
51,620,Franklin city,2013,3693,3357,336,9.1
51,630,Fredericksburg city,2013,13763,12894,869,6.3
51,640,Galax city,2013,3018,2764,254,8.4
51,650,Hampton city,2013,65830,61010,4820,7.3
51,660,Harrisonburg city,2013,24033,22446,1587,6.6
51,670,Hopewell city,2013,9650,8729,921,9.5
51,678,Lexington city,2013,2251,2064,187,8.3
51,680,Lynchburg city,2013,35740,33266,2474,6.9
51,683,Manassas city,2013,22246,21075,1171,5.3
51,685,Manassas Park city,2013,8808,8371,437,5.0
51,690,Martinsville city,2013,5693,5067,626,11.0
51,700,Newport News city,2013,90463,84482,5981,6.6
51,710,Norfolk city,2013,112752,105086,7666,6.8
51,720,Norton city,2013,1869,1717,152,8.1
51,730,Petersburg city,2013,13760,12190,1570,11.4
51,735,Poquoson city,2013,6349,6041,308,4.9
51,740,Portsmouth city,2013,45461,41847,3614,7.9
51,750,Radford city,2013,8336,7722,614,7.4
51,760,Richmond city,2013,110460,103127,7333,6.6
51,770,Roanoke city,2013,49777,46540,3237,6.5
51,775,Salem city,2013,13052,12310,742,5.7
51,790,Staunton city,2013,11957,11278,679,5.7
51,800,Suffolk city,2013,41988,39393,2595,6.2
51,810,Virginia Beach city,2013,231089,218890,12199,5.3
51,820,Waynesboro city,2013,10030,9437,593,5.9
51,830,Williamsburg city,2013,6876,6360,516,7.5
51,840,Winchester city,2013,14363,13547,816,5.7
53,1,Adams,2013,8366,7680,686,8.2
53,3,Asotin,2013,9785,9151,634,6.5
53,5,Benton,2013,90174,82314,7860,8.7
53,7,Chelan,2013,40363,37491,2872,7.1
53,9,Clallam,2013,27299,24731,2568,9.4
53,11,Clark,2013,208097,190863,17234,8.3
53,13,Columbia,2013,1765,1627,138,7.8
53,15,Cowlitz,2013,43270,39108,4162,9.6
53,17,Douglas,2013,18895,17362,1533,8.1
53,19,Ferry,2013,2480,2152,328,13.2
53,21,Franklin,2013,38342,34802,3540,9.2
53,23,Garfield,2013,984,913,71,7.2
53,25,Grant,2013,43959,40239,3720,8.5
53,27,Grays Harbor,2013,28081,24810,3271,11.6
53,29,Island,2013,31749,29438,2311,7.3
53,31,Jefferson,2013,11407,10360,1047,9.2
53,33,King,2013,1137057,1086876,50181,4.4
53,35,Kitsap,2013,113595,105576,8019,7.1
53,37,Kittitas,2013,20189,18651,1538,7.6
53,39,Klickitat,2013,9707,8813,894,9.2
53,41,Lewis,2013,31311,28070,3241,10.4
53,43,Lincoln,2013,5086,4745,341,6.7
53,45,Mason,2013,23335,21048,2287,9.8
53,47,Okanogan,2013,20976,19212,1764,8.4
53,49,Pacific,2013,7986,7103,883,11.1
53,51,Pend Oreille,2013,4674,4128,546,11.7
53,53,Pierce,2013,383769,352522,31247,8.1
53,55,San Juan,2013,7784,7329,455,5.8
53,57,Skagit,2013,56680,51920,4760,8.4
53,59,Skamania,2013,4992,4505,487,9.8
53,61,Snohomish,2013,388242,368625,19617,5.1
53,63,Spokane,2013,227147,209018,18129,8.0
53,65,Stevens,2013,17708,15832,1876,10.6
53,67,Thurston,2013,122701,113589,9112,7.4
53,69,Wahkiakum,2013,1292,1140,152,11.8
53,71,Walla Walla,2013,28404,26425,1979,7.0
53,73,Whatcom,2013,102057,94643,7414,7.3
53,75,Whitman,2013,22205,20894,1311,5.9
53,77,Yakima,2013,118863,107243,11620,9.8
54,1,Barbour,2013,6716,6242,474,7.1
54,3,Berkeley,2013,52621,49687,2934,5.6
54,5,Boone,2013,8662,7842,820,9.5
54,7,Braxton,2013,5335,4792,543,10.2
54,9,Brooke,2013,10383,9591,792,7.6
54,11,Cabell,2013,42456,40033,2423,5.7
54,13,Calhoun,2013,2881,2593,288,10.0
54,15,Clay,2013,3482,3068,414,11.9
54,17,Doddridge,2013,3522,3336,186,5.3
54,19,Fayette,2013,17000,15551,1449,8.5
54,21,Gilmer,2013,2754,2573,181,6.6
54,23,Grant,2013,6001,5516,485,8.1
54,25,Greenbrier,2013,15482,14342,1140,7.4
54,27,Hampshire,2013,9582,8918,664,6.9
54,29,Hancock,2013,13409,12333,1076,8.0
54,31,Hardy,2013,5458,4945,513,9.4
54,33,Harrison,2013,31822,30071,1751,5.5
54,35,Jackson,2013,12036,11219,817,6.8
54,37,Jefferson,2013,27443,26142,1301,4.7
54,39,Kanawha,2013,89513,84281,5232,5.8
54,41,Lewis,2013,7367,6900,467,6.3
54,43,Lincoln,2013,7554,6836,718,9.5
54,45,Logan,2013,12390,11185,1205,9.7
54,47,McDowell,2013,6197,5416,781,12.6
54,49,Marion,2013,26780,25205,1575,5.9
54,51,Marshall,2013,14316,13283,1033,7.2
54,53,Mason,2013,10573,9593,980,9.3
54,55,Mercer,2013,23150,21400,1750,7.6
54,57,Mineral,2013,11908,10984,924,7.8
54,59,Mingo,2013,8487,7547,940,11.1
54,61,Monongalia,2013,50098,47855,2243,4.5
54,63,Monroe,2013,5685,5331,354,6.2
54,65,Morgan,2013,7449,6992,457,6.1
54,67,Nicholas,2013,10381,9397,984,9.5
54,69,Ohio,2013,21358,20158,1200,5.6
54,71,Pendleton,2013,3584,3390,194,5.4
54,73,Pleasants,2013,2896,2688,208,7.2
54,75,Pocahontas,2013,3599,3294,305,8.5
54,77,Preston,2013,14649,13702,947,6.5
54,79,Putnam,2013,25993,24532,1461,5.6
54,81,Raleigh,2013,31828,29535,2293,7.2
54,83,Randolph,2013,11933,11083,850,7.1
54,85,Ritchie,2013,4560,4284,276,6.1
54,87,Roane,2013,5361,4812,549,10.2
54,89,Summers,2013,4554,4211,343,7.5
54,91,Taylor,2013,7769,7335,434,5.6
54,93,Tucker,2013,3276,3055,221,6.7
54,95,Tyler,2013,3634,3321,313,8.6
54,97,Upshur,2013,9621,8944,677,7.0
54,99,Wayne,2013,16061,14960,1101,6.9
54,101,Webster,2013,3517,3159,358,10.2
54,103,Wetzel,2013,7289,6633,656,9.0
54,105,Wirt,2013,2320,2087,233,10.0
54,107,Wood,2013,38493,36133,2360,6.1
54,109,Wyoming,2013,8296,7537,759,9.1
55,1,Adams,2013,8721,7779,942,10.8
55,3,Ashland,2013,8156,7416,740,9.1
55,5,Barron,2013,23633,21874,1759,7.4
55,7,Bayfield,2013,7753,6908,845,10.9
55,9,Brown,2013,138007,129515,8492,6.2
55,11,Buffalo,2013,6550,6123,427,6.5
55,13,Burnett,2013,7482,6852,630,8.4
55,15,Calumet,2013,27175,25755,1420,5.2
55,17,Chippewa,2013,32966,30759,2207,6.7
55,19,Clark,2013,17122,15923,1199,7.0
55,21,Columbia,2013,31221,29195,2026,6.5
55,23,Crawford,2013,8120,7460,660,8.1
55,25,Dane,2013,301102,287097,14005,4.7
55,27,Dodge,2013,47360,44131,3229,6.8
55,29,Door,2013,15732,14191,1541,9.8
55,31,Douglas,2013,23564,22015,1549,6.6
55,33,Dunn,2013,23538,22051,1487,6.3
55,35,Eau Claire,2013,57905,54654,3251,5.6
55,37,Florence,2013,2196,2015,181,8.2
55,39,Fond du Lac,2013,57054,53569,3485,6.1
55,41,Forest,2013,4078,3634,444,10.9
55,43,Grant,2013,27643,26026,1617,5.8
55,45,Green,2013,20856,19672,1184,5.7
55,47,Green Lake,2013,10202,9398,804,7.9
55,49,Iowa,2013,13541,12670,871,6.4
55,51,Iron,2013,2726,2436,290,10.6
55,53,Jackson,2013,10145,9434,711,7.0
55,55,Jefferson,2013,45899,43042,2857,6.2
55,57,Juneau,2013,13474,12387,1087,8.1
55,59,Kenosha,2013,86909,80302,6607,7.6
55,61,Kewaunee,2013,10932,10239,693,6.3
55,63,La Crosse,2013,66755,63241,3514,5.3
55,65,Lafayette,2013,9346,8846,500,5.3
55,67,Langlade,2013,9808,8923,885,9.0
55,69,Lincoln,2013,15173,13919,1254,8.3
55,71,Manitowoc,2013,42680,39554,3126,7.3
55,73,Marathon,2013,72105,67301,4804,6.7
55,75,Marinette,2013,21441,19754,1687,7.9
55,77,Marquette,2013,7505,6877,628,8.4
55,78,Menominee,2013,1571,1324,247,15.7
55,79,Milwaukee,2013,478784,438862,39922,8.3
55,81,Monroe,2013,22756,21199,1557,6.8
55,83,Oconto,2013,20447,18882,1565,7.7
55,85,Oneida,2013,18586,17004,1582,8.5
55,87,Outagamie,2013,100461,94378,6083,6.1
55,89,Ozaukee,2013,47520,45048,2472,5.2
55,91,Pepin,2013,4030,3803,227,5.6
55,93,Pierce,2013,23993,22737,1256,5.2
55,95,Polk,2013,24302,22582,1720,7.1
55,97,Portage,2013,38939,36266,2673,6.9
55,99,Price,2013,6853,6384,469,6.8
55,101,Racine,2013,99697,91452,8245,8.3
55,103,Richland,2013,9346,8782,564,6.0
55,105,Rock,2013,82138,75851,6287,7.7
55,107,Rusk,2013,6731,6161,570,8.5
55,109,St. Croix,2013,47803,45251,2552,5.3
55,111,Sauk,2013,35375,33181,2194,6.2
55,113,Sawyer,2013,8184,7296,888,10.9
55,115,Shawano,2013,21460,19869,1591,7.4
55,117,Sheboygan,2013,60745,57074,3671,6.0
55,119,Taylor,2013,10985,10286,699,6.4
55,121,Trempealeau,2013,16411,15501,910,5.5
55,123,Vernon,2013,15131,14235,896,5.9
55,125,Vilas,2013,10175,9152,1023,10.1
55,127,Walworth,2013,56775,52919,3856,6.8
55,129,Washburn,2013,7995,7406,589,7.4
55,131,Washington,2013,75244,70976,4268,5.7
55,133,Waukesha,2013,218987,207001,11986,5.5
55,135,Waupaca,2013,27345,25362,1983,7.3
55,137,Waushara,2013,11822,10816,1006,8.5
55,139,Winnebago,2013,91645,85832,5813,6.3
55,141,Wood,2013,38995,36178,2817,7.2
56,1,Albany,2013,20392,19620,772,3.8
56,3,Big Horn,2013,5502,5214,288,5.2
56,5,Campbell,2013,25328,24242,1086,4.3
56,7,Carbon,2013,8257,7897,360,4.4
56,9,Converse,2013,7991,7695,296,3.7
56,11,Crook,2013,3638,3475,163,4.5
56,13,Fremont,2013,20746,19553,1193,5.8
56,15,Goshen,2013,7227,6921,306,4.2
56,17,Hot Springs,2013,2520,2400,120,4.8
56,19,Johnson,2013,4413,4187,226,5.1
56,21,Laramie,2013,47889,45571,2318,4.8
56,23,Lincoln,2013,8050,7583,467,5.8
56,25,Natrona,2013,42485,40539,1946,4.6
56,27,Niobrara,2013,1360,1312,48,3.5
56,29,Park,2013,15636,14832,804,5.1
56,31,Platte,2013,4735,4525,210,4.4
56,33,Sheridan,2013,15565,14701,864,5.6
56,35,Sublette,2013,5008,4770,238,4.8
56,37,Sweetwater,2013,23539,22499,1040,4.4
56,39,Teton,2013,13906,13120,786,5.7
56,41,Uinta,2013,9817,9295,522,5.3
56,43,Washakie,2013,4300,4085,215,5.0
56,45,Weston,2013,3899,3758,141,3.6
72,1,Adjuntas Municipio,2013,4814,3702,1112,23.1
72,3,Aguada Municipio,2013,12355,10071,2284,18.5
72,5,Aguadilla Municipio,2013,15382,12693,2689,17.5
72,7,Aguas Buenas Municipio,2013,7118,5921,1197,16.8
72,9,Aibonito Municipio,2013,7012,5816,1196,17.1
72,11,Anasco Municipio,2013,9259,7554,1705,18.4
72,13,Arecibo Municipio,2013,25281,21338,3943,15.6
72,15,Arroyo Municipio,2013,5662,4227,1435,25.3
72,17,Barceloneta Municipio,2013,6321,4964,1357,21.5
72,19,Barranquitas Municipio,2013,7725,6527,1198,15.5
72,21,Bayamon Municipio,2013,69654,62613,7041,10.1
72,23,Cabo Rojo Municipio,2013,14878,11878,3000,20.2
72,25,Caguas Municipio,2013,50558,44534,6024,11.9
72,27,Camuy Municipio,2013,9990,8486,1504,15.1
72,29,Canovanas Municipio,2013,16427,14276,2151,13.1
72,31,Carolina Municipio,2013,64574,58444,6130,9.5
72,33,Catano Municipio,2013,8470,7366,1104,13.0
72,35,Cayey Municipio,2013,16912,14616,2296,13.6
72,37,Ceiba Municipio,2013,4195,3437,758,18.1
72,39,Ciales Municipio,2013,4465,3317,1148,25.7
72,41,Cidra Municipio,2013,16280,14210,2070,12.7
72,43,Coamo Municipio,2013,11414,9106,2308,20.2
72,45,Comerio Municipio,2013,5493,4395,1098,20.0
72,47,Corozal Municipio,2013,9748,8285,1463,15.0
72,49,Culebra Municipio,2013,850,793,57,6.7
72,51,Dorado Municipio,2013,12842,11707,1135,8.8
72,53,Fajardo Municipio,2013,12255,10154,2101,17.1
72,54,Florida Municipio,2013,3696,2924,772,20.9
72,55,Guanica Municipio,2013,4776,3503,1273,26.7
72,57,Guayama Municipio,2013,12982,10159,2823,21.7
72,59,Guayanilla Municipio,2013,5696,4443,1253,22.0
72,61,Guaynabo Municipio,2013,37825,35532,2293,6.1
72,63,Gurabo Municipio,2013,17236,15394,1842,10.7
72,65,Hatillo Municipio,2013,13423,11264,2159,16.1
72,67,Hormigueros Municipio,2013,5859,4863,996,17.0
72,69,Humacao Municipio,2013,18539,15140,3399,18.3
72,71,Isabela Municipio,2013,12116,10012,2104,17.4
72,73,Jayuya Municipio,2013,4374,3574,800,18.3
72,75,Juana Diaz Municipio,2013,16078,13566,2512,15.6
72,77,Juncos Municipio,2013,12703,10729,1974,15.5
72,79,Lajas Municipio,2013,6224,4520,1704,27.4
72,81,Lares Municipio,2013,8092,6088,2004,24.8
72,83,Las Marias Municipio,2013,3106,2357,749,24.1
72,85,Las Piedras Municipio,2013,11794,9724,2070,17.6
72,87,Loiza Municipio,2013,9120,7979,1141,12.5
72,89,Luquillo Municipio,2013,6796,5513,1283,18.9
72,91,Manati Municipio,2013,12064,10407,1657,13.7
72,93,Maricao Municipio,2013,2129,1679,450,21.1
72,95,Maunabo Municipio,2013,3221,2524,697,21.6
72,97,Mayaguez Municipio,2013,25197,20390,4807,19.1
72,99,Moca Municipio,2013,11132,8933,2199,19.8
72,101,Morovis Municipio,2013,8707,7030,1677,19.3
72,103,Naguabo Municipio,2013,8518,7126,1392,16.3
72,105,Naranjito Municipio,2013,7670,6403,1267,16.5
72,107,Orocovis Municipio,2013,5542,4506,1036,18.7
72,109,Patillas Municipio,2013,5139,3886,1253,24.4
72,111,Penuelas Municipio,2013,6682,5309,1373,20.5
72,113,Ponce Municipio,2013,50837,42728,8109,16.0
72,115,Quebradillas Municipio,2013,6366,5160,1206,18.9
72,117,Rincon Municipio,2013,4767,3791,976,20.5
72,119,Rio Grande Municipio,2013,17586,15509,2077,11.8
72,121,Sabana Grande Municipio,2013,6712,5287,1425,21.2
72,123,Salinas Municipio,2013,8610,6374,2236,26.0
72,125,San German Municipio,2013,10853,8689,2164,19.9
72,127,San Juan Municipio,2013,139979,128736,11243,8.0
72,129,San Lorenzo Municipio,2013,12656,10558,2098,16.6
72,131,San Sebastian Municipio,2013,11363,8654,2709,23.8
72,133,Santa Isabel Municipio,2013,10008,8118,1890,18.9
72,135,Toa Alta Municipio,2013,26289,23838,2451,9.3
72,137,Toa Baja Municipio,2013,31209,27921,3288,10.5
72,139,Trujillo Alto Municipio,2013,27826,25725,2101,7.6
72,141,Utuado Municipio,2013,7324,5885,1439,19.6
72,143,Vega Alta Municipio,2013,10188,8751,1437,14.1
72,145,Vega Baja Municipio,2013,14601,12198,2403,16.5
72,147,Vieques Municipio,2013,3080,2589,491,15.9
72,149,Villalba Municipio,2013,8184,6416,1768,21.6
72,151,Yabucoa Municipio,2013,10169,7742,2427,23.9
72,153,Yauco Municipio,2013,11350,8959,2391,21.1
1,1,Autauga,2014,25639,24150,1489,5.8
1,3,Baldwin,2014,86546,81265,5281,6.1
1,5,Barbour,2014,8859,7930,929,10.5
1,7,Bibb,2014,8573,7959,614,7.2
1,9,Blount,2014,24571,23074,1497,6.1
1,11,Bullock,2014,4738,4323,415,8.8
1,13,Butler,2014,9285,8496,789,8.5
1,15,Calhoun,2014,47321,43562,3759,7.9
1,17,Chambers,2014,15329,14308,1021,6.7
1,19,Cherokee,2014,11407,10748,659,5.8
1,21,Chilton,2014,19130,17938,1192,6.2
1,23,Choctaw,2014,4501,4098,403,9.0
1,25,Clarke,2014,8166,7177,989,12.1
1,27,Clay,2014,5521,5128,393,7.1
1,29,Cleburne,2014,5864,5479,385,6.6
1,31,Coffee,2014,20264,18926,1338,6.6
1,33,Colbert,2014,24069,22082,1987,8.3
1,35,Conecuh,2014,4724,4239,485,10.3
1,37,Coosa,2014,4474,4082,392,8.8
1,39,Covington,2014,15940,14706,1234,7.7
1,41,Crenshaw,2014,6310,5875,435,6.9
1,43,Cullman,2014,35984,33812,2172,6.0
1,45,Dale,2014,20351,18919,1432,7.0
1,47,Dallas,2014,16026,14234,1792,11.2
1,49,DeKalb,2014,28997,27014,1983,6.8
1,51,Elmore,2014,36610,34530,2080,5.7
1,53,Escambia,2014,14389,13244,1145,8.0
1,55,Etowah,2014,43798,40729,3069,7.0
1,57,Fayette,2014,6359,5863,496,7.8
1,59,Franklin,2014,13737,12681,1056,7.7
1,61,Geneva,2014,10813,10093,720,6.7
1,63,Greene,2014,2990,2619,371,12.4
1,65,Hale,2014,6041,5448,593,9.8
1,67,Henry,2014,6788,6281,507,7.5
1,69,Houston,2014,45224,42172,3052,6.7
1,71,Jackson,2014,23489,21792,1697,7.2
1,73,Jefferson,2014,312706,293144,19562,6.3
1,75,Lamar,2014,5634,5244,390,6.9
1,77,Lauderdale,2014,43551,40434,3117,7.2
1,79,Lawrence,2014,14046,12896,1150,8.2
1,81,Lee,2014,71478,67506,3972,5.6
1,83,Limestone,2014,39648,37244,2404,6.1
1,85,Lowndes,2014,3879,3384,495,12.8
1,87,Macon,2014,8250,7502,748,9.1
1,89,Madison,2014,170377,159923,10454,6.1
1,91,Marengo,2014,7636,7031,605,7.9
1,93,Marion,2014,12311,11342,969,7.9
1,95,Marshall,2014,39974,37321,2653,6.6
1,97,Mobile,2014,185640,171332,14308,7.7
1,99,Monroe,2014,7625,6787,838,11.0
1,101,Montgomery,2014,105193,98012,7181,6.8
1,103,Morgan,2014,56135,52450,3685,6.6
1,105,Perry,2014,3494,3073,421,12.0
1,107,Pickens,2014,7770,7139,631,8.1
1,109,Pike,2014,14975,13877,1098,7.3
1,111,Randolph,2014,9291,8669,622,6.7
1,113,Russell,2014,24812,23197,1615,6.5
1,115,St. Clair,2014,38577,36367,2210,5.7
1,117,Shelby,2014,107413,102624,4789,4.5
1,119,Sumter,2014,5381,4927,454,8.4
1,121,Talladega,2014,35445,32710,2735,7.7
1,123,Tallapoosa,2014,18448,17072,1376,7.5
1,125,Tuscaloosa,2014,97230,91523,5707,5.9
1,127,Walker,2014,25796,23766,2030,7.9
1,129,Washington,2014,6664,6028,636,9.5
1,131,Wilcox,2014,2868,2385,483,16.8
1,133,Winston,2014,9647,8822,825,8.6
2,13,Aleutians East Borough,2014,2219,2121,98,4.4
2,16,Aleutians West Census Area,2014,4464,4253,211,4.7
2,20,Anchorage Borough/municipality,2014,157650,149591,8059,5.1
2,50,Bethel Census Area,2014,7270,6120,1150,15.8
2,60,Bristol Bay Borough,2014,495,456,39,7.9
2,68,Denali Borough,2014,1068,959,109,10.2
2,70,Dillingham Census Area,2014,2111,1902,209,9.9
2,90,Fairbanks North Star Borough,2014,46662,44016,2646,5.7
2,100,Haines Borough,2014,1108,991,117,10.6
2,105,Hoonah-Angoon Census Area,2014,1134,965,169,14.9
2,110,Juneau Borough/city,2014,17412,16548,864,5.0
2,122,Kenai Peninsula Borough,2014,27867,25712,2155,7.7
2,130,Ketchikan Gateway Borough,2014,7083,6535,548,7.7
2,150,Kodiak Island Borough,2014,6563,6197,366,5.6
2,158,Kusilvak Census Area,2014,2812,2152,660,23.5
2,164,Lake and Peninsula Borough,2014,641,538,103,16.1
2,170,Matanuska-Susitna Borough,2014,44744,41199,3545,7.9
2,180,Nome Census Area,2014,4107,3610,497,12.1
2,185,North Slope Borough,2014,4338,4084,254,5.9
2,188,Northwest Arctic Borough,2014,2991,2490,501,16.8
2,195,Petersburg Borough,2014,1577,1430,147,9.3
2,198,Prince of Wales-Hyder Census Area,2014,2825,2453,372,13.2
2,220,Sitka Borough/city,2014,4669,4435,234,5.0
2,230,Skagway Municipality,2014,802,708,94,11.7
2,240,Southeast Fairbanks Census Area,2014,2908,2530,378,13.0
2,261,Valdez-Cordova Census Area,2014,4865,4404,461,9.5
2,275,Wrangell Borough/city,2014,1057,970,87,8.2
2,282,Yakutat Borough/city,2014,273,246,27,9.9
2,290,Yukon-Koyukuk Census Area,2014,2571,2091,480,18.7
4,1,Apache,2014,21345,17994,3351,15.7
4,3,Cochise,2014,51273,46954,4319,8.4
4,5,Coconino,2014,72671,67508,5163,7.1
4,7,Gila,2014,21544,19750,1794,8.3
4,9,Graham,2014,14529,13447,1082,7.4
4,11,Greenlee,2014,4748,4439,309,6.5
4,12,La Paz,2014,8002,7394,608,7.6
4,13,Maricopa,2014,1973683,1858871,114812,5.8
4,15,Mohave,2014,78835,71947,6888,8.7
4,17,Navajo,2014,41943,37291,4652,11.1
4,19,Pima,2014,465898,437713,28185,6.0
4,21,Pinal,2014,154678,143829,10849,7.0
4,23,Santa Cruz,2014,20422,17777,2645,13.0
4,25,Yavapai,2014,94877,88836,6041,6.4
4,27,Yuma,2014,93996,72444,21552,22.9
5,1,Arkansas,2014,9545,9045,500,5.2
5,3,Ashley,2014,8736,7962,774,8.9
5,5,Baxter,2014,16104,15052,1052,6.5
5,7,Benton,2014,116340,111104,5236,4.5
5,9,Boone,2014,15780,14858,922,5.8
5,11,Bradley,2014,4349,4008,341,7.8
5,13,Calhoun,2014,2397,2244,153,6.4
5,15,Carroll,2014,12641,12001,640,5.1
5,17,Chicot,2014,3877,3480,397,10.2
5,19,Clark,2014,9749,9100,649,6.7
5,21,Clay,2014,6459,5964,495,7.7
5,23,Cleburne,2014,9821,9028,793,8.1
5,25,Cleveland,2014,3481,3249,232,6.7
5,27,Columbia,2014,9630,8957,673,7.0
5,29,Conway,2014,8667,8061,606,7.0
5,31,Craighead,2014,49862,47210,2652,5.3
5,33,Crawford,2014,27006,25426,1580,5.9
5,35,Crittenden,2014,21584,20031,1553,7.2
5,37,Cross,2014,8153,7646,507,6.2
5,39,Dallas,2014,3001,2737,264,8.8
5,41,Desha,2014,5600,5159,441,7.9
5,43,Drew,2014,8180,7518,662,8.1
5,45,Faulkner,2014,59498,56270,3228,5.4
5,47,Franklin,2014,7343,6936,407,5.5
5,49,Fulton,2014,4823,4549,274,5.7
5,51,Garland,2014,40645,38129,2516,6.2
5,53,Grant,2014,8287,7844,443,5.3
5,55,Greene,2014,19777,18553,1224,6.2
5,57,Hempstead,2014,10056,9473,583,5.8
5,59,Hot Spring,2014,14124,13327,797,5.6
5,61,Howard,2014,6254,5900,354,5.7
5,63,Independence,2014,15590,14403,1187,7.6
5,65,Izard,2014,4952,4587,365,7.4
5,67,Jackson,2014,6231,5669,562,9.0
5,69,Jefferson,2014,29713,27170,2543,8.6
5,71,Johnson,2014,10380,9716,664,6.4
5,73,Lafayette,2014,2711,2507,204,7.5
5,75,Lawrence,2014,7129,6625,504,7.1
5,77,Lee,2014,3274,3033,241,7.4
5,79,Lincoln,2014,4246,3952,294,6.9
5,81,Little River,2014,5587,5228,359,6.4
5,83,Logan,2014,9150,8616,534,5.8
5,85,Lonoke,2014,33001,31356,1645,5.0
5,87,Madison,2014,7023,6691,332,4.7
5,89,Marion,2014,6582,6178,404,6.1
5,91,Miller,2014,19522,18411,1111,5.7
5,93,Mississippi,2014,19205,17473,1732,9.0
5,95,Monroe,2014,3116,2911,205,6.6
5,97,Montgomery,2014,3400,3137,263,7.7
5,99,Nevada,2014,3732,3513,219,5.9
5,101,Newton,2014,3388,3195,193,5.7
5,103,Ouachita,2014,10085,9304,781,7.7
5,105,Perry,2014,4261,3940,321,7.5
5,107,Phillips,2014,7277,6593,684,9.4
5,109,Pike,2014,4273,3970,303,7.1
5,111,Poinsett,2014,10177,9489,688,6.8
5,113,Polk,2014,8546,8024,522,6.1
5,115,Pope,2014,29921,28094,1827,6.1
5,117,Prairie,2014,3841,3624,217,5.6
5,119,Pulaski,2014,185985,175968,10017,5.4
5,121,Randolph,2014,6592,6084,508,7.7
5,123,St. Francis,2014,9044,8274,770,8.5
5,125,Saline,2014,55039,52439,2600,4.7
5,127,Scott,2014,4614,4388,226,4.9
5,129,Searcy,2014,3016,2829,187,6.2
5,131,Sebastian,2014,57622,54425,3197,5.5
5,133,Sevier,2014,5889,5491,398,6.8
5,135,Sharp,2014,6006,5510,496,8.3
5,137,Stone,2014,4735,4382,353,7.5
5,139,Union,2014,16754,15545,1209,7.2
5,141,Van Buren,2014,6503,5988,515,7.9
5,143,Washington,2014,111044,106301,4743,4.3
5,145,White,2014,34720,32332,2388,6.9
5,147,Woodruff,2014,3189,2952,237,7.4
5,149,Yell,2014,9128,8627,501,5.5
6,1,Alameda,2014,806326,758819,47507,5.9
6,3,Alpine,2014,509,467,42,8.3
6,5,Amador,2014,14321,13118,1203,8.4
6,7,Butte,2014,101057,92215,8842,8.7
6,9,Calaveras,2014,20205,18569,1636,8.1
6,11,Colusa,2014,11078,9131,1947,17.6
6,13,Contra Costa,2014,538458,504821,33637,6.2
6,15,Del Norte,2014,9915,8905,1010,10.2
6,17,El Dorado,2014,87730,81532,6198,7.1
6,19,Fresno,2014,437617,386366,51251,11.7
6,21,Glenn,2014,12783,11405,1378,10.8
6,23,Humboldt,2014,62235,58036,4199,6.7
6,25,Imperial,2014,78264,59281,18983,24.3
6,27,Inyo,2014,9192,8558,634,6.9
6,29,Kern,2014,391896,350628,41268,10.5
6,31,Kings,2014,57361,50447,6914,12.1
6,33,Lake,2014,29230,26585,2645,9.0
6,35,Lassen,2014,10798,9803,995,9.2
6,37,Los Angeles,2014,4982412,4572171,410241,8.2
6,39,Madera,2014,61712,54720,6992,11.3
6,41,Marin,2014,138458,132477,5981,4.3
6,43,Mariposa,2014,8077,7359,718,8.9
6,45,Mendocino,2014,40301,37446,2855,7.1
6,47,Merced,2014,114169,99355,14814,13.0
6,49,Modoc,2014,3361,3012,349,10.4
6,51,Mono,2014,8224,7637,587,7.1
6,53,Monterey,2014,217354,197439,19915,9.2
6,55,Napa,2014,73259,69047,4212,5.7
6,57,Nevada,2014,47746,44581,3165,6.6
6,59,Orange,2014,1565446,1478476,86970,5.6
6,61,Placer,2014,175097,163994,11103,6.3
6,63,Plumas,2014,8088,7144,944,11.7
6,65,Riverside,2014,1009162,925465,83697,8.3
6,67,Sacramento,2014,677696,627615,50081,7.4
6,69,San Benito,2014,29121,26372,2749,9.4
6,71,San Bernardino,2014,903649,830461,73188,8.1
6,73,San Diego,2014,1537512,1437398,100114,6.5
6,75,San Francisco/city,2014,527320,503984,23336,4.4
6,77,San Joaquin,2014,311543,278342,33201,10.7
6,79,San Luis Obispo,2014,139919,132020,7899,5.6
6,81,San Mateo,2014,425863,407692,18171,4.3
6,83,Santa Barbara,2014,217331,203882,13449,6.2
6,85,Santa Clara,2014,987613,936090,51523,5.2
6,87,Santa Cruz,2014,142048,129469,12579,8.9
6,89,Shasta,2014,74741,67469,7272,9.7
6,91,Sierra,2014,1410,1266,144,10.2
6,93,Siskiyou,2014,17977,15961,2016,11.2
6,95,Solano,2014,202391,186972,15419,7.6
6,97,Sonoma,2014,255563,241048,14515,5.7
6,99,Stanislaus,2014,240222,213079,27143,11.3
6,101,Sutter,2014,44230,38574,5656,12.8
6,103,Tehama,2014,25041,22605,2436,9.7
6,105,Trinity,2014,5161,4668,493,9.6
6,107,Tulare,2014,197913,171630,26283,13.3
6,109,Tuolumne,2014,21536,19651,1885,8.8
6,111,Ventura,2014,429179,400313,28866,6.7
6,113,Yolo,2014,102028,94258,7770,7.6
6,115,Yuba,2014,27853,24696,3157,11.3
8,1,Adams,2014,244942,230977,13965,5.7
8,3,Alamosa,2014,7509,6970,539,7.2
8,5,Arapahoe,2014,331140,314951,16189,4.9
8,7,Archuleta,2014,5722,5381,341,6.0
8,9,Baca,2014,1925,1872,53,2.8
8,11,Bent,2014,1651,1564,87,5.3
8,13,Boulder,2014,176123,168947,7176,4.1
8,14,Broomfield/city,2014,34165,32727,1438,4.2
8,15,Chaffee,2014,8381,8017,364,4.3
8,17,Cheyenne,2014,971,943,28,2.9
8,19,Clear Creek,2014,5515,5260,255,4.6
8,21,Conejos,2014,3607,3327,280,7.8
8,23,Costilla,2014,1608,1463,145,9.0
8,25,Crowley,2014,1315,1238,77,5.9
8,27,Custer,2014,1979,1888,91,4.6
8,29,Delta,2014,13592,12638,954,7.0
8,31,Denver/city,2014,368663,351002,17661,4.8
8,33,Dolores,2014,1329,1277,52,3.9
8,35,Douglas,2014,169151,162392,6759,4.0
8,37,Eagle,2014,32381,31036,1345,4.2
8,39,Elbert,2014,12954,12403,551,4.3
8,41,El Paso,2014,306538,288214,18324,6.0
8,43,Fremont,2014,14524,13336,1188,8.2
8,45,Garfield,2014,31156,29525,1631,5.2
8,47,Gilpin,2014,3448,3298,150,4.4
8,49,Grand,2014,8927,8570,357,4.0
8,51,Gunnison,2014,9670,9281,389,4.0
8,53,Hinsdale,2014,434,418,16,3.7
8,55,Huerfano,2014,2409,2169,240,10.0
8,57,Jackson,2014,834,804,30,3.6
8,59,Jefferson,2014,307519,293571,13948,4.5
8,61,Kiowa,2014,752,727,25,3.3
8,63,Kit Carson,2014,4311,4180,131,3.0
8,65,Lake,2014,4504,4296,208,4.6
8,67,La Plata,2014,29907,28651,1256,4.2
8,69,Larimer,2014,177024,169514,7510,4.2
8,71,Las Animas,2014,6422,5940,482,7.5
8,73,Lincoln,2014,2132,2046,86,4.0
8,75,Logan,2014,10992,10577,415,3.8
8,77,Mesa,2014,73179,68640,4539,6.2
8,79,Mineral,2014,424,403,21,5.0
8,81,Moffat,2014,7303,6884,419,5.7
8,83,Montezuma,2014,12650,11883,767,6.1
8,85,Montrose,2014,19260,17958,1302,6.8
8,87,Morgan,2014,14802,14125,677,4.6
8,89,Otero,2014,7966,7360,606,7.6
8,91,Ouray,2014,2133,2010,123,5.8
8,93,Park,2014,9352,8924,428,4.6
8,95,Phillips,2014,2252,2178,74,3.3
8,97,Pitkin,2014,11020,10486,534,4.8
8,99,Prowers,2014,5724,5457,267,4.7
8,101,Pueblo,2014,72273,67010,5263,7.3
8,103,Rio Blanco,2014,2939,2765,174,5.9
8,105,Rio Grande,2014,4817,4376,441,9.2
8,107,Routt,2014,14378,13782,596,4.1
8,109,Saguache,2014,3003,2742,261,8.7
8,111,San Juan,2014,475,450,25,5.3
8,113,San Miguel,2014,4919,4687,232,4.7
8,115,Sedgwick,2014,1086,1036,50,4.6
8,117,Summit,2014,20071,19398,673,3.4
8,119,Teller,2014,11577,10902,675,5.8
8,121,Washington,2014,2645,2562,83,3.1
8,123,Weld,2014,145343,138877,6466,4.4
8,125,Yuma,2014,4956,4792,164,3.3
9,1,Fairfield,2014,476325,446853,29472,6.2
9,3,Hartford,2014,473900,441868,32032,6.8
9,5,Litchfield,2014,105540,99181,6359,6.0
9,7,Middlesex,2014,92330,87057,5273,5.7
9,9,New Haven,2014,456647,423660,32987,7.2
9,11,New London,2014,136831,127531,9300,6.8
9,13,Tolland,2014,84810,79876,4934,5.8
9,15,Windham,2014,62717,58091,4626,7.4
10,1,Kent,2014,75102,70391,4711,6.3
10,3,New Castle,2014,282923,267664,15259,5.4
10,5,Sussex,2014,94687,89345,5342,5.6
11,1,District of Colu,2014,379678,350415,29263,7.7
12,1,Alachua,2014,129301,122367,6934,5.4
12,3,Baker,2014,11192,10454,738,6.6
12,5,Bay,2014,87426,81720,5706,6.5
12,7,Bradford,2014,10733,10110,623,5.8
12,9,Brevard,2014,257569,239073,18496,7.2
12,11,Broward,2014,985640,925482,60158,6.1
12,13,Calhoun,2014,4939,4586,353,7.1
12,15,Charlotte,2014,66794,62075,4719,7.1
12,17,Citrus,2014,48186,43951,4235,8.8
12,19,Clay,2014,97643,91867,5776,5.9
12,21,Collier,2014,159799,149982,9817,6.1
12,23,Columbia,2014,28321,26384,1937,6.8
12,27,DeSoto,2014,13152,12185,967,7.4
12,29,Dixie,2014,5549,5126,423,7.6
12,31,Duval,2014,459322,427557,31765,6.9
12,33,Escambia,2014,139128,129917,9211,6.6
12,35,Flagler,2014,43164,39906,3258,7.5
12,37,Franklin,2014,4936,4650,286,5.8
12,39,Gadsden,2014,18794,17202,1592,8.5
12,41,Gilchrist,2014,6548,6094,454,6.9
12,43,Glades,2014,4915,4527,388,7.9
12,45,Gulf,2014,6114,5732,382,6.2
12,47,Hamilton,2014,4602,4241,361,7.8
12,49,Hardee,2014,10332,9516,816,7.9
12,51,Hendry,2014,15825,13984,1841,11.6
12,53,Hernando,2014,66188,60781,5407,8.2
12,55,Highlands,2014,35813,32705,3108,8.7
12,57,Hillsborough,2014,681695,641101,40594,6.0
12,59,Holmes,2014,6852,6361,491,7.2
12,61,Indian River,2014,61680,56676,5004,8.1
12,63,Jackson,2014,17458,16256,1202,6.9
12,65,Jefferson,2014,5489,5116,373,6.8
12,67,Lafayette,2014,3348,3171,177,5.3
12,69,Lake,2014,138134,129049,9085,6.6
12,71,Lee,2014,309859,290623,19236,6.2
12,73,Leon,2014,149611,141074,8537,5.7
12,75,Levy,2014,16276,15129,1147,7.0
12,77,Liberty,2014,2748,2560,188,6.8
12,79,Madison,2014,7727,7161,566,7.3
12,81,Manatee,2014,160276,150831,9445,5.9
12,83,Marion,2014,131442,121579,9863,7.5
12,85,Martin,2014,68572,64296,4276,6.2
12,86,Miami-Dade,2014,1298195,1210346,87849,6.8
12,87,Monroe,2014,44941,43038,1903,4.2
12,89,Nassau,2014,36208,33989,2219,6.1
12,91,Okaloosa,2014,91890,87023,4867,5.3
12,93,Okeechobee,2014,17652,16316,1336,7.6
12,95,Orange,2014,675438,634818,40620,6.0
12,97,Osceola,2014,152455,141903,10552,6.9
12,99,Palm Beach,2014,683721,642418,41303,6.0
12,101,Pasco,2014,212730,198120,14610,6.9
12,103,Pinellas,2014,470895,442921,27974,5.9
12,105,Polk,2014,278128,257543,20585,7.4
12,107,Putnam,2014,27922,25416,2506,9.0
12,109,St. Johns,2014,110429,105091,5338,4.8
12,111,St. Lucie,2014,130404,119663,10741,8.2
12,113,Santa Rosa,2014,72991,68881,4110,5.6
12,115,Sarasota,2014,174637,164132,10505,6.0
12,117,Seminole,2014,235652,221800,13852,5.9
12,119,Sumter,2014,28243,25819,2424,8.6
12,121,Suwannee,2014,17944,16781,1163,6.5
12,123,Taylor,2014,9349,8689,660,7.1
12,125,Union,2014,4727,4436,291,6.2
12,127,Volusia,2014,237504,220799,16705,7.0
12,129,Wakulla,2014,14282,13520,762,5.3
12,131,Walton,2014,27301,25811,1490,5.5
12,133,Washington,2014,9681,9010,671,6.9
13,1,Appling,2014,8653,7886,767,8.9
13,3,Atkinson,2014,3610,3335,275,7.6
13,5,Bacon,2014,4840,4501,339,7.0
13,7,Baker,2014,1113,1012,101,9.1
13,9,Baldwin,2014,18451,16836,1615,8.8
13,11,Banks,2014,8137,7595,542,6.7
13,13,Barrow,2014,35131,32915,2216,6.3
13,15,Bartow,2014,46539,43190,3349,7.2
13,17,Ben Hill,2014,5589,5028,561,10.0
13,19,Berrien,2014,7225,6605,620,8.6
13,21,Bibb,2014,68918,63364,5554,8.1
13,23,Bleckley,2014,4625,4103,522,11.3
13,25,Brantley,2014,6880,6240,640,9.3
13,27,Brooks,2014,6619,6141,478,7.2
13,29,Bryan,2014,15516,14513,1003,6.5
13,31,Bulloch,2014,34486,31949,2537,7.4
13,33,Burke,2014,9159,8236,923,10.1
13,35,Butts,2014,10012,9258,754,7.5
13,37,Calhoun,2014,2136,1987,149,7.0
13,39,Camden,2014,21925,20471,1454,6.6
13,43,Candler,2014,5067,4715,352,6.9
13,45,Carroll,2014,51886,47618,4268,8.2
13,47,Catoosa,2014,30990,29079,1911,6.2
13,49,Charlton,2014,4797,4442,355,7.4
13,51,Chatham,2014,131529,121872,9657,7.3
13,53,Chattahoochee,2014,2226,2009,217,9.7
13,55,Chattooga,2014,10499,9698,801,7.6
13,57,Cherokee,2014,117819,111330,6489,5.5
13,59,Clarke,2014,56136,52226,3910,7.0
13,61,Clay,2014,914,810,104,11.4
13,63,Clayton,2014,124524,112890,11634,9.3
13,65,Clinch,2014,2823,2585,238,8.4
13,67,Cobb,2014,392834,369474,23360,5.9
13,69,Coffee,2014,17611,16172,1439,8.2
13,71,Colquitt,2014,20052,18425,1627,8.1
13,73,Columbia,2014,66326,62459,3867,5.8
13,75,Cook,2014,7384,6783,601,8.1
13,77,Coweta,2014,66402,62297,4105,6.2
13,79,Crawford,2014,5604,5183,421,7.5
13,81,Crisp,2014,9442,8604,838,8.9
13,83,Dade,2014,7873,7375,498,6.3
13,85,Dawson,2014,10779,10121,658,6.1
13,87,Decatur,2014,11359,10430,929,8.2
13,89,DeKalb,2014,368198,341429,26769,7.3
13,91,Dodge,2014,7423,6695,728,9.8
13,93,Dooly,2014,4629,4183,446,9.6
13,95,Dougherty,2014,38601,35022,3579,9.3
13,97,Douglas,2014,67571,62550,5021,7.4
13,99,Early,2014,4337,3947,390,9.0
13,101,Echols,2014,1781,1676,105,5.9
13,103,Effingham,2014,26223,24587,1636,6.2
13,105,Elbert,2014,8056,7359,697,8.7
13,107,Emanuel,2014,8573,7673,900,10.5
13,109,Evans,2014,4729,4423,306,6.5
13,111,Fannin,2014,9840,9090,750,7.6
13,113,Fayette,2014,53669,50386,3283,6.1
13,115,Floyd,2014,43217,39787,3430,7.9
13,117,Forsyth,2014,100209,94927,5282,5.3
13,119,Franklin,2014,9236,8483,753,8.2
13,121,Fulton,2014,508619,472618,36001,7.1
13,123,Gilmer,2014,11946,11075,871,7.3
13,125,Glascock,2014,1264,1162,102,8.1
13,127,Glynn,2014,37028,34255,2773,7.5
13,129,Gordon,2014,26035,24131,1904,7.3
13,131,Grady,2014,10437,9669,768,7.4
13,133,Greene,2014,6416,5888,528,8.2
13,135,Gwinnett,2014,443651,416686,26965,6.1
13,137,Habersham,2014,18941,17617,1324,7.0
13,139,Hall,2014,89924,84604,5320,5.9
13,141,Hancock,2014,2520,2224,296,11.7
13,143,Haralson,2014,11856,10912,944,8.0
13,145,Harris,2014,15700,14758,942,6.0
13,147,Hart,2014,10369,9588,781,7.5
13,149,Heard,2014,4959,4565,394,7.9
13,151,Henry,2014,103372,95844,7528,7.3
13,153,Houston,2014,65831,61332,4499,6.8
13,155,Irwin,2014,3138,2838,300,9.6
13,157,Jackson,2014,29767,28017,1750,5.9
13,159,Jasper,2014,6341,5918,423,6.7
13,161,Jeff Davis,2014,6387,5863,524,8.2
13,163,Jefferson,2014,6644,5893,751,11.3
13,165,Jenkins,2014,3256,2930,326,10.0
13,167,Johnson,2014,3930,3591,339,8.6
13,169,Jones,2014,13671,12804,867,6.3
13,171,Lamar,2014,7778,7032,746,9.6
13,173,Lanier,2014,3787,3480,307,8.1
13,175,Laurens,2014,19004,17244,1760,9.3
13,177,Lee,2014,14121,13237,884,6.3
13,179,Liberty,2014,25594,23631,1963,7.7
13,181,Lincoln,2014,3332,3054,278,8.3
13,183,Long,2014,6690,6192,498,7.4
13,185,Lowndes,2014,50467,46786,3681,7.3
13,187,Lumpkin,2014,15232,14260,972,6.4
13,189,McDuffie,2014,8787,7906,881,10.0
13,191,McIntosh,2014,5858,5395,463,7.9
13,193,Macon,2014,4733,4173,560,11.8
13,195,Madison,2014,12686,11835,851,6.7
13,197,Marion,2014,3451,3185,266,7.7
13,199,Meriwether,2014,8734,7878,856,9.8
13,201,Miller,2014,2669,2500,169,6.3
13,205,Mitchell,2014,8751,8061,690,7.9
13,207,Monroe,2014,12710,11855,855,6.7
13,209,Montgomery,2014,3853,3454,399,10.4
13,211,Morgan,2014,8344,7796,548,6.6
13,213,Murray,2014,15847,14358,1489,9.4
13,215,Muscogee,2014,80711,73885,6826,8.5
13,217,Newton,2014,47871,43929,3942,8.2
13,219,Oconee,2014,17232,16355,877,5.1
13,221,Oglethorpe,2014,6649,6207,442,6.6
13,223,Paulding,2014,74715,70102,4613,6.2
13,225,Peach,2014,11470,10379,1091,9.5
13,227,Pickens,2014,13803,12878,925,6.7
13,229,Pierce,2014,8077,7471,606,7.5
13,231,Pike,2014,8181,7605,576,7.0
13,233,Polk,2014,18313,16881,1432,7.8
13,235,Pulaski,2014,4056,3738,318,7.8
13,237,Putnam,2014,8079,7345,734,9.1
13,239,Quitman,2014,890,815,75,8.4
13,241,Rabun,2014,6540,6003,537,8.2
13,243,Randolph,2014,2715,2451,264,9.7
13,245,Richmond,2014,84527,77147,7380,8.7
13,247,Rockdale,2014,41972,38661,3311,7.9
13,249,Schley,2014,2172,2006,166,7.6
13,251,Screven,2014,5355,4817,538,10.0
13,253,Seminole,2014,3115,2820,295,9.5
13,255,Spalding,2014,27238,24651,2587,9.5
13,257,Stephens,2014,11194,10334,860,7.7
13,259,Stewart,2014,2184,2020,164,7.5
13,261,Sumter,2014,13418,12140,1278,9.5
13,263,Talbot,2014,2801,2580,221,7.9
13,265,Taliaferro,2014,592,527,65,11.0
13,267,Tattnall,2014,9508,8844,664,7.0
13,269,Taylor,2014,2843,2551,292,10.3
13,271,Telfair,2014,5242,4729,513,9.8
13,273,Terrell,2014,3613,3322,291,8.1
13,275,Thomas,2014,17123,15619,1504,8.8
13,277,Tift,2014,18223,16890,1333,7.3
13,279,Toombs,2014,12220,11009,1211,9.9
13,281,Towns,2014,4133,3751,382,9.2
13,283,Treutlen,2014,2790,2493,297,10.6
13,285,Troup,2014,36041,33389,2652,7.4
13,287,Turner,2014,3253,2993,260,8.0
13,289,Twiggs,2014,2993,2659,334,11.2
13,291,Union,2014,9501,8872,629,6.6
13,293,Upson,2014,11290,10281,1009,8.9
13,295,Walker,2014,29356,27230,2126,7.2
13,297,Walton,2014,41346,38673,2673,6.5
13,299,Ware,2014,14737,13567,1170,7.9
13,301,Warren,2014,2711,2447,264,9.7
13,303,Washington,2014,7542,6929,613,8.1
13,305,Wayne,2014,11814,10777,1037,8.8
13,307,Webster,2014,1013,926,87,8.6
13,309,Wheeler,2014,1864,1633,231,12.4
13,311,White,2014,13812,12950,862,6.2
13,313,Whitfield,2014,44662,41146,3516,7.9
13,315,Wilcox,2014,2837,2577,260,9.2
13,317,Wilkes,2014,3730,3382,348,9.3
13,319,Wilkinson,2014,3712,3388,324,8.7
13,321,Worth,2014,8929,8223,706,7.9
15,1,Hawaii,2014,88402,83722,4680,5.3
15,3,Honolulu/city,2014,457070,438886,18184,4.0
15,7,Kauai,2014,35343,33718,1625,4.6
15,9,Maui,2014,83200,79587,3613,4.3
16,1,Ada,2014,210952,203035,7917,3.8
16,3,Adams,2014,1663,1510,153,9.2
16,5,Bannock,2014,41367,39661,1706,4.1
16,7,Bear Lake,2014,2850,2733,117,4.1
16,9,Benewah,2014,3940,3649,291,7.4
16,11,Bingham,2014,21977,21079,898,4.1
16,13,Blaine,2014,11418,10954,464,4.1
16,15,Boise,2014,2903,2730,173,6.0
16,17,Bonner,2014,18116,16937,1179,6.5
16,19,Bonneville,2014,49418,47550,1868,3.8
16,21,Boundary,2014,4885,4616,269,5.5
16,23,Butte,2014,1297,1233,64,4.9
16,25,Camas,2014,629,598,31,4.9
16,27,Canyon,2014,88575,83805,4770,5.4
16,29,Caribou,2014,3838,3691,147,3.8
16,31,Cassia,2014,11199,10768,431,3.8
16,33,Clark,2014,441,422,19,4.3
16,35,Clearwater,2014,3105,2842,263,8.5
16,37,Custer,2014,2125,1991,134,6.3
16,39,Elmore,2014,10958,10438,520,4.7
16,41,Franklin,2014,6386,6192,194,3.0
16,43,Fremont,2014,6955,6698,257,3.7
16,45,Gem,2014,7475,7074,401,5.4
16,47,Gooding,2014,7960,7672,288,3.6
16,49,Idaho,2014,6447,6004,443,6.9
16,51,Jefferson,2014,12210,11765,445,3.6
16,53,Jerome,2014,11139,10738,401,3.6
16,55,Kootenai,2014,70152,66441,3711,5.3
16,57,Latah,2014,19229,18526,703,3.7
16,59,Lemhi,2014,3339,3100,239,7.2
16,61,Lewis,2014,1588,1523,65,4.1
16,63,Lincoln,2014,2593,2455,138,5.3
16,65,Madison,2014,18969,18423,546,2.9
16,67,Minidoka,2014,10367,9938,429,4.1
16,69,Nez Perce,2014,20275,19531,744,3.7
16,71,Oneida,2014,2110,2037,73,3.5
16,73,Owyhee,2014,5002,4838,164,3.3
16,75,Payette,2014,10905,10345,560,5.1
16,77,Power,2014,3960,3786,174,4.4
16,79,Shoshone,2014,5160,4689,471,9.1
16,81,Teton,2014,5601,5398,203,3.6
16,83,Twin Falls,2014,38380,36895,1485,3.9
16,85,Valley,2014,4530,4216,314,6.9
16,87,Washington,2014,4556,4281,275,6.0
17,1,Adams,2014,32629,30873,1756,5.4
17,3,Alexander,2014,2556,2281,275,10.8
17,5,Bond,2014,7892,7371,521,6.6
17,7,Boone,2014,26281,24210,2071,7.9
17,9,Brown,2014,2733,2618,115,4.2
17,11,Bureau,2014,17476,16187,1289,7.4
17,13,Calhoun,2014,2365,2169,196,8.3
17,15,Carroll,2014,7848,7342,506,6.4
17,17,Cass,2014,6411,5964,447,7.0
17,19,Champaign,2014,106804,100559,6245,5.8
17,21,Christian,2014,15728,14519,1209,7.7
17,23,Clark,2014,7963,7391,572,7.2
17,25,Clay,2014,6440,5921,519,8.1
17,27,Clinton,2014,19950,18859,1091,5.5
17,29,Coles,2014,24280,22621,1659,6.8
17,31,Cook,2014,2657984,2456426,201558,7.6
17,33,Crawford,2014,9743,9107,636,6.5
17,35,Cumberland,2014,5860,5511,349,6.0
17,37,DeKalb,2014,55090,51463,3627,6.6
17,39,De Witt,2014,7965,7436,529,6.6
17,41,Douglas,2014,9949,9366,583,5.9
17,43,DuPage,2014,510658,480977,29681,5.8
17,45,Edgar,2014,9133,8473,660,7.2
17,47,Edwards,2014,2851,2658,193,6.8
17,49,Effingham,2014,18357,17352,1005,5.5
17,51,Fayette,2014,9753,9007,746,7.6
17,53,Ford,2014,6640,6246,394,5.9
17,55,Franklin,2014,16642,15092,1550,9.3
17,57,Fulton,2014,15751,14389,1362,8.6
17,59,Gallatin,2014,2463,2286,177,7.2
17,61,Greene,2014,6177,5756,421,6.8
17,63,Grundy,2014,25632,23364,2268,8.8
17,65,Hamilton,2014,4332,4072,260,6.0
17,67,Hancock,2014,8881,8302,579,6.5
17,69,Hardin,2014,1639,1495,144,8.8
17,71,Henderson,2014,3738,3499,239,6.4
17,73,Henry,2014,25341,23642,1699,6.7
17,75,Iroquois,2014,14927,13962,965,6.5
17,77,Jackson,2014,28464,26622,1842,6.5
17,79,Jasper,2014,4645,4345,300,6.5
17,81,Jefferson,2014,17616,16289,1327,7.5
17,83,Jersey,2014,11076,10276,800,7.2
17,85,Jo Daviess,2014,11560,10843,717,6.2
17,87,Johnson,2014,4160,3761,399,9.6
17,89,Kane,2014,265695,247318,18377,6.9
17,91,Kankakee,2014,54852,50378,4474,8.2
17,93,Kendall,2014,65270,61014,4256,6.5
17,95,Knox,2014,23582,21936,1646,7.0
17,97,Lake,2014,364629,340872,23757,6.5
17,99,LaSalle,2014,57214,52516,4698,8.2
17,101,Lawrence,2014,6347,5850,497,7.8
17,103,Lee,2014,18138,16995,1143,6.3
17,105,Livingston,2014,17474,16348,1126,6.4
17,107,Logan,2014,12996,12157,839,6.5
17,109,McDonough,2014,14291,13307,984,6.9
17,111,McHenry,2014,165941,154933,11008,6.6
17,113,McLean,2014,91147,86138,5009,5.5
17,115,Macon,2014,51102,46727,4375,8.6
17,117,Macoupin,2014,23132,21388,1744,7.5
17,119,Madison,2014,132263,122876,9387,7.1
17,121,Marion,2014,18044,16658,1386,7.7
17,123,Marshall,2014,5753,5344,409,7.1
17,125,Mason,2014,6636,6061,575,8.7
17,127,Massac,2014,6318,5810,508,8.0
17,129,Menard,2014,6624,6239,385,5.8
17,131,Mercer,2014,8316,7730,586,7.0
17,133,Monroe,2014,17873,16906,967,5.4
17,135,Montgomery,2014,12114,11045,1069,8.8
17,137,Morgan,2014,17158,16125,1033,6.0
17,139,Moultrie,2014,7052,6667,385,5.5
17,141,Ogle,2014,25916,23982,1934,7.5
17,143,Peoria,2014,91488,84396,7092,7.8
17,145,Perry,2014,8884,8127,757,8.5
17,147,Piatt,2014,8581,8107,474,5.5
17,149,Pike,2014,7748,7298,450,5.8
17,151,Pope,2014,1796,1646,150,8.4
17,153,Pulaski,2014,2138,1914,224,10.5
17,155,Putnam,2014,3033,2799,234,7.7
17,157,Randolph,2014,14161,13215,946,6.7
17,159,Richland,2014,7231,6761,470,6.5
17,161,Rock Island,2014,72905,67727,5178,7.1
17,163,St. Clair,2014,126426,116428,9998,7.9
17,165,Saline,2014,10768,9878,890,8.3
17,167,Sangamon,2014,102401,96182,6219,6.1
17,169,Schuyler,2014,3457,3222,235,6.8
17,171,Scott,2014,2554,2376,178,7.0
17,173,Shelby,2014,10158,9466,692,6.8
17,175,Stark,2014,2802,2589,213,7.6
17,177,Stephenson,2014,22233,20584,1649,7.4
17,179,Tazewell,2014,67731,63132,4599,6.8
17,181,Union,2014,7295,6647,648,8.9
17,183,Vermilion,2014,35478,32441,3037,8.6
17,185,Wabash,2014,5565,5230,335,6.0
17,187,Warren,2014,8732,8219,513,5.9
17,189,Washington,2014,9019,8587,432,4.8
17,191,Wayne,2014,7670,7159,511,6.7
17,193,White,2014,7070,6652,418,5.9
17,195,Whiteside,2014,28576,26581,1995,7.0
17,197,Will,2014,357335,329806,27529,7.7
17,199,Williamson,2014,31389,29133,2256,7.2
17,201,Winnebago,2014,141833,129969,11864,8.4
17,203,Woodford,2014,19671,18574,1097,5.6
18,1,Adams,2014,16424,15673,751,4.6
18,3,Allen,2014,175752,165714,10038,5.7
18,5,Bartholomew,2014,42629,40766,1863,4.4
18,7,Benton,2014,4475,4233,242,5.4
18,9,Blackford,2014,5266,4877,389,7.4
18,11,Boone,2014,32204,30795,1409,4.4
18,13,Brown,2014,7361,6922,439,6.0
18,15,Carroll,2014,9887,9371,516,5.2
18,17,Cass,2014,17740,16722,1018,5.7
18,19,Clark,2014,57640,54537,3103,5.4
18,21,Clay,2014,12440,11604,836,6.7
18,23,Clinton,2014,16663,15812,851,5.1
18,25,Crawford,2014,4895,4521,374,7.6
18,27,Daviess,2014,15184,14507,677,4.5
18,29,Dearborn,2014,25126,23479,1647,6.6
18,31,Decatur,2014,14189,13494,695,4.9
18,33,DeKalb,2014,21268,20164,1104,5.2
18,35,Delaware,2014,53602,49868,3734,7.0
18,37,Dubois,2014,22052,21157,895,4.1
18,39,Elkhart,2014,102208,97040,5168,5.1
18,41,Fayette,2014,9093,8386,707,7.8
18,43,Floyd,2014,39092,37113,1979,5.1
18,45,Fountain,2014,8194,7623,571,7.0
18,47,Franklin,2014,10887,10179,708,6.5
18,49,Fulton,2014,9796,9184,612,6.2
18,51,Gibson,2014,18440,17615,825,4.5
18,53,Grant,2014,32671,30437,2234,6.8
18,55,Greene,2014,13858,12760,1098,7.9
18,57,Hamilton,2014,161190,154656,6534,4.1
18,59,Hancock,2014,36626,34737,1889,5.2
18,61,Harrison,2014,19049,17988,1061,5.6
18,63,Hendricks,2014,80729,77028,3701,4.6
18,65,Henry,2014,21471,20015,1456,6.8
18,67,Howard,2014,36950,34640,2310,6.3
18,69,Huntington,2014,18559,17486,1073,5.8
18,71,Jackson,2014,21329,20268,1061,5.0
18,73,Jasper,2014,16149,15075,1074,6.7
18,75,Jay,2014,10106,9521,585,5.8
18,77,Jefferson,2014,15069,14156,913,6.1
18,79,Jennings,2014,13095,12221,874,6.7
18,81,Johnson,2014,75554,71807,3747,5.0
18,83,Knox,2014,18851,17870,981,5.2
18,85,Kosciusko,2014,40341,38375,1966,4.9
18,87,LaGrange,2014,18230,17419,811,4.4
18,89,Lake,2014,230655,212526,18129,7.9
18,91,LaPorte,2014,48898,45175,3723,7.6
18,93,Lawrence,2014,20390,18747,1643,8.1
18,95,Madison,2014,57963,53843,4120,7.1
18,97,Marion,2014,467693,437320,30373,6.5
18,99,Marshall,2014,23729,22436,1293,5.4
18,101,Martin,2014,4958,4694,264,5.3
18,103,Miami,2014,15677,14646,1031,6.6
18,105,Monroe,2014,67528,63675,3853,5.7
18,107,Montgomery,2014,18701,17695,1006,5.4
18,109,Morgan,2014,35009,32982,2027,5.8
18,111,Newton,2014,6951,6468,483,6.9
18,113,Noble,2014,23144,21947,1197,5.2
18,115,Ohio,2014,3219,2998,221,6.9
18,117,Orange,2014,8544,7885,659,7.7
18,119,Owen,2014,9486,8719,767,8.1
18,121,Parke,2014,6953,6469,484,7.0
18,123,Perry,2014,9181,8646,535,5.8
18,125,Pike,2014,6350,6029,321,5.1
18,127,Porter,2014,84077,78881,5196,6.2
18,129,Posey,2014,13161,12534,627,4.8
18,131,Pulaski,2014,6197,5864,333,5.4
18,133,Putnam,2014,16275,15199,1076,6.6
18,135,Randolph,2014,12489,11687,802,6.4
18,137,Ripley,2014,13645,12748,897,6.6
18,139,Rush,2014,8534,8056,478,5.6
18,141,St. Joseph,2014,128812,120407,8405,6.5
18,143,Scott,2014,10193,9502,691,6.8
18,145,Shelby,2014,22447,21174,1273,5.7
18,147,Spencer,2014,10752,10202,550,5.1
18,149,Starke,2014,10238,9498,740,7.2
18,151,Steuben,2014,19819,18864,955,4.8
18,153,Sullivan,2014,8653,8036,617,7.1
18,155,Switzerland,2014,4806,4523,283,5.9
18,157,Tippecanoe,2014,91364,86782,4582,5.0
18,159,Tipton,2014,8170,7747,423,5.2
18,161,Union,2014,3545,3346,199,5.6
18,163,Vanderburgh,2014,92139,87183,4956,5.4
18,165,Vermillion,2014,7230,6610,620,8.6
18,167,Vigo,2014,49505,45748,3757,7.6
18,169,Wabash,2014,15479,14620,859,5.5
18,171,Warren,2014,4098,3849,249,6.1
18,173,Warrick,2014,31202,29676,1526,4.9
18,175,Washington,2014,13326,12441,885,6.6
18,177,Wayne,2014,30933,28924,2009,6.5
18,179,Wells,2014,13765,13107,658,4.8
18,181,White,2014,13461,12780,681,5.1
18,183,Whitley,2014,16850,15984,866,5.1
19,1,Adair,2014,4151,3985,166,4.0
19,3,Adams,2014,2212,2138,74,3.3
19,5,Allamakee,2014,7703,7270,433,5.6
19,7,Appanoose,2014,6149,5799,350,5.7
19,9,Audubon,2014,3258,3118,140,4.3
19,11,Benton,2014,13862,13224,638,4.6
19,13,Black Hawk,2014,72154,68621,3533,4.9
19,15,Boone,2014,15193,14677,516,3.4
19,17,Bremer,2014,14176,13657,519,3.7
19,19,Buchanan,2014,11465,10933,532,4.6
19,21,Buena Vista,2014,11481,11027,454,4.0
19,23,Butler,2014,8379,8026,353,4.2
19,25,Calhoun,2014,4420,4207,213,4.8
19,27,Carroll,2014,11225,10871,354,3.2
19,29,Cass,2014,7383,7064,319,4.3
19,31,Cedar,2014,10925,10504,421,3.9
19,33,Cerro Gordo,2014,23232,22155,1077,4.6
19,35,Cherokee,2014,6630,6294,336,5.1
19,37,Chickasaw,2014,6478,6172,306,4.7
19,39,Clarke,2014,4678,4469,209,4.5
19,41,Clay,2014,8942,8569,373,4.2
19,43,Clayton,2014,10188,9682,506,5.0
19,45,Clinton,2014,24783,23484,1299,5.2
19,47,Crawford,2014,8732,8377,355,4.1
19,49,Dallas,2014,42713,41312,1401,3.3
19,51,Davis,2014,4110,3900,210,5.1
19,53,Decatur,2014,4440,4272,168,3.8
19,55,Delaware,2014,10525,10129,396,3.8
19,57,Des Moines,2014,20839,19796,1043,5.0
19,59,Dickinson,2014,9710,9257,453,4.7
19,61,Dubuque,2014,55567,53278,2289,4.1
19,63,Emmet,2014,5733,5507,226,3.9
19,65,Fayette,2014,10792,10253,539,5.0
19,67,Floyd,2014,8409,8030,379,4.5
19,69,Franklin,2014,5977,5741,236,3.9
19,71,Fremont,2014,4169,4008,161,3.9
19,73,Greene,2014,5273,5061,212,4.0
19,75,Grundy,2014,6723,6444,279,4.1
19,77,Guthrie,2014,5611,5366,245,4.4
19,79,Hamilton,2014,7098,6777,321,4.5
19,81,Hancock,2014,6297,6090,207,3.3
19,83,Hardin,2014,8708,8333,375,4.3
19,85,Harrison,2014,7538,7236,302,4.0
19,87,Henry,2014,9544,9126,418,4.4
19,89,Howard,2014,5316,5101,215,4.0
19,91,Humboldt,2014,5260,5061,199,3.8
19,93,Ida,2014,3890,3751,139,3.6
19,95,Iowa,2014,10206,9781,425,4.2
19,97,Jackson,2014,11019,10463,556,5.0
19,99,Jasper,2014,19327,18475,852,4.4
19,101,Jefferson,2014,9080,8685,395,4.4
19,103,Johnson,2014,84034,81448,2586,3.1
19,105,Jones,2014,10793,10263,530,4.9
19,107,Keokuk,2014,5516,5273,243,4.4
19,109,Kossuth,2014,8662,8385,277,3.2
19,111,Lee,2014,17733,16691,1042,5.9
19,113,Linn,2014,121005,115706,5299,4.4
19,115,Louisa,2014,5933,5667,266,4.5
19,117,Lucas,2014,4311,4143,168,3.9
19,119,Lyon,2014,7016,6838,178,2.5
19,121,Madison,2014,8231,7859,372,4.5
19,123,Mahaska,2014,11860,11341,519,4.4
19,125,Marion,2014,17437,16774,663,3.8
19,127,Marshall,2014,19833,18767,1066,5.4
19,129,Mills,2014,7398,7075,323,4.4
19,131,Mitchell,2014,5461,5267,194,3.6
19,133,Monona,2014,4756,4520,236,5.0
19,135,Monroe,2014,4076,3870,206,5.1
19,137,Montgomery,2014,5162,4950,212,4.1
19,139,Muscatine,2014,22117,21116,1001,4.5
19,141,O'Brien,2014,8237,7969,268,3.3
19,143,Osceola,2014,3460,3345,115,3.3
19,145,Page,2014,6598,6306,292,4.4
19,147,Palo Alto,2014,4854,4679,175,3.6
19,149,Plymouth,2014,14665,14163,502,3.4
19,151,Pocahontas,2014,4328,4177,151,3.5
19,153,Polk,2014,255659,244872,10787,4.2
19,155,Pottawattamie,2014,49193,47086,2107,4.3
19,157,Poweshiek,2014,10406,9964,442,4.2
19,159,Ringgold,2014,2531,2434,97,3.8
19,161,Sac,2014,5557,5339,218,3.9
19,163,Scott,2014,88865,84265,4600,5.2
19,165,Shelby,2014,7053,6833,220,3.1
19,167,Sioux,2014,20134,19544,590,2.9
19,169,Story,2014,56632,54999,1633,2.9
19,171,Tama,2014,9238,8752,486,5.3
19,173,Taylor,2014,3243,3124,119,3.7
19,175,Union,2014,6815,6495,320,4.7
19,177,Van Buren,2014,3915,3738,177,4.5
19,179,Wapello,2014,18142,17147,995,5.5
19,181,Warren,2014,26772,25714,1058,4.0
19,183,Washington,2014,12323,11881,442,3.6
19,185,Wayne,2014,2872,2728,144,5.0
19,187,Webster,2014,19827,18870,957,4.8
19,189,Winnebago,2014,5225,5005,220,4.2
19,191,Winneshiek,2014,12060,11549,511,4.2
19,193,Woodbury,2014,55956,53508,2448,4.4
19,195,Worth,2014,4204,4014,190,4.5
19,197,Wright,2014,6951,6667,284,4.1
20,1,Allen,2014,6817,6473,344,5.0
20,3,Anderson,2014,4193,3978,215,5.1
20,5,Atchison,2014,7643,7150,493,6.5
20,7,Barber,2014,2720,2637,83,3.1
20,9,Barton,2014,15482,14936,546,3.5
20,11,Bourbon,2014,7105,6734,371,5.2
20,13,Brown,2014,5416,5196,220,4.1
20,15,Butler,2014,31996,30448,1548,4.8
20,17,Chase,2014,1234,1184,50,4.1
20,19,Chautauqua,2014,1579,1494,85,5.4
20,21,Cherokee,2014,10366,9848,518,5.0
20,23,Cheyenne,2014,1317,1276,41,3.1
20,25,Clark,2014,1146,1116,30,2.6
20,27,Clay,2014,4176,3993,183,4.4
20,29,Cloud,2014,4397,4213,184,4.2
20,31,Coffey,2014,4902,4624,278,5.7
20,33,Comanche,2014,980,950,30,3.1
20,35,Cowley,2014,17288,16493,795,4.6
20,37,Crawford,2014,19162,18144,1018,5.3
20,39,Decatur,2014,1355,1308,47,3.5
20,41,Dickinson,2014,9735,9246,489,5.0
20,43,Doniphan,2014,4301,4109,192,4.5
20,45,Douglas,2014,64745,62121,2624,4.1
20,47,Edwards,2014,1608,1555,53,3.3
20,49,Elk,2014,1311,1244,67,5.1
20,51,Ellis,2014,17937,17447,490,2.7
20,53,Ellsworth,2014,3450,3349,101,2.9
20,55,Finney,2014,20232,19543,689,3.4
20,57,Ford,2014,18206,17519,687,3.8
20,59,Franklin,2014,14072,13358,714,5.1
20,61,Geary,2014,12349,11454,895,7.2
20,63,Gove,2014,1486,1447,39,2.6
20,65,Graham,2014,1314,1272,42,3.2
20,67,Grant,2014,3943,3809,134,3.4
20,69,Gray,2014,3501,3407,94,2.7
20,71,Greeley,2014,898,879,19,2.1
20,73,Greenwood,2014,3332,3183,149,4.5
20,75,Hamilton,2014,1664,1626,38,2.3
20,77,Harper,2014,2985,2875,110,3.7
20,79,Harvey,2014,17139,16415,724,4.2
20,81,Haskell,2014,2360,2299,61,2.6
20,83,Hodgeman,2014,1036,1001,35,3.4
20,85,Jackson,2014,7399,7095,304,4.1
20,87,Jefferson,2014,10231,9741,490,4.8
20,89,Jewell,2014,1382,1329,53,3.8
20,91,Johnson,2014,321300,309249,12051,3.8
20,93,Kearny,2014,2121,2056,65,3.1
20,95,Kingman,2014,3609,3466,143,4.0
20,97,Kiowa,2014,1352,1308,44,3.3
20,99,Labette,2014,10788,10164,624,5.8
20,101,Lane,2014,865,837,28,3.2
20,103,Leavenworth,2014,35047,33312,1735,5.0
20,105,Lincoln,2014,1775,1702,73,4.1
20,107,Linn,2014,4325,4005,320,7.4
20,109,Logan,2014,1737,1698,39,2.2
20,111,Lyon,2014,16539,15698,841,5.1
20,113,McPherson,2014,16853,16310,543,3.2
20,115,Marion,2014,6150,5901,249,4.0
20,117,Marshall,2014,5886,5697,189,3.2
20,119,Meade,2014,2384,2321,63,2.6
20,121,Miami,2014,16880,16090,790,4.7
20,123,Mitchell,2014,3840,3716,124,3.2
20,125,Montgomery,2014,17364,16371,993,5.7
20,127,Morris,2014,3101,2965,136,4.4
20,129,Morton,2014,1490,1432,58,3.9
20,131,Nemaha,2014,5857,5691,166,2.8
20,133,Neosho,2014,6402,5923,479,7.5
20,135,Ness,2014,1615,1572,43,2.7
20,137,Norton,2014,3044,2972,72,2.4
20,139,Osage,2014,8150,7710,440,5.4
20,141,Osborne,2014,2060,1984,76,3.7
20,143,Ottawa,2014,3247,3114,133,4.1
20,145,Pawnee,2014,3395,3267,128,3.8
20,147,Phillips,2014,2912,2811,101,3.5
20,149,Pottawatomie,2014,12048,11582,466,3.9
20,151,Pratt,2014,5508,5331,177,3.2
20,153,Rawlins,2014,1518,1481,37,2.4
20,155,Reno,2014,31235,29870,1365,4.4
20,157,Republic,2014,2572,2494,78,3.0
20,159,Rice,2014,5456,5265,191,3.5
20,161,Riley,2014,36635,35292,1343,3.7
20,163,Rooks,2014,2854,2752,102,3.6
20,165,Rush,2014,1811,1747,64,3.5
20,167,Russell,2014,3843,3709,134,3.5
20,169,Saline,2014,30732,29446,1286,4.2
20,171,Scott,2014,2855,2778,77,2.7
20,173,Sedgwick,2014,247338,234148,13190,5.3
20,175,Seward,2014,11173,10785,388,3.5
20,177,Shawnee,2014,92001,87642,4359,4.7
20,179,Sheridan,2014,1461,1423,38,2.6
20,181,Sherman,2014,3095,2997,98,3.2
20,183,Smith,2014,2120,2054,66,3.1
20,185,Stafford,2014,2166,2085,81,3.7
20,187,Stanton,2014,1028,994,34,3.3
20,189,Stevens,2014,3370,3270,100,3.0
20,191,Sumner,2014,11083,10558,525,4.7
20,193,Thomas,2014,4386,4260,126,2.9
20,195,Trego,2014,1491,1445,46,3.1
20,197,Wabaunsee,2014,3765,3611,154,4.1
20,199,Wallace,2014,877,855,22,2.5
20,201,Washington,2014,3109,3010,99,3.2
20,203,Wichita,2014,1237,1202,35,2.8
20,205,Wilson,2014,4175,3889,286,6.9
20,207,Woodson,2014,1629,1544,85,5.2
20,209,Wyandotte,2014,75658,70513,5145,6.8
21,1,Adair,2014,7224,6602,622,8.6
21,3,Allen,2014,8670,8160,510,5.9
21,5,Anderson,2014,11432,10839,593,5.2
21,7,Ballard,2014,3676,3383,293,8.0
21,9,Barren,2014,18725,17554,1171,6.3
21,11,Bath,2014,4722,4304,418,8.9
21,13,Bell,2014,9311,8375,936,10.1
21,15,Boone,2014,65273,61910,3363,5.2
21,17,Bourbon,2014,9649,9109,540,5.6
21,19,Boyd,2014,19081,17648,1433,7.5
21,21,Boyle,2014,12292,11447,845,6.9
21,23,Bracken,2014,3800,3501,299,7.9
21,25,Breathitt,2014,4180,3705,475,11.4
21,27,Breckinridge,2014,8087,7506,581,7.2
21,29,Bullitt,2014,39228,36963,2265,5.8
21,31,Butler,2014,5191,4804,387,7.5
21,33,Caldwell,2014,5453,5099,354,6.5
21,35,Calloway,2014,18719,17644,1075,5.7
21,37,Campbell,2014,47899,45428,2471,5.2
21,39,Carlisle,2014,2382,2240,142,6.0
21,41,Carroll,2014,4870,4524,346,7.1
21,43,Carter,2014,10485,9364,1121,10.7
21,45,Casey,2014,6620,6172,448,6.8
21,47,Christian,2014,25431,23505,1926,7.6
21,49,Clark,2014,16983,15948,1035,6.1
21,51,Clay,2014,5555,4936,619,11.1
21,53,Clinton,2014,4005,3645,360,9.0
21,55,Crittenden,2014,3873,3634,239,6.2
21,57,Cumberland,2014,2950,2728,222,7.5
21,59,Daviess,2014,45952,43358,2594,5.6
21,61,Edmonson,2014,4782,4384,398,8.3
21,63,Elliott,2014,2154,1911,243,11.3
21,65,Estill,2014,5408,5003,405,7.5
21,67,Fayette,2014,167074,159106,7968,4.8
21,69,Fleming,2014,6371,5881,490,7.7
21,71,Floyd,2014,12404,11135,1269,10.2
21,73,Franklin,2014,24370,23085,1285,5.3
21,75,Fulton,2014,2229,2044,185,8.3
21,77,Gallatin,2014,3864,3595,269,7.0
21,79,Garrard,2014,7592,7098,494,6.5
21,81,Grant,2014,11208,10477,731,6.5
21,83,Graves,2014,15867,14685,1182,7.4
21,85,Grayson,2014,10867,9958,909,8.4
21,87,Green,2014,5084,4753,331,6.5
21,89,Greenup,2014,14295,13080,1215,8.5
21,91,Hancock,2014,3982,3743,239,6.0
21,93,Hardin,2014,46629,43744,2885,6.2
21,95,Harlan,2014,8400,7233,1167,13.9
21,97,Harrison,2014,8426,7924,502,6.0
21,99,Hart,2014,7821,7329,492,6.3
21,101,Henderson,2014,21657,20346,1311,6.1
21,103,Henry,2014,7643,7206,437,5.7
21,105,Hickman,2014,2129,1997,132,6.2
21,107,Hopkins,2014,20422,19113,1309,6.4
21,109,Jackson,2014,4582,4059,523,11.4
21,111,Jefferson,2014,377547,354906,22641,6.0
21,113,Jessamine,2014,24921,23619,1302,5.2
21,115,Johnson,2014,8054,7315,739,9.2
21,117,Kenton,2014,83160,78569,4591,5.5
21,119,Knott,2014,5136,4567,569,11.1
21,121,Knox,2014,10122,9120,1002,9.9
21,123,Larue,2014,5768,5389,379,6.6
21,125,Laurel,2014,24137,22302,1835,7.6
21,127,Lawrence,2014,5276,4773,503,9.5
21,129,Lee,2014,2314,2090,224,9.7
21,131,Leslie,2014,3176,2769,407,12.8
21,133,Letcher,2014,7246,6355,891,12.3
21,135,Lewis,2014,5172,4676,496,9.6
21,137,Lincoln,2014,9332,8510,822,8.8
21,139,Livingston,2014,3761,3453,308,8.2
21,141,Logan,2014,11926,11254,672,5.6
21,143,Lyon,2014,2983,2775,208,7.0
21,145,McCracken,2014,29493,27433,2060,7.0
21,147,McCreary,2014,5046,4516,530,10.5
21,149,McLean,2014,4318,4044,274,6.3
21,151,Madison,2014,45326,42882,2444,5.4
21,153,Magoffin,2014,3726,3207,519,13.9
21,155,Marion,2014,9194,8610,584,6.4
21,157,Marshall,2014,14965,13961,1004,6.7
21,159,Martin,2014,3438,3126,312,9.1
21,161,Mason,2014,7744,7134,610,7.9
21,163,Meade,2014,12126,11274,852,7.0
21,165,Menifee,2014,2357,2127,230,9.8
21,167,Mercer,2014,9903,9294,609,6.1
21,169,Metcalfe,2014,4133,3882,251,6.1
21,171,Monroe,2014,4603,4350,253,5.5
21,173,Montgomery,2014,11760,10885,875,7.4
21,175,Morgan,2014,4795,4346,449,9.4
21,177,Muhlenberg,2014,12369,11429,940,7.6
21,179,Nelson,2014,21313,20016,1297,6.1
21,181,Nicholas,2014,3453,3187,266,7.7
21,183,Ohio,2014,9523,8794,729,7.7
21,185,Oldham,2014,30282,28852,1430,4.7
21,187,Owen,2014,5527,5251,276,5.0
21,189,Owsley,2014,1179,1056,123,10.4
21,191,Pendleton,2014,6763,6314,449,6.6
21,193,Perry,2014,9540,8560,980,10.3
21,195,Pike,2014,22000,19696,2304,10.5
21,197,Powell,2014,4973,4553,420,8.4
21,199,Pulaski,2014,26290,24365,1925,7.3
21,201,Robertson,2014,810,747,63,7.8
21,203,Rockcastle,2014,6889,6371,518,7.5
21,205,Rowan,2014,10557,9824,733,6.9
21,207,Russell,2014,6586,5914,672,10.2
21,209,Scott,2014,26500,25211,1289,4.9
21,211,Shelby,2014,22509,21400,1109,4.9
21,213,Simpson,2014,8493,7994,499,5.9
21,215,Spencer,2014,9159,8679,480,5.2
21,217,Taylor,2014,11281,10413,868,7.7
21,219,Todd,2014,5463,5168,295,5.4
21,221,Trigg,2014,5718,5316,402,7.0
21,223,Trimble,2014,3878,3597,281,7.2
21,225,Union,2014,6761,6329,432,6.4
21,227,Warren,2014,59395,56106,3289,5.5
21,229,Washington,2014,6126,5795,331,5.4
21,231,Wayne,2014,7259,6559,700,9.6
21,233,Webster,2014,6291,5950,341,5.4
21,235,Whitley,2014,13406,12241,1165,8.7
21,237,Wolfe,2014,2056,1825,231,11.2
21,239,Woodford,2014,14245,13611,634,4.5
22,1,Acadia Parish,2014,26543,25045,1498,5.6
22,3,Allen Parish,2014,8859,8234,625,7.1
22,5,Ascension Parish,2014,59431,56324,3107,5.2
22,7,Assumption Parish,2014,10016,9259,757,7.6
22,9,Avoyelles Parish,2014,16059,14921,1138,7.1
22,11,Beauregard Parish,2014,14733,13752,981,6.7
22,13,Bienville Parish,2014,5904,5445,459,7.8
22,15,Bossier Parish,2014,57910,54652,3258,5.6
22,17,Caddo Parish,2014,110589,102525,8064,7.3
22,19,Calcasieu Parish,2014,94139,88684,5455,5.8
22,21,Caldwell Parish,2014,4059,3750,309,7.6
22,23,Cameron Parish,2014,3429,3263,166,4.8
22,25,Catahoula Parish,2014,3826,3523,303,7.9
22,27,Claiborne Parish,2014,6329,5868,461,7.3
22,29,Concordia Parish,2014,7716,7064,652,8.4
22,31,De Soto Parish,2014,11070,10190,880,7.9
22,33,East Baton Rouge Parish,2014,231088,218054,13034,5.6
22,35,East Carroll Parish,2014,2207,1890,317,14.4
22,37,East Feliciana Parish,2014,8152,7638,514,6.3
22,39,Evangeline Parish,2014,13077,12210,867,6.6
22,41,Franklin Parish,2014,7561,6860,701,9.3
22,43,Grant Parish,2014,8371,7788,583,7.0
22,45,Iberia Parish,2014,32429,30419,2010,6.2
22,47,Iberville Parish,2014,14303,13205,1098,7.7
22,49,Jackson Parish,2014,7209,6794,415,5.8
22,51,Jefferson Parish,2014,217170,204407,12763,5.9
22,53,Jefferson Davis Parish,2014,13514,12735,779,5.8
22,55,Lafayette Parish,2014,121951,116068,5883,4.8
22,57,Lafourche Parish,2014,48292,46020,2272,4.7
22,59,LaSalle Parish,2014,6602,6264,338,5.1
22,61,Lincoln Parish,2014,20580,19061,1519,7.4
22,63,Livingston Parish,2014,66303,62728,3575,5.4
22,65,Madison Parish,2014,3903,3479,424,10.9
22,67,Morehouse Parish,2014,11106,9880,1226,11.0
22,69,Natchitoches Parish,2014,16818,15539,1279,7.6
22,71,Orleans Parish,2014,178265,166143,12122,6.8
22,73,Ouachita Parish,2014,71668,66761,4907,6.8
22,75,Plaquemines Parish,2014,10195,9626,569,5.6
22,77,Pointe Coupee Parish,2014,10061,9366,695,6.9
22,79,Rapides Parish,2014,57784,53998,3786,6.6
22,81,Red River Parish,2014,3974,3693,281,7.1
22,83,Richland Parish,2014,8680,7938,742,8.5
22,85,Sabine Parish,2014,9171,8582,589,6.4
22,87,St. Bernard Parish,2014,19140,17840,1300,6.8
22,89,St. Charles Parish,2014,25378,23863,1515,6.0
22,91,St. Helena Parish,2014,4511,4067,444,9.8
22,93,St. James Parish,2014,9721,8902,819,8.4
22,95,St. John the Baptist Parish,2014,20286,18698,1588,7.8
22,97,St. Landry Parish,2014,34039,31489,2550,7.5
22,99,St. Martin Parish,2014,24569,23185,1384,5.6
22,101,St. Mary Parish,2014,25224,23671,1553,6.2
22,103,St. Tammany Parish,2014,114505,108152,6353,5.5
22,105,Tangipahoa Parish,2014,53508,49512,3996,7.5
22,107,Tensas Parish,2014,1777,1612,165,9.3
22,109,Terrebonne Parish,2014,54458,51868,2590,4.8
22,111,Union Parish,2014,9331,8643,688,7.4
22,113,Vermilion Parish,2014,26415,24968,1447,5.5
22,115,Vernon Parish,2014,17349,15897,1452,8.4
22,117,Washington Parish,2014,16884,15582,1302,7.7
22,119,Webster Parish,2014,15605,14268,1337,8.6
22,121,West Baton Rouge Parish,2014,12829,12098,731,5.7
22,123,West Carroll Parish,2014,4220,3679,541,12.8
22,125,West Feliciana Parish,2014,5337,5039,298,5.6
22,127,Winn Parish,2014,5394,4995,399,7.4
23,1,Androscoggin,2014,56041,53019,3022,5.4
23,3,Aroostook,2014,33021,30530,2491,7.5
23,5,Cumberland,2014,159584,152585,6999,4.4
23,7,Franklin,2014,14971,14003,968,6.5
23,9,Hancock,2014,29849,27836,2013,6.7
23,11,Kennebec,2014,63463,60072,3391,5.3
23,13,Knox,2014,20694,19638,1056,5.1
23,15,Lincoln,2014,17245,16234,1011,5.9
23,17,Oxford,2014,27413,25504,1909,7.0
23,19,Penobscot,2014,79149,74357,4792,6.1
23,21,Piscataquis,2014,7714,7157,557,7.2
23,23,Sagadahoc,2014,19077,18218,859,4.5
23,25,Somerset,2014,24372,22476,1896,7.8
23,27,Waldo,2014,20888,19634,1254,6.0
23,29,Washington,2014,14412,13248,1164,8.1
23,31,York,2014,110144,104496,5648,5.1
24,1,Allegany,2014,33252,30763,2489,7.5
24,3,Anne Arundel,2014,297403,282564,14839,5.0
24,5,Baltimore,2014,441320,414836,26484,6.0
24,9,Calvert,2014,47212,44735,2477,5.2
24,11,Caroline,2014,17406,16332,1074,6.2
24,13,Carroll,2014,92570,88185,4385,4.7
24,15,Cecil,2014,52420,49013,3407,6.5
24,17,Charles,2014,80126,75591,4535,5.7
24,19,Dorchester,2014,15775,14470,1305,8.3
24,21,Frederick,2014,128021,121643,6378,5.0
24,23,Garrett,2014,15534,14440,1094,7.0
24,25,Harford,2014,135219,127649,7570,5.6
24,27,Howard,2014,173385,165997,7388,4.3
24,29,Kent,2014,10344,9688,656,6.3
24,31,Montgomery,2014,544271,520698,23573,4.3
24,33,Prince George's,2014,486156,457128,29028,6.0
24,35,Queen Anne's,2014,26364,25040,1324,5.0
24,37,St. Mary's,2014,54062,51200,2862,5.3
24,39,Somerset,2014,9271,8407,864,9.3
24,41,Talbot,2014,19118,18089,1029,5.4
24,43,Washington,2014,76367,71498,4869,6.4
24,45,Wicomico,2014,50050,46230,3820,7.6
24,47,Worcester,2014,25640,22722,2918,11.4
24,510,Baltimore city,2014,293732,268993,24739,8.4
25,1,Barnstable,2014,112092,104063,8029,7.2
25,3,Berkshire,2014,65597,61290,4307,6.6
25,5,Bristol,2014,289058,267790,21268,7.4
25,7,Dukes,2014,9477,8727,750,7.9
25,9,Essex,2014,405200,380964,24236,6.0
25,11,Franklin,2014,39528,37435,2093,5.3
25,13,Hampden,2014,222351,205507,16844,7.6
25,15,Hampshire,2014,87074,82496,4578,5.3
25,17,Middlesex,2014,855356,815472,39884,4.7
25,19,Nantucket/town,2014,6965,6534,431,6.2
25,21,Norfolk,2014,367437,349093,18344,5.0
25,23,Plymouth,2014,267046,251027,16019,6.0
25,25,Suffolk,2014,415607,393692,21915,5.3
25,27,Worcester,2014,426774,400764,26010,6.1
26,1,Alcona,2014,3836,3428,408,10.6
26,3,Alger,2014,3324,2977,347,10.4
26,5,Allegan,2014,59859,56610,3249,5.4
26,7,Alpena,2014,13571,12483,1088,8.0
26,9,Antrim,2014,10090,9129,961,9.5
26,11,Arenac,2014,6410,5699,711,11.1
26,13,Baraga,2014,3472,3081,391,11.3
26,15,Barry,2014,30015,28388,1627,5.4
26,17,Bay,2014,53232,49393,3839,7.2
26,19,Benzie,2014,8745,7986,759,8.7
26,21,Berrien,2014,73550,68569,4981,6.8
26,23,Branch,2014,19328,18041,1287,6.7
26,25,Calhoun,2014,64211,60140,4071,6.3
26,27,Cass,2014,23884,22273,1611,6.7
26,29,Charlevoix,2014,13123,12053,1070,8.2
26,31,Cheboygan,2014,10701,9551,1150,10.7
26,33,Chippewa,2014,16912,15304,1608,9.5
26,35,Clare,2014,11945,10767,1178,9.9
26,37,Clinton,2014,39673,37671,2002,5.0
26,39,Crawford,2014,5350,4841,509,9.5
26,41,Delta,2014,17479,15998,1481,8.5
26,43,Dickinson,2014,12881,12002,879,6.8
26,45,Eaton,2014,55866,52662,3204,5.7
26,47,Emmet,2014,17980,16262,1718,9.6
26,49,Genesee,2014,181939,167392,14547,8.0
26,51,Gladwin,2014,10059,9124,935,9.3
26,53,Gogebic,2014,6710,6113,597,8.9
26,55,Grand Traverse,2014,48044,45141,2903,6.0
26,57,Gratiot,2014,18514,17203,1311,7.1
26,59,Hillsdale,2014,20546,19106,1440,7.0
26,61,Houghton,2014,16978,15674,1304,7.7
26,63,Huron,2014,16580,15439,1141,6.9
26,65,Ingham,2014,145727,136700,9027,6.2
26,67,Ionia,2014,29305,27486,1819,6.2
26,69,Iosco,2014,10324,9317,1007,9.8
26,71,Iron,2014,5215,4761,454,8.7
26,73,Isabella,2014,35562,33453,2109,5.9
26,75,Jackson,2014,73167,68293,4874,6.7
26,77,Kalamazoo,2014,128362,121148,7214,5.6
26,79,Kalkaska,2014,7732,7001,731,9.5
26,81,Kent,2014,336948,320264,16684,5.0
26,83,Keweenaw,2014,986,876,110,11.2
26,85,Lake,2014,3626,3219,407,11.2
26,87,Lapeer,2014,39845,36049,3796,9.5
26,89,Leelanau,2014,10553,9848,705,6.7
26,91,Lenawee,2014,48104,45011,3093,6.4
26,93,Livingston,2014,95367,89348,6019,6.3
26,95,Luce,2014,2488,2276,212,8.5
26,97,Mackinac,2014,5306,4711,595,11.2
26,99,Macomb,2014,420573,387466,33107,7.9
26,101,Manistee,2014,10381,9497,884,8.5
26,103,Marquette,2014,33868,31488,2380,7.0
26,105,Mason,2014,14715,13607,1108,7.5
26,107,Mecosta,2014,19222,17694,1528,7.9
26,109,Menominee,2014,11752,10943,809,6.9
26,111,Midland,2014,41707,39163,2544,6.1
26,113,Missaukee,2014,7078,6528,550,7.8
26,115,Monroe,2014,76222,71563,4659,6.1
26,117,Montcalm,2014,27716,25615,2101,7.6
26,119,Montmorency,2014,3163,2753,410,13.0
26,121,Muskegon,2014,77368,71415,5953,7.7
26,123,Newaygo,2014,22672,21039,1633,7.2
26,125,Oakland,2014,629684,589088,40596,6.4
26,127,Oceana,2014,12867,11573,1294,10.1
26,129,Ogemaw,2014,8615,7769,846,9.8
26,131,Ontonagon,2014,2386,2114,272,11.4
26,133,Osceola,2014,10237,9362,875,8.5
26,135,Oscoda,2014,2985,2632,353,11.8
26,137,Otsego,2014,11235,10321,914,8.1
26,139,Ottawa,2014,149580,142408,7172,4.8
26,141,Presque Isle,2014,5460,4761,699,12.8
26,143,Roscommon,2014,7975,7059,916,11.5
26,145,Saginaw,2014,89243,82552,6691,7.5
26,147,St. Clair,2014,73631,66608,7023,9.5
26,149,St. Joseph,2014,28928,27245,1683,5.8
26,151,Sanilac,2014,19678,18001,1677,8.5
26,153,Schoolcraft,2014,3541,3152,389,11.0
26,155,Shiawassee,2014,33256,30742,2514,7.6
26,157,Tuscola,2014,25150,22988,2162,8.6
26,159,Van Buren,2014,35436,32578,2858,8.1
26,161,Washtenaw,2014,187616,178470,9146,4.9
26,163,Wayne,2014,767640,694103,73537,9.6
26,165,Wexford,2014,14724,13463,1261,8.6
27,1,Aitkin,2014,6792,6328,464,6.8
27,3,Anoka,2014,189457,181414,8043,4.2
27,5,Becker,2014,18019,17140,879,4.9
27,7,Beltrami,2014,23369,22096,1273,5.4
27,9,Benton,2014,21763,20638,1125,5.2
27,11,Big Stone,2014,2599,2481,118,4.5
27,13,Blue Earth,2014,38618,37258,1360,3.5
27,15,Brown,2014,14225,13561,664,4.7
27,17,Carlton,2014,17632,16686,946,5.4
27,19,Carver,2014,54396,52377,2019,3.7
27,21,Cass,2014,14032,13011,1021,7.3
27,23,Chippewa,2014,6913,6592,321,4.6
27,25,Chisago,2014,28651,27270,1381,4.8
27,27,Clay,2014,35306,34076,1230,3.5
27,29,Clearwater,2014,4562,4075,487,10.7
27,31,Cook,2014,3065,2888,177,5.8
27,33,Cottonwood,2014,5596,5295,301,5.4
27,35,Crow Wing,2014,31559,29665,1894,6.0
27,37,Dakota,2014,232013,223040,8973,3.9
27,39,Dodge,2014,11274,10794,480,4.3
27,41,Douglas,2014,19917,19157,760,3.8
27,43,Faribault,2014,7393,6998,395,5.3
27,45,Fillmore,2014,11050,10553,497,4.5
27,47,Freeborn,2014,16283,15561,722,4.4
27,49,Goodhue,2014,26788,25707,1081,4.0
27,51,Grant,2014,3289,3122,167,5.1
27,53,Hennepin,2014,673912,647791,26121,3.9
27,55,Houston,2014,10379,9909,470,4.5
27,57,Hubbard,2014,9462,8844,618,6.5
27,59,Isanti,2014,20287,19238,1049,5.2
27,61,Itasca,2014,22015,20526,1489,6.8
27,63,Jackson,2014,6317,6046,271,4.3
27,65,Kanabec,2014,8877,8202,675,7.6
27,67,Kandiyohi,2014,23727,22697,1030,4.3
27,69,Kittson,2014,2396,2276,120,5.0
27,71,Koochiching,2014,6456,5897,559,8.7
27,73,Lac qui Parle,2014,3660,3482,178,4.9
27,75,Lake,2014,5696,5428,268,4.7
27,77,Lake of the Woods,2014,2393,2276,117,4.9
27,79,Le Sueur,2014,15522,14667,855,5.5
27,81,Lincoln,2014,3287,3141,146,4.4
27,83,Lyon,2014,15316,14750,566,3.7
27,85,McLeod,2014,19869,18930,939,4.7
27,87,Mahnomen,2014,2368,2231,137,5.8
27,89,Marshall,2014,5606,5219,387,6.9
27,91,Martin,2014,10245,9751,494,4.8
27,93,Meeker,2014,12890,12284,606,4.7
27,95,Mille Lacs,2014,12719,11846,873,6.9
27,97,Morrison,2014,17441,16327,1114,6.4
27,99,Mower,2014,20324,19529,795,3.9
27,101,Murray,2014,4870,4627,243,5.0
27,103,Nicollet,2014,19810,19190,620,3.1
27,105,Nobles,2014,11256,10862,394,3.5
27,107,Norman,2014,3323,3153,170,5.1
27,109,Olmsted,2014,83226,80284,2942,3.5
27,111,Otter Tail,2014,30955,29517,1438,4.6
27,113,Pennington,2014,8865,8399,466,5.3
27,115,Pine,2014,14645,13726,919,6.3
27,117,Pipestone,2014,4792,4607,185,3.9
27,119,Polk,2014,17128,16320,808,4.7
27,121,Pope,2014,6237,6004,233,3.7
27,123,Ramsey,2014,278003,266524,11479,4.1
27,125,Red Lake,2014,2265,2131,134,5.9
27,127,Redwood,2014,8020,7658,362,4.5
27,129,Renville,2014,8228,7763,465,5.7
27,131,Rice,2014,35186,33704,1482,4.2
27,133,Rock,2014,5682,5535,147,2.6
27,135,Roseau,2014,8831,8499,332,3.8
27,137,St. Louis,2014,102538,97198,5340,5.2
27,139,Scott,2014,78333,75442,2891,3.7
27,141,Sherburne,2014,49319,47028,2291,4.6
27,143,Sibley,2014,8288,7896,392,4.7
27,145,Stearns,2014,87919,84245,3674,4.2
27,147,Steele,2014,21349,20523,826,3.9
27,149,Stevens,2014,5580,5395,185,3.3
27,151,Swift,2014,4879,4638,241,4.9
27,153,Todd,2014,12847,12236,611,4.8
27,155,Traverse,2014,1716,1635,81,4.7
27,157,Wabasha,2014,11753,11268,485,4.1
27,159,Wadena,2014,6158,5767,391,6.3
27,161,Waseca,2014,9695,9217,478,4.9
27,163,Washington,2014,136346,131262,5084,3.7
27,165,Watonwan,2014,6175,5864,311,5.0
27,167,Wilkin,2014,3600,3475,125,3.5
27,169,Winona,2014,29409,28286,1123,3.8
27,171,Wright,2014,71353,68273,3080,4.3
27,173,Yellow Medicine,2014,5499,5266,233,4.2
28,1,Adams,2014,11568,10592,976,8.4
28,3,Alcorn,2014,15083,14071,1012,6.7
28,5,Amite,2014,4435,4076,359,8.1
28,7,Attala,2014,7022,6403,619,8.8
28,9,Benton,2014,2971,2690,281,9.5
28,11,Bolivar,2014,13270,11989,1281,9.7
28,13,Calhoun,2014,6219,5751,468,7.5
28,15,Carroll,2014,3402,3076,326,9.6
28,17,Chickasaw,2014,7186,6480,706,9.8
28,19,Choctaw,2014,3567,3273,294,8.2
28,21,Claiborne,2014,3103,2645,458,14.8
28,23,Clarke,2014,6251,5682,569,9.1
28,25,Clay,2014,7962,6895,1067,13.4
28,27,Coahoma,2014,9532,8399,1133,11.9
28,29,Copiah,2014,11135,10136,999,9.0
28,31,Covington,2014,7813,7292,521,6.7
28,33,DeSoto,2014,81070,76686,4384,5.4
28,35,Forrest,2014,32177,29768,2409,7.5
28,37,Franklin,2014,2899,2653,246,8.5
28,39,George,2014,8891,8150,741,8.3
28,41,Greene,2014,4379,3987,392,9.0
28,43,Grenada,2014,9263,8591,672,7.3
28,45,Hancock,2014,18415,17070,1345,7.3
28,47,Harrison,2014,84498,78755,5743,6.8
28,49,Hinds,2014,107739,99866,7873,7.3
28,51,Holmes,2014,6126,5198,928,15.1
28,53,Humphreys,2014,2557,2148,409,16.0
28,55,Issaquena,2014,426,351,75,17.6
28,57,Itawamba,2014,9867,9153,714,7.2
28,59,Jackson,2014,58907,54152,4755,8.1
28,61,Jasper,2014,6413,5862,551,8.6
28,63,Jefferson,2014,2399,2009,390,16.3
28,65,Jefferson Davis,2014,4107,3682,425,10.3
28,67,Jones,2014,26582,24921,1661,6.2
28,69,Kemper,2014,3741,3259,482,12.9
28,71,Lafayette,2014,23202,21699,1503,6.5
28,73,Lamar,2014,27681,26247,1434,5.2
28,75,Lauderdale,2014,32464,30006,2458,7.6
28,77,Lawrence,2014,4506,4128,378,8.4
28,79,Leake,2014,7806,7245,561,7.2
28,81,Lee,2014,38705,35890,2815,7.3
28,83,Leflore,2014,10528,9186,1342,12.7
28,85,Lincoln,2014,13698,12783,915,6.7
28,87,Lowndes,2014,25189,22968,2221,8.8
28,89,Madison,2014,49596,46959,2637,5.3
28,91,Marion,2014,9862,9044,818,8.3
28,93,Marshall,2014,14315,13059,1256,8.8
28,95,Monroe,2014,15418,13848,1570,10.2
28,97,Montgomery,2014,4181,3791,390,9.3
28,99,Neshoba,2014,10743,10007,736,6.9
28,101,Newton,2014,8743,8154,589,6.7
28,103,Noxubee,2014,3996,3491,505,12.6
28,105,Oktibbeha,2014,22002,20411,1591,7.2
28,107,Panola,2014,13377,11951,1426,10.7
28,109,Pearl River,2014,22256,20754,1502,6.7
28,111,Perry,2014,4195,3807,388,9.2
28,113,Pike,2014,14498,13285,1213,8.4
28,115,Pontotoc,2014,13439,12518,921,6.9
28,117,Prentiss,2014,10822,10004,818,7.6
28,119,Quitman,2014,2744,2382,362,13.2
28,121,Rankin,2014,70738,67418,3320,4.7
28,123,Scott,2014,12626,11926,700,5.5
28,125,Sharkey,2014,1764,1568,196,11.1
28,127,Simpson,2014,10726,10032,694,6.5
28,129,Smith,2014,6702,6311,391,5.8
28,131,Stone,2014,6313,5768,545,8.6
28,133,Sunflower,2014,8637,7548,1089,12.6
28,135,Tallahatchie,2014,5823,5278,545,9.4
28,137,Tate,2014,11739,10733,1006,8.6
28,139,Tippah,2014,8699,7970,729,8.4
28,141,Tishomingo,2014,7568,6979,589,7.8
28,143,Tunica,2014,4747,4182,565,11.9
28,145,Union,2014,12806,12010,796,6.2
28,147,Walthall,2014,5141,4650,491,9.6
28,149,Warren,2014,20874,19263,1611,7.7
28,151,Washington,2014,18315,15998,2317,12.7
28,153,Wayne,2014,7712,7022,690,8.9
28,155,Webster,2014,3951,3610,341,8.6
28,157,Wilkinson,2014,2828,2501,327,11.6
28,159,Winston,2014,7133,6414,719,10.1
28,161,Yalobusha,2014,4907,4450,457,9.3
28,163,Yazoo,2014,9251,8321,930,10.1
29,1,Adair,2014,10557,9873,684,6.5
29,3,Andrew,2014,9816,9308,508,5.2
29,5,Atchison,2014,2862,2707,155,5.4
29,7,Audrain,2014,11195,10567,628,5.6
29,9,Barry,2014,14753,13843,910,6.2
29,11,Barton,2014,5466,5121,345,6.3
29,13,Bates,2014,8069,7496,573,7.1
29,15,Benton,2014,7153,6593,560,7.8
29,17,Bollinger,2014,5623,5241,382,6.8
29,19,Boone,2014,97268,93196,4072,4.2
29,21,Buchanan,2014,46094,43456,2638,5.7
29,23,Butler,2014,19022,17675,1347,7.1
29,25,Caldwell,2014,4318,4080,238,5.5
29,27,Callaway,2014,21706,20480,1226,5.6
29,29,Camden,2014,18738,17206,1532,8.2
29,31,Cape Girardeau,2014,40517,38296,2221,5.5
29,33,Carroll,2014,4723,4383,340,7.2
29,35,Carter,2014,2548,2319,229,9.0
29,37,Cass,2014,52619,49595,3024,5.7
29,39,Cedar,2014,5839,5467,372,6.4
29,41,Chariton,2014,3837,3614,223,5.8
29,43,Christian,2014,42042,39964,2078,4.9
29,45,Clark,2014,3427,3188,239,7.0
29,47,Clay,2014,128935,121912,7023,5.4
29,49,Clinton,2014,10647,10019,628,5.9
29,51,Cole,2014,39508,37516,1992,5.0
29,53,Cooper,2014,7622,7165,457,6.0
29,55,Crawford,2014,10851,9979,872,8.0
29,57,Dade,2014,3496,3285,211,6.0
29,59,Dallas,2014,6942,6411,531,7.6
29,61,Daviess,2014,4021,3786,235,5.8
29,63,DeKalb,2014,4954,4684,270,5.5
29,65,Dent,2014,6247,5823,424,6.8
29,67,Douglas,2014,5011,4625,386,7.7
29,69,Dunklin,2014,13092,11900,1192,9.1
29,71,Franklin,2014,51903,48531,3372,6.5
29,73,Gasconade,2014,7590,7187,403,5.3
29,75,Gentry,2014,3621,3416,205,5.7
29,77,Greene,2014,146806,139639,7167,4.9
29,79,Grundy,2014,4882,4623,259,5.3
29,81,Harrison,2014,3966,3706,260,6.6
29,83,Henry,2014,10085,9427,658,6.5
29,85,Hickory,2014,3683,3374,309,8.4
29,87,Holt,2014,2687,2555,132,4.9
29,89,Howard,2014,4970,4701,269,5.4
29,91,Howell,2014,16222,15058,1164,7.2
29,93,Iron,2014,3911,3523,388,9.9
29,95,Jackson,2014,356144,330689,25455,7.1
29,97,Jasper,2014,57529,54472,3057,5.3
29,99,Jefferson,2014,115933,108688,7245,6.2
29,101,Johnson,2014,22727,21255,1472,6.5
29,103,Knox,2014,1963,1873,90,4.6
29,105,Laclede,2014,15848,14561,1287,8.1
29,107,Lafayette,2014,16900,15889,1011,6.0
29,109,Lawrence,2014,17413,16383,1030,5.9
29,111,Lewis,2014,5140,4871,269,5.2
29,113,Lincoln,2014,26484,24751,1733,6.5
29,115,Linn,2014,5203,4777,426,8.2
29,117,Livingston,2014,7282,6914,368,5.1
29,119,McDonald,2014,10253,9656,597,5.8
29,121,Macon,2014,7422,6964,458,6.2
29,123,Madison,2014,5483,5101,382,7.0
29,125,Maries,2014,3958,3711,247,6.2
29,127,Marion,2014,14576,13767,809,5.6
29,129,Mercer,2014,1863,1768,95,5.1
29,131,Miller,2014,11604,10704,900,7.8
29,133,Mississippi,2014,6244,5788,456,7.3
29,135,Moniteau,2014,7356,6914,442,6.0
29,137,Monroe,2014,4171,3902,269,6.4
29,139,Montgomery,2014,5667,5330,337,5.9
29,141,Morgan,2014,7939,7247,692,8.7
29,143,New Madrid,2014,8435,7806,629,7.5
29,145,Newton,2014,28332,26796,1536,5.4
29,147,Nodaway,2014,11061,10304,757,6.8
29,149,Oregon,2014,4129,3818,311,7.5
29,151,Osage,2014,7198,6862,336,4.7
29,153,Ozark,2014,3653,3324,329,9.0
29,155,Pemiscot,2014,7074,6413,661,9.3
29,157,Perry,2014,10243,9684,559,5.5
29,159,Pettis,2014,20583,19315,1268,6.2
29,161,Phelps,2014,19371,18110,1261,6.5
29,163,Pike,2014,8118,7654,464,5.7
29,165,Platte,2014,53791,51030,2761,5.1
29,167,Polk,2014,14065,13166,899,6.4
29,169,Pulaski,2014,15170,14064,1106,7.3
29,171,Putnam,2014,2483,2357,126,5.1
29,173,Ralls,2014,5620,5322,298,5.3
29,175,Randolph,2014,10530,9783,747,7.1
29,177,Ray,2014,11093,10335,758,6.8
29,179,Reynolds,2014,2683,2458,225,8.4
29,181,Ripley,2014,5549,5091,458,8.3
29,183,St. Charles,2014,211394,201163,10231,4.8
29,185,St. Clair,2014,3974,3668,306,7.7
29,186,Ste. Genevieve,2014,9047,8443,604,6.7
29,187,St. Francois,2014,26224,24214,2010,7.7
29,189,St. Louis,2014,527334,496520,30814,5.8
29,195,Saline,2014,11202,10571,631,5.6
29,197,Schuyler,2014,1883,1743,140,7.4
29,199,Scotland,2014,2384,2269,115,4.8
29,201,Scott,2014,19801,18492,1309,6.6
29,203,Shannon,2014,3416,3093,323,9.5
29,205,Shelby,2014,3047,2863,184,6.0
29,207,Stoddard,2014,13105,12078,1027,7.8
29,209,Stone,2014,13266,11981,1285,9.7
29,211,Sullivan,2014,2731,2550,181,6.6
29,213,Taney,2014,25643,23134,2509,9.8
29,215,Texas,2014,9403,8656,747,7.9
29,217,Vernon,2014,9799,9245,554,5.7
29,219,Warren,2014,17052,15997,1055,6.2
29,221,Washington,2014,10430,9534,896,8.6
29,223,Wayne,2014,5635,5213,422,7.5
29,225,Webster,2014,16243,15257,986,6.1
29,227,Worth,2014,1289,1237,52,4.0
29,229,Wright,2014,7615,7058,557,7.3
29,510,St. Louis city,2014,159559,147413,12146,7.6
30,1,Beaverhead,2014,4869,4689,180,3.7
30,3,Big Horn,2014,5593,5036,557,10.0
30,5,Blaine,2014,2434,2293,141,5.8
30,7,Broadwater,2014,2502,2368,134,5.4
30,9,Carbon,2014,5391,5181,210,3.9
30,11,Carter,2014,687,665,22,3.2
30,13,Cascade,2014,38301,36654,1647,4.3
30,15,Chouteau,2014,2592,2508,84,3.2
30,17,Custer,2014,6593,6381,212,3.2
30,19,Daniels,2014,952,923,29,3.0
30,21,Dawson,2014,4866,4738,128,2.6
30,23,Deer Lodge,2014,5240,5012,228,4.4
30,25,Fallon,2014,2074,2034,40,1.9
30,27,Fergus,2014,5746,5499,247,4.3
30,29,Flathead,2014,43773,40954,2819,6.4
30,31,Gallatin,2014,56887,54904,1983,3.5
30,33,Garfield,2014,748,728,20,2.7
30,35,Glacier,2014,5957,5329,628,10.5
30,37,Golden Valley,2014,392,374,18,4.6
30,39,Granite,2014,1527,1423,104,6.8
30,41,Hill,2014,7833,7381,452,5.8
30,43,Jefferson,2014,5632,5373,259,4.6
30,45,Judith Basin,2014,967,926,41,4.2
30,47,Lake,2014,12487,11797,690,5.5
30,49,Lewis and Clark,2014,35221,33913,1308,3.7
30,51,Liberty,2014,974,943,31,3.2
30,53,Lincoln,2014,7920,7036,884,11.2
30,55,McCone,2014,1089,1064,25,2.3
30,57,Madison,2014,4231,4037,194,4.6
30,59,Meagher,2014,908,869,39,4.3
30,61,Mineral,2014,1747,1588,159,9.1
30,63,Missoula,2014,59970,57311,2659,4.4
30,65,Musselshell,2014,2362,2266,96,4.1
30,67,Park,2014,8068,7617,451,5.6
30,69,Petroleum,2014,284,272,12,4.2
30,71,Phillips,2014,1994,1888,106,5.3
30,73,Pondera,2014,2844,2704,140,4.9
30,75,Powder River,2014,1076,1043,33,3.1
30,77,Powell,2014,2937,2790,147,5.0
30,79,Prairie,2014,514,492,22,4.3
30,81,Ravalli,2014,18792,17658,1134,6.0
30,83,Richland,2014,7328,7153,175,2.4
30,85,Roosevelt,2014,4822,4573,249,5.2
30,87,Rosebud,2014,4176,3940,236,5.7
30,89,Sanders,2014,4637,4207,430,9.3
30,91,Sheridan,2014,2130,2074,56,2.6
30,93,Silver Bow,2014,17023,16184,839,4.9
30,95,Stillwater,2014,4998,4811,187,3.7
30,97,Sweet Grass,2014,1782,1719,63,3.5
30,99,Teton,2014,2882,2774,108,3.7
30,101,Toole,2014,2348,2277,71,3.0
30,103,Treasure,2014,347,333,14,4.0
30,105,Valley,2014,4364,4232,132,3.0
30,107,Wheatland,2014,783,744,39,5.0
30,109,Wibaux,2014,550,534,16,2.9
30,111,Yellowstone,2014,79477,76525,2952,3.7
31,1,Adams,2014,16728,16167,561,3.4
31,3,Antelope,2014,3594,3497,97,2.7
31,5,Arthur,2014,224,212,12,5.4
31,7,Banner,2014,437,421,16,3.7
31,9,Blaine,2014,275,263,12,4.4
31,11,Boone,2014,3025,2947,78,2.6
31,13,Box Butte,2014,5747,5569,178,3.1
31,15,Boyd,2014,1100,1064,36,3.3
31,17,Brown,2014,1421,1372,49,3.4
31,19,Buffalo,2014,27498,26745,753,2.7
31,21,Burt,2014,3584,3445,139,3.9
31,23,Butler,2014,4830,4688,142,2.9
31,25,Cass,2014,13244,12755,489,3.7
31,27,Cedar,2014,4670,4563,107,2.3
31,29,Chase,2014,2349,2301,48,2.0
31,31,Cherry,2014,3417,3334,83,2.4
31,33,Cheyenne,2014,5751,5627,124,2.2
31,35,Clay,2014,3463,3351,112,3.2
31,37,Colfax,2014,5625,5458,167,3.0
31,39,Cuming,2014,4952,4823,129,2.6
31,41,Custer,2014,6138,5991,147,2.4
31,43,Dakota,2014,11054,10645,409,3.7
31,45,Dawes,2014,5288,5134,154,2.9
31,47,Dawson,2014,13340,12881,459,3.4
31,49,Deuel,2014,1092,1062,30,2.7
31,51,Dixon,2014,3059,2966,93,3.0
31,53,Dodge,2014,19232,18537,695,3.6
31,55,Douglas,2014,286657,276341,10316,3.6
31,57,Dundy,2014,1278,1249,29,2.3
31,59,Fillmore,2014,3248,3170,78,2.4
31,61,Franklin,2014,1577,1527,50,3.2
31,63,Frontier,2014,1552,1509,43,2.8
31,65,Furnas,2014,2711,2634,77,2.8
31,67,Gage,2014,11094,10638,456,4.1
31,69,Garden,2014,1194,1160,34,2.8
31,71,Garfield,2014,1203,1172,31,2.6
31,73,Gosper,2014,1137,1103,34,3.0
31,75,Grant,2014,429,419,10,2.3
31,77,Greeley,2014,1272,1231,41,3.2
31,79,Hall,2014,32417,31160,1257,3.9
31,81,Hamilton,2014,4766,4624,142,3.0
31,83,Harlan,2014,1803,1756,47,2.6
31,85,Hayes,2014,629,611,18,2.9
31,87,Hitchcock,2014,1342,1296,46,3.4
31,89,Holt,2014,5925,5769,156,2.6
31,91,Hooker,2014,424,406,18,4.2
31,93,Howard,2014,3369,3244,125,3.7
31,95,Jefferson,2014,4302,4172,130,3.0
31,97,Johnson,2014,2169,2087,82,3.8
31,99,Kearney,2014,3851,3757,94,2.4
31,101,Keith,2014,4668,4535,133,2.8
31,103,Keya Paha,2014,620,603,17,2.7
31,105,Kimball,2014,2229,2173,56,2.5
31,107,Knox,2014,4735,4589,146,3.1
31,109,Lancaster,2014,168083,163106,4977,3.0
31,111,Lincoln,2014,18742,18137,605,3.2
31,113,Logan,2014,495,480,15,3.0
31,115,Loup,2014,382,367,15,3.9
31,117,McPherson,2014,439,429,10,2.3
31,119,Madison,2014,19497,18926,571,2.9
31,121,Merrick,2014,4116,3961,155,3.8
31,123,Morrill,2014,2683,2603,80,3.0
31,125,Nance,2014,2072,2016,56,2.7
31,127,Nemaha,2014,3728,3586,142,3.8
31,129,Nuckolls,2014,2405,2338,67,2.8
31,131,Otoe,2014,8248,7945,303,3.7
31,133,Pawnee,2014,1654,1608,46,2.8
31,135,Perkins,2014,1853,1814,39,2.1
31,137,Phelps,2014,5056,4926,130,2.6
31,139,Pierce,2014,4242,4121,121,2.9
31,141,Platte,2014,17325,16812,513,3.0
31,143,Polk,2014,2964,2870,94,3.2
31,145,Red Willow,2014,6292,6131,161,2.6
31,147,Richardson,2014,4279,4124,155,3.6
31,149,Rock,2014,884,861,23,2.6
31,151,Saline,2014,7237,6990,247,3.4
31,153,Sarpy,2014,89873,87108,2765,3.1
31,155,Saunders,2014,11025,10644,381,3.5
31,157,Scotts Bluff,2014,18764,18088,676,3.6
31,159,Seward,2014,8851,8581,270,3.1
31,161,Sheridan,2014,2782,2710,72,2.6
31,163,Sherman,2014,1728,1671,57,3.3
31,165,Sioux,2014,807,787,20,2.5
31,167,Stanton,2014,3578,3479,99,2.8
31,169,Thayer,2014,3034,2957,77,2.5
31,171,Thomas,2014,428,413,15,3.5
31,173,Thurston,2014,3021,2839,182,6.0
31,175,Valley,2014,2119,2056,63,3.0
31,177,Washington,2014,11050,10696,354,3.2
31,179,Wayne,2014,5571,5416,155,2.8
31,181,Webster,2014,1730,1672,58,3.4
31,183,Wheeler,2014,559,543,16,2.9
31,185,York,2014,7400,7167,233,3.1
32,1,Churchill,2014,10505,9664,841,8.0
32,3,Clark,2014,1010053,926938,83115,8.2
32,5,Douglas,2014,22128,20300,1828,8.3
32,7,Elko,2014,27626,26024,1602,5.8
32,9,Esmeralda,2014,535,511,24,4.5
32,11,Eureka,2014,1016,954,62,6.1
32,13,Humboldt,2014,8525,7953,572,6.7
32,15,Lander,2014,3292,3064,228,6.9
32,17,Lincoln,2014,1934,1787,147,7.6
32,19,Lyon,2014,22258,19879,2379,10.7
32,21,Mineral,2014,1698,1508,190,11.2
32,23,Nye,2014,16035,14434,1601,10.0
32,27,Pershing,2014,2534,2343,191,7.5
32,29,Storey,2014,1831,1660,171,9.3
32,31,Washoe,2014,220570,203367,17203,7.8
32,33,White Pine,2014,4793,4492,301,6.3
32,510,Carson City,2014,24752,22548,2204,8.9
33,1,Belknap,2014,31687,30358,1329,4.2
33,3,Carroll,2014,24229,23205,1024,4.2
33,5,Cheshire,2014,42124,40412,1712,4.1
33,7,Coos,2014,15189,14321,868,5.7
33,9,Grafton,2014,48583,46897,1686,3.5
33,11,Hillsborough,2014,229207,218843,10364,4.5
33,13,Merrimack,2014,81094,77972,3122,3.8
33,15,Rockingham,2014,177073,168849,8224,4.6
33,17,Strafford,2014,70787,67940,2847,4.0
33,19,Sullivan,2014,23789,22945,844,3.5
34,1,Atlantic,2014,131703,117847,13856,10.5
34,3,Bergen,2014,478313,452433,25880,5.4
34,5,Burlington,2014,228312,213648,14664,6.4
34,7,Camden,2014,251451,232102,19349,7.7
34,9,Cape May,2014,48530,42606,5924,12.2
34,11,Cumberland,2014,67591,60911,6680,9.9
34,13,Essex,2014,374445,344549,29896,8.0
34,15,Gloucester,2014,147308,136550,10758,7.3
34,17,Hudson,2014,357828,335149,22679,6.3
34,19,Hunterdon,2014,65510,62333,3177,4.8
34,21,Mercer,2014,195199,183805,11394,5.8
34,23,Middlesex,2014,432359,406084,26275,6.1
34,25,Monmouth,2014,325811,306099,19712,6.1
34,27,Morris,2014,261034,247930,13104,5.0
34,29,Ocean,2014,264702,245225,19477,7.4
34,31,Passaic,2014,247350,227039,20311,8.2
34,33,Salem,2014,31075,28440,2635,8.5
34,35,Somerset,2014,172969,163976,8993,5.2
34,37,Sussex,2014,77212,72273,4939,6.4
34,39,Union,2014,278319,259030,19289,6.9
34,41,Warren,2014,56873,53288,3585,6.3
35,1,Bernalillo,2014,322126,302407,19719,6.1
35,3,Catron,2014,1194,1096,98,8.2
35,5,Chaves,2014,27248,25604,1644,6.0
35,6,Cibola,2014,9122,8347,775,8.5
35,7,Colfax,2014,6185,5801,384,6.2
35,9,Curry,2014,21814,20723,1091,5.0
35,11,De Baca,2014,845,806,39,4.6
35,13,Dona Ana,2014,94455,87658,6797,7.2
35,15,Eddy,2014,29214,27936,1278,4.4
35,17,Grant,2014,12587,11766,821,6.5
35,19,Guadalupe,2014,1624,1500,124,7.6
35,21,Harding,2014,319,304,15,4.7
35,23,Hidalgo,2014,2159,2007,152,7.0
35,25,Lea,2014,30890,29550,1340,4.3
35,27,Lincoln,2014,8855,8329,526,5.9
35,28,Los Alamos,2014,8509,8162,347,4.1
35,29,Luna,2014,11410,9373,2037,17.9
35,31,McKinley,2014,24064,21657,2407,10.0
35,33,Mora,2014,2276,2029,247,10.9
35,35,Otero,2014,24883,23347,1536,6.2
35,37,Quay,2014,3323,3106,217,6.5
35,39,Rio Arriba,2014,16593,15158,1435,8.6
35,41,Roosevelt,2014,8170,7723,447,5.5
35,43,Sandoval,2014,61533,57186,4347,7.1
35,45,San Juan,2014,55623,52119,3504,6.3
35,47,San Miguel,2014,11058,10170,888,8.0
35,49,Santa Fe,2014,73054,69128,3926,5.4
35,51,Sierra,2014,3970,3610,360,9.1
35,53,Socorro,2014,6511,6038,473,7.3
35,55,Taos,2014,15105,13628,1477,9.8
35,57,Torrance,2014,5601,5059,542,9.7
35,59,Union,2014,1914,1827,87,4.5
35,61,Valencia,2014,29721,27417,2304,7.8
36,1,Albany,2014,157049,149307,7742,4.9
36,3,Allegany,2014,23292,21833,1459,6.3
36,5,Bronx,2014,603201,545610,57591,9.5
36,7,Broome,2014,87879,82002,5877,6.7
36,9,Cattaraugus,2014,36581,34000,2581,7.1
36,11,Cayuga,2014,37566,35298,2268,6.0
36,13,Chautauqua,2014,57704,53745,3959,6.9
36,15,Chemung,2014,38121,35717,2404,6.3
36,17,Chenango,2014,23155,21704,1451,6.3
36,19,Clinton,2014,35938,33543,2395,6.7
36,21,Columbia,2014,31281,29794,1487,4.8
36,23,Cortland,2014,23633,22082,1551,6.6
36,25,Delaware,2014,20004,18681,1323,6.6
36,27,Dutchess,2014,142064,134432,7632,5.4
36,29,Erie,2014,447882,420334,27548,6.2
36,31,Essex,2014,17528,16312,1216,6.9
36,33,Franklin,2014,20489,18990,1499,7.3
36,35,Fulton,2014,23407,21599,1808,7.7
36,37,Genesee,2014,29986,28310,1676,5.6
36,39,Greene,2014,20691,19282,1409,6.8
36,41,Hamilton,2014,2427,2245,182,7.5
36,43,Herkimer,2014,28817,26846,1971,6.8
36,45,Jefferson,2014,46554,42979,3575,7.7
36,47,Kings,2014,1213696,1123287,90409,7.4
36,49,Lewis,2014,11853,10915,938,7.9
36,51,Livingston,2014,30909,29103,1806,5.8
36,53,Madison,2014,33382,31224,2158,6.5
36,55,Monroe,2014,364023,342750,21273,5.8
36,57,Montgomery,2014,22241,20565,1676,7.5
36,59,Nassau,2014,684808,651793,33015,4.8
36,61,New York,2014,905240,851252,53988,6.0
36,63,Niagara,2014,101415,94233,7182,7.1
36,65,Oneida,2014,103036,96696,6340,6.2
36,67,Onondaga,2014,224355,211780,12575,5.6
36,69,Ontario,2014,54704,51815,2889,5.3
36,71,Orange,2014,175195,165500,9695,5.5
36,73,Orleans,2014,18026,16633,1393,7.7
36,75,Oswego,2014,54993,50518,4475,8.1
36,77,Otsego,2014,29966,28240,1726,5.8
36,79,Putnam,2014,50199,47713,2486,5.0
36,81,Queens,2014,1149271,1077982,71289,6.2
36,83,Rensselaer,2014,81048,76657,4391,5.4
36,85,Richmond,2014,219670,203725,15945,7.3
36,87,Rockland,2014,149157,141405,7752,5.2
36,89,St. Lawrence,2014,47022,43347,3675,7.8
36,91,Saratoga,2014,115485,110057,5428,4.7
36,93,Schenectady,2014,75998,71888,4110,5.4
36,95,Schoharie,2014,14724,13728,996,6.8
36,97,Schuyler,2014,8595,7987,608,7.1
36,99,Seneca,2014,15497,14616,881,5.7
36,101,Steuben,2014,44037,40980,3057,6.9
36,103,Suffolk,2014,765069,723564,41505,5.4
36,105,Sullivan,2014,33241,31034,2207,6.6
36,107,Tioga,2014,23748,22288,1460,6.1
36,109,Tompkins,2014,54678,52262,2416,4.4
36,111,Ulster,2014,87883,82831,5052,5.7
36,113,Warren,2014,32260,30116,2144,6.6
36,115,Washington,2014,28530,26779,1751,6.1
36,117,Wayne,2014,44353,41591,2762,6.2
36,119,Westchester,2014,470006,445694,24312,5.2
36,121,Wyoming,2014,18331,17126,1205,6.6
36,123,Yates,2014,11677,11011,666,5.7
37,1,Alamance,2014,76826,72595,4231,5.5
37,3,Alexander,2014,17471,16518,953,5.5
37,5,Alleghany,2014,4390,4099,291,6.6
37,7,Anson,2014,10918,10166,752,6.9
37,9,Ashe,2014,12412,11586,826,6.7
37,11,Avery,2014,7651,7165,486,6.4
37,13,Beaufort,2014,20087,18653,1434,7.1
37,15,Bertie,2014,8518,7865,653,7.7
37,17,Bladen,2014,14284,12981,1303,9.1
37,19,Brunswick,2014,47685,44026,3659,7.7
37,21,Buncombe,2014,127808,121978,5830,4.6
37,23,Burke,2014,39369,36989,2380,6.0
37,25,Cabarrus,2014,94343,89007,5336,5.7
37,27,Caldwell,2014,35487,32983,2504,7.1
37,29,Camden,2014,4553,4284,269,5.9
37,31,Carteret,2014,31079,29208,1871,6.0
37,33,Caswell,2014,9652,8976,676,7.0
37,35,Catawba,2014,74659,70051,4608,6.2
37,37,Chatham,2014,32257,30729,1528,4.7
37,39,Cherokee,2014,11102,10337,765,6.9
37,41,Chowan,2014,5676,5241,435,7.7
37,43,Clay,2014,4103,3842,261,6.4
37,45,Cleveland,2014,45968,42710,3258,7.1
37,47,Columbus,2014,23009,21106,1903,8.3
37,49,Craven,2014,41089,38332,2757,6.7
37,51,Cumberland,2014,127501,117510,9991,7.8
37,53,Currituck,2014,12712,11935,777,6.1
37,55,Dare,2014,20099,18457,1642,8.2
37,57,Davidson,2014,78382,73589,4793,6.1
37,59,Davie,2014,19684,18564,1120,5.7
37,61,Duplin,2014,26586,24937,1649,6.2
37,63,Durham,2014,153026,145417,7609,5.0
37,65,Edgecombe,2014,23213,20885,2328,10.0
37,67,Forsyth,2014,177329,166984,10345,5.8
37,69,Franklin,2014,28295,26507,1788,6.3
37,71,Gaston,2014,100806,94143,6663,6.6
37,73,Gates,2014,5198,4898,300,5.8
37,75,Graham,2014,3311,2881,430,13.0
37,77,Granville,2014,28141,26659,1482,5.3
37,79,Greene,2014,9413,8844,569,6.0
37,81,Guilford,2014,253309,237205,16104,6.4
37,83,Halifax,2014,21244,19245,1999,9.4
37,85,Harnett,2014,49363,45824,3539,7.2
37,87,Haywood,2014,27252,25713,1539,5.6
37,89,Henderson,2014,49445,47025,2420,4.9
37,91,Hertford,2014,9380,8706,674,7.2
37,93,Hoke,2014,19384,17811,1573,8.1
37,95,Hyde,2014,2197,2001,196,8.9
37,97,Iredell,2014,79951,75063,4888,6.1
37,99,Jackson,2014,18364,17172,1192,6.5
37,101,Johnston,2014,85890,81147,4743,5.5
37,103,Jones,2014,4489,4199,290,6.5
37,105,Lee,2014,25006,23020,1986,7.9
37,107,Lenoir,2014,27848,25915,1933,6.9
37,109,Lincoln,2014,39640,37271,2369,6.0
37,111,McDowell,2014,20803,19506,1297,6.2
37,113,Macon,2014,15035,14071,964,6.4
37,115,Madison,2014,9397,8829,568,6.0
37,117,Martin,2014,9879,9129,750,7.6
37,119,Mecklenburg,2014,548084,516183,31901,5.8
37,121,Mitchell,2014,6533,6042,491,7.5
37,123,Montgomery,2014,11471,10760,711,6.2
37,125,Moore,2014,38184,35914,2270,5.9
37,127,Nash,2014,44217,40795,3422,7.7
37,129,New Hanover,2014,110542,104191,6351,5.7
37,131,Northampton,2014,7940,7319,621,7.8
37,133,Onslow,2014,64023,60243,3780,5.9
37,135,Orange,2014,72720,69439,3281,4.5
37,137,Pamlico,2014,5302,4960,342,6.5
37,139,Pasquotank,2014,17268,15916,1352,7.8
37,141,Pender,2014,25304,23562,1742,6.9
37,143,Perquimans,2014,5099,4713,386,7.6
37,145,Person,2014,17933,16582,1351,7.5
37,147,Pitt,2014,87471,82000,5471,6.3
37,149,Polk,2014,8408,7971,437,5.2
37,151,Randolph,2014,66632,62396,4236,6.4
37,153,Richmond,2014,16922,15450,1472,8.7
37,155,Robeson,2014,51074,46378,4696,9.2
37,157,Rockingham,2014,41103,38116,2987,7.3
37,159,Rowan,2014,62426,58148,4278,6.9
37,161,Rutherford,2014,25436,23323,2113,8.3
37,163,Sampson,2014,29636,27775,1861,6.3
37,165,Scotland,2014,11973,10581,1392,11.6
37,167,Stanly,2014,28530,26855,1675,5.9
37,169,Stokes,2014,21784,20503,1281,5.9
37,171,Surry,2014,33006,31034,1972,6.0
37,173,Swain,2014,6482,5915,567,8.7
37,175,Transylvania,2014,13345,12588,757,5.7
37,177,Tyrrell,2014,1552,1402,150,9.7
37,179,Union,2014,108842,103296,5546,5.1
37,181,Vance,2014,18043,16405,1638,9.1
37,183,Wake,2014,523736,498730,25006,4.8
37,185,Warren,2014,7215,6591,624,8.6
37,187,Washington,2014,5035,4564,471,9.4
37,189,Watauga,2014,27043,25683,1360,5.0
37,191,Wayne,2014,53861,50510,3351,6.2
37,193,Wilkes,2014,29541,27643,1898,6.4
37,195,Wilson,2014,37589,34120,3469,9.2
37,197,Yadkin,2014,17529,16564,965,5.5
37,199,Yancey,2014,7489,6998,491,6.6
38,1,Adams,2014,1100,1071,29,2.6
38,3,Barnes,2014,5533,5365,168,3.0
38,5,Benson,2014,2483,2326,157,6.3
38,7,Billings,2014,486,472,14,2.9
38,9,Bottineau,2014,3220,3113,107,3.3
38,11,Bowman,2014,1873,1840,33,1.8
38,13,Burke,2014,1283,1251,32,2.5
38,15,Burleigh,2014,46912,45789,1123,2.4
38,17,Cass,2014,91738,89562,2176,2.4
38,19,Cavalier,2014,2028,1971,57,2.8
38,21,Dickey,2014,2558,2508,50,2.0
38,23,Divide,2014,1852,1825,27,1.5
38,25,Dunn,2014,4248,4196,52,1.2
38,27,Eddy,2014,1275,1206,69,5.4
38,29,Emmons,2014,1541,1457,84,5.5
38,31,Foster,2014,1613,1565,48,3.0
38,33,Golden Valley,2014,965,945,20,2.1
38,35,Grand Forks,2014,36560,35566,994,2.7
38,37,Grant,2014,1282,1247,35,2.7
38,39,Griggs,2014,1172,1145,27,2.3
38,41,Hettinger,2014,1521,1490,31,2.0
38,43,Kidder,2014,1264,1216,48,3.8
38,45,LaMoure,2014,2233,2180,53,2.4
38,47,Logan,2014,918,891,27,2.9
38,49,McHenry,2014,3264,3131,133,4.1
38,51,McIntosh,2014,1232,1196,36,2.9
38,53,McKenzie,2014,9089,8955,134,1.5
38,55,McLean,2014,4831,4643,188,3.9
38,57,Mercer,2014,4101,3943,158,3.9
38,59,Morton,2014,15775,15270,505,3.2
38,61,Mountrail,2014,8957,8846,111,1.2
38,63,Nelson,2014,1516,1460,56,3.7
38,65,Oliver,2014,870,816,54,6.2
38,67,Pembina,2014,3559,3364,195,5.5
38,69,Pierce,2014,1784,1710,74,4.1
38,71,Ramsey,2014,5608,5413,195,3.5
38,73,Ransom,2014,2700,2625,75,2.8
38,75,Renville,2014,1391,1355,36,2.6
38,77,Richland,2014,8420,8170,250,3.0
38,79,Rolette,2014,4730,4199,531,11.2
38,81,Sargent,2014,2141,2094,47,2.2
38,83,Sheridan,2014,717,682,35,4.9
38,85,Sioux,2014,1286,1227,59,4.6
38,87,Slope,2014,506,496,10,2.0
38,89,Stark,2014,21091,20757,334,1.6
38,91,Steele,2014,1017,995,22,2.2
38,93,Stutsman,2014,10317,10038,279,2.7
38,95,Towner,2014,1221,1179,42,3.4
38,97,Traill,2014,4408,4295,113,2.6
38,99,Walsh,2014,5508,5258,250,4.5
38,101,Ward,2014,34144,33265,879,2.6
38,103,Wells,2014,2168,2075,93,4.3
38,105,Williams,2014,31500,31132,368,1.2
39,1,Adams,2014,10542,9574,968,9.2
39,3,Allen,2014,48478,45671,2807,5.8
39,5,Ashland,2014,25616,24091,1525,6.0
39,7,Ashtabula,2014,45049,41823,3226,7.2
39,9,Athens,2014,27676,25780,1896,6.9
39,11,Auglaize,2014,24202,23155,1047,4.3
39,13,Belmont,2014,31908,29766,2142,6.7
39,15,Brown,2014,19736,18266,1470,7.4
39,17,Butler,2014,187055,176686,10369,5.5
39,19,Carroll,2014,13608,12773,835,6.1
39,21,Champaign,2014,19984,18974,1010,5.1
39,23,Clark,2014,65151,61379,3772,5.8
39,25,Clermont,2014,102852,97223,5629,5.5
39,27,Clinton,2014,16989,15683,1306,7.7
39,29,Columbiana,2014,50234,46989,3245,6.5
39,31,Coshocton,2014,15813,14622,1191,7.5
39,33,Crawford,2014,19635,18318,1317,6.7
39,35,Cuyahoga,2014,615565,576999,38566,6.3
39,37,Darke,2014,26207,24811,1396,5.3
39,39,Defiance,2014,19004,17961,1043,5.5
39,41,Delaware,2014,100665,96531,4134,4.1
39,43,Erie,2014,37512,35106,2406,6.4
39,45,Fairfield,2014,74858,70977,3881,5.2
39,47,Fayette,2014,14173,13324,849,6.0
39,49,Franklin,2014,649140,617574,31566,4.9
39,51,Fulton,2014,22423,21101,1322,5.9
39,53,Gallia,2014,12439,11481,958,7.7
39,55,Geauga,2014,49017,46545,2472,5.0
39,57,Greene,2014,79935,75748,4187,5.2
39,59,Guernsey,2014,19140,17854,1286,6.7
39,61,Hamilton,2014,402530,380542,21988,5.5
39,63,Hancock,2014,40551,38747,1804,4.4
39,65,Hardin,2014,15147,14282,865,5.7
39,67,Harrison,2014,7374,6928,446,6.0
39,69,Henry,2014,13786,12895,891,6.5
39,71,Highland,2014,17370,16023,1347,7.8
39,73,Hocking,2014,13213,12359,854,6.5
39,75,Holmes,2014,19953,19151,802,4.0
39,77,Huron,2014,27957,25723,2234,8.0
39,79,Jackson,2014,13257,12090,1167,8.8
39,81,Jefferson,2014,29866,27438,2428,8.1
39,83,Knox,2014,31205,29553,1652,5.3
39,85,Lake,2014,124386,117488,6898,5.5
39,87,Lawrence,2014,25909,24183,1726,6.7
39,89,Licking,2014,86874,82315,4559,5.2
39,91,Logan,2014,23146,21983,1163,5.0
39,93,Lorain,2014,150215,140520,9695,6.5
39,95,Lucas,2014,209419,195995,13424,6.4
39,97,Madison,2014,20512,19540,972,4.7
39,99,Mahoning,2014,108255,100993,7262,6.7
39,101,Marion,2014,27937,26263,1674,6.0
39,103,Medina,2014,94842,90047,4795,5.1
39,105,Meigs,2014,9208,8379,829,9.0
39,107,Mercer,2014,22717,21852,865,3.8
39,109,Miami,2014,52201,49386,2815,5.4
39,111,Monroe,2014,5891,5242,649,11.0
39,113,Montgomery,2014,249711,234391,15320,6.1
39,115,Morgan,2014,6684,6163,521,7.8
39,117,Morrow,2014,16844,15842,1002,5.9
39,119,Muskingum,2014,39446,36643,2803,7.1
39,121,Noble,2014,5095,4707,388,7.6
39,123,Ottawa,2014,21548,19902,1646,7.6
39,125,Paulding,2014,9036,8539,497,5.5
39,127,Perry,2014,15856,14687,1169,7.4
39,129,Pickaway,2014,25868,24406,1462,5.7
39,131,Pike,2014,10529,9575,954,9.1
39,133,Portage,2014,87056,81956,5100,5.9
39,135,Preble,2014,21189,19981,1208,5.7
39,137,Putnam,2014,18696,17847,849,4.5
39,139,Richland,2014,54654,51085,3569,6.5
39,141,Ross,2014,33749,31592,2157,6.4
39,143,Sandusky,2014,31374,29577,1797,5.7
39,145,Scioto,2014,29957,27335,2622,8.8
39,147,Seneca,2014,27233,25671,1562,5.7
39,149,Shelby,2014,23713,22504,1209,5.1
39,151,Stark,2014,188754,177806,10948,5.8
39,153,Summit,2014,272945,256847,16098,5.9
39,155,Trumbull,2014,92842,86109,6733,7.3
39,157,Tuscarawas,2014,45434,42918,2516,5.5
39,159,Union,2014,26874,25677,1197,4.5
39,161,Van Wert,2014,14443,13738,705,4.9
39,163,Vinton,2014,5529,5086,443,8.0
39,165,Warren,2014,111252,105721,5531,5.0
39,167,Washington,2014,28302,26493,1809,6.4
39,169,Wayne,2014,59683,56913,2770,4.6
39,171,Williams,2014,18833,17806,1027,5.5
39,173,Wood,2014,69341,65730,3611,5.2
39,175,Wyandot,2014,12386,11842,544,4.4
40,1,Adair,2014,8082,7457,625,7.7
40,3,Alfalfa,2014,3092,3018,74,2.4
40,5,Atoka,2014,4795,4510,285,5.9
40,7,Beaver,2014,3098,3015,83,2.7
40,9,Beckham,2014,12755,12408,347,2.7
40,11,Blaine,2014,4483,4334,149,3.3
40,13,Bryan,2014,17843,17008,835,4.7
40,15,Caddo,2014,11134,10551,583,5.2
40,17,Canadian,2014,65885,63625,2260,3.4
40,19,Carter,2014,22011,21066,945,4.3
40,21,Cherokee,2014,18506,17427,1079,5.8
40,23,Choctaw,2014,5804,5339,465,8.0
40,25,Cimarron,2014,1275,1240,35,2.7
40,27,Cleveland,2014,135719,130898,4821,3.6
40,29,Coal,2014,2296,2147,149,6.5
40,31,Comanche,2014,49280,47057,2223,4.5
40,33,Cotton,2014,2848,2721,127,4.5
40,35,Craig,2014,6049,5726,323,5.3
40,37,Creek,2014,30945,29458,1487,4.8
40,39,Custer,2014,15902,15425,477,3.0
40,41,Delaware,2014,17089,16128,961,5.6
40,43,Dewey,2014,2403,2330,73,3.0
40,45,Ellis,2014,2338,2270,68,2.9
40,47,Garfield,2014,29646,28625,1021,3.4
40,49,Garvin,2014,12623,12127,496,3.9
40,51,Grady,2014,25394,24411,983,3.9
40,53,Grant,2014,2810,2738,72,2.6
40,55,Greer,2014,2031,1940,91,4.5
40,57,Harmon,2014,1278,1228,50,3.9
40,59,Harper,2014,1971,1918,53,2.7
40,61,Haskell,2014,4335,4023,312,7.2
40,63,Hughes,2014,5635,5253,382,6.8
40,65,Jackson,2014,10655,10212,443,4.2
40,67,Jefferson,2014,2582,2466,116,4.5
40,69,Johnston,2014,3626,3381,245,6.8
40,71,Kay,2014,19263,18201,1062,5.5
40,73,Kingfisher,2014,7961,7724,237,3.0
40,75,Kiowa,2014,4054,3895,159,3.9
40,77,Latimer,2014,3953,3671,282,7.1
40,79,Le Flore,2014,19341,18055,1286,6.6
40,81,Lincoln,2014,15482,14805,677,4.4
40,83,Logan,2014,20982,20169,813,3.9
40,85,Love,2014,5432,5243,189,3.5
40,87,McClain,2014,18113,17468,645,3.6
40,89,McCurtain,2014,14131,13026,1105,7.8
40,91,McIntosh,2014,7024,6398,626,8.9
40,93,Major,2014,4358,4249,109,2.5
40,95,Marshall,2014,6929,6607,322,4.6
40,97,Mayes,2014,18764,17880,884,4.7
40,99,Murray,2014,6546,6281,265,4.0
40,101,Muskogee,2014,29269,27650,1619,5.5
40,103,Noble,2014,5538,5342,196,3.5
40,105,Nowata,2014,4749,4469,280,5.9
40,107,Okfuskee,2014,4449,4190,259,5.8
40,109,Oklahoma,2014,369434,354490,14944,4.0
40,111,Okmulgee,2014,15972,14923,1049,6.6
40,113,Osage,2014,20954,19915,1039,5.0
40,115,Ottawa,2014,13786,12887,899,6.5
40,117,Pawnee,2014,7300,6926,374,5.1
40,119,Payne,2014,38372,36984,1388,3.6
40,121,Pittsburg,2014,17141,16124,1017,5.9
40,123,Pontotoc,2014,17753,17011,742,4.2
40,125,Pottawatomie,2014,32101,30633,1468,4.6
40,127,Pushmataha,2014,4689,4350,339,7.2
40,129,Roger Mills,2014,1796,1747,49,2.7
40,131,Rogers,2014,43691,41917,1774,4.1
40,133,Seminole,2014,9554,8922,632,6.6
40,135,Sequoyah,2014,16657,15558,1099,6.6
40,137,Stephens,2014,20286,19411,875,4.3
40,139,Texas,2014,9343,9010,333,3.6
40,141,Tillman,2014,3293,3145,148,4.5
40,143,Tulsa,2014,311433,298511,12922,4.1
40,145,Wagoner,2014,35567,34107,1460,4.1
40,147,Washington,2014,24450,23447,1003,4.1
40,149,Washita,2014,5601,5416,185,3.3
40,151,Woods,2014,5289,5151,138,2.6
40,153,Woodward,2014,10763,10441,322,3.0
41,1,Baker,2014,6752,6199,553,8.2
41,3,Benton,2014,44628,42410,2218,5.0
41,5,Clackamas,2014,202082,189892,12190,6.0
41,7,Clatsop,2014,18130,16956,1174,6.5
41,9,Columbia,2014,22510,20649,1861,8.3
41,11,Coos,2014,26205,23898,2307,8.8
41,13,Crook,2014,9063,8190,873,9.6
41,15,Curry,2014,8671,7809,862,9.9
41,17,Deschutes,2014,81509,75321,6188,7.6
41,19,Douglas,2014,44297,40313,3984,9.0
41,21,Gilliam,2014,829,764,65,7.8
41,23,Grant,2014,3152,2827,325,10.3
41,25,Harney,2014,3298,2987,311,9.4
41,27,Hood River,2014,13816,13077,739,5.3
41,29,Jackson,2014,97220,89199,8021,8.3
41,31,Jefferson,2014,9440,8615,825,8.7
41,33,Josephine,2014,32953,29919,3034,9.2
41,35,Klamath,2014,28755,26117,2638,9.2
41,37,Lake,2014,3512,3181,331,9.4
41,39,Lane,2014,170318,158772,11546,6.8
41,41,Lincoln,2014,20670,19082,1588,7.7
41,43,Linn,2014,54407,50071,4336,8.0
41,45,Malheur,2014,12107,11164,943,7.8
41,47,Marion,2014,150144,139301,10843,7.2
41,49,Morrow,2014,5510,5137,373,6.8
41,51,Multnomah,2014,422171,397764,24407,5.8
41,53,Polk,2014,35729,33335,2394,6.7
41,55,Sherman,2014,886,821,65,7.3
41,57,Tillamook,2014,11231,10470,761,6.8
41,59,Umatilla,2014,35488,32788,2700,7.6
41,61,Union,2014,11659,10829,830,7.1
41,63,Wallowa,2014,3225,2909,316,9.8
41,65,Wasco,2014,13655,12775,880,6.4
41,67,Washington,2014,295034,278821,16213,5.5
41,69,Wheeler,2014,734,689,45,6.1
41,71,Yamhill,2014,50339,47153,3186,6.3
42,1,Adams,2014,55056,52499,2557,4.6
42,3,Allegheny,2014,645854,610849,35005,5.4
42,5,Armstrong,2014,33120,30958,2162,6.5
42,7,Beaver,2014,85843,80212,5631,6.6
42,9,Bedford,2014,24240,22618,1622,6.7
42,11,Berks,2014,210765,199054,11711,5.6
42,13,Blair,2014,60880,57348,3532,5.8
42,15,Bradford,2014,31590,29854,1736,5.5
42,17,Bucks,2014,334885,317133,17752,5.3
42,19,Butler,2014,97327,92344,4983,5.1
42,21,Cambria,2014,62946,58501,4445,7.1
42,23,Cameron,2014,2297,2133,164,7.1
42,25,Carbon,2014,31566,29301,2265,7.2
42,27,Centre,2014,77538,74166,3372,4.3
42,29,Chester,2014,273533,262015,11518,4.2
42,31,Clarion,2014,18420,17251,1169,6.3
42,33,Clearfield,2014,36667,33991,2676,7.3
42,35,Clinton,2014,18952,17553,1399,7.4
42,37,Columbia,2014,34197,32047,2150,6.3
42,39,Crawford,2014,41210,38792,2418,5.9
42,41,Cumberland,2014,125954,120237,5717,4.5
42,43,Dauphin,2014,139179,131653,7526,5.4
42,45,Delaware,2014,289871,273671,16200,5.6
42,47,Elk,2014,16338,15490,848,5.2
42,49,Erie,2014,134490,126078,8412,6.3
42,51,Fayette,2014,58427,53772,4655,8.0
42,53,Forest,2014,1928,1771,157,8.1
42,55,Franklin,2014,76431,72222,4209,5.5
42,57,Fulton,2014,7296,6773,523,7.2
42,59,Greene,2014,18497,17454,1043,5.6
42,61,Huntingdon,2014,19846,18260,1586,8.0
42,63,Indiana,2014,43163,40512,2651,6.1
42,65,Jefferson,2014,20835,19484,1351,6.5
42,67,Juniata,2014,11843,11166,677,5.7
42,69,Lackawanna,2014,106598,99512,7086,6.6
42,71,Lancaster,2014,272259,259550,12709,4.7
42,73,Lawrence,2014,42568,39889,2679,6.3
42,75,Lebanon,2014,70051,66536,3515,5.0
42,77,Lehigh,2014,182897,171665,11232,6.1
42,79,Luzerne,2014,158891,147115,11776,7.4
42,81,Lycoming,2014,61472,57647,3825,6.2
42,83,McKean,2014,19297,18047,1250,6.5
42,85,Mercer,2014,53015,49868,3147,5.9
42,87,Mifflin,2014,21076,19708,1368,6.5
42,89,Monroe,2014,79786,73695,6091,7.6
42,91,Montgomery,2014,436057,415511,20546,4.7
42,93,Montour,2014,9229,8794,435,4.7
42,95,Northampton,2014,155204,145876,9328,6.0
42,97,Northumberland,2014,43887,40904,2983,6.8
42,99,Perry,2014,23984,22732,1252,5.2
42,101,Philadelphia/city,2014,690526,633842,56684,8.2
42,103,Pike,2014,25130,23204,1926,7.7
42,105,Potter,2014,7562,6998,564,7.5
42,107,Schuylkill,2014,68912,63979,4933,7.2
42,109,Snyder,2014,19839,18802,1037,5.2
42,111,Somerset,2014,34975,32389,2586,7.4
42,113,Sullivan,2014,3057,2868,189,6.2
42,115,Susquehanna,2014,21421,20136,1285,6.0
42,117,Tioga,2014,20438,19004,1434,7.0
42,119,Union,2014,19106,18143,963,5.0
42,121,Venango,2014,24669,23190,1479,6.0
42,123,Warren,2014,20151,19075,1076,5.3
42,125,Washington,2014,106059,99879,6180,5.8
42,127,Wayne,2014,22326,20876,1450,6.5
42,129,Westmoreland,2014,183032,172388,10644,5.8
42,131,Wyoming,2014,14259,13299,960,6.7
42,133,York,2014,230354,217798,12556,5.5
44,1,Bristol,2014,26192,24417,1775,6.8
44,3,Kent,2014,91577,84952,6625,7.2
44,5,Newport,2014,44132,41070,3062,6.9
44,7,Providence,2014,325022,298306,26716,8.2
44,9,Washington,2014,69713,64662,5051,7.2
45,1,Abbeville,2014,10570,9776,794,7.5
45,3,Aiken,2014,72954,68338,4616,6.3
45,5,Allendale,2014,2863,2523,340,11.9
45,7,Anderson,2014,86680,81652,5028,5.8
45,9,Bamberg,2014,5555,4929,626,11.3
45,11,Barnwell,2014,8637,7822,815,9.4
45,13,Beaufort,2014,69430,65598,3832,5.5
45,15,Berkeley,2014,90863,85561,5302,5.8
45,17,Calhoun,2014,6880,6343,537,7.8
45,19,Charleston,2014,192347,182709,9638,5.0
45,21,Cherokee,2014,23647,21735,1912,8.1
45,23,Chester,2014,13418,12154,1264,9.4
45,25,Chesterfield,2014,21215,19798,1417,6.7
45,27,Clarendon,2014,12978,11920,1058,8.2
45,29,Colleton,2014,16638,15401,1237,7.4
45,31,Darlington,2014,29729,27421,2308,7.8
45,33,Dillon,2014,12585,11405,1180,9.4
45,35,Dorchester,2014,70276,66286,3990,5.7
45,37,Edgefield,2014,10552,9862,690,6.5
45,39,Fairfield,2014,10023,9176,847,8.5
45,41,Florence,2014,64829,60279,4550,7.0
45,43,Georgetown,2014,24817,22748,2069,8.3
45,45,Greenville,2014,235581,223367,12214,5.2
45,47,Greenwood,2014,31656,29536,2120,6.7
45,49,Hampton,2014,8309,7685,624,7.5
45,51,Horry,2014,134144,124494,9650,7.2
45,53,Jasper,2014,11430,10797,633,5.5
45,55,Kershaw,2014,28424,26644,1780,6.3
45,57,Lancaster,2014,35261,32785,2476,7.0
45,59,Laurens,2014,29878,27818,2060,6.9
45,61,Lee,2014,6445,5876,569,8.8
45,63,Lexington,2014,141540,134576,6964,4.9
45,65,McCormick,2014,3486,3219,267,7.7
45,67,Marion,2014,12843,11523,1320,10.3
45,69,Marlboro,2014,9959,8930,1029,10.3
45,71,Newberry,2014,18557,17524,1033,5.6
45,73,Oconee,2014,34180,32079,2101,6.1
45,75,Orangeburg,2014,37794,33618,4176,11.0
45,77,Pickens,2014,54850,51482,3368,6.1
45,79,Richland,2014,193943,182681,11262,5.8
45,81,Saluda,2014,8656,8177,479,5.5
45,83,Spartanburg,2014,136871,128416,8455,6.2
45,85,Sumter,2014,44389,41229,3160,7.1
45,87,Union,2014,11495,10531,964,8.4
45,89,Williamsburg,2014,12635,11405,1230,9.7
45,91,York,2014,122624,115119,7505,6.1
46,3,Aurora,2014,1619,1578,41,2.5
46,5,Beadle,2014,9485,9198,287,3.0
46,7,Bennett,2014,1142,1081,61,5.3
46,9,Bon Homme,2014,3024,2941,83,2.7
46,11,Brookings,2014,18309,17747,562,3.1
46,13,Brown,2014,21159,20558,601,2.8
46,15,Brule,2014,2584,2502,82,3.2
46,17,Buffalo,2014,738,682,56,7.6
46,19,Butte,2014,5123,4954,169,3.3
46,21,Campbell,2014,856,829,27,3.2
46,23,Charles Mix,2014,4044,3894,150,3.7
46,25,Clark,2014,2002,1926,76,3.8
46,27,Clay,2014,7138,6898,240,3.4
46,29,Codington,2014,15468,14969,499,3.2
46,31,Corson,2014,1501,1415,86,5.7
46,33,Custer,2014,3998,3821,177,4.4
46,35,Davison,2014,11367,11055,312,2.7
46,37,Day,2014,2895,2745,150,5.2
46,39,Deuel,2014,2349,2226,123,5.2
46,41,Dewey,2014,2382,2043,339,14.2
46,43,Douglas,2014,1736,1687,49,2.8
46,45,Edmunds,2014,2249,2193,56,2.5
46,47,Fall River,2014,3029,2890,139,4.6
46,49,Faulk,2014,1150,1115,35,3.0
46,51,Grant,2014,4727,4562,165,3.5
46,53,Gregory,2014,2088,2019,69,3.3
46,55,Haakon,2014,1097,1068,29,2.6
46,57,Hamlin,2014,3149,3044,105,3.3
46,59,Hand,2014,1840,1794,46,2.5
46,61,Hanson,2014,1822,1760,62,3.4
46,63,Harding,2014,780,762,18,2.3
46,65,Hughes,2014,10038,9784,254,2.5
46,67,Hutchinson,2014,3684,3581,103,2.8
46,69,Hyde,2014,717,697,20,2.8
46,71,Jackson,2014,1345,1274,71,5.3
46,73,Jerauld,2014,1207,1178,29,2.4
46,75,Jones,2014,612,590,22,3.6
46,77,Kingsbury,2014,2905,2821,84,2.9
46,79,Lake,2014,6371,6146,225,3.5
46,81,Lawrence,2014,12733,12300,433,3.4
46,83,Lincoln,2014,29780,29077,703,2.4
46,85,Lyman,2014,1816,1741,75,4.1
46,87,McCook,2014,3181,3098,83,2.6
46,89,McPherson,2014,1136,1093,43,3.8
46,91,Marshall,2014,2544,2442,102,4.0
46,93,Meade,2014,13389,12951,438,3.3
46,95,Mellette,2014,832,783,49,5.9
46,97,Miner,2014,1249,1210,39,3.1
46,99,Minnehaha,2014,105348,102263,3085,2.9
46,101,Moody,2014,4000,3840,160,4.0
46,102,Oglala Lakota,2014,3637,3164,473,13.0
46,103,Pennington,2014,54411,52602,1809,3.3
46,105,Perkins,2014,1562,1511,51,3.3
46,107,Potter,2014,1208,1169,39,3.2
46,109,Roberts,2014,4891,4662,229,4.7
46,111,Sanborn,2014,1253,1222,31,2.5
46,115,Spink,2014,3414,3297,117,3.4
46,117,Stanley,2014,1873,1826,47,2.5
46,119,Sully,2014,891,867,24,2.7
46,121,Todd,2014,3127,2862,265,8.5
46,123,Tripp,2014,3150,3052,98,3.1
46,125,Turner,2014,4702,4569,133,2.8
46,127,Union,2014,8070,7779,291,3.6
46,129,Walworth,2014,2380,2256,124,5.2
46,135,Yankton,2014,11456,11120,336,2.9
46,137,Ziebach,2014,1011,953,58,5.7
47,1,Anderson,2014,33154,30889,2265,6.8
47,3,Bedford,2014,19524,18057,1467,7.5
47,5,Benton,2014,6737,6144,593,8.8
47,7,Bledsoe,2014,4299,3910,389,9.0
47,9,Blount,2014,58993,55444,3549,6.0
47,11,Bradley,2014,49294,46297,2997,6.1
47,13,Campbell,2014,14775,13388,1387,9.4
47,15,Cannon,2014,5804,5434,370,6.4
47,17,Carroll,2014,12535,11271,1264,10.1
47,19,Carter,2014,23880,22036,1844,7.7
47,21,Cheatham,2014,19858,18765,1093,5.5
47,23,Chester,2014,8165,7609,556,6.8
47,25,Claiborne,2014,12709,11606,1103,8.7
47,27,Clay,2014,3004,2730,274,9.1
47,29,Cocke,2014,14569,13248,1321,9.1
47,31,Coffee,2014,24504,22932,1572,6.4
47,33,Crockett,2014,6899,6371,528,7.7
47,35,Cumberland,2014,23142,21296,1846,8.0
47,37,Davidson,2014,356981,339010,17971,5.0
47,39,Decatur,2014,4806,4346,460,9.6
47,41,DeKalb,2014,7469,6856,613,8.2
47,43,Dickson,2014,23628,22142,1486,6.3
47,45,Dyer,2014,16631,15256,1375,8.3
47,47,Fayette,2014,17862,16568,1294,7.2
47,49,Fentress,2014,7057,6455,602,8.5
47,51,Franklin,2014,19686,18474,1212,6.2
47,53,Gibson,2014,21272,19367,1905,9.0
47,55,Giles,2014,14261,13387,874,6.1
47,57,Grainger,2014,9239,8480,759,8.2
47,59,Greene,2014,30239,27790,2449,8.1
47,61,Grundy,2014,5112,4632,480,9.4
47,63,Hamblen,2014,26401,24445,1956,7.4
47,65,Hamilton,2014,165050,154791,10259,6.2
47,67,Hancock,2014,2074,1870,204,9.8
47,69,Hardeman,2014,9597,8702,895,9.3
47,71,Hardin,2014,10493,9547,946,9.0
47,73,Hawkins,2014,23916,22158,1758,7.4
47,75,Haywood,2014,7776,7009,767,9.9
47,77,Henderson,2014,12236,11176,1060,8.7
47,79,Henry,2014,13953,12824,1129,8.1
47,81,Hickman,2014,10353,9667,686,6.6
47,83,Houston,2014,3305,2977,328,9.9
47,85,Humphreys,2014,8404,7745,659,7.8
47,87,Jackson,2014,4481,4086,395,8.8
47,89,Jefferson,2014,23091,21374,1717,7.4
47,91,Johnson,2014,7152,6660,492,6.9
47,93,Knox,2014,226266,213912,12354,5.5
47,95,Lake,2014,2107,1912,195,9.3
47,97,Lauderdale,2014,9846,8877,969,9.8
47,99,Lawrence,2014,17678,16235,1443,8.2
47,101,Lewis,2014,4866,4428,438,9.0
47,103,Lincoln,2014,15370,14545,825,5.4
47,105,Loudon,2014,21840,20378,1462,6.7
47,107,McMinn,2014,22437,20740,1697,7.6
47,109,McNairy,2014,8968,8013,955,10.6
47,111,Macon,2014,9981,9328,653,6.5
47,113,Madison,2014,46598,43431,3167,6.8
47,115,Marion,2014,11661,10737,924,7.9
47,117,Marshall,2014,14482,13572,910,6.3
47,119,Maury,2014,41206,38749,2457,6.0
47,121,Meigs,2014,4883,4457,426,8.7
47,123,Monroe,2014,19072,17616,1456,7.6
47,125,Montgomery,2014,77370,72207,5163,6.7
47,127,Moore,2014,3295,3127,168,5.1
47,129,Morgan,2014,7803,7113,690,8.8
47,131,Obion,2014,12858,11625,1233,9.6
47,133,Overton,2014,9142,8418,724,7.9
47,135,Perry,2014,3053,2805,248,8.1
47,137,Pickett,2014,2285,2081,204,8.9
47,139,Polk,2014,7414,6827,587,7.9
47,141,Putnam,2014,32122,29904,2218,6.9
47,143,Rhea,2014,13301,12176,1125,8.5
47,145,Roane,2014,22615,20879,1736,7.7
47,147,Robertson,2014,33561,31648,1913,5.7
47,149,Rutherford,2014,149973,142096,7877,5.3
47,151,Scott,2014,8272,7303,969,11.7
47,153,Sequatchie,2014,5746,5316,430,7.5
47,155,Sevier,2014,49012,45496,3516,7.2
47,157,Shelby,2014,430546,397700,32846,7.6
47,159,Smith,2014,8364,7827,537,6.4
47,161,Stewart,2014,5240,4754,486,9.3
47,163,Sullivan,2014,70014,65343,4671,6.7
47,165,Sumner,2014,86652,82079,4573,5.3
47,167,Tipton,2014,27436,25159,2277,8.3
47,169,Trousdale,2014,3679,3418,261,7.1
47,171,Unicoi,2014,7140,6485,655,9.2
47,173,Union,2014,7243,6669,574,7.9
47,175,Van Buren,2014,2114,1910,204,9.6
47,177,Warren,2014,17457,16268,1189,6.8
47,179,Washington,2014,57833,54177,3656,6.3
47,181,Wayne,2014,6469,5904,565,8.7
47,183,Weakley,2014,15915,14548,1367,8.6
47,185,White,2014,11461,10609,852,7.4
47,187,Williamson,2014,103910,99185,4725,4.5
47,189,Wilson,2014,62655,59336,3319,5.3
48,1,Anderson,2014,21760,20732,1028,4.7
48,3,Andrews,2014,9512,9223,289,3.0
48,5,Angelina,2014,37688,35688,2000,5.3
48,7,Aransas,2014,10187,9616,571,5.6
48,9,Archer,2014,4236,4042,194,4.6
48,11,Armstrong,2014,1003,970,33,3.3
48,13,Atascosa,2014,20343,19323,1020,5.0
48,15,Austin,2014,14116,13433,683,4.8
48,17,Bailey,2014,2954,2803,151,5.1
48,19,Bandera,2014,9112,8672,440,4.8
48,21,Bastrop,2014,36660,34852,1808,4.9
48,23,Baylor,2014,1650,1579,71,4.3
48,25,Bee,2014,10720,10089,631,5.9
48,27,Bell,2014,134720,126763,7957,5.9
48,29,Bexar,2014,865150,824137,41013,4.7
48,31,Blanco,2014,5670,5460,210,3.7
48,33,Borden,2014,423,410,13,3.1
48,35,Bosque,2014,8128,7703,425,5.2
48,37,Bowie,2014,39612,37088,2524,6.4
48,39,Brazoria,2014,166488,157901,8587,5.2
48,41,Brazos,2014,104180,99973,4207,4.0
48,43,Brewster,2014,4062,3871,191,4.7
48,45,Briscoe,2014,636,609,27,4.2
48,47,Brooks,2014,2704,2492,212,7.8
48,49,Brown,2014,15828,14998,830,5.2
48,51,Burleson,2014,7581,7216,365,4.8
48,53,Burnet,2014,21468,20531,937,4.4
48,55,Caldwell,2014,17218,16309,909,5.3
48,57,Calhoun,2014,11073,10538,535,4.8
48,59,Callahan,2014,5823,5561,262,4.5
48,61,Cameron,2014,166204,152175,14029,8.4
48,63,Camp,2014,5211,4889,322,6.2
48,65,Carson,2014,3145,3038,107,3.4
48,67,Cass,2014,12270,11321,949,7.7
48,69,Castro,2014,3790,3637,153,4.0
48,71,Chambers,2014,17820,16779,1041,5.8
48,73,Cherokee,2014,21153,19910,1243,5.9
48,75,Childress,2014,2859,2753,106,3.7
48,77,Clay,2014,5012,4780,232,4.6
48,79,Cochran,2014,1396,1324,72,5.2
48,81,Coke,2014,1436,1373,63,4.4
48,83,Coleman,2014,3117,2925,192,6.2
48,85,Collin,2014,473402,451569,21833,4.6
48,87,Collingsworth,2014,1258,1206,52,4.1
48,89,Colorado,2014,10262,9799,463,4.5
48,91,Comal,2014,59759,57012,2747,4.6
48,93,Comanche,2014,5528,5258,270,4.9
48,95,Concho,2014,1412,1369,43,3.0
48,97,Cooke,2014,20512,19711,801,3.9
48,99,Coryell,2014,24690,23199,1491,6.0
48,101,Cottle,2014,605,567,38,6.3
48,103,Crane,2014,2004,1922,82,4.1
48,105,Crockett,2014,1930,1856,74,3.8
48,107,Crosby,2014,2694,2566,128,4.8
48,109,Culberson,2014,1012,969,43,4.2
48,111,Dallam,2014,3896,3780,116,3.0
48,113,Dallas,2014,1249276,1180636,68640,5.5
48,115,Dawson,2014,4892,4651,241,4.9
48,117,Deaf Smith,2014,9093,8760,333,3.7
48,119,Delta,2014,2649,2487,162,6.1
48,121,Denton,2014,413525,394926,18599,4.5
48,123,DeWitt,2014,9999,9611,388,3.9
48,125,Dickens,2014,743,696,47,6.3
48,127,Dimmit,2014,7648,7355,293,3.8
48,129,Donley,2014,1617,1538,79,4.9
48,131,Duval,2014,5523,5211,312,5.6
48,133,Eastland,2014,8351,7941,410,4.9
48,135,Ector,2014,82249,79378,2871,3.5
48,137,Edwards,2014,866,828,38,4.4
48,139,Ellis,2014,78971,75034,3937,5.0
48,141,El Paso,2014,344136,321731,22405,6.5
48,143,Erath,2014,20070,19205,865,4.3
48,145,Falls,2014,6540,6176,364,5.6
48,147,Fannin,2014,15257,14435,822,5.4
48,149,Fayette,2014,13052,12599,453,3.5
48,151,Fisher,2014,1861,1776,85,4.6
48,153,Floyd,2014,2961,2747,214,7.2
48,155,Foard,2014,578,553,25,4.3
48,157,Fort Bend,2014,346538,330674,15864,4.6
48,159,Franklin,2014,4652,4409,243,5.2
48,161,Freestone,2014,7834,7387,447,5.7
48,163,Frio,2014,10326,9952,374,3.6
48,165,Gaines,2014,9351,9042,309,3.3
48,167,Galveston,2014,157411,148465,8946,5.7
48,169,Garza,2014,2239,2157,82,3.7
48,171,Gillespie,2014,12499,12053,446,3.6
48,173,Glasscock,2014,828,806,22,2.7
48,175,Goliad,2014,3566,3418,148,4.2
48,177,Gonzales,2014,9922,9534,388,3.9
48,179,Gray,2014,9772,9374,398,4.1
48,181,Grayson,2014,60269,57302,2967,4.9
48,183,Gregg,2014,61065,58055,3010,4.9
48,185,Grimes,2014,11807,11236,571,4.8
48,187,Guadalupe,2014,71470,68337,3133,4.4
48,189,Hale,2014,13514,12229,1285,9.5
48,191,Hall,2014,1262,1182,80,6.3
48,193,Hamilton,2014,3562,3395,167,4.7
48,195,Hansford,2014,3236,3153,83,2.6
48,197,Hardeman,2014,1646,1564,82,5.0
48,199,Hardin,2014,25363,23751,1612,6.4
48,201,Harris,2014,2226977,2114484,112493,5.1
48,203,Harrison,2014,32151,30358,1793,5.6
48,205,Hartley,2014,2896,2822,74,2.6
48,207,Haskell,2014,2690,2583,107,4.0
48,209,Hays,2014,93897,89833,4064,4.3
48,211,Hemphill,2014,2540,2479,61,2.4
48,213,Henderson,2014,34692,32729,1963,5.7
48,215,Hidalgo,2014,331733,302287,29446,8.9
48,217,Hill,2014,15860,15013,847,5.3
48,219,Hockley,2014,12071,11599,472,3.9
48,221,Hood,2014,24223,23014,1209,5.0
48,223,Hopkins,2014,17465,16635,830,4.8
48,225,Houston,2014,9788,9297,491,5.0
48,227,Howard,2014,13571,12969,602,4.4
48,229,Hudspeth,2014,1250,1170,80,6.4
48,231,Hunt,2014,38523,36214,2309,6.0
48,233,Hutchinson,2014,10503,10038,465,4.4
48,235,Irion,2014,831,800,31,3.7
48,237,Jack,2014,4300,4137,163,3.8
48,239,Jackson,2014,7620,7317,303,4.0
48,241,Jasper,2014,14432,13240,1192,8.3
48,243,Jeff Davis,2014,1146,1104,42,3.7
48,245,Jefferson,2014,110034,100799,9235,8.4
48,247,Jim Hogg,2014,2196,2061,135,6.1
48,249,Jim Wells,2014,20077,19015,1062,5.3
48,251,Johnson,2014,74263,70470,3793,5.1
48,253,Jones,2014,5797,5474,323,5.6
48,255,Karnes,2014,6265,6033,232,3.7
48,257,Kaufman,2014,53532,50740,2792,5.2
48,259,Kendall,2014,18651,17886,765,4.1
48,261,Kenedy,2014,338,328,10,3.0
48,263,Kent,2014,512,494,18,3.5
48,265,Kerr,2014,21399,20448,951,4.4
48,267,Kimble,2014,2110,2027,83,3.9
48,269,King,2014,224,215,9,4.0
48,271,Kinney,2014,1227,1137,90,7.3
48,273,Kleberg,2014,15240,14398,842,5.5
48,275,Knox,2014,1737,1661,76,4.4
48,277,Lamar,2014,22116,20749,1367,6.2
48,279,Lamb,2014,6022,5667,355,5.9
48,281,Lampasas,2014,8955,8446,509,5.7
48,283,La Salle,2014,4569,4426,143,3.1
48,285,Lavaca,2014,8961,8605,356,4.0
48,287,Lee,2014,9326,8950,376,4.0
48,289,Leon,2014,7210,6822,388,5.4
48,291,Liberty,2014,30948,28700,2248,7.3
48,293,Limestone,2014,9189,8646,543,5.9
48,295,Lipscomb,2014,1745,1686,59,3.4
48,297,Live Oak,2014,6106,5885,221,3.6
48,299,Llano,2014,8077,7654,423,5.2
48,301,Loving,2014,78,74,4,5.1
48,303,Lubbock,2014,147568,141676,5892,4.0
48,305,Lynn,2014,2858,2731,127,4.4
48,307,McCulloch,2014,4106,3931,175,4.3
48,309,McLennan,2014,112751,106974,5777,5.1
48,311,McMullen,2014,1058,1037,21,2.0
48,313,Madison,2014,5018,4770,248,4.9
48,315,Marion,2014,4475,4182,293,6.5
48,317,Martin,2014,2683,2591,92,3.4
48,319,Mason,2014,1894,1806,88,4.6
48,321,Matagorda,2014,16663,15338,1325,8.0
48,323,Maverick,2014,23383,20789,2594,11.1
48,325,Medina,2014,20373,19359,1014,5.0
48,327,Menard,2014,884,842,42,4.8
48,329,Midland,2014,90787,88143,2644,2.9
48,331,Milam,2014,10216,9573,643,6.3
48,333,Mills,2014,2045,1955,90,4.4
48,335,Mitchell,2014,2900,2775,125,4.3
48,337,Montague,2014,10120,9713,407,4.0
48,339,Montgomery,2014,253442,242097,11345,4.5
48,341,Moore,2014,11279,10882,397,3.5
48,343,Morris,2014,5619,5174,445,7.9
48,345,Motley,2014,496,475,21,4.2
48,347,Nacogdoches,2014,28588,27041,1547,5.4
48,349,Navarro,2014,23110,21888,1222,5.3
48,351,Newton,2014,5555,5089,466,8.4
48,353,Nolan,2014,7037,6731,306,4.3
48,355,Nueces,2014,168014,159297,8717,5.2
48,357,Ochiltree,2014,5563,5395,168,3.0
48,359,Oldham,2014,940,905,35,3.7
48,361,Orange,2014,37855,34796,3059,8.1
48,363,Palo Pinto,2014,13357,12660,697,5.2
48,365,Panola,2014,12541,11913,628,5.0
48,367,Parker,2014,59018,56288,2730,4.6
48,369,Parmer,2014,5119,4960,159,3.1
48,371,Pecos,2014,6853,6565,288,4.2
48,373,Polk,2014,17208,16084,1124,6.5
48,375,Potter,2014,56753,54476,2277,4.0
48,377,Presidio,2014,3410,3008,402,11.8
48,379,Rains,2014,5398,5128,270,5.0
48,381,Randall,2014,68729,66325,2404,3.5
48,383,Reagan,2014,2074,2007,67,3.2
48,385,Real,2014,1058,991,67,6.3
48,387,Red River,2014,4932,4544,388,7.9
48,389,Reeves,2014,5751,5516,235,4.1
48,391,Refugio,2014,3595,3440,155,4.3
48,393,Roberts,2014,450,433,17,3.8
48,395,Robertson,2014,7138,6749,389,5.4
48,397,Rockwall,2014,43349,41366,1983,4.6
48,399,Runnels,2014,4964,4751,213,4.3
48,401,Rusk,2014,24172,22965,1207,5.0
48,403,Sabine,2014,3540,3161,379,10.7
48,405,San Augustine,2014,2823,2550,273,9.7
48,407,San Jacinto,2014,11397,10732,665,5.8
48,409,San Patricio,2014,30646,28708,1938,6.3
48,411,San Saba,2014,2228,2134,94,4.2
48,413,Schleicher,2014,1776,1722,54,3.0
48,415,Scurry,2014,8598,8308,290,3.4
48,417,Shackelford,2014,2370,2304,66,2.8
48,419,Shelby,2014,11598,10911,687,5.9
48,421,Sherman,2014,1503,1455,48,3.2
48,423,Smith,2014,102112,96723,5389,5.3
48,425,Somervell,2014,4131,3916,215,5.2
48,427,Starr,2014,25990,22401,3589,13.8
48,429,Stephens,2014,4285,4095,190,4.4
48,431,Sterling,2014,811,787,24,3.0
48,433,Stonewall,2014,696,669,27,3.9
48,435,Sutton,2014,2018,1945,73,3.6
48,437,Swisher,2014,2878,2699,179,6.2
48,439,Tarrant,2014,989579,939109,50470,5.1
48,441,Taylor,2014,64315,61569,2746,4.3
48,443,Terrell,2014,479,457,22,4.6
48,445,Terry,2014,5604,5360,244,4.4
48,447,Throckmorton,2014,831,798,33,4.0
48,449,Titus,2014,12894,12071,823,6.4
48,451,Tom Green,2014,54580,52349,2231,4.1
48,453,Travis,2014,643405,616779,26626,4.1
48,455,Trinity,2014,5516,5180,336,6.1
48,457,Tyler,2014,7568,6956,612,8.1
48,459,Upshur,2014,18551,17585,966,5.2
48,461,Upton,2014,1872,1811,61,3.3
48,463,Uvalde,2014,11671,10997,674,5.8
48,465,Val Verde,2014,19358,18231,1127,5.8
48,467,Van Zandt,2014,23869,22589,1280,5.4
48,469,Victoria,2014,46188,44240,1948,4.2
48,471,Walker,2014,23124,21851,1273,5.5
48,473,Waller,2014,21289,20186,1103,5.2
48,475,Ward,2014,5912,5697,215,3.6
48,477,Washington,2014,15676,14946,730,4.7
48,479,Webb,2014,111033,105313,5720,5.2
48,481,Wharton,2014,21542,20524,1018,4.7
48,483,Wheeler,2014,3076,2965,111,3.6
48,485,Wichita,2014,56429,53641,2788,4.9
48,487,Wilbarger,2014,5287,5024,263,5.0
48,489,Willacy,2014,7168,6269,899,12.5
48,491,Williamson,2014,254967,243698,11269,4.4
48,493,Wilson,2014,22513,21565,948,4.2
48,495,Winkler,2014,3281,3135,146,4.4
48,497,Wise,2014,28450,27045,1405,4.9
48,499,Wood,2014,16747,15735,1012,6.0
48,501,Yoakum,2014,4286,4155,131,3.1
48,503,Young,2014,8657,8299,358,4.1
48,505,Zapata,2014,6929,6564,365,5.3
48,507,Zavala,2014,3896,3417,479,12.3
49,1,Beaver,2014,2940,2827,113,3.8
49,3,Box Elder,2014,23230,22372,858,3.7
49,5,Cache,2014,58407,56624,1783,3.1
49,7,Carbon,2014,8620,8198,422,4.9
49,9,Daggett,2014,427,410,17,4.0
49,11,Davis,2014,154563,149286,5277,3.4
49,13,Duchesne,2014,9499,9170,329,3.5
49,15,Emery,2014,4571,4339,232,5.1
49,17,Garfield,2014,2688,2463,225,8.4
49,19,Grand,2014,5470,5138,332,6.1
49,21,Iron,2014,19746,18892,854,4.3
49,23,Juab,2014,4756,4571,185,3.9
49,25,Kane,2014,3533,3372,161,4.6
49,27,Millard,2014,5915,5718,197,3.3
49,29,Morgan,2014,4651,4500,151,3.2
49,31,Piute,2014,455,424,31,6.8
49,33,Rich,2014,998,961,37,3.7
49,35,Salt Lake,2014,570837,550796,20041,3.5
49,37,San Juan,2014,5549,5139,410,7.4
49,39,Sanpete,2014,10968,10493,475,4.3
49,41,Sevier,2014,9186,8792,394,4.3
49,43,Summit,2014,22350,21619,731,3.3
49,45,Tooele,2014,28646,27335,1311,4.6
49,47,Uintah,2014,15861,15321,540,3.4
49,49,Utah,2014,253091,244673,8418,3.3
49,51,Wasatch,2014,12609,12155,454,3.6
49,53,Washington,2014,60968,58414,2554,4.2
49,55,Wayne,2014,1369,1246,123,9.0
49,57,Weber,2014,113878,109106,4772,4.2
50,1,Addison,2014,20914,20128,786,3.8
50,3,Bennington,2014,18759,17886,873,4.7
50,5,Caledonia,2014,15344,14597,747,4.9
50,7,Chittenden,2014,95964,93018,2946,3.1
50,9,Essex,2014,2782,2616,166,6.0
50,11,Franklin,2014,27595,26493,1102,4.0
50,13,Grand Isle,2014,4085,3901,184,4.5
50,15,Lamoille,2014,13818,13103,715,5.2
50,17,Orange,2014,15965,15347,618,3.9
50,19,Orleans,2014,13680,12822,858,6.3
50,21,Rutland,2014,31918,30393,1525,4.8
50,23,Washington,2014,34412,33067,1345,3.9
50,25,Windham,2014,23623,22647,976,4.1
50,27,Windsor,2014,29835,28723,1112,3.7
51,1,Accomack,2014,16112,15056,1056,6.6
51,3,Albemarle,2014,53788,51417,2371,4.4
51,5,Alleghany,2014,7221,6801,420,5.8
51,7,Amelia,2014,6230,5908,322,5.2
51,9,Amherst,2014,15682,14847,835,5.3
51,11,Appomattox,2014,7139,6739,400,5.6
51,13,Arlington,2014,145098,140437,4661,3.2
51,15,Augusta,2014,36977,35275,1702,4.6
51,17,Bath,2014,2602,2488,114,4.4
51,19,Bedford,2014,38576,36641,1935,5.0
51,21,Bland,2014,2876,2706,170,5.9
51,23,Botetourt,2014,17749,16900,849,4.8
51,25,Brunswick,2014,6485,5971,514,7.9
51,27,Buchanan,2014,7788,6988,800,10.3
51,29,Buckingham,2014,6322,5900,422,6.7
51,31,Campbell,2014,26725,25317,1408,5.3
51,33,Caroline,2014,14819,13922,897,6.1
51,35,Carroll,2014,13229,12357,872,6.6
51,36,Charles City,2014,3730,3512,218,5.8
51,37,Charlotte,2014,5317,4964,353,6.6
51,41,Chesterfield,2014,178043,169093,8950,5.0
51,43,Clarke,2014,7572,7246,326,4.3
51,45,Craig,2014,2466,2312,154,6.2
51,47,Culpeper,2014,23431,22281,1150,4.9
51,49,Cumberland,2014,4553,4279,274,6.0
51,51,Dickenson,2014,5209,4688,521,10.0
51,53,Dinwiddie,2014,13505,12650,855,6.3
51,57,Essex,2014,5700,5344,356,6.2
51,59,Fairfax,2014,622116,596624,25492,4.1
51,61,Fauquier,2014,36049,34427,1622,4.5
51,63,Floyd,2014,8332,7952,380,4.6
51,65,Fluvanna,2014,13215,12648,567,4.3
51,67,Franklin,2014,27256,25824,1432,5.3
51,69,Frederick,2014,44636,42578,2058,4.6
51,71,Giles,2014,8092,7601,491,6.1
51,73,Gloucester,2014,19504,18581,923,4.7
51,75,Goochland,2014,10577,10080,497,4.7
51,77,Grayson,2014,7091,6552,539,7.6
51,79,Greene,2014,9887,9460,427,4.3
51,81,Greensville,2014,4257,3987,270,6.3
51,83,Halifax,2014,15598,14404,1194,7.7
51,85,Hanover,2014,55997,53492,2505,4.5
51,87,Henrico,2014,176852,168004,8848,5.0
51,89,Henry,2014,22989,21257,1732,7.5
51,91,Highland,2014,1425,1371,54,3.8
51,93,Isle of Wight,2014,19038,18058,980,5.1
51,95,James City,2014,34735,33060,1675,4.8
51,97,King and Queen,2014,3656,3449,207,5.7
51,99,King George,2014,12123,11482,641,5.3
51,101,King William,2014,8783,8338,445,5.1
51,103,Lancaster,2014,5364,4961,403,7.5
51,105,Lee,2014,8864,8153,711,8.0
51,107,Loudoun,2014,196697,188499,8198,4.2
51,109,Louisa,2014,18513,17591,922,5.0
51,111,Lunenburg,2014,5358,5048,310,5.8
51,113,Madison,2014,7272,6984,288,4.0
51,115,Mathews,2014,4139,3951,188,4.5
51,117,Mecklenburg,2014,12663,11705,958,7.6
51,119,Middlesex,2014,5045,4795,250,5.0
51,121,Montgomery,2014,49948,47448,2500,5.0
51,125,Nelson,2014,7418,7060,358,4.8
51,127,New Kent,2014,11116,10623,493,4.4
51,131,Northampton,2014,6101,5648,453,7.4
51,133,Northumberland,2014,5657,5265,392,6.9
51,135,Nottoway,2014,7102,6730,372,5.2
51,137,Orange,2014,16237,15393,844,5.2
51,139,Page,2014,11863,10925,938,7.9
51,141,Patrick,2014,7747,7239,508,6.6
51,143,Pittsylvania,2014,30353,28461,1892,6.2
51,145,Powhatan,2014,13711,13101,610,4.4
51,147,Prince Edward,2014,10055,9300,755,7.5
51,149,Prince George,2014,14812,13894,918,6.2
51,153,Prince William,2014,232639,221468,11171,4.8
51,155,Pulaski,2014,16511,15523,988,6.0
51,157,Rappahannock,2014,3811,3632,179,4.7
51,159,Richmond,2014,3986,3773,213,5.3
51,161,Roanoke,2014,50161,47911,2250,4.5
51,163,Rockbridge,2014,10334,9794,540,5.2
51,165,Rockingham,2014,40524,38662,1862,4.6
51,167,Russell,2014,11308,10434,874,7.7
51,169,Scott,2014,9817,9254,563,5.7
51,171,Shenandoah,2014,21298,20253,1045,4.9
51,173,Smyth,2014,13485,12439,1046,7.8
51,175,Southampton,2014,9156,8716,440,4.8
51,177,Spotsylvania,2014,64336,60922,3414,5.3
51,179,Stafford,2014,66910,63415,3495,5.2
51,181,Surry,2014,3676,3452,224,6.1
51,183,Sussex,2014,4120,3804,316,7.7
51,185,Tazewell,2014,17273,15895,1378,8.0
51,187,Warren,2014,19983,18878,1105,5.5
51,191,Washington,2014,27712,26146,1566,5.7
51,193,Westmoreland,2014,9042,8468,574,6.3
51,195,Wise,2014,14471,13123,1348,9.3
51,197,Wythe,2014,13834,12960,874,6.3
51,199,York,2014,31944,30376,1568,4.9
51,510,Alexandria city,2014,93893,90355,3538,3.8
51,520,Bristol city,2014,7746,7261,485,6.3
51,530,Buena Vista city,2014,3317,3129,188,5.7
51,540,Charlottesville city,2014,24308,23277,1031,4.2
51,550,Chesapeake city,2014,117670,111586,6084,5.2
51,570,Colonial Heights city,2014,8732,8236,496,5.7
51,580,Covington city,2014,2495,2299,196,7.9
51,590,Danville city,2014,19649,17976,1673,8.5
51,595,Emporia city,2014,2319,2133,186,8.0
51,600,Fairfax city,2014,13292,12755,537,4.0
51,610,Falls Church city,2014,7818,7542,276,3.5
51,620,Franklin city,2014,3625,3346,279,7.7
51,630,Fredericksburg city,2014,13716,12894,822,6.0
51,640,Galax city,2014,3003,2786,217,7.2
51,650,Hampton city,2014,65793,61431,4362,6.6
51,660,Harrisonburg city,2014,24296,22843,1453,6.0
51,670,Hopewell city,2014,9682,8828,854,8.8
51,678,Lexington city,2014,2280,2106,174,7.6
51,680,Lynchburg city,2014,36112,33853,2259,6.3
51,683,Manassas city,2014,22193,21102,1091,4.9
51,685,Manassas Park city,2014,8190,7806,384,4.7
51,690,Martinsville city,2014,5559,5017,542,9.7
51,700,Newport News city,2014,90995,85403,5592,6.1
51,710,Norfolk city,2014,112403,105379,7024,6.2
51,720,Norton city,2014,1811,1674,137,7.6
51,730,Petersburg city,2014,13827,12371,1456,10.5
51,735,Poquoson city,2014,6321,6039,282,4.5
51,740,Portsmouth city,2014,45226,41996,3230,7.1
51,750,Radford city,2014,8495,7933,562,6.6
51,760,Richmond city,2014,112740,105947,6793,6.0
51,770,Roanoke city,2014,50256,47364,2892,5.8
51,775,Salem city,2014,13166,12499,667,5.1
51,790,Staunton city,2014,12083,11472,611,5.1
51,800,Suffolk city,2014,42508,40105,2403,5.7
51,810,Virginia Beach city,2014,232581,221324,11257,4.8
51,820,Waynesboro city,2014,10104,9574,530,5.2
51,830,Williamsburg city,2014,6658,6178,480,7.2
51,840,Winchester city,2014,14481,13753,728,5.0
53,1,Adams,2014,8537,7944,593,6.9
53,3,Asotin,2014,9694,9190,504,5.2
53,5,Benton,2014,89740,83220,6520,7.3
53,7,Chelan,2014,41117,38656,2461,6.0
53,9,Clallam,2014,26682,24504,2178,8.2
53,11,Clark,2014,208941,194712,14229,6.8
53,13,Columbia,2014,1738,1617,121,7.0
53,15,Cowlitz,2014,43534,40120,3414,7.8
53,17,Douglas,2014,19292,17961,1331,6.9
53,19,Ferry,2014,2445,2174,271,11.1
53,21,Franklin,2014,37979,34902,3077,8.1
53,23,Garfield,2014,959,897,62,6.5
53,25,Grant,2014,44765,41532,3233,7.2
53,27,Grays Harbor,2014,27137,24462,2675,9.9
53,29,Island,2014,31680,29643,2037,6.4
53,31,Jefferson,2014,11175,10304,871,7.8
53,33,King,2014,1164823,1112394,52429,4.5
53,35,Kitsap,2014,113427,106681,6746,5.9
53,37,Kittitas,2014,20169,18810,1359,6.7
53,39,Klickitat,2014,9567,8848,719,7.5
53,41,Lewis,2014,30479,27793,2686,8.8
53,43,Lincoln,2014,5031,4749,282,5.6
53,45,Mason,2014,23090,21213,1877,8.1
53,47,Okanogan,2014,21276,19804,1472,6.9
53,49,Pacific,2014,7838,7084,754,9.6
53,51,Pend Oreille,2014,4570,4125,445,9.7
53,53,Pierce,2014,384834,358653,26181,6.8
53,55,San Juan,2014,7684,7311,373,4.9
53,57,Skagit,2014,56370,52423,3947,7.0
53,59,Skamania,2014,4936,4542,394,8.0
53,61,Snohomish,2014,397747,377774,19973,5.0
53,63,Spokane,2014,225104,209870,15234,6.8
53,65,Stevens,2014,17361,15788,1573,9.1
53,67,Thurston,2014,123222,115445,7777,6.3
53,69,Wahkiakum,2014,1274,1154,120,9.4
53,71,Walla Walla,2014,28420,26722,1698,6.0
53,73,Whatcom,2014,101159,94713,6446,6.4
53,75,Whitman,2014,22132,21009,1123,5.1
53,77,Yakima,2014,119231,109163,10068,8.4
54,1,Barbour,2014,6888,6432,456,6.6
54,3,Berkeley,2014,53053,50199,2854,5.4
54,5,Boone,2014,8499,7725,774,9.1
54,7,Braxton,2014,5273,4784,489,9.3
54,9,Brooke,2014,10199,9473,726,7.1
54,11,Cabell,2014,42541,40245,2296,5.4
54,13,Calhoun,2014,2930,2650,280,9.6
54,15,Clay,2014,3347,2989,358,10.7
54,17,Doddridge,2014,3669,3489,180,4.9
54,19,Fayette,2014,16756,15380,1376,8.2
54,21,Gilmer,2014,2768,2591,177,6.4
54,23,Grant,2014,5863,5420,443,7.6
54,25,Greenbrier,2014,15280,14243,1037,6.8
54,27,Hampshire,2014,9500,8911,589,6.2
54,29,Hancock,2014,13253,12209,1044,7.9
54,31,Hardy,2014,5400,4952,448,8.3
54,33,Harrison,2014,32109,30415,1694,5.3
54,35,Jackson,2014,11944,11163,781,6.5
54,37,Jefferson,2014,27162,25920,1242,4.6
54,39,Kanawha,2014,89517,84347,5170,5.8
54,41,Lewis,2014,7246,6795,451,6.2
54,43,Lincoln,2014,7589,6874,715,9.4
54,45,Logan,2014,11998,10756,1242,10.4
54,47,McDowell,2014,5819,5070,749,12.9
54,49,Marion,2014,26687,25118,1569,5.9
54,51,Marshall,2014,14379,13300,1079,7.5
54,53,Mason,2014,10217,9273,944,9.2
54,55,Mercer,2014,22429,20748,1681,7.5
54,57,Mineral,2014,11899,10970,929,7.8
54,59,Mingo,2014,7775,6859,916,11.8
54,61,Monongalia,2014,50802,48594,2208,4.3
54,63,Monroe,2014,5617,5294,323,5.8
54,65,Morgan,2014,7472,7036,436,5.8
54,67,Nicholas,2014,10147,9239,908,8.9
54,69,Ohio,2014,21184,20025,1159,5.5
54,71,Pendleton,2014,3515,3346,169,4.8
54,73,Pleasants,2014,3003,2793,210,7.0
54,75,Pocahontas,2014,3569,3265,304,8.5
54,77,Preston,2014,14611,13747,864,5.9
54,79,Putnam,2014,26151,24725,1426,5.5
54,81,Raleigh,2014,31505,29284,2221,7.0
54,83,Randolph,2014,11918,11071,847,7.1
54,85,Ritchie,2014,4638,4355,283,6.1
54,87,Roane,2014,5332,4807,525,9.8
54,89,Summers,2014,4524,4207,317,7.0
54,91,Taylor,2014,7817,7409,408,5.2
54,93,Tucker,2014,3392,3180,212,6.3
54,95,Tyler,2014,3635,3311,324,8.9
54,97,Upshur,2014,9635,8997,638,6.6
54,99,Wayne,2014,16006,14927,1079,6.7
54,101,Webster,2014,3471,3178,293,8.4
54,103,Wetzel,2014,7324,6586,738,10.1
54,105,Wirt,2014,2284,2067,217,9.5
54,107,Wood,2014,38168,35938,2230,5.8
54,109,Wyoming,2014,8021,7271,750,9.4
55,1,Adams,2014,8383,7652,731,8.7
55,3,Ashland,2014,8041,7447,594,7.4
55,5,Barron,2014,24043,22676,1367,5.7
55,7,Bayfield,2014,7528,6817,711,9.4
55,9,Brown,2014,138288,131689,6599,4.8
55,11,Buffalo,2014,6454,6096,358,5.5
55,13,Burnett,2014,7357,6774,583,7.9
55,15,Calumet,2014,27116,25996,1120,4.1
55,17,Chippewa,2014,33022,31269,1753,5.3
55,19,Clark,2014,16947,16035,912,5.4
55,21,Columbia,2014,31157,29537,1620,5.2
55,23,Crawford,2014,7975,7420,555,7.0
55,25,Dane,2014,305442,294301,11141,3.6
55,27,Dodge,2014,47472,44958,2514,5.3
55,29,Door,2014,15349,14112,1237,8.1
55,31,Douglas,2014,23512,22196,1316,5.6
55,33,Dunn,2014,23611,22397,1214,5.1
55,35,Eau Claire,2014,57929,55365,2564,4.4
55,37,Florence,2014,2202,2040,162,7.4
55,39,Fond du Lac,2014,57050,54285,2765,4.8
55,41,Forest,2014,4016,3672,344,8.6
55,43,Grant,2014,27708,26394,1314,4.7
55,45,Green,2014,20815,19890,925,4.4
55,47,Green Lake,2014,10031,9396,635,6.3
55,49,Iowa,2014,13537,12854,683,5.0
55,51,Iron,2014,2675,2425,250,9.3
55,53,Jackson,2014,10192,9604,588,5.8
55,55,Jefferson,2014,45761,43512,2249,4.9
55,57,Juneau,2014,13366,12515,851,6.4
55,59,Kenosha,2014,86666,81481,5185,6.0
55,61,Kewaunee,2014,10827,10289,538,5.0
55,63,La Crosse,2014,66625,63762,2863,4.3
55,65,Lafayette,2014,9391,9000,391,4.2
55,67,Langlade,2014,9552,8843,709,7.4
55,69,Lincoln,2014,15356,14415,941,6.1
55,71,Manitowoc,2014,42506,39973,2533,6.0
55,73,Marathon,2014,73076,69446,3630,5.0
55,75,Marinette,2014,21067,19664,1403,6.7
55,77,Marquette,2014,7316,6799,517,7.1
55,78,Menominee,2014,1596,1401,195,12.2
55,79,Milwaukee,2014,478001,445584,32417,6.8
55,81,Monroe,2014,22520,21321,1199,5.3
55,83,Oconto,2014,20321,19079,1242,6.1
55,85,Oneida,2014,18743,17497,1246,6.6
55,87,Outagamie,2014,101176,96425,4751,4.7
55,89,Ozaukee,2014,47895,45896,1999,4.2
55,91,Pepin,2014,4026,3837,189,4.7
55,93,Pierce,2014,23991,22945,1046,4.4
55,95,Polk,2014,24408,23030,1378,5.6
55,97,Portage,2014,39247,37092,2155,5.5
55,99,Price,2014,6770,6410,360,5.3
55,101,Racine,2014,99713,93226,6487,6.5
55,103,Richland,2014,9298,8835,463,5.0
55,105,Rock,2014,82181,77215,4966,6.0
55,107,Rusk,2014,6985,6534,451,6.5
55,109,St. Croix,2014,48256,46130,2126,4.4
55,111,Sauk,2014,34945,33229,1716,4.9
55,113,Sawyer,2014,7942,7243,699,8.8
55,115,Shawano,2014,21270,20026,1244,5.8
55,117,Sheboygan,2014,61151,58410,2741,4.5
55,119,Taylor,2014,10625,10067,558,5.3
55,121,Trempealeau,2014,16508,15767,741,4.5
55,123,Vernon,2014,15026,14310,716,4.8
55,125,Vilas,2014,10066,9228,838,8.3
55,127,Walworth,2014,56932,53825,3107,5.5
55,129,Washburn,2014,7921,7435,486,6.1
55,131,Washington,2014,75688,72299,3389,4.5
55,133,Waukesha,2014,220344,210721,9623,4.4
55,135,Waupaca,2014,27287,25765,1522,5.6
55,137,Waushara,2014,11600,10782,818,7.1
55,139,Winnebago,2014,91483,86781,4702,5.1
55,141,Wood,2014,34716,32431,2285,6.6
56,1,Albany,2014,20251,19516,735,3.6
56,3,Big Horn,2014,5517,5257,260,4.7
56,5,Campbell,2014,25946,25033,913,3.5
56,7,Carbon,2014,8342,7993,349,4.2
56,9,Converse,2014,8241,7980,261,3.2
56,11,Crook,2014,3668,3519,149,4.1
56,13,Fremont,2014,20333,19273,1060,5.2
56,15,Goshen,2014,7057,6791,266,3.8
56,17,Hot Springs,2014,2459,2352,107,4.4
56,19,Johnson,2014,4430,4221,209,4.7
56,21,Laramie,2014,48216,46027,2189,4.5
56,23,Lincoln,2014,8145,7706,439,5.4
56,25,Natrona,2014,42863,41051,1812,4.2
56,27,Niobrara,2014,1335,1288,47,3.5
56,29,Park,2014,15569,14842,727,4.7
56,31,Platte,2014,4725,4534,191,4.0
56,33,Sheridan,2014,15726,14963,763,4.9
56,35,Sublette,2014,4817,4601,216,4.5
56,37,Sweetwater,2014,23026,22061,965,4.2
56,39,Teton,2014,14272,13579,693,4.9
56,41,Uinta,2014,9774,9281,493,5.0
56,43,Washakie,2014,4228,4036,192,4.5
56,45,Weston,2014,3925,3789,136,3.5
72,1,Adjuntas Municipio,2014,4491,3505,986,22.0
72,3,Aguada Municipio,2014,11990,9927,2063,17.2
72,5,Aguadilla Municipio,2014,14933,12472,2461,16.5
72,7,Aguas Buenas Municipio,2014,6921,5778,1143,16.5
72,9,Aibonito Municipio,2014,6839,5641,1198,17.5
72,11,Anasco Municipio,2014,8959,7489,1470,16.4
72,13,Arecibo Municipio,2014,24353,20564,3789,15.6
72,15,Arroyo Municipio,2014,5305,4074,1231,23.2
72,17,Barceloneta Municipio,2014,6148,4926,1222,19.9
72,19,Barranquitas Municipio,2014,7540,6357,1183,15.7
72,21,Bayamon Municipio,2014,67762,60786,6976,10.3
72,23,Cabo Rojo Municipio,2014,14391,11927,2464,17.1
72,25,Caguas Municipio,2014,48642,42911,5731,11.8
72,27,Camuy Municipio,2014,9628,8196,1432,14.9
72,29,Canovanas Municipio,2014,16179,14067,2112,13.1
72,31,Carolina Municipio,2014,63037,56843,6194,9.8
72,33,Catano Municipio,2014,8159,7153,1006,12.3
72,35,Cayey Municipio,2014,16375,14300,2075,12.7
72,37,Ceiba Municipio,2014,4010,3327,683,17.0
72,39,Ciales Municipio,2014,4189,3225,964,23.0
72,41,Cidra Municipio,2014,15764,13876,1888,12.0
72,43,Coamo Municipio,2014,11022,8702,2320,21.0
72,45,Comerio Municipio,2014,5312,4315,997,18.8
72,47,Corozal Municipio,2014,9535,8093,1442,15.1
72,49,Culebra Municipio,2014,786,737,49,6.2
72,51,Dorado Municipio,2014,12666,11559,1107,8.7
72,53,Fajardo Municipio,2014,11911,9816,2095,17.6
72,54,Florida Municipio,2014,3526,2861,665,18.9
72,55,Guanica Municipio,2014,4483,3364,1119,25.0
72,57,Guayama Municipio,2014,12315,9799,2516,20.4
72,59,Guayanilla Municipio,2014,5499,4301,1198,21.8
72,61,Guaynabo Municipio,2014,36950,34644,2306,6.2
72,63,Gurabo Municipio,2014,17085,15283,1802,10.5
72,65,Hatillo Municipio,2014,13093,10962,2131,16.3
72,67,Hormigueros Municipio,2014,5662,4836,826,14.6
72,69,Humacao Municipio,2014,17974,14868,3106,17.3
72,71,Isabela Municipio,2014,12423,10543,1880,15.1
72,73,Jayuya Municipio,2014,4202,3467,735,17.5
72,75,Juana Diaz Municipio,2014,15739,13175,2564,16.3
72,77,Juncos Municipio,2014,12462,10543,1919,15.4
72,79,Lajas Municipio,2014,5891,4484,1407,23.9
72,81,Lares Municipio,2014,7587,5819,1768,23.3
72,83,Las Marias Municipio,2014,2901,2167,734,25.3
72,85,Las Piedras Municipio,2014,11421,9580,1841,16.1
72,87,Loiza Municipio,2014,8944,7761,1183,13.2
72,89,Luquillo Municipio,2014,6658,5377,1281,19.2
72,91,Manati Municipio,2014,11792,10169,1623,13.8
72,93,Maricao Municipio,2014,1959,1549,410,20.9
72,95,Maunabo Municipio,2014,3119,2452,667,21.4
72,97,Mayaguez Municipio,2014,24223,20082,4141,17.1
72,99,Moca Municipio,2014,10762,8778,1984,18.4
72,101,Morovis Municipio,2014,8422,6867,1555,18.5
72,103,Naguabo Municipio,2014,8288,7026,1262,15.2
72,105,Naranjito Municipio,2014,7478,6233,1245,16.6
72,107,Orocovis Municipio,2014,5389,4365,1024,19.0
72,109,Patillas Municipio,2014,4915,3747,1168,23.8
72,111,Penuelas Municipio,2014,6496,5126,1370,21.1
72,113,Ponce Municipio,2014,48964,41435,7529,15.4
72,115,Quebradillas Municipio,2014,6126,4996,1130,18.4
72,117,Rincon Municipio,2014,4706,3768,938,19.9
72,119,Rio Grande Municipio,2014,17162,15120,2042,11.9
72,121,Sabana Grande Municipio,2014,6508,5288,1220,18.7
72,123,Salinas Municipio,2014,8312,6121,2191,26.4
72,125,San German Municipio,2014,10549,8649,1900,18.0
72,127,San Juan Municipio,2014,135903,124920,10983,8.1
72,129,San Lorenzo Municipio,2014,12230,10320,1910,15.6
72,131,San Sebastian Municipio,2014,11018,8461,2557,23.2
72,133,Santa Isabel Municipio,2014,9874,7920,1954,19.8
72,135,Toa Alta Municipio,2014,25939,23561,2378,9.2
72,137,Toa Baja Municipio,2014,30263,27171,3092,10.2
72,139,Trujillo Alto Municipio,2014,27129,25028,2101,7.7
72,141,Utuado Municipio,2014,7047,5740,1307,18.5
72,143,Vega Alta Municipio,2014,9965,8591,1374,13.8
72,145,Vega Baja Municipio,2014,14157,11869,2288,16.2
72,147,Vieques Municipio,2014,3152,2710,442,14.0
72,149,Villalba Municipio,2014,7920,6196,1724,21.8
72,151,Yabucoa Municipio,2014,9642,7546,2096,21.7
72,153,Yauco Municipio,2014,11031,8665,2366,21.4
1,1,Autauga,2015,25541,24206,1335,5.2
1,3,Baldwin,2015,87493,82619,4874,5.6
1,5,Barbour,2015,8590,7823,767,8.9
1,7,Bibb,2015,8552,7983,569,6.7
1,9,Blount,2015,24416,23089,1327,5.4
1,11,Bullock,2015,4765,4385,380,8.0
1,13,Butler,2015,9113,8417,696,7.6
1,15,Calhoun,2015,45808,42566,3242,7.1
1,17,Chambers,2015,14939,14031,908,6.1
1,19,Cherokee,2015,11132,10521,611,5.5
1,21,Chilton,2015,19089,18005,1084,5.7
1,23,Choctaw,2015,4369,3969,400,9.2
1,25,Clarke,2015,7976,7036,940,11.8
1,27,Clay,2015,5535,5194,341,6.2
1,29,Cleburne,2015,5664,5321,343,6.1
1,31,Coffee,2015,20222,19010,1212,6.0
1,33,Colbert,2015,23550,21673,1877,8.0
1,35,Conecuh,2015,4671,4238,433,9.3
1,37,Coosa,2015,4416,4119,297,6.7
1,39,Covington,2015,15422,14314,1108,7.2
1,41,Crenshaw,2015,6339,5957,382,6.0
1,43,Cullman,2015,36296,34376,1920,5.3
1,45,Dale,2015,19789,18524,1265,6.4
1,47,Dallas,2015,15555,14056,1499,9.6
1,49,DeKalb,2015,28700,26949,1751,6.1
1,51,Elmore,2015,36655,34803,1852,5.1
1,53,Escambia,2015,14564,13535,1029,7.1
1,55,Etowah,2015,42586,39936,2650,6.2
1,57,Fayette,2015,6406,5954,452,7.1
1,59,Franklin,2015,13628,12746,882,6.5
1,61,Geneva,2015,10761,10120,641,6.0
1,63,Greene,2015,2872,2552,320,11.1
1,65,Hale,2015,6034,5562,472,7.8
1,67,Henry,2015,6702,6243,459,6.8
1,69,Houston,2015,44440,41655,2785,6.3
1,71,Jackson,2015,23407,21840,1567,6.7
1,73,Jefferson,2015,310158,292165,17993,5.8
1,75,Lamar,2015,5602,5246,356,6.4
1,77,Lauderdale,2015,42544,39577,2967,7.0
1,79,Lawrence,2015,13642,12582,1060,7.8
1,81,Lee,2015,70690,66958,3732,5.3
1,83,Limestone,2015,39848,37653,2195,5.5
1,85,Lowndes,2015,3819,3376,443,11.6
1,87,Macon,2015,7951,7307,644,8.1
1,89,Madison,2015,170473,161071,9402,5.5
1,91,Marengo,2015,7387,6820,567,7.7
1,93,Marion,2015,12453,11583,870,7.0
1,95,Marshall,2015,40290,37944,2346,5.8
1,97,Mobile,2015,186483,173586,12897,6.9
1,99,Monroe,2015,7324,6583,741,10.1
1,101,Montgomery,2015,104799,98376,6423,6.1
1,103,Morgan,2015,54782,51538,3244,5.9
1,105,Perry,2015,3478,3129,349,10.0
1,107,Pickens,2015,7987,7445,542,6.8
1,109,Pike,2015,14904,13918,986,6.6
1,111,Randolph,2015,9410,8852,558,5.9
1,113,Russell,2015,24051,22614,1437,6.0
1,115,St. Clair,2015,38470,36452,2018,5.2
1,117,Shelby,2015,107932,103362,4570,4.2
1,119,Sumter,2015,5096,4687,409,8.0
1,121,Talladega,2015,35052,32736,2316,6.6
1,123,Tallapoosa,2015,18696,17550,1146,6.1
1,125,Tuscaloosa,2015,98625,93229,5396,5.5
1,127,Walker,2015,25503,23650,1853,7.3
1,129,Washington,2015,6685,6086,599,9.0
1,131,Wilcox,2015,2819,2404,415,14.7
1,133,Winston,2015,9354,8645,709,7.6
2,13,Aleutians East Borough,2015,2472,2395,77,3.1
2,16,Aleutians West Census Area,2015,4060,3908,152,3.7
2,20,Anchorage Borough/municipality,2015,156476,148856,7620,4.9
2,50,Bethel Census Area,2015,7325,6304,1021,13.9
2,60,Bristol Bay Borough,2015,380,346,34,8.9
2,68,Denali Borough,2015,1066,976,90,8.4
2,70,Dillingham Census Area,2015,2033,1843,190,9.3
2,90,Fairbanks North Star Borough,2015,46308,43862,2446,5.3
2,100,Haines Borough,2015,1083,980,103,9.5
2,105,Hoonah-Angoon Census Area,2015,1128,962,166,14.7
2,110,Juneau Borough/city,2015,17060,16283,777,4.6
2,122,Kenai Peninsula Borough,2015,27557,25470,2087,7.6
2,130,Ketchikan Gateway Borough,2015,6944,6482,462,6.7
2,150,Kodiak Island Borough,2015,6608,6300,308,4.7
2,158,Kusilvak Census Area,2015,2787,2160,627,22.5
2,164,Lake and Peninsula Borough,2015,643,565,78,12.1
2,170,Matanuska-Susitna Borough,2015,46057,42633,3424,7.4
2,180,Nome Census Area,2015,4065,3596,469,11.5
2,185,North Slope Borough,2015,4296,4059,237,5.5
2,188,Northwest Arctic Borough,2015,2893,2444,449,15.5
2,195,Petersburg Borough,2015,1490,1361,129,8.7
2,198,Prince of Wales-Hyder Census Area,2015,2750,2415,335,12.2
2,220,Sitka Borough/city,2015,4591,4387,204,4.4
2,230,Skagway Municipality,2015,808,718,90,11.1
2,240,Southeast Fairbanks Census Area,2015,2997,2688,309,10.3
2,261,Valdez-Cordova Census Area,2015,4864,4456,408,8.4
2,275,Wrangell Borough/city,2015,1028,950,78,7.6
2,282,Yakutat Borough/city,2015,259,237,22,8.5
2,290,Yukon-Koyukuk Census Area,2015,2395,1968,427,17.8
4,1,Apache,2015,20730,17966,2764,13.3
4,3,Cochise,2015,50586,46891,3695,7.3
4,5,Coconino,2015,73669,68861,4808,6.5
4,7,Gila,2015,21321,19633,1688,7.9
4,9,Graham,2015,14590,13515,1075,7.4
4,11,Greenlee,2015,4068,3745,323,7.9
4,12,La Paz,2015,8217,7602,615,7.5
4,13,Maricopa,2015,2033488,1928852,104636,5.1
4,15,Mohave,2015,80004,73633,6371,8.0
4,17,Navajo,2015,40931,36963,3968,9.7
4,19,Pima,2015,467826,442099,25727,5.5
4,21,Pinal,2015,158049,148079,9970,6.3
4,23,Santa Cruz,2015,19986,17687,2299,11.5
4,25,Yavapai,2015,96735,91286,5449,5.6
4,27,Yuma,2015,94249,73736,20513,21.8
5,1,Arkansas,2015,9534,9142,392,4.1
5,3,Ashley,2015,8397,7771,626,7.5
5,5,Baxter,2015,16288,15407,881,5.4
5,7,Benton,2015,122348,117802,4546,3.7
5,9,Boone,2015,15909,15145,764,4.8
5,11,Bradley,2015,4575,4314,261,5.7
5,13,Calhoun,2015,2429,2300,129,5.3
5,15,Carroll,2015,12711,12138,573,4.5
5,17,Chicot,2015,3743,3408,335,9.0
5,19,Clark,2015,9663,9144,519,5.4
5,21,Clay,2015,6323,5911,412,6.5
5,23,Cleburne,2015,9655,8996,659,6.8
5,25,Cleveland,2015,3371,3184,187,5.5
5,27,Columbia,2015,9599,8982,617,6.4
5,29,Conway,2015,8682,8161,521,6.0
5,31,Craighead,2015,51214,48977,2237,4.4
5,33,Crawford,2015,26962,25582,1380,5.1
5,35,Crittenden,2015,21503,20198,1305,6.1
5,37,Cross,2015,8135,7701,434,5.3
5,39,Dallas,2015,2987,2782,205,6.9
5,41,Desha,2015,5579,5178,401,7.2
5,43,Drew,2015,8115,7568,547,6.7
5,45,Faulkner,2015,60161,57396,2765,4.6
5,47,Franklin,2015,7442,7080,362,4.9
5,49,Fulton,2015,4779,4534,245,5.1
5,51,Garland,2015,40111,37950,2161,5.4
5,53,Grant,2015,8293,7921,372,4.5
5,55,Greene,2015,20036,19012,1024,5.1
5,57,Hempstead,2015,9965,9483,482,4.8
5,59,Hot Spring,2015,14260,13552,708,5.0
5,61,Howard,2015,6110,5856,254,4.2
5,63,Independence,2015,15733,14731,1002,6.4
5,65,Izard,2015,4999,4673,326,6.5
5,67,Jackson,2015,6212,5750,462,7.4
5,69,Jefferson,2015,28882,26872,2010,7.0
5,71,Johnson,2015,10446,9854,592,5.7
5,73,Lafayette,2015,2658,2461,197,7.4
5,75,Lawrence,2015,7075,6655,420,5.9
5,77,Lee,2015,3194,2984,210,6.6
5,79,Lincoln,2015,4143,3892,251,6.1
5,81,Little River,2015,5617,5315,302,5.4
5,83,Logan,2015,9204,8682,522,5.7
5,85,Lonoke,2015,33138,31769,1369,4.1
5,87,Madison,2015,7113,6843,270,3.8
5,89,Marion,2015,6552,6217,335,5.1
5,91,Miller,2015,19993,19007,986,4.9
5,93,Mississippi,2015,18412,16774,1638,8.9
5,95,Monroe,2015,2986,2808,178,6.0
5,97,Montgomery,2015,3271,3054,217,6.6
5,99,Nevada,2015,3675,3495,180,4.9
5,101,Newton,2015,3409,3246,163,4.8
5,103,Ouachita,2015,9977,9357,620,6.2
5,105,Perry,2015,4218,3963,255,6.0
5,107,Phillips,2015,7023,6498,525,7.5
5,109,Pike,2015,4231,3987,244,5.8
5,111,Poinsett,2015,10105,9548,557,5.5
5,113,Polk,2015,8362,7887,475,5.7
5,115,Pope,2015,29886,28333,1553,5.2
5,117,Prairie,2015,3744,3571,173,4.6
5,119,Pulaski,2015,186837,178413,8424,4.5
5,121,Randolph,2015,6209,5772,437,7.0
5,123,St. Francis,2015,8992,8351,641,7.1
5,125,Saline,2015,56229,53970,2259,4.0
5,127,Scott,2015,4546,4333,213,4.7
5,129,Searcy,2015,3039,2870,169,5.6
5,131,Sebastian,2015,57971,55224,2747,4.7
5,133,Sevier,2015,5688,5348,340,6.0
5,135,Sharp,2015,6028,5618,410,6.8
5,137,Stone,2015,4723,4432,291,6.2
5,139,Union,2015,16999,15973,1026,6.0
5,141,Van Buren,2015,6453,6026,427,6.6
5,143,Washington,2015,115733,111702,4031,3.5
5,145,White,2015,34681,32557,2124,6.1
5,147,Woodruff,2015,3043,2851,192,6.3
5,149,Yell,2015,9001,8551,450,5.0
6,1,Alameda,2015,819008,779897,39111,4.8
6,3,Alpine,2015,549,508,41,7.5
6,5,Amador,2015,14317,13366,951,6.6
6,7,Butte,2015,101066,93766,7300,7.2
6,9,Calaveras,2015,20549,19231,1318,6.4
6,11,Colusa,2015,11051,9342,1709,15.5
6,13,Contra Costa,2015,544617,517048,27569,5.1
6,15,Del Norte,2015,9856,9009,847,8.6
6,17,El Dorado,2015,87892,82840,5052,5.7
6,19,Fresno,2015,440308,395174,45134,10.3
6,21,Glenn,2015,12964,11827,1137,8.8
6,23,Humboldt,2015,62290,58782,3508,5.6
6,25,Imperial,2015,76750,57864,18886,24.6
6,27,Inyo,2015,9081,8552,529,5.8
6,29,Kern,2015,390138,350050,40088,10.3
6,31,Kings,2015,57729,51628,6101,10.6
6,33,Lake,2015,29006,26790,2216,7.6
6,35,Lassen,2015,10760,9978,782,7.3
6,37,Los Angeles,2015,4973756,4641054,332702,6.7
6,39,Madera,2015,59807,53480,6327,10.6
6,41,Marin,2015,138677,133718,4959,3.6
6,43,Mariposa,2015,8011,7436,575,7.2
6,45,Mendocino,2015,39831,37500,2331,5.9
6,47,Merced,2015,114061,101031,13030,11.4
6,49,Modoc,2015,3303,3019,284,8.6
6,51,Mono,2015,8239,7731,508,6.2
6,53,Monterey,2015,218274,200452,17822,8.2
6,55,Napa,2015,73717,70290,3427,4.6
6,57,Nevada,2015,48006,45388,2618,5.5
6,59,Orange,2015,1584296,1513060,71236,4.5
6,61,Placer,2015,176339,167367,8972,5.1
6,63,Plumas,2015,7891,7076,815,10.3
6,65,Riverside,2015,1033458,963825,69633,6.7
6,67,Sacramento,2015,684577,643295,41282,6.0
6,69,San Benito,2015,29759,27495,2264,7.6
6,71,San Bernardino,2015,919308,859733,59575,6.5
6,73,San Diego,2015,1548794,1467686,81108,5.2
6,75,San Francisco/city,2015,541414,521569,19845,3.7
6,77,San Joaquin,2015,314401,286281,28120,8.9
6,79,San Luis Obispo,2015,138913,132302,6611,4.8
6,81,San Mateo,2015,434234,419310,14924,3.4
6,83,Santa Barbara,2015,217158,205591,11567,5.3
6,85,Santa Clara,2015,1012215,969950,42265,4.2
6,87,Santa Cruz,2015,143227,132434,10793,7.5
6,89,Shasta,2015,74122,68325,5797,7.8
6,91,Sierra,2015,1362,1242,120,8.8
6,93,Siskiyou,2015,17884,16199,1685,9.4
6,95,Solano,2015,204869,192237,12632,6.2
6,97,Sonoma,2015,257659,246028,11631,4.5
6,99,Stanislaus,2015,240986,217971,23015,9.6
6,101,Sutter,2015,44734,39925,4809,10.8
6,103,Tehama,2015,25019,23029,1990,8.0
6,105,Trinity,2015,5141,4739,402,7.8
6,107,Tulare,2015,202126,178491,23635,11.7
6,109,Tuolumne,2015,21532,20005,1527,7.1
6,111,Ventura,2015,427235,402977,24258,5.7
6,113,Yolo,2015,104154,97384,6770,6.5
6,115,Yuba,2015,27726,25135,2591,9.3
8,1,Adams,2015,247743,237372,10371,4.2
8,3,Alamosa,2015,7648,7267,381,5.0
8,5,Arapahoe,2015,334380,322380,12000,3.6
8,7,Archuleta,2015,6011,5777,234,3.9
8,9,Baca,2015,1971,1932,39,2.0
8,11,Bent,2015,1732,1666,66,3.8
8,13,Boulder,2015,176818,171415,5403,3.1
8,14,Broomfield/city,2015,35546,34415,1131,3.2
8,15,Chaffee,2015,8494,8215,279,3.3
8,17,Cheyenne,2015,1011,985,26,2.6
8,19,Clear Creek,2015,5545,5349,196,3.5
8,21,Conejos,2015,3596,3398,198,5.5
8,23,Costilla,2015,1621,1521,100,6.2
8,25,Crowley,2015,1353,1295,58,4.3
8,27,Custer,2015,1988,1921,67,3.4
8,29,Delta,2015,13432,12693,739,5.5
8,31,Denver/city,2015,375631,362250,13381,3.6
8,33,Dolores,2015,1323,1283,40,3.0
8,35,Douglas,2015,172204,167066,5138,3.0
8,37,Eagle,2015,32755,31765,990,3.0
8,39,Elbert,2015,13264,12862,402,3.0
8,41,El Paso,2015,307595,293988,13607,4.4
8,43,Fremont,2015,14489,13627,862,5.9
8,45,Garfield,2015,30462,29247,1215,4.0
8,47,Gilpin,2015,3399,3297,102,3.0
8,49,Grand,2015,9056,8775,281,3.1
8,51,Gunnison,2015,9793,9515,278,2.8
8,53,Hinsdale,2015,440,427,13,3.0
8,55,Huerfano,2015,2366,2190,176,7.4
8,57,Jackson,2015,834,804,30,3.6
8,59,Jefferson,2015,308899,298400,10499,3.4
8,61,Kiowa,2015,791,771,20,2.5
8,63,Kit Carson,2015,4322,4222,100,2.3
8,65,Lake,2015,4567,4397,170,3.7
8,67,La Plata,2015,29862,28871,991,3.3
8,69,Larimer,2015,180622,174867,5755,3.2
8,71,Las Animas,2015,6124,5793,331,5.4
8,73,Lincoln,2015,2169,2098,71,3.3
8,75,Logan,2015,10935,10614,321,2.9
8,77,Mesa,2015,71758,67929,3829,5.3
8,79,Mineral,2015,444,429,15,3.4
8,81,Moffat,2015,7104,6793,311,4.4
8,83,Montezuma,2015,12330,11655,675,5.5
8,85,Montrose,2015,19319,18379,940,4.9
8,87,Morgan,2015,14669,14132,537,3.7
8,89,Otero,2015,7877,7437,440,5.6
8,91,Ouray,2015,2154,2064,90,4.2
8,93,Park,2015,9370,9060,310,3.3
8,95,Phillips,2015,2358,2304,54,2.3
8,97,Pitkin,2015,10737,10337,400,3.7
8,99,Prowers,2015,5812,5586,226,3.9
8,101,Pueblo,2015,71657,67755,3902,5.4
8,103,Rio Blanco,2015,2805,2663,142,5.1
8,105,Rio Grande,2015,4861,4566,295,6.1
8,107,Routt,2015,14282,13835,447,3.1
8,109,Saguache,2015,3075,2893,182,5.9
8,111,San Juan,2015,470,451,19,4.0
8,113,San Miguel,2015,5073,4888,185,3.6
8,115,Sedgwick,2015,1146,1109,37,3.2
8,117,Summit,2015,20570,20070,500,2.4
8,119,Teller,2015,11402,10912,490,4.3
8,121,Washington,2015,2786,2717,69,2.5
8,123,Weld,2015,147778,142298,5480,3.7
8,125,Yuma,2015,5133,5004,129,2.5
9,1,Fairfield,2015,478977,453714,25263,5.3
9,3,Hartford,2015,474837,447501,27336,5.8
9,5,Litchfield,2015,105269,99923,5346,5.1
9,7,Middlesex,2015,92375,87903,4472,4.8
9,9,New Haven,2015,456464,428594,27870,6.1
9,11,New London,2015,136378,128424,7954,5.8
9,13,Tolland,2015,85230,81081,4149,4.9
9,15,Windham,2015,62556,58647,3909,6.2
10,1,Kent,2015,75799,71772,4027,5.3
10,3,New Castle,2015,289489,276051,13438,4.6
10,5,Sussex,2015,97463,92732,4731,4.9
11,1,District of Colu,2015,388446,361556,26890,6.9
12,1,Alachua,2015,129993,123941,6052,4.7
12,3,Baker,2015,11217,10584,633,5.6
12,5,Bay,2015,87884,83026,4858,5.5
12,7,Bradford,2015,10786,10260,526,4.9
12,9,Brevard,2015,257457,241882,15575,6.0
12,11,Broward,2015,992033,940668,51365,5.2
12,13,Calhoun,2015,4960,4654,306,6.2
12,15,Charlotte,2015,67928,63810,4118,6.1
12,17,Citrus,2015,48006,44364,3642,7.6
12,19,Clay,2015,98837,93804,5033,5.1
12,21,Collier,2015,164330,155607,8723,5.3
12,23,Columbia,2015,29089,27474,1615,5.6
12,27,DeSoto,2015,13431,12643,788,5.9
12,29,Dixie,2015,5609,5256,353,6.3
12,31,Duval,2015,462381,435287,27094,5.9
12,33,Escambia,2015,138671,130843,7828,5.6
12,35,Flagler,2015,43845,41064,2781,6.3
12,37,Franklin,2015,4791,4563,228,4.8
12,39,Gadsden,2015,18285,16957,1328,7.3
12,41,Gilchrist,2015,6524,6151,373,5.7
12,43,Glades,2015,4729,4388,341,7.2
12,45,Gulf,2015,6019,5699,320,5.3
12,47,Hamilton,2015,4540,4243,297,6.5
12,49,Hardee,2015,10131,9416,715,7.1
12,51,Hendry,2015,15162,13535,1627,10.7
12,53,Hernando,2015,66373,61707,4666,7.0
12,55,Highlands,2015,35485,32799,2686,7.6
12,57,Hillsborough,2015,692032,656690,35342,5.1
12,59,Holmes,2015,6718,6301,417,6.2
12,61,Indian River,2015,61460,57212,4248,6.9
12,63,Jackson,2015,17379,16345,1034,5.9
12,65,Jefferson,2015,5395,5071,324,6.0
12,67,Lafayette,2015,3217,3068,149,4.6
12,69,Lake,2015,141343,133475,7868,5.6
12,71,Lee,2015,320586,303892,16694,5.2
12,73,Leon,2015,148125,140607,7518,5.1
12,75,Levy,2015,16510,15547,963,5.8
12,77,Liberty,2015,2648,2491,157,5.9
12,79,Madison,2015,7504,7039,465,6.2
12,81,Manatee,2015,165527,157051,8476,5.1
12,83,Marion,2015,130698,122131,8567,6.6
12,85,Martin,2015,69769,65987,3782,5.4
12,86,Miami-Dade,2015,1295273,1215857,79416,6.1
12,87,Monroe,2015,45948,44332,1616,3.5
12,89,Nassau,2015,36703,34798,1905,5.2
12,91,Okaloosa,2015,92079,87870,4209,4.6
12,93,Okeechobee,2015,17318,16216,1102,6.4
12,95,Orange,2015,688737,653788,34949,5.1
12,97,Osceola,2015,157892,148689,9203,5.8
12,99,Palm Beach,2015,693582,657771,35811,5.2
12,101,Pasco,2015,216242,203402,12840,5.9
12,103,Pinellas,2015,472466,448842,23624,5.0
12,105,Polk,2015,281059,263119,17940,6.4
12,107,Putnam,2015,27376,25266,2110,7.7
12,109,St. Johns,2015,113798,109271,4527,4.0
12,111,St. Lucie,2015,131823,123346,8477,6.4
12,113,Santa Rosa,2015,74246,70622,3624,4.9
12,115,Sarasota,2015,178504,169363,9141,5.1
12,117,Seminole,2015,237549,225741,11808,5.0
12,119,Sumter,2015,28750,26518,2232,7.8
12,121,Suwannee,2015,18005,17014,991,5.5
12,123,Taylor,2015,9015,8404,611,6.8
12,125,Union,2015,4753,4520,233,4.9
12,127,Volusia,2015,239604,225449,14155,5.9
12,129,Wakulla,2015,14013,13353,660,4.7
12,131,Walton,2015,27949,26623,1326,4.7
12,133,Washington,2015,9648,9068,580,6.0
13,1,Appling,2015,8578,7940,638,7.4
13,3,Atkinson,2015,3821,3598,223,5.8
13,5,Bacon,2015,4840,4557,283,5.8
13,7,Baker,2015,1111,1029,82,7.4
13,9,Baldwin,2015,17554,16186,1368,7.8
13,11,Banks,2015,8127,7666,461,5.7
13,13,Barrow,2015,35704,33793,1911,5.4
13,15,Bartow,2015,46322,43548,2774,6.0
13,17,Ben Hill,2015,5418,4922,496,9.2
13,19,Berrien,2015,6966,6458,508,7.3
13,21,Bibb,2015,67167,62617,4550,6.8
13,23,Bleckley,2015,4323,3948,375,8.7
13,25,Brantley,2015,6830,6311,519,7.6
13,27,Brooks,2015,6805,6386,419,6.2
13,29,Bryan,2015,15962,15109,853,5.3
13,31,Bulloch,2015,34344,32226,2118,6.2
13,33,Burke,2015,9031,8285,746,8.3
13,35,Butts,2015,10012,9335,677,6.8
13,37,Calhoun,2015,2105,1972,133,6.3
13,39,Camden,2015,22048,20804,1244,5.6
13,43,Candler,2015,4910,4626,284,5.8
13,45,Carroll,2015,51208,47706,3502,6.8
13,47,Catoosa,2015,31012,29364,1648,5.3
13,49,Charlton,2015,4713,4407,306,6.5
13,51,Chatham,2015,131745,123904,7841,6.0
13,53,Chattahoochee,2015,2087,1901,186,8.9
13,55,Chattooga,2015,10432,9777,655,6.3
13,57,Cherokee,2015,118953,113293,5660,4.8
13,59,Clarke,2015,56485,52987,3498,6.2
13,61,Clay,2015,851,749,102,12.0
13,63,Clayton,2015,124988,115296,9692,7.8
13,65,Clinch,2015,2742,2546,196,7.1
13,67,Cobb,2015,393682,373383,20299,5.2
13,69,Coffee,2015,17096,15926,1170,6.8
13,71,Colquitt,2015,19823,18535,1288,6.5
13,73,Columbia,2015,67851,64390,3461,5.1
13,75,Cook,2015,7206,6716,490,6.8
13,77,Coweta,2015,67073,63448,3625,5.4
13,79,Crawford,2015,5514,5160,354,6.4
13,81,Crisp,2015,9320,8671,649,7.0
13,83,Dade,2015,7761,7329,432,5.6
13,85,Dawson,2015,10818,10256,562,5.2
13,87,Decatur,2015,11265,10486,779,6.9
13,89,DeKalb,2015,368863,346210,22653,6.1
13,91,Dodge,2015,6881,6295,586,8.5
13,93,Dooly,2015,4705,4344,361,7.7
13,95,Dougherty,2015,37460,34519,2941,7.9
13,97,Douglas,2015,67568,63209,4359,6.5
13,99,Early,2015,4309,4005,304,7.1
13,101,Echols,2015,1844,1756,88,4.8
13,103,Effingham,2015,26854,25458,1396,5.2
13,105,Elbert,2015,7529,6960,569,7.6
13,107,Emanuel,2015,8227,7495,732,8.9
13,109,Evans,2015,4610,4348,262,5.7
13,111,Fannin,2015,9999,9369,630,6.3
13,113,Fayette,2015,53538,50712,2826,5.3
13,115,Floyd,2015,42497,39611,2886,6.8
13,117,Forsyth,2015,103197,98435,4762,4.6
13,119,Franklin,2015,9180,8594,586,6.4
13,121,Fulton,2015,508815,477884,30931,6.1
13,123,Gilmer,2015,11589,10877,712,6.1
13,125,Glascock,2015,1219,1137,82,6.7
13,127,Glynn,2015,37264,34962,2302,6.2
13,129,Gordon,2015,25856,24302,1554,6.0
13,131,Grady,2015,10304,9673,631,6.1
13,133,Greene,2015,6751,6296,455,6.7
13,135,Gwinnett,2015,447227,423631,23596,5.3
13,137,Habersham,2015,18602,17519,1083,5.8
13,139,Hall,2015,91705,87171,4534,4.9
13,141,Hancock,2015,2461,2216,245,10.0
13,143,Haralson,2015,11736,10955,781,6.7
13,145,Harris,2015,15520,14692,828,5.3
13,147,Hart,2015,10284,9635,649,6.3
13,149,Heard,2015,4856,4539,317,6.5
13,151,Henry,2015,103843,97333,6510,6.3
13,153,Houston,2015,64936,61086,3850,5.9
13,155,Irwin,2015,3100,2836,264,8.5
13,157,Jackson,2015,30386,28890,1496,4.9
13,159,Jasper,2015,6367,6010,357,5.6
13,161,Jeff Davis,2015,6272,5847,425,6.8
13,163,Jefferson,2015,6298,5719,579,9.2
13,165,Jenkins,2015,3071,2811,260,8.5
13,167,Johnson,2015,3829,3556,273,7.1
13,169,Jones,2015,13322,12574,748,5.6
13,171,Lamar,2015,7597,7003,594,7.8
13,173,Lanier,2015,3740,3486,254,6.8
13,175,Laurens,2015,18434,17018,1416,7.7
13,177,Lee,2015,13967,13211,756,5.4
13,179,Liberty,2015,24690,23103,1587,6.4
13,181,Lincoln,2015,3327,3099,228,6.9
13,183,Long,2015,7005,6587,418,6.0
13,185,Lowndes,2015,49790,46796,2994,6.0
13,187,Lumpkin,2015,15145,14312,833,5.5
13,189,McDuffie,2015,8690,7954,736,8.5
13,191,McIntosh,2015,5753,5373,380,6.6
13,193,Macon,2015,4567,4140,427,9.3
13,195,Madison,2015,12481,11776,705,5.6
13,197,Marion,2015,3407,3115,292,8.6
13,199,Meriwether,2015,8576,7877,699,8.2
13,201,Miller,2015,2639,2494,145,5.5
13,205,Mitchell,2015,8619,8029,590,6.8
13,207,Monroe,2015,12526,11784,742,5.9
13,209,Montgomery,2015,3671,3347,324,8.8
13,211,Morgan,2015,8324,7860,464,5.6
13,213,Murray,2015,15891,14700,1191,7.5
13,215,Muscogee,2015,78024,72100,5924,7.6
13,217,Newton,2015,47891,44597,3294,6.9
13,219,Oconee,2015,17385,16602,783,4.5
13,221,Oglethorpe,2015,6650,6275,375,5.6
13,223,Paulding,2015,75454,71460,3994,5.3
13,225,Peach,2015,11163,10263,900,8.1
13,227,Pickens,2015,13716,12972,744,5.4
13,229,Pierce,2015,7954,7449,505,6.3
13,231,Pike,2015,8134,7660,474,5.8
13,233,Polk,2015,17945,16736,1209,6.7
13,235,Pulaski,2015,3968,3702,266,6.7
13,237,Putnam,2015,7716,7082,634,8.2
13,239,Quitman,2015,807,751,56,6.9
13,241,Rabun,2015,6430,5991,439,6.8
13,243,Randolph,2015,2399,2177,222,9.3
13,245,Richmond,2015,83351,77071,6280,7.5
13,247,Rockdale,2015,41793,39019,2774,6.6
13,249,Schley,2015,2086,1945,141,6.8
13,251,Screven,2015,4986,4564,422,8.5
13,253,Seminole,2015,3057,2805,252,8.2
13,255,Spalding,2015,26814,24620,2194,8.2
13,257,Stephens,2015,10739,10025,714,6.6
13,259,Stewart,2015,2091,1944,147,7.0
13,261,Sumter,2015,12692,11618,1074,8.5
13,263,Talbot,2015,2667,2457,210,7.9
13,265,Taliaferro,2015,587,540,47,8.0
13,267,Tattnall,2015,9171,8596,575,6.3
13,269,Taylor,2015,2743,2487,256,9.3
13,271,Telfair,2015,4772,4350,422,8.8
13,273,Terrell,2015,3590,3318,272,7.6
13,275,Thomas,2015,16626,15403,1223,7.4
13,277,Tift,2015,18137,17009,1128,6.2
13,279,Toombs,2015,11735,10693,1042,8.9
13,281,Towns,2015,3873,3562,311,8.0
13,283,Treutlen,2015,2671,2440,231,8.6
13,285,Troup,2015,35191,33016,2175,6.2
13,287,Turner,2015,3157,2939,218,6.9
13,289,Twiggs,2015,2933,2661,272,9.3
13,291,Union,2015,9719,9190,529,5.4
13,293,Upson,2015,11006,10195,811,7.4
13,295,Walker,2015,29064,27298,1766,6.1
13,297,Walton,2015,41195,38928,2267,5.5
13,299,Ware,2015,14324,13375,949,6.6
13,301,Warren,2015,2610,2403,207,7.9
13,303,Washington,2015,7117,6611,506,7.1
13,305,Wayne,2015,11439,10596,843,7.4
13,307,Webster,2015,957,866,91,9.5
13,309,Wheeler,2015,1676,1491,185,11.0
13,311,White,2015,13625,12906,719,5.3
13,313,Whitfield,2015,45084,42154,2930,6.5
13,315,Wilcox,2015,2713,2496,217,8.0
13,317,Wilkes,2015,3847,3564,283,7.4
13,319,Wilkinson,2015,3563,3298,265,7.4
13,321,Worth,2015,8744,8168,576,6.6
15,1,Hawaii,2015,89418,85690,3728,4.2
15,3,Honolulu/city,2015,460605,445679,14926,3.2
15,7,Kauai,2015,35836,34485,1351,3.8
15,9,Maui,2015,84736,81762,2974,3.5
16,1,Ada,2015,217455,210124,7331,3.4
16,3,Adams,2015,1712,1591,121,7.1
16,5,Bannock,2015,41928,40372,1556,3.7
16,7,Bear Lake,2015,2832,2714,118,4.2
16,9,Benewah,2015,4031,3786,245,6.1
16,11,Bingham,2015,22072,21234,838,3.8
16,13,Blaine,2015,11839,11449,390,3.3
16,15,Boise,2015,3049,2870,179,5.9
16,17,Bonner,2015,18517,17493,1024,5.5
16,19,Bonneville,2015,51063,49414,1649,3.2
16,21,Boundary,2015,5089,4829,260,5.1
16,23,Butte,2015,1278,1224,54,4.2
16,25,Camas,2015,649,628,21,3.2
16,27,Canyon,2015,91002,86781,4221,4.6
16,29,Caribou,2015,3768,3624,144,3.8
16,31,Cassia,2015,11476,11120,356,3.1
16,33,Clark,2015,396,382,14,3.5
16,35,Clearwater,2015,3078,2848,230,7.5
16,37,Custer,2015,2127,1996,131,6.2
16,39,Elmore,2015,10745,10274,471,4.4
16,41,Franklin,2015,6461,6274,187,2.9
16,43,Fremont,2015,7185,6943,242,3.4
16,45,Gem,2015,7532,7164,368,4.9
16,47,Gooding,2015,7988,7731,257,3.2
16,49,Idaho,2015,6392,6023,369,5.8
16,51,Jefferson,2015,12484,12089,395,3.2
16,53,Jerome,2015,11347,10999,348,3.1
16,55,Kootenai,2015,71601,68225,3376,4.7
16,57,Latah,2015,19499,18875,624,3.2
16,59,Lemhi,2015,3373,3153,220,6.5
16,61,Lewis,2015,1590,1506,84,5.3
16,63,Lincoln,2015,2642,2531,111,4.2
16,65,Madison,2015,19808,19315,493,2.5
16,67,Minidoka,2015,10698,10333,365,3.4
16,69,Nez Perce,2015,20641,19932,709,3.4
16,71,Oneida,2015,2129,2059,70,3.3
16,73,Owyhee,2015,5215,4983,232,4.4
16,75,Payette,2015,11101,10589,512,4.6
16,77,Power,2015,3877,3710,167,4.3
16,79,Shoshone,2015,5115,4746,369,7.2
16,81,Teton,2015,5830,5644,186,3.2
16,83,Twin Falls,2015,39060,37719,1341,3.4
16,85,Valley,2015,4787,4514,273,5.7
16,87,Washington,2015,4563,4316,247,5.4
17,1,Adams,2015,32579,30956,1623,5.0
17,3,Alexander,2015,2297,2086,211,9.2
17,5,Bond,2015,7795,7381,414,5.3
17,7,Boone,2015,26343,24621,1722,6.5
17,9,Brown,2015,2782,2683,99,3.6
17,11,Bureau,2015,17142,16037,1105,6.4
17,13,Calhoun,2015,2345,2187,158,6.7
17,15,Carroll,2015,7950,7516,434,5.5
17,17,Cass,2015,6437,6072,365,5.7
17,19,Champaign,2015,107403,101976,5427,5.1
17,21,Christian,2015,15428,14406,1022,6.6
17,23,Clark,2015,8095,7591,504,6.2
17,25,Clay,2015,6630,6160,470,7.1
17,27,Clinton,2015,20114,19206,908,4.5
17,29,Coles,2015,24131,22667,1464,6.1
17,31,Cook,2015,2647903,2481137,166766,6.3
17,33,Crawford,2015,9649,9077,572,5.9
17,35,Cumberland,2015,5917,5605,312,5.3
17,37,DeKalb,2015,54841,51776,3065,5.6
17,39,De Witt,2015,7978,7535,443,5.6
17,41,Douglas,2015,10170,9673,497,4.9
17,43,DuPage,2015,511797,487131,24666,4.8
17,45,Edgar,2015,9448,8856,592,6.3
17,47,Edwards,2015,2950,2774,176,6.0
17,49,Effingham,2015,18448,17562,886,4.8
17,51,Fayette,2015,9718,9078,640,6.6
17,53,Ford,2015,6662,6309,353,5.3
17,55,Franklin,2015,16518,15180,1338,8.1
17,57,Fulton,2015,15813,14606,1207,7.6
17,59,Gallatin,2015,2470,2305,165,6.7
17,61,Greene,2015,6057,5685,372,6.1
17,63,Grundy,2015,25482,23690,1792,7.0
17,65,Hamilton,2015,4384,4143,241,5.5
17,67,Hancock,2015,8928,8376,552,6.2
17,69,Hardin,2015,1531,1401,130,8.5
17,71,Henderson,2015,3756,3530,226,6.0
17,73,Henry,2015,25236,23688,1548,6.1
17,75,Iroquois,2015,14778,13936,842,5.7
17,77,Jackson,2015,28680,27083,1597,5.6
17,79,Jasper,2015,4647,4357,290,6.2
17,81,Jefferson,2015,17203,16040,1163,6.8
17,83,Jersey,2015,11096,10392,704,6.3
17,85,Jo Daviess,2015,11471,10842,629,5.5
17,87,Johnson,2015,4142,3788,354,8.5
17,89,Kane,2015,268642,253171,15471,5.8
17,91,Kankakee,2015,54342,50609,3733,6.9
17,93,Kendall,2015,66247,62762,3485,5.3
17,95,Knox,2015,23245,21828,1417,6.1
17,97,Lake,2015,367278,347425,19853,5.4
17,99,LaSalle,2015,57508,53493,4015,7.0
17,101,Lawrence,2015,6155,5717,438,7.1
17,103,Lee,2015,17876,16921,955,5.3
17,105,Livingston,2015,17287,16355,932,5.4
17,107,Logan,2015,13007,12301,706,5.4
17,109,McDonough,2015,14096,13236,860,6.1
17,111,McHenry,2015,165854,156760,9094,5.5
17,113,McLean,2015,91406,87031,4375,4.8
17,115,Macon,2015,50933,47380,3553,7.0
17,117,Macoupin,2015,23092,21629,1463,6.3
17,119,Madison,2015,133247,125231,8016,6.0
17,121,Marion,2015,18125,16898,1227,6.8
17,123,Marshall,2015,5716,5336,380,6.6
17,125,Mason,2015,6620,6147,473,7.1
17,127,Massac,2015,6090,5645,445,7.3
17,129,Menard,2015,6624,6306,318,4.8
17,131,Mercer,2015,8243,7728,515,6.2
17,133,Monroe,2015,18128,17333,795,4.4
17,135,Montgomery,2015,12037,11123,914,7.6
17,137,Morgan,2015,16959,16106,853,5.0
17,139,Moultrie,2015,7386,7064,322,4.4
17,141,Ogle,2015,25947,24345,1602,6.2
17,143,Peoria,2015,90083,83891,6192,6.9
17,145,Perry,2015,8873,8239,634,7.1
17,147,Piatt,2015,8556,8135,421,4.9
17,149,Pike,2015,7628,7232,396,5.2
17,151,Pope,2015,1769,1645,124,7.0
17,153,Pulaski,2015,2093,1907,186,8.9
17,155,Putnam,2015,3046,2858,188,6.2
17,157,Randolph,2015,14329,13550,779,5.4
17,159,Richland,2015,7478,7038,440,5.9
17,161,Rock Island,2015,72708,68066,4642,6.4
17,163,St. Clair,2015,126401,118065,8336,6.6
17,165,Saline,2015,10367,9563,804,7.8
17,167,Sangamon,2015,103571,98071,5500,5.3
17,169,Schuyler,2015,3487,3283,204,5.9
17,171,Scott,2015,2556,2405,151,5.9
17,173,Shelby,2015,10261,9656,605,5.9
17,175,Stark,2015,2765,2581,184,6.7
17,177,Stephenson,2015,21576,20149,1427,6.6
17,179,Tazewell,2015,66915,62712,4203,6.3
17,181,Union,2015,7367,6800,567,7.7
17,183,Vermilion,2015,35399,32881,2518,7.1
17,185,Wabash,2015,5633,5314,319,5.7
17,187,Warren,2015,8580,8132,448,5.2
17,189,Washington,2015,9371,9016,355,3.8
17,191,Wayne,2015,7515,6996,519,6.9
17,193,White,2015,6941,6542,399,5.7
17,195,Whiteside,2015,28567,26796,1771,6.2
17,197,Will,2015,356963,334632,22331,6.3
17,199,Williamson,2015,31983,30002,1981,6.2
17,201,Winnebago,2015,142199,132206,9993,7.0
17,203,Woodford,2015,19594,18598,996,5.1
18,1,Adams,2015,16898,16257,641,3.8
18,3,Allen,2015,178004,169861,8143,4.6
18,5,Bartholomew,2015,43579,42013,1566,3.6
18,7,Benton,2015,4578,4374,204,4.5
18,9,Blackford,2015,5241,4927,314,6.0
18,11,Boone,2015,33492,32264,1228,3.7
18,13,Brown,2015,7442,7088,354,4.8
18,15,Carroll,2015,10021,9589,432,4.3
18,17,Cass,2015,17758,16947,811,4.6
18,19,Clark,2015,58777,56146,2631,4.5
18,21,Clay,2015,12365,11715,650,5.3
18,23,Clinton,2015,16917,16241,676,4.0
18,25,Crawford,2015,4914,4619,295,6.0
18,27,Daviess,2015,15695,15104,591,3.8
18,29,Dearborn,2015,25210,23925,1285,5.1
18,31,Decatur,2015,14291,13713,578,4.0
18,33,DeKalb,2015,21781,20891,890,4.1
18,35,Delaware,2015,54427,51349,3078,5.7
18,37,Dubois,2015,22673,21910,763,3.4
18,39,Elkhart,2015,104706,100665,4041,3.9
18,41,Fayette,2015,8987,8400,587,6.5
18,43,Floyd,2015,39855,38157,1698,4.3
18,45,Fountain,2015,8039,7565,474,5.9
18,47,Franklin,2015,11386,10812,574,5.0
18,49,Fulton,2015,9859,9391,468,4.7
18,51,Gibson,2015,18859,18147,712,3.8
18,53,Grant,2015,32517,30766,1751,5.4
18,55,Greene,2015,13750,12811,939,6.8
18,57,Hamilton,2015,167231,161612,5619,3.4
18,59,Hancock,2015,37367,35800,1567,4.2
18,61,Harrison,2015,19379,18496,883,4.6
18,63,Hendricks,2015,82856,79705,3151,3.8
18,65,Henry,2015,21659,20516,1143,5.3
18,67,Howard,2015,36982,35148,1834,5.0
18,69,Huntington,2015,18639,17828,811,4.4
18,71,Jackson,2015,21784,20922,862,4.0
18,73,Jasper,2015,16357,15411,946,5.8
18,75,Jay,2015,9945,9451,494,5.0
18,77,Jefferson,2015,15324,14586,738,4.8
18,79,Jennings,2015,13166,12494,672,5.1
18,81,Johnson,2015,77580,74437,3143,4.1
18,83,Knox,2015,19024,18158,866,4.6
18,85,Kosciusko,2015,40659,39016,1643,4.0
18,87,LaGrange,2015,18900,18213,687,3.6
18,89,Lake,2015,229650,214098,15552,6.8
18,91,LaPorte,2015,48508,45486,3022,6.2
18,93,Lawrence,2015,20273,18953,1320,6.5
18,95,Madison,2015,58211,54928,3283,5.6
18,97,Marion,2015,472230,448465,23765,5.0
18,99,Marshall,2015,24006,23011,995,4.1
18,101,Martin,2015,5046,4835,211,4.2
18,103,Miami,2015,15749,14934,815,5.2
18,105,Monroe,2015,67361,64069,3292,4.9
18,107,Montgomery,2015,19265,18500,765,4.0
18,109,Morgan,2015,35365,33710,1655,4.7
18,111,Newton,2015,6960,6558,402,5.8
18,113,Noble,2015,23649,22647,1002,4.2
18,115,Ohio,2015,3177,3003,174,5.5
18,117,Orange,2015,8724,8206,518,5.9
18,119,Owen,2015,9283,8701,582,6.3
18,121,Parke,2015,7051,6655,396,5.6
18,123,Perry,2015,9230,8798,432,4.7
18,125,Pike,2015,6188,5920,268,4.3
18,127,Porter,2015,84689,80174,4515,5.3
18,129,Posey,2015,13299,12774,525,3.9
18,131,Pulaski,2015,6273,5991,282,4.5
18,133,Putnam,2015,16398,15566,832,5.1
18,135,Randolph,2015,12683,12059,624,4.9
18,137,Ripley,2015,13631,12905,726,5.3
18,139,Rush,2015,8837,8457,380,4.3
18,141,St. Joseph,2015,130384,123868,6516,5.0
18,143,Scott,2015,10266,9709,557,5.4
18,145,Shelby,2015,22623,21623,1000,4.4
18,147,Spencer,2015,10973,10522,451,4.1
18,149,Starke,2015,10546,9923,623,5.9
18,151,Steuben,2015,19979,19203,776,3.9
18,153,Sullivan,2015,8655,8119,536,6.2
18,155,Switzerland,2015,4853,4614,239,4.9
18,157,Tippecanoe,2015,93108,89182,3926,4.2
18,159,Tipton,2015,8380,8047,333,4.0
18,161,Union,2015,3560,3402,158,4.4
18,163,Vanderburgh,2015,92229,88320,3909,4.2
18,165,Vermillion,2015,7224,6713,511,7.1
18,167,Vigo,2015,48977,45990,2987,6.1
18,169,Wabash,2015,15385,14653,732,4.8
18,171,Warren,2015,4097,3895,202,4.9
18,173,Warrick,2015,31751,30469,1282,4.0
18,175,Washington,2015,13501,12804,697,5.2
18,177,Wayne,2015,30641,29022,1619,5.3
18,179,Wells,2015,14035,13489,546,3.9
18,181,White,2015,13609,13059,550,4.0
18,183,Whitley,2015,17016,16322,694,4.1
19,1,Adair,2015,4224,4089,135,3.2
19,3,Adams,2015,2289,2226,63,2.8
19,5,Allamakee,2015,7697,7325,372,4.8
19,7,Appanoose,2015,6220,5919,301,4.8
19,9,Audubon,2015,3237,3110,127,3.9
19,11,Benton,2015,13769,13239,530,3.8
19,13,Black Hawk,2015,70483,67292,3191,4.5
19,15,Boone,2015,15313,14855,458,3.0
19,17,Bremer,2015,13969,13483,486,3.5
19,19,Buchanan,2015,11313,10836,477,4.2
19,21,Buena Vista,2015,11582,11163,419,3.6
19,23,Butler,2015,8279,7920,359,4.3
19,25,Calhoun,2015,4455,4265,190,4.3
19,27,Carroll,2015,11304,11011,293,2.6
19,29,Cass,2015,7457,7189,268,3.6
19,31,Cedar,2015,10985,10612,373,3.4
19,33,Cerro Gordo,2015,23007,22107,900,3.9
19,35,Cherokee,2015,6340,6015,325,5.1
19,37,Chickasaw,2015,6455,6167,288,4.5
19,39,Clarke,2015,4768,4575,193,4.0
19,41,Clay,2015,8850,8533,317,3.6
19,43,Clayton,2015,10290,9868,422,4.1
19,45,Clinton,2015,24428,23219,1209,4.9
19,47,Crawford,2015,8749,8386,363,4.1
19,49,Dallas,2015,43682,42443,1239,2.8
19,51,Davis,2015,4176,3992,184,4.4
19,53,Decatur,2015,4429,4285,144,3.3
19,55,Delaware,2015,10684,10327,357,3.3
19,57,Des Moines,2015,20514,19555,959,4.7
19,59,Dickinson,2015,10209,9816,393,3.8
19,61,Dubuque,2015,55719,53699,2020,3.6
19,63,Emmet,2015,5664,5455,209,3.7
19,65,Fayette,2015,10812,10327,485,4.5
19,67,Floyd,2015,8700,8375,325,3.7
19,69,Franklin,2015,5958,5760,198,3.3
19,71,Fremont,2015,4149,4013,136,3.3
19,73,Greene,2015,5570,5376,194,3.5
19,75,Grundy,2015,6732,6479,253,3.8
19,77,Guthrie,2015,5622,5412,210,3.7
19,79,Hamilton,2015,7228,6924,304,4.2
19,81,Hancock,2015,6367,6196,171,2.7
19,83,Hardin,2015,8815,8470,345,3.9
19,85,Harrison,2015,7538,7285,253,3.4
19,87,Henry,2015,9597,9225,372,3.9
19,89,Howard,2015,5376,5185,191,3.6
19,91,Humboldt,2015,5343,5167,176,3.3
19,93,Ida,2015,3961,3839,122,3.1
19,95,Iowa,2015,10383,10022,361,3.5
19,97,Jackson,2015,11165,10700,465,4.2
19,99,Jasper,2015,19105,18371,734,3.8
19,101,Jefferson,2015,9151,8803,348,3.8
19,103,Johnson,2015,83898,81684,2214,2.6
19,105,Jones,2015,10781,10335,446,4.1
19,107,Keokuk,2015,5424,5195,229,4.2
19,109,Kossuth,2015,8835,8585,250,2.8
19,111,Lee,2015,18265,17293,972,5.3
19,113,Linn,2015,120196,115687,4509,3.8
19,115,Louisa,2015,6025,5799,226,3.8
19,117,Lucas,2015,4402,4248,154,3.5
19,119,Lyon,2015,7064,6924,140,2.0
19,121,Madison,2015,8235,7916,319,3.9
19,123,Mahaska,2015,11836,11372,464,3.9
19,125,Marion,2015,17435,16870,565,3.2
19,127,Marshall,2015,19435,18459,976,5.0
19,129,Mills,2015,7425,7125,300,4.0
19,131,Mitchell,2015,5596,5440,156,2.8
19,133,Monona,2015,4762,4555,207,4.3
19,135,Monroe,2015,4038,3860,178,4.4
19,137,Montgomery,2015,5171,4989,182,3.5
19,139,Muscatine,2015,22214,21364,850,3.8
19,141,O'Brien,2015,8432,8196,236,2.8
19,143,Osceola,2015,3545,3445,100,2.8
19,145,Page,2015,6570,6301,269,4.1
19,147,Palo Alto,2015,4865,4716,149,3.1
19,149,Plymouth,2015,14793,14380,413,2.8
19,151,Pocahontas,2015,4311,4181,130,3.0
19,153,Polk,2015,255669,246352,9317,3.6
19,155,Pottawattamie,2015,49001,47227,1774,3.6
19,157,Poweshiek,2015,10510,10134,376,3.6
19,159,Ringgold,2015,2567,2482,85,3.3
19,161,Sac,2015,5642,5456,186,3.3
19,163,Scott,2015,87907,83842,4065,4.6
19,165,Shelby,2015,7020,6821,199,2.8
19,167,Sioux,2015,20763,20258,505,2.4
19,169,Story,2015,57440,56019,1421,2.5
19,171,Tama,2015,9668,9251,417,4.3
19,173,Taylor,2015,3240,3138,102,3.1
19,175,Union,2015,6576,6304,272,4.1
19,177,Van Buren,2015,3841,3687,154,4.0
19,179,Wapello,2015,18008,17090,918,5.1
19,181,Warren,2015,26711,25805,906,3.4
19,183,Washington,2015,12392,12009,383,3.1
19,185,Wayne,2015,2850,2739,111,3.9
19,187,Webster,2015,20353,19483,870,4.3
19,189,Winnebago,2015,5170,4967,203,3.9
19,191,Winneshiek,2015,12229,11785,444,3.6
19,193,Woodbury,2015,56200,54099,2101,3.7
19,195,Worth,2015,4228,4061,167,3.9
19,197,Wright,2015,6908,6641,267,3.9
20,1,Allen,2015,6623,6284,339,5.1
20,3,Anderson,2015,4144,3945,199,4.8
20,5,Atchison,2015,7490,7031,459,6.1
20,7,Barber,2015,2669,2556,113,4.2
20,9,Barton,2015,14629,14013,616,4.2
20,11,Bourbon,2015,7138,6796,342,4.8
20,13,Brown,2015,5370,5156,214,4.0
20,15,Butler,2015,32119,30752,1367,4.3
20,17,Chase,2015,1255,1210,45,3.6
20,19,Chautauqua,2015,1556,1467,89,5.7
20,21,Cherokee,2015,10441,9978,463,4.4
20,23,Cheyenne,2015,1361,1324,37,2.7
20,25,Clark,2015,1162,1134,28,2.4
20,27,Clay,2015,4128,3951,177,4.3
20,29,Cloud,2015,4323,4159,164,3.8
20,31,Coffey,2015,4753,4482,271,5.7
20,33,Comanche,2015,994,961,33,3.3
20,35,Cowley,2015,17088,16307,781,4.6
20,37,Crawford,2015,18978,18012,966,5.1
20,39,Decatur,2015,1354,1305,49,3.6
20,41,Dickinson,2015,9545,9052,493,5.2
20,43,Doniphan,2015,4330,4143,187,4.3
20,45,Douglas,2015,64936,62542,2394,3.7
20,47,Edwards,2015,1754,1701,53,3.0
20,49,Elk,2015,1283,1222,61,4.8
20,51,Ellis,2015,17569,17044,525,3.0
20,53,Ellsworth,2015,2946,2838,108,3.7
20,55,Finney,2015,20184,19473,711,3.5
20,57,Ford,2015,18110,17495,615,3.4
20,59,Franklin,2015,14139,13493,646,4.6
20,61,Geary,2015,12142,11391,751,6.2
20,63,Gove,2015,1490,1453,37,2.5
20,65,Graham,2015,1276,1225,51,4.0
20,67,Grant,2015,3913,3773,140,3.6
20,69,Gray,2015,3610,3527,83,2.3
20,71,Greeley,2015,937,917,20,2.1
20,73,Greenwood,2015,3298,3147,151,4.6
20,75,Hamilton,2015,1657,1624,33,2.0
20,77,Harper,2015,2863,2752,111,3.9
20,79,Harvey,2015,17254,16582,672,3.9
20,81,Haskell,2015,2365,2306,59,2.5
20,83,Hodgeman,2015,1030,998,32,3.1
20,85,Jackson,2015,7259,6990,269,3.7
20,87,Jefferson,2015,10214,9787,427,4.2
20,89,Jewell,2015,1378,1318,60,4.4
20,91,Johnson,2015,325565,314557,11008,3.4
20,93,Kearny,2015,2154,2086,68,3.2
20,95,Kingman,2015,3659,3500,159,4.3
20,97,Kiowa,2015,1452,1409,43,3.0
20,99,Labette,2015,10782,10164,618,5.7
20,101,Lane,2015,880,851,29,3.3
20,103,Leavenworth,2015,35366,33776,1590,4.5
20,105,Lincoln,2015,1802,1740,62,3.4
20,107,Linn,2015,4340,4062,278,6.4
20,109,Logan,2015,1760,1717,43,2.4
20,111,Lyon,2015,16682,15966,716,4.3
20,113,McPherson,2015,17228,16714,514,3.0
20,115,Marion,2015,6178,5945,233,3.8
20,117,Marshall,2015,5751,5583,168,2.9
20,119,Meade,2015,2425,2353,72,3.0
20,121,Miami,2015,16802,16075,727,4.3
20,123,Mitchell,2015,3785,3660,125,3.3
20,125,Montgomery,2015,16619,15548,1071,6.4
20,127,Morris,2015,3112,2979,133,4.3
20,129,Morton,2015,1439,1379,60,4.2
20,131,Nemaha,2015,5955,5803,152,2.6
20,133,Neosho,2015,6285,5818,467,7.4
20,135,Ness,2015,1542,1491,51,3.3
20,137,Norton,2015,2957,2884,73,2.5
20,139,Osage,2015,8078,7676,402,5.0
20,141,Osborne,2015,2096,2023,73,3.5
20,143,Ottawa,2015,3238,3116,122,3.8
20,145,Pawnee,2015,3316,3193,123,3.7
20,147,Phillips,2015,2962,2867,95,3.2
20,149,Pottawatomie,2015,11987,11550,437,3.6
20,151,Pratt,2015,5305,5091,214,4.0
20,153,Rawlins,2015,1539,1504,35,2.3
20,155,Reno,2015,30925,29594,1331,4.3
20,157,Republic,2015,2597,2526,71,2.7
20,159,Rice,2015,5492,5285,207,3.8
20,161,Riley,2015,35727,34508,1219,3.4
20,163,Rooks,2015,2817,2688,129,4.6
20,165,Rush,2015,1800,1737,63,3.5
20,167,Russell,2015,3744,3604,140,3.7
20,169,Saline,2015,30954,29791,1163,3.8
20,171,Scott,2015,2893,2813,80,2.8
20,173,Sedgwick,2015,247439,235654,11785,4.8
20,175,Seward,2015,10651,10193,458,4.3
20,177,Shawnee,2015,91478,87603,3875,4.2
20,179,Sheridan,2015,1486,1453,33,2.2
20,181,Sherman,2015,3099,3009,90,2.9
20,183,Smith,2015,2099,2018,81,3.9
20,185,Stafford,2015,2189,2101,88,4.0
20,187,Stanton,2015,1064,1032,32,3.0
20,189,Stevens,2015,3187,3068,119,3.7
20,191,Sumner,2015,11109,10615,494,4.4
20,193,Thomas,2015,4427,4310,117,2.6
20,195,Trego,2015,1513,1460,53,3.5
20,197,Wabaunsee,2015,3742,3598,144,3.8
20,199,Wallace,2015,879,855,24,2.7
20,201,Washington,2015,3137,3039,98,3.1
20,203,Wichita,2015,1258,1221,37,2.9
20,205,Wilson,2015,4019,3755,264,6.6
20,207,Woodson,2015,1615,1534,81,5.0
20,209,Wyandotte,2015,76349,71773,4576,6.0
21,1,Adair,2015,7219,6707,512,7.1
21,3,Allen,2015,8668,8250,418,4.8
21,5,Anderson,2015,11339,10877,462,4.1
21,7,Ballard,2015,3600,3355,245,6.8
21,9,Barren,2015,18429,17486,943,5.1
21,11,Bath,2015,4684,4327,357,7.6
21,13,Bell,2015,8719,7979,740,8.5
21,15,Boone,2015,65619,62983,2636,4.0
21,17,Bourbon,2015,9742,9288,454,4.7
21,19,Boyd,2015,18300,17058,1242,6.8
21,21,Boyle,2015,12015,11358,657,5.5
21,23,Bracken,2015,3723,3492,231,6.2
21,25,Breathitt,2015,3814,3443,371,9.7
21,27,Breckinridge,2015,7651,7185,466,6.1
21,29,Bullitt,2015,39420,37652,1768,4.5
21,31,Butler,2015,5092,4795,297,5.8
21,33,Caldwell,2015,5299,5006,293,5.5
21,35,Calloway,2015,18544,17693,851,4.6
21,37,Campbell,2015,47793,45840,1953,4.1
21,39,Carlisle,2015,2226,2096,130,5.8
21,41,Carroll,2015,5007,4733,274,5.5
21,43,Carter,2015,9929,8937,992,10.0
21,45,Casey,2015,6504,6133,371,5.7
21,47,Christian,2015,24932,23368,1564,6.3
21,49,Clark,2015,16870,16002,868,5.1
21,51,Clay,2015,5282,4775,507,9.6
21,53,Clinton,2015,3791,3477,314,8.3
21,55,Crittenden,2015,3717,3513,204,5.5
21,57,Cumberland,2015,2866,2696,170,5.9
21,59,Daviess,2015,45598,43527,2071,4.5
21,61,Edmonson,2015,4680,4355,325,6.9
21,63,Elliott,2015,2036,1829,207,10.2
21,65,Estill,2015,5192,4874,318,6.1
21,67,Fayette,2015,167924,161561,6363,3.8
21,69,Fleming,2015,6071,5691,380,6.3
21,71,Floyd,2015,11551,10468,1083,9.4
21,73,Franklin,2015,24316,23294,1022,4.2
21,75,Fulton,2015,2062,1905,157,7.6
21,77,Gallatin,2015,3842,3646,196,5.1
21,79,Garrard,2015,7492,7109,383,5.1
21,81,Grant,2015,11085,10503,582,5.3
21,83,Graves,2015,15113,14184,929,6.1
21,85,Grayson,2015,10502,9804,698,6.6
21,87,Green,2015,4963,4701,262,5.3
21,89,Greenup,2015,13737,12703,1034,7.5
21,91,Hancock,2015,3888,3697,191,4.9
21,93,Hardin,2015,46591,44310,2281,4.9
21,95,Harlan,2015,6985,6107,878,12.6
21,97,Harrison,2015,8321,7939,382,4.6
21,99,Hart,2015,7665,7275,390,5.1
21,101,Henderson,2015,21415,20394,1021,4.8
21,103,Henry,2015,7660,7309,351,4.6
21,105,Hickman,2015,1926,1810,116,6.0
21,107,Hopkins,2015,19114,18028,1086,5.7
21,109,Jackson,2015,4188,3818,370,8.8
21,111,Jefferson,2015,377461,359625,17836,4.7
21,113,Jessamine,2015,25263,24218,1045,4.1
21,115,Johnson,2015,7158,6531,627,8.8
21,117,Kenton,2015,83262,79629,3633,4.4
21,119,Knott,2015,4709,4232,477,10.1
21,121,Knox,2015,9730,8940,790,8.1
21,123,Larue,2015,5858,5563,295,5.0
21,125,Laurel,2015,23379,21933,1446,6.2
21,127,Lawrence,2015,4969,4499,470,9.5
21,129,Lee,2015,1974,1804,170,8.6
21,131,Leslie,2015,2867,2550,317,11.1
21,133,Letcher,2015,6603,5843,760,11.5
21,135,Lewis,2015,4789,4368,421,8.8
21,137,Lincoln,2015,9031,8428,603,6.7
21,139,Livingston,2015,3678,3416,262,7.1
21,141,Logan,2015,11448,10903,545,4.8
21,143,Lyon,2015,2864,2701,163,5.7
21,145,McCracken,2015,28732,27102,1630,5.7
21,147,McCreary,2015,4633,4243,390,8.4
21,149,McLean,2015,4255,4049,206,4.8
21,151,Madison,2015,45192,43268,1924,4.3
21,153,Magoffin,2015,3322,2803,519,15.6
21,155,Marion,2015,9118,8674,444,4.9
21,157,Marshall,2015,14807,13986,821,5.5
21,159,Martin,2015,3085,2779,306,9.9
21,161,Mason,2015,7286,6842,444,6.1
21,163,Meade,2015,11785,11136,649,5.5
21,165,Menifee,2015,2353,2152,201,8.5
21,167,Mercer,2015,9675,9192,483,5.0
21,169,Metcalfe,2015,4020,3813,207,5.1
21,171,Monroe,2015,4491,4295,196,4.4
21,173,Montgomery,2015,11705,10943,762,6.5
21,175,Morgan,2015,4405,4042,363,8.2
21,177,Muhlenberg,2015,11503,10677,826,7.2
21,179,Nelson,2015,21016,19963,1053,5.0
21,181,Nicholas,2015,3175,2978,197,6.2
21,183,Ohio,2015,9307,8720,587,6.3
21,185,Oldham,2015,30938,29747,1191,3.8
21,187,Owen,2015,5370,5150,220,4.1
21,189,Owsley,2015,1137,1023,114,10.0
21,191,Pendleton,2015,6672,6321,351,5.3
21,193,Perry,2015,8799,8007,792,9.0
21,195,Pike,2015,20842,18924,1918,9.2
21,197,Powell,2015,4857,4516,341,7.0
21,199,Pulaski,2015,25444,23956,1488,5.8
21,201,Robertson,2015,781,730,51,6.5
21,203,Rockcastle,2015,6872,6438,434,6.3
21,205,Rowan,2015,10290,9685,605,5.9
21,207,Russell,2015,6140,5425,715,11.6
21,209,Scott,2015,26918,25868,1050,3.9
21,211,Shelby,2015,22897,21987,910,4.0
21,213,Simpson,2015,8322,7928,394,4.7
21,215,Spencer,2015,9258,8867,391,4.2
21,217,Taylor,2015,11773,11072,701,6.0
21,219,Todd,2015,5230,4980,250,4.8
21,221,Trigg,2015,5724,5401,323,5.6
21,223,Trimble,2015,3841,3627,214,5.6
21,225,Union,2015,6126,5716,410,6.7
21,227,Warren,2015,59464,56834,2630,4.4
21,229,Washington,2015,5954,5691,263,4.4
21,231,Wayne,2015,7028,6461,567,8.1
21,233,Webster,2015,5958,5650,308,5.2
21,235,Whitley,2015,13117,12235,882,6.7
21,237,Wolfe,2015,1908,1716,192,10.1
21,239,Woodford,2015,14375,13876,499,3.5
22,1,Acadia Parish,2015,25710,23962,1748,6.8
22,3,Allen Parish,2015,8788,8181,607,6.9
22,5,Ascension Parish,2015,61401,58319,3082,5.0
22,7,Assumption Parish,2015,9760,8997,763,7.8
22,9,Avoyelles Parish,2015,15896,14710,1186,7.5
22,11,Beauregard Parish,2015,15132,14179,953,6.3
22,13,Bienville Parish,2015,5779,5302,477,8.3
22,15,Bossier Parish,2015,57945,54695,3250,5.6
22,17,Caddo Parish,2015,109831,102042,7789,7.1
22,19,Calcasieu Parish,2015,98809,93523,5286,5.3
22,21,Caldwell Parish,2015,4010,3679,331,8.3
22,23,Cameron Parish,2015,3653,3484,169,4.6
22,25,Catahoula Parish,2015,3599,3255,344,9.6
22,27,Claiborne Parish,2015,6161,5713,448,7.3
22,29,Concordia Parish,2015,7511,6863,648,8.6
22,31,De Soto Parish,2015,11030,10158,872,7.9
22,33,East Baton Rouge Parish,2015,234153,221537,12616,5.4
22,35,East Carroll Parish,2015,2206,1897,309,14.0
22,37,East Feliciana Parish,2015,8178,7695,483,5.9
22,39,Evangeline Parish,2015,12934,11967,967,7.5
22,41,Franklin Parish,2015,7489,6768,721,9.6
22,43,Grant Parish,2015,8438,7825,613,7.3
22,45,Iberia Parish,2015,31693,29138,2555,8.1
22,47,Iberville Parish,2015,14347,13305,1042,7.3
22,49,Jackson Parish,2015,7226,6796,430,6.0
22,51,Jefferson Parish,2015,218574,206102,12472,5.7
22,53,Jefferson Davis Parish,2015,13543,12709,834,6.2
22,55,Lafayette Parish,2015,119603,112863,6740,5.6
22,57,Lafourche Parish,2015,46446,43950,2496,5.4
22,59,LaSalle Parish,2015,6580,6128,452,6.9
22,61,Lincoln Parish,2015,20974,19518,1456,6.9
22,63,Livingston Parish,2015,68016,64556,3460,5.1
22,65,Madison Parish,2015,3887,3528,359,9.2
22,67,Morehouse Parish,2015,10773,9597,1176,10.9
22,69,Natchitoches Parish,2015,16501,15256,1245,7.5
22,71,Orleans Parish,2015,181288,169564,11724,6.5
22,73,Ouachita Parish,2015,71983,67230,4753,6.6
22,75,Plaquemines Parish,2015,10286,9714,572,5.6
22,77,Pointe Coupee Parish,2015,10085,9423,662,6.6
22,79,Rapides Parish,2015,57958,54240,3718,6.4
22,81,Red River Parish,2015,3900,3632,268,6.9
22,83,Richland Parish,2015,8628,7879,749,8.7
22,85,Sabine Parish,2015,9439,8769,670,7.1
22,87,St. Bernard Parish,2015,19641,18354,1287,6.6
22,89,St. Charles Parish,2015,25511,24062,1449,5.7
22,91,St. Helena Parish,2015,4511,4104,407,9.0
22,93,St. James Parish,2015,9763,8942,821,8.4
22,95,St. John the Baptist Parish,2015,20293,18786,1507,7.4
22,97,St. Landry Parish,2015,33642,30959,2683,8.0
22,99,St. Martin Parish,2015,23980,22343,1637,6.8
22,101,St. Mary Parish,2015,24165,22338,1827,7.6
22,103,St. Tammany Parish,2015,116999,110740,6259,5.3
22,105,Tangipahoa Parish,2015,53997,50124,3873,7.2
22,107,Tensas Parish,2015,1710,1544,166,9.7
22,109,Terrebonne Parish,2015,52800,49667,3133,5.9
22,111,Union Parish,2015,9317,8655,662,7.1
22,113,Vermilion Parish,2015,25733,23959,1774,6.9
22,115,Vernon Parish,2015,17359,16019,1340,7.7
22,117,Washington Parish,2015,16974,15687,1287,7.6
22,119,Webster Parish,2015,15517,14157,1360,8.8
22,121,West Baton Rouge Parish,2015,13206,12472,734,5.6
22,123,West Carroll Parish,2015,4104,3556,548,13.4
22,125,West Feliciana Parish,2015,5384,5102,282,5.2
22,127,Winn Parish,2015,5317,4870,447,8.4
23,1,Androscoggin,2015,55166,52859,2307,4.2
23,3,Aroostook,2015,31915,30022,1893,5.9
23,5,Cumberland,2015,158956,153481,5475,3.4
23,7,Franklin,2015,14629,13932,697,4.8
23,9,Hancock,2015,29250,27616,1634,5.6
23,11,Kennebec,2015,62035,59397,2638,4.3
23,13,Knox,2015,20607,19760,847,4.1
23,15,Lincoln,2015,16835,16086,749,4.4
23,17,Oxford,2015,26707,25250,1457,5.5
23,19,Penobscot,2015,77374,73700,3674,4.7
23,21,Piscataquis,2015,7501,7087,414,5.5
23,23,Sagadahoc,2015,19058,18386,672,3.5
23,25,Somerset,2015,23789,22227,1562,6.6
23,27,Waldo,2015,20752,19669,1083,5.2
23,29,Washington,2015,14084,13183,901,6.4
23,31,York,2015,109194,104892,4302,3.9
24,1,Allegany,2015,32260,30051,2209,6.8
24,3,Anne Arundel,2015,300799,287823,12976,4.3
24,5,Baltimore,2015,444707,421631,23076,5.2
24,9,Calvert,2015,46993,44875,2118,4.5
24,11,Caroline,2015,17460,16525,935,5.4
24,13,Carroll,2015,93014,89165,3849,4.1
24,15,Cecil,2015,52545,49457,3088,5.9
24,17,Charles,2015,80471,76540,3931,4.9
24,19,Dorchester,2015,15790,14680,1110,7.0
24,21,Frederick,2015,128473,122837,5636,4.4
24,23,Garrett,2015,15627,14660,967,6.2
24,25,Harford,2015,135807,129254,6553,4.8
24,27,Howard,2015,176684,170079,6605,3.7
24,29,Kent,2015,10568,10015,553,5.2
24,31,Montgomery,2015,547229,526310,20919,3.8
24,33,Prince George's,2015,486318,461301,25017,5.1
24,35,Queen Anne's,2015,26612,25434,1178,4.4
24,37,St. Mary's,2015,54562,51964,2598,4.8
24,39,Somerset,2015,9215,8470,745,8.1
24,41,Talbot,2015,19259,18331,928,4.8
24,43,Washington,2015,76634,72415,4219,5.5
24,45,Wicomico,2015,50182,46839,3343,6.7
24,47,Worcester,2015,25423,22784,2639,10.4
24,510,Baltimore city,2015,293358,271643,21715,7.4
25,1,Barnstable,2015,111590,104779,6811,6.1
25,3,Berkshire,2015,65100,61585,3515,5.4
25,5,Bristol,2015,289838,272117,17721,6.1
25,7,Dukes,2015,9459,8841,618,6.5
25,9,Essex,2015,407752,387410,20342,5.0
25,11,Franklin,2015,39438,37710,1728,4.4
25,13,Hampden,2015,222709,208493,14216,6.4
25,15,Hampshire,2015,87374,83444,3930,4.5
25,17,Middlesex,2015,863343,829572,33771,3.9
25,19,Nantucket/town,2015,6969,6594,375,5.4
25,21,Norfolk,2015,369154,353798,15356,4.2
25,23,Plymouth,2015,268260,254734,13526,5.0
25,25,Suffolk,2015,420898,402393,18505,4.4
25,27,Worcester,2015,427528,405828,21700,5.1
26,1,Alcona,2015,3826,3515,311,8.1
26,3,Alger,2015,3246,2966,280,8.6
26,5,Allegan,2015,60755,58207,2548,4.2
26,7,Alpena,2015,13686,12820,866,6.3
26,9,Antrim,2015,10041,9282,759,7.6
26,11,Arenac,2015,6259,5691,568,9.1
26,13,Baraga,2015,3314,3008,306,9.2
26,15,Barry,2015,30360,29042,1318,4.3
26,17,Bay,2015,52464,49397,3067,5.8
26,19,Benzie,2015,8719,8103,616,7.1
26,21,Berrien,2015,73748,69862,3886,5.3
26,23,Branch,2015,19238,18243,995,5.2
26,25,Calhoun,2015,64461,61137,3324,5.2
26,27,Cass,2015,24132,22898,1234,5.1
26,29,Charlevoix,2015,13111,12311,800,6.1
26,31,Cheboygan,2015,10742,9750,992,9.2
26,33,Chippewa,2015,16776,15455,1321,7.9
26,35,Clare,2015,11841,10912,929,7.8
26,37,Clinton,2015,39927,38344,1583,4.0
26,39,Crawford,2015,5301,4880,421,7.9
26,41,Delta,2015,17327,16136,1191,6.9
26,43,Dickinson,2015,12665,11941,724,5.7
26,45,Eaton,2015,56123,53607,2516,4.5
26,47,Emmet,2015,17725,16431,1294,7.3
26,49,Genesee,2015,180129,168867,11262,6.3
26,51,Gladwin,2015,10029,9290,739,7.4
26,53,Gogebic,2015,6528,6044,484,7.4
26,55,Grand Traverse,2015,48682,46381,2301,4.7
26,57,Gratiot,2015,18382,17325,1057,5.8
26,59,Hillsdale,2015,21129,20005,1124,5.3
26,61,Houghton,2015,16648,15577,1071,6.4
26,63,Huron,2015,16444,15546,898,5.5
26,65,Ingham,2015,146506,139586,6920,4.7
26,67,Ionia,2015,29496,28131,1365,4.6
26,69,Iosco,2015,10147,9373,774,7.6
26,71,Iron,2015,5233,4859,374,7.1
26,73,Isabella,2015,35472,33747,1725,4.9
26,75,Jackson,2015,73385,69458,3927,5.4
26,77,Kalamazoo,2015,129756,124041,5715,4.4
26,79,Kalkaska,2015,7666,7070,596,7.8
26,81,Kent,2015,344072,330959,13113,3.8
26,83,Keweenaw,2015,944,856,88,9.3
26,85,Lake,2015,3698,3377,321,8.7
26,87,Lapeer,2015,39587,36768,2819,7.1
26,89,Leelanau,2015,10634,10068,566,5.3
26,91,Lenawee,2015,47701,45280,2421,5.1
26,93,Livingston,2015,96123,91736,4387,4.6
26,95,Luce,2015,2472,2297,175,7.1
26,97,Mackinac,2015,5151,4644,507,9.8
26,99,Macomb,2015,420070,396168,23902,5.7
26,101,Manistee,2015,10458,9754,704,6.7
26,103,Marquette,2015,33546,31507,2039,6.1
26,105,Mason,2015,14485,13589,896,6.2
26,107,Mecosta,2015,19235,18036,1199,6.2
26,109,Menominee,2015,11583,10951,632,5.5
26,111,Midland,2015,41628,39575,2053,4.9
26,113,Missaukee,2015,7021,6557,464,6.6
26,115,Monroe,2015,76585,73051,3534,4.6
26,117,Montcalm,2015,27820,26205,1615,5.8
26,119,Montmorency,2015,3083,2772,311,10.1
26,121,Muskegon,2015,77683,73101,4582,5.9
26,123,Newaygo,2015,23190,21906,1284,5.5
26,125,Oakland,2015,630756,601330,29426,4.7
26,127,Oceana,2015,12552,11536,1016,8.1
26,129,Ogemaw,2015,8450,7777,673,8.0
26,131,Ontonagon,2015,2306,2087,219,9.5
26,133,Osceola,2015,10210,9537,673,6.6
26,135,Oscoda,2015,2926,2669,257,8.8
26,137,Otsego,2015,11464,10751,713,6.2
26,139,Ottawa,2015,153110,147476,5634,3.7
26,141,Presque Isle,2015,5387,4831,556,10.3
26,143,Roscommon,2015,7849,7131,718,9.1
26,145,Saginaw,2015,88751,83622,5129,5.8
26,147,St. Clair,2015,72569,67674,4895,6.7
26,149,St. Joseph,2015,29179,27848,1331,4.6
26,151,Sanilac,2015,19601,18310,1291,6.6
26,153,Schoolcraft,2015,3477,3096,381,11.0
26,155,Shiawassee,2015,33167,31263,1904,5.7
26,157,Tuscola,2015,24606,22933,1673,6.8
26,159,Van Buren,2015,35409,33157,2252,6.4
26,161,Washtenaw,2015,189301,182177,7124,3.8
26,163,Wayne,2015,756308,704576,51732,6.8
26,165,Wexford,2015,14648,13647,1001,6.8
27,1,Aitkin,2015,6893,6432,461,6.7
27,3,Anoka,2015,190298,183267,7031,3.7
27,5,Becker,2015,18445,17621,824,4.5
27,7,Beltrami,2015,23565,22384,1181,5.0
27,9,Benton,2015,21644,20662,982,4.5
27,11,Big Stone,2015,2689,2567,122,4.5
27,13,Blue Earth,2015,39466,38277,1189,3.0
27,15,Brown,2015,14655,14043,612,4.2
27,17,Carlton,2015,17617,16732,885,5.0
27,19,Carver,2015,55301,53510,1791,3.2
27,21,Cass,2015,14073,13112,961,6.8
27,23,Chippewa,2015,6963,6651,312,4.5
27,25,Chisago,2015,28805,27577,1228,4.3
27,27,Clay,2015,35623,34494,1129,3.2
27,29,Clearwater,2015,4644,4214,430,9.3
27,31,Cook,2015,3162,3020,142,4.5
27,33,Cottonwood,2015,5804,5521,283,4.9
27,35,Crow Wing,2015,31582,29920,1662,5.3
27,37,Dakota,2015,232810,224956,7854,3.4
27,39,Dodge,2015,11480,11043,437,3.8
27,41,Douglas,2015,20182,19478,704,3.5
27,43,Faribault,2015,7521,7185,336,4.5
27,45,Fillmore,2015,11432,10956,476,4.2
27,47,Freeborn,2015,16383,15751,632,3.9
27,49,Goodhue,2015,26942,25974,968,3.6
27,51,Grant,2015,3355,3194,161,4.8
27,53,Hennepin,2015,678387,655614,22773,3.4
27,55,Houston,2015,10509,10100,409,3.9
27,57,Hubbard,2015,9583,8984,599,6.3
27,59,Isanti,2015,20248,19358,890,4.4
27,61,Itasca,2015,22367,20884,1483,6.6
27,63,Jackson,2015,6303,6043,260,4.1
27,65,Kanabec,2015,8861,8266,595,6.7
27,67,Kandiyohi,2015,24118,23198,920,3.8
27,69,Kittson,2015,2479,2362,117,4.7
27,71,Koochiching,2015,6276,5755,521,8.3
27,73,Lac qui Parle,2015,3773,3615,158,4.2
27,75,Lake,2015,5626,5350,276,4.9
27,77,Lake of the Woods,2015,2429,2318,111,4.6
27,79,Le Sueur,2015,15577,14811,766,4.9
27,81,Lincoln,2015,3399,3278,121,3.6
27,83,Lyon,2015,15319,14816,503,3.3
27,85,McLeod,2015,20251,19438,813,4.0
27,87,Mahnomen,2015,2413,2270,143,5.9
27,89,Marshall,2015,5761,5355,406,7.0
27,91,Martin,2015,10473,10038,435,4.2
27,93,Meeker,2015,13373,12800,573,4.3
27,95,Mille Lacs,2015,12650,11901,749,5.9
27,97,Morrison,2015,17845,16861,984,5.5
27,99,Mower,2015,20407,19738,669,3.3
27,101,Murray,2015,5075,4846,229,4.5
27,103,Nicollet,2015,20349,19801,548,2.7
27,105,Nobles,2015,11552,11174,378,3.3
27,107,Norman,2015,3450,3286,164,4.8
27,109,Olmsted,2015,84080,81573,2507,3.0
27,111,Otter Tail,2015,31194,29856,1338,4.3
27,113,Pennington,2015,9102,8626,476,5.2
27,115,Pine,2015,14825,13983,842,5.7
27,117,Pipestone,2015,4988,4818,170,3.4
27,119,Polk,2015,17208,16466,742,4.3
27,121,Pope,2015,6403,6176,227,3.5
27,123,Ramsey,2015,280242,270141,10101,3.6
27,125,Red Lake,2015,2336,2196,140,6.0
27,127,Redwood,2015,8288,7957,331,4.0
27,129,Renville,2015,8615,8192,423,4.9
27,131,Rice,2015,35507,34222,1285,3.6
27,133,Rock,2015,5920,5792,128,2.2
27,135,Roseau,2015,8623,8273,350,4.1
27,137,St. Louis,2015,102211,97018,5193,5.1
27,139,Scott,2015,79335,76799,2536,3.2
27,141,Sherburne,2015,49591,47561,2030,4.1
27,143,Sibley,2015,8530,8169,361,4.2
27,145,Stearns,2015,88340,85079,3261,3.7
27,147,Steele,2015,21251,20526,725,3.4
27,149,Stevens,2015,5721,5557,164,2.9
27,151,Swift,2015,5186,4867,319,6.2
27,153,Todd,2015,13040,12457,583,4.5
27,155,Traverse,2015,1840,1762,78,4.2
27,157,Wabasha,2015,12021,11557,464,3.9
27,159,Wadena,2015,6346,5963,383,6.0
27,161,Waseca,2015,9776,9363,413,4.2
27,163,Washington,2015,137465,133023,4442,3.2
27,165,Watonwan,2015,6268,5968,300,4.8
27,167,Wilkin,2015,3698,3573,125,3.4
27,169,Winona,2015,29540,28539,1001,3.4
27,171,Wright,2015,72151,69443,2708,3.8
27,173,Yellow Medicine,2015,5589,5379,210,3.8
28,1,Adams,2015,11380,10461,919,8.1
28,3,Alcorn,2015,15671,14777,894,5.7
28,5,Amite,2015,4501,4156,345,7.7
28,7,Attala,2015,6964,6427,537,7.7
28,9,Benton,2015,2976,2735,241,8.1
28,11,Bolivar,2015,13351,12288,1063,8.0
28,13,Calhoun,2015,6120,5737,383,6.3
28,15,Carroll,2015,3451,3164,287,8.3
28,17,Chickasaw,2015,7130,6575,555,7.8
28,19,Choctaw,2015,3700,3465,235,6.4
28,21,Claiborne,2015,3112,2716,396,12.7
28,23,Clarke,2015,6060,5577,483,8.0
28,25,Clay,2015,7997,7221,776,9.7
28,27,Coahoma,2015,9427,8466,961,10.2
28,29,Copiah,2015,11227,10405,822,7.3
28,31,Covington,2015,7941,7471,470,5.9
28,33,DeSoto,2015,84286,80182,4104,4.9
28,35,Forrest,2015,32740,30654,2086,6.4
28,37,Franklin,2015,2930,2702,228,7.8
28,39,George,2015,8831,8160,671,7.6
28,41,Greene,2015,4318,3988,330,7.6
28,43,Grenada,2015,9449,8881,568,6.0
28,45,Hancock,2015,18619,17396,1223,6.6
28,47,Harrison,2015,85384,80244,5140,6.0
28,49,Hinds,2015,108864,102227,6637,6.1
28,51,Holmes,2015,6103,5360,743,12.2
28,53,Humphreys,2015,2462,2147,315,12.8
28,55,Issaquena,2015,418,346,72,17.2
28,57,Itawamba,2015,10177,9587,590,5.8
28,59,Jackson,2015,58800,54606,4194,7.1
28,61,Jasper,2015,6345,5843,502,7.9
28,63,Jefferson,2015,2273,1930,343,15.1
28,65,Jefferson Davis,2015,4117,3753,364,8.8
28,67,Jones,2015,26470,24860,1610,6.1
28,69,Kemper,2015,3568,3194,374,10.5
28,71,Lafayette,2015,24368,23018,1350,5.5
28,73,Lamar,2015,28807,27400,1407,4.9
28,75,Lauderdale,2015,31562,29466,2096,6.6
28,77,Lawrence,2015,4732,4386,346,7.3
28,79,Leake,2015,7866,7376,490,6.2
28,81,Lee,2015,39726,37495,2231,5.6
28,83,Leflore,2015,10466,9325,1141,10.9
28,85,Lincoln,2015,14182,13310,872,6.1
28,87,Lowndes,2015,25047,23264,1783,7.1
28,89,Madison,2015,51473,49085,2388,4.6
28,91,Marion,2015,9979,9241,738,7.4
28,93,Marshall,2015,14402,13349,1053,7.3
28,95,Monroe,2015,15439,14285,1154,7.5
28,97,Montgomery,2015,4188,3859,329,7.9
28,99,Neshoba,2015,10592,9933,659,6.2
28,101,Newton,2015,8692,8152,540,6.2
28,103,Noxubee,2015,3944,3553,391,9.9
28,105,Oktibbeha,2015,22425,21034,1391,6.2
28,107,Panola,2015,13404,12222,1182,8.8
28,109,Pearl River,2015,22794,21374,1420,6.2
28,111,Perry,2015,4303,3956,347,8.1
28,113,Pike,2015,14652,13568,1084,7.4
28,115,Pontotoc,2015,13831,13050,781,5.6
28,117,Prentiss,2015,10960,10287,673,6.1
28,119,Quitman,2015,2681,2389,292,10.9
28,121,Rankin,2015,72763,69701,3062,4.2
28,123,Scott,2015,12940,12310,630,4.9
28,125,Sharkey,2015,1723,1555,168,9.8
28,127,Simpson,2015,10864,10216,648,6.0
28,129,Smith,2015,6732,6367,365,5.4
28,131,Stone,2015,6391,5911,480,7.5
28,133,Sunflower,2015,8454,7555,899,10.6
28,135,Tallahatchie,2015,5793,5350,443,7.6
28,137,Tate,2015,11960,11104,856,7.2
28,139,Tippah,2015,9410,8804,606,6.4
28,141,Tishomingo,2015,7987,7472,515,6.4
28,143,Tunica,2015,4643,4207,436,9.4
28,145,Union,2015,13168,12488,680,5.2
28,147,Walthall,2015,5135,4714,421,8.2
28,149,Warren,2015,20821,19417,1404,6.7
28,151,Washington,2015,17998,16125,1873,10.4
28,153,Wayne,2015,7599,6990,609,8.0
28,155,Webster,2015,3928,3642,286,7.3
28,157,Wilkinson,2015,2876,2567,309,10.7
28,159,Winston,2015,7065,6474,591,8.4
28,161,Yalobusha,2015,4912,4556,356,7.2
28,163,Yazoo,2015,9181,8420,761,8.3
29,1,Adair,2015,10380,9784,596,5.7
29,3,Andrew,2015,9860,9442,418,4.2
29,5,Atchison,2015,2815,2687,128,4.5
29,7,Audrain,2015,11242,10712,530,4.7
29,9,Barry,2015,14822,14066,756,5.1
29,11,Barton,2015,5295,5003,292,5.5
29,13,Bates,2015,8103,7601,502,6.2
29,15,Benton,2015,7151,6675,476,6.7
29,17,Bollinger,2015,5521,5206,315,5.7
29,19,Boone,2015,98238,94717,3521,3.6
29,21,Buchanan,2015,46208,44045,2163,4.7
29,23,Butler,2015,18866,17674,1192,6.3
29,25,Caldwell,2015,4368,4165,203,4.6
29,27,Callaway,2015,21542,20507,1035,4.8
29,29,Camden,2015,18644,17400,1244,6.7
29,31,Cape Girardeau,2015,40612,38827,1785,4.4
29,33,Carroll,2015,4789,4494,295,6.2
29,35,Carter,2015,2496,2307,189,7.6
29,37,Cass,2015,53555,50932,2623,4.9
29,39,Cedar,2015,5857,5542,315,5.4
29,41,Chariton,2015,3830,3646,184,4.8
29,43,Christian,2015,42786,40943,1843,4.3
29,45,Clark,2015,3415,3166,249,7.3
29,47,Clay,2015,131384,125297,6087,4.6
29,49,Clinton,2015,10925,10384,541,5.0
29,51,Cole,2015,39133,37538,1595,4.1
29,53,Cooper,2015,7569,7123,446,5.9
29,55,Crawford,2015,10845,10179,666,6.1
29,57,Dade,2015,3549,3364,185,5.2
29,59,Dallas,2015,6937,6497,440,6.3
29,61,Daviess,2015,4061,3872,189,4.7
29,63,DeKalb,2015,5018,4780,238,4.7
29,65,Dent,2015,6262,5890,372,5.9
29,67,Douglas,2015,5010,4663,347,6.9
29,69,Dunklin,2015,13051,11982,1069,8.2
29,71,Franklin,2015,52207,49509,2698,5.2
29,73,Gasconade,2015,7634,7304,330,4.3
29,75,Gentry,2015,3592,3438,154,4.3
29,77,Greene,2015,148369,142081,6288,4.2
29,79,Grundy,2015,4880,4674,206,4.2
29,81,Harrison,2015,3963,3758,205,5.2
29,83,Henry,2015,10050,9491,559,5.6
29,85,Hickory,2015,3700,3450,250,6.8
29,87,Holt,2015,2692,2593,99,3.7
29,89,Howard,2015,5015,4765,250,5.0
29,91,Howell,2015,16254,15189,1065,6.6
29,93,Iron,2015,3830,3521,309,8.1
29,95,Jackson,2015,360910,339191,21719,6.0
29,97,Jasper,2015,57705,55185,2520,4.4
29,99,Jefferson,2015,116938,111148,5790,5.0
29,101,Johnson,2015,22972,21711,1261,5.5
29,103,Knox,2015,1950,1873,77,3.9
29,105,Laclede,2015,15843,14817,1026,6.5
29,107,Lafayette,2015,17075,16232,843,4.9
29,109,Lawrence,2015,17773,16885,888,5.0
29,111,Lewis,2015,5181,4921,260,5.0
29,113,Lincoln,2015,26795,25383,1412,5.3
29,115,Linn,2015,5213,4840,373,7.2
29,117,Livingston,2015,7259,6944,315,4.3
29,119,McDonald,2015,10347,9847,500,4.8
29,121,Macon,2015,7425,7022,403,5.4
29,123,Madison,2015,5486,5157,329,6.0
29,125,Maries,2015,3913,3701,212,5.4
29,127,Marion,2015,14659,13995,664,4.5
29,129,Mercer,2015,1876,1791,85,4.5
29,131,Miller,2015,11584,10873,711,6.1
29,133,Mississippi,2015,6246,5877,369,5.9
29,135,Moniteau,2015,7354,6987,367,5.0
29,137,Monroe,2015,4184,3962,222,5.3
29,139,Montgomery,2015,5672,5385,287,5.1
29,141,Morgan,2015,8031,7479,552,6.9
29,143,New Madrid,2015,8531,7990,541,6.3
29,145,Newton,2015,28266,26948,1318,4.7
29,147,Nodaway,2015,10947,10399,548,5.0
29,149,Oregon,2015,4138,3871,267,6.5
29,151,Osage,2015,7114,6842,272,3.8
29,153,Ozark,2015,3628,3333,295,8.1
29,155,Pemiscot,2015,7006,6359,647,9.2
29,157,Perry,2015,10146,9711,435,4.3
29,159,Pettis,2015,20800,19684,1116,5.4
29,161,Phelps,2015,19452,18396,1056,5.4
29,163,Pike,2015,8060,7684,376,4.7
29,165,Platte,2015,55094,52734,2360,4.3
29,167,Polk,2015,14173,13410,763,5.4
29,169,Pulaski,2015,14803,13921,882,6.0
29,171,Putnam,2015,2485,2384,101,4.1
29,173,Ralls,2015,5636,5393,243,4.3
29,175,Randolph,2015,10444,9805,639,6.1
29,177,Ray,2015,11096,10478,618,5.6
29,179,Reynolds,2015,2697,2505,192,7.1
29,181,Ripley,2015,5295,4866,429,8.1
29,183,St. Charles,2015,216222,207742,8480,3.9
29,185,St. Clair,2015,3955,3675,280,7.1
29,186,Ste. Genevieve,2015,9009,8517,492,5.5
29,187,St. Francois,2015,26252,24624,1628,6.2
29,189,St. Louis,2015,530371,505340,25031,4.7
29,195,Saline,2015,10985,10445,540,4.9
29,197,Schuyler,2015,1896,1784,112,5.9
29,199,Scotland,2015,2437,2324,113,4.6
29,201,Scott,2015,19930,18866,1064,5.3
29,203,Shannon,2015,3320,3044,276,8.3
29,205,Shelby,2015,3058,2911,147,4.8
29,207,Stoddard,2015,13158,12270,888,6.7
29,209,Stone,2015,13296,12228,1068,8.0
29,211,Sullivan,2015,2763,2595,168,6.1
29,213,Taney,2015,26022,23886,2136,8.2
29,215,Texas,2015,9352,8718,634,6.8
29,217,Vernon,2015,9761,9255,506,5.2
29,219,Warren,2015,17238,16398,840,4.9
29,221,Washington,2015,10463,9747,716,6.8
29,223,Wayne,2015,5685,5344,341,6.0
29,225,Webster,2015,16553,15694,859,5.2
29,227,Worth,2015,1210,1170,40,3.3
29,229,Wright,2015,7599,7114,485,6.4
29,510,St. Louis city,2015,158810,148980,9830,6.2
30,1,Beaverhead,2015,4982,4806,176,3.5
30,3,Big Horn,2015,5555,5175,380,6.8
30,5,Blaine,2015,2398,2275,123,5.1
30,7,Broadwater,2015,2487,2357,130,5.2
30,9,Carbon,2015,5427,5222,205,3.8
30,11,Carter,2015,686,663,23,3.4
30,13,Cascade,2015,38320,36730,1590,4.1
30,15,Chouteau,2015,2525,2440,85,3.4
30,17,Custer,2015,6390,6174,216,3.4
30,19,Daniels,2015,944,919,25,2.6
30,21,Dawson,2015,4822,4666,156,3.2
30,23,Deer Lodge,2015,5238,5024,214,4.1
30,25,Fallon,2015,1970,1923,47,2.4
30,27,Fergus,2015,5704,5462,242,4.2
30,29,Flathead,2015,44861,42228,2633,5.9
30,31,Gallatin,2015,59459,57622,1837,3.1
30,33,Garfield,2015,762,740,22,2.9
30,35,Glacier,2015,5863,5323,540,9.2
30,37,Golden Valley,2015,380,364,16,4.2
30,39,Granite,2015,1562,1462,100,6.4
30,41,Hill,2015,7799,7464,335,4.3
30,43,Jefferson,2015,5585,5351,234,4.2
30,45,Judith Basin,2015,994,959,35,3.5
30,47,Lake,2015,12705,12054,651,5.1
30,49,Lewis and Clark,2015,35016,33805,1211,3.5
30,51,Liberty,2015,986,959,27,2.7
30,53,Lincoln,2015,7824,7015,809,10.3
30,55,McCone,2015,1062,1038,24,2.3
30,57,Madison,2015,4288,4129,159,3.7
30,59,Meagher,2015,936,901,35,3.7
30,61,Mineral,2015,1731,1582,149,8.6
30,63,Missoula,2015,60542,58102,2440,4.0
30,65,Musselshell,2015,2410,2304,106,4.4
30,67,Park,2015,8304,7895,409,4.9
30,69,Petroleum,2015,284,269,15,5.3
30,71,Phillips,2015,1979,1876,103,5.2
30,73,Pondera,2015,2867,2736,131,4.6
30,75,Powder River,2015,1056,1028,28,2.7
30,77,Powell,2015,2962,2827,135,4.6
30,79,Prairie,2015,529,507,22,4.2
30,81,Ravalli,2015,19235,18206,1029,5.3
30,83,Richland,2015,6881,6653,228,3.3
30,85,Roosevelt,2015,4696,4443,253,5.4
30,87,Rosebud,2015,4180,3950,230,5.5
30,89,Sanders,2015,4710,4309,401,8.5
30,91,Sheridan,2015,2075,2022,53,2.6
30,93,Silver Bow,2015,17140,16385,755,4.4
30,95,Stillwater,2015,4933,4743,190,3.9
30,97,Sweet Grass,2015,1790,1738,52,2.9
30,99,Teton,2015,2891,2777,114,3.9
30,101,Toole,2015,2299,2219,80,3.5
30,103,Treasure,2015,357,339,18,5.0
30,105,Valley,2015,4392,4250,142,3.2
30,107,Wheatland,2015,788,744,44,5.6
30,109,Wibaux,2015,546,528,18,3.3
30,111,Yellowstone,2015,80797,78046,2751,3.4
31,1,Adams,2015,16677,16157,520,3.1
31,3,Antelope,2015,3610,3517,93,2.6
31,5,Arthur,2015,225,215,10,4.4
31,7,Banner,2015,442,427,15,3.4
31,9,Blaine,2015,269,257,12,4.5
31,11,Boone,2015,3024,2950,74,2.4
31,13,Box Butte,2015,5683,5513,170,3.0
31,15,Boyd,2015,1093,1064,29,2.7
31,17,Brown,2015,1400,1348,52,3.7
31,19,Buffalo,2015,27245,26582,663,2.4
31,21,Burt,2015,3624,3493,131,3.6
31,23,Butler,2015,4757,4625,132,2.8
31,25,Cass,2015,13123,12688,435,3.3
31,27,Cedar,2015,4660,4550,110,2.4
31,29,Chase,2015,2348,2303,45,1.9
31,31,Cherry,2015,3463,3384,79,2.3
31,33,Cheyenne,2015,5770,5645,125,2.2
31,35,Clay,2015,3387,3289,98,2.9
31,37,Colfax,2015,5572,5427,145,2.6
31,39,Cuming,2015,4858,4730,128,2.6
31,41,Custer,2015,6309,6169,140,2.2
31,43,Dakota,2015,11038,10649,389,3.5
31,45,Dawes,2015,5271,5135,136,2.6
31,47,Dawson,2015,13115,12700,415,3.2
31,49,Deuel,2015,1079,1052,27,2.5
31,51,Dixon,2015,3094,2992,102,3.3
31,53,Dodge,2015,19171,18548,623,3.2
31,55,Douglas,2015,287891,278389,9502,3.3
31,57,Dundy,2015,1201,1176,25,2.1
31,59,Fillmore,2015,3221,3126,95,2.9
31,61,Franklin,2015,1517,1481,36,2.4
31,63,Frontier,2015,1538,1501,37,2.4
31,65,Furnas,2015,2739,2667,72,2.6
31,67,Gage,2015,11090,10689,401,3.6
31,69,Garden,2015,1201,1172,29,2.4
31,71,Garfield,2015,1198,1169,29,2.4
31,73,Gosper,2015,1078,1052,26,2.4
31,75,Grant,2015,437,427,10,2.3
31,77,Greeley,2015,1253,1214,39,3.1
31,79,Hall,2015,31717,30471,1246,3.9
31,81,Hamilton,2015,4690,4556,134,2.9
31,83,Harlan,2015,1793,1755,38,2.1
31,85,Hayes,2015,618,604,14,2.3
31,87,Hitchcock,2015,1326,1283,43,3.2
31,89,Holt,2015,5890,5750,140,2.4
31,91,Hooker,2015,406,389,17,4.2
31,93,Howard,2015,3322,3201,121,3.6
31,95,Jefferson,2015,4291,4175,116,2.7
31,97,Johnson,2015,2132,2062,70,3.3
31,99,Kearney,2015,3807,3723,84,2.2
31,101,Keith,2015,4702,4577,125,2.7
31,103,Keya Paha,2015,663,649,14,2.1
31,105,Kimball,2015,2059,1986,73,3.5
31,107,Knox,2015,4736,4585,151,3.2
31,109,Lancaster,2015,168174,163746,4428,2.6
31,111,Lincoln,2015,18611,18073,538,2.9
31,113,Logan,2015,495,480,15,3.0
31,115,Loup,2015,379,366,13,3.4
31,117,McPherson,2015,462,453,9,1.9
31,119,Madison,2015,19284,18757,527,2.7
31,121,Merrick,2015,4043,3893,150,3.7
31,123,Morrill,2015,2661,2585,76,2.9
31,125,Nance,2015,2073,2022,51,2.5
31,127,Nemaha,2015,3704,3569,135,3.6
31,129,Nuckolls,2015,2391,2330,61,2.6
31,131,Otoe,2015,8232,7961,271,3.3
31,133,Pawnee,2015,1678,1635,43,2.6
31,135,Perkins,2015,1842,1808,34,1.8
31,137,Phelps,2015,5013,4893,120,2.4
31,139,Pierce,2015,4183,4077,106,2.5
31,141,Platte,2015,17209,16698,511,3.0
31,143,Polk,2015,2921,2847,74,2.5
31,145,Red Willow,2015,6126,5965,161,2.6
31,147,Richardson,2015,4317,4179,138,3.2
31,149,Rock,2015,862,839,23,2.7
31,151,Saline,2015,7308,7094,214,2.9
31,153,Sarpy,2015,91004,88454,2550,2.8
31,155,Saunders,2015,10970,10634,336,3.1
31,157,Scotts Bluff,2015,18734,18102,632,3.4
31,159,Seward,2015,8731,8478,253,2.9
31,161,Sheridan,2015,2741,2667,74,2.7
31,163,Sherman,2015,1715,1665,50,2.9
31,165,Sioux,2015,791,771,20,2.5
31,167,Stanton,2015,3518,3429,89,2.5
31,169,Thayer,2015,2978,2908,70,2.4
31,171,Thomas,2015,437,424,13,3.0
31,173,Thurston,2015,2982,2824,158,5.3
31,175,Valley,2015,2071,2013,58,2.8
31,177,Washington,2015,10980,10651,329,3.0
31,179,Wayne,2015,5563,5421,142,2.6
31,181,Webster,2015,1732,1671,61,3.5
31,183,Wheeler,2015,564,551,13,2.3
31,185,York,2015,7368,7155,213,2.9
32,1,Churchill,2015,10276,9545,731,7.1
32,3,Clark,2015,1027290,956238,71052,6.9
32,5,Douglas,2015,22244,20730,1514,6.8
32,7,Elko,2015,26478,25097,1381,5.2
32,9,Esmeralda,2015,520,497,23,4.4
32,11,Eureka,2015,986,928,58,5.9
32,13,Humboldt,2015,8191,7694,497,6.1
32,15,Lander,2015,3193,2975,218,6.8
32,17,Lincoln,2015,1920,1802,118,6.1
32,19,Lyon,2015,21287,19251,2036,9.6
32,21,Mineral,2015,1613,1448,165,10.2
32,23,Nye,2015,15802,14399,1403,8.9
32,27,Pershing,2015,2429,2259,170,7.0
32,29,Storey,2015,1853,1714,139,7.5
32,31,Washoe,2015,223392,209279,14113,6.3
32,33,White Pine,2015,4685,4429,256,5.5
32,510,Carson City,2015,24601,22808,1793,7.3
33,1,Belknap,2015,31645,30579,1066,3.4
33,3,Carroll,2015,23831,22995,836,3.5
33,5,Cheshire,2015,41608,40278,1330,3.2
33,7,Coos,2015,14843,14189,654,4.4
33,9,Grafton,2015,48727,47374,1353,2.8
33,11,Hillsborough,2015,230122,221818,8304,3.6
33,13,Merrimack,2015,81430,78897,2533,3.1
33,15,Rockingham,2015,179043,172541,6502,3.6
33,17,Strafford,2015,71357,69107,2250,3.2
33,19,Sullivan,2015,23713,23056,657,2.8
34,1,Atlantic,2015,126278,114318,11960,9.5
34,3,Bergen,2015,479904,457628,22276,4.6
34,5,Burlington,2015,229716,217549,12167,5.3
34,7,Camden,2015,252159,236023,16136,6.4
34,9,Cape May,2015,48022,42747,5275,11.0
34,11,Cumberland,2015,67397,61516,5881,8.7
34,13,Essex,2015,371971,346576,25395,6.8
34,15,Gloucester,2015,148033,139153,8880,6.0
34,17,Hudson,2015,359246,340154,19092,5.3
34,19,Hunterdon,2015,65014,62290,2724,4.2
34,21,Mercer,2015,197692,187968,9724,4.9
34,23,Middlesex,2015,436039,413881,22158,5.1
34,25,Monmouth,2015,326471,309787,16684,5.1
34,27,Morris,2015,259970,248747,11223,4.3
34,29,Ocean,2015,265617,249404,16213,6.1
34,31,Passaic,2015,246668,229425,17243,7.0
34,33,Salem,2015,30799,28563,2236,7.3
34,35,Somerset,2015,172941,165150,7791,4.5
34,37,Sussex,2015,76021,71927,4094,5.4
34,39,Union,2015,277954,261374,16580,6.0
34,41,Warren,2015,56694,53695,2999,5.3
35,1,Bernalillo,2015,324436,305108,19328,6.0
35,3,Catron,2015,1200,1099,101,8.4
35,5,Chaves,2015,27901,26121,1780,6.4
35,6,Cibola,2015,9334,8578,756,8.1
35,7,Colfax,2015,6078,5709,369,6.1
35,9,Curry,2015,22043,20954,1089,4.9
35,11,De Baca,2015,856,812,44,5.1
35,13,Dona Ana,2015,94974,87947,7027,7.4
35,15,Eddy,2015,30009,28513,1496,5.0
35,17,Grant,2015,12555,11733,822,6.5
35,19,Guadalupe,2015,1645,1527,118,7.2
35,21,Harding,2015,288,263,25,8.7
35,23,Hidalgo,2015,2150,2015,135,6.3
35,25,Lea,2015,30113,28224,1889,6.3
35,27,Lincoln,2015,8751,8240,511,5.8
35,28,Los Alamos,2015,8558,8208,350,4.1
35,29,Luna,2015,11130,9184,1946,17.5
35,31,McKinley,2015,24475,22055,2420,9.9
35,33,Mora,2015,2286,2062,224,9.8
35,35,Otero,2015,25168,23594,1574,6.3
35,37,Quay,2015,3293,3056,237,7.2
35,39,Rio Arriba,2015,16709,15354,1355,8.1
35,41,Roosevelt,2015,8095,7652,443,5.5
35,43,Sandoval,2015,62492,58296,4196,6.7
35,45,San Juan,2015,56002,52098,3904,7.0
35,47,San Miguel,2015,11166,10299,867,7.8
35,49,Santa Fe,2015,73665,69678,3987,5.4
35,51,Sierra,2015,4058,3685,373,9.2
35,53,Socorro,2015,6583,6080,503,7.6
35,55,Taos,2015,15020,13628,1392,9.3
35,57,Torrance,2015,5503,5000,503,9.1
35,59,Union,2015,1905,1821,84,4.4
35,61,Valencia,2015,29860,27613,2247,7.5
36,1,Albany,2015,158197,151269,6928,4.4
36,3,Allegany,2015,20309,18979,1330,6.5
36,5,Bronx,2015,602931,556946,45985,7.6
36,7,Broome,2015,86642,81430,5212,6.0
36,9,Cattaraugus,2015,35157,32929,2228,6.3
36,11,Cayuga,2015,37005,35015,1990,5.4
36,13,Chautauqua,2015,57502,54012,3490,6.1
36,15,Chemung,2015,37406,35195,2211,5.9
36,17,Chenango,2015,23047,21780,1267,5.5
36,19,Clinton,2015,35861,33758,2103,5.9
36,21,Columbia,2015,31352,30094,1258,4.0
36,23,Cortland,2015,23233,21855,1378,5.9
36,25,Delaware,2015,19467,18290,1177,6.0
36,27,Dutchess,2015,142997,136526,6471,4.5
36,29,Erie,2015,447913,423855,24058,5.4
36,31,Essex,2015,17283,16235,1048,6.1
36,33,Franklin,2015,19940,18632,1308,6.6
36,35,Fulton,2015,23409,21892,1517,6.5
36,37,Genesee,2015,30049,28549,1500,5.0
36,39,Greene,2015,20686,19511,1175,5.7
36,41,Hamilton,2015,2430,2265,165,6.8
36,43,Herkimer,2015,28373,26590,1783,6.3
36,45,Jefferson,2015,46451,43366,3085,6.6
36,47,Kings,2015,1209375,1139369,70006,5.8
36,49,Lewis,2015,11749,10930,819,7.0
36,51,Livingston,2015,31195,29543,1652,5.3
36,53,Madison,2015,32835,30957,1878,5.7
36,55,Monroe,2015,364827,346195,18632,5.1
36,57,Montgomery,2015,22235,20765,1470,6.6
36,59,Nassau,2015,696394,666770,29624,4.3
36,61,New York,2015,906077,862865,43212,4.8
36,63,Niagara,2015,100970,94705,6265,6.2
36,65,Oneida,2015,101948,96471,5477,5.4
36,67,Onondaga,2015,222097,211070,11027,5.0
36,69,Ontario,2015,54971,52355,2616,4.8
36,71,Orange,2015,177655,169318,8337,4.7
36,73,Orleans,2015,17846,16702,1144,6.4
36,75,Oswego,2015,53940,50041,3899,7.2
36,77,Otsego,2015,28657,27100,1557,5.4
36,79,Putnam,2015,50525,48354,2171,4.3
36,81,Queens,2015,1152142,1095485,56657,4.9
36,83,Rensselaer,2015,81439,77625,3814,4.7
36,85,Richmond,2015,218528,206018,12510,5.7
36,87,Rockland,2015,151923,144999,6924,4.6
36,89,St. Lawrence,2015,43825,40602,3223,7.4
36,91,Saratoga,2015,116670,111795,4875,4.2
36,93,Schenectady,2015,75620,72028,3592,4.8
36,95,Schoharie,2015,14650,13793,857,5.8
36,97,Schuyler,2015,8339,7784,555,6.7
36,99,Seneca,2015,15699,14883,816,5.2
36,101,Steuben,2015,43642,40872,2770,6.3
36,103,Suffolk,2015,774850,738096,36754,4.7
36,105,Sullivan,2015,33658,31826,1832,5.4
36,107,Tioga,2015,23346,22042,1304,5.6
36,109,Tompkins,2015,50336,48107,2229,4.4
36,111,Ulster,2015,88193,83923,4270,4.8
36,113,Warren,2015,32202,30407,1795,5.6
36,115,Washington,2015,28605,27159,1446,5.1
36,117,Wayne,2015,44217,41844,2373,5.4
36,119,Westchester,2015,477632,455780,21852,4.6
36,121,Wyoming,2015,18350,17307,1043,5.7
36,123,Yates,2015,11722,11134,588,5.0
37,1,Alamance,2015,77206,73126,4080,5.3
37,3,Alexander,2015,17523,16671,852,4.9
37,5,Alleghany,2015,4462,4191,271,6.1
37,7,Anson,2015,10817,10119,698,6.5
37,9,Ashe,2015,12297,11566,731,5.9
37,11,Avery,2015,7524,7082,442,5.9
37,13,Beaufort,2015,20094,18786,1308,6.5
37,15,Bertie,2015,8592,7979,613,7.1
37,17,Bladen,2015,14721,13563,1158,7.9
37,19,Brunswick,2015,48478,44982,3496,7.2
37,21,Buncombe,2015,130295,124676,5619,4.3
37,23,Burke,2015,39285,37103,2182,5.6
37,25,Cabarrus,2015,97511,92526,4985,5.1
37,27,Caldwell,2015,35421,33234,2187,6.2
37,29,Camden,2015,4608,4347,261,5.7
37,31,Carteret,2015,31300,29472,1828,5.8
37,33,Caswell,2015,9613,9014,599,6.2
37,35,Catawba,2015,75074,70986,4088,5.4
37,37,Chatham,2015,33354,31789,1565,4.7
37,39,Cherokee,2015,11108,10400,708,6.4
37,41,Chowan,2015,5634,5236,398,7.1
37,43,Clay,2015,4038,3795,243,6.0
37,45,Cleveland,2015,46037,43129,2908,6.3
37,47,Columbus,2015,22581,20901,1680,7.4
37,49,Craven,2015,41295,38826,2469,6.0
37,51,Cumberland,2015,126103,117001,9102,7.2
37,53,Currituck,2015,12833,12099,734,5.7
37,55,Dare,2015,20275,18781,1494,7.4
37,57,Davidson,2015,78652,74333,4319,5.5
37,59,Davie,2015,19828,18843,985,5.0
37,61,Duplin,2015,26459,24962,1497,5.7
37,63,Durham,2015,156464,148713,7751,5.0
37,65,Edgecombe,2015,22786,20629,2157,9.5
37,67,Forsyth,2015,179552,169780,9772,5.4
37,69,Franklin,2015,28684,27006,1678,5.8
37,71,Gaston,2015,102672,96576,6096,5.9
37,73,Gates,2015,5139,4860,279,5.4
37,75,Graham,2015,3181,2804,377,11.9
37,77,Granville,2015,28505,27113,1392,4.9
37,79,Greene,2015,9469,8952,517,5.5
37,81,Guilford,2015,256007,241158,14849,5.8
37,83,Halifax,2015,20744,18936,1808,8.7
37,85,Harnett,2015,50188,46864,3324,6.6
37,87,Haywood,2015,27623,26189,1434,5.2
37,89,Henderson,2015,50614,48238,2376,4.7
37,91,Hertford,2015,9211,8568,643,7.0
37,93,Hoke,2015,19803,18251,1552,7.8
37,95,Hyde,2015,2141,1948,193,9.0
37,97,Iredell,2015,82099,77644,4455,5.4
37,99,Jackson,2015,18445,17335,1110,6.0
37,101,Johnston,2015,88074,83524,4550,5.2
37,103,Jones,2015,4543,4284,259,5.7
37,105,Lee,2015,26059,24201,1858,7.1
37,107,Lenoir,2015,27710,25973,1737,6.3
37,109,Lincoln,2015,40572,38396,2176,5.4
37,111,McDowell,2015,21239,20085,1154,5.4
37,113,Macon,2015,15104,14183,921,6.1
37,115,Madison,2015,9459,8928,531,5.6
37,117,Martin,2015,9705,8968,737,7.6
37,119,Mecklenburg,2015,564683,534833,29850,5.3
37,121,Mitchell,2015,6303,5877,426,6.8
37,123,Montgomery,2015,11613,10960,653,5.6
37,125,Moore,2015,38251,36059,2192,5.7
37,127,Nash,2015,43809,40658,3151,7.2
37,129,New Hanover,2015,113266,107283,5983,5.3
37,131,Northampton,2015,7856,7271,585,7.4
37,133,Onslow,2015,63680,59974,3706,5.8
37,135,Orange,2015,73308,69954,3354,4.6
37,137,Pamlico,2015,5330,5016,314,5.9
37,139,Pasquotank,2015,17430,16181,1249,7.2
37,141,Pender,2015,25989,24423,1566,6.0
37,143,Perquimans,2015,5150,4787,363,7.0
37,145,Person,2015,17864,16665,1199,6.7
37,147,Pitt,2015,87592,82352,5240,6.0
37,149,Polk,2015,8653,8217,436,5.0
37,151,Randolph,2015,66574,62820,3754,5.6
37,153,Richmond,2015,16905,15582,1323,7.8
37,155,Robeson,2015,50978,46709,4269,8.4
37,157,Rockingham,2015,41074,38388,2686,6.5
37,159,Rowan,2015,63026,59235,3791,6.0
37,161,Rutherford,2015,25016,23097,1919,7.7
37,163,Sampson,2015,29511,27786,1725,5.8
37,165,Scotland,2015,11841,10600,1241,10.5
37,167,Stanly,2015,28767,27255,1512,5.3
37,169,Stokes,2015,21782,20614,1168,5.4
37,171,Surry,2015,33295,31513,1782,5.4
37,173,Swain,2015,6767,6254,513,7.6
37,175,Transylvania,2015,13533,12806,727,5.4
37,177,Tyrrell,2015,1545,1400,145,9.4
37,179,Union,2015,112222,106848,5374,4.8
37,181,Vance,2015,18022,16496,1526,8.5
37,183,Wake,2015,539009,513915,25094,4.7
37,185,Warren,2015,7202,6612,590,8.2
37,187,Washington,2015,4960,4534,426,8.6
37,189,Watauga,2015,27365,26056,1309,4.8
37,191,Wayne,2015,53672,50458,3214,6.0
37,193,Wilkes,2015,29597,27937,1660,5.6
37,195,Wilson,2015,36697,33251,3446,9.4
37,197,Yadkin,2015,17471,16608,863,4.9
37,199,Yancey,2015,7408,6976,432,5.8
38,1,Adams,2015,1100,1068,32,2.9
38,3,Barnes,2015,5600,5420,180,3.2
38,5,Benson,2015,2460,2347,113,4.6
38,7,Billings,2015,464,450,14,3.0
38,9,Bottineau,2015,3216,3075,141,4.4
38,11,Bowman,2015,1847,1813,34,1.8
38,13,Burke,2015,1172,1133,39,3.3
38,15,Burleigh,2015,48573,47414,1159,2.4
38,17,Cass,2015,94623,92497,2126,2.2
38,19,Cavalier,2015,2045,1988,57,2.8
38,21,Dickey,2015,2532,2485,47,1.9
38,23,Divide,2015,1801,1768,33,1.8
38,25,Dunn,2015,3987,3908,79,2.0
38,27,Eddy,2015,1260,1200,60,4.8
38,29,Emmons,2015,1539,1463,76,4.9
38,31,Foster,2015,1617,1570,47,2.9
38,33,Golden Valley,2015,970,948,22,2.3
38,35,Grand Forks,2015,37216,36307,909,2.4
38,37,Grant,2015,1309,1268,41,3.1
38,39,Griggs,2015,1146,1119,27,2.4
38,41,Hettinger,2015,1543,1504,39,2.5
38,43,Kidder,2015,1332,1283,49,3.7
38,45,LaMoure,2015,2253,2197,56,2.5
38,47,Logan,2015,941,914,27,2.9
38,49,McHenry,2015,3254,3117,137,4.2
38,51,McIntosh,2015,1234,1195,39,3.2
38,53,McKenzie,2015,9132,8905,227,2.5
38,55,McLean,2015,4884,4701,183,3.7
38,57,Mercer,2015,4275,4095,180,4.2
38,59,Morton,2015,16137,15639,498,3.1
38,61,Mountrail,2015,8079,7920,159,2.0
38,63,Nelson,2015,1505,1449,56,3.7
38,65,Oliver,2015,876,824,52,5.9
38,67,Pembina,2015,3580,3389,191,5.3
38,69,Pierce,2015,1824,1747,77,4.2
38,71,Ramsey,2015,5645,5453,192,3.4
38,73,Ransom,2015,2754,2686,68,2.5
38,75,Renville,2015,1327,1283,44,3.3
38,77,Richland,2015,8531,8298,233,2.7
38,79,Rolette,2015,4850,4349,501,10.3
38,81,Sargent,2015,2238,2197,41,1.8
38,83,Sheridan,2015,720,684,36,5.0
38,85,Sioux,2015,1283,1227,56,4.4
38,87,Slope,2015,461,449,12,2.6
38,89,Stark,2015,20128,19583,545,2.7
38,91,Steele,2015,1055,1031,24,2.3
38,93,Stutsman,2015,10624,10350,274,2.6
38,95,Towner,2015,1232,1199,33,2.7
38,97,Traill,2015,4415,4290,125,2.8
38,99,Walsh,2015,5534,5302,232,4.2
38,101,Ward,2015,34012,32926,1086,3.2
38,103,Wells,2015,2155,2069,86,4.0
38,105,Williams,2015,28478,27801,677,2.4
39,1,Adams,2015,10722,9870,852,7.9
39,3,Allen,2015,47999,45647,2352,4.9
39,5,Ashland,2015,26064,24739,1325,5.1
39,7,Ashtabula,2015,44504,41816,2688,6.0
39,9,Athens,2015,28006,26244,1762,6.3
39,11,Auglaize,2015,24530,23619,911,3.7
39,13,Belmont,2015,31259,29255,2004,6.4
39,15,Brown,2015,19554,18323,1231,6.3
39,17,Butler,2015,188071,179345,8726,4.6
39,19,Carroll,2015,13394,12587,807,6.0
39,21,Champaign,2015,19939,19057,882,4.4
39,23,Clark,2015,64293,61045,3248,5.1
39,25,Clermont,2015,103007,98315,4692,4.6
39,27,Clinton,2015,16744,15693,1051,6.3
39,29,Columbiana,2015,49555,46616,2939,5.9
39,31,Coshocton,2015,15907,14883,1024,6.4
39,33,Crawford,2015,19142,18018,1124,5.9
39,35,Cuyahoga,2015,609062,577370,31692,5.2
39,37,Darke,2015,26302,25168,1134,4.3
39,39,Defiance,2015,18736,17806,930,5.0
39,41,Delaware,2015,102670,99005,3665,3.6
39,43,Erie,2015,37487,35388,2099,5.6
39,45,Fairfield,2015,75125,71819,3306,4.4
39,47,Fayette,2015,14069,13367,702,5.0
39,49,Franklin,2015,657983,630764,27219,4.1
39,51,Fulton,2015,22512,21402,1110,4.9
39,53,Gallia,2015,12247,11444,803,6.6
39,55,Geauga,2015,48701,46652,2049,4.2
39,57,Greene,2015,80645,77086,3559,4.4
39,59,Guernsey,2015,19270,18061,1209,6.3
39,61,Hamilton,2015,402777,384465,18312,4.5
39,63,Hancock,2015,40887,39373,1514,3.7
39,65,Hardin,2015,14544,13835,709,4.9
39,67,Harrison,2015,7208,6750,458,6.4
39,69,Henry,2015,13595,12826,769,5.7
39,71,Highland,2015,16995,15902,1093,6.4
39,73,Hocking,2015,13057,12319,738,5.7
39,75,Holmes,2015,20691,19975,716,3.5
39,77,Huron,2015,27713,25869,1844,6.7
39,79,Jackson,2015,13095,12100,995,7.6
39,81,Jefferson,2015,29492,27280,2212,7.5
39,83,Knox,2015,31331,29862,1469,4.7
39,85,Lake,2015,123551,117946,5605,4.5
39,87,Lawrence,2015,24984,23503,1481,5.9
39,89,Licking,2015,87222,83310,3912,4.5
39,91,Logan,2015,23172,22186,986,4.3
39,93,Lorain,2015,149895,141498,8397,5.6
39,95,Lucas,2015,209455,198218,11237,5.4
39,97,Madison,2015,20563,19725,838,4.1
39,99,Mahoning,2015,107305,100697,6608,6.2
39,101,Marion,2015,27866,26425,1441,5.2
39,103,Medina,2015,94525,90591,3934,4.2
39,105,Meigs,2015,9127,8368,759,8.3
39,107,Mercer,2015,23077,22312,765,3.3
39,109,Miami,2015,52568,50231,2337,4.4
39,111,Monroe,2015,5563,5004,559,10.0
39,113,Montgomery,2015,249904,237254,12650,5.1
39,115,Morgan,2015,6728,6232,496,7.4
39,117,Morrow,2015,16741,15888,853,5.1
39,119,Muskingum,2015,38940,36495,2445,6.3
39,121,Noble,2015,4991,4624,367,7.4
39,123,Ottawa,2015,21101,19691,1410,6.7
39,125,Paulding,2015,8934,8501,433,4.8
39,127,Perry,2015,15880,14832,1048,6.6
39,129,Pickaway,2015,25828,24585,1243,4.8
39,131,Pike,2015,10511,9734,777,7.4
39,133,Portage,2015,87111,82825,4286,4.9
39,135,Preble,2015,21054,20028,1026,4.9
39,137,Putnam,2015,18724,17990,734,3.9
39,139,Richland,2015,53744,50713,3031,5.6
39,141,Ross,2015,33827,31996,1831,5.4
39,143,Sandusky,2015,31461,29929,1532,4.9
39,145,Scioto,2015,29682,27386,2296,7.7
39,147,Seneca,2015,27233,25903,1330,4.9
39,149,Shelby,2015,24157,23107,1050,4.3
39,151,Stark,2015,187170,177206,9964,5.3
39,153,Summit,2015,272635,258933,13702,5.0
39,155,Trumbull,2015,91723,85743,5980,6.5
39,157,Tuscarawas,2015,45594,43118,2476,5.4
39,159,Union,2015,27111,26059,1052,3.9
39,161,Van Wert,2015,14373,13769,604,4.2
39,163,Vinton,2015,5479,5116,363,6.6
39,165,Warren,2015,112777,108041,4736,4.2
39,167,Washington,2015,28152,26442,1710,6.1
39,169,Wayne,2015,60189,57793,2396,4.0
39,171,Williams,2015,19074,18222,852,4.5
39,173,Wood,2015,69812,66796,3016,4.3
39,175,Wyandot,2015,12387,11929,458,3.7
40,1,Adair,2015,8156,7673,483,5.9
40,3,Alfalfa,2015,3162,3071,91,2.9
40,5,Atoka,2015,4856,4548,308,6.3
40,7,Beaver,2015,3023,2943,80,2.6
40,9,Beckham,2015,12201,11594,607,5.0
40,11,Blaine,2015,4484,4316,168,3.7
40,13,Bryan,2015,18326,17510,816,4.5
40,15,Caddo,2015,11826,11231,595,5.0
40,17,Canadian,2015,68258,65855,2403,3.5
40,19,Carter,2015,22540,21541,999,4.4
40,21,Cherokee,2015,19249,18279,970,5.0
40,23,Choctaw,2015,5906,5464,442,7.5
40,25,Cimarron,2015,1375,1345,30,2.2
40,27,Cleveland,2015,138083,133326,4757,3.4
40,29,Coal,2015,2316,2144,172,7.4
40,31,Comanche,2015,49607,47502,2105,4.2
40,33,Cotton,2015,2859,2743,116,4.1
40,35,Craig,2015,6256,5961,295,4.7
40,37,Creek,2015,31309,29795,1514,4.8
40,39,Custer,2015,15646,15028,618,3.9
40,41,Delaware,2015,17460,16618,842,4.8
40,43,Dewey,2015,2495,2407,88,3.5
40,45,Ellis,2015,2390,2295,95,4.0
40,47,Garfield,2015,30065,28910,1155,3.8
40,49,Garvin,2015,12821,12233,588,4.6
40,51,Grady,2015,26200,25052,1148,4.4
40,53,Grant,2015,3289,3195,94,2.9
40,55,Greer,2015,2166,2047,119,5.5
40,57,Harmon,2015,1302,1258,44,3.4
40,59,Harper,2015,1986,1927,59,3.0
40,61,Haskell,2015,4472,4126,346,7.7
40,63,Hughes,2015,5725,5307,418,7.3
40,65,Jackson,2015,10867,10436,431,4.0
40,67,Jefferson,2015,2677,2527,150,5.6
40,69,Johnston,2015,3965,3713,252,6.4
40,71,Kay,2015,19175,18113,1062,5.5
40,73,Kingfisher,2015,8275,8021,254,3.1
40,75,Kiowa,2015,4160,3971,189,4.5
40,77,Latimer,2015,3855,3550,305,7.9
40,79,Le Flore,2015,19608,18285,1323,6.7
40,81,Lincoln,2015,15865,15143,722,4.6
40,83,Logan,2015,21461,20665,796,3.7
40,85,Love,2015,5974,5767,207,3.5
40,87,McClain,2015,18746,18067,679,3.6
40,89,McCurtain,2015,14713,13575,1138,7.7
40,91,McIntosh,2015,7072,6476,596,8.4
40,93,Major,2015,4296,4159,137,3.2
40,95,Marshall,2015,6777,6416,361,5.3
40,97,Mayes,2015,19389,18572,817,4.2
40,99,Murray,2015,6762,6483,279,4.1
40,101,Muskogee,2015,29552,28071,1481,5.0
40,103,Noble,2015,5637,5442,195,3.5
40,105,Nowata,2015,4794,4527,267,5.6
40,107,Okfuskee,2015,4537,4278,259,5.7
40,109,Oklahoma,2015,374610,360212,14398,3.8
40,111,Okmulgee,2015,16197,15144,1053,6.5
40,113,Osage,2015,21201,20111,1090,5.1
40,115,Ottawa,2015,14359,13641,718,5.0
40,117,Pawnee,2015,7464,7039,425,5.7
40,119,Payne,2015,38368,37049,1319,3.4
40,121,Pittsburg,2015,17414,16446,968,5.6
40,123,Pontotoc,2015,18232,17524,708,3.9
40,125,Pottawatomie,2015,32715,31279,1436,4.4
40,127,Pushmataha,2015,4906,4533,373,7.6
40,129,Roger Mills,2015,1837,1761,76,4.1
40,131,Rogers,2015,44578,42672,1906,4.3
40,133,Seminole,2015,9592,8954,638,6.7
40,135,Sequoyah,2015,16755,15718,1037,6.2
40,137,Stephens,2015,20255,19071,1184,5.8
40,139,Texas,2015,9688,9384,304,3.1
40,141,Tillman,2015,3355,3215,140,4.2
40,143,Tulsa,2015,317640,304809,12831,4.0
40,145,Wagoner,2015,36223,34737,1486,4.1
40,147,Washington,2015,24436,23410,1026,4.2
40,149,Washita,2015,5601,5297,304,5.4
40,151,Woods,2015,5367,5222,145,2.7
40,153,Woodward,2015,10295,9775,520,5.1
41,1,Baker,2015,6675,6235,440,6.6
41,3,Benton,2015,45479,43607,1872,4.1
41,5,Clackamas,2015,205321,195069,10252,5.0
41,7,Clatsop,2015,18363,17385,978,5.3
41,9,Columbia,2015,22688,21104,1584,7.0
41,11,Coos,2015,25953,24071,1882,7.3
41,13,Crook,2015,9021,8285,736,8.2
41,15,Curry,2015,8712,8011,701,8.0
41,17,Deschutes,2015,84796,79935,4861,5.7
41,19,Douglas,2015,44376,41128,3248,7.3
41,21,Gilliam,2015,810,759,51,6.3
41,23,Grant,2015,3090,2828,262,8.5
41,25,Harney,2015,3305,3074,231,7.0
41,27,Hood River,2015,13537,12914,623,4.6
41,29,Jackson,2015,98070,91580,6490,6.6
41,31,Jefferson,2015,9646,8957,689,7.1
41,33,Josephine,2015,33275,30766,2509,7.5
41,35,Klamath,2015,28664,26481,2183,7.6
41,37,Lake,2015,3436,3179,257,7.5
41,39,Lane,2015,172635,162845,9790,5.7
41,41,Lincoln,2015,20529,19197,1332,6.5
41,43,Linn,2015,55211,51589,3622,6.6
41,45,Malheur,2015,11960,11218,742,6.2
41,47,Marion,2015,152715,143774,8941,5.9
41,49,Morrow,2015,5545,5235,310,5.6
41,51,Multnomah,2015,430032,409444,20588,4.8
41,53,Polk,2015,36607,34598,2009,5.5
41,55,Sherman,2015,888,835,53,6.0
41,57,Tillamook,2015,11396,10771,625,5.5
41,59,Umatilla,2015,35260,33075,2185,6.2
41,61,Union,2015,11708,11005,703,6.0
41,63,Wallowa,2015,3242,2996,246,7.6
41,65,Wasco,2015,13032,12320,712,5.5
41,67,Washington,2015,301910,288084,13826,4.6
41,69,Wheeler,2015,692,657,35,5.1
41,71,Yamhill,2015,50900,48276,2624,5.2
42,1,Adams,2015,54980,52627,2353,4.3
42,3,Allegheny,2015,647733,615035,32698,5.0
42,5,Armstrong,2015,33051,30813,2238,6.8
42,7,Beaver,2015,85836,80545,5291,6.2
42,9,Bedford,2015,24138,22646,1492,6.2
42,11,Berks,2015,212575,201893,10682,5.0
42,13,Blair,2015,61011,57810,3201,5.2
42,15,Bradford,2015,31381,29490,1891,6.0
42,17,Bucks,2015,337666,321616,16050,4.8
42,19,Butler,2015,98129,93410,4719,4.8
42,21,Cambria,2015,62371,58206,4165,6.7
42,23,Cameron,2015,2265,2100,165,7.3
42,25,Carbon,2015,31477,29534,1943,6.2
42,27,Centre,2015,77816,74668,3148,4.0
42,29,Chester,2015,277098,266346,10752,3.9
42,31,Clarion,2015,18278,17167,1111,6.1
42,33,Clearfield,2015,36435,33969,2466,6.8
42,35,Clinton,2015,18778,17460,1318,7.0
42,37,Columbia,2015,33751,31808,1943,5.8
42,39,Crawford,2015,41059,38884,2175,5.3
42,41,Cumberland,2015,128408,123193,5215,4.1
42,43,Dauphin,2015,141032,134341,6691,4.7
42,45,Delaware,2015,291615,277085,14530,5.0
42,47,Elk,2015,16334,15514,820,5.0
42,49,Erie,2015,134801,127260,7541,5.6
42,51,Fayette,2015,58414,53952,4462,7.6
42,53,Forest,2015,1900,1748,152,8.0
42,55,Franklin,2015,77875,73942,3933,5.1
42,57,Fulton,2015,7446,6973,473,6.4
42,59,Greene,2015,18171,17061,1110,6.1
42,61,Huntingdon,2015,19684,18276,1408,7.2
42,63,Indiana,2015,41777,39092,2685,6.4
42,65,Jefferson,2015,20983,19678,1305,6.2
42,67,Juniata,2015,11994,11389,605,5.0
42,69,Lackawanna,2015,106458,100145,6313,5.9
42,71,Lancaster,2015,276028,264467,11561,4.2
42,73,Lawrence,2015,42140,39429,2711,6.4
42,75,Lebanon,2015,70081,66849,3232,4.6
42,77,Lehigh,2015,185867,175780,10087,5.4
42,79,Luzerne,2015,158870,148426,10444,6.6
42,81,Lycoming,2015,60933,57180,3753,6.2
42,83,McKean,2015,18989,17814,1175,6.2
42,85,Mercer,2015,53022,50077,2945,5.6
42,87,Mifflin,2015,20924,19693,1231,5.9
42,89,Monroe,2015,80817,75512,5305,6.6
42,91,Montgomery,2015,440959,422289,18670,4.2
42,93,Montour,2015,9148,8746,402,4.4
42,95,Northampton,2015,156657,148266,8391,5.4
42,97,Northumberland,2015,43454,40755,2699,6.2
42,99,Perry,2015,24113,23016,1097,4.5
42,101,Philadelphia/city,2015,696074,645691,50383,7.2
42,103,Pike,2015,24994,23331,1663,6.7
42,105,Potter,2015,7380,6852,528,7.2
42,107,Schuylkill,2015,68229,63858,4371,6.4
42,109,Snyder,2015,20070,19111,959,4.8
42,111,Somerset,2015,34490,32090,2400,7.0
42,113,Sullivan,2015,3036,2845,191,6.3
42,115,Susquehanna,2015,21410,20192,1218,5.7
42,117,Tioga,2015,20344,18994,1350,6.6
42,119,Union,2015,19312,18432,880,4.6
42,121,Venango,2015,24472,22991,1481,6.1
42,123,Warren,2015,19962,18948,1014,5.1
42,125,Washington,2015,106670,100616,6054,5.7
42,127,Wayne,2015,22283,20961,1322,5.9
42,129,Westmoreland,2015,182989,172937,10052,5.5
42,131,Wyoming,2015,14122,13246,876,6.2
42,133,York,2015,232597,221333,11264,4.8
44,1,Bristol,2015,26199,24805,1394,5.3
44,3,Kent,2015,91150,86087,5063,5.6
44,5,Newport,2015,44144,41740,2404,5.4
44,7,Providence,2015,324384,303657,20727,6.4
44,9,Washington,2015,69395,65478,3917,5.6
45,1,Abbeville,2015,10342,9637,705,6.8
45,3,Aiken,2015,73880,69572,4308,5.8
45,5,Allendale,2015,2746,2438,308,11.2
45,7,Anderson,2015,88419,83693,4726,5.3
45,9,Bamberg,2015,5455,4888,567,10.4
45,11,Barnwell,2015,8369,7624,745,8.9
45,13,Beaufort,2015,71613,67743,3870,5.4
45,15,Berkeley,2015,93431,88352,5079,5.4
45,17,Calhoun,2015,6887,6401,486,7.1
45,19,Charleston,2015,198083,188588,9495,4.8
45,21,Cherokee,2015,23446,21792,1654,7.1
45,23,Chester,2015,13443,12328,1115,8.3
45,25,Chesterfield,2015,21431,20145,1286,6.0
45,27,Clarendon,2015,13056,12061,995,7.6
45,29,Colleton,2015,16707,15554,1153,6.9
45,31,Darlington,2015,30042,27849,2193,7.3
45,33,Dillon,2015,12662,11582,1080,8.5
45,35,Dorchester,2015,72661,68727,3934,5.4
45,37,Edgefield,2015,10660,9991,669,6.3
45,39,Fairfield,2015,10014,9215,799,8.0
45,41,Florence,2015,65470,61234,4236,6.5
45,43,Georgetown,2015,25212,23112,2100,8.3
45,45,Greenville,2015,242842,230968,11874,4.9
45,47,Greenwood,2015,31243,29288,1955,6.3
45,49,Hampton,2015,8340,7647,693,8.3
45,51,Horry,2015,137237,127562,9675,7.0
45,53,Jasper,2015,11813,11215,598,5.1
45,55,Kershaw,2015,28924,27215,1709,5.9
45,57,Lancaster,2015,36684,34401,2283,6.2
45,59,Laurens,2015,30269,28302,1967,6.5
45,61,Lee,2015,6453,5914,539,8.4
45,63,Lexington,2015,145305,138353,6952,4.8
45,65,McCormick,2015,3439,3196,243,7.1
45,67,Marion,2015,12849,11580,1269,9.9
45,69,Marlboro,2015,9637,8678,959,10.0
45,71,Newberry,2015,18886,17895,991,5.2
45,73,Oconee,2015,34467,32490,1977,5.7
45,75,Orangeburg,2015,36902,32930,3972,10.8
45,77,Pickens,2015,56030,52833,3197,5.7
45,79,Richland,2015,198564,187463,11101,5.6
45,81,Saluda,2015,8825,8367,458,5.2
45,83,Spartanburg,2015,139790,131890,7900,5.7
45,85,Sumter,2015,44355,41354,3001,6.8
45,87,Union,2015,11547,10644,903,7.8
45,89,Williamsburg,2015,12805,11637,1168,9.1
45,91,York,2015,126603,119739,6864,5.4
46,3,Aurora,2015,1581,1547,34,2.2
46,5,Beadle,2015,9531,9284,247,2.6
46,7,Bennett,2015,1137,1081,56,4.9
46,9,Bon Homme,2015,3029,2950,79,2.6
46,11,Brookings,2015,18684,18146,538,2.9
46,13,Brown,2015,21126,20573,553,2.6
46,15,Brule,2015,2552,2485,67,2.6
46,17,Buffalo,2015,719,669,50,7.0
46,19,Butte,2015,5124,4953,171,3.3
46,21,Campbell,2015,855,830,25,2.9
46,23,Charles Mix,2015,4009,3874,135,3.4
46,25,Clark,2015,1978,1907,71,3.6
46,27,Clay,2015,7055,6842,213,3.0
46,29,Codington,2015,15418,14951,467,3.0
46,31,Corson,2015,1499,1424,75,5.0
46,33,Custer,2015,3987,3821,166,4.2
46,35,Davison,2015,11399,11115,284,2.5
46,37,Day,2015,2876,2736,140,4.9
46,39,Deuel,2015,2324,2211,113,4.9
46,41,Dewey,2015,2304,2043,261,11.3
46,43,Douglas,2015,1685,1644,41,2.4
46,45,Edmunds,2015,2235,2180,55,2.5
46,47,Fall River,2015,2992,2861,131,4.4
46,49,Faulk,2015,1126,1097,29,2.6
46,51,Grant,2015,4735,4598,137,2.9
46,53,Gregory,2015,2070,2006,64,3.1
46,55,Haakon,2015,1105,1080,25,2.3
46,57,Hamlin,2015,3152,3049,103,3.3
46,59,Hand,2015,1886,1843,43,2.3
46,61,Hanson,2015,1809,1750,59,3.3
46,63,Harding,2015,785,766,19,2.4
46,65,Hughes,2015,9958,9723,235,2.4
46,67,Hutchinson,2015,3697,3607,90,2.4
46,69,Hyde,2015,712,692,20,2.8
46,71,Jackson,2015,1334,1278,56,4.2
46,73,Jerauld,2015,1133,1108,25,2.2
46,75,Jones,2015,588,571,17,2.9
46,77,Kingsbury,2015,2771,2691,80,2.9
46,79,Lake,2015,6551,6317,234,3.6
46,81,Lawrence,2015,12816,12404,412,3.2
46,83,Lincoln,2015,30651,29974,677,2.2
46,85,Lyman,2015,1804,1721,83,4.6
46,87,McCook,2015,3151,3077,74,2.3
46,89,McPherson,2015,1120,1083,37,3.3
46,91,Marshall,2015,2518,2423,95,3.8
46,93,Meade,2015,13421,13004,417,3.1
46,95,Mellette,2015,803,762,41,5.1
46,97,Miner,2015,1220,1191,29,2.4
46,99,Minnehaha,2015,106985,104148,2837,2.7
46,101,Moody,2015,3968,3836,132,3.3
46,102,Oglala Lakota,2015,3604,3197,407,11.3
46,103,Pennington,2015,54705,53010,1695,3.1
46,105,Perkins,2015,1585,1536,49,3.1
46,107,Potter,2015,1190,1152,38,3.2
46,109,Roberts,2015,4895,4686,209,4.3
46,111,Sanborn,2015,1235,1204,31,2.5
46,115,Spink,2015,3338,3237,101,3.0
46,117,Stanley,2015,1845,1802,43,2.3
46,119,Sully,2015,876,854,22,2.5
46,121,Todd,2015,3066,2844,222,7.2
46,123,Tripp,2015,3100,3019,81,2.6
46,125,Turner,2015,4665,4543,122,2.6
46,127,Union,2015,8080,7811,269,3.3
46,129,Walworth,2015,2281,2160,121,5.3
46,135,Yankton,2015,11673,11374,299,2.6
46,137,Ziebach,2015,989,940,49,5.0
47,1,Anderson,2015,33351,31423,1928,5.8
47,3,Bedford,2015,19448,18203,1245,6.4
47,5,Benton,2015,6778,6261,517,7.6
47,7,Bledsoe,2015,4257,3922,335,7.9
47,9,Blount,2015,59654,56591,3063,5.1
47,11,Bradley,2015,49544,46975,2569,5.2
47,13,Campbell,2015,14657,13504,1153,7.9
47,15,Cannon,2015,5869,5533,336,5.7
47,17,Carroll,2015,12206,11203,1003,8.2
47,19,Carter,2015,23575,22069,1506,6.4
47,21,Cheatham,2015,19908,18953,955,4.8
47,23,Chester,2015,8242,7762,480,5.8
47,25,Claiborne,2015,12601,11696,905,7.2
47,27,Clay,2015,3004,2740,264,8.8
47,29,Cocke,2015,14433,13321,1112,7.7
47,31,Coffee,2015,24345,23004,1341,5.5
47,33,Crockett,2015,6833,6398,435,6.4
47,35,Cumberland,2015,22976,21363,1613,7.0
47,37,Davidson,2015,364944,349100,15844,4.3
47,39,Decatur,2015,4721,4352,369,7.8
47,41,DeKalb,2015,7380,6877,503,6.8
47,43,Dickson,2015,24143,22841,1302,5.4
47,45,Dyer,2015,16696,15507,1189,7.1
47,47,Fayette,2015,17907,16808,1099,6.1
47,49,Fentress,2015,7016,6508,508,7.2
47,51,Franklin,2015,19633,18623,1010,5.1
47,53,Gibson,2015,21069,19528,1541,7.3
47,55,Giles,2015,14582,13861,721,4.9
47,57,Grainger,2015,9163,8559,604,6.6
47,59,Greene,2015,30671,28707,1964,6.4
47,61,Grundy,2015,4881,4504,377,7.7
47,63,Hamblen,2015,26517,24885,1632,6.2
47,65,Hamilton,2015,167676,158840,8836,5.3
47,67,Hancock,2015,2068,1869,199,9.6
47,69,Hardeman,2015,9307,8613,694,7.5
47,71,Hardin,2015,10282,9549,733,7.1
47,73,Hawkins,2015,23580,22085,1495,6.3
47,75,Haywood,2015,7644,7009,635,8.3
47,77,Henderson,2015,12297,11324,973,7.9
47,79,Henry,2015,13904,13002,902,6.5
47,81,Hickman,2015,10340,9756,584,5.6
47,83,Houston,2015,3203,2929,274,8.6
47,85,Humphreys,2015,8485,7916,569,6.7
47,87,Jackson,2015,4472,4124,348,7.8
47,89,Jefferson,2015,23342,21860,1482,6.3
47,91,Johnson,2015,7324,6915,409,5.6
47,93,Knox,2015,228904,218294,10610,4.6
47,95,Lake,2015,1974,1807,167,8.5
47,97,Lauderdale,2015,9613,8769,844,8.8
47,99,Lawrence,2015,17756,16593,1163,6.5
47,101,Lewis,2015,4814,4465,349,7.2
47,103,Lincoln,2015,15174,14450,724,4.8
47,105,Loudon,2015,21981,20760,1221,5.6
47,107,McMinn,2015,22694,21269,1425,6.3
47,109,McNairy,2015,8776,8036,740,8.4
47,111,Macon,2015,9983,9458,525,5.3
47,113,Madison,2015,46629,43904,2725,5.8
47,115,Marion,2015,11737,10950,787,6.7
47,117,Marshall,2015,14795,13974,821,5.5
47,119,Maury,2015,42448,40289,2159,5.1
47,121,Meigs,2015,4866,4498,368,7.6
47,123,Monroe,2015,19085,17895,1190,6.2
47,125,Montgomery,2015,78752,74205,4547,5.8
47,127,Moore,2015,3312,3164,148,4.5
47,129,Morgan,2015,7732,7159,573,7.4
47,131,Obion,2015,12499,11430,1069,8.6
47,133,Overton,2015,9107,8463,644,7.1
47,135,Perry,2015,3126,2917,209,6.7
47,137,Pickett,2015,2405,2222,183,7.6
47,139,Polk,2015,7341,6862,479,6.5
47,141,Putnam,2015,32517,30633,1884,5.8
47,143,Rhea,2015,13118,12155,963,7.3
47,145,Roane,2015,22628,21177,1451,6.4
47,147,Robertson,2015,33891,32250,1641,4.8
47,149,Rutherford,2015,155929,148996,6933,4.4
47,151,Scott,2015,8094,7346,748,9.2
47,153,Sequatchie,2015,5806,5432,374,6.4
47,155,Sevier,2015,49958,46972,2986,6.0
47,157,Shelby,2015,430892,403447,27445,6.4
47,159,Smith,2015,8504,8031,473,5.6
47,161,Stewart,2015,5149,4757,392,7.6
47,163,Sullivan,2015,69296,65319,3977,5.7
47,165,Sumner,2015,88780,84723,4057,4.6
47,167,Tipton,2015,27547,25611,1936,7.0
47,169,Trousdale,2015,3691,3475,216,5.9
47,171,Unicoi,2015,7045,6488,557,7.9
47,173,Union,2015,7234,6746,488,6.7
47,175,Van Buren,2015,2057,1894,163,7.9
47,177,Warren,2015,17844,16846,998,5.6
47,179,Washington,2015,57965,54767,3198,5.5
47,181,Wayne,2015,6198,5743,455,7.3
47,183,Weakley,2015,15624,14570,1054,6.7
47,185,White,2015,11438,10750,688,6.0
47,187,Williamson,2015,107820,103534,4286,4.0
47,189,Wilson,2015,64763,61820,2943,4.5
48,1,Anderson,2015,22853,21948,905,4.0
48,3,Andrews,2015,9303,8977,326,3.5
48,5,Angelina,2015,37412,35306,2106,5.6
48,7,Aransas,2015,10065,9551,514,5.1
48,9,Archer,2015,4125,3941,184,4.5
48,11,Armstrong,2015,976,950,26,2.7
48,13,Atascosa,2015,20546,19560,986,4.8
48,15,Austin,2015,14047,13397,650,4.6
48,17,Bailey,2015,2801,2680,121,4.3
48,19,Bandera,2015,9182,8814,368,4.0
48,21,Bastrop,2015,37553,36083,1470,3.9
48,23,Baylor,2015,1628,1570,58,3.6
48,25,Bee,2015,10386,9740,646,6.2
48,27,Bell,2015,136340,129940,6400,4.7
48,29,Bexar,2015,879163,845395,33768,3.8
48,31,Blanco,2015,5769,5587,182,3.2
48,33,Borden,2015,412,400,12,2.9
48,35,Bosque,2015,8064,7699,365,4.5
48,37,Bowie,2015,39171,37274,1897,4.8
48,39,Brazoria,2015,167126,159416,7710,4.6
48,41,Brazos,2015,108638,105010,3628,3.3
48,43,Brewster,2015,3911,3756,155,4.0
48,45,Briscoe,2015,595,572,23,3.9
48,47,Brooks,2015,2604,2344,260,10.0
48,49,Brown,2015,15900,15208,692,4.4
48,51,Burleson,2015,7761,7420,341,4.4
48,53,Burnet,2015,21184,20406,778,3.7
48,55,Caldwell,2015,17431,16669,762,4.4
48,57,Calhoun,2015,11333,10877,456,4.0
48,59,Callahan,2015,5733,5487,246,4.3
48,61,Cameron,2015,163191,151483,11708,7.2
48,63,Camp,2015,5096,4781,315,6.2
48,65,Carson,2015,3069,2970,99,3.2
48,67,Cass,2015,12175,11342,833,6.8
48,69,Castro,2015,3618,3494,124,3.4
48,71,Chambers,2015,17815,16858,957,5.4
48,73,Cherokee,2015,20908,19820,1088,5.2
48,75,Childress,2015,2870,2780,90,3.1
48,77,Clay,2015,4914,4697,217,4.4
48,79,Cochran,2015,1318,1250,68,5.2
48,81,Coke,2015,1399,1342,57,4.1
48,83,Coleman,2015,3051,2881,170,5.6
48,85,Collin,2015,488810,470919,17891,3.7
48,87,Collingsworth,2015,1271,1224,47,3.7
48,89,Colorado,2015,9911,9517,394,4.0
48,91,Comal,2015,61914,59623,2291,3.7
48,93,Comanche,2015,5361,5132,229,4.3
48,95,Concho,2015,1374,1329,45,3.3
48,97,Cooke,2015,19774,19039,735,3.7
48,99,Coryell,2015,24516,23338,1178,4.8
48,101,Cottle,2015,546,507,39,7.1
48,103,Crane,2015,1838,1731,107,5.8
48,105,Crockett,2015,1901,1786,115,6.0
48,107,Crosby,2015,2649,2533,116,4.4
48,109,Culberson,2015,1041,997,44,4.2
48,111,Dallam,2015,4008,3920,88,2.2
48,113,Dallas,2015,1263314,1208806,54508,4.3
48,115,Dawson,2015,4774,4556,218,4.6
48,117,Deaf Smith,2015,8797,8518,279,3.2
48,119,Delta,2015,2595,2476,119,4.6
48,121,Denton,2015,428668,413303,15365,3.6
48,123,DeWitt,2015,10057,9653,404,4.0
48,125,Dickens,2015,703,670,33,4.7
48,127,Dimmit,2015,7164,6830,334,4.7
48,129,Donley,2015,1594,1527,67,4.2
48,131,Duval,2015,5241,4815,426,8.1
48,133,Eastland,2015,8043,7658,385,4.8
48,135,Ector,2015,79803,76071,3732,4.7
48,137,Edwards,2015,865,825,40,4.6
48,139,Ellis,2015,80979,77765,3214,4.0
48,141,El Paso,2015,341782,323955,17827,5.2
48,143,Erath,2015,20168,19371,797,4.0
48,145,Falls,2015,6457,6181,276,4.3
48,147,Fannin,2015,15382,14746,636,4.1
48,149,Fayette,2015,12778,12351,427,3.3
48,151,Fisher,2015,1801,1731,70,3.9
48,153,Floyd,2015,2746,2593,153,5.6
48,155,Foard,2015,552,529,23,4.2
48,157,Fort Bend,2015,356003,340720,15283,4.3
48,159,Franklin,2015,4559,4335,224,4.9
48,161,Freestone,2015,7414,7009,405,5.5
48,163,Frio,2015,9806,9427,379,3.9
48,165,Gaines,2015,9408,9101,307,3.3
48,167,Galveston,2015,158012,150077,7935,5.0
48,169,Garza,2015,2132,2053,79,3.7
48,171,Gillespie,2015,12647,12280,367,2.9
48,173,Glasscock,2015,822,799,23,2.8
48,175,Goliad,2015,3449,3295,154,4.5
48,177,Gonzales,2015,9703,9344,359,3.7
48,179,Gray,2015,9279,8754,525,5.7
48,181,Grayson,2015,60020,57580,2440,4.1
48,183,Gregg,2015,59308,56347,2961,5.0
48,185,Grimes,2015,11517,10900,617,5.4
48,187,Guadalupe,2015,72967,70371,2596,3.6
48,189,Hale,2015,12894,12069,825,6.4
48,191,Hall,2015,1204,1139,65,5.4
48,193,Hamilton,2015,3485,3321,164,4.7
48,195,Hansford,2015,3113,3020,93,3.0
48,197,Hardeman,2015,1621,1541,80,4.9
48,199,Hardin,2015,25002,23581,1421,5.7
48,201,Harris,2015,2235393,2130793,104600,4.7
48,203,Harrison,2015,31217,29575,1642,5.3
48,205,Hartley,2015,3004,2940,64,2.1
48,207,Haskell,2015,2583,2492,91,3.5
48,209,Hays,2015,98497,95094,3403,3.5
48,211,Hemphill,2015,2302,2229,73,3.2
48,213,Henderson,2015,34384,32700,1684,4.9
48,215,Hidalgo,2015,331119,304695,26424,8.0
48,217,Hill,2015,15623,14907,716,4.6
48,219,Hockley,2015,11723,11232,491,4.2
48,221,Hood,2015,24547,23431,1116,4.5
48,223,Hopkins,2015,17019,16298,721,4.2
48,225,Houston,2015,9941,9495,446,4.5
48,227,Howard,2015,13362,12742,620,4.6
48,229,Hudspeth,2015,1282,1209,73,5.7
48,231,Hunt,2015,38927,37071,1856,4.8
48,233,Hutchinson,2015,9801,9365,436,4.4
48,235,Irion,2015,799,770,29,3.6
48,237,Jack,2015,4079,3906,173,4.2
48,239,Jackson,2015,7371,7092,279,3.8
48,241,Jasper,2015,13887,12841,1046,7.5
48,243,Jeff Davis,2015,1081,1045,36,3.3
48,245,Jefferson,2015,108031,100448,7583,7.0
48,247,Jim Hogg,2015,2029,1882,147,7.2
48,249,Jim Wells,2015,19230,17702,1528,7.9
48,251,Johnson,2015,74321,71032,3289,4.4
48,253,Jones,2015,5671,5357,314,5.5
48,255,Karnes,2015,6429,6155,274,4.3
48,257,Kaufman,2015,55084,52824,2260,4.1
48,259,Kendall,2015,19167,18533,634,3.3
48,261,Kenedy,2015,282,273,9,3.2
48,263,Kent,2015,497,484,13,2.6
48,265,Kerr,2015,21188,20403,785,3.7
48,267,Kimble,2015,2000,1927,73,3.7
48,269,King,2015,200,193,7,3.5
48,271,Kinney,2015,1185,1109,76,6.4
48,273,Kleberg,2015,14405,13548,857,5.9
48,275,Knox,2015,1683,1619,64,3.8
48,277,Lamar,2015,22197,21125,1072,4.8
48,279,Lamb,2015,5513,5017,496,9.0
48,281,Lampasas,2015,9059,8658,401,4.4
48,283,La Salle,2015,4270,4091,179,4.2
48,285,Lavaca,2015,8808,8472,336,3.8
48,287,Lee,2015,9304,8971,333,3.6
48,289,Leon,2015,6936,6563,373,5.4
48,291,Liberty,2015,30968,28813,2155,7.0
48,293,Limestone,2015,8584,8150,434,5.1
48,295,Lipscomb,2015,1725,1657,68,3.9
48,297,Live Oak,2015,5892,5654,238,4.0
48,299,Llano,2015,8152,7803,349,4.3
48,301,Loving,2015,77,73,4,5.2
48,303,Lubbock,2015,149630,144499,5131,3.4
48,305,Lynn,2015,2763,2651,112,4.1
48,307,McCulloch,2015,3925,3735,190,4.8
48,309,McLennan,2015,112616,107995,4621,4.1
48,311,McMullen,2015,969,949,20,2.1
48,313,Madison,2015,5119,4897,222,4.3
48,315,Marion,2015,4417,4128,289,6.5
48,317,Martin,2015,2584,2493,91,3.5
48,319,Mason,2015,1805,1735,70,3.9
48,321,Matagorda,2015,17187,16020,1167,6.8
48,323,Maverick,2015,23666,21126,2540,10.7
48,325,Medina,2015,20431,19531,900,4.4
48,327,Menard,2015,857,812,45,5.3
48,329,Midland,2015,88407,85325,3082,3.5
48,331,Milam,2015,10126,9591,535,5.3
48,333,Mills,2015,1991,1917,74,3.7
48,335,Mitchell,2015,2746,2590,156,5.7
48,337,Montague,2015,9707,9292,415,4.3
48,339,Montgomery,2015,258314,247267,11047,4.3
48,341,Moore,2015,11115,10765,350,3.1
48,343,Morris,2015,5318,4847,471,8.9
48,345,Motley,2015,493,475,18,3.7
48,347,Nacogdoches,2015,28142,26811,1331,4.7
48,349,Navarro,2015,22898,21926,972,4.2
48,351,Newton,2015,5371,4964,407,7.6
48,353,Nolan,2015,6915,6633,282,4.1
48,355,Nueces,2015,165890,157629,8261,5.0
48,357,Ochiltree,2015,5274,5048,226,4.3
48,359,Oldham,2015,914,887,27,3.0
48,361,Orange,2015,37205,34755,2450,6.6
48,363,Palo Pinto,2015,13173,12482,691,5.2
48,365,Panola,2015,11574,10965,609,5.3
48,367,Parker,2015,59589,57095,2494,4.2
48,369,Parmer,2015,4969,4851,118,2.4
48,371,Pecos,2015,6869,6512,357,5.2
48,373,Polk,2015,17049,16009,1040,6.1
48,375,Potter,2015,56271,54382,1889,3.4
48,377,Presidio,2015,3118,2784,334,10.7
48,379,Rains,2015,5414,5165,249,4.6
48,381,Randall,2015,69109,67092,2017,2.9
48,383,Reagan,2015,1929,1841,88,4.6
48,385,Real,2015,1064,1009,55,5.2
48,387,Red River,2015,4912,4600,312,6.4
48,389,Reeves,2015,5680,5406,274,4.8
48,391,Refugio,2015,3308,3131,177,5.4
48,393,Roberts,2015,456,438,18,3.9
48,395,Robertson,2015,7251,6903,348,4.8
48,397,Rockwall,2015,44915,43216,1699,3.8
48,399,Runnels,2015,4673,4498,175,3.7
48,401,Rusk,2015,22853,21758,1095,4.8
48,403,Sabine,2015,3505,3176,329,9.4
48,405,San Augustine,2015,2801,2545,256,9.1
48,407,San Jacinto,2015,11295,10657,638,5.6
48,409,San Patricio,2015,30250,28264,1986,6.6
48,411,San Saba,2015,2246,2163,83,3.7
48,413,Schleicher,2015,1502,1422,80,5.3
48,415,Scurry,2015,8170,7829,341,4.2
48,417,Shackelford,2015,2083,2023,60,2.9
48,419,Shelby,2015,11383,10780,603,5.3
48,421,Sherman,2015,1421,1382,39,2.7
48,423,Smith,2015,103777,99100,4677,4.5
48,425,Somervell,2015,4112,3904,208,5.1
48,427,Starr,2015,25911,22395,3516,13.6
48,429,Stephens,2015,4108,3935,173,4.2
48,431,Sterling,2015,747,721,26,3.5
48,433,Stonewall,2015,663,634,29,4.4
48,435,Sutton,2015,1720,1615,105,6.1
48,437,Swisher,2015,2733,2602,131,4.8
48,439,Tarrant,2015,991895,950296,41599,4.2
48,441,Taylor,2015,63374,61031,2343,3.7
48,443,Terrell,2015,435,414,21,4.8
48,445,Terry,2015,5405,5150,255,4.7
48,447,Throckmorton,2015,781,756,25,3.2
48,449,Titus,2015,12741,12002,739,5.8
48,451,Tom Green,2015,54568,52313,2255,4.1
48,453,Travis,2015,655919,634230,21689,3.3
48,455,Trinity,2015,5485,5159,326,5.9
48,457,Tyler,2015,7371,6851,520,7.1
48,459,Upshur,2015,17983,17032,951,5.3
48,461,Upton,2015,1784,1714,70,3.9
48,463,Uvalde,2015,11687,11093,594,5.1
48,465,Val Verde,2015,19581,18398,1183,6.0
48,467,Van Zandt,2015,24221,23124,1097,4.5
48,469,Victoria,2015,45350,43437,1913,4.2
48,471,Walker,2015,22988,21817,1171,5.1
48,473,Waller,2015,21670,20622,1048,4.8
48,475,Ward,2015,5915,5660,255,4.3
48,477,Washington,2015,15365,14628,737,4.8
48,479,Webb,2015,111837,106503,5334,4.8
48,481,Wharton,2015,21238,20294,944,4.4
48,483,Wheeler,2015,2822,2712,110,3.9
48,485,Wichita,2015,55348,52958,2390,4.3
48,487,Wilbarger,2015,5112,4863,249,4.9
48,489,Willacy,2015,6755,5868,887,13.1
48,491,Williamson,2015,264097,254904,9193,3.5
48,493,Wilson,2015,22981,22103,878,3.8
48,495,Winkler,2015,3104,2926,178,5.7
48,497,Wise,2015,28685,27345,1340,4.7
48,499,Wood,2015,16770,15873,897,5.3
48,501,Yoakum,2015,4047,3894,153,3.8
48,503,Young,2015,8473,8109,364,4.3
48,505,Zapata,2015,6194,5718,476,7.7
48,507,Zavala,2015,3810,3381,429,11.3
49,1,Beaver,2015,3100,2985,115,3.7
49,3,Box Elder,2015,23854,22991,863,3.6
49,5,Cache,2015,59742,57948,1794,3.0
49,7,Carbon,2015,8661,8178,483,5.6
49,9,Daggett,2015,464,443,21,4.5
49,11,Davis,2015,159156,153881,5275,3.3
49,13,Duchesne,2015,8756,8109,647,7.4
49,15,Emery,2015,4377,4117,260,5.9
49,17,Garfield,2015,2737,2498,239,8.7
49,19,Grand,2015,5580,5247,333,6.0
49,21,Iron,2015,20224,19343,881,4.4
49,23,Juab,2015,4912,4721,191,3.9
49,25,Kane,2015,3606,3450,156,4.3
49,27,Millard,2015,6094,5884,210,3.4
49,29,Morgan,2015,4904,4754,150,3.1
49,31,Piute,2015,462,433,29,6.3
49,33,Rich,2015,1040,1003,37,3.6
49,35,Salt Lake,2015,582490,563174,19316,3.3
49,37,San Juan,2015,5683,5243,440,7.7
49,39,Sanpete,2015,11358,10898,460,4.1
49,41,Sevier,2015,9460,9047,413,4.4
49,43,Summit,2015,22953,22208,745,3.2
49,45,Tooele,2015,29380,28188,1192,4.1
49,47,Uintah,2015,15217,14201,1016,6.7
49,49,Utah,2015,264713,256260,8453,3.2
49,51,Wasatch,2015,13190,12736,454,3.4
49,53,Washington,2015,63328,60796,2532,4.0
49,55,Wayne,2015,1405,1280,125,8.9
49,57,Weber,2015,116610,111928,4682,4.0
50,1,Addison,2015,20801,20088,713,3.4
50,3,Bennington,2015,18671,17891,780,4.2
50,5,Caledonia,2015,15158,14460,698,4.6
50,7,Chittenden,2015,95366,92799,2567,2.7
50,9,Essex,2015,2770,2612,158,5.7
50,11,Franklin,2015,27438,26471,967,3.5
50,13,Grand Isle,2015,3955,3799,156,3.9
50,15,Lamoille,2015,13848,13212,636,4.6
50,17,Orange,2015,15978,15435,543,3.4
50,19,Orleans,2015,13661,12908,753,5.5
50,21,Rutland,2015,31435,30111,1324,4.2
50,23,Washington,2015,34236,33055,1181,3.4
50,25,Windham,2015,23577,22745,832,3.5
50,27,Windsor,2015,29621,28678,943,3.2
51,1,Accomack,2015,15938,15082,856,5.4
51,3,Albemarle,2015,54136,52053,2083,3.8
51,5,Alleghany,2015,7075,6722,353,5.0
51,7,Amelia,2015,6215,5941,274,4.4
51,9,Amherst,2015,15340,14618,722,4.7
51,11,Appomattox,2015,7066,6725,341,4.8
51,13,Arlington,2015,144902,140880,4022,2.8
51,15,Augusta,2015,36791,35304,1487,4.0
51,17,Bath,2015,2546,2444,102,4.0
51,19,Bedford,2015,38381,36703,1678,4.4
51,21,Bland,2015,2792,2635,157,5.6
51,23,Botetourt,2015,17459,16738,721,4.1
51,25,Brunswick,2015,6355,5928,427,6.7
51,27,Buchanan,2015,7298,6517,781,10.7
51,29,Buckingham,2015,6317,5948,369,5.8
51,31,Campbell,2015,26328,25100,1228,4.7
51,33,Caroline,2015,14790,14047,743,5.0
51,35,Carroll,2015,13100,12409,691,5.3
51,36,Charles City,2015,3731,3535,196,5.3
51,37,Charlotte,2015,5271,4975,296,5.6
51,41,Chesterfield,2015,178675,171090,7585,4.2
51,43,Clarke,2015,7461,7168,293,3.9
51,45,Craig,2015,2389,2259,130,5.4
51,47,Culpeper,2015,23196,22202,994,4.3
51,49,Cumberland,2015,4573,4341,232,5.1
51,51,Dickenson,2015,4927,4436,491,10.0
51,53,Dinwiddie,2015,13362,12648,714,5.3
51,57,Essex,2015,5531,5238,293,5.3
51,59,Fairfax,2015,616185,594499,21686,3.5
51,61,Fauquier,2015,35873,34477,1396,3.9
51,63,Floyd,2015,8326,7999,327,3.9
51,65,Fluvanna,2015,13214,12724,490,3.7
51,67,Franklin,2015,26550,25328,1222,4.6
51,69,Frederick,2015,44796,43043,1753,3.9
51,71,Giles,2015,7974,7567,407,5.1
51,73,Gloucester,2015,19169,18399,770,4.0
51,75,Goochland,2015,10659,10220,439,4.1
51,77,Grayson,2015,7071,6659,412,5.8
51,79,Greene,2015,9888,9525,363,3.7
51,81,Greensville,2015,4188,3966,222,5.3
51,83,Halifax,2015,15255,14299,956,6.3
51,85,Hanover,2015,56465,54307,2158,3.8
51,87,Henrico,2015,177634,170112,7522,4.2
51,89,Henry,2015,22437,21019,1418,6.3
51,91,Highland,2015,1345,1298,47,3.5
51,93,Isle of Wight,2015,18876,18026,850,4.5
51,95,James City,2015,34430,32960,1470,4.3
51,97,King and Queen,2015,3645,3472,173,4.7
51,99,King George,2015,12101,11533,568,4.7
51,101,King William,2015,8739,8375,364,4.2
51,103,Lancaster,2015,5147,4813,334,6.5
51,105,Lee,2015,8601,7989,612,7.1
51,107,Loudoun,2015,200891,193830,7061,3.5
51,109,Louisa,2015,18866,18078,788,4.2
51,111,Lunenburg,2015,5305,5038,267,5.0
51,113,Madison,2015,7255,7011,244,3.4
51,115,Mathews,2015,4090,3920,170,4.2
51,117,Mecklenburg,2015,12561,11803,758,6.0
51,119,Middlesex,2015,5000,4791,209,4.2
51,121,Montgomery,2015,49925,47798,2127,4.3
51,125,Nelson,2015,7296,7003,293,4.0
51,127,New Kent,2015,11258,10835,423,3.8
51,131,Northampton,2015,6120,5752,368,6.0
51,133,Northumberland,2015,5483,5154,329,6.0
51,135,Nottoway,2015,7158,6838,320,4.5
51,137,Orange,2015,16118,15388,730,4.5
51,139,Page,2015,11684,10891,793,6.8
51,141,Patrick,2015,7667,7258,409,5.3
51,143,Pittsylvania,2015,30185,28606,1579,5.2
51,145,Powhatan,2015,13442,12915,527,3.9
51,147,Prince Edward,2015,10096,9473,623,6.2
51,149,Prince George,2015,14928,14133,795,5.3
51,153,Prince William,2015,232296,222831,9465,4.1
51,155,Pulaski,2015,16373,15556,817,5.0
51,157,Rappahannock,2015,3749,3596,153,4.1
51,159,Richmond,2015,3915,3739,176,4.5
51,161,Roanoke,2015,49273,47365,1908,3.9
51,163,Rockbridge,2015,10363,9882,481,4.6
51,165,Rockingham,2015,40273,38639,1634,4.1
51,167,Russell,2015,11465,10723,742,6.5
51,169,Scott,2015,9537,9052,485,5.1
51,171,Shenandoah,2015,21120,20230,890,4.2
51,173,Smyth,2015,13509,12641,868,6.4
51,175,Southampton,2015,9234,8869,365,4.0
51,177,Spotsylvania,2015,64057,61127,2930,4.6
51,179,Stafford,2015,66918,63975,2943,4.4
51,181,Surry,2015,3731,3545,186,5.0
51,183,Sussex,2015,4088,3812,276,6.8
51,185,Tazewell,2015,16670,15454,1216,7.3
51,187,Warren,2015,19697,18773,924,4.7
51,191,Washington,2015,27083,25804,1279,4.7
51,193,Westmoreland,2015,8954,8478,476,5.3
51,195,Wise,2015,13831,12701,1130,8.2
51,197,Wythe,2015,13694,12961,733,5.4
51,199,York,2015,32121,30763,1358,4.2
51,510,Alexandria city,2015,94551,91485,3066,3.2
51,520,Bristol city,2015,7541,7143,398,5.3
51,530,Buena Vista city,2015,3307,3141,166,5.0
51,540,Charlottesville city,2015,24746,23846,900,3.6
51,550,Chesapeake city,2015,116777,111550,5227,4.5
51,570,Colonial Heights city,2015,8700,8295,405,4.7
51,580,Covington city,2015,2427,2283,144,5.9
51,590,Danville city,2015,19184,17819,1365,7.1
51,595,Emporia city,2015,2252,2098,154,6.8
51,600,Fairfax city,2015,12853,12409,444,3.5
51,610,Falls Church city,2015,7878,7641,237,3.0
51,620,Franklin city,2015,3622,3382,240,6.6
51,630,Fredericksburg city,2015,13419,12712,707,5.3
51,640,Galax city,2015,2957,2798,159,5.4
51,650,Hampton city,2015,64501,60682,3819,5.9
51,660,Harrisonburg city,2015,23977,22722,1255,5.2
51,670,Hopewell city,2015,9655,8933,722,7.5
51,678,Lexington city,2015,2260,2108,152,6.7
51,680,Lynchburg city,2015,35763,33791,1972,5.5
51,683,Manassas city,2015,21681,20794,887,4.1
51,685,Manassas Park city,2015,8367,8022,345,4.1
51,690,Martinsville city,2015,5375,4909,466,8.7
51,700,Newport News city,2015,89143,84369,4774,5.4
51,710,Norfolk city,2015,110946,104840,6106,5.5
51,720,Norton city,2015,1739,1620,119,6.8
51,730,Petersburg city,2015,13547,12320,1227,9.1
51,735,Poquoson city,2015,6226,5988,238,3.8
51,740,Portsmouth city,2015,44417,41689,2728,6.1
51,750,Radford city,2015,8323,7859,464,5.6
51,760,Richmond city,2015,113141,107324,5817,5.1
51,770,Roanoke city,2015,49096,46728,2368,4.8
51,775,Salem city,2015,12816,12258,558,4.4
51,790,Staunton city,2015,11857,11348,509,4.3
51,800,Suffolk city,2015,42458,40380,2078,4.9
51,810,Virginia Beach city,2015,229696,219985,9711,4.2
51,820,Waynesboro city,2015,10050,9576,474,4.7
51,830,Williamsburg city,2015,6682,6264,418,6.3
51,840,Winchester city,2015,14256,13640,616,4.3
53,1,Adams,2015,8617,8038,579,6.7
53,3,Asotin,2015,9682,9234,448,4.6
53,5,Benton,2015,91733,85797,5936,6.5
53,7,Chelan,2015,42646,40344,2302,5.4
53,9,Clallam,2015,26784,24680,2104,7.9
53,11,Clark,2015,214327,200966,13361,6.2
53,13,Columbia,2015,1693,1586,107,6.3
53,15,Cowlitz,2015,44093,40793,3300,7.5
53,17,Douglas,2015,19772,18547,1225,6.2
53,19,Ferry,2015,2472,2228,244,9.9
53,21,Franklin,2015,38958,36088,2870,7.4
53,23,Garfield,2015,930,874,56,6.0
53,25,Grant,2015,44688,41531,3157,7.1
53,27,Grays Harbor,2015,26897,24532,2365,8.8
53,29,Island,2015,31766,29885,1881,5.9
53,31,Jefferson,2015,11196,10422,774,6.9
53,33,King,2015,1185074,1136052,49022,4.1
53,35,Kitsap,2015,115388,109174,6214,5.4
53,37,Kittitas,2015,20846,19591,1255,6.0
53,39,Klickitat,2015,9454,8796,658,7.0
53,41,Lewis,2015,31203,28657,2546,8.2
53,43,Lincoln,2015,4877,4601,276,5.7
53,45,Mason,2015,23007,21259,1748,7.6
53,47,Okanogan,2015,21230,19803,1427,6.7
53,49,Pacific,2015,8091,7385,706,8.7
53,51,Pend Oreille,2015,4596,4165,431,9.4
53,53,Pierce,2015,392279,367880,24399,6.2
53,55,San Juan,2015,7724,7363,361,4.7
53,57,Skagit,2015,56687,52969,3718,6.6
53,59,Skamania,2015,4946,4591,355,7.2
53,61,Snohomish,2015,404003,385767,18236,4.5
53,63,Spokane,2015,227863,213461,14402,6.3
53,65,Stevens,2015,17432,15924,1508,8.7
53,67,Thurston,2015,125761,118488,7273,5.8
53,69,Wahkiakum,2015,1291,1179,112,8.7
53,71,Walla Walla,2015,28056,26459,1597,5.7
53,73,Whatcom,2015,104286,98270,6016,5.8
53,75,Whitman,2015,22767,21694,1073,4.7
53,77,Yakima,2015,121715,112179,9536,7.8
54,1,Barbour,2015,6979,6476,503,7.2
54,3,Berkeley,2015,54578,51968,2610,4.8
54,5,Boone,2015,8277,7490,787,9.5
54,7,Braxton,2015,5523,5042,481,8.7
54,9,Brooke,2015,10204,9475,729,7.1
54,11,Cabell,2015,41790,39572,2218,5.3
54,13,Calhoun,2015,2790,2450,340,12.2
54,15,Clay,2015,3307,2946,361,10.9
54,17,Doddridge,2015,3687,3488,199,5.4
54,19,Fayette,2015,16464,15083,1381,8.4
54,21,Gilmer,2015,2737,2528,209,7.6
54,23,Grant,2015,5830,5399,431,7.4
54,25,Greenbrier,2015,15543,14548,995,6.4
54,27,Hampshire,2015,9739,9209,530,5.4
54,29,Hancock,2015,13147,12146,1001,7.6
54,31,Hardy,2015,5533,5129,404,7.3
54,33,Harrison,2015,32228,30244,1984,6.2
54,35,Jackson,2015,12050,11202,848,7.0
54,37,Jefferson,2015,28100,26973,1127,4.0
54,39,Kanawha,2015,87250,82145,5105,5.9
54,41,Lewis,2015,7057,6489,568,8.0
54,43,Lincoln,2015,7437,6729,708,9.5
54,45,Logan,2015,11620,10345,1275,11.0
54,47,McDowell,2015,5399,4726,673,12.5
54,49,Marion,2015,26326,24564,1762,6.7
54,51,Marshall,2015,14211,13035,1176,8.3
54,53,Mason,2015,10078,9241,837,8.3
54,55,Mercer,2015,22225,20650,1575,7.1
54,57,Mineral,2015,11757,10915,842,7.2
54,59,Mingo,2015,7303,6362,941,12.9
54,61,Monongalia,2015,51084,48736,2348,4.6
54,63,Monroe,2015,5818,5502,316,5.4
54,65,Morgan,2015,7563,7158,405,5.4
54,67,Nicholas,2015,10046,9158,888,8.8
54,69,Ohio,2015,20909,19764,1145,5.5
54,71,Pendleton,2015,3618,3454,164,4.5
54,73,Pleasants,2015,3019,2768,251,8.3
54,75,Pocahontas,2015,3632,3343,289,8.0
54,77,Preston,2015,14811,13909,902,6.1
54,79,Putnam,2015,25842,24430,1412,5.5
54,81,Raleigh,2015,30696,28484,2212,7.2
54,83,Randolph,2015,12037,11213,824,6.8
54,85,Ritchie,2015,4546,4236,310,6.8
54,87,Roane,2015,5278,4685,593,11.2
54,89,Summers,2015,4573,4259,314,6.9
54,91,Taylor,2015,7832,7374,458,5.8
54,93,Tucker,2015,3465,3258,207,6.0
54,95,Tyler,2015,3697,3359,338,9.1
54,97,Upshur,2015,9771,9005,766,7.8
54,99,Wayne,2015,15751,14657,1094,6.9
54,101,Webster,2015,3512,3253,259,7.4
54,103,Wetzel,2015,7238,6531,707,9.8
54,105,Wirt,2015,2281,2050,231,10.1
54,107,Wood,2015,37513,35206,2307,6.1
54,109,Wyoming,2015,7833,7095,738,9.4
55,1,Adams,2015,8302,7713,589,7.1
55,3,Ashland,2015,7901,7418,483,6.1
55,5,Barron,2015,24396,23207,1189,4.9
55,7,Bayfield,2015,7505,6894,611,8.1
55,9,Brown,2015,138906,133376,5530,4.0
55,11,Buffalo,2015,6518,6206,312,4.8
55,13,Burnett,2015,7249,6754,495,6.8
55,15,Calumet,2015,27398,26443,955,3.5
55,17,Chippewa,2015,33064,31542,1522,4.6
55,19,Clark,2015,17384,16641,743,4.3
55,21,Columbia,2015,31265,29930,1335,4.3
55,23,Crawford,2015,7882,7432,450,5.7
55,25,Dane,2015,310088,300430,9658,3.1
55,27,Dodge,2015,47425,45384,2041,4.3
55,29,Door,2015,15436,14433,1003,6.5
55,31,Douglas,2015,23293,22165,1128,4.8
55,33,Dunn,2015,23715,22673,1042,4.4
55,35,Eau Claire,2015,58024,55864,2160,3.7
55,37,Florence,2015,2206,2061,145,6.6
55,39,Fond du Lac,2015,56896,54630,2266,4.0
55,41,Forest,2015,3984,3693,291,7.3
55,43,Grant,2015,28094,26891,1203,4.3
55,45,Green,2015,21042,20259,783,3.7
55,47,Green Lake,2015,9966,9439,527,5.3
55,49,Iowa,2015,13659,13093,566,4.1
55,51,Iron,2015,2612,2388,224,8.6
55,53,Jackson,2015,10321,9840,481,4.7
55,55,Jefferson,2015,45541,43657,1884,4.1
55,57,Juneau,2015,13475,12799,676,5.0
55,59,Kenosha,2015,87124,82773,4351,5.0
55,61,Kewaunee,2015,10867,10433,434,4.0
55,63,La Crosse,2015,66464,63958,2506,3.8
55,65,Lafayette,2015,9725,9376,349,3.6
55,67,Langlade,2015,9447,8886,561,5.9
55,69,Lincoln,2015,15217,14475,742,4.9
55,71,Manitowoc,2015,41789,39741,2048,4.9
55,73,Marathon,2015,73287,70401,2886,3.9
55,75,Marinette,2015,20691,19515,1176,5.7
55,77,Marquette,2015,7476,7028,448,6.0
55,78,Menominee,2015,1598,1447,151,9.4
55,79,Milwaukee,2015,475735,448993,26742,5.6
55,81,Monroe,2015,22778,21787,991,4.4
55,83,Oconto,2015,20288,19266,1022,5.0
55,85,Oneida,2015,18582,17536,1046,5.6
55,87,Outagamie,2015,101717,97778,3939,3.9
55,89,Ozaukee,2015,48129,46393,1736,3.6
55,91,Pepin,2015,4097,3930,167,4.1
55,93,Pierce,2015,24077,23152,925,3.8
55,95,Polk,2015,24544,23386,1158,4.7
55,97,Portage,2015,39484,37715,1769,4.5
55,99,Price,2015,6834,6537,297,4.3
55,101,Racine,2015,99081,93644,5437,5.5
55,103,Richland,2015,9271,8891,380,4.1
55,105,Rock,2015,83122,78910,4212,5.1
55,107,Rusk,2015,6978,6605,373,5.3
55,109,St. Croix,2015,48697,46875,1822,3.7
55,111,Sauk,2015,35218,33806,1412,4.0
55,113,Sawyer,2015,7787,7187,600,7.7
55,115,Shawano,2015,21231,20221,1010,4.8
55,117,Sheboygan,2015,61110,58857,2253,3.7
55,119,Taylor,2015,10672,10214,458,4.3
55,121,Trempealeau,2015,16576,15943,633,3.8
55,123,Vernon,2015,15456,14836,620,4.0
55,125,Vilas,2015,9970,9287,683,6.9
55,127,Walworth,2015,56843,54266,2577,4.5
55,129,Washburn,2015,7935,7519,416,5.2
55,131,Washington,2015,75890,73109,2781,3.7
55,133,Waukesha,2015,220891,212689,8202,3.7
55,135,Waupaca,2015,26970,25748,1222,4.5
55,137,Waushara,2015,11454,10751,703,6.1
55,139,Winnebago,2015,91233,87453,3780,4.1
55,141,Wood,2015,34328,32481,1847,5.4
56,1,Albany,2015,20471,19836,635,3.1
56,3,Big Horn,2015,5513,5272,241,4.4
56,5,Campbell,2015,25599,24606,993,3.9
56,7,Carbon,2015,8368,8061,307,3.7
56,9,Converse,2015,8247,7949,298,3.6
56,11,Crook,2015,3679,3552,127,3.5
56,13,Fremont,2015,20074,18977,1097,5.5
56,15,Goshen,2015,7023,6795,228,3.2
56,17,Hot Springs,2015,2380,2282,98,4.1
56,19,Johnson,2015,4167,3966,201,4.8
56,21,Laramie,2015,48225,46341,1884,3.9
56,23,Lincoln,2015,8343,7955,388,4.7
56,25,Natrona,2015,42482,40431,2051,4.8
56,27,Niobrara,2015,1317,1278,39,3.0
56,29,Park,2015,15637,14974,663,4.2
56,31,Platte,2015,4871,4683,188,3.9
56,33,Sheridan,2015,15799,15139,660,4.2
56,35,Sublette,2015,4531,4298,233,5.1
56,37,Sweetwater,2015,22556,21509,1047,4.6
56,39,Teton,2015,14574,14016,558,3.8
56,41,Uinta,2015,9593,9120,473,4.9
56,43,Washakie,2015,4233,4058,175,4.1
56,45,Weston,2015,3930,3798,132,3.4
72,1,Adjuntas Municipio,2015,4385,3608,777,17.7
72,3,Aguada Municipio,2015,11826,10172,1654,14.0
72,5,Aguadilla Municipio,2015,14768,12694,2074,14.0
72,7,Aguas Buenas Municipio,2015,6828,5830,998,14.6
72,9,Aibonito Municipio,2015,6648,5678,970,14.6
72,11,Anasco Municipio,2015,8857,7702,1155,13.0
72,13,Arecibo Municipio,2015,23927,20600,3327,13.9
72,15,Arroyo Municipio,2015,5191,4213,978,18.8
72,17,Barceloneta Municipio,2015,5908,5010,898,15.2
72,19,Barranquitas Municipio,2015,7422,6439,983,13.2
72,21,Bayamon Municipio,2015,67355,61093,6262,9.3
72,23,Cabo Rojo Municipio,2015,14132,12404,1728,12.2
72,25,Caguas Municipio,2015,48445,43426,5019,10.4
72,27,Camuy Municipio,2015,9429,8217,1212,12.9
72,29,Canovanas Municipio,2015,16270,14358,1912,11.8
72,31,Carolina Municipio,2015,62770,57222,5548,8.8
72,33,Catano Municipio,2015,8048,7207,841,10.4
72,35,Cayey Municipio,2015,16237,14493,1744,10.7
72,37,Ceiba Municipio,2015,3866,3331,535,13.8
72,39,Ciales Municipio,2015,3915,3235,680,17.4
72,41,Cidra Municipio,2015,15546,14001,1545,9.9
72,43,Coamo Municipio,2015,11020,8939,2081,18.9
72,45,Comerio Municipio,2015,5155,4370,785,15.2
72,47,Corozal Municipio,2015,9419,8152,1267,13.5
72,49,Culebra Municipio,2015,844,813,31,3.7
72,51,Dorado Municipio,2015,12803,11802,1001,7.8
72,53,Fajardo Municipio,2015,11552,9848,1704,14.8
72,54,Florida Municipio,2015,3400,2892,508,14.9
72,55,Guanica Municipio,2015,4204,3380,824,19.6
72,57,Guayama Municipio,2015,12242,10123,2119,17.3
72,59,Guayanilla Municipio,2015,5319,4284,1035,19.5
72,61,Guaynabo Municipio,2015,37218,35051,2167,5.8
72,63,Gurabo Municipio,2015,17292,15789,1503,8.7
72,65,Hatillo Municipio,2015,13064,11024,2040,15.6
72,67,Hormigueros Municipio,2015,5583,4934,649,11.6
72,69,Humacao Municipio,2015,17646,15044,2602,14.7
72,71,Isabela Municipio,2015,12313,10760,1553,12.6
72,73,Jayuya Municipio,2015,4158,3543,615,14.8
72,75,Juana Diaz Municipio,2015,15758,13369,2389,15.2
72,77,Juncos Municipio,2015,12478,10743,1735,13.9
72,79,Lajas Municipio,2015,5609,4603,1006,17.9
72,81,Lares Municipio,2015,7358,5860,1498,20.4
72,83,Las Marias Municipio,2015,2887,2401,486,16.8
72,85,Las Piedras Municipio,2015,11350,9757,1593,14.0
72,87,Loiza Municipio,2015,8793,7760,1033,11.7
72,89,Luquillo Municipio,2015,6455,5451,1004,15.6
72,91,Manati Municipio,2015,11674,10291,1383,11.8
72,93,Maricao Municipio,2015,1855,1549,306,16.5
72,95,Maunabo Municipio,2015,3038,2478,560,18.4
72,97,Mayaguez Municipio,2015,23411,20248,3163,13.5
72,99,Moca Municipio,2015,10641,8981,1660,15.6
72,101,Morovis Municipio,2015,8137,6992,1145,14.1
72,103,Naguabo Municipio,2015,8088,7023,1065,13.2
72,105,Naranjito Municipio,2015,7307,6308,999,13.7
72,107,Orocovis Municipio,2015,5254,4396,858,16.3
72,109,Patillas Municipio,2015,4847,3837,1010,20.8
72,111,Penuelas Municipio,2015,6247,5155,1092,17.5
72,113,Ponce Municipio,2015,48408,41686,6722,13.9
72,115,Quebradillas Municipio,2015,6038,5025,1013,16.8
72,117,Rincon Municipio,2015,4639,3874,765,16.5
72,119,Rio Grande Municipio,2015,17061,15297,1764,10.3
72,121,Sabana Grande Municipio,2015,6366,5425,941,14.8
72,123,Salinas Municipio,2015,7897,5992,1905,24.1
72,125,San German Municipio,2015,10330,8872,1458,14.1
72,127,San Juan Municipio,2015,135762,125441,10321,7.6
72,129,San Lorenzo Municipio,2015,11979,10410,1569,13.1
72,131,San Sebastian Municipio,2015,10677,8555,2122,19.9
72,133,Santa Isabel Municipio,2015,9533,7791,1742,18.3
72,135,Toa Alta Municipio,2015,26336,24140,2196,8.3
72,137,Toa Baja Municipio,2015,30030,27316,2714,9.0
72,139,Trujillo Alto Municipio,2015,27212,25308,1904,7.0
72,141,Utuado Municipio,2015,6925,5817,1108,16.0
72,143,Vega Alta Municipio,2015,9872,8719,1153,11.7
72,145,Vega Baja Municipio,2015,13820,11921,1899,13.7
72,147,Vieques Municipio,2015,3194,2832,362,11.3
72,149,Villalba Municipio,2015,7802,6262,1540,19.7
72,151,Yabucoa Municipio,2015,9198,7593,1605,17.4
72,153,Yauco Municipio,2015,10748,8717,2031,18.9
1,1,Autauga,2016,25710,24395,1315,5.1
1,3,Baldwin,2016,89778,84972,4806,5.4
1,5,Barbour,2016,8334,7638,696,8.4
1,7,Bibb,2016,8539,7986,553,6.5
1,9,Blount,2016,24380,23061,1319,5.4
1,11,Bullock,2016,4785,4457,328,6.9
1,13,Butler,2016,9116,8484,632,6.9
1,15,Calhoun,2016,45450,42470,2980,6.6
1,17,Chambers,2016,14858,14044,814,5.5
1,19,Cherokee,2016,11241,10671,570,5.1
1,21,Chilton,2016,19029,17982,1047,5.5
1,23,Choctaw,2016,4292,3926,366,8.5
1,25,Clarke,2016,7889,7030,859,10.9
1,27,Clay,2016,5579,5247,332,6.0
1,29,Cleburne,2016,5738,5394,344,6.0
1,31,Coffee,2016,20429,19227,1202,5.9
1,33,Colbert,2016,23261,21640,1621,7.0
1,35,Conecuh,2016,4512,4131,381,8.4
1,37,Coosa,2016,4344,4084,260,6.0
1,39,Covington,2016,15366,14325,1041,6.8
1,41,Crenshaw,2016,6401,6024,377,5.9
1,43,Cullman,2016,37594,35720,1874,5.0
1,45,Dale,2016,19796,18648,1148,5.8
1,47,Dallas,2016,15293,13880,1413,9.2
1,49,DeKalb,2016,28996,27232,1764,6.1
1,51,Elmore,2016,36921,35161,1760,4.8
1,53,Escambia,2016,14433,13472,961,6.7
1,55,Etowah,2016,42914,40372,2542,5.9
1,57,Fayette,2016,6542,6100,442,6.8
1,59,Franklin,2016,13752,12941,811,5.9
1,61,Geneva,2016,10720,10097,623,5.8
1,63,Greene,2016,2848,2564,284,10.0
1,65,Hale,2016,5933,5478,455,7.7
1,67,Henry,2016,6666,6231,435,6.5
1,69,Houston,2016,44185,41621,2564,5.8
1,71,Jackson,2016,23390,21911,1479,6.3
1,73,Jefferson,2016,308632,290887,17745,5.7
1,75,Lamar,2016,5643,5324,319,5.7
1,77,Lauderdale,2016,42180,39490,2690,6.4
1,79,Lawrence,2016,13607,12665,942,6.9
1,81,Lee,2016,71759,67995,3764,5.2
1,83,Limestone,2016,40349,38229,2120,5.3
1,85,Lowndes,2016,3770,3371,399,10.6
1,87,Macon,2016,7803,7208,595,7.6
1,89,Madison,2016,172125,163288,8837,5.1
1,91,Marengo,2016,7608,7063,545,7.2
1,93,Marion,2016,12394,11572,822,6.6
1,95,Marshall,2016,41240,39034,2206,5.3
1,97,Mobile,2016,186230,173856,12374,6.6
1,99,Monroe,2016,7255,6596,659,9.1
1,101,Montgomery,2016,104883,98929,5954,5.7
1,103,Morgan,2016,54413,51395,3018,5.5
1,105,Perry,2016,3438,3083,355,10.3
1,107,Pickens,2016,7702,7172,530,6.9
1,109,Pike,2016,14825,13860,965,6.5
1,111,Randolph,2016,9350,8827,523,5.6
1,113,Russell,2016,23338,22038,1300,5.6
1,115,St. Clair,2016,38757,36745,2012,5.2
1,117,Shelby,2016,108670,103986,4684,4.3
1,119,Sumter,2016,5069,4678,391,7.7
1,121,Talladega,2016,34528,32244,2284,6.6
1,123,Tallapoosa,2016,18426,17396,1030,5.6
1,125,Tuscaloosa,2016,98431,92864,5567,5.7
1,127,Walker,2016,25356,23465,1891,7.5
1,129,Washington,2016,6686,6109,577,8.6
1,131,Wilcox,2016,2795,2391,404,14.5
1,133,Winston,2016,9455,8783,672,7.1
2,13,Aleutians East Borough,2016,2589,2523,66,2.5
2,16,Aleutians West Census Area,2016,3982,3856,126,3.2
2,20,Anchorage Borough/municipality,2016,155471,147254,8217,5.3
2,50,Bethel Census Area,2016,7219,6230,989,13.7
2,60,Bristol Bay Borough,2016,413,385,28,6.8
2,68,Denali Borough,2016,1091,996,95,8.7
2,70,Dillingham Census Area,2016,2073,1881,192,9.3
2,90,Fairbanks North Star Borough,2016,46443,43824,2619,5.6
2,100,Haines Borough,2016,1071,966,105,9.8
2,105,Hoonah-Angoon Census Area,2016,1200,1064,136,11.3
2,110,Juneau Borough/city,2016,17343,16599,744,4.3
2,122,Kenai Peninsula Borough,2016,27123,24906,2217,8.2
2,130,Ketchikan Gateway Borough,2016,7019,6581,438,6.2
2,150,Kodiak Island Borough,2016,6418,6101,317,4.9
2,158,Kusilvak Census Area,2016,2706,2142,564,20.8
2,164,Lake and Peninsula Borough,2016,653,575,78,11.9
2,170,Matanuska-Susitna Borough,2016,47353,43613,3740,7.9
2,180,Nome Census Area,2016,4072,3574,498,12.2
2,185,North Slope Borough,2016,3951,3694,257,6.5
2,188,Northwest Arctic Borough,2016,2950,2496,454,15.4
2,195,Petersburg Borough,2016,1447,1322,125,8.6
2,198,Prince of Wales-Hyder Census Area,2016,2760,2437,323,11.7
2,220,Sitka Borough/city,2016,4373,4179,194,4.4
2,230,Skagway Municipality,2016,803,717,86,10.7
2,240,Southeast Fairbanks Census Area,2016,2990,2681,309,10.3
2,261,Valdez-Cordova Census Area,2016,4802,4406,396,8.2
2,275,Wrangell Borough/city,2016,1053,977,76,7.2
2,282,Yakutat Borough/city,2016,244,224,20,8.2
2,290,Yukon-Koyukuk Census Area,2016,2408,1994,414,17.2
4,1,Apache,2016,20418,18042,2376,11.6
4,3,Cochise,2016,49799,46647,3152,6.3
4,5,Coconino,2016,74484,69930,4554,6.1
4,7,Gila,2016,21084,19536,1548,7.3
4,9,Graham,2016,14433,13445,988,6.8
4,11,Greenlee,2016,3916,3615,301,7.7
4,12,La Paz,2016,8506,7983,523,6.1
4,13,Maricopa,2016,2088551,1991371,97180,4.7
4,15,Mohave,2016,80843,75410,5433,6.7
4,17,Navajo,2016,41511,38030,3481,8.4
4,19,Pima,2016,471452,447695,23757,5.0
4,21,Pinal,2016,164605,155330,9275,5.6
4,23,Santa Cruz,2016,19282,17317,1965,10.2
4,25,Yavapai,2016,99916,94913,5003,5.0
4,27,Yuma,2016,94671,76590,18081,19.1
5,1,Arkansas,2016,9284,8967,317,3.4
5,3,Ashley,2016,7966,7477,489,6.1
5,5,Baxter,2016,16130,15435,695,4.3
5,7,Benton,2016,128130,124390,3740,2.9
5,9,Boone,2016,15957,15370,587,3.7
5,11,Bradley,2016,4491,4265,226,5.0
5,13,Calhoun,2016,2396,2286,110,4.6
5,15,Carroll,2016,12891,12432,459,3.6
5,17,Chicot,2016,3590,3353,237,6.6
5,19,Clark,2016,9589,9173,416,4.3
5,21,Clay,2016,6048,5706,342,5.7
5,23,Cleburne,2016,9500,8935,565,5.9
5,25,Cleveland,2016,3349,3198,151,4.5
5,27,Columbia,2016,9313,8781,532,5.7
5,29,Conway,2016,8468,7983,485,5.7
5,31,Craighead,2016,52315,50613,1702,3.3
5,33,Crawford,2016,26995,25941,1054,3.9
5,35,Crittenden,2016,21642,20664,978,4.5
5,37,Cross,2016,7897,7547,350,4.4
5,39,Dallas,2016,2987,2842,145,4.9
5,41,Desha,2016,5455,5157,298,5.5
5,43,Drew,2016,8002,7549,453,5.7
5,45,Faulkner,2016,60654,58345,2309,3.8
5,47,Franklin,2016,7378,7079,299,4.1
5,49,Fulton,2016,4675,4472,203,4.3
5,51,Garland,2016,40152,38421,1731,4.3
5,53,Grant,2016,8288,7989,299,3.6
5,55,Greene,2016,19839,18987,852,4.3
5,57,Hempstead,2016,10019,9643,376,3.8
5,59,Hot Spring,2016,14139,13582,557,3.9
5,61,Howard,2016,5989,5793,196,3.3
5,63,Independence,2016,16039,15243,796,5.0
5,65,Izard,2016,4976,4696,280,5.6
5,67,Jackson,2016,6068,5689,379,6.2
5,69,Jefferson,2016,28373,26779,1594,5.6
5,71,Johnson,2016,10551,10049,502,4.8
5,73,Lafayette,2016,2586,2435,151,5.8
5,75,Lawrence,2016,6929,6628,301,4.3
5,77,Lee,2016,3098,2951,147,4.7
5,79,Lincoln,2016,4102,3904,198,4.8
5,81,Little River,2016,5602,5339,263,4.7
5,83,Logan,2016,9145,8724,421,4.6
5,85,Lonoke,2016,33442,32327,1115,3.3
5,87,Madison,2016,7297,7063,234,3.2
5,89,Marion,2016,6532,6271,261,4.0
5,91,Miller,2016,19904,19067,837,4.2
5,93,Mississippi,2016,18099,16869,1230,6.8
5,95,Monroe,2016,2886,2747,139,4.8
5,97,Montgomery,2016,3133,2972,161,5.1
5,99,Nevada,2016,3650,3515,135,3.7
5,101,Newton,2016,3417,3284,133,3.9
5,103,Ouachita,2016,9897,9399,498,5.0
5,105,Perry,2016,4174,3974,200,4.8
5,107,Phillips,2016,6668,6274,394,5.9
5,109,Pike,2016,4228,4048,180,4.3
5,111,Poinsett,2016,10108,9675,433,4.3
5,113,Polk,2016,8194,7794,400,4.9
5,115,Pope,2016,29332,27981,1351,4.6
5,117,Prairie,2016,3656,3516,140,3.8
5,119,Pulaski,2016,187419,180752,6667,3.6
5,121,Randolph,2016,6534,6232,302,4.6
5,123,St. Francis,2016,8855,8394,461,5.2
5,125,Saline,2016,56952,55170,1782,3.1
5,127,Scott,2016,4469,4305,164,3.7
5,129,Searcy,2016,2994,2857,137,4.6
5,131,Sebastian,2016,57697,55543,2154,3.7
5,133,Sevier,2016,5704,5427,277,4.9
5,135,Sharp,2016,6062,5731,331,5.5
5,137,Stone,2016,4748,4504,244,5.1
5,139,Union,2016,16401,15504,897,5.5
5,141,Van Buren,2016,6113,5692,421,6.9
5,143,Washington,2016,118574,115300,3274,2.8
5,145,White,2016,34092,32318,1774,5.2
5,147,Woodruff,2016,2974,2811,163,5.5
5,149,Yell,2016,8700,8311,389,4.5
6,1,Alameda,2016,831827,796037,35790,4.3
6,3,Alpine,2016,554,518,36,6.5
6,5,Amador,2016,14525,13658,867,6.0
6,7,Butte,2016,101648,94909,6739,6.6
6,9,Calaveras,2016,20798,19615,1183,5.7
6,11,Colusa,2016,10908,9205,1703,15.6
6,13,Contra Costa,2016,553221,528401,24820,4.5
6,15,Del Norte,2016,9755,9019,736,7.5
6,17,El Dorado,2016,88824,84248,4576,5.2
6,19,Fresno,2016,444737,402364,42373,9.5
6,21,Glenn,2016,12949,11867,1082,8.4
6,23,Humboldt,2016,62424,59338,3086,4.9
6,25,Imperial,2016,75186,56998,18188,24.2
6,27,Inyo,2016,8860,8390,470,5.3
6,29,Kern,2016,388109,347692,40417,10.4
6,31,Kings,2016,57161,51446,5715,10.0
6,33,Lake,2016,29067,27108,1959,6.7
6,35,Lassen,2016,10363,9642,721,7.0
6,37,Los Angeles,2016,5018920,4751209,267711,5.3
6,39,Madera,2016,61051,55393,5658,9.3
6,41,Marin,2016,139632,135040,4592,3.3
6,43,Mariposa,2016,7568,7048,520,6.9
6,45,Mendocino,2016,39617,37521,2096,5.3
6,47,Merced,2016,114339,102211,12128,10.6
6,49,Modoc,2016,3292,3034,258,7.8
6,51,Mono,2016,8365,7915,450,5.4
6,53,Monterey,2016,218802,201971,16831,7.7
6,55,Napa,2016,72941,69799,3142,4.3
6,57,Nevada,2016,48147,45838,2309,4.8
6,59,Orange,2016,1597447,1532725,64722,4.1
6,61,Placer,2016,179634,171550,8084,4.5
6,63,Plumas,2016,7851,7085,766,9.8
6,65,Riverside,2016,1051610,987187,64423,6.1
6,67,Sacramento,2016,693979,656360,37619,5.4
6,69,San Benito,2016,30434,28398,2036,6.7
6,71,San Bernardino,2016,930242,876387,53855,5.8
6,73,San Diego,2016,1563246,1489143,74103,4.7
6,75,San Francisco/city,2016,555316,536972,18344,3.3
6,77,San Joaquin,2016,318316,292367,25949,8.2
6,79,San Luis Obispo,2016,139484,133438,6046,4.3
6,81,San Mateo,2016,441792,428282,13510,3.1
6,83,Santa Barbara,2016,215256,204329,10927,5.1
6,85,Santa Clara,2016,1027918,989048,38870,3.8
6,87,Santa Cruz,2016,143764,133730,10034,7.0
6,89,Shasta,2016,74207,69019,5188,7.0
6,91,Sierra,2016,1334,1232,102,7.6
6,93,Siskiyou,2016,17896,16370,1526,8.5
6,95,Solano,2016,207273,195835,11438,5.5
6,97,Sonoma,2016,259214,248876,10338,4.0
6,99,Stanislaus,2016,242737,221769,20968,8.6
6,101,Sutter,2016,44983,40612,4371,9.7
6,103,Tehama,2016,25071,23280,1791,7.1
6,105,Trinity,2016,4993,4638,355,7.1
6,107,Tulare,2016,203292,180503,22789,11.2
6,109,Tuolumne,2016,21567,20221,1346,6.2
6,111,Ventura,2016,425346,403087,22259,5.2
6,113,Yolo,2016,106078,99812,6266,5.9
6,115,Yuba,2016,28153,25722,2431,8.6
8,1,Adams,2016,253599,244903,8696,3.4
8,3,Alamosa,2016,7964,7657,307,3.9
8,5,Arapahoe,2016,340623,330532,10091,3.0
8,7,Archuleta,2016,6365,6165,200,3.1
8,9,Baca,2016,2093,2059,34,1.6
8,11,Bent,2016,1851,1797,54,2.9
8,13,Boulder,2016,180901,176286,4615,2.6
8,14,Broomfield/city,2016,36784,35767,1017,2.8
8,15,Chaffee,2016,8843,8619,224,2.5
8,17,Cheyenne,2016,1081,1058,23,2.1
8,19,Clear Creek,2016,5686,5513,173,3.0
8,21,Conejos,2016,3769,3594,175,4.6
8,23,Costilla,2016,1728,1648,80,4.6
8,25,Crowley,2016,1422,1374,48,3.4
8,27,Custer,2016,2019,1958,61,3.0
8,29,Delta,2016,13948,13293,655,4.7
8,31,Denver/city,2016,385108,373645,11463,3.0
8,33,Dolores,2016,1071,1031,40,3.7
8,35,Douglas,2016,177570,173042,4528,2.5
8,37,Eagle,2016,33733,32848,885,2.6
8,39,Elbert,2016,13802,13460,342,2.5
8,41,El Paso,2016,314650,303352,11298,3.6
8,43,Fremont,2016,14695,13968,727,4.9
8,45,Garfield,2016,30994,29959,1035,3.3
8,47,Gilpin,2016,3485,3406,79,2.3
8,49,Grand,2016,9191,8955,236,2.6
8,51,Gunnison,2016,10140,9918,222,2.2
8,53,Hinsdale,2016,447,437,10,2.2
8,55,Huerfano,2016,2497,2346,151,6.0
8,57,Jackson,2016,892,869,23,2.6
8,59,Jefferson,2016,315406,306493,8913,2.8
8,61,Kiowa,2016,846,830,16,1.9
8,63,Kit Carson,2016,4540,4448,92,2.0
8,65,Lake,2016,4618,4492,126,2.7
8,67,La Plata,2016,30992,30141,851,2.7
8,69,Larimer,2016,187400,182374,5026,2.7
8,71,Las Animas,2016,6183,5884,299,4.8
8,73,Lincoln,2016,2280,2224,56,2.5
8,75,Logan,2016,11017,10707,310,2.8
8,77,Mesa,2016,72044,68374,3670,5.1
8,79,Mineral,2016,464,454,10,2.2
8,81,Moffat,2016,7180,6908,272,3.8
8,83,Montezuma,2016,12715,12112,603,4.7
8,85,Montrose,2016,20062,19268,794,4.0
8,87,Morgan,2016,15039,14542,497,3.3
8,89,Otero,2016,8110,7745,365,4.5
8,91,Ouray,2016,2166,2088,78,3.6
8,93,Park,2016,9836,9574,262,2.7
8,95,Phillips,2016,2472,2426,46,1.9
8,97,Pitkin,2016,10736,10390,346,3.2
8,99,Prowers,2016,6006,5820,186,3.1
8,101,Pueblo,2016,73058,69714,3344,4.6
8,103,Rio Blanco,2016,2735,2603,132,4.8
8,105,Rio Grande,2016,5153,4909,244,4.7
8,107,Routt,2016,14912,14539,373,2.5
8,109,Saguache,2016,3226,3075,151,4.7
8,111,San Juan,2016,479,462,17,3.5
8,113,San Miguel,2016,5185,5024,161,3.1
8,115,Sedgwick,2016,1178,1152,26,2.2
8,117,Summit,2016,21140,20722,418,2.0
8,119,Teller,2016,11731,11315,416,3.5
8,121,Washington,2016,2921,2861,60,2.1
8,123,Weld,2016,149941,145047,4894,3.3
8,125,Yuma,2016,5441,5330,111,2.0
9,1,Fairfield,2016,480217,458104,22113,4.6
9,3,Hartford,2016,474499,450547,23952,5.0
9,5,Litchfield,2016,104748,100081,4667,4.5
9,7,Middlesex,2016,92488,88622,3866,4.2
9,9,New Haven,2016,456991,433276,23715,5.2
9,11,New London,2016,136179,129593,6586,4.8
9,13,Tolland,2016,85416,81803,3613,4.2
9,15,Windham,2016,62660,59363,3297,5.3
10,1,Kent,2016,76699,72935,3764,4.9
10,3,New Castle,2016,291757,278853,12904,4.4
10,5,Sussex,2016,100352,95852,4500,4.5
11,1,District of Colu,2016,395124,370553,24571,6.2
12,1,Alachua,2016,133055,127302,5753,4.3
12,3,Baker,2016,11456,10892,564,4.9
12,5,Bay,2016,88209,83963,4246,4.8
12,7,Bradford,2016,10896,10427,469,4.3
12,9,Brevard,2016,263418,249817,13601,5.2
12,11,Broward,2016,1007259,961500,45759,4.5
12,13,Calhoun,2016,5003,4713,290,5.8
12,15,Charlotte,2016,69519,65781,3738,5.4
12,17,Citrus,2016,48006,44748,3258,6.8
12,19,Clay,2016,101345,96747,4598,4.5
12,21,Collier,2016,169758,161752,8006,4.7
12,23,Columbia,2016,29856,28387,1469,4.9
12,27,DeSoto,2016,13516,12797,719,5.3
12,29,Dixie,2016,5669,5358,311,5.5
12,31,Duval,2016,469165,445908,23257,5.0
12,33,Escambia,2016,141419,134347,7072,5.0
12,35,Flagler,2016,45492,42967,2525,5.6
12,37,Franklin,2016,4752,4544,208,4.4
12,39,Gadsden,2016,18269,17114,1155,6.3
12,41,Gilchrist,2016,6698,6360,338,5.0
12,43,Glades,2016,4734,4436,298,6.3
12,45,Gulf,2016,5985,5704,281,4.7
12,47,Hamilton,2016,4673,4406,267,5.7
12,49,Hardee,2016,9287,8664,623,6.7
12,51,Hendry,2016,15462,14133,1329,8.6
12,53,Hernando,2016,68152,63991,4161,6.1
12,55,Highlands,2016,35846,33481,2365,6.6
12,57,Hillsborough,2016,709538,677812,31726,4.5
12,59,Holmes,2016,6734,6367,367,5.4
12,61,Indian River,2016,62394,58604,3790,6.1
12,63,Jackson,2016,17396,16480,916,5.3
12,65,Jefferson,2016,5404,5117,287,5.3
12,67,Lafayette,2016,2977,2846,131,4.4
12,69,Lake,2016,146577,139389,7188,4.9
12,71,Lee,2016,330398,314990,15408,4.7
12,73,Leon,2016,150702,143808,6894,4.6
12,75,Levy,2016,16702,15831,871,5.2
12,77,Liberty,2016,2646,2509,137,5.2
12,79,Madison,2016,7350,6960,390,5.3
12,81,Manatee,2016,171148,163281,7867,4.6
12,83,Marion,2016,132466,124689,7777,5.9
12,85,Martin,2016,71125,67646,3479,4.9
12,86,Miami-Dade,2016,1305259,1233029,72230,5.5
12,87,Monroe,2016,46592,45095,1497,3.2
12,89,Nassau,2016,37897,36176,1721,4.5
12,91,Okaloosa,2016,93533,89740,3793,4.1
12,93,Okeechobee,2016,18205,17261,944,5.2
12,95,Orange,2016,708817,677671,31146,4.4
12,97,Osceola,2016,164792,156541,8251,5.0
12,99,Palm Beach,2016,711609,677839,33770,4.7
12,101,Pasco,2016,223250,211693,11557,5.2
12,103,Pinellas,2016,479772,458724,21048,4.4
12,105,Polk,2016,287843,271786,16057,5.6
12,107,Putnam,2016,27071,25332,1739,6.4
12,109,St. Johns,2016,118966,114422,4544,3.8
12,111,St. Lucie,2016,135657,127736,7921,5.8
12,113,Santa Rosa,2016,76371,72892,3479,4.6
12,115,Sarasota,2016,181607,173272,8335,4.6
12,117,Seminole,2016,242812,232335,10477,4.3
12,119,Sumter,2016,29490,27358,2132,7.2
12,121,Suwannee,2016,18243,17342,901,4.9
12,123,Taylor,2016,8866,8383,483,5.4
12,125,Union,2016,4811,4601,210,4.4
12,127,Volusia,2016,246286,233701,12585,5.1
12,129,Wakulla,2016,14342,13743,599,4.2
12,131,Walton,2016,29035,27776,1259,4.3
12,133,Washington,2016,9732,9228,504,5.2
13,1,Appling,2016,9191,8596,595,6.5
13,3,Atkinson,2016,3976,3765,211,5.3
13,5,Bacon,2016,4981,4717,264,5.3
13,7,Baker,2016,1181,1089,92,7.8
13,9,Baldwin,2016,17637,16414,1223,6.9
13,11,Banks,2016,8816,8382,434,4.9
13,13,Barrow,2016,37699,35894,1805,4.8
13,15,Bartow,2016,48194,45690,2504,5.2
13,17,Ben Hill,2016,5550,5089,461,8.3
13,19,Berrien,2016,7220,6772,448,6.2
13,21,Bibb,2016,68659,64517,4142,6.0
13,23,Bleckley,2016,4504,4143,361,8.0
13,25,Brantley,2016,7098,6614,484,6.8
13,27,Brooks,2016,7010,6638,372,5.3
13,29,Bryan,2016,16928,16093,835,4.9
13,31,Bulloch,2016,35965,33878,2087,5.8
13,33,Burke,2016,9244,8522,722,7.8
13,35,Butts,2016,10379,9786,593,5.7
13,37,Calhoun,2016,2164,2040,124,5.7
13,39,Camden,2016,20352,19164,1188,5.8
13,43,Candler,2016,5071,4825,246,4.9
13,45,Carroll,2016,53550,50291,3259,6.1
13,47,Catoosa,2016,32172,30595,1577,4.9
13,49,Charlton,2016,4741,4470,271,5.7
13,51,Chatham,2016,136088,128852,7236,5.3
13,53,Chattahoochee,2016,2060,1887,173,8.4
13,55,Chattooga,2016,10436,9769,667,6.4
13,57,Cherokee,2016,125883,120452,5431,4.3
13,59,Clarke,2016,58767,55484,3283,5.6
13,61,Clay,2016,884,791,93,10.5
13,63,Clayton,2016,130800,122049,8751,6.7
13,65,Clinch,2016,2769,2596,173,6.2
13,67,Cobb,2016,410083,390988,19095,4.7
13,69,Coffee,2016,18092,17024,1068,5.9
13,71,Colquitt,2016,21103,19979,1124,5.3
13,73,Columbia,2016,71036,67691,3345,4.7
13,75,Cook,2016,7524,7111,413,5.5
13,77,Coweta,2016,70403,66854,3549,5.0
13,79,Crawford,2016,5678,5339,339,6.0
13,81,Crisp,2016,9191,8629,562,6.1
13,83,Dade,2016,8018,7607,411,5.1
13,85,Dawson,2016,11330,10793,537,4.7
13,87,Decatur,2016,11476,10703,773,6.7
13,89,DeKalb,2016,382731,361823,20908,5.5
13,91,Dodge,2016,7018,6501,517,7.4
13,93,Dooly,2016,4951,4660,291,5.9
13,95,Dougherty,2016,38172,35525,2647,6.9
13,97,Douglas,2016,70232,66273,3959,5.6
13,99,Early,2016,4401,4095,306,7.0
13,101,Echols,2016,1882,1800,82,4.4
13,103,Effingham,2016,28415,27025,1390,4.9
13,105,Elbert,2016,7730,7223,507,6.6
13,107,Emanuel,2016,8448,7786,662,7.8
13,109,Evans,2016,4788,4550,238,5.0
13,111,Fannin,2016,10829,10242,587,5.4
13,113,Fayette,2016,55712,53051,2661,4.8
13,115,Floyd,2016,43503,40856,2647,6.1
13,117,Forsyth,2016,110988,106296,4692,4.2
13,119,Franklin,2016,9788,9269,519,5.3
13,121,Fulton,2016,531124,502170,28954,5.5
13,123,Gilmer,2016,11833,11152,681,5.8
13,125,Glascock,2016,1268,1191,77,6.1
13,127,Glynn,2016,39177,37071,2106,5.4
13,129,Gordon,2016,25300,23865,1435,5.7
13,131,Grady,2016,10250,9685,565,5.5
13,133,Greene,2016,6605,6200,405,6.1
13,135,Gwinnett,2016,467734,445147,22587,4.8
13,137,Habersham,2016,19302,18268,1034,5.4
13,139,Hall,2016,96308,91917,4391,4.6
13,141,Hancock,2016,2532,2317,215,8.5
13,143,Haralson,2016,12159,11445,714,5.9
13,145,Harris,2016,16066,15271,795,4.9
13,147,Hart,2016,11013,10414,599,5.4
13,149,Heard,2016,4996,4697,299,6.0
13,151,Henry,2016,108917,102845,6072,5.6
13,153,Houston,2016,67671,64005,3666,5.4
13,155,Irwin,2016,3219,2964,255,7.9
13,157,Jackson,2016,33289,31852,1437,4.3
13,159,Jasper,2016,6581,6262,319,4.8
13,161,Jeff Davis,2016,6226,5825,401,6.4
13,163,Jefferson,2016,6599,6106,493,7.5
13,165,Jenkins,2016,3163,2921,242,7.7
13,167,Johnson,2016,3925,3683,242,6.2
13,169,Jones,2016,13792,13121,671,4.9
13,171,Lamar,2016,7900,7375,525,6.6
13,173,Lanier,2016,3828,3604,224,5.9
13,175,Laurens,2016,19066,17781,1285,6.7
13,177,Lee,2016,14557,13865,692,4.8
13,179,Liberty,2016,25047,23562,1485,5.9
13,181,Lincoln,2016,3479,3271,208,6.0
13,183,Long,2016,7424,7018,406,5.5
13,185,Lowndes,2016,51312,48569,2743,5.3
13,187,Lumpkin,2016,15975,15199,776,4.9
13,189,McDuffie,2016,8802,8150,652,7.4
13,191,McIntosh,2016,6004,5649,355,5.9
13,193,Macon,2016,4681,4289,392,8.4
13,195,Madison,2016,13084,12428,656,5.0
13,197,Marion,2016,3381,3130,251,7.4
13,199,Meriwether,2016,8759,8150,609,7.0
13,201,Miller,2016,2753,2602,151,5.5
13,205,Mitchell,2016,8569,7999,570,6.7
13,207,Monroe,2016,13018,12336,682,5.2
13,209,Montgomery,2016,3725,3444,281,7.5
13,211,Morgan,2016,8698,8254,444,5.1
13,213,Murray,2016,15645,14521,1124,7.2
13,215,Muscogee,2016,78438,73041,5397,6.9
13,217,Newton,2016,50006,46972,3034,6.1
13,219,Oconee,2016,18472,17706,766,4.1
13,221,Oglethorpe,2016,6919,6578,341,4.9
13,223,Paulding,2016,79648,75914,3734,4.7
13,225,Peach,2016,11441,10630,811,7.1
13,227,Pickens,2016,14404,13692,712,4.9
13,229,Pierce,2016,8556,8097,459,5.4
13,231,Pike,2016,8402,7961,441,5.2
13,233,Polk,2016,18072,16948,1124,6.2
13,235,Pulaski,2016,4039,3799,240,5.9
13,237,Putnam,2016,7955,7388,567,7.1
13,239,Quitman,2016,815,755,60,7.4
13,241,Rabun,2016,6700,6299,401,6.0
13,243,Randolph,2016,2475,2263,212,8.6
13,245,Richmond,2016,84842,79035,5807,6.8
13,247,Rockdale,2016,43254,40714,2540,5.9
13,249,Schley,2016,2117,1982,135,6.4
13,251,Screven,2016,5240,4840,400,7.6
13,253,Seminole,2016,3093,2846,247,8.0
13,255,Spalding,2016,27798,25863,1935,7.0
13,257,Stephens,2016,11033,10376,657,6.0
13,259,Stewart,2016,2138,2000,138,6.5
13,261,Sumter,2016,12849,11864,985,7.7
13,263,Talbot,2016,2745,2559,186,6.8
13,265,Taliaferro,2016,548,510,38,6.9
13,267,Tattnall,2016,9330,8825,505,5.4
13,269,Taylor,2016,3323,3071,252,7.6
13,271,Telfair,2016,4811,4403,408,8.5
13,273,Terrell,2016,3657,3417,240,6.6
13,275,Thomas,2016,17533,16425,1108,6.3
13,277,Tift,2016,18553,17541,1012,5.5
13,279,Toombs,2016,11789,10856,933,7.9
13,281,Towns,2016,4108,3825,283,6.9
13,283,Treutlen,2016,2743,2529,214,7.8
13,285,Troup,2016,36835,34934,1901,5.2
13,287,Turner,2016,3236,3024,212,6.6
13,289,Twiggs,2016,2950,2690,260,8.8
13,291,Union,2016,10451,9949,502,4.8
13,293,Upson,2016,11143,10415,728,6.5
13,295,Walker,2016,29938,28247,1691,5.6
13,297,Walton,2016,43382,41222,2160,5.0
13,299,Ware,2016,15484,14637,847,5.5
13,301,Warren,2016,2700,2510,190,7.0
13,303,Washington,2016,7184,6723,461,6.4
13,305,Wayne,2016,11296,10512,784,6.9
13,307,Webster,2016,967,883,84,8.7
13,309,Wheeler,2016,1734,1576,158,9.1
13,311,White,2016,14481,13801,680,4.7
13,313,Whitfield,2016,44742,41968,2774,6.2
13,315,Wilcox,2016,2720,2521,199,7.3
13,317,Wilkes,2016,3708,3459,249,6.7
13,319,Wilkinson,2016,3650,3416,234,6.4
13,321,Worth,2016,9125,8586,539,5.9
15,1,Hawaii,2016,92474,89228,3246,3.5
15,3,Honolulu/city,2016,463370,450745,12625,2.7
15,7,Kauai,2016,36587,35468,1119,3.1
15,9,Maui,2016,86690,84117,2573,3.0
16,1,Ada,2016,225135,217925,7210,3.2
16,3,Adams,2016,1740,1624,116,6.7
16,5,Bannock,2016,41066,39648,1418,3.5
16,7,Bear Lake,2016,2808,2684,124,4.4
16,9,Benewah,2016,4007,3778,229,5.7
16,11,Bingham,2016,22783,22007,776,3.4
16,13,Blaine,2016,11843,11482,361,3.0
16,15,Boise,2016,3092,2935,157,5.1
16,17,Bonner,2016,18871,17879,992,5.3
16,19,Bonneville,2016,52377,50762,1615,3.1
16,21,Boundary,2016,5098,4841,257,5.0
16,23,Butte,2016,1293,1241,52,4.0
16,25,Camas,2016,658,635,23,3.5
16,27,Canyon,2016,93555,89622,3933,4.2
16,29,Caribou,2016,3792,3661,131,3.5
16,31,Cassia,2016,11589,11254,335,2.9
16,33,Clark,2016,393,381,12,3.1
16,35,Clearwater,2016,3045,2830,215,7.1
16,37,Custer,2016,2138,2033,105,4.9
16,39,Elmore,2016,10948,10511,437,4.0
16,41,Franklin,2016,6639,6442,197,3.0
16,43,Fremont,2016,7367,7127,240,3.3
16,45,Gem,2016,7723,7373,350,4.5
16,47,Gooding,2016,7997,7759,238,3.0
16,49,Idaho,2016,6334,5986,348,5.5
16,51,Jefferson,2016,12823,12439,384,3.0
16,53,Jerome,2016,11344,10998,346,3.1
16,55,Kootenai,2016,73762,70446,3316,4.5
16,57,Latah,2016,19892,19281,611,3.1
16,59,Lemhi,2016,3403,3202,201,5.9
16,61,Lewis,2016,1624,1524,100,6.2
16,63,Lincoln,2016,2639,2525,114,4.3
16,65,Madison,2016,20565,20083,482,2.3
16,67,Minidoka,2016,10871,10535,336,3.1
16,69,Nez Perce,2016,20861,20198,663,3.2
16,71,Oneida,2016,2200,2123,77,3.5
16,73,Owyhee,2016,5276,5042,234,4.4
16,75,Payette,2016,11247,10742,505,4.5
16,77,Power,2016,3927,3772,155,3.9
16,79,Shoshone,2016,5108,4757,351,6.9
16,81,Teton,2016,5980,5793,187,3.1
16,83,Twin Falls,2016,39555,38249,1306,3.3
16,85,Valley,2016,4959,4701,258,5.2
16,87,Washington,2016,4595,4350,245,5.3
17,1,Adams,2016,32621,31068,1553,4.8
17,3,Alexander,2016,2215,2008,207,9.3
17,5,Bond,2016,7911,7506,405,5.1
17,7,Boone,2016,26437,24753,1684,6.4
17,9,Brown,2016,2868,2771,97,3.4
17,11,Bureau,2016,17450,16393,1057,6.1
17,13,Calhoun,2016,2383,2237,146,6.1
17,15,Carroll,2016,7900,7452,448,5.7
17,17,Cass,2016,6239,5890,349,5.6
17,19,Champaign,2016,107860,102464,5396,5.0
17,21,Christian,2016,15355,14373,982,6.4
17,23,Clark,2016,8197,7720,477,5.8
17,25,Clay,2016,6734,6274,460,6.8
17,27,Clinton,2016,20537,19621,916,4.5
17,29,Coles,2016,24628,23173,1455,5.9
17,31,Cook,2016,2664757,2500070,164687,6.2
17,33,Crawford,2016,9065,8498,567,6.3
17,35,Cumberland,2016,6009,5694,315,5.2
17,37,DeKalb,2016,55418,52454,2964,5.3
17,39,De Witt,2016,7975,7521,454,5.7
17,41,Douglas,2016,10326,9839,487,4.7
17,43,DuPage,2016,516779,491849,24930,4.8
17,45,Edgar,2016,9747,9163,584,6.0
17,47,Edwards,2016,2984,2811,173,5.8
17,49,Effingham,2016,18775,17880,895,4.8
17,51,Fayette,2016,9786,9149,637,6.5
17,53,Ford,2016,6683,6319,364,5.4
17,55,Franklin,2016,16765,15406,1359,8.1
17,57,Fulton,2016,15871,14697,1174,7.4
17,59,Gallatin,2016,2546,2352,194,7.6
17,61,Greene,2016,6095,5740,355,5.8
17,63,Grundy,2016,25767,23999,1768,6.9
17,65,Hamilton,2016,4273,4007,266,6.2
17,67,Hancock,2016,8868,8289,579,6.5
17,69,Hardin,2016,1400,1269,131,9.4
17,71,Henderson,2016,3732,3505,227,6.1
17,73,Henry,2016,25322,23793,1529,6.0
17,75,Iroquois,2016,14860,14040,820,5.5
17,77,Jackson,2016,28802,27249,1553,5.4
17,79,Jasper,2016,4665,4373,292,6.3
17,81,Jefferson,2016,17642,16512,1130,6.4
17,83,Jersey,2016,11102,10455,647,5.8
17,85,Jo Daviess,2016,11425,10810,615,5.4
17,87,Johnson,2016,4227,3858,369,8.7
17,89,Kane,2016,271321,256304,15017,5.5
17,91,Kankakee,2016,54935,51381,3554,6.5
17,93,Kendall,2016,67962,64414,3548,5.2
17,95,Knox,2016,23035,21619,1416,6.1
17,97,Lake,2016,373373,353803,19570,5.2
17,99,LaSalle,2016,57348,53477,3871,6.8
17,101,Lawrence,2016,6200,5741,459,7.4
17,103,Lee,2016,18097,17168,929,5.1
17,105,Livingston,2016,17097,16174,923,5.4
17,107,Logan,2016,13097,12398,699,5.3
17,109,McDonough,2016,14086,13203,883,6.3
17,111,McHenry,2016,167872,158890,8982,5.4
17,113,McLean,2016,90907,86312,4595,5.1
17,115,Macon,2016,50782,47430,3352,6.6
17,117,Macoupin,2016,23458,22060,1398,6.0
17,119,Madison,2016,135685,127691,7994,5.9
17,121,Marion,2016,18104,16947,1157,6.4
17,123,Marshall,2016,5656,5280,376,6.6
17,125,Mason,2016,6466,6005,461,7.1
17,127,Massac,2016,6018,5588,430,7.1
17,129,Menard,2016,6772,6454,318,4.7
17,131,Mercer,2016,8258,7744,514,6.2
17,133,Monroe,2016,18565,17810,755,4.1
17,135,Montgomery,2016,12160,11297,863,7.1
17,137,Morgan,2016,17005,16165,840,4.9
17,139,Moultrie,2016,7475,7133,342,4.6
17,141,Ogle,2016,25900,24368,1532,5.9
17,143,Peoria,2016,88412,82310,6102,6.9
17,145,Perry,2016,8743,8121,622,7.1
17,147,Piatt,2016,8729,8305,424,4.9
17,149,Pike,2016,7542,7155,387,5.1
17,151,Pope,2016,1774,1647,127,7.2
17,153,Pulaski,2016,2203,2017,186,8.4
17,155,Putnam,2016,3121,2945,176,5.6
17,157,Randolph,2016,14609,13878,731,5.0
17,159,Richland,2016,7574,7124,450,5.9
17,161,Rock Island,2016,72387,67847,4540,6.3
17,163,St. Clair,2016,127728,119971,7757,6.1
17,165,Saline,2016,10092,9228,864,8.6
17,167,Sangamon,2016,104237,99031,5206,5.0
17,169,Schuyler,2016,3372,3183,189,5.6
17,171,Scott,2016,2538,2394,144,5.7
17,173,Shelby,2016,10439,9842,597,5.7
17,175,Stark,2016,2771,2567,204,7.4
17,177,Stephenson,2016,21497,20237,1260,5.9
17,179,Tazewell,2016,66050,61804,4246,6.4
17,181,Union,2016,7555,6995,560,7.4
17,183,Vermilion,2016,35043,32499,2544,7.3
17,185,Wabash,2016,5778,5415,363,6.3
17,187,Warren,2016,8734,8273,461,5.3
17,189,Washington,2016,9686,9321,365,3.8
17,191,Wayne,2016,7332,6707,625,8.5
17,193,White,2016,6919,6464,455,6.6
17,195,Whiteside,2016,28851,27177,1674,5.8
17,197,Will,2016,362899,340783,22116,6.1
17,199,Williamson,2016,32459,30464,1995,6.1
17,201,Winnebago,2016,141910,132448,9462,6.7
17,203,Woodford,2016,19433,18367,1066,5.5
18,1,Adams,2016,17057,16454,603,3.5
18,3,Allen,2016,181043,173422,7621,4.2
18,5,Bartholomew,2016,44497,43010,1487,3.3
18,7,Benton,2016,4570,4379,191,4.2
18,9,Blackford,2016,5341,5059,282,5.3
18,11,Boone,2016,34896,33733,1163,3.3
18,13,Brown,2016,7531,7232,299,4.0
18,15,Carroll,2016,10118,9695,423,4.2
18,17,Cass,2016,18065,17238,827,4.6
18,19,Clark,2016,60593,58105,2488,4.1
18,21,Clay,2016,12399,11826,573,4.6
18,23,Clinton,2016,17170,16512,658,3.8
18,25,Crawford,2016,5003,4725,278,5.6
18,27,Daviess,2016,15990,15432,558,3.5
18,29,Dearborn,2016,25622,24431,1191,4.6
18,31,Decatur,2016,14571,14059,512,3.5
18,33,DeKalb,2016,22257,21397,860,3.9
18,35,Delaware,2016,55129,52342,2787,5.1
18,37,Dubois,2016,23421,22702,719,3.1
18,39,Elkhart,2016,108584,104854,3730,3.4
18,41,Fayette,2016,9358,8827,531,5.7
18,43,Floyd,2016,41025,39369,1656,4.0
18,45,Fountain,2016,7977,7520,457,5.7
18,47,Franklin,2016,11490,10998,492,4.3
18,49,Fulton,2016,9896,9439,457,4.6
18,51,Gibson,2016,19219,18532,687,3.6
18,53,Grant,2016,32170,30606,1564,4.9
18,55,Greene,2016,13751,12864,887,6.5
18,57,Hamilton,2016,174686,169167,5519,3.2
18,59,Hancock,2016,38727,37281,1446,3.7
18,61,Harrison,2016,19976,19148,828,4.1
18,63,Hendricks,2016,85878,82920,2958,3.4
18,65,Henry,2016,22136,21128,1008,4.6
18,67,Howard,2016,38114,36365,1749,4.6
18,69,Huntington,2016,18707,17958,749,4.0
18,71,Jackson,2016,22370,21563,807,3.6
18,73,Jasper,2016,16585,15714,871,5.3
18,75,Jay,2016,9955,9510,445,4.5
18,77,Jefferson,2016,15300,14597,703,4.6
18,79,Jennings,2016,13278,12656,622,4.7
18,81,Johnson,2016,80340,77460,2880,3.6
18,83,Knox,2016,19084,18261,823,4.3
18,85,Kosciusko,2016,41542,40008,1534,3.7
18,87,LaGrange,2016,19445,18784,661,3.4
18,89,Lake,2016,232420,217907,14513,6.2
18,91,LaPorte,2016,48689,45863,2826,5.8
18,93,Lawrence,2016,20611,19455,1156,5.6
18,95,Madison,2016,59021,56085,2936,5.0
18,97,Marion,2016,481919,460661,21258,4.4
18,99,Marshall,2016,24351,23451,900,3.7
18,101,Martin,2016,5155,4947,208,4.0
18,103,Miami,2016,16103,15351,752,4.7
18,105,Monroe,2016,68053,64931,3122,4.6
18,107,Montgomery,2016,19178,18450,728,3.8
18,109,Morgan,2016,36074,34561,1513,4.2
18,111,Newton,2016,7043,6655,388,5.5
18,113,Noble,2016,23354,22419,935,4.0
18,115,Ohio,2016,3227,3072,155,4.8
18,117,Orange,2016,8888,8443,445,5.0
18,119,Owen,2016,9268,8759,509,5.5
18,121,Parke,2016,7273,6899,374,5.1
18,123,Perry,2016,9470,9044,426,4.5
18,125,Pike,2016,6337,6065,272,4.3
18,127,Porter,2016,86357,81990,4367,5.1
18,129,Posey,2016,13465,12941,524,3.9
18,131,Pulaski,2016,6386,6104,282,4.4
18,133,Putnam,2016,16619,15880,739,4.4
18,135,Randolph,2016,12681,12118,563,4.4
18,137,Ripley,2016,14078,13442,636,4.5
18,139,Rush,2016,8987,8654,333,3.7
18,141,St. Joseph,2016,134247,128253,5994,4.5
18,143,Scott,2016,10486,9984,502,4.8
18,145,Shelby,2016,22980,22074,906,3.9
18,147,Spencer,2016,10988,10543,445,4.0
18,149,Starke,2016,10869,10289,580,5.3
18,151,Steuben,2016,20104,19379,725,3.6
18,153,Sullivan,2016,8707,8202,505,5.8
18,155,Switzerland,2016,5000,4759,241,4.8
18,157,Tippecanoe,2016,94482,90699,3783,4.0
18,159,Tipton,2016,8537,8213,324,3.8
18,161,Union,2016,3641,3496,145,4.0
18,163,Vanderburgh,2016,93328,89539,3789,4.1
18,165,Vermillion,2016,7276,6803,473,6.5
18,167,Vigo,2016,49419,46792,2627,5.3
18,169,Wabash,2016,15493,14842,651,4.2
18,171,Warren,2016,4116,3919,197,4.8
18,173,Warrick,2016,32516,31221,1295,4.0
18,175,Washington,2016,13696,13078,618,4.5
18,177,Wayne,2016,30980,29514,1466,4.7
18,179,Wells,2016,14183,13685,498,3.5
18,181,White,2016,13658,13122,536,3.9
18,183,Whitley,2016,17252,16591,661,3.8
19,1,Adair,2016,4255,4131,124,2.9
19,3,Adams,2016,2227,2169,58,2.6
19,5,Allamakee,2016,7708,7329,379,4.9
19,7,Appanoose,2016,6190,5900,290,4.7
19,9,Audubon,2016,3293,3185,108,3.3
19,11,Benton,2016,13666,13179,487,3.6
19,13,Black Hawk,2016,69624,66425,3199,4.6
19,15,Boone,2016,15193,14772,421,2.8
19,17,Bremer,2016,13979,13483,496,3.5
19,19,Buchanan,2016,11259,10799,460,4.1
19,21,Buena Vista,2016,11571,11167,404,3.5
19,23,Butler,2016,8070,7722,348,4.3
19,25,Calhoun,2016,4545,4375,170,3.7
19,27,Carroll,2016,11337,11049,288,2.5
19,29,Cass,2016,7301,7065,236,3.2
19,31,Cedar,2016,10914,10554,360,3.3
19,33,Cerro Gordo,2016,23235,22408,827,3.6
19,35,Cherokee,2016,6353,6124,229,3.6
19,37,Chickasaw,2016,6458,6175,283,4.4
19,39,Clarke,2016,4855,4693,162,3.3
19,41,Clay,2016,8764,8429,335,3.8
19,43,Clayton,2016,10354,9918,436,4.2
19,45,Clinton,2016,23936,22765,1171,4.9
19,47,Crawford,2016,8479,8020,459,5.4
19,49,Dallas,2016,46059,44856,1203,2.6
19,51,Davis,2016,4311,4130,181,4.2
19,53,Decatur,2016,4428,4287,141,3.2
19,55,Delaware,2016,10782,10412,370,3.4
19,57,Des Moines,2016,20141,19155,986,4.9
19,59,Dickinson,2016,10354,9912,442,4.3
19,61,Dubuque,2016,54968,53029,1939,3.5
19,63,Emmet,2016,5624,5387,237,4.2
19,65,Fayette,2016,10767,10293,474,4.4
19,67,Floyd,2016,8735,8420,315,3.6
19,69,Franklin,2016,5975,5770,205,3.4
19,71,Fremont,2016,4009,3878,131,3.3
19,73,Greene,2016,5697,5520,177,3.1
19,75,Grundy,2016,6669,6441,228,3.4
19,77,Guthrie,2016,5654,5452,202,3.6
19,79,Hamilton,2016,7178,6910,268,3.7
19,81,Hancock,2016,6424,6252,172,2.7
19,83,Hardin,2016,8617,8285,332,3.9
19,85,Harrison,2016,7489,7238,251,3.4
19,87,Henry,2016,9612,9273,339,3.5
19,89,Howard,2016,5357,5166,191,3.6
19,91,Humboldt,2016,5415,5260,155,2.9
19,93,Ida,2016,4046,3944,102,2.5
19,95,Iowa,2016,10613,10286,327,3.1
19,97,Jackson,2016,11119,10658,461,4.1
19,99,Jasper,2016,19345,18665,680,3.5
19,101,Jefferson,2016,9233,8897,336,3.6
19,103,Johnson,2016,84759,82580,2179,2.6
19,105,Jones,2016,10743,10287,456,4.2
19,107,Keokuk,2016,5349,5121,228,4.3
19,109,Kossuth,2016,8941,8709,232,2.6
19,111,Lee,2016,17549,16499,1050,6.0
19,113,Linn,2016,119414,115074,4340,3.6
19,115,Louisa,2016,6134,5896,238,3.9
19,117,Lucas,2016,4404,4266,138,3.1
19,119,Lyon,2016,7125,6981,144,2.0
19,121,Madison,2016,8294,8002,292,3.5
19,123,Mahaska,2016,11859,11424,435,3.7
19,125,Marion,2016,17538,17014,524,3.0
19,127,Marshall,2016,19234,18300,934,4.9
19,129,Mills,2016,7445,7176,269,3.6
19,131,Mitchell,2016,5911,5757,154,2.6
19,133,Monona,2016,4750,4558,192,4.0
19,135,Monroe,2016,3978,3796,182,4.6
19,137,Montgomery,2016,5139,4959,180,3.5
19,139,Muscatine,2016,22548,21697,851,3.8
19,141,O'Brien,2016,8405,8174,231,2.7
19,143,Osceola,2016,3662,3566,96,2.6
19,145,Page,2016,6498,6176,322,5.0
19,147,Palo Alto,2016,4992,4839,153,3.1
19,149,Plymouth,2016,15087,14705,382,2.5
19,151,Pocahontas,2016,4340,4217,123,2.8
19,153,Polk,2016,258689,249790,8899,3.4
19,155,Pottawattamie,2016,48517,46887,1630,3.4
19,157,Poweshiek,2016,10478,10122,356,3.4
19,159,Ringgold,2016,2621,2530,91,3.5
19,161,Sac,2016,5523,5359,164,3.0
19,163,Scott,2016,87175,83275,3900,4.5
19,165,Shelby,2016,6859,6659,200,2.9
19,167,Sioux,2016,20796,20323,473,2.3
19,169,Story,2016,57270,55939,1331,2.3
19,171,Tama,2016,9818,9411,407,4.1
19,173,Taylor,2016,3247,3152,95,2.9
19,175,Union,2016,6549,6302,247,3.8
19,177,Van Buren,2016,3880,3739,141,3.6
19,179,Wapello,2016,17981,16949,1032,5.7
19,181,Warren,2016,27252,26388,864,3.2
19,183,Washington,2016,12421,12060,361,2.9
19,185,Wayne,2016,2856,2749,107,3.7
19,187,Webster,2016,20538,19725,813,4.0
19,189,Winnebago,2016,5226,5046,180,3.4
19,191,Winneshiek,2016,12125,11702,423,3.5
19,193,Woodbury,2016,56044,54065,1979,3.5
19,195,Worth,2016,4292,4146,146,3.4
19,197,Wright,2016,6726,6452,274,4.1
20,1,Allen,2016,6467,6108,359,5.6
20,3,Anderson,2016,4193,4014,179,4.3
20,5,Atchison,2016,7078,6639,439,6.2
20,7,Barber,2016,2538,2445,93,3.7
20,9,Barton,2016,14087,13457,630,4.5
20,11,Bourbon,2016,7160,6813,347,4.8
20,13,Brown,2016,5189,5001,188,3.6
20,15,Butler,2016,32340,30994,1346,4.2
20,17,Chase,2016,1413,1364,49,3.5
20,19,Chautauqua,2016,1547,1467,80,5.2
20,21,Cherokee,2016,10336,9879,457,4.4
20,23,Cheyenne,2016,1351,1313,38,2.8
20,25,Clark,2016,1121,1090,31,2.8
20,27,Clay,2016,4053,3888,165,4.1
20,29,Cloud,2016,4275,4100,175,4.1
20,31,Coffey,2016,4303,4037,266,6.2
20,33,Comanche,2016,975,945,30,3.1
20,35,Cowley,2016,16985,16236,749,4.4
20,37,Crawford,2016,19001,18087,914,4.8
20,39,Decatur,2016,1298,1247,51,3.9
20,41,Dickinson,2016,9209,8803,406,4.4
20,43,Doniphan,2016,4294,4128,166,3.9
20,45,Douglas,2016,65567,63255,2312,3.5
20,47,Edwards,2016,1662,1612,50,3.0
20,49,Elk,2016,1194,1135,59,4.9
20,51,Ellis,2016,17090,16564,526,3.1
20,53,Ellsworth,2016,2846,2737,109,3.8
20,55,Finney,2016,20245,19620,625,3.1
20,57,Ford,2016,17966,17399,567,3.2
20,59,Franklin,2016,14291,13693,598,4.2
20,61,Geary,2016,12112,11431,681,5.6
20,63,Gove,2016,1458,1423,35,2.4
20,65,Graham,2016,1230,1176,54,4.4
20,67,Grant,2016,3792,3656,136,3.6
20,69,Gray,2016,3426,3348,78,2.3
20,71,Greeley,2016,916,897,19,2.1
20,73,Greenwood,2016,3337,3175,162,4.9
20,75,Hamilton,2016,1650,1606,44,2.7
20,77,Harper,2016,2894,2791,103,3.6
20,79,Harvey,2016,17283,16554,729,4.2
20,81,Haskell,2016,2315,2255,60,2.6
20,83,Hodgeman,2016,1034,1007,27,2.6
20,85,Jackson,2016,7293,7041,252,3.5
20,87,Jefferson,2016,10262,9864,398,3.9
20,89,Jewell,2016,1336,1279,57,4.3
20,91,Johnson,2016,329826,319111,10715,3.2
20,93,Kearny,2016,2067,2002,65,3.1
20,95,Kingman,2016,3544,3388,156,4.4
20,97,Kiowa,2016,1426,1387,39,2.7
20,99,Labette,2016,10782,10202,580,5.4
20,101,Lane,2016,814,789,25,3.1
20,103,Leavenworth,2016,35945,34402,1543,4.3
20,105,Lincoln,2016,1746,1686,60,3.4
20,107,Linn,2016,4362,4083,279,6.4
20,109,Logan,2016,1731,1687,44,2.5
20,111,Lyon,2016,16897,16206,691,4.1
20,113,McPherson,2016,16413,15897,516,3.1
20,115,Marion,2016,6148,5907,241,3.9
20,117,Marshall,2016,5588,5419,169,3.0
20,119,Meade,2016,2388,2324,64,2.7
20,121,Miami,2016,17098,16389,709,4.1
20,123,Mitchell,2016,3712,3590,122,3.3
20,125,Montgomery,2016,16070,15088,982,6.1
20,127,Morris,2016,3065,2947,118,3.8
20,129,Morton,2016,1350,1298,52,3.9
20,131,Nemaha,2016,5923,5765,158,2.7
20,133,Neosho,2016,6083,5648,435,7.2
20,135,Ness,2016,1429,1380,49,3.4
20,137,Norton,2016,2885,2815,70,2.4
20,139,Osage,2016,8094,7738,356,4.4
20,141,Osborne,2016,2068,1998,70,3.4
20,143,Ottawa,2016,3177,3057,120,3.8
20,145,Pawnee,2016,3224,3118,106,3.3
20,147,Phillips,2016,2870,2780,90,3.1
20,149,Pottawatomie,2016,12207,11782,425,3.5
20,151,Pratt,2016,5128,4920,208,4.1
20,153,Rawlins,2016,1552,1515,37,2.4
20,155,Reno,2016,30273,28944,1329,4.4
20,157,Republic,2016,2555,2485,70,2.7
20,159,Rice,2016,5329,5117,212,4.0
20,161,Riley,2016,35046,33861,1185,3.4
20,163,Rooks,2016,2681,2555,126,4.7
20,165,Rush,2016,1740,1671,69,4.0
20,167,Russell,2016,3589,3439,150,4.2
20,169,Saline,2016,30249,29124,1125,3.7
20,171,Scott,2016,2900,2829,71,2.4
20,173,Sedgwick,2016,248395,236886,11509,4.6
20,175,Seward,2016,10278,9831,447,4.3
20,177,Shawnee,2016,92101,88415,3686,4.0
20,179,Sheridan,2016,1456,1421,35,2.4
20,181,Sherman,2016,2954,2857,97,3.3
20,183,Smith,2016,2043,1978,65,3.2
20,185,Stafford,2016,2104,2027,77,3.7
20,187,Stanton,2016,1075,1045,30,2.8
20,189,Stevens,2016,2921,2806,115,3.9
20,191,Sumner,2016,10981,10517,464,4.2
20,193,Thomas,2016,4372,4252,120,2.7
20,195,Trego,2016,1483,1424,59,4.0
20,197,Wabaunsee,2016,3723,3590,133,3.6
20,199,Wallace,2016,863,840,23,2.7
20,201,Washington,2016,3097,2996,101,3.3
20,203,Wichita,2016,1211,1183,28,2.3
20,205,Wilson,2016,4133,3886,247,6.0
20,207,Woodson,2016,1624,1531,93,5.7
20,209,Wyandotte,2016,76774,72523,4251,5.5
21,1,Adair,2016,7083,6622,461,6.5
21,3,Allen,2016,8853,8477,376,4.2
21,5,Anderson,2016,11461,11006,455,4.0
21,7,Ballard,2016,3641,3320,321,8.8
21,9,Barren,2016,18859,17985,874,4.6
21,11,Bath,2016,4758,4412,346,7.3
21,13,Bell,2016,8654,7869,785,9.1
21,15,Boone,2016,67283,64755,2528,3.8
21,17,Bourbon,2016,9879,9416,463,4.7
21,19,Boyd,2016,18542,17058,1484,8.0
21,21,Boyle,2016,12312,11711,601,4.9
21,23,Bracken,2016,3831,3604,227,5.9
21,25,Breathitt,2016,3745,3381,364,9.7
21,27,Breckinridge,2016,7736,7256,480,6.2
21,29,Bullitt,2016,40534,38873,1661,4.1
21,31,Butler,2016,5161,4884,277,5.4
21,33,Caldwell,2016,5356,5067,289,5.4
21,35,Calloway,2016,18694,17860,834,4.5
21,37,Campbell,2016,48731,46893,1838,3.8
21,39,Carlisle,2016,2565,2401,164,6.4
21,41,Carroll,2016,5183,4930,253,4.9
21,43,Carter,2016,9934,8899,1035,10.4
21,45,Casey,2016,6689,6371,318,4.8
21,47,Christian,2016,24889,23381,1508,6.1
21,49,Clark,2016,17023,16215,808,4.7
21,51,Clay,2016,5449,4904,545,10.0
21,53,Clinton,2016,3749,3470,279,7.4
21,55,Crittenden,2016,4022,3814,208,5.2
21,57,Cumberland,2016,2890,2728,162,5.6
21,59,Daviess,2016,46692,44636,2056,4.4
21,61,Edmonson,2016,4804,4511,293,6.1
21,63,Elliott,2016,2096,1858,238,11.4
21,65,Estill,2016,5241,4936,305,5.8
21,67,Fayette,2016,171498,165460,6038,3.5
21,69,Fleming,2016,5945,5579,366,6.2
21,71,Floyd,2016,11447,10169,1278,11.2
21,73,Franklin,2016,24448,23466,982,4.0
21,75,Fulton,2016,2066,1925,141,6.8
21,77,Gallatin,2016,3904,3717,187,4.8
21,79,Garrard,2016,7527,7165,362,4.8
21,81,Grant,2016,11350,10806,544,4.8
21,83,Graves,2016,15305,14366,939,6.1
21,85,Grayson,2016,10726,10015,711,6.6
21,87,Green,2016,5002,4780,222,4.4
21,89,Greenup,2016,13884,12698,1186,8.5
21,91,Hancock,2016,4040,3826,214,5.3
21,93,Hardin,2016,47800,45688,2112,4.4
21,95,Harlan,2016,6738,5862,876,13.0
21,97,Harrison,2016,8494,8099,395,4.7
21,99,Hart,2016,7903,7534,369,4.7
21,101,Henderson,2016,21607,20594,1013,4.7
21,103,Henry,2016,7927,7606,321,4.0
21,105,Hickman,2016,1920,1807,113,5.9
21,107,Hopkins,2016,19637,18530,1107,5.6
21,109,Jackson,2016,4166,3841,325,7.8
21,111,Jefferson,2016,386769,369938,16831,4.4
21,113,Jessamine,2016,25667,24677,990,3.9
21,115,Johnson,2016,7010,6297,713,10.2
21,117,Kenton,2016,84740,81306,3434,4.1
21,119,Knott,2016,4556,4035,521,11.4
21,121,Knox,2016,9896,9115,781,7.9
21,123,Larue,2016,5900,5632,268,4.5
21,125,Laurel,2016,23913,22450,1463,6.1
21,127,Lawrence,2016,5039,4496,543,10.8
21,129,Lee,2016,1897,1714,183,9.6
21,131,Leslie,2016,2789,2417,372,13.3
21,133,Letcher,2016,6421,5634,787,12.3
21,135,Lewis,2016,4742,4281,461,9.7
21,137,Lincoln,2016,9148,8599,549,6.0
21,139,Livingston,2016,3687,3425,262,7.1
21,141,Logan,2016,11735,11225,510,4.3
21,143,Lyon,2016,2961,2789,172,5.8
21,145,McCracken,2016,29006,27354,1652,5.7
21,147,McCreary,2016,4600,4234,366,8.0
21,149,McLean,2016,4333,4127,206,4.8
21,151,Madison,2016,45115,43253,1862,4.1
21,153,Magoffin,2016,3139,2525,614,19.6
21,155,Marion,2016,9402,9010,392,4.2
21,157,Marshall,2016,14912,14058,854,5.7
21,159,Martin,2016,3083,2769,314,10.2
21,161,Mason,2016,7137,6687,450,6.3
21,163,Meade,2016,12092,11477,615,5.1
21,165,Menifee,2016,2393,2188,205,8.6
21,167,Mercer,2016,9891,9418,473,4.8
21,169,Metcalfe,2016,4120,3934,186,4.5
21,171,Monroe,2016,4603,4411,192,4.2
21,173,Montgomery,2016,11854,11101,753,6.4
21,175,Morgan,2016,4485,4130,355,7.9
21,177,Muhlenberg,2016,11361,10540,821,7.2
21,179,Nelson,2016,21706,20731,975,4.5
21,181,Nicholas,2016,3219,3036,183,5.7
21,183,Ohio,2016,9524,8894,630,6.6
21,185,Oldham,2016,31932,30862,1070,3.4
21,187,Owen,2016,5490,5257,233,4.2
21,189,Owsley,2016,1120,1012,108,9.6
21,191,Pendleton,2016,6851,6526,325,4.7
21,193,Perry,2016,8549,7634,915,10.7
21,195,Pike,2016,20225,18052,2173,10.7
21,197,Powell,2016,4958,4607,351,7.1
21,199,Pulaski,2016,25388,24021,1367,5.4
21,201,Robertson,2016,805,756,49,6.1
21,203,Rockcastle,2016,6683,6280,403,6.0
21,205,Rowan,2016,10574,9955,619,5.9
21,207,Russell,2016,6135,5626,509,8.3
21,209,Scott,2016,27992,26943,1049,3.7
21,211,Shelby,2016,23811,22972,839,3.5
21,213,Simpson,2016,8391,8021,370,4.4
21,215,Spencer,2016,9656,9294,362,3.7
21,217,Taylor,2016,12218,11622,596,4.9
21,219,Todd,2016,5303,5070,233,4.4
21,221,Trigg,2016,5819,5497,322,5.5
21,223,Trimble,2016,3869,3663,206,5.3
21,225,Union,2016,6163,5749,414,6.7
21,227,Warren,2016,61992,59600,2392,3.9
21,229,Washington,2016,6083,5825,258,4.2
21,231,Wayne,2016,7259,6708,551,7.6
21,233,Webster,2016,5834,5487,347,5.9
21,235,Whitley,2016,13349,12480,869,6.5
21,237,Wolfe,2016,1917,1725,192,10.0
21,239,Woodford,2016,14762,14294,468,3.2
22,1,Acadia Parish,2016,24540,22724,1816,7.4
22,3,Allen Parish,2016,8910,8337,573,6.4
22,5,Ascension Parish,2016,62060,59019,3041,4.9
22,7,Assumption Parish,2016,9218,8443,775,8.4
22,9,Avoyelles Parish,2016,15702,14591,1111,7.1
22,11,Beauregard Parish,2016,15083,14169,914,6.1
22,13,Bienville Parish,2016,5671,5239,432,7.6
22,15,Bossier Parish,2016,57649,54581,3068,5.3
22,17,Caddo Parish,2016,107169,100070,7099,6.6
22,19,Calcasieu Parish,2016,103001,98072,4929,4.8
22,21,Caldwell Parish,2016,3987,3682,305,7.6
22,23,Cameron Parish,2016,3822,3654,168,4.4
22,25,Catahoula Parish,2016,3428,3109,319,9.3
22,27,Claiborne Parish,2016,5958,5560,398,6.7
22,29,Concordia Parish,2016,7260,6659,601,8.3
22,31,De Soto Parish,2016,10902,10100,802,7.4
22,33,East Baton Rouge Parish,2016,232408,220408,12000,5.2
22,35,East Carroll Parish,2016,2141,1893,248,11.6
22,37,East Feliciana Parish,2016,8114,7645,469,5.8
22,39,Evangeline Parish,2016,12686,11745,941,7.4
22,41,Franklin Parish,2016,7288,6627,661,9.1
22,43,Grant Parish,2016,8334,7752,582,7.0
22,45,Iberia Parish,2016,30150,27315,2835,9.4
22,47,Iberville Parish,2016,14126,13157,969,6.9
22,49,Jackson Parish,2016,7092,6696,396,5.6
22,51,Jefferson Parish,2016,216748,205292,11456,5.3
22,53,Jefferson Davis Parish,2016,13592,12773,819,6.0
22,55,Lafayette Parish,2016,114488,107456,7032,6.1
22,57,Lafourche Parish,2016,43345,40617,2728,6.3
22,59,LaSalle Parish,2016,6278,5862,416,6.6
22,61,Lincoln Parish,2016,21490,20153,1337,6.2
22,63,Livingston Parish,2016,68759,65272,3487,5.1
22,65,Madison Parish,2016,3840,3495,345,9.0
22,67,Morehouse Parish,2016,10635,9603,1032,9.7
22,69,Natchitoches Parish,2016,16733,15606,1127,6.7
22,71,Orleans Parish,2016,180187,169604,10583,5.9
22,73,Ouachita Parish,2016,71640,67279,4361,6.1
22,75,Plaquemines Parish,2016,10197,9651,546,5.4
22,77,Pointe Coupee Parish,2016,9972,9325,647,6.5
22,79,Rapides Parish,2016,57346,53805,3541,6.2
22,81,Red River Parish,2016,3813,3583,230,6.0
22,83,Richland Parish,2016,8455,7827,628,7.4
22,85,Sabine Parish,2016,9150,8516,634,6.9
22,87,St. Bernard Parish,2016,19571,18379,1192,6.1
22,89,St. Charles Parish,2016,25351,24004,1347,5.3
22,91,St. Helena Parish,2016,4395,4058,337,7.7
22,93,St. James Parish,2016,9618,8898,720,7.5
22,95,St. John the Baptist Parish,2016,20080,18706,1374,6.8
22,97,St. Landry Parish,2016,32850,30194,2656,8.1
22,99,St. Martin Parish,2016,22992,21208,1784,7.8
22,101,St. Mary Parish,2016,21967,19903,2064,9.4
22,103,St. Tammany Parish,2016,117626,111775,5851,5.0
22,105,Tangipahoa Parish,2016,54229,50567,3662,6.8
22,107,Tensas Parish,2016,1628,1468,160,9.8
22,109,Terrebonne Parish,2016,49011,45592,3419,7.0
22,111,Union Parish,2016,9254,8647,607,6.6
22,113,Vermilion Parish,2016,24732,22848,1884,7.6
22,115,Vernon Parish,2016,16949,15720,1229,7.3
22,117,Washington Parish,2016,16966,15773,1193,7.0
22,119,Webster Parish,2016,15218,13919,1299,8.5
22,121,West Baton Rouge Parish,2016,13256,12549,707,5.3
22,123,West Carroll Parish,2016,4108,3617,491,12.0
22,125,West Feliciana Parish,2016,5334,5058,276,5.2
22,127,Winn Parish,2016,5191,4788,403,7.8
23,1,Androscoggin,2016,55481,53499,1982,3.6
23,3,Aroostook,2016,31548,29842,1706,5.4
23,5,Cumberland,2016,162396,157678,4718,2.9
23,7,Franklin,2016,14483,13838,645,4.5
23,9,Hancock,2016,29245,27934,1311,4.5
23,11,Kennebec,2016,62459,60193,2266,3.6
23,13,Knox,2016,20762,20034,728,3.5
23,15,Lincoln,2016,17057,16429,628,3.7
23,17,Oxford,2016,26635,25409,1226,4.6
23,19,Penobscot,2016,77183,73852,3331,4.3
23,21,Piscataquis,2016,7494,7123,371,5.0
23,23,Sagadahoc,2016,19240,18672,568,3.0
23,25,Somerset,2016,23544,22225,1319,5.6
23,27,Waldo,2016,20914,20041,873,4.2
23,29,Washington,2016,14042,13268,774,5.5
23,31,York,2016,111436,107686,3750,3.4
24,1,Allegany,2016,32365,30416,1949,6.0
24,3,Anne Arundel,2016,303234,292085,11149,3.7
24,5,Baltimore,2016,444683,424736,19947,4.5
24,9,Calvert,2016,48750,46930,1820,3.7
24,11,Caroline,2016,17643,16830,813,4.6
24,13,Carroll,2016,93015,89753,3262,3.5
24,15,Cecil,2016,52564,49912,2652,5.0
24,17,Charles,2016,83812,80379,3433,4.1
24,19,Dorchester,2016,15863,14911,952,6.0
24,21,Frederick,2016,128533,123692,4841,3.8
24,23,Garrett,2016,15483,14635,848,5.5
24,25,Harford,2016,136199,130653,5546,4.1
24,27,Howard,2016,179120,173421,5699,3.2
24,29,Kent,2016,10230,9750,480,4.7
24,31,Montgomery,2016,544649,526510,18139,3.3
24,33,Prince George's,2016,499860,478398,21462,4.3
24,35,Queen Anne's,2016,26567,25564,1003,3.8
24,37,St. Mary's,2016,54730,52486,2244,4.1
24,39,Somerset,2016,9219,8573,646,7.0
24,41,Talbot,2016,19517,18727,790,4.0
24,43,Washington,2016,75300,71575,3725,4.9
24,45,Wicomico,2016,50359,47331,3028,6.0
24,47,Worcester,2016,25158,22900,2258,9.0
24,510,Baltimore city,2016,289071,270665,18406,6.4
25,1,Barnstable,2016,111626,105959,5667,5.1
25,3,Berkshire,2016,64364,61359,3005,4.7
25,5,Bristol,2016,290740,275951,14789,5.1
25,7,Dukes,2016,9352,8852,500,5.3
25,9,Essex,2016,410541,393604,16937,4.1
25,11,Franklin,2016,39529,38095,1434,3.6
25,13,Hampden,2016,222182,210095,12087,5.4
25,15,Hampshire,2016,88060,84748,3312,3.8
25,17,Middlesex,2016,873429,844743,28686,3.3
25,19,Nantucket/town,2016,7047,6724,323,4.6
25,21,Norfolk,2016,372538,359497,13041,3.5
25,23,Plymouth,2016,270877,259454,11423,4.2
25,25,Suffolk,2016,427162,411480,15682,3.7
25,27,Worcester,2016,430052,411765,18287,4.3
26,1,Alcona,2016,3839,3543,296,7.7
26,3,Alger,2016,3274,3002,272,8.3
26,5,Allegan,2016,61447,59033,2414,3.9
26,7,Alpena,2016,13689,12867,822,6.0
26,9,Antrim,2016,10098,9378,720,7.1
26,11,Arenac,2016,6140,5627,513,8.4
26,13,Baraga,2016,3230,2962,268,8.3
26,15,Barry,2016,30829,29584,1245,4.0
26,17,Bay,2016,52039,49168,2871,5.5
26,19,Benzie,2016,8864,8276,588,6.6
26,21,Berrien,2016,74004,70297,3707,5.0
26,23,Branch,2016,19157,18224,933,4.9
26,25,Calhoun,2016,64585,61453,3132,4.8
26,27,Cass,2016,24412,23254,1158,4.7
26,29,Charlevoix,2016,13093,12362,731,5.6
26,31,Cheboygan,2016,10851,9821,1030,9.5
26,33,Chippewa,2016,16438,15165,1273,7.7
26,35,Clare,2016,11991,11106,885,7.4
26,37,Clinton,2016,40607,39093,1514,3.7
26,39,Crawford,2016,5383,4972,411,7.6
26,41,Delta,2016,17169,16033,1136,6.6
26,43,Dickinson,2016,12539,11882,657,5.2
26,45,Eaton,2016,57051,54670,2381,4.2
26,47,Emmet,2016,17649,16489,1160,6.6
26,49,Genesee,2016,180586,170150,10436,5.8
26,51,Gladwin,2016,9915,9216,699,7.0
26,53,Gogebic,2016,6354,5961,393,6.2
26,55,Grand Traverse,2016,49515,47371,2144,4.3
26,57,Gratiot,2016,18220,17266,954,5.2
26,59,Hillsdale,2016,21233,20150,1083,5.1
26,61,Houghton,2016,16612,15585,1027,6.2
26,63,Huron,2016,16042,15204,838,5.2
26,65,Ingham,2016,149317,142853,6464,4.3
26,67,Ionia,2016,29735,28468,1267,4.3
26,69,Iosco,2016,10141,9395,746,7.4
26,71,Iron,2016,5233,4891,342,6.5
26,73,Isabella,2016,35448,33768,1680,4.7
26,75,Jackson,2016,74612,70963,3649,4.9
26,77,Kalamazoo,2016,132365,126947,5418,4.1
26,79,Kalkaska,2016,7743,7182,561,7.2
26,81,Kent,2016,351257,338786,12471,3.6
26,83,Keweenaw,2016,944,862,82,8.7
26,85,Lake,2016,3764,3479,285,7.6
26,87,Lapeer,2016,40678,38080,2598,6.4
26,89,Leelanau,2016,10603,10083,520,4.9
26,91,Lenawee,2016,47487,45278,2209,4.7
26,93,Livingston,2016,99935,95886,4049,4.1
26,95,Luce,2016,2409,2245,164,6.8
26,97,Mackinac,2016,5208,4689,519,10.0
26,99,Macomb,2016,435441,412956,22485,5.2
26,101,Manistee,2016,10565,9866,699,6.6
26,103,Marquette,2016,33412,31489,1923,5.8
26,105,Mason,2016,14316,13476,840,5.9
26,107,Mecosta,2016,19160,18071,1089,5.7
26,109,Menominee,2016,11281,10693,588,5.2
26,111,Midland,2016,41136,39179,1957,4.8
26,113,Missaukee,2016,7045,6622,423,6.0
26,115,Monroe,2016,76614,73276,3338,4.4
26,117,Montcalm,2016,28000,26501,1499,5.4
26,119,Montmorency,2016,3069,2755,314,10.2
26,121,Muskegon,2016,77659,73383,4276,5.5
26,123,Newaygo,2016,23394,22239,1155,4.9
26,125,Oakland,2016,652450,625608,26842,4.1
26,127,Oceana,2016,12360,11446,914,7.4
26,129,Ogemaw,2016,8262,7612,650,7.9
26,131,Ontonagon,2016,2209,2019,190,8.6
26,133,Osceola,2016,10462,9859,603,5.8
26,135,Oscoda,2016,2915,2700,215,7.4
26,137,Otsego,2016,11721,11017,704,6.0
26,139,Ottawa,2016,155788,150491,5297,3.4
26,141,Presque Isle,2016,5304,4792,512,9.7
26,143,Roscommon,2016,7894,7219,675,8.6
26,145,Saginaw,2016,88762,83977,4785,5.4
26,147,St. Clair,2016,74615,70103,4512,6.0
26,149,St. Joseph,2016,29200,27985,1215,4.2
26,151,Sanilac,2016,19470,18247,1223,6.3
26,153,Schoolcraft,2016,3399,3087,312,9.2
26,155,Shiawassee,2016,33510,31723,1787,5.3
26,157,Tuscola,2016,24253,22711,1542,6.4
26,159,Van Buren,2016,35566,33502,2064,5.8
26,161,Washtenaw,2016,192000,184914,7086,3.7
26,163,Wayne,2016,778939,730549,48390,6.2
26,165,Wexford,2016,14741,13868,873,5.9
27,1,Aitkin,2016,7024,6531,493,7.0
27,3,Anoka,2016,191787,184641,7146,3.7
27,5,Becker,2016,18547,17699,848,4.6
27,7,Beltrami,2016,23662,22427,1235,5.2
27,9,Benton,2016,21764,20803,961,4.4
27,11,Big Stone,2016,2702,2572,130,4.8
27,13,Blue Earth,2016,39595,38325,1270,3.2
27,15,Brown,2016,14512,13904,608,4.2
27,17,Carlton,2016,17731,16791,940,5.3
27,19,Carver,2016,56292,54436,1856,3.3
27,21,Cass,2016,14150,13183,967,6.8
27,23,Chippewa,2016,6963,6648,315,4.5
27,25,Chisago,2016,29128,27869,1259,4.3
27,27,Clay,2016,35591,34368,1223,3.4
27,29,Clearwater,2016,4713,4260,453,9.6
27,31,Cook,2016,3093,2952,141,4.6
27,33,Cottonwood,2016,5530,5134,396,7.2
27,35,Crow Wing,2016,31820,30198,1622,5.1
27,37,Dakota,2016,234941,226978,7963,3.4
27,39,Dodge,2016,11549,11120,429,3.7
27,41,Douglas,2016,20218,19513,705,3.5
27,43,Faribault,2016,7316,6995,321,4.4
27,45,Fillmore,2016,11492,11028,464,4.0
27,47,Freeborn,2016,16276,15654,622,3.8
27,49,Goodhue,2016,26830,25833,997,3.7
27,51,Grant,2016,3285,3131,154,4.7
27,53,Hennepin,2016,685106,662298,22808,3.3
27,55,Houston,2016,10593,10179,414,3.9
27,57,Hubbard,2016,9790,9154,636,6.5
27,59,Isanti,2016,20661,19697,964,4.7
27,61,Itasca,2016,22014,20132,1882,8.5
27,63,Jackson,2016,6094,5819,275,4.5
27,65,Kanabec,2016,8987,8402,585,6.5
27,67,Kandiyohi,2016,24175,23256,919,3.8
27,69,Kittson,2016,2403,2293,110,4.6
27,71,Koochiching,2016,6159,5636,523,8.5
27,73,Lac qui Parle,2016,3617,3462,155,4.3
27,75,Lake,2016,5414,5069,345,6.4
27,77,Lake of the Woods,2016,2382,2267,115,4.8
27,79,Le Sueur,2016,15550,14790,760,4.9
27,81,Lincoln,2016,3380,3257,123,3.6
27,83,Lyon,2016,15176,14637,539,3.6
27,85,McLeod,2016,19765,18893,872,4.4
27,87,Mahnomen,2016,2388,2250,138,5.8
27,89,Marshall,2016,5615,5204,411,7.3
27,91,Martin,2016,10455,10025,430,4.1
27,93,Meeker,2016,13254,12659,595,4.5
27,95,Mille Lacs,2016,12717,11958,759,6.0
27,97,Morrison,2016,17856,16853,1003,5.6
27,99,Mower,2016,20506,19858,648,3.2
27,101,Murray,2016,4953,4719,234,4.7
27,103,Nicollet,2016,20343,19767,576,2.8
27,105,Nobles,2016,11450,11018,432,3.8
27,107,Norman,2016,3439,3275,164,4.8
27,109,Olmsted,2016,85163,82628,2535,3.0
27,111,Otter Tail,2016,31275,29913,1362,4.4
27,113,Pennington,2016,9039,8518,521,5.8
27,115,Pine,2016,14830,13963,867,5.8
27,117,Pipestone,2016,4899,4712,187,3.8
27,119,Polk,2016,17136,16392,744,4.3
27,121,Pope,2016,6299,6075,224,3.6
27,123,Ramsey,2016,282227,272058,10169,3.6
27,125,Red Lake,2016,2289,2121,168,7.3
27,127,Redwood,2016,8315,7974,341,4.1
27,129,Renville,2016,8411,7969,442,5.3
27,131,Rice,2016,36083,34818,1265,3.5
27,133,Rock,2016,5907,5770,137,2.3
27,135,Roseau,2016,8244,7822,422,5.1
27,137,St. Louis,2016,102556,96688,5868,5.7
27,139,Scott,2016,80660,78068,2592,3.2
27,141,Sherburne,2016,50664,48603,2061,4.1
27,143,Sibley,2016,8488,8125,363,4.3
27,145,Stearns,2016,88889,85541,3348,3.8
27,147,Steele,2016,21176,20422,754,3.6
27,149,Stevens,2016,5647,5478,169,3.0
27,151,Swift,2016,5045,4773,272,5.4
27,153,Todd,2016,12900,12292,608,4.7
27,155,Traverse,2016,1705,1639,66,3.9
27,157,Wabasha,2016,12007,11564,443,3.7
27,159,Wadena,2016,6246,5875,371,5.9
27,161,Waseca,2016,9461,9055,406,4.3
27,163,Washington,2016,138733,134104,4629,3.3
27,165,Watonwan,2016,6573,6253,320,4.9
27,167,Wilkin,2016,3718,3597,121,3.3
27,169,Winona,2016,29250,28213,1037,3.5
27,171,Wright,2016,73060,70243,2817,3.9
27,173,Yellow Medicine,2016,5475,5265,210,3.8
28,1,Adams,2016,11207,10261,946,8.4
28,3,Alcorn,2016,15747,14911,836,5.3
28,5,Amite,2016,4489,4153,336,7.5
28,7,Attala,2016,6984,6506,478,6.8
28,9,Benton,2016,3034,2826,208,6.9
28,11,Bolivar,2016,13346,12360,986,7.4
28,13,Calhoun,2016,6156,5819,337,5.5
28,15,Carroll,2016,3549,3286,263,7.4
28,17,Chickasaw,2016,7062,6588,474,6.7
28,19,Choctaw,2016,3710,3496,214,5.8
28,21,Claiborne,2016,3082,2725,357,11.6
28,23,Clarke,2016,6049,5631,418,6.9
28,25,Clay,2016,7988,7326,662,8.3
28,27,Coahoma,2016,9181,8368,813,8.9
28,29,Copiah,2016,11230,10482,748,6.7
28,31,Covington,2016,8116,7666,450,5.5
28,33,DeSoto,2016,86854,83114,3740,4.3
28,35,Forrest,2016,33231,31288,1943,5.8
28,37,Franklin,2016,2841,2633,208,7.3
28,39,George,2016,8777,8113,664,7.6
28,41,Greene,2016,4268,3951,317,7.4
28,43,Grenada,2016,9563,9063,500,5.2
28,45,Hancock,2016,18788,17620,1168,6.2
28,47,Harrison,2016,86334,81468,4866,5.6
28,49,Hinds,2016,109481,103402,6079,5.6
28,51,Holmes,2016,5958,5290,668,11.2
28,53,Humphreys,2016,2366,2091,275,11.6
28,55,Issaquena,2016,400,343,57,14.3
28,57,Itawamba,2016,10354,9818,536,5.2
28,59,Jackson,2016,58850,54898,3952,6.7
28,61,Jasper,2016,6166,5684,482,7.8
28,63,Jefferson,2016,2221,1884,337,15.2
28,65,Jefferson Davis,2016,4165,3814,351,8.4
28,67,Jones,2016,25680,24075,1605,6.3
28,69,Kemper,2016,3540,3225,315,8.9
28,71,Lafayette,2016,25868,24579,1289,5.0
28,73,Lamar,2016,29464,28097,1367,4.6
28,75,Lauderdale,2016,31639,29740,1899,6.0
28,77,Lawrence,2016,4655,4317,338,7.3
28,79,Leake,2016,7720,7242,478,6.2
28,81,Lee,2016,40620,38598,2022,5.0
28,83,Leflore,2016,10296,9343,953,9.3
28,85,Lincoln,2016,14358,13524,834,5.8
28,87,Lowndes,2016,25405,23813,1592,6.3
28,89,Madison,2016,53109,50769,2340,4.4
28,91,Marion,2016,10221,9537,684,6.7
28,93,Marshall,2016,14492,13600,892,6.2
28,95,Monroe,2016,15569,14567,1002,6.4
28,97,Montgomery,2016,4218,3943,275,6.5
28,99,Neshoba,2016,10652,10027,625,5.9
28,101,Newton,2016,8603,8085,518,6.0
28,103,Noxubee,2016,3949,3616,333,8.4
28,105,Oktibbeha,2016,22946,21675,1271,5.5
28,107,Panola,2016,13128,12143,985,7.5
28,109,Pearl River,2016,23116,21706,1410,6.1
28,111,Perry,2016,4339,4023,316,7.3
28,113,Pike,2016,14608,13597,1011,6.9
28,115,Pontotoc,2016,14367,13673,694,4.8
28,117,Prentiss,2016,11011,10398,613,5.6
28,119,Quitman,2016,2607,2348,259,9.9
28,121,Rankin,2016,74573,71558,3015,4.0
28,123,Scott,2016,13197,12579,618,4.7
28,125,Sharkey,2016,1708,1555,153,9.0
28,127,Simpson,2016,10882,10278,604,5.6
28,129,Smith,2016,6707,6346,361,5.4
28,131,Stone,2016,6465,6021,444,6.9
28,133,Sunflower,2016,8307,7520,787,9.5
28,135,Tallahatchie,2016,5711,5316,395,6.9
28,137,Tate,2016,12026,11308,718,6.0
28,139,Tippah,2016,9353,8823,530,5.7
28,141,Tishomingo,2016,8217,7757,460,5.6
28,143,Tunica,2016,4589,4256,333,7.3
28,145,Union,2016,13593,12979,614,4.5
28,147,Walthall,2016,5016,4621,395,7.9
28,149,Warren,2016,20715,19377,1338,6.5
28,151,Washington,2016,17691,16068,1623,9.2
28,153,Wayne,2016,7503,6943,560,7.5
28,155,Webster,2016,3889,3640,249,6.4
28,157,Wilkinson,2016,2825,2532,293,10.4
28,159,Winston,2016,7076,6563,513,7.2
28,161,Yalobusha,2016,4864,4553,311,6.4
28,163,Yazoo,2016,9208,8515,693,7.5
29,1,Adair,2016,10359,9772,587,5.7
29,3,Andrew,2016,10021,9649,372,3.7
29,5,Atchison,2016,2838,2709,129,4.5
29,7,Audrain,2016,11120,10649,471,4.2
29,9,Barry,2016,15175,14495,680,4.5
29,11,Barton,2016,5313,5036,277,5.2
29,13,Bates,2016,8146,7711,435,5.3
29,15,Benton,2016,7250,6811,439,6.1
29,17,Bollinger,2016,5454,5169,285,5.2
29,19,Boone,2016,98042,94825,3217,3.3
29,21,Buchanan,2016,46642,44741,1901,4.1
29,23,Butler,2016,18771,17701,1070,5.7
29,25,Caldwell,2016,4469,4259,210,4.7
29,27,Callaway,2016,21800,20908,892,4.1
29,29,Camden,2016,18705,17620,1085,5.8
29,31,Cape Girardeau,2016,40711,38952,1759,4.3
29,33,Carroll,2016,4762,4507,255,5.4
29,35,Carter,2016,2540,2360,180,7.1
29,37,Cass,2016,54449,52196,2253,4.1
29,39,Cedar,2016,5789,5501,288,5.0
29,41,Chariton,2016,3851,3684,167,4.3
29,43,Christian,2016,43307,41613,1694,3.9
29,45,Clark,2016,3366,3119,247,7.3
29,47,Clay,2016,133855,128647,5208,3.9
29,49,Clinton,2016,10999,10536,463,4.2
29,51,Cole,2016,39380,37982,1398,3.6
29,53,Cooper,2016,7473,7106,367,4.9
29,55,Crawford,2016,10817,10240,577,5.3
29,57,Dade,2016,3583,3423,160,4.5
29,59,Dallas,2016,6947,6567,380,5.5
29,61,Daviess,2016,4111,3953,158,3.8
29,63,DeKalb,2016,5077,4856,221,4.4
29,65,Dent,2016,6195,5862,333,5.4
29,67,Douglas,2016,5075,4767,308,6.1
29,69,Dunklin,2016,12820,11767,1053,8.2
29,71,Franklin,2016,52613,50323,2290,4.4
29,73,Gasconade,2016,7692,7361,331,4.3
29,75,Gentry,2016,3584,3451,133,3.7
29,77,Greene,2016,148413,142801,5612,3.8
29,79,Grundy,2016,4897,4674,223,4.6
29,81,Harrison,2016,3968,3801,167,4.2
29,83,Henry,2016,9880,9388,492,5.0
29,85,Hickory,2016,3691,3484,207,5.6
29,87,Holt,2016,2682,2595,87,3.2
29,89,Howard,2016,5024,4802,222,4.4
29,91,Howell,2016,16097,15079,1018,6.3
29,93,Iron,2016,3710,3445,265,7.1
29,95,Jackson,2016,363794,345196,18598,5.1
29,97,Jasper,2016,57668,55277,2391,4.1
29,99,Jefferson,2016,117502,112461,5041,4.3
29,101,Johnson,2016,23156,22024,1132,4.9
29,103,Knox,2016,1982,1910,72,3.6
29,105,Laclede,2016,16142,15263,879,5.4
29,107,Lafayette,2016,17173,16434,739,4.3
29,109,Lawrence,2016,17766,16992,774,4.4
29,111,Lewis,2016,5132,4900,232,4.5
29,113,Lincoln,2016,27200,25980,1220,4.5
29,115,Linn,2016,5266,4914,352,6.7
29,117,Livingston,2016,7342,7056,286,3.9
29,119,McDonald,2016,10462,10010,452,4.3
29,121,Macon,2016,7606,7243,363,4.8
29,123,Madison,2016,5472,5172,300,5.5
29,125,Maries,2016,3906,3710,196,5.0
29,127,Marion,2016,14557,13935,622,4.3
29,129,Mercer,2016,1926,1838,88,4.6
29,131,Miller,2016,11871,11257,614,5.2
29,133,Mississippi,2016,6208,5797,411,6.6
29,135,Moniteau,2016,7463,7140,323,4.3
29,137,Monroe,2016,4157,3956,201,4.8
29,139,Montgomery,2016,5743,5481,262,4.6
29,141,Morgan,2016,7958,7491,467,5.9
29,143,New Madrid,2016,8230,7468,762,9.3
29,145,Newton,2016,28186,26960,1226,4.3
29,147,Nodaway,2016,10838,10334,504,4.7
29,149,Oregon,2016,4110,3864,246,6.0
29,151,Osage,2016,7219,6974,245,3.4
29,153,Ozark,2016,3627,3364,263,7.3
29,155,Pemiscot,2016,7023,6401,622,8.9
29,157,Perry,2016,10068,9710,358,3.6
29,159,Pettis,2016,20602,19588,1014,4.9
29,161,Phelps,2016,19485,18562,923,4.7
29,163,Pike,2016,8056,7694,362,4.5
29,165,Platte,2016,56646,54601,2045,3.6
29,167,Polk,2016,14205,13516,689,4.9
29,169,Pulaski,2016,14461,13678,783,5.4
29,171,Putnam,2016,2452,2340,112,4.6
29,173,Ralls,2016,5621,5395,226,4.0
29,175,Randolph,2016,10481,9933,548,5.2
29,177,Ray,2016,11135,10588,547,4.9
29,179,Reynolds,2016,2680,2507,173,6.5
29,181,Ripley,2016,5329,4954,375,7.0
29,183,St. Charles,2016,220910,213165,7745,3.5
29,185,St. Clair,2016,3912,3667,245,6.3
29,186,Ste. Genevieve,2016,8980,8563,417,4.6
29,187,St. Francois,2016,26210,24770,1440,5.5
29,189,St. Louis,2016,531064,508770,22294,4.2
29,195,Saline,2016,10726,10227,499,4.7
29,197,Schuyler,2016,1904,1783,121,6.4
29,199,Scotland,2016,2452,2351,101,4.1
29,201,Scott,2016,19950,18810,1140,5.7
29,203,Shannon,2016,3322,3079,243,7.3
29,205,Shelby,2016,3069,2940,129,4.2
29,207,Stoddard,2016,13286,12436,850,6.4
29,209,Stone,2016,13417,12478,939,7.0
29,211,Sullivan,2016,2768,2609,159,5.7
29,213,Taney,2016,26311,24362,1949,7.4
29,215,Texas,2016,9314,8731,583,6.3
29,217,Vernon,2016,9598,9133,465,4.8
29,219,Warren,2016,17480,16750,730,4.2
29,221,Washington,2016,10331,9677,654,6.3
29,223,Wayne,2016,5653,5351,302,5.3
29,225,Webster,2016,16883,16054,829,4.9
29,227,Worth,2016,1210,1174,36,3.0
29,229,Wright,2016,7595,7146,449,5.9
29,510,St. Louis city,2016,157198,148669,8529,5.4
30,1,Beaverhead,2016,5068,4894,174,3.4
30,3,Big Horn,2016,5539,5123,416,7.5
30,5,Blaine,2016,2369,2257,112,4.7
30,7,Broadwater,2016,2551,2421,130,5.1
30,9,Carbon,2016,5418,5196,222,4.1
30,11,Carter,2016,696,676,20,2.9
30,13,Cascade,2016,37781,36224,1557,4.1
30,15,Chouteau,2016,2513,2415,98,3.9
30,17,Custer,2016,6235,6007,228,3.7
30,19,Daniels,2016,934,909,25,2.7
30,21,Dawson,2016,4601,4418,183,4.0
30,23,Deer Lodge,2016,5296,5087,209,3.9
30,25,Fallon,2016,1810,1742,68,3.8
30,27,Fergus,2016,5763,5528,235,4.1
30,29,Flathead,2016,45960,43298,2662,5.8
30,31,Gallatin,2016,62060,60245,1815,2.9
30,33,Garfield,2016,763,740,23,3.0
30,35,Glacier,2016,5826,5310,516,8.9
30,37,Golden Valley,2016,378,361,17,4.5
30,39,Granite,2016,1632,1532,100,6.1
30,41,Hill,2016,7797,7448,349,4.5
30,43,Jefferson,2016,5669,5399,270,4.8
30,45,Judith Basin,2016,932,899,33,3.5
30,47,Lake,2016,13078,12435,643,4.9
30,49,Lewis and Clark,2016,35167,33961,1206,3.4
30,51,Liberty,2016,988,956,32,3.2
30,53,Lincoln,2016,7940,7200,740,9.3
30,55,McCone,2016,1042,1021,21,2.0
30,57,Madison,2016,4412,4239,173,3.9
30,59,Meagher,2016,915,877,38,4.2
30,61,Mineral,2016,1688,1556,132,7.8
30,63,Missoula,2016,61361,58972,2389,3.9
30,65,Musselshell,2016,2294,2172,122,5.3
30,67,Park,2016,8406,8032,374,4.4
30,69,Petroleum,2016,277,264,13,4.7
30,71,Phillips,2016,1935,1829,106,5.5
30,73,Pondera,2016,2864,2739,125,4.4
30,75,Powder River,2016,1066,1040,26,2.4
30,77,Powell,2016,2868,2718,150,5.2
30,79,Prairie,2016,526,508,18,3.4
30,81,Ravalli,2016,19569,18594,975,5.0
30,83,Richland,2016,6213,5893,320,5.2
30,85,Roosevelt,2016,4687,4428,259,5.5
30,87,Rosebud,2016,4107,3874,233,5.7
30,89,Sanders,2016,4758,4377,381,8.0
30,91,Sheridan,2016,1958,1892,66,3.4
30,93,Silver Bow,2016,17184,16421,763,4.4
30,95,Stillwater,2016,4808,4609,199,4.1
30,97,Sweet Grass,2016,1796,1738,58,3.2
30,99,Teton,2016,2828,2722,106,3.7
30,101,Toole,2016,2224,2144,80,3.6
30,103,Treasure,2016,353,337,16,4.5
30,105,Valley,2016,4400,4246,154,3.5
30,107,Wheatland,2016,797,755,42,5.3
30,109,Wibaux,2016,513,492,21,4.1
30,111,Yellowstone,2016,81129,78099,3030,3.7
31,1,Adams,2016,16749,16226,523,3.1
31,3,Antelope,2016,3613,3519,94,2.6
31,5,Arthur,2016,228,215,13,5.7
31,7,Banner,2016,420,405,15,3.6
31,9,Blaine,2016,267,255,12,4.5
31,11,Boone,2016,3021,2942,79,2.6
31,13,Box Butte,2016,5675,5472,203,3.6
31,15,Boyd,2016,1105,1072,33,3.0
31,17,Brown,2016,1388,1337,51,3.7
31,19,Buffalo,2016,27371,26687,684,2.5
31,21,Burt,2016,3566,3435,131,3.7
31,23,Butler,2016,4652,4503,149,3.2
31,25,Cass,2016,13217,12774,443,3.4
31,27,Cedar,2016,4595,4478,117,2.5
31,29,Chase,2016,2304,2257,47,2.0
31,31,Cherry,2016,3491,3412,79,2.3
31,33,Cheyenne,2016,5483,5329,154,2.8
31,35,Clay,2016,3340,3237,103,3.1
31,37,Colfax,2016,5582,5424,158,2.8
31,39,Cuming,2016,4742,4606,136,2.9
31,41,Custer,2016,6387,6238,149,2.3
31,43,Dakota,2016,10969,10515,454,4.1
31,45,Dawes,2016,5243,5089,154,2.9
31,47,Dawson,2016,13037,12653,384,2.9
31,49,Deuel,2016,1067,1039,28,2.6
31,51,Dixon,2016,3086,2984,102,3.3
31,53,Dodge,2016,19237,18649,588,3.1
31,55,Douglas,2016,289613,280038,9575,3.3
31,57,Dundy,2016,1202,1176,26,2.2
31,59,Fillmore,2016,3201,3113,88,2.7
31,61,Franklin,2016,1509,1464,45,3.0
31,63,Frontier,2016,1578,1534,44,2.8
31,65,Furnas,2016,2731,2655,76,2.8
31,67,Gage,2016,11112,10749,363,3.3
31,69,Garden,2016,1194,1155,39,3.3
31,71,Garfield,2016,1162,1133,29,2.5
31,73,Gosper,2016,1062,1035,27,2.5
31,75,Grant,2016,455,445,10,2.2
31,77,Greeley,2016,1241,1203,38,3.1
31,79,Hall,2016,31581,30429,1152,3.6
31,81,Hamilton,2016,4679,4549,130,2.8
31,83,Harlan,2016,1767,1723,44,2.5
31,85,Hayes,2016,593,579,14,2.4
31,87,Hitchcock,2016,1313,1266,47,3.6
31,89,Holt,2016,5892,5747,145,2.5
31,91,Hooker,2016,394,380,14,3.6
31,93,Howard,2016,3318,3209,109,3.3
31,95,Jefferson,2016,4245,4143,102,2.4
31,97,Johnson,2016,2103,2037,66,3.1
31,99,Kearney,2016,3761,3673,88,2.3
31,101,Keith,2016,4643,4509,134,2.9
31,103,Keya Paha,2016,623,610,13,2.1
31,105,Kimball,2016,1982,1902,80,4.0
31,107,Knox,2016,4745,4601,144,3.0
31,109,Lancaster,2016,169981,165281,4700,2.8
31,111,Lincoln,2016,18815,18238,577,3.1
31,113,Logan,2016,486,472,14,2.9
31,115,Loup,2016,398,384,14,3.5
31,117,McPherson,2016,466,455,11,2.4
31,119,Madison,2016,19266,18738,528,2.7
31,121,Merrick,2016,4056,3910,146,3.6
31,123,Morrill,2016,2663,2579,84,3.2
31,125,Nance,2016,2011,1956,55,2.7
31,127,Nemaha,2016,3637,3505,132,3.6
31,129,Nuckolls,2016,2380,2311,69,2.9
31,131,Otoe,2016,8307,8026,281,3.4
31,133,Pawnee,2016,1663,1626,37,2.2
31,135,Perkins,2016,1830,1790,40,2.2
31,137,Phelps,2016,4957,4833,124,2.5
31,139,Pierce,2016,4168,4059,109,2.6
31,141,Platte,2016,17068,16476,592,3.5
31,143,Polk,2016,2898,2821,77,2.7
31,145,Red Willow,2016,6009,5840,169,2.8
31,147,Richardson,2016,4261,4124,137,3.2
31,149,Rock,2016,896,873,23,2.6
31,151,Saline,2016,7391,7164,227,3.1
31,153,Sarpy,2016,92568,89882,2686,2.9
31,155,Saunders,2016,10935,10600,335,3.1
31,157,Scotts Bluff,2016,18951,18290,661,3.5
31,159,Seward,2016,8802,8551,251,2.9
31,161,Sheridan,2016,2753,2675,78,2.8
31,163,Sherman,2016,1726,1671,55,3.2
31,165,Sioux,2016,788,767,21,2.7
31,167,Stanton,2016,3460,3370,90,2.6
31,169,Thayer,2016,2919,2848,71,2.4
31,171,Thomas,2016,451,436,15,3.3
31,173,Thurston,2016,2995,2852,143,4.8
31,175,Valley,2016,2104,2045,59,2.8
31,177,Washington,2016,11169,10813,356,3.2
31,179,Wayne,2016,5656,5506,150,2.7
31,181,Webster,2016,1722,1668,54,3.1
31,183,Wheeler,2016,569,557,12,2.1
31,185,York,2016,7365,7166,199,2.7
32,1,Churchill,2016,10304,9724,580,5.6
32,3,Clark,2016,1040292,978799,61493,5.9
32,5,Douglas,2016,22069,20810,1259,5.7
32,7,Elko,2016,26709,25497,1212,4.5
32,9,Esmeralda,2016,511,487,24,4.7
32,11,Eureka,2016,980,935,45,4.6
32,13,Humboldt,2016,7990,7545,445,5.6
32,15,Lander,2016,3106,2909,197,6.3
32,17,Lincoln,2016,1969,1863,106,5.4
32,19,Lyon,2016,21106,19500,1606,7.6
32,21,Mineral,2016,1994,1866,128,6.4
32,23,Nye,2016,15905,14721,1184,7.4
32,27,Pershing,2016,2439,2293,146,6.0
32,29,Storey,2016,1891,1770,121,6.4
32,31,Washoe,2016,227991,216417,11574,5.1
32,33,White Pine,2016,4448,4238,210,4.7
32,510,Carson City,2016,24529,23017,1512,6.2
33,1,Belknap,2016,31425,30534,891,2.8
33,3,Carroll,2016,23700,23001,699,2.9
33,5,Cheshire,2016,41456,40321,1135,2.7
33,7,Coos,2016,14662,14109,553,3.8
33,9,Grafton,2016,48810,47656,1154,2.4
33,11,Hillsborough,2016,232307,225271,7036,3.0
33,13,Merrimack,2016,82033,79939,2094,2.6
33,15,Rockingham,2016,181949,176434,5515,3.0
33,17,Strafford,2016,72510,70662,1848,2.5
33,19,Sullivan,2016,23625,23074,551,2.3
34,1,Atlantic,2016,122892,113830,9062,7.4
34,3,Bergen,2016,480567,460611,19956,4.2
34,5,Burlington,2016,230481,220255,10226,4.4
34,7,Camden,2016,252929,239104,13825,5.5
34,9,Cape May,2016,46793,42217,4576,9.8
34,11,Cumberland,2016,66509,61566,4943,7.4
34,13,Essex,2016,369938,347909,22029,6.0
34,15,Gloucester,2016,149104,141597,7507,5.0
34,17,Hudson,2016,360457,343732,16725,4.6
34,19,Hunterdon,2016,64581,62170,2411,3.7
34,21,Mercer,2016,198908,190357,8551,4.3
34,23,Middlesex,2016,437873,418638,19235,4.4
34,25,Monmouth,2016,327742,313267,14475,4.4
34,27,Morris,2016,259391,249324,10067,3.9
34,29,Ocean,2016,268913,254984,13929,5.2
34,31,Passaic,2016,244402,229422,14980,6.1
34,33,Salem,2016,30082,28171,1911,6.4
34,35,Somerset,2016,172894,165942,6952,4.0
34,37,Sussex,2016,75191,71676,3515,4.7
34,39,Union,2016,276649,262474,14175,5.1
34,41,Warren,2016,56527,53955,2572,4.6
35,1,Bernalillo,2016,329282,309914,19368,5.9
35,3,Catron,2016,1214,1115,99,8.2
35,5,Chaves,2016,28257,26338,1919,6.8
35,6,Cibola,2016,9379,8600,779,8.3
35,7,Colfax,2016,5874,5517,357,6.1
35,9,Curry,2016,22136,21004,1132,5.1
35,11,De Baca,2016,839,799,40,4.8
35,13,Dona Ana,2016,96370,89390,6980,7.2
35,15,Eddy,2016,28918,27013,1905,6.6
35,17,Grant,2016,12559,11740,819,6.5
35,19,Guadalupe,2016,1705,1593,112,6.6
35,21,Harding,2016,280,260,20,7.1
35,23,Hidalgo,2016,2219,2095,124,5.6
35,25,Lea,2016,27967,25359,2608,9.3
35,27,Lincoln,2016,8708,8184,524,6.0
35,28,Los Alamos,2016,8862,8482,380,4.3
35,29,Luna,2016,10870,9283,1587,14.6
35,31,McKinley,2016,24587,22260,2327,9.5
35,33,Mora,2016,2256,2057,199,8.8
35,35,Otero,2016,25674,24101,1573,6.1
35,37,Quay,2016,3235,3013,222,6.9
35,39,Rio Arriba,2016,16892,15617,1275,7.5
35,41,Roosevelt,2016,8130,7661,469,5.8
35,43,Sandoval,2016,64607,60300,4307,6.7
35,45,San Juan,2016,54678,49824,4854,8.9
35,47,San Miguel,2016,11179,10310,869,7.8
35,49,Santa Fe,2016,74060,70098,3962,5.3
35,51,Sierra,2016,4094,3745,349,8.5
35,53,Socorro,2016,6733,6233,500,7.4
35,55,Taos,2016,15062,13780,1282,8.5
35,57,Torrance,2016,5554,5042,512,9.2
35,59,Union,2016,1909,1831,78,4.1
35,61,Valencia,2016,30156,27958,2198,7.3
36,1,Albany,2016,158526,151974,6552,4.1
36,3,Allegany,2016,20070,18781,1289,6.4
36,5,Bronx,2016,603006,560468,42538,7.1
36,7,Broome,2016,85916,81177,4739,5.5
36,9,Cattaraugus,2016,34879,32760,2119,6.1
36,11,Cayuga,2016,36716,34828,1888,5.1
36,13,Chautauqua,2016,56159,52844,3315,5.9
36,15,Chemung,2016,36232,34123,2109,5.8
36,17,Chenango,2016,22844,21668,1176,5.1
36,19,Clinton,2016,35822,33869,1953,5.5
36,21,Columbia,2016,31473,30294,1179,3.7
36,23,Cortland,2016,22999,21667,1332,5.8
36,25,Delaware,2016,19234,18154,1080,5.6
36,27,Dutchess,2016,143108,137045,6063,4.2
36,29,Erie,2016,445373,423060,22313,5.0
36,31,Essex,2016,17248,16311,937,5.4
36,33,Franklin,2016,19804,18662,1142,5.8
36,35,Fulton,2016,23238,21886,1352,5.8
36,37,Genesee,2016,29744,28357,1387,4.7
36,39,Greene,2016,20575,19517,1058,5.1
36,41,Hamilton,2016,2366,2210,156,6.6
36,43,Herkimer,2016,28187,26620,1567,5.6
36,45,Jefferson,2016,45691,42795,2896,6.3
36,47,Kings,2016,1206229,1142605,63624,5.3
36,49,Lewis,2016,11752,10949,803,6.8
36,51,Livingston,2016,31052,29491,1561,5.0
36,53,Madison,2016,32717,30966,1751,5.4
36,55,Monroe,2016,363421,346044,17377,4.8
36,57,Montgomery,2016,22321,21022,1299,5.8
36,59,Nassau,2016,700139,672300,27839,4.0
36,61,New York,2016,908259,867324,40935,4.5
36,63,Niagara,2016,100281,94345,5936,5.9
36,65,Oneida,2016,101706,96689,5017,4.9
36,67,Onondaga,2016,221252,211093,10159,4.6
36,69,Ontario,2016,55084,52667,2417,4.4
36,71,Orange,2016,178963,171096,7867,4.4
36,73,Orleans,2016,17760,16727,1033,5.8
36,75,Oswego,2016,53335,49835,3500,6.6
36,77,Otsego,2016,28215,26806,1409,5.0
36,79,Putnam,2016,50700,48646,2054,4.1
36,81,Queens,2016,1150751,1099048,51703,4.5
36,83,Rensselaer,2016,81585,78036,3549,4.4
36,85,Richmond,2016,219313,207941,11372,5.2
36,87,Rockland,2016,152561,146064,6497,4.3
36,89,St. Lawrence,2016,43387,40479,2908,6.7
36,91,Saratoga,2016,117493,112934,4559,3.9
36,93,Schenectady,2016,75807,72465,3342,4.4
36,95,Schoharie,2016,14731,13917,814,5.5
36,97,Schuyler,2016,8281,7775,506,6.1
36,99,Seneca,2016,15494,14743,751,4.8
36,101,Steuben,2016,43187,40628,2559,5.9
36,103,Suffolk,2016,774238,739954,34284,4.4
36,105,Sullivan,2016,34048,32392,1656,4.9
36,107,Tioga,2016,23027,21824,1203,5.2
36,109,Tompkins,2016,50377,48245,2132,4.2
36,111,Ulster,2016,88189,84222,3967,4.5
36,113,Warren,2016,32003,30292,1711,5.3
36,115,Washington,2016,28352,27012,1340,4.7
36,117,Wayne,2016,44010,41779,2231,5.1
36,119,Westchester,2016,477963,457115,20848,4.4
36,121,Wyoming,2016,18115,17133,982,5.4
36,123,Yates,2016,11720,11194,526,4.5
37,1,Alamance,2016,78694,74964,3730,4.7
37,3,Alexander,2016,17778,17022,756,4.3
37,5,Alleghany,2016,4413,4170,243,5.5
37,7,Anson,2016,10627,10011,616,5.8
37,9,Ashe,2016,12468,11870,598,4.8
37,11,Avery,2016,7551,7171,380,5.0
37,13,Beaufort,2016,20244,19091,1153,5.7
37,15,Bertie,2016,8411,7854,557,6.6
37,17,Bladen,2016,14524,13519,1005,6.9
37,19,Brunswick,2016,49551,46354,3197,6.5
37,21,Buncombe,2016,133951,128768,5183,3.9
37,23,Burke,2016,39733,37798,1935,4.9
37,25,Cabarrus,2016,100864,96254,4610,4.6
37,27,Caldwell,2016,35786,33928,1858,5.2
37,29,Camden,2016,4643,4404,239,5.1
37,31,Carteret,2016,31473,29850,1623,5.2
37,33,Caswell,2016,9661,9135,526,5.4
37,35,Catawba,2016,76648,73016,3632,4.7
37,37,Chatham,2016,34416,32957,1459,4.2
37,39,Cherokee,2016,11111,10479,632,5.7
37,41,Chowan,2016,5585,5227,358,6.4
37,43,Clay,2016,4039,3818,221,5.5
37,45,Cleveland,2016,46669,44114,2555,5.5
37,47,Columbus,2016,22528,21081,1447,6.4
37,49,Craven,2016,41628,39448,2180,5.2
37,51,Cumberland,2016,126947,118818,8129,6.4
37,53,Currituck,2016,13111,12446,665,5.1
37,55,Dare,2016,19939,18593,1346,6.8
37,57,Davidson,2016,79258,75444,3814,4.8
37,59,Davie,2016,20107,19202,905,4.5
37,61,Duplin,2016,26422,25012,1410,5.3
37,63,Durham,2016,161608,154321,7287,4.5
37,65,Edgecombe,2016,22353,20411,1942,8.7
37,67,Forsyth,2016,182081,173210,8871,4.9
37,69,Franklin,2016,29255,27725,1530,5.2
37,71,Gaston,2016,105324,99700,5624,5.3
37,73,Gates,2016,5175,4909,266,5.1
37,75,Graham,2016,3092,2819,273,8.8
37,77,Granville,2016,29191,27928,1263,4.3
37,79,Greene,2016,9496,8992,504,5.3
37,81,Guilford,2016,257680,244175,13505,5.2
37,83,Halifax,2016,20621,18985,1636,7.9
37,85,Harnett,2016,51302,48328,2974,5.8
37,87,Haywood,2016,28396,27104,1292,4.5
37,89,Henderson,2016,52134,49909,2225,4.3
37,91,Hertford,2016,9287,8676,611,6.6
37,93,Hoke,2016,19855,18545,1310,6.6
37,95,Hyde,2016,2103,1904,199,9.5
37,97,Iredell,2016,84300,80244,4056,4.8
37,99,Jackson,2016,18773,17751,1022,5.4
37,101,Johnston,2016,91306,87026,4280,4.7
37,103,Jones,2016,4501,4263,238,5.3
37,105,Lee,2016,26150,24611,1539,5.9
37,107,Lenoir,2016,27566,25947,1619,5.9
37,109,Lincoln,2016,40966,39033,1933,4.7
37,111,McDowell,2016,20950,19943,1007,4.8
37,113,Macon,2016,15171,14353,818,5.4
37,115,Madison,2016,9671,9200,471,4.9
37,117,Martin,2016,9784,9122,662,6.8
37,119,Mecklenburg,2016,581630,554067,27563,4.7
37,121,Mitchell,2016,6169,5791,378,6.1
37,123,Montgomery,2016,11664,11061,603,5.2
37,125,Moore,2016,39389,37411,1978,5.0
37,127,Nash,2016,43792,40909,2883,6.6
37,129,New Hanover,2016,115690,110226,5464,4.7
37,131,Northampton,2016,7791,7225,566,7.3
37,133,Onslow,2016,63519,60018,3501,5.5
37,135,Orange,2016,74699,71532,3167,4.2
37,137,Pamlico,2016,5392,5107,285,5.3
37,139,Pasquotank,2016,17344,16252,1092,6.3
37,141,Pender,2016,26769,25350,1419,5.3
37,143,Perquimans,2016,5086,4758,328,6.4
37,145,Person,2016,17980,16993,987,5.5
37,147,Pitt,2016,87935,83032,4903,5.6
37,149,Polk,2016,8798,8389,409,4.6
37,151,Randolph,2016,66681,63396,3285,4.9
37,153,Richmond,2016,16739,15579,1160,6.9
37,155,Robeson,2016,50401,46394,4007,8.0
37,157,Rockingham,2016,40727,38423,2304,5.7
37,159,Rowan,2016,64035,60466,3569,5.6
37,161,Rutherford,2016,24733,23078,1655,6.7
37,163,Sampson,2016,29423,27817,1606,5.5
37,165,Scotland,2016,11601,10540,1061,9.1
37,167,Stanly,2016,29195,27841,1354,4.6
37,169,Stokes,2016,21805,20762,1043,4.8
37,171,Surry,2016,33418,31820,1598,4.8
37,173,Swain,2016,7096,6663,433,6.1
37,175,Transylvania,2016,13915,13237,678,4.9
37,177,Tyrrell,2016,1525,1396,129,8.5
37,179,Union,2016,115411,110320,5091,4.4
37,181,Vance,2016,17949,16663,1286,7.2
37,183,Wake,2016,554963,531092,23871,4.3
37,185,Warren,2016,7120,6600,520,7.3
37,187,Washington,2016,4850,4490,360,7.4
37,189,Watauga,2016,27861,26608,1253,4.5
37,191,Wayne,2016,53390,50274,3116,5.8
37,193,Wilkes,2016,30109,28665,1444,4.8
37,195,Wilson,2016,36377,33408,2969,8.2
37,197,Yadkin,2016,17557,16786,771,4.4
37,199,Yancey,2016,7455,7070,385,5.2
38,1,Adams,2016,1131,1102,29,2.6
38,3,Barnes,2016,5609,5430,179,3.2
38,5,Benson,2016,2429,2332,97,4.0
38,7,Billings,2016,437,424,13,3.0
38,9,Bottineau,2016,3222,3072,150,4.7
38,11,Bowman,2016,1832,1792,40,2.2
38,13,Burke,2016,1143,1091,52,4.5
38,15,Burleigh,2016,50517,49212,1305,2.6
38,17,Cass,2016,99994,97756,2238,2.2
38,19,Cavalier,2016,2111,2055,56,2.7
38,21,Dickey,2016,2541,2492,49,1.9
38,23,Divide,2016,1680,1636,44,2.6
38,25,Dunn,2016,3241,3139,102,3.1
38,27,Eddy,2016,1276,1221,55,4.3
38,29,Emmons,2016,1581,1512,69,4.4
38,31,Foster,2016,1682,1632,50,3.0
38,33,Golden Valley,2016,969,943,26,2.7
38,35,Grand Forks,2016,38733,37818,915,2.4
38,37,Grant,2016,1294,1255,39,3.0
38,39,Griggs,2016,1157,1124,33,2.9
38,41,Hettinger,2016,1536,1490,46,3.0
38,43,Kidder,2016,1373,1321,52,3.8
38,45,LaMoure,2016,2310,2255,55,2.4
38,47,Logan,2016,957,924,33,3.4
38,49,McHenry,2016,3369,3204,165,4.9
38,51,McIntosh,2016,1238,1200,38,3.1
38,53,McKenzie,2016,7930,7631,299,3.8
38,55,McLean,2016,5058,4882,176,3.5
38,57,Mercer,2016,4643,4439,204,4.4
38,59,Morton,2016,16758,16212,546,3.3
38,61,Mountrail,2016,7117,6904,213,3.0
38,63,Nelson,2016,1531,1479,52,3.4
38,65,Oliver,2016,896,847,49,5.5
38,67,Pembina,2016,3652,3469,183,5.0
38,69,Pierce,2016,1894,1819,75,4.0
38,71,Ramsey,2016,6133,5958,175,2.9
38,73,Ransom,2016,2833,2769,64,2.3
38,75,Renville,2016,1306,1255,51,3.9
38,77,Richland,2016,8884,8640,244,2.7
38,79,Rolette,2016,4977,4437,540,10.8
38,81,Sargent,2016,2327,2282,45,1.9
38,83,Sheridan,2016,734,693,41,5.6
38,85,Sioux,2016,1336,1277,59,4.4
38,87,Slope,2016,435,424,11,2.5
38,89,Stark,2016,18048,17341,707,3.9
38,91,Steele,2016,1072,1049,23,2.1
38,93,Stutsman,2016,11055,10782,273,2.5
38,95,Towner,2016,1328,1299,29,2.2
38,97,Traill,2016,4589,4461,128,2.8
38,99,Walsh,2016,5649,5435,214,3.8
38,101,Ward,2016,33466,32086,1380,4.1
38,103,Wells,2016,2185,2101,84,3.8
38,105,Williams,2016,22585,21599,986,4.4
39,1,Adams,2016,10987,10156,831,7.6
39,3,Allen,2016,48450,46006,2444,5.0
39,5,Ashland,2016,26365,25018,1347,5.1
39,7,Ashtabula,2016,44399,41673,2726,6.1
39,9,Athens,2016,28129,26318,1811,6.4
39,11,Auglaize,2016,24716,23789,927,3.8
39,13,Belmont,2016,31137,28798,2339,7.5
39,15,Brown,2016,19569,18429,1140,5.8
39,17,Butler,2016,190182,181562,8620,4.5
39,19,Carroll,2016,13491,12562,929,6.9
39,21,Champaign,2016,19958,19055,903,4.5
39,23,Clark,2016,63827,60463,3364,5.3
39,25,Clermont,2016,104313,99654,4659,4.5
39,27,Clinton,2016,17238,16228,1010,5.9
39,29,Columbiana,2016,48577,45310,3267,6.7
39,31,Coshocton,2016,15054,13980,1074,7.1
39,33,Crawford,2016,19246,18079,1167,6.1
39,35,Cuyahoga,2016,612160,578168,33992,5.6
39,37,Darke,2016,26477,25380,1097,4.1
39,39,Defiance,2016,18453,17536,917,5.0
39,41,Delaware,2016,105264,101438,3826,3.6
39,43,Erie,2016,37574,35494,2080,5.5
39,45,Fairfield,2016,76253,72940,3313,4.3
39,47,Fayette,2016,14545,13896,649,4.5
39,49,Franklin,2016,669446,641672,27774,4.1
39,51,Fulton,2016,22766,21700,1066,4.7
39,53,Gallia,2016,12176,11340,836,6.9
39,55,Geauga,2016,49049,46852,2197,4.5
39,57,Greene,2016,81414,77853,3561,4.4
39,59,Guernsey,2016,18968,17613,1355,7.1
39,61,Hamilton,2016,406542,388426,18116,4.5
39,63,Hancock,2016,41625,40080,1545,3.7
39,65,Hardin,2016,14434,13709,725,5.0
39,67,Harrison,2016,6998,6460,538,7.7
39,69,Henry,2016,13660,12924,736,5.4
39,71,Highland,2016,16998,15913,1085,6.4
39,73,Hocking,2016,13063,12329,734,5.6
39,75,Holmes,2016,21073,20309,764,3.6
39,77,Huron,2016,28231,26380,1851,6.6
39,79,Jackson,2016,12853,11837,1016,7.9
39,81,Jefferson,2016,29024,26583,2441,8.4
39,83,Knox,2016,31354,29894,1460,4.7
39,85,Lake,2016,124566,118449,6117,4.9
39,87,Lawrence,2016,24851,23223,1628,6.6
39,89,Licking,2016,88594,84685,3909,4.4
39,91,Logan,2016,23413,22426,987,4.2
39,93,Lorain,2016,152264,143118,9146,6.0
39,95,Lucas,2016,211249,200233,11016,5.2
39,97,Madison,2016,20417,19608,809,4.0
39,99,Mahoning,2016,106380,99542,6838,6.4
39,101,Marion,2016,27849,26425,1424,5.1
39,103,Medina,2016,95889,91657,4232,4.4
39,105,Meigs,2016,8990,8218,772,8.6
39,107,Mercer,2016,23516,22743,773,3.3
39,109,Miami,2016,53220,50887,2333,4.4
39,111,Monroe,2016,5344,4745,599,11.2
39,113,Montgomery,2016,251039,238575,12464,5.0
39,115,Morgan,2016,6780,6214,566,8.3
39,117,Morrow,2016,16834,15978,856,5.1
39,119,Muskingum,2016,39897,37474,2423,6.1
39,121,Noble,2016,4913,4481,432,8.8
39,123,Ottawa,2016,21118,19744,1374,6.5
39,125,Paulding,2016,8910,8498,412,4.6
39,127,Perry,2016,15954,14929,1025,6.4
39,129,Pickaway,2016,26309,25028,1281,4.9
39,131,Pike,2016,10851,10031,820,7.6
39,133,Portage,2016,87472,83048,4424,5.1
39,135,Preble,2016,21103,20090,1013,4.8
39,137,Putnam,2016,18975,18275,700,3.7
39,139,Richland,2016,53626,50633,2993,5.6
39,141,Ross,2016,33973,32087,1886,5.6
39,143,Sandusky,2016,31149,29669,1480,4.8
39,145,Scioto,2016,29999,27662,2337,7.8
39,147,Seneca,2016,27259,25914,1345,4.9
39,149,Shelby,2016,24167,23158,1009,4.2
39,151,Stark,2016,187210,176932,10278,5.5
39,153,Summit,2016,273479,259430,14049,5.1
39,155,Trumbull,2016,90798,84612,6186,6.8
39,157,Tuscarawas,2016,45200,42585,2615,5.8
39,159,Union,2016,27903,26830,1073,3.8
39,161,Van Wert,2016,14361,13777,584,4.1
39,163,Vinton,2016,5476,5088,388,7.1
39,165,Warren,2016,115051,110242,4809,4.2
39,167,Washington,2016,27890,25931,1959,7.0
39,169,Wayne,2016,61460,58995,2465,4.0
39,171,Williams,2016,19100,18232,868,4.5
39,173,Wood,2016,70927,67946,2981,4.2
39,175,Wyandot,2016,12724,12249,475,3.7
40,1,Adair,2016,8141,7683,458,5.6
40,3,Alfalfa,2016,2965,2870,95,3.2
40,5,Atoka,2016,5052,4731,321,6.4
40,7,Beaver,2016,2885,2798,87,3.0
40,9,Beckham,2016,11011,10246,765,6.9
40,11,Blaine,2016,4388,4232,156,3.6
40,13,Bryan,2016,19490,18680,810,4.2
40,15,Caddo,2016,11908,11298,610,5.1
40,17,Canadian,2016,69350,66683,2667,3.8
40,19,Carter,2016,22690,21557,1133,5.0
40,21,Cherokee,2016,19259,18237,1022,5.3
40,23,Choctaw,2016,5742,5319,423,7.4
40,25,Cimarron,2016,1416,1382,34,2.4
40,27,Cleveland,2016,139036,133913,5123,3.7
40,29,Coal,2016,2317,2153,164,7.1
40,31,Comanche,2016,49391,47196,2195,4.4
40,33,Cotton,2016,2887,2753,134,4.6
40,35,Craig,2016,6245,5954,291,4.7
40,37,Creek,2016,31452,29687,1765,5.6
40,39,Custer,2016,15181,14514,667,4.4
40,41,Delaware,2016,17947,17100,847,4.7
40,43,Dewey,2016,2673,2568,105,3.9
40,45,Ellis,2016,2254,2171,83,3.7
40,47,Garfield,2016,28969,27748,1221,4.2
40,49,Garvin,2016,12697,12042,655,5.2
40,51,Grady,2016,26059,24810,1249,4.8
40,53,Grant,2016,3003,2910,93,3.1
40,55,Greer,2016,2186,2030,156,7.1
40,57,Harmon,2016,1292,1244,48,3.7
40,59,Harper,2016,1908,1838,70,3.7
40,61,Haskell,2016,4493,4134,359,8.0
40,63,Hughes,2016,5503,5117,386,7.0
40,65,Jackson,2016,10991,10526,465,4.2
40,67,Jefferson,2016,2705,2518,187,6.9
40,69,Johnston,2016,4368,4120,248,5.7
40,71,Kay,2016,18913,17761,1152,6.1
40,73,Kingfisher,2016,8444,8174,270,3.2
40,75,Kiowa,2016,4104,3893,211,5.1
40,77,Latimer,2016,3716,3406,310,8.3
40,79,Le Flore,2016,19720,18405,1315,6.7
40,81,Lincoln,2016,15857,15044,813,5.1
40,83,Logan,2016,21559,20717,842,3.9
40,85,Love,2016,6568,6368,200,3.0
40,87,McClain,2016,18944,18192,752,4.0
40,89,McCurtain,2016,14780,13760,1020,6.9
40,91,McIntosh,2016,7042,6435,607,8.6
40,93,Major,2016,3991,3832,159,4.0
40,95,Marshall,2016,6607,6285,322,4.9
40,97,Mayes,2016,19418,18464,954,4.9
40,99,Murray,2016,6338,6062,276,4.4
40,101,Muskogee,2016,29588,28033,1555,5.3
40,103,Noble,2016,5756,5560,196,3.4
40,105,Nowata,2016,4679,4404,275,5.9
40,107,Okfuskee,2016,4545,4278,267,5.9
40,109,Oklahoma,2016,374767,359263,15504,4.1
40,111,Okmulgee,2016,16123,15005,1118,6.9
40,113,Osage,2016,21040,19871,1169,5.6
40,115,Ottawa,2016,14450,13749,701,4.9
40,117,Pawnee,2016,7478,6999,479,6.4
40,119,Payne,2016,38882,37488,1394,3.6
40,121,Pittsburg,2016,17604,16561,1043,5.9
40,123,Pontotoc,2016,18442,17717,725,3.9
40,125,Pottawatomie,2016,33026,31553,1473,4.5
40,127,Pushmataha,2016,4866,4523,343,7.0
40,129,Roger Mills,2016,1809,1719,90,5.0
40,131,Rogers,2016,44828,42659,2169,4.8
40,133,Seminole,2016,9424,8795,629,6.7
40,135,Sequoyah,2016,16815,15799,1016,6.0
40,137,Stephens,2016,18974,17232,1742,9.2
40,139,Texas,2016,9396,9089,307,3.3
40,141,Tillman,2016,3308,3167,141,4.3
40,143,Tulsa,2016,317900,303589,14311,4.5
40,145,Wagoner,2016,36576,34892,1684,4.6
40,147,Washington,2016,23906,22779,1127,4.7
40,149,Washita,2016,5311,4956,355,6.7
40,151,Woods,2016,5216,5055,161,3.1
40,153,Woodward,2016,9502,8933,569,6.0
41,1,Baker,2016,6933,6504,429,6.2
41,3,Benton,2016,46695,44891,1804,3.9
41,5,Clackamas,2016,212188,203105,9083,4.3
41,7,Clatsop,2016,18975,18097,878,4.6
41,9,Columbia,2016,23557,22143,1414,6.0
41,11,Coos,2016,26370,24713,1657,6.3
41,13,Crook,2016,9316,8682,634,6.8
41,15,Curry,2016,9019,8421,598,6.6
41,17,Deschutes,2016,89650,85369,4281,4.8
41,19,Douglas,2016,45583,42770,2813,6.2
41,21,Gilliam,2016,836,787,49,5.9
41,23,Grant,2016,3098,2866,232,7.5
41,25,Harney,2016,3413,3204,209,6.1
41,27,Hood River,2016,13877,13312,565,4.1
41,29,Jackson,2016,101140,95428,5712,5.6
41,31,Jefferson,2016,9833,9195,638,6.5
41,33,Josephine,2016,34195,32019,2176,6.4
41,35,Klamath,2016,29144,27206,1938,6.6
41,37,Lake,2016,3443,3228,215,6.2
41,39,Lane,2016,178047,169145,8902,5.0
41,41,Lincoln,2016,20843,19695,1148,5.5
41,43,Linn,2016,56682,53505,3177,5.6
41,45,Malheur,2016,12445,11771,674,5.4
41,47,Marion,2016,157013,149200,7813,5.0
41,49,Morrow,2016,5753,5478,275,4.8
41,51,Multnomah,2016,442861,424464,18397,4.2
41,53,Polk,2016,38236,36337,1899,5.0
41,55,Sherman,2016,892,852,40,4.5
41,57,Tillamook,2016,11612,11051,561,4.8
41,59,Umatilla,2016,35921,34040,1881,5.2
41,61,Union,2016,11944,11252,692,5.8
41,63,Wallowa,2016,3305,3087,218,6.6
41,65,Wasco,2016,13655,13011,644,4.7
41,67,Washington,2016,312711,300084,12627,4.0
41,69,Wheeler,2016,684,656,28,4.1
41,71,Yamhill,2016,53067,50668,2399,4.5
42,1,Adams,2016,55472,53294,2178,3.9
42,3,Allegheny,2016,648489,615242,33247,5.1
42,5,Armstrong,2016,33133,30674,2459,7.4
42,7,Beaver,2016,85443,80207,5236,6.1
42,9,Bedford,2016,24082,22687,1395,5.8
42,11,Berks,2016,213539,203031,10508,4.9
42,13,Blair,2016,60859,57677,3182,5.2
42,15,Bradford,2016,30214,28262,1952,6.5
42,17,Bucks,2016,341373,325784,15589,4.6
42,19,Butler,2016,98766,93817,4949,5.0
42,21,Cambria,2016,61532,57404,4128,6.7
42,23,Cameron,2016,2234,2072,162,7.3
42,25,Carbon,2016,31613,29747,1866,5.9
42,27,Centre,2016,79058,75796,3262,4.1
42,29,Chester,2016,280798,270040,10758,3.8
42,31,Clarion,2016,18053,16953,1100,6.1
42,33,Clearfield,2016,36354,33733,2621,7.2
42,35,Clinton,2016,18579,17278,1301,7.0
42,37,Columbia,2016,33950,32091,1859,5.5
42,39,Crawford,2016,40559,38150,2409,5.9
42,41,Cumberland,2016,130295,125064,5231,4.0
42,43,Dauphin,2016,142301,135593,6708,4.7
42,45,Delaware,2016,294655,280449,14206,4.8
42,47,Elk,2016,16356,15464,892,5.5
42,49,Erie,2016,133789,125178,8611,6.4
42,51,Fayette,2016,58506,53815,4691,8.0
42,53,Forest,2016,1893,1746,147,7.8
42,55,Franklin,2016,77607,73651,3956,5.1
42,57,Fulton,2016,7314,6857,457,6.2
42,59,Greene,2016,17318,15991,1327,7.7
42,61,Huntingdon,2016,19687,18326,1361,6.9
42,63,Indiana,2016,40217,37321,2896,7.2
42,65,Jefferson,2016,20730,19326,1404,6.8
42,67,Juniata,2016,12217,11570,647,5.3
42,69,Lackawanna,2016,107087,101105,5982,5.6
42,71,Lancaster,2016,278301,266858,11443,4.1
42,73,Lawrence,2016,41562,38799,2763,6.6
42,75,Lebanon,2016,70694,67561,3133,4.4
42,77,Lehigh,2016,189319,179314,10005,5.3
42,79,Luzerne,2016,159198,149291,9907,6.2
42,81,Lycoming,2016,58797,54941,3856,6.6
42,83,McKean,2016,18515,17303,1212,6.5
42,85,Mercer,2016,52607,49502,3105,5.9
42,87,Mifflin,2016,20836,19657,1179,5.7
42,89,Monroe,2016,82003,76939,5064,6.2
42,91,Montgomery,2016,448108,429780,18328,4.1
42,93,Montour,2016,9142,8757,385,4.2
42,95,Northampton,2016,159085,150961,8124,5.1
42,97,Northumberland,2016,44014,41296,2718,6.2
42,99,Perry,2016,24316,23206,1110,4.6
42,101,Philadelphia/city,2016,704284,657187,47097,6.7
42,103,Pike,2016,24963,23390,1573,6.3
42,105,Potter,2016,7390,6816,574,7.8
42,107,Schuylkill,2016,67661,63524,4137,6.1
42,109,Snyder,2016,20547,19598,949,4.6
42,111,Somerset,2016,34234,31799,2435,7.1
42,113,Sullivan,2016,2844,2642,202,7.1
42,115,Susquehanna,2016,20904,19729,1175,5.6
42,117,Tioga,2016,19892,18489,1403,7.1
42,119,Union,2016,19811,18874,937,4.7
42,121,Venango,2016,23742,22040,1702,7.2
42,123,Warren,2016,19804,18732,1072,5.4
42,125,Washington,2016,107411,100914,6497,6.0
42,127,Wayne,2016,22564,21282,1282,5.7
42,129,Westmoreland,2016,183064,172471,10593,5.8
42,131,Wyoming,2016,14127,13261,866,6.1
42,133,York,2016,235081,224336,10745,4.6
44,1,Bristol,2016,26132,24919,1213,4.6
44,3,Kent,2016,90719,86415,4304,4.7
44,5,Newport,2016,44231,42145,2086,4.7
44,7,Providence,2016,323197,305287,17910,5.5
44,9,Washington,2016,68953,65673,3280,4.8
45,1,Abbeville,2016,10252,9702,550,5.4
45,3,Aiken,2016,73907,70293,3614,4.9
45,5,Allendale,2016,2651,2429,222,8.4
45,7,Anderson,2016,88643,84665,3978,4.5
45,9,Bamberg,2016,5295,4827,468,8.8
45,11,Barnwell,2016,8043,7462,581,7.2
45,13,Beaufort,2016,72294,68914,3380,4.7
45,15,Berkeley,2016,96705,92384,4321,4.5
45,17,Calhoun,2016,6878,6462,416,6.0
45,19,Charleston,2016,201188,193146,8042,4.0
45,21,Cherokee,2016,23456,22085,1371,5.8
45,23,Chester,2016,13344,12404,940,7.0
45,25,Chesterfield,2016,21568,20516,1052,4.9
45,27,Clarendon,2016,12677,11849,828,6.5
45,29,Colleton,2016,16703,15788,915,5.5
45,31,Darlington,2016,29810,27993,1817,6.1
45,33,Dillon,2016,12643,11805,838,6.6
45,35,Dorchester,2016,72954,69685,3269,4.5
45,37,Edgefield,2016,10514,9931,583,5.5
45,39,Fairfield,2016,9962,9258,704,7.1
45,41,Florence,2016,65180,61817,3363,5.2
45,43,Georgetown,2016,24882,23225,1657,6.7
45,45,Greenville,2016,244829,234676,10153,4.1
45,47,Greenwood,2016,31252,29671,1581,5.1
45,49,Hampton,2016,8203,7734,469,5.7
45,51,Horry,2016,139740,131738,8002,5.7
45,53,Jasper,2016,11964,11454,510,4.3
45,55,Kershaw,2016,29157,27668,1489,5.1
45,57,Lancaster,2016,38222,36233,1989,5.2
45,59,Laurens,2016,29943,28417,1526,5.1
45,61,Lee,2016,6417,5972,445,6.9
45,63,Lexington,2016,147657,141777,5880,4.0
45,65,McCormick,2016,3383,3198,185,5.5
45,67,Marion,2016,12632,11553,1079,8.5
45,69,Marlboro,2016,9278,8514,764,8.2
45,71,Newberry,2016,19135,18303,832,4.3
45,73,Oconee,2016,34119,32396,1723,5.0
45,75,Orangeburg,2016,35474,32396,3078,8.7
45,77,Pickens,2016,56189,53455,2734,4.9
45,79,Richland,2016,199813,190406,9407,4.7
45,81,Saluda,2016,8870,8476,394,4.4
45,83,Spartanburg,2016,141957,135410,6547,4.6
45,85,Sumter,2016,44134,41595,2539,5.8
45,87,Union,2016,11431,10736,695,6.1
45,89,Williamsburg,2016,12431,11490,941,7.6
45,91,York,2016,130280,124395,5885,4.5
46,3,Aurora,2016,1528,1494,34,2.2
46,5,Beadle,2016,9459,9213,246,2.6
46,7,Bennett,2016,1129,1084,45,4.0
46,9,Bon Homme,2016,2960,2879,81,2.7
46,11,Brookings,2016,18983,18457,526,2.8
46,13,Brown,2016,21196,20623,573,2.7
46,15,Brule,2016,2484,2420,64,2.6
46,17,Buffalo,2016,730,669,61,8.4
46,19,Butte,2016,5073,4896,177,3.5
46,21,Campbell,2016,854,829,25,2.9
46,23,Charles Mix,2016,3908,3782,126,3.2
46,25,Clark,2016,1930,1854,76,3.9
46,27,Clay,2016,7023,6810,213,3.0
46,29,Codington,2016,15283,14808,475,3.1
46,31,Corson,2016,1461,1395,66,4.5
46,33,Custer,2016,4014,3852,162,4.0
46,35,Davison,2016,11294,11021,273,2.4
46,37,Day,2016,2873,2751,122,4.2
46,39,Deuel,2016,2251,2141,110,4.9
46,41,Dewey,2016,2266,2059,207,9.1
46,43,Douglas,2016,1680,1637,43,2.6
46,45,Edmunds,2016,2174,2123,51,2.3
46,47,Fall River,2016,3039,2905,134,4.4
46,49,Faulk,2016,1119,1089,30,2.7
46,51,Grant,2016,4480,4335,145,3.2
46,53,Gregory,2016,2086,2023,63,3.0
46,55,Haakon,2016,1111,1084,27,2.4
46,57,Hamlin,2016,3190,3082,108,3.4
46,59,Hand,2016,1841,1801,40,2.2
46,61,Hanson,2016,1778,1717,61,3.4
46,63,Harding,2016,765,743,22,2.9
46,65,Hughes,2016,10113,9872,241,2.4
46,67,Hutchinson,2016,3668,3574,94,2.6
46,69,Hyde,2016,702,683,19,2.7
46,71,Jackson,2016,1311,1256,55,4.2
46,73,Jerauld,2016,1077,1050,27,2.5
46,75,Jones,2016,572,558,14,2.4
46,77,Kingsbury,2016,2754,2681,73,2.7
46,79,Lake,2016,6491,6268,223,3.4
46,81,Lawrence,2016,13129,12692,437,3.3
46,83,Lincoln,2016,31596,30908,688,2.2
46,85,Lyman,2016,1784,1700,84,4.7
46,87,McCook,2016,3149,3070,79,2.5
46,89,McPherson,2016,1094,1056,38,3.5
46,91,Marshall,2016,2473,2377,96,3.9
46,93,Meade,2016,13746,13310,436,3.2
46,95,Mellette,2016,774,741,33,4.3
46,97,Miner,2016,1206,1174,32,2.7
46,99,Minnehaha,2016,108249,105446,2803,2.6
46,101,Moody,2016,3970,3823,147,3.7
46,102,Oglala Lakota,2016,3634,3239,395,10.9
46,103,Pennington,2016,54987,53277,1710,3.1
46,105,Perkins,2016,1585,1539,46,2.9
46,107,Potter,2016,1163,1131,32,2.8
46,109,Roberts,2016,4865,4663,202,4.2
46,111,Sanborn,2016,1215,1179,36,3.0
46,115,Spink,2016,3302,3199,103,3.1
46,117,Stanley,2016,1879,1834,45,2.4
46,119,Sully,2016,863,843,20,2.3
46,121,Todd,2016,3077,2876,201,6.5
46,123,Tripp,2016,3078,3009,69,2.2
46,125,Turner,2016,4700,4568,132,2.8
46,127,Union,2016,8090,7836,254,3.1
46,129,Walworth,2016,2254,2137,117,5.2
46,135,Yankton,2016,11643,11341,302,2.6
46,137,Ziebach,2016,981,936,45,4.6
47,1,Anderson,2016,33693,32045,1648,4.9
47,3,Bedford,2016,19835,18846,989,5.0
47,5,Benton,2016,6744,6262,482,7.1
47,7,Bledsoe,2016,4325,4023,302,7.0
47,9,Blount,2016,60872,58202,2670,4.4
47,11,Bradley,2016,50153,47911,2242,4.5
47,13,Campbell,2016,14743,13720,1023,6.9
47,15,Cannon,2016,6024,5744,280,4.6
47,17,Carroll,2016,12031,11219,812,6.7
47,19,Carter,2016,23685,22342,1343,5.7
47,21,Cheatham,2016,20271,19462,809,4.0
47,23,Chester,2016,8450,8028,422,5.0
47,25,Claiborne,2016,12706,11913,793,6.2
47,27,Clay,2016,3044,2844,200,6.6
47,29,Cocke,2016,14460,13543,917,6.3
47,31,Coffee,2016,24470,23310,1160,4.7
47,33,Crockett,2016,6890,6528,362,5.3
47,35,Cumberland,2016,23576,22174,1402,5.9
47,37,Davidson,2016,374155,360601,13554,3.6
47,39,Decatur,2016,4663,4341,322,6.9
47,41,DeKalb,2016,7553,7131,422,5.6
47,43,Dickson,2016,24797,23714,1083,4.4
47,45,Dyer,2016,16376,15357,1019,6.2
47,47,Fayette,2016,18294,17369,925,5.1
47,49,Fentress,2016,7111,6671,440,6.2
47,51,Franklin,2016,19851,18884,967,4.9
47,53,Gibson,2016,21250,20001,1249,5.9
47,55,Giles,2016,15282,14665,617,4.0
47,57,Grainger,2016,9292,8786,506,5.4
47,59,Greene,2016,30893,29202,1691,5.5
47,61,Grundy,2016,4793,4482,311,6.5
47,63,Hamblen,2016,26867,25489,1378,5.1
47,65,Hamilton,2016,172011,164062,7949,4.6
47,67,Hancock,2016,2035,1873,162,8.0
47,69,Hardeman,2016,9201,8633,568,6.2
47,71,Hardin,2016,10211,9599,612,6.0
47,73,Hawkins,2016,23723,22439,1284,5.4
47,75,Haywood,2016,7681,7181,500,6.5
47,77,Henderson,2016,11995,11172,823,6.9
47,79,Henry,2016,13932,13109,823,5.9
47,81,Hickman,2016,10442,9957,485,4.6
47,83,Houston,2016,3200,2959,241,7.5
47,85,Humphreys,2016,8647,8126,521,6.0
47,87,Jackson,2016,4495,4180,315,7.0
47,89,Jefferson,2016,23629,22377,1252,5.3
47,91,Johnson,2016,7546,7182,364,4.8
47,93,Knox,2016,233831,224458,9373,4.0
47,95,Lake,2016,1917,1767,150,7.8
47,97,Lauderdale,2016,9442,8710,732,7.8
47,99,Lawrence,2016,17806,16776,1030,5.8
47,101,Lewis,2016,4890,4599,291,6.0
47,103,Lincoln,2016,15974,15318,656,4.1
47,105,Loudon,2016,22295,21250,1045,4.7
47,107,McMinn,2016,22776,21535,1241,5.4
47,109,McNairy,2016,8772,8154,618,7.0
47,111,Macon,2016,10243,9795,448,4.4
47,113,Madison,2016,47829,45493,2336,4.9
47,115,Marion,2016,11929,11176,753,6.3
47,117,Marshall,2016,15083,14385,698,4.6
47,119,Maury,2016,44115,42327,1788,4.1
47,121,Meigs,2016,4901,4565,336,6.9
47,123,Monroe,2016,19417,18388,1029,5.3
47,125,Montgomery,2016,80018,75931,4087,5.1
47,127,Moore,2016,3387,3259,128,3.8
47,129,Morgan,2016,7809,7304,505,6.5
47,131,Obion,2016,12580,11691,889,7.1
47,133,Overton,2016,9222,8727,495,5.4
47,135,Perry,2016,3192,2989,203,6.4
47,137,Pickett,2016,2328,2173,155,6.7
47,139,Polk,2016,7394,6970,424,5.7
47,141,Putnam,2016,33282,31644,1638,4.9
47,143,Rhea,2016,13485,12523,962,7.1
47,145,Roane,2016,22878,21599,1279,5.6
47,147,Robertson,2016,34780,33328,1452,4.2
47,149,Rutherford,2016,163741,157663,6078,3.7
47,151,Scott,2016,8028,7432,596,7.4
47,153,Sequatchie,2016,5926,5579,347,5.9
47,155,Sevier,2016,51239,48696,2543,5.0
47,157,Shelby,2016,434502,411215,23287,5.4
47,159,Smith,2016,8687,8288,399,4.6
47,161,Stewart,2016,5171,4819,352,6.8
47,163,Sullivan,2016,69815,66193,3622,5.2
47,165,Sumner,2016,92394,88792,3602,3.9
47,167,Tipton,2016,27529,25958,1571,5.7
47,169,Trousdale,2016,3849,3662,187,4.9
47,171,Unicoi,2016,7017,6517,500,7.1
47,173,Union,2016,7285,6862,423,5.8
47,175,Van Buren,2016,2038,1912,126,6.2
47,177,Warren,2016,17685,16832,853,4.8
47,179,Washington,2016,58782,55964,2818,4.8
47,181,Wayne,2016,6093,5691,402,6.6
47,183,Weakley,2016,15875,14944,931,5.9
47,185,White,2016,11770,11182,588,5.0
47,187,Williamson,2016,113631,109736,3895,3.4
47,189,Wilson,2016,67876,65252,2624,3.9
48,1,Anderson,2016,23518,22499,1019,4.3
48,3,Andrews,2016,8693,8282,411,4.7
48,5,Angelina,2016,37081,34888,2193,5.9
48,7,Aransas,2016,10241,9669,572,5.6
48,9,Archer,2016,4091,3914,177,4.3
48,11,Armstrong,2016,934,908,26,2.8
48,13,Atascosa,2016,21031,19906,1125,5.3
48,15,Austin,2016,14036,13287,749,5.3
48,17,Bailey,2016,2719,2600,119,4.4
48,19,Bandera,2016,9507,9116,391,4.1
48,21,Bastrop,2016,39046,37583,1463,3.7
48,23,Baylor,2016,1606,1548,58,3.6
48,25,Bee,2016,10314,9537,777,7.5
48,27,Bell,2016,139561,133264,6297,4.5
48,29,Bexar,2016,905846,871855,33991,3.8
48,31,Blanco,2016,5937,5753,184,3.1
48,33,Borden,2016,366,353,13,3.6
48,35,Bosque,2016,8191,7838,353,4.3
48,37,Bowie,2016,39643,37775,1868,4.7
48,39,Brazoria,2016,169940,161111,8829,5.2
48,41,Brazos,2016,111338,107481,3857,3.5
48,43,Brewster,2016,3963,3814,149,3.8
48,45,Briscoe,2016,548,524,24,4.4
48,47,Brooks,2016,2441,2152,289,11.8
48,49,Brown,2016,16177,15473,704,4.4
48,51,Burleson,2016,7880,7513,367,4.7
48,53,Burnet,2016,22004,21241,763,3.5
48,55,Caldwell,2016,17952,17173,779,4.3
48,57,Calhoun,2016,10780,10178,602,5.6
48,59,Callahan,2016,5808,5560,248,4.3
48,61,Cameron,2016,166111,154169,11942,7.2
48,63,Camp,2016,5064,4717,347,6.9
48,65,Carson,2016,3098,2997,101,3.3
48,67,Cass,2016,12276,11391,885,7.2
48,69,Castro,2016,3497,3389,108,3.1
48,71,Chambers,2016,18221,17110,1111,6.1
48,73,Cherokee,2016,21208,20128,1080,5.1
48,75,Childress,2016,2961,2872,89,3.0
48,77,Clay,2016,4797,4587,210,4.4
48,79,Cochran,2016,1174,1115,59,5.0
48,81,Coke,2016,1422,1363,59,4.1
48,83,Coleman,2016,3067,2888,179,5.8
48,85,Collin,2016,513225,495061,18164,3.5
48,87,Collingsworth,2016,1216,1174,42,3.5
48,89,Colorado,2016,9798,9336,462,4.7
48,91,Comal,2016,65520,63146,2374,3.6
48,93,Comanche,2016,5360,5129,231,4.3
48,95,Concho,2016,1332,1287,45,3.4
48,97,Cooke,2016,18923,18171,752,4.0
48,99,Coryell,2016,24428,23285,1143,4.7
48,101,Cottle,2016,525,498,27,5.1
48,103,Crane,2016,1706,1560,146,8.6
48,105,Crockett,2016,1737,1606,131,7.5
48,107,Crosby,2016,2623,2508,115,4.4
48,109,Culberson,2016,1000,959,41,4.1
48,111,Dallam,2016,4001,3912,89,2.2
48,113,Dallas,2016,1299134,1246814,52320,4.0
48,115,Dawson,2016,4643,4409,234,5.0
48,117,Deaf Smith,2016,8614,8344,270,3.1
48,119,Delta,2016,2607,2508,99,3.8
48,121,Denton,2016,452147,436615,15532,3.4
48,123,DeWitt,2016,9502,8983,519,5.5
48,125,Dickens,2016,692,658,34,4.9
48,127,Dimmit,2016,6242,5796,446,7.1
48,129,Donley,2016,1557,1494,63,4.0
48,131,Duval,2016,4887,4352,535,10.9
48,133,Eastland,2016,7424,7019,405,5.5
48,135,Ector,2016,76245,71389,4856,6.4
48,137,Edwards,2016,867,827,40,4.6
48,139,Ellis,2016,85025,81835,3190,3.8
48,141,El Paso,2016,349935,332601,17334,5.0
48,143,Erath,2016,20240,19418,822,4.1
48,145,Falls,2016,6613,6321,292,4.4
48,147,Fannin,2016,15774,15179,595,3.8
48,149,Fayette,2016,12496,12039,457,3.7
48,151,Fisher,2016,1760,1684,76,4.3
48,153,Floyd,2016,2738,2600,138,5.0
48,155,Foard,2016,540,520,20,3.7
48,157,Fort Bend,2016,367050,348684,18366,5.0
48,159,Franklin,2016,4512,4290,222,4.9
48,161,Freestone,2016,6872,6412,460,6.7
48,163,Frio,2016,8783,8355,428,4.9
48,165,Gaines,2016,9187,8844,343,3.7
48,167,Galveston,2016,160171,151625,8546,5.3
48,169,Garza,2016,2131,2048,83,3.9
48,171,Gillespie,2016,13001,12631,370,2.8
48,173,Glasscock,2016,749,720,29,3.9
48,175,Goliad,2016,3320,3127,193,5.8
48,177,Gonzales,2016,9574,9168,406,4.2
48,179,Gray,2016,8489,7903,586,6.9
48,181,Grayson,2016,61232,58868,2364,3.9
48,183,Gregg,2016,58383,54826,3557,6.1
48,185,Grimes,2016,11058,10326,732,6.6
48,187,Guadalupe,2016,75992,73263,2729,3.6
48,189,Hale,2016,12596,11887,709,5.6
48,191,Hall,2016,1166,1088,78,6.7
48,193,Hamilton,2016,3602,3425,177,4.9
48,195,Hansford,2016,2946,2854,92,3.1
48,197,Hardeman,2016,1625,1561,64,3.9
48,199,Hardin,2016,25170,23636,1534,6.1
48,201,Harris,2016,2251316,2131125,120191,5.3
48,203,Harrison,2016,29961,28159,1802,6.0
48,205,Hartley,2016,2961,2901,60,2.0
48,207,Haskell,2016,2509,2403,106,4.2
48,209,Hays,2016,104921,101416,3505,3.3
48,211,Hemphill,2016,2115,2036,79,3.7
48,213,Henderson,2016,35398,33741,1657,4.7
48,215,Hidalgo,2016,337251,310858,26393,7.8
48,217,Hill,2016,15812,15114,698,4.4
48,219,Hockley,2016,11176,10656,520,4.7
48,221,Hood,2016,25276,24086,1190,4.7
48,223,Hopkins,2016,17331,16639,692,4.0
48,225,Houston,2016,10067,9602,465,4.6
48,227,Howard,2016,13218,12486,732,5.5
48,229,Hudspeth,2016,1542,1450,92,6.0
48,231,Hunt,2016,40532,38793,1739,4.3
48,233,Hutchinson,2016,9639,9095,544,5.6
48,235,Irion,2016,780,755,25,3.2
48,237,Jack,2016,3857,3666,191,5.0
48,239,Jackson,2016,7277,6936,341,4.7
48,241,Jasper,2016,13472,12437,1035,7.7
48,243,Jeff Davis,2016,1074,1042,32,3.0
48,245,Jefferson,2016,107546,99999,7547,7.0
48,247,Jim Hogg,2016,1945,1759,186,9.6
48,249,Jim Wells,2016,17470,15625,1845,10.6
48,251,Johnson,2016,76072,72753,3319,4.4
48,253,Jones,2016,5627,5300,327,5.8
48,255,Karnes,2016,6279,5972,307,4.9
48,257,Kaufman,2016,57940,55742,2198,3.8
48,259,Kendall,2016,20353,19702,651,3.2
48,261,Kenedy,2016,217,207,10,4.6
48,263,Kent,2016,470,456,14,3.0
48,265,Kerr,2016,21366,20597,769,3.6
48,267,Kimble,2016,1953,1879,74,3.8
48,269,King,2016,178,171,7,3.9
48,271,Kinney,2016,1156,1089,67,5.8
48,273,Kleberg,2016,14114,13165,949,6.7
48,275,Knox,2016,1560,1494,66,4.2
48,277,Lamar,2016,23238,22161,1077,4.6
48,279,Lamb,2016,5249,4908,341,6.5
48,281,Lampasas,2016,9164,8783,381,4.2
48,283,La Salle,2016,3887,3687,200,5.1
48,285,Lavaca,2016,8746,8376,370,4.2
48,287,Lee,2016,9286,8936,350,3.8
48,289,Leon,2016,6513,6091,422,6.5
48,291,Liberty,2016,31554,29176,2378,7.5
48,293,Limestone,2016,8329,7862,467,5.6
48,295,Lipscomb,2016,1652,1579,73,4.4
48,297,Live Oak,2016,5206,4897,309,5.9
48,299,Llano,2016,8296,7950,346,4.2
48,301,Loving,2016,86,82,4,4.7
48,303,Lubbock,2016,153626,148411,5215,3.4
48,305,Lynn,2016,2731,2622,109,4.0
48,307,McCulloch,2016,3712,3545,167,4.5
48,309,McLennan,2016,116150,111548,4602,4.0
48,311,McMullen,2016,862,844,18,2.1
48,313,Madison,2016,4770,4527,243,5.1
48,315,Marion,2016,4343,4038,305,7.0
48,317,Martin,2016,2483,2374,109,4.4
48,319,Mason,2016,1791,1726,65,3.6
48,321,Matagorda,2016,16890,15653,1237,7.3
48,323,Maverick,2016,24249,21519,2730,11.3
48,325,Medina,2016,20999,20073,926,4.4
48,327,Menard,2016,818,781,37,4.5
48,329,Midland,2016,85080,81326,3754,4.4
48,331,Milam,2016,10272,9742,530,5.2
48,333,Mills,2016,1925,1845,80,4.2
48,335,Mitchell,2016,2610,2427,183,7.0
48,337,Montague,2016,9035,8587,448,5.0
48,339,Montgomery,2016,265996,252941,13055,4.9
48,341,Moore,2016,11197,10864,333,3.0
48,343,Morris,2016,4895,4359,536,10.9
48,345,Motley,2016,508,490,18,3.5
48,347,Nacogdoches,2016,28722,27375,1347,4.7
48,349,Navarro,2016,22775,21822,953,4.2
48,351,Newton,2016,5355,4930,425,7.9
48,353,Nolan,2016,6867,6537,330,4.8
48,355,Nueces,2016,167827,158355,9472,5.6
48,357,Ochiltree,2016,4664,4419,245,5.3
48,359,Oldham,2016,908,881,27,3.0
48,361,Orange,2016,37368,34859,2509,6.7
48,363,Palo Pinto,2016,13256,12530,726,5.5
48,365,Panola,2016,10235,9500,735,7.2
48,367,Parker,2016,61297,58798,2499,4.1
48,369,Parmer,2016,4950,4825,125,2.5
48,371,Pecos,2016,6498,6116,382,5.9
48,373,Polk,2016,17388,16287,1101,6.3
48,375,Potter,2016,56177,54294,1883,3.4
48,377,Presidio,2016,3081,2751,330,10.7
48,379,Rains,2016,5556,5333,223,4.0
48,381,Randall,2016,70685,68595,2090,3.0
48,383,Reagan,2016,1702,1597,105,6.2
48,385,Real,2016,1041,982,59,5.7
48,387,Red River,2016,5036,4744,292,5.8
48,389,Reeves,2016,6036,5715,321,5.3
48,391,Refugio,2016,3137,2929,208,6.6
48,393,Roberts,2016,442,422,20,4.5
48,395,Robertson,2016,7258,6890,368,5.1
48,397,Rockwall,2016,47367,45704,1663,3.5
48,399,Runnels,2016,4649,4465,184,4.0
48,401,Rusk,2016,22382,21076,1306,5.8
48,403,Sabine,2016,3484,3157,327,9.4
48,405,San Augustine,2016,2805,2554,251,8.9
48,407,San Jacinto,2016,11431,10713,718,6.3
48,409,San Patricio,2016,30623,28335,2288,7.5
48,411,San Saba,2016,2448,2365,83,3.4
48,413,Schleicher,2016,1421,1347,74,5.2
48,415,Scurry,2016,7410,6973,437,5.9
48,417,Shackelford,2016,1878,1806,72,3.8
48,419,Shelby,2016,10959,10300,659,6.0
48,421,Sherman,2016,1351,1311,40,3.0
48,423,Smith,2016,105484,100706,4778,4.5
48,425,Somervell,2016,4134,3935,199,4.8
48,427,Starr,2016,26365,22837,3528,13.4
48,429,Stephens,2016,4019,3807,212,5.3
48,431,Sterling,2016,670,644,26,3.9
48,433,Stonewall,2016,640,612,28,4.4
48,435,Sutton,2016,1592,1465,127,8.0
48,437,Swisher,2016,2716,2600,116,4.3
48,439,Tarrant,2016,1011543,971204,40339,4.0
48,441,Taylor,2016,63322,60949,2373,3.7
48,443,Terrell,2016,407,390,17,4.2
48,445,Terry,2016,5352,5096,256,4.8
48,447,Throckmorton,2016,743,717,26,3.5
48,449,Titus,2016,12884,12088,796,6.2
48,451,Tom Green,2016,54272,51838,2434,4.5
48,453,Travis,2016,678480,656873,21607,3.2
48,455,Trinity,2016,5485,5151,334,6.1
48,457,Tyler,2016,7217,6689,528,7.3
48,459,Upshur,2016,17903,16754,1149,6.4
48,461,Upton,2016,1582,1498,84,5.3
48,463,Uvalde,2016,11813,11184,629,5.3
48,465,Val Verde,2016,20147,18887,1260,6.3
48,467,Van Zandt,2016,24862,23791,1071,4.3
48,469,Victoria,2016,43732,41357,2375,5.4
48,471,Walker,2016,23797,22547,1250,5.3
48,473,Waller,2016,22180,20939,1241,5.6
48,475,Ward,2016,5397,5089,308,5.7
48,477,Washington,2016,15089,14320,769,5.1
48,479,Webb,2016,113897,108314,5583,4.9
48,481,Wharton,2016,21080,20018,1062,5.0
48,483,Wheeler,2016,2484,2366,118,4.8
48,485,Wichita,2016,55486,53072,2414,4.4
48,487,Wilbarger,2016,5050,4812,238,4.7
48,489,Willacy,2016,6505,5707,798,12.3
48,491,Williamson,2016,278717,269349,9368,3.4
48,493,Wilson,2016,23760,22830,930,3.9
48,495,Winkler,2016,3071,2834,237,7.7
48,497,Wise,2016,29438,28044,1394,4.7
48,499,Wood,2016,17248,16339,909,5.3
48,501,Yoakum,2016,3762,3582,180,4.8
48,503,Young,2016,8312,7947,365,4.4
48,505,Zapata,2016,5210,4648,562,10.8
48,507,Zavala,2016,3887,3347,540,13.9
49,1,Beaver,2016,3065,2918,147,4.8
49,3,Box Elder,2016,24595,23763,832,3.4
49,5,Cache,2016,61026,59218,1808,3.0
49,7,Carbon,2016,8298,7819,479,5.8
49,9,Daggett,2016,461,438,23,5.0
49,11,Davis,2016,163777,158759,5018,3.1
49,13,Duchesne,2016,8070,7373,697,8.6
49,15,Emery,2016,4246,3988,258,6.1
49,17,Garfield,2016,2779,2554,225,8.1
49,19,Grand,2016,5701,5376,325,5.7
49,21,Iron,2016,21385,20480,905,4.2
49,23,Juab,2016,5200,5016,184,3.5
49,25,Kane,2016,3679,3543,136,3.7
49,27,Millard,2016,6190,5990,200,3.2
49,29,Morgan,2016,5125,4977,148,2.9
49,31,Piute,2016,456,430,26,5.7
49,33,Rich,2016,1091,1057,34,3.1
49,35,Salt Lake,2016,599503,581020,18483,3.1
49,37,San Juan,2016,5713,5265,448,7.8
49,39,Sanpete,2016,11755,11300,455,3.9
49,41,Sevier,2016,9551,9145,406,4.3
49,43,Summit,2016,23791,23066,725,3.0
49,45,Tooele,2016,30713,29582,1131,3.7
49,47,Uintah,2016,14057,12782,1275,9.1
49,49,Utah,2016,277959,269619,8340,3.0
49,51,Wasatch,2016,13853,13398,455,3.3
49,53,Washington,2016,67007,64578,2429,3.6
49,55,Wayne,2016,1419,1312,107,7.5
49,57,Weber,2016,119671,115214,4457,3.7
50,1,Addison,2016,20925,20323,602,2.9
50,3,Bennington,2016,18503,17830,673,3.6
50,5,Caledonia,2016,14946,14345,601,4.0
50,7,Chittenden,2016,95560,93248,2312,2.4
50,9,Essex,2016,2708,2577,131,4.8
50,11,Franklin,2016,27448,26623,825,3.0
50,13,Grand Isle,2016,3988,3844,144,3.6
50,15,Lamoille,2016,13961,13389,572,4.1
50,17,Orange,2016,15951,15472,479,3.0
50,19,Orleans,2016,13572,12883,689,5.1
50,21,Rutland,2016,31554,30405,1149,3.6
50,23,Washington,2016,34014,32965,1049,3.1
50,25,Windham,2016,23294,22545,749,3.2
50,27,Windsor,2016,29429,28594,835,2.8
51,1,Accomack,2016,15820,15060,760,4.8
51,3,Albemarle,2016,54534,52631,1903,3.5
51,5,Alleghany,2016,6941,6593,348,5.0
51,7,Amelia,2016,6207,5947,260,4.2
51,9,Amherst,2016,15010,14364,646,4.3
51,11,Appomattox,2016,7006,6684,322,4.6
51,13,Arlington,2016,146628,142857,3771,2.6
51,15,Augusta,2016,36898,35570,1328,3.6
51,17,Bath,2016,2499,2408,91,3.6
51,19,Bedford,2016,38012,36486,1526,4.0
51,21,Bland,2016,2742,2601,141,5.1
51,23,Botetourt,2016,17375,16755,620,3.6
51,25,Brunswick,2016,6216,5852,364,5.9
51,27,Buchanan,2016,6860,6136,724,10.6
51,29,Buckingham,2016,6273,5939,334,5.3
51,31,Campbell,2016,25973,24840,1133,4.4
51,33,Caroline,2016,14875,14224,651,4.4
51,35,Carroll,2016,12977,12321,656,5.1
51,36,Charles City,2016,3724,3558,166,4.5
51,37,Charlotte,2016,5259,5000,259,4.9
51,41,Chesterfield,2016,180972,174105,6867,3.8
51,43,Clarke,2016,7446,7184,262,3.5
51,45,Craig,2016,2353,2243,110,4.7
51,47,Culpeper,2016,23481,22585,896,3.8
51,49,Cumberland,2016,4609,4400,209,4.5
51,51,Dickenson,2016,4575,4128,447,9.8
51,53,Dinwiddie,2016,13461,12815,646,4.8
51,57,Essex,2016,5529,5267,262,4.7
51,59,Fairfax,2016,617693,598093,19600,3.2
51,61,Fauquier,2016,35977,34745,1232,3.4
51,63,Floyd,2016,8201,7873,328,4.0
51,65,Fluvanna,2016,13201,12764,437,3.3
51,67,Franklin,2016,26402,25288,1114,4.2
51,69,Frederick,2016,45404,43842,1562,3.4
51,71,Giles,2016,7950,7530,420,5.3
51,73,Gloucester,2016,19118,18430,688,3.6
51,75,Goochland,2016,10845,10443,402,3.7
51,77,Grayson,2016,7031,6677,354,5.0
51,79,Greene,2016,9946,9626,320,3.2
51,81,Greensville,2016,4212,4002,210,5.0
51,83,Halifax,2016,14880,14026,854,5.7
51,85,Hanover,2016,57255,55280,1975,3.4
51,87,Henrico,2016,179085,172221,6864,3.8
51,89,Henry,2016,22165,20946,1219,5.5
51,91,Highland,2016,1308,1268,40,3.1
51,93,Isle of Wight,2016,18955,18151,804,4.2
51,95,James City,2016,34910,33580,1330,3.8
51,97,King and Queen,2016,3665,3515,150,4.1
51,99,King George,2016,12336,11817,519,4.2
51,101,King William,2016,8762,8435,327,3.7
51,103,Lancaster,2016,5115,4832,283,5.5
51,105,Lee,2016,8451,7886,565,6.7
51,107,Loudoun,2016,207602,201078,6524,3.1
51,109,Louisa,2016,18595,17895,700,3.8
51,111,Lunenburg,2016,5260,5021,239,4.5
51,113,Madison,2016,7183,6962,221,3.1
51,115,Mathews,2016,4045,3885,160,4.0
51,117,Mecklenburg,2016,12473,11783,690,5.5
51,119,Middlesex,2016,5035,4845,190,3.8
51,121,Montgomery,2016,49796,47769,2027,4.1
51,125,Nelson,2016,7246,6989,257,3.5
51,127,New Kent,2016,11690,11300,390,3.3
51,131,Northampton,2016,5881,5546,335,5.7
51,133,Northumberland,2016,5454,5161,293,5.4
51,135,Nottoway,2016,7044,6768,276,3.9
51,137,Orange,2016,16386,15730,656,4.0
51,139,Page,2016,11606,10971,635,5.5
51,141,Patrick,2016,7962,7582,380,4.8
51,143,Pittsylvania,2016,29732,28343,1389,4.7
51,145,Powhatan,2016,13656,13180,476,3.5
51,147,Prince Edward,2016,10166,9632,534,5.3
51,149,Prince George,2016,14949,14234,715,4.8
51,153,Prince William,2016,235285,226848,8437,3.6
51,155,Pulaski,2016,16285,15331,954,5.9
51,157,Rappahannock,2016,3717,3588,129,3.5
51,159,Richmond,2016,3913,3771,142,3.6
51,161,Roanoke,2016,49206,47475,1731,3.5
51,163,Rockbridge,2016,10475,10024,451,4.3
51,165,Rockingham,2016,40616,39212,1404,3.5
51,167,Russell,2016,11253,10538,715,6.4
51,169,Scott,2016,9436,8982,454,4.8
51,171,Shenandoah,2016,20856,20084,772,3.7
51,173,Smyth,2016,13691,12909,782,5.7
51,175,Southampton,2016,9049,8699,350,3.9
51,177,Spotsylvania,2016,65027,62413,2614,4.0
51,179,Stafford,2016,68383,65749,2634,3.9
51,181,Surry,2016,3660,3471,189,5.2
51,183,Sussex,2016,3952,3708,244,6.2
51,185,Tazewell,2016,15965,14787,1178,7.4
51,187,Warren,2016,19725,18940,785,4.0
51,191,Washington,2016,26881,25687,1194,4.4
51,193,Westmoreland,2016,8989,8584,405,4.5
51,195,Wise,2016,13211,12109,1102,8.3
51,197,Wythe,2016,13673,12905,768,5.6
51,199,York,2016,32155,30926,1229,3.8
51,510,Alexandria city,2016,96536,93776,2760,2.9
51,520,Bristol city,2016,7455,7084,371,5.0
51,530,Buena Vista city,2016,3279,3115,164,5.0
51,540,Charlottesville city,2016,24916,24088,828,3.3
51,550,Chesapeake city,2016,118086,113123,4963,4.2
51,570,Colonial Heights city,2016,8723,8338,385,4.4
51,580,Covington city,2016,2385,2247,138,5.8
51,590,Danville city,2016,19125,17984,1141,6.0
51,595,Emporia city,2016,2246,2104,142,6.3
51,600,Fairfax city,2016,12993,12602,391,3.0
51,610,Falls Church city,2016,7993,7778,215,2.7
51,620,Franklin city,2016,3540,3329,211,6.0
51,630,Fredericksburg city,2016,13575,12936,639,4.7
51,640,Galax city,2016,2905,2764,141,4.9
51,650,Hampton city,2016,64029,60438,3591,5.6
51,660,Harrisonburg city,2016,24259,23107,1152,4.7
51,670,Hopewell city,2016,9786,9157,629,6.4
51,678,Lexington city,2016,2267,2130,137,6.0
51,680,Lynchburg city,2016,35557,33738,1819,5.1
51,683,Manassas city,2016,21626,20858,768,3.6
51,685,Manassas Park city,2016,8493,8188,305,3.6
51,690,Martinsville city,2016,5167,4807,360,7.0
51,700,Newport News city,2016,88936,84452,4484,5.0
51,710,Norfolk city,2016,110464,104722,5742,5.2
51,720,Norton city,2016,1662,1550,112,6.7
51,730,Petersburg city,2016,13214,12194,1020,7.7
51,735,Poquoson city,2016,6176,5963,213,3.4
51,740,Portsmouth city,2016,44103,41436,2667,6.0
51,750,Radford city,2016,8267,7826,441,5.3
51,760,Richmond city,2016,114798,109549,5249,4.6
51,770,Roanoke city,2016,48997,46924,2073,4.2
51,775,Salem city,2016,12909,12409,500,3.9
51,790,Staunton city,2016,11808,11354,454,3.8
51,800,Suffolk city,2016,43013,41030,1983,4.6
51,810,Virginia Beach city,2016,229517,220574,8943,3.9
51,820,Waynesboro city,2016,10205,9788,417,4.1
51,830,Williamsburg city,2016,6720,6354,366,5.4
51,840,Winchester city,2016,14345,13780,565,3.9
53,1,Adams,2016,8717,8166,551,6.3
53,3,Asotin,2016,9972,9483,489,4.9
53,5,Benton,2016,94362,88504,5858,6.2
53,7,Chelan,2016,43313,40878,2435,5.6
53,9,Clallam,2016,27332,25285,2047,7.5
53,11,Clark,2016,220996,207736,13260,6.0
53,13,Columbia,2016,1720,1610,110,6.4
53,15,Cowlitz,2016,44876,41712,3164,7.1
53,17,Douglas,2016,20545,19154,1391,6.8
53,19,Ferry,2016,2493,2240,253,10.1
53,21,Franklin,2016,39864,36952,2912,7.3
53,23,Garfield,2016,920,867,53,5.8
53,25,Grant,2016,44585,41462,3123,7.0
53,27,Grays Harbor,2016,27256,25019,2237,8.2
53,29,Island,2016,32764,30860,1904,5.8
53,31,Jefferson,2016,11516,10714,802,7.0
53,33,King,2016,1213173,1166951,46222,3.8
53,35,Kitsap,2016,118285,111789,6496,5.5
53,37,Kittitas,2016,21549,20286,1263,5.9
53,39,Klickitat,2016,9649,9002,647,6.7
53,41,Lewis,2016,31938,29483,2455,7.7
53,43,Lincoln,2016,4894,4626,268,5.5
53,45,Mason,2016,23519,21769,1750,7.4
53,47,Okanogan,2016,21415,20015,1400,6.5
53,49,Pacific,2016,8295,7637,658,7.9
53,51,Pend Oreille,2016,4663,4254,409,8.8
53,53,Pierce,2016,404970,380954,24016,5.9
53,55,San Juan,2016,7879,7518,361,4.6
53,57,Skagit,2016,58012,54287,3725,6.4
53,59,Skamania,2016,5078,4731,347,6.8
53,61,Snohomish,2016,415292,397875,17417,4.2
53,63,Spokane,2016,234673,220625,14048,6.0
53,65,Stevens,2016,17894,16446,1448,8.1
53,67,Thurston,2016,129896,122677,7219,5.6
53,69,Wahkiakum,2016,1289,1179,110,8.5
53,71,Walla Walla,2016,28734,27206,1528,5.3
53,73,Whatcom,2016,107213,101059,6154,5.7
53,75,Whitman,2016,23132,21989,1143,4.9
53,77,Yakima,2016,125890,116529,9361,7.4
54,1,Barbour,2016,6983,6508,475,6.8
54,3,Berkeley,2016,54260,52110,2150,4.0
54,5,Boone,2016,8014,7284,730,9.1
54,7,Braxton,2016,5509,5026,483,8.8
54,9,Brooke,2016,10012,9306,706,7.1
54,11,Cabell,2016,41349,39356,1993,4.8
54,13,Calhoun,2016,2630,2292,338,12.9
54,15,Clay,2016,3269,2930,339,10.4
54,17,Doddridge,2016,3794,3597,197,5.2
54,19,Fayette,2016,16024,14752,1272,7.9
54,21,Gilmer,2016,2547,2337,210,8.2
54,23,Grant,2016,5974,5619,355,5.9
54,25,Greenbrier,2016,15735,14885,850,5.4
54,27,Hampshire,2016,9927,9495,432,4.4
54,29,Hancock,2016,12899,11995,904,7.0
54,31,Hardy,2016,5736,5409,327,5.7
54,33,Harrison,2016,32448,30555,1893,5.8
54,35,Jackson,2016,12045,11263,782,6.5
54,37,Jefferson,2016,28648,27683,965,3.4
54,39,Kanawha,2016,85575,80899,4676,5.5
54,41,Lewis,2016,6850,6268,582,8.5
54,43,Lincoln,2016,7312,6688,624,8.5
54,45,Logan,2016,11195,10052,1143,10.2
54,47,McDowell,2016,5102,4481,621,12.2
54,49,Marion,2016,25754,24069,1685,6.5
54,51,Marshall,2016,14111,12986,1125,8.0
54,53,Mason,2016,10063,9345,718,7.1
54,55,Mercer,2016,21760,20302,1458,6.7
54,57,Mineral,2016,11947,11235,712,6.0
54,59,Mingo,2016,6751,5899,852,12.6
54,61,Monongalia,2016,51452,49222,2230,4.3
54,63,Monroe,2016,5998,5725,273,4.6
54,65,Morgan,2016,7679,7342,337,4.4
54,67,Nicholas,2016,9619,8770,849,8.8
54,69,Ohio,2016,20695,19546,1149,5.6
54,71,Pendleton,2016,3665,3523,142,3.9
54,73,Pleasants,2016,2964,2721,243,8.2
54,75,Pocahontas,2016,3739,3490,249,6.7
54,77,Preston,2016,14900,14044,856,5.7
54,79,Putnam,2016,25859,24594,1265,4.9
54,81,Raleigh,2016,30031,27931,2100,7.0
54,83,Randolph,2016,12245,11511,734,6.0
54,85,Ritchie,2016,4578,4279,299,6.5
54,87,Roane,2016,5219,4681,538,10.3
54,89,Summers,2016,4585,4304,281,6.1
54,91,Taylor,2016,7844,7401,443,5.6
54,93,Tucker,2016,3487,3299,188,5.4
54,95,Tyler,2016,3559,3242,317,8.9
54,97,Upshur,2016,9837,9095,742,7.5
54,99,Wayne,2016,15582,14552,1030,6.6
54,101,Webster,2016,3502,3209,293,8.4
54,103,Wetzel,2016,7225,6557,668,9.2
54,105,Wirt,2016,2239,2042,197,8.8
54,107,Wood,2016,36940,34816,2124,5.7
54,109,Wyoming,2016,7444,6685,759,10.2
55,1,Adams,2016,8255,7770,485,5.9
55,3,Ashland,2016,7929,7510,419,5.3
55,5,Barron,2016,24277,23203,1074,4.4
55,7,Bayfield,2016,7507,7003,504,6.7
55,9,Brown,2016,140794,135820,4974,3.5
55,11,Buffalo,2016,6553,6268,285,4.3
55,13,Burnett,2016,7152,6735,417,5.8
55,15,Calumet,2016,27650,26782,868,3.1
55,17,Chippewa,2016,33263,31887,1376,4.1
55,19,Clark,2016,17481,16817,664,3.8
55,21,Columbia,2016,31490,30384,1106,3.5
55,23,Crawford,2016,7899,7523,376,4.8
55,25,Dane,2016,316992,308144,8848,2.8
55,27,Dodge,2016,47741,46043,1698,3.6
55,29,Door,2016,15457,14712,745,4.8
55,31,Douglas,2016,23499,22295,1204,5.1
55,33,Dunn,2016,24257,23290,967,4.0
55,35,Eau Claire,2016,58728,56769,1959,3.3
55,37,Florence,2016,2221,2093,128,5.8
55,39,Fond du Lac,2016,56786,54835,1951,3.4
55,41,Forest,2016,3987,3745,242,6.1
55,43,Grant,2016,28126,27054,1072,3.8
55,45,Green,2016,21153,20466,687,3.2
55,47,Green Lake,2016,9733,9270,463,4.8
55,49,Iowa,2016,13661,13195,466,3.4
55,51,Iron,2016,2629,2438,191,7.3
55,53,Jackson,2016,10298,9859,439,4.3
55,55,Jefferson,2016,45585,43852,1733,3.8
55,57,Juneau,2016,13498,12916,582,4.3
55,59,Kenosha,2016,88081,84061,4020,4.6
55,61,Kewaunee,2016,11005,10611,394,3.6
55,63,La Crosse,2016,67388,65012,2376,3.5
55,65,Lafayette,2016,9818,9514,304,3.1
55,67,Langlade,2016,9548,9064,484,5.1
55,69,Lincoln,2016,15218,14570,648,4.3
55,71,Manitowoc,2016,41731,39977,1754,4.2
55,73,Marathon,2016,73437,70883,2554,3.5
55,75,Marinette,2016,20173,19094,1079,5.3
55,77,Marquette,2016,7532,7159,373,5.0
55,78,Menominee,2016,1569,1452,117,7.5
55,79,Milwaukee,2016,475320,452193,23127,4.9
55,81,Monroe,2016,22965,22110,855,3.7
55,83,Oconto,2016,20406,19527,879,4.3
55,85,Oneida,2016,18531,17654,877,4.7
55,87,Outagamie,2016,103617,100040,3577,3.5
55,89,Ozaukee,2016,48924,47327,1597,3.3
55,91,Pepin,2016,4155,4001,154,3.7
55,93,Pierce,2016,24617,23645,972,3.9
55,95,Polk,2016,24806,23701,1105,4.5
55,97,Portage,2016,39386,37920,1466,3.7
55,99,Price,2016,6864,6576,288,4.2
55,101,Racine,2016,99453,94662,4791,4.8
55,103,Richland,2016,9240,8901,339,3.7
55,105,Rock,2016,83884,80279,3605,4.3
55,107,Rusk,2016,6983,6634,349,5.0
55,109,St. Croix,2016,49537,47714,1823,3.7
55,111,Sauk,2016,35144,33921,1223,3.5
55,113,Sawyer,2016,7893,7413,480,6.1
55,115,Shawano,2016,21235,20375,860,4.0
55,117,Sheboygan,2016,61579,59535,2044,3.3
55,119,Taylor,2016,11048,10605,443,4.0
55,121,Trempealeau,2016,16622,16024,598,3.6
55,123,Vernon,2016,15716,15158,558,3.6
55,125,Vilas,2016,9943,9394,549,5.5
55,127,Walworth,2016,57550,55307,2243,3.9
55,129,Washburn,2016,7952,7566,386,4.9
55,131,Washington,2016,77012,74493,2519,3.3
55,133,Waukesha,2016,224280,216710,7570,3.4
55,135,Waupaca,2016,26902,25864,1038,3.9
55,137,Waushara,2016,11447,10886,561,4.9
55,139,Winnebago,2016,92838,89604,3234,3.5
55,141,Wood,2016,34518,32929,1589,4.6
56,1,Albany,2016,20975,20299,676,3.2
56,3,Big Horn,2016,5540,5263,277,5.0
56,5,Campbell,2016,24415,22648,1767,7.2
56,7,Carbon,2016,8363,7969,394,4.7
56,9,Converse,2016,7879,7385,494,6.3
56,11,Crook,2016,3740,3567,173,4.6
56,13,Fremont,2016,20040,18591,1449,7.2
56,15,Goshen,2016,7029,6784,245,3.5
56,17,Hot Springs,2016,2425,2308,117,4.8
56,19,Johnson,2016,4207,3981,226,5.4
56,21,Laramie,2016,48803,46765,2038,4.2
56,23,Lincoln,2016,8725,8313,412,4.7
56,25,Natrona,2016,41016,38073,2943,7.2
56,27,Niobrara,2016,1338,1294,44,3.3
56,29,Park,2016,15931,15174,757,4.8
56,31,Platte,2016,4775,4544,231,4.8
56,33,Sheridan,2016,16127,15363,764,4.7
56,35,Sublette,2016,4232,3958,274,6.5
56,37,Sweetwater,2016,22140,20794,1346,6.1
56,39,Teton,2016,15247,14715,532,3.5
56,41,Uinta,2016,9426,8876,550,5.8
56,43,Washakie,2016,4214,4013,201,4.8
56,45,Weston,2016,3960,3761,199,5.0
72,1,Adjuntas Municipio,2016,4470,3717,753,16.8
72,3,Aguada Municipio,2016,11907,10245,1662,14.0
72,5,Aguadilla Municipio,2016,14906,12689,2217,14.9
72,7,Aguas Buenas Municipio,2016,6787,5814,973,14.3
72,9,Aibonito Municipio,2016,6673,5680,993,14.9
72,11,Anasco Municipio,2016,8893,7749,1144,12.9
72,13,Arecibo Municipio,2016,23997,20832,3165,13.2
72,15,Arroyo Municipio,2016,5140,4187,953,18.5
72,17,Barceloneta Municipio,2016,5863,5034,829,14.1
72,19,Barranquitas Municipio,2016,7480,6521,959,12.8
72,21,Bayamon Municipio,2016,66356,60399,5957,9.0
72,23,Cabo Rojo Municipio,2016,14168,12405,1763,12.4
72,25,Caguas Municipio,2016,48264,43281,4983,10.3
72,27,Camuy Municipio,2016,9505,8330,1175,12.4
72,29,Canovanas Municipio,2016,16274,14404,1870,11.5
72,31,Carolina Municipio,2016,62164,56791,5373,8.6
72,33,Catano Municipio,2016,7912,7119,793,10.0
72,35,Cayey Municipio,2016,16220,14480,1740,10.7
72,37,Ceiba Municipio,2016,3798,3301,497,13.1
72,39,Ciales Municipio,2016,3839,3220,619,16.1
72,41,Cidra Municipio,2016,15580,13986,1594,10.2
72,43,Coamo Municipio,2016,10868,8903,1965,18.1
72,45,Comerio Municipio,2016,5072,4389,683,13.5
72,47,Corozal Municipio,2016,9250,8114,1136,12.3
72,49,Culebra Municipio,2016,896,866,30,3.3
72,51,Dorado Municipio,2016,12924,11882,1042,8.1
72,53,Fajardo Municipio,2016,11285,9728,1557,13.8
72,54,Florida Municipio,2016,3370,2882,488,14.5
72,55,Guanica Municipio,2016,4142,3394,748,18.1
72,57,Guayama Municipio,2016,12052,10076,1976,16.4
72,59,Guayanilla Municipio,2016,5292,4302,990,18.7
72,61,Guaynabo Municipio,2016,37190,34975,2215,6.0
72,63,Gurabo Municipio,2016,17513,16026,1487,8.5
72,65,Hatillo Municipio,2016,13323,11253,2070,15.5
72,67,Hormigueros Municipio,2016,5621,4933,688,12.2
72,69,Humacao Municipio,2016,17467,15004,2463,14.1
72,71,Isabela Municipio,2016,12613,10835,1778,14.1
72,73,Jayuya Municipio,2016,4221,3675,546,12.9
72,75,Juana Diaz Municipio,2016,15597,13338,2259,14.5
72,77,Juncos Municipio,2016,12462,10817,1645,13.2
72,79,Lajas Municipio,2016,5631,4580,1051,18.7
72,81,Lares Municipio,2016,7412,5980,1432,19.3
72,83,Las Marias Municipio,2016,2865,2439,426,14.9
72,85,Las Piedras Municipio,2016,11365,9835,1530,13.5
72,87,Loiza Municipio,2016,8654,7675,979,11.3
72,89,Luquillo Municipio,2016,6333,5434,899,14.2
72,91,Manati Municipio,2016,11648,10295,1353,11.6
72,93,Maricao Municipio,2016,1955,1657,298,15.2
72,95,Maunabo Municipio,2016,3020,2466,554,18.3
72,97,Mayaguez Municipio,2016,23225,20039,3186,13.7
72,99,Moca Municipio,2016,10745,9073,1672,15.6
72,101,Morovis Municipio,2016,8119,7027,1092,13.4
72,103,Naguabo Municipio,2016,8086,7089,997,12.3
72,105,Naranjito Municipio,2016,7260,6319,941,13.0
72,107,Orocovis Municipio,2016,5204,4397,807,15.5
72,109,Patillas Municipio,2016,4813,3820,993,20.6
72,111,Penuelas Municipio,2016,6120,5099,1021,16.7
72,113,Ponce Municipio,2016,47812,41397,6415,13.4
72,115,Quebradillas Municipio,2016,6079,5109,970,16.0
72,117,Rincon Municipio,2016,4631,3908,723,15.6
72,119,Rio Grande Municipio,2016,17095,15303,1792,10.5
72,121,Sabana Grande Municipio,2016,6446,5424,1022,15.9
72,123,Salinas Municipio,2016,7568,5928,1640,21.7
72,125,San German Municipio,2016,10356,8775,1581,15.3
72,127,San Juan Municipio,2016,135159,124495,10664,7.9
72,129,San Lorenzo Municipio,2016,11910,10418,1492,12.5
72,131,San Sebastian Municipio,2016,10721,8694,2027,18.9
72,133,Santa Isabel Municipio,2016,9898,8244,1654,16.7
72,135,Toa Alta Municipio,2016,26551,24343,2208,8.3
72,137,Toa Baja Municipio,2016,29753,27071,2682,9.0
72,139,Trujillo Alto Municipio,2016,27127,25174,1953,7.2
72,141,Utuado Municipio,2016,6885,5817,1068,15.5
72,143,Vega Alta Municipio,2016,9878,8740,1138,11.5
72,145,Vega Baja Municipio,2016,13733,11829,1904,13.9
72,147,Vieques Municipio,2016,3260,2914,346,10.6
72,149,Villalba Municipio,2016,7815,6235,1580,20.2
72,151,Yabucoa Municipio,2016,9081,7545,1536,16.9
72,153,Yauco Municipio,2016,10735,8719,2016,18.8
1,1,Autauga,2017,25898,24858,1040,4.0
1,3,Baldwin,2017,91838,87994,3844,4.2
1,5,Barbour,2017,8298,7800,498,6.0
1,7,Bibb,2017,8527,8142,385,4.5
1,9,Blount,2017,24656,23631,1025,4.2
1,11,Bullock,2017,4820,4576,244,5.1
1,13,Butler,2017,8920,8412,508,5.7
1,15,Calhoun,2017,45656,43324,2332,5.1
1,17,Chambers,2017,15158,14521,637,4.2
1,19,Cherokee,2017,11309,10834,475,4.2
1,21,Chilton,2017,19203,18396,807,4.2
1,23,Choctaw,2017,4398,4112,286,6.5
1,25,Clarke,2017,7725,7049,676,8.8
1,27,Clay,2017,5781,5522,259,4.5
1,29,Cleburne,2017,5709,5444,265,4.6
1,31,Coffee,2017,20831,19887,944,4.5
1,33,Colbert,2017,23195,21950,1245,5.4
1,35,Conecuh,2017,4479,4196,283,6.3
1,37,Coosa,2017,4368,4157,211,4.8
1,39,Covington,2017,15678,14836,842,5.4
1,41,Crenshaw,2017,6387,6088,299,4.7
1,43,Cullman,2017,37716,36259,1457,3.9
1,45,Dale,2017,19882,18964,918,4.6
1,47,Dallas,2017,15002,13843,1159,7.7
1,49,DeKalb,2017,29494,28128,1366,4.6
1,51,Elmore,2017,37109,35697,1412,3.8
1,53,Escambia,2017,14408,13667,741,5.1
1,55,Etowah,2017,42949,40915,2034,4.7
1,57,Fayette,2017,6536,6218,318,4.9
1,59,Franklin,2017,13934,13320,614,4.4
1,61,Geneva,2017,10755,10272,483,4.5
1,63,Greene,2017,2845,2623,222,7.8
1,65,Hale,2017,5932,5568,364,6.1
1,67,Henry,2017,6695,6359,336,5.0
1,69,Houston,2017,44585,42574,2011,4.5
1,71,Jackson,2017,23049,21909,1140,4.9
1,73,Jefferson,2017,309410,295805,13605,4.4
1,75,Lamar,2017,5726,5478,248,4.3
1,77,Lauderdale,2017,41942,39933,2009,4.8
1,79,Lawrence,2017,13601,12909,692,5.1
1,81,Lee,2017,73263,70259,3004,4.1
1,83,Limestone,2017,41411,39692,1719,4.2
1,85,Lowndes,2017,3653,3344,309,8.5
1,87,Macon,2017,7868,7399,469,6.0
1,89,Madison,2017,175368,168333,7035,4.0
1,91,Marengo,2017,7676,7232,444,5.8
1,93,Marion,2017,12486,11867,619,5.0
1,95,Marshall,2017,41954,40286,1668,4.0
1,97,Mobile,2017,186372,176373,9999,5.4
1,99,Monroe,2017,7200,6701,499,6.9
1,101,Montgomery,2017,105451,100729,4722,4.5
1,103,Morgan,2017,54881,52555,2326,4.2
1,105,Perry,2017,3431,3155,276,8.0
1,107,Pickens,2017,7699,7273,426,5.5
1,109,Pike,2017,15252,14487,765,5.0
1,111,Randolph,2017,9458,9030,428,4.5
1,113,Russell,2017,23327,22286,1041,4.5
1,115,St. Clair,2017,39076,37473,1603,4.1
1,117,Shelby,2017,110987,107294,3693,3.3
1,119,Sumter,2017,4956,4621,335,6.8
1,121,Talladega,2017,34558,32772,1786,5.2
1,123,Tallapoosa,2017,18151,17363,788,4.3
1,125,Tuscaloosa,2017,99589,95310,4279,4.3
1,127,Walker,2017,24836,23545,1291,5.2
1,129,Washington,2017,6678,6212,466,7.0
1,131,Wilcox,2017,2800,2471,329,11.8
1,133,Winston,2017,9668,9166,502,5.2
2,13,Aleutians East Borough,2017,2550,2490,60,2.4
2,16,Aleutians West Census Area,2017,3752,3623,129,3.4
2,20,Anchorage Borough/municipality,2017,154046,145674,8372,5.4
2,50,Bethel Census Area,2017,7336,6405,931,12.7
2,60,Bristol Bay Borough,2017,422,397,25,5.9
2,68,Denali Borough,2017,1148,1051,97,8.4
2,70,Dillingham Census Area,2017,2053,1881,172,8.4
2,90,Fairbanks North Star Borough,2017,46505,43856,2649,5.7
2,100,Haines Borough,2017,1082,992,90,8.3
2,105,Hoonah-Angoon Census Area,2017,1139,1008,131,11.5
2,110,Juneau Borough/city,2017,17326,16578,748,4.3
2,122,Kenai Peninsula Borough,2017,26869,24790,2079,7.7
2,130,Ketchikan Gateway Borough,2017,7106,6698,408,5.7
2,150,Kodiak Island Borough,2017,6333,6036,297,4.7
2,158,Kusilvak Census Area,2017,2739,2231,508,18.5
2,164,Lake and Peninsula Borough,2017,717,638,79,11.0
2,170,Matanuska-Susitna Borough,2017,48345,44608,3737,7.7
2,180,Nome Census Area,2017,4098,3633,465,11.3
2,185,North Slope Borough,2017,3604,3354,250,6.9
2,188,Northwest Arctic Borough,2017,2950,2501,449,15.2
2,195,Petersburg Borough,2017,1417,1295,122,8.6
2,198,Prince of Wales-Hyder Census Area,2017,2847,2551,296,10.4
2,220,Sitka Borough/city,2017,4456,4268,188,4.2
2,230,Skagway Municipality,2017,829,749,80,9.7
2,240,Southeast Fairbanks Census Area,2017,2937,2655,282,9.6
2,261,Valdez-Cordova Census Area,2017,4878,4526,352,7.2
2,275,Wrangell Borough/city,2017,1050,975,75,7.1
2,282,Yakutat Borough/city,2017,233,213,20,8.6
2,290,Yukon-Koyukuk Census Area,2017,2462,2054,408,16.6
4,1,Apache,2017,20433,18300,2133,10.4
4,3,Cochise,2017,49453,46660,2793,5.6
4,5,Coconino,2017,75595,71354,4241,5.6
4,7,Gila,2017,21363,20054,1309,6.1
4,9,Graham,2017,14394,13600,794,5.5
4,11,Greenlee,2017,3992,3789,203,5.1
4,12,La Paz,2017,8704,8228,476,5.5
4,13,Maricopa,2017,2146260,2055052,91208,4.2
4,15,Mohave,2017,82566,77653,4913,6.0
4,17,Navajo,2017,40806,37645,3161,7.7
4,19,Pima,2017,477055,455288,21767,4.6
4,21,Pinal,2017,171890,163117,8773,5.1
4,23,Santa Cruz,2017,19114,17280,1834,9.6
4,25,Yavapai,2017,102091,97409,4682,4.6
4,27,Yuma,2017,95902,79380,16522,17.2
5,1,Arkansas,2017,8979,8684,295,3.3
5,3,Ashley,2017,7877,7434,443,5.6
5,5,Baxter,2017,16388,15683,705,4.3
5,7,Benton,2017,132629,128669,3960,3.0
5,9,Boone,2017,15817,15269,548,3.5
5,11,Bradley,2017,4462,4257,205,4.6
5,13,Calhoun,2017,2413,2319,94,3.9
5,15,Carroll,2017,13008,12570,438,3.4
5,17,Chicot,2017,3472,3243,229,6.6
5,19,Clark,2017,9587,9210,377,3.9
5,21,Clay,2017,5890,5621,269,4.6
5,23,Cleburne,2017,9299,8837,462,5.0
5,25,Cleveland,2017,3332,3186,146,4.4
5,27,Columbia,2017,9091,8627,464,5.1
5,29,Conway,2017,8241,7844,397,4.8
5,31,Craighead,2017,53656,52029,1627,3.0
5,33,Crawford,2017,26964,26005,959,3.6
5,35,Crittenden,2017,21409,20464,945,4.4
5,37,Cross,2017,7666,7356,310,4.0
5,39,Dallas,2017,2923,2793,130,4.4
5,41,Desha,2017,5454,5190,264,4.8
5,43,Drew,2017,7972,7563,409,5.1
5,45,Faulkner,2017,61429,59362,2067,3.4
5,47,Franklin,2017,7411,7148,263,3.5
5,49,Fulton,2017,4724,4523,201,4.3
5,51,Garland,2017,40388,38741,1647,4.1
5,53,Grant,2017,8335,8063,272,3.3
5,55,Greene,2017,19745,19011,734,3.7
5,57,Hempstead,2017,9907,9563,344,3.5
5,59,Hot Spring,2017,14138,13610,528,3.7
5,61,Howard,2017,5995,5812,183,3.1
5,63,Independence,2017,16164,15471,693,4.3
5,65,Izard,2017,4888,4615,273,5.6
5,67,Jackson,2017,5889,5540,349,5.9
5,69,Jefferson,2017,28037,26569,1468,5.2
5,71,Johnson,2017,10590,10133,457,4.3
5,73,Lafayette,2017,2542,2413,129,5.1
5,75,Lawrence,2017,6867,6605,262,3.8
5,77,Lee,2017,2973,2828,145,4.9
5,79,Lincoln,2017,4058,3887,171,4.2
5,81,Little River,2017,5506,5237,269,4.9
5,83,Logan,2017,8909,8564,345,3.9
5,85,Lonoke,2017,33888,32769,1119,3.3
5,87,Madison,2017,7379,7166,213,2.9
5,89,Marion,2017,6488,6229,259,4.0
5,91,Miller,2017,19786,18918,868,4.4
5,93,Mississippi,2017,17809,16740,1069,6.0
5,95,Monroe,2017,2801,2681,120,4.3
5,97,Montgomery,2017,3096,2946,150,4.8
5,99,Nevada,2017,3608,3479,129,3.6
5,101,Newton,2017,3327,3205,122,3.7
5,103,Ouachita,2017,9736,9287,449,4.6
5,105,Perry,2017,4251,4073,178,4.2
5,107,Phillips,2017,6541,6159,382,5.8
5,109,Pike,2017,4300,4126,174,4.0
5,111,Poinsett,2017,10270,9839,431,4.2
5,113,Polk,2017,8039,7675,364,4.5
5,115,Pope,2017,29133,27825,1308,4.5
5,117,Prairie,2017,3700,3548,152,4.1
5,119,Pulaski,2017,188707,182210,6497,3.4
5,121,Randolph,2017,6932,6641,291,4.2
5,123,St. Francis,2017,8373,7947,426,5.1
5,125,Saline,2017,57556,55801,1755,3.0
5,127,Scott,2017,4440,4285,155,3.5
5,129,Searcy,2017,2939,2802,137,4.7
5,131,Sebastian,2017,57291,55203,2088,3.6
5,133,Sevier,2017,5673,5414,259,4.6
5,135,Sharp,2017,5969,5667,302,5.1
5,137,Stone,2017,4800,4569,231,4.8
5,139,Union,2017,16118,15259,859,5.3
5,141,Van Buren,2017,6048,5715,333,5.5
5,143,Washington,2017,120838,117676,3162,2.6
5,145,White,2017,33678,32132,1546,4.6
5,147,Woodruff,2017,2929,2786,143,4.9
5,149,Yell,2017,8571,8222,349,4.1
6,1,Alameda,2017,838697,807652,31045,3.7
6,3,Alpine,2017,549,515,34,6.2
6,5,Amador,2017,14703,13968,735,5.0
6,7,Butte,2017,102068,96122,5946,5.8
6,9,Calaveras,2017,21029,20028,1001,4.8
6,11,Colusa,2017,10825,9274,1551,14.3
6,13,Contra Costa,2017,558246,536671,21575,3.9
6,15,Del Norte,2017,9702,9074,628,6.5
6,17,El Dorado,2017,89773,85825,3948,4.4
6,19,Fresno,2017,444760,406544,38216,8.6
6,21,Glenn,2017,12812,11848,964,7.5
6,23,Humboldt,2017,62524,59883,2641,4.2
6,25,Imperial,2017,72094,57926,14168,19.7
6,27,Inyo,2017,8611,8232,379,4.4
6,29,Kern,2017,384337,348732,35605,9.3
6,31,Kings,2017,57305,52169,5136,9.0
6,33,Lake,2017,29322,27617,1705,5.8
6,35,Lassen,2017,10033,9476,557,5.6
6,37,Los Angeles,2017,5109810,4864120,245690,4.8
6,39,Madera,2017,60951,55970,4981,8.2
6,41,Marin,2017,139727,135677,4050,2.9
6,43,Mariposa,2017,7658,7208,450,5.9
6,45,Mendocino,2017,39562,37761,1801,4.6
6,47,Merced,2017,115291,104402,10889,9.4
6,49,Modoc,2017,3195,2934,261,8.2
6,51,Mono,2017,8491,8112,379,4.5
6,53,Monterey,2017,219644,203770,15874,7.2
6,55,Napa,2017,73286,70597,2689,3.7
6,57,Nevada,2017,48320,46320,2000,4.1
6,59,Orange,2017,1606780,1550063,56717,3.5
6,61,Placer,2017,181354,174297,7057,3.9
6,63,Plumas,2017,7770,7075,695,8.9
6,65,Riverside,2017,1071594,1014926,56668,5.3
6,67,Sacramento,2017,696936,664181,32755,4.7
6,69,San Benito,2017,30608,28830,1778,5.8
6,71,San Bernardino,2017,942682,895878,46804,5.0
6,73,San Diego,2017,1571852,1508212,63640,4.0
6,75,San Francisco/city,2017,563427,546814,16613,2.9
6,77,San Joaquin,2017,323172,300411,22761,7.0
6,79,San Luis Obispo,2017,140345,135263,5082,3.6
6,81,San Mateo,2017,445210,433025,12185,2.7
6,83,Santa Barbara,2017,215094,205285,9809,4.6
6,85,Santa Clara,2017,1038022,1004370,33652,3.2
6,87,Santa Cruz,2017,142700,134514,8186,5.7
6,89,Shasta,2017,73963,69642,4321,5.8
6,91,Sierra,2017,1290,1205,85,6.6
6,93,Siskiyou,2017,17798,16496,1302,7.3
6,95,Solano,2017,208087,198094,9993,4.8
6,97,Sonoma,2017,259944,251104,8840,3.4
6,99,Stanislaus,2017,242137,223888,18249,7.5
6,101,Sutter,2017,44997,41056,3941,8.8
6,103,Tehama,2017,25529,23892,1637,6.4
6,105,Trinity,2017,4807,4507,300,6.2
6,107,Tulare,2017,204597,183083,21514,10.5
6,109,Tuolumne,2017,21383,20222,1161,5.4
6,111,Ventura,2017,423923,404739,19184,4.5
6,113,Yolo,2017,106632,101152,5480,5.1
6,115,Yuba,2017,28738,26588,2150,7.5
8,1,Adams,2017,260140,252756,7384,2.8
8,3,Alamosa,2017,8117,7858,259,3.2
8,5,Arapahoe,2017,349710,340677,9033,2.6
8,7,Archuleta,2017,6600,6414,186,2.8
8,9,Baca,2017,2118,2086,32,1.5
8,11,Bent,2017,1920,1871,49,2.6
8,13,Boulder,2017,186219,182044,4175,2.2
8,14,Broomfield/city,2017,38454,37522,932,2.4
8,15,Chaffee,2017,9285,9082,203,2.2
8,17,Cheyenne,2017,1131,1113,18,1.6
8,19,Clear Creek,2017,5855,5714,141,2.4
8,21,Conejos,2017,3912,3761,151,3.9
8,23,Costilla,2017,1817,1757,60,3.3
8,25,Crowley,2017,1466,1424,42,2.9
8,27,Custer,2017,2028,1970,58,2.9
8,29,Delta,2017,14240,13727,513,3.6
8,31,Denver/city,2017,398075,387910,10165,2.6
8,33,Dolores,2017,1127,1096,31,2.8
8,35,Douglas,2017,184388,180299,4089,2.2
8,37,Eagle,2017,34737,33986,751,2.2
8,39,Elbert,2017,14364,14040,324,2.3
8,41,El Paso,2017,324873,314992,9881,3.0
8,43,Fremont,2017,14914,14320,594,4.0
8,45,Garfield,2017,31454,30610,844,2.7
8,47,Gilpin,2017,3595,3527,68,1.9
8,49,Grand,2017,9522,9323,199,2.1
8,51,Gunnison,2017,10669,10468,201,1.9
8,53,Hinsdale,2017,472,462,10,2.1
8,55,Huerfano,2017,2541,2405,136,5.4
8,57,Jackson,2017,958,942,16,1.7
8,59,Jefferson,2017,322393,314521,7872,2.4
8,61,Kiowa,2017,923,907,16,1.7
8,63,Kit Carson,2017,4372,4302,70,1.6
8,65,Lake,2017,4703,4609,94,2.0
8,67,La Plata,2017,31350,30639,711,2.3
8,69,Larimer,2017,194733,190340,4393,2.3
8,71,Las Animas,2017,6242,6007,235,3.8
8,73,Lincoln,2017,2374,2328,46,1.9
8,75,Logan,2017,11079,10838,241,2.2
8,77,Mesa,2017,73440,70735,2705,3.7
8,79,Mineral,2017,464,456,8,1.7
8,81,Moffat,2017,7306,7080,226,3.1
8,83,Montezuma,2017,12809,12337,472,3.7
8,85,Montrose,2017,20752,20118,634,3.1
8,87,Morgan,2017,15543,15193,350,2.3
8,89,Otero,2017,8247,7928,319,3.9
8,91,Ouray,2017,2256,2196,60,2.7
8,93,Park,2017,10439,10210,229,2.2
8,95,Phillips,2017,2568,2530,38,1.5
8,97,Pitkin,2017,10958,10644,314,2.9
8,99,Prowers,2017,6181,6031,150,2.4
8,101,Pueblo,2017,74506,71526,2980,4.0
8,103,Rio Blanco,2017,2775,2675,100,3.6
8,105,Rio Grande,2017,5353,5137,216,4.0
8,107,Routt,2017,15517,15174,343,2.2
8,109,Saguache,2017,3425,3284,141,4.1
8,111,San Juan,2017,526,515,11,2.1
8,113,San Miguel,2017,5331,5190,141,2.6
8,115,Sedgwick,2017,1188,1164,24,2.0
8,117,Summit,2017,21799,21420,379,1.7
8,119,Teller,2017,12211,11847,364,3.0
8,121,Washington,2017,3022,2967,55,1.8
8,123,Weld,2017,157350,153433,3917,2.5
8,125,Yuma,2017,5666,5581,85,1.5
9,1,Fairfield,2017,479975,459476,20499,4.3
9,3,Hartford,2017,478852,457067,21785,4.5
9,5,Litchfield,2017,104298,100044,4254,4.1
9,7,Middlesex,2017,93021,89483,3538,3.8
9,9,New Haven,2017,460033,438277,21756,4.7
9,11,New London,2017,137927,132098,5829,4.2
9,13,Tolland,2017,86124,82892,3232,3.8
9,15,Windham,2017,63119,60109,3010,4.8
10,1,Kent,2017,77350,73600,3750,4.8
10,3,New Castle,2017,295130,282287,12843,4.4
10,5,Sussex,2017,103190,98626,4564,4.4
11,1,District of Colu,2017,393326,369388,23938,6.1
12,1,Alachua,2017,135272,130056,5216,3.9
12,3,Baker,2017,11641,11149,492,4.2
12,5,Bay,2017,88151,84453,3698,4.2
12,7,Bradford,2017,11241,10827,414,3.7
12,9,Brevard,2017,268605,256861,11744,4.4
12,11,Broward,2017,1021018,980078,40940,4.0
12,13,Calhoun,2017,4969,4724,245,4.9
12,15,Charlotte,2017,69962,66612,3350,4.8
12,17,Citrus,2017,47822,44981,2841,5.9
12,19,Clay,2017,104051,99963,4088,3.9
12,21,Collier,2017,173133,165888,7245,4.2
12,23,Columbia,2017,29297,28004,1293,4.4
12,27,DeSoto,2017,14034,13401,633,4.5
12,29,Dixie,2017,5743,5467,276,4.8
12,31,Duval,2017,477717,457198,20519,4.3
12,33,Escambia,2017,141954,135943,6011,4.2
12,35,Flagler,2017,46111,43871,2240,4.9
12,37,Franklin,2017,4696,4524,172,3.7
12,39,Gadsden,2017,18146,17140,1006,5.5
12,41,Gilchrist,2017,6814,6509,305,4.5
12,43,Glades,2017,4947,4679,268,5.4
12,45,Gulf,2017,6007,5770,237,3.9
12,47,Hamilton,2017,4309,4098,211,4.9
12,49,Hardee,2017,8958,8427,531,5.9
12,51,Hendry,2017,15995,14817,1178,7.4
12,53,Hernando,2017,69327,65650,3677,5.3
12,55,Highlands,2017,36370,34290,2080,5.7
12,57,Hillsborough,2017,723819,695123,28696,4.0
12,59,Holmes,2017,6885,6554,331,4.8
12,61,Indian River,2017,63889,60640,3249,5.1
12,63,Jackson,2017,17287,16499,788,4.6
12,65,Jefferson,2017,5493,5250,243,4.4
12,67,Lafayette,2017,2937,2827,110,3.7
12,69,Lake,2017,150886,144477,6409,4.2
12,71,Lee,2017,334903,321049,13854,4.1
12,73,Leon,2017,152004,145999,6005,4.0
12,75,Levy,2017,16762,16005,757,4.5
12,77,Liberty,2017,2618,2497,121,4.6
12,79,Madison,2017,7363,7032,331,4.5
12,81,Manatee,2017,174624,167587,7037,4.0
12,83,Marion,2017,133626,126814,6812,5.1
12,85,Martin,2017,71994,68947,3047,4.2
12,86,Miami-Dade,2017,1348920,1284543,64377,4.8
12,87,Monroe,2017,45626,44121,1505,3.3
12,89,Nassau,2017,39104,37564,1540,3.9
12,91,Okaloosa,2017,94307,90997,3310,3.5
12,93,Okeechobee,2017,18325,17514,811,4.4
12,95,Orange,2017,728390,700650,27740,3.8
12,97,Osceola,2017,172886,165325,7561,4.4
12,99,Palm Beach,2017,721446,690987,30459,4.2
12,101,Pasco,2017,228053,217765,10288,4.5
12,103,Pinellas,2017,483673,464978,18695,3.9
12,105,Polk,2017,293119,278914,14205,4.8
12,107,Putnam,2017,27008,25521,1487,5.5
12,109,St. Johns,2017,124767,120488,4279,3.4
12,111,St. Lucie,2017,139075,131816,7259,5.2
12,113,Santa Rosa,2017,78962,75852,3110,3.9
12,115,Sarasota,2017,184457,177095,7362,4.0
12,117,Seminole,2017,246987,237683,9304,3.8
12,119,Sumter,2017,30233,28364,1869,6.2
12,121,Suwannee,2017,18326,17535,791,4.3
12,123,Taylor,2017,8761,8363,398,4.5
12,125,Union,2017,4808,4626,182,3.8
12,127,Volusia,2017,249477,238277,11200,4.5
12,129,Wakulla,2017,14473,13947,526,3.6
12,131,Walton,2017,30007,28896,1111,3.7
12,133,Washington,2017,9775,9343,432,4.4
13,1,Appling,2017,9352,8833,519,5.5
13,3,Atkinson,2017,4205,4015,190,4.5
13,5,Bacon,2017,5101,4871,230,4.5
13,7,Baker,2017,1250,1171,79,6.3
13,9,Baldwin,2017,17765,16712,1053,5.9
13,11,Banks,2017,9360,8991,369,3.9
13,13,Barrow,2017,39563,37941,1622,4.1
13,15,Bartow,2017,50028,47696,2332,4.7
13,17,Ben Hill,2017,5522,5089,433,7.8
13,19,Berrien,2017,7460,7074,386,5.2
13,21,Bibb,2017,70212,66444,3768,5.4
13,23,Bleckley,2017,4626,4312,314,6.8
13,25,Brantley,2017,7373,6948,425,5.8
13,27,Brooks,2017,7109,6785,324,4.6
13,29,Bryan,2017,17771,17017,754,4.2
13,31,Bulloch,2017,37013,35128,1885,5.1
13,33,Burke,2017,9426,8748,678,7.2
13,35,Butts,2017,10719,10198,521,4.9
13,37,Calhoun,2017,2269,2148,121,5.3
13,39,Camden,2017,21048,19969,1079,5.1
13,43,Candler,2017,5276,5058,218,4.1
13,45,Carroll,2017,55409,52594,2815,5.1
13,47,Catoosa,2017,33160,31775,1385,4.2
13,49,Charlton,2017,4906,4656,250,5.1
13,51,Chatham,2017,140135,133776,6359,4.5
13,53,Chattahoochee,2017,2007,1869,138,6.9
13,55,Chattooga,2017,10655,10147,508,4.8
13,57,Cherokee,2017,132261,127259,5002,3.8
13,59,Clarke,2017,61483,58535,2948,4.8
13,61,Clay,2017,876,796,80,9.1
13,63,Clayton,2017,136425,128379,8046,5.9
13,65,Clinch,2017,2802,2646,156,5.6
13,67,Cobb,2017,424855,407295,17560,4.1
13,69,Coffee,2017,18625,17667,958,5.1
13,71,Colquitt,2017,22282,21267,1015,4.6
13,73,Columbia,2017,74940,71820,3120,4.2
13,75,Cook,2017,7787,7430,357,4.6
13,77,Coweta,2017,73317,70209,3108,4.2
13,79,Crawford,2017,5784,5496,288,5.0
13,81,Crisp,2017,9489,8991,498,5.2
13,83,Dade,2017,8284,7917,367,4.4
13,85,Dawson,2017,11987,11519,468,3.9
13,87,Decatur,2017,11770,11110,660,5.6
13,89,DeKalb,2017,398889,379528,19361,4.9
13,91,Dodge,2017,7200,6745,455,6.3
13,93,Dooly,2017,5134,4872,262,5.1
13,95,Dougherty,2017,39280,36887,2393,6.1
13,97,Douglas,2017,72725,69127,3598,4.9
13,99,Early,2017,4575,4324,251,5.5
13,101,Echols,2017,1922,1846,76,4.0
13,103,Effingham,2017,29737,28521,1216,4.1
13,105,Elbert,2017,7934,7513,421,5.3
13,107,Emanuel,2017,8676,8090,586,6.8
13,109,Evans,2017,4935,4717,218,4.4
13,111,Fannin,2017,11084,10548,536,4.8
13,113,Fayette,2017,57511,55141,2370,4.1
13,115,Floyd,2017,44627,42281,2346,5.3
13,117,Forsyth,2017,117538,113083,4455,3.8
13,119,Franklin,2017,10175,9683,492,4.8
13,121,Fulton,2017,553991,526963,27028,4.9
13,123,Gilmer,2017,12122,11504,618,5.1
13,125,Glascock,2017,1312,1246,66,5.0
13,127,Glynn,2017,40184,38265,1919,4.8
13,129,Gordon,2017,26919,25663,1256,4.7
13,131,Grady,2017,10848,10314,534,4.9
13,133,Greene,2017,6894,6535,359,5.2
13,135,Gwinnett,2017,486607,465768,20839,4.3
13,137,Habersham,2017,19485,18587,898,4.6
13,139,Hall,2017,101303,97306,3997,3.9
13,141,Hancock,2017,2554,2371,183,7.2
13,143,Haralson,2017,12501,11896,605,4.8
13,145,Harris,2017,16802,16096,706,4.2
13,147,Hart,2017,11355,10845,510,4.5
13,149,Heard,2017,5216,4953,263,5.0
13,151,Henry,2017,113472,107907,5565,4.9
13,153,Houston,2017,69830,66493,3337,4.8
13,155,Irwin,2017,3313,3079,234,7.1
13,157,Jackson,2017,35622,34299,1323,3.7
13,159,Jasper,2017,6919,6617,302,4.4
13,161,Jeff Davis,2017,6189,5811,378,6.1
13,163,Jefferson,2017,6811,6386,425,6.2
13,165,Jenkins,2017,3196,2978,218,6.8
13,167,Johnson,2017,4139,3927,212,5.1
13,169,Jones,2017,14066,13451,615,4.4
13,171,Lamar,2017,8124,7664,460,5.7
13,173,Lanier,2017,3882,3682,200,5.2
13,175,Laurens,2017,19463,18306,1157,5.9
13,177,Lee,2017,15188,14548,640,4.2
13,179,Liberty,2017,25741,24401,1340,5.2
13,181,Lincoln,2017,3604,3413,191,5.3
13,183,Long,2017,8050,7657,393,4.9
13,185,Lowndes,2017,52177,49724,2453,4.7
13,187,Lumpkin,2017,16891,16183,708,4.2
13,189,McDuffie,2017,8980,8413,567,6.3
13,191,McIntosh,2017,6195,5878,317,5.1
13,193,Macon,2017,4763,4429,334,7.0
13,195,Madison,2017,13688,13096,592,4.3
13,197,Marion,2017,3458,3248,210,6.1
13,199,Meriwether,2017,8949,8414,535,6.0
13,201,Miller,2017,2847,2719,128,4.5
13,205,Mitchell,2017,8578,8036,542,6.3
13,207,Monroe,2017,13229,12632,597,4.5
13,209,Montgomery,2017,3800,3547,253,6.7
13,211,Morgan,2017,9073,8661,412,4.5
13,213,Murray,2017,16011,15014,997,6.2
13,215,Muscogee,2017,79762,74978,4784,6.0
13,217,Newton,2017,51713,48935,2778,5.4
13,219,Oconee,2017,19648,18946,702,3.6
13,221,Oglethorpe,2017,7121,6810,311,4.4
13,223,Paulding,2017,83584,80090,3494,4.2
13,225,Peach,2017,11872,11169,703,5.9
13,227,Pickens,2017,15117,14464,653,4.3
13,229,Pierce,2017,8875,8468,407,4.6
13,231,Pike,2017,8743,8348,395,4.5
13,233,Polk,2017,18657,17670,987,5.3
13,235,Pulaski,2017,4132,3912,220,5.3
13,237,Putnam,2017,8250,7768,482,5.8
13,239,Quitman,2017,841,791,50,5.9
13,241,Rabun,2017,6971,6624,347,5.0
13,243,Randolph,2017,2539,2373,166,6.5
13,245,Richmond,2017,86792,81560,5232,6.0
13,247,Rockdale,2017,44827,42431,2396,5.3
13,249,Schley,2017,2232,2109,123,5.5
13,251,Screven,2017,5320,4983,337,6.3
13,253,Seminole,2017,3116,2914,202,6.5
13,255,Spalding,2017,28596,26914,1682,5.9
13,257,Stephens,2017,11136,10548,588,5.3
13,259,Stewart,2017,2302,2164,138,6.0
13,261,Sumter,2017,13027,12133,894,6.9
13,263,Talbot,2017,2821,2646,175,6.2
13,265,Taliaferro,2017,581,542,39,6.7
13,267,Tattnall,2017,9683,9200,483,5.0
13,269,Taylor,2017,2847,2597,250,8.8
13,271,Telfair,2017,4831,4449,382,7.9
13,273,Terrell,2017,3701,3477,224,6.1
13,275,Thomas,2017,17377,16358,1019,5.9
13,277,Tift,2017,19310,18399,911,4.7
13,279,Toombs,2017,11930,11143,787,6.6
13,281,Towns,2017,3800,3548,252,6.6
13,283,Treutlen,2017,2760,2573,187,6.8
13,285,Troup,2017,37715,36038,1677,4.4
13,287,Turner,2017,3307,3119,188,5.7
13,289,Twiggs,2017,2997,2769,228,7.6
13,291,Union,2017,10248,9781,467,4.6
13,293,Upson,2017,11383,10754,629,5.5
13,295,Walker,2017,31159,29736,1423,4.6
13,297,Walton,2017,45151,43176,1975,4.4
13,299,Ware,2017,15974,15241,733,4.6
13,301,Warren,2017,2749,2587,162,5.9
13,303,Washington,2017,7438,6995,443,6.0
13,305,Wayne,2017,11464,10803,661,5.8
13,307,Webster,2017,1003,927,76,7.6
13,309,Wheeler,2017,1756,1597,159,9.1
13,311,White,2017,15847,15229,618,3.9
13,313,Whitfield,2017,45360,42863,2497,5.5
13,315,Wilcox,2017,2792,2628,164,5.9
13,317,Wilkes,2017,3851,3631,220,5.7
13,319,Wilkinson,2017,3845,3626,219,5.7
13,321,Worth,2017,9354,8895,459,4.9
15,1,Hawaii,2017,92980,90592,2388,2.6
15,3,Honolulu/city,2017,462048,452234,9814,2.1
15,7,Kauai,2017,36986,36184,802,2.2
15,9,Maui,2017,87770,85719,2051,2.3
16,1,Ada,2017,234461,227935,6526,2.8
16,3,Adams,2017,1747,1648,99,5.7
16,5,Bannock,2017,41497,40243,1254,3.0
16,7,Bear Lake,2017,2829,2740,89,3.1
16,9,Benewah,2017,4005,3784,221,5.5
16,11,Bingham,2017,23030,22352,678,2.9
16,13,Blaine,2017,12227,11916,311,2.5
16,15,Boise,2017,3203,3052,151,4.7
16,17,Bonner,2017,19249,18391,858,4.5
16,19,Bonneville,2017,53552,52123,1429,2.7
16,21,Boundary,2017,5149,4906,243,4.7
16,23,Butte,2017,1332,1293,39,2.9
16,25,Camas,2017,682,664,18,2.6
16,27,Canyon,2017,96536,93091,3445,3.6
16,29,Caribou,2017,3863,3743,120,3.1
16,31,Cassia,2017,11720,11431,289,2.5
16,33,Clark,2017,398,387,11,2.8
16,35,Clearwater,2017,3004,2797,207,6.9
16,37,Custer,2017,2158,2067,91,4.2
16,39,Elmore,2017,11186,10781,405,3.6
16,41,Franklin,2017,6752,6599,153,2.3
16,43,Fremont,2017,7615,7415,200,2.6
16,45,Gem,2017,7865,7556,309,3.9
16,47,Gooding,2017,8022,7827,195,2.4
16,49,Idaho,2017,6308,6000,308,4.9
16,51,Jefferson,2017,13079,12751,328,2.5
16,53,Jerome,2017,11639,11315,324,2.8
16,55,Kootenai,2017,75697,72801,2896,3.8
16,57,Latah,2017,20049,19523,526,2.6
16,59,Lemhi,2017,3476,3297,179,5.1
16,61,Lewis,2017,1614,1520,94,5.8
16,63,Lincoln,2017,2702,2616,86,3.2
16,65,Madison,2017,21181,20785,396,1.9
16,67,Minidoka,2017,10991,10700,291,2.6
16,69,Nez Perce,2017,21161,20565,596,2.8
16,71,Oneida,2017,2255,2191,64,2.8
16,73,Owyhee,2017,5304,5096,208,3.9
16,75,Payette,2017,11484,11033,451,3.9
16,77,Power,2017,3955,3822,133,3.4
16,79,Shoshone,2017,5032,4719,313,6.2
16,81,Teton,2017,6131,5977,154,2.5
16,83,Twin Falls,2017,40122,38924,1198,3.0
16,85,Valley,2017,5139,4915,224,4.4
16,87,Washington,2017,4601,4388,213,4.6
17,1,Adams,2017,32432,31173,1259,3.9
17,3,Alexander,2017,2136,1957,179,8.4
17,5,Bond,2017,7931,7580,351,4.4
17,7,Boone,2017,26202,24446,1756,6.7
17,9,Brown,2017,2865,2783,82,2.9
17,11,Bureau,2017,17412,16558,854,4.9
17,13,Calhoun,2017,2339,2213,126,5.4
17,15,Carroll,2017,7630,7277,353,4.6
17,17,Cass,2017,6156,5877,279,4.5
17,19,Champaign,2017,107264,102700,4564,4.3
17,21,Christian,2017,14781,13995,786,5.3
17,23,Clark,2017,7902,7504,398,5.0
17,25,Clay,2017,6655,6301,354,5.3
17,27,Clinton,2017,20330,19610,720,3.5
17,29,Coles,2017,24490,23345,1145,4.7
17,31,Cook,2017,2635275,2499538,135737,5.2
17,33,Crawford,2017,8881,8416,465,5.2
17,35,Cumberland,2017,6130,5884,246,4.0
17,37,DeKalb,2017,54909,52363,2546,4.6
17,39,De Witt,2017,7706,7343,363,4.7
17,41,Douglas,2017,10269,9849,420,4.1
17,43,DuPage,2017,511936,491445,20491,4.0
17,45,Edgar,2017,9475,9008,467,4.9
17,47,Edwards,2017,2855,2721,134,4.7
17,49,Effingham,2017,18921,18200,721,3.8
17,51,Fayette,2017,9688,9159,529,5.5
17,53,Ford,2017,6472,6161,311,4.8
17,55,Franklin,2017,16609,15534,1075,6.5
17,57,Fulton,2017,15503,14512,991,6.4
17,59,Gallatin,2017,2474,2327,147,5.9
17,61,Greene,2017,6026,5720,306,5.1
17,63,Grundy,2017,25521,24032,1489,5.8
17,65,Hamilton,2017,4468,4268,200,4.5
17,67,Hancock,2017,8532,8093,439,5.1
17,69,Hardin,2017,1351,1249,102,7.5
17,71,Henderson,2017,3653,3467,186,5.1
17,73,Henry,2017,25027,23750,1277,5.1
17,75,Iroquois,2017,14621,13950,671,4.6
17,77,Jackson,2017,28103,26843,1260,4.5
17,79,Jasper,2017,4493,4269,224,5.0
17,81,Jefferson,2017,17510,16557,953,5.4
17,83,Jersey,2017,10966,10437,529,4.8
17,85,Jo Daviess,2017,11074,10580,494,4.5
17,87,Johnson,2017,4121,3813,308,7.5
17,89,Kane,2017,269867,256830,13037,4.8
17,91,Kankakee,2017,54891,51881,3010,5.5
17,93,Kendall,2017,68125,65134,2991,4.4
17,95,Knox,2017,22525,21356,1169,5.2
17,97,Lake,2017,372989,356148,16841,4.5
17,99,LaSalle,2017,56178,53038,3140,5.6
17,101,Lawrence,2017,6095,5706,389,6.4
17,103,Lee,2017,17841,17066,775,4.3
17,105,Livingston,2017,16684,15941,743,4.5
17,107,Logan,2017,12872,12279,593,4.6
17,109,McDonough,2017,13541,12863,678,5.0
17,111,McHenry,2017,167144,159717,7427,4.4
17,113,McLean,2017,89436,85751,3685,4.1
17,115,Macon,2017,49665,46915,2750,5.5
17,117,Macoupin,2017,23010,21886,1124,4.9
17,119,Madison,2017,134305,127901,6404,4.8
17,121,Marion,2017,17708,16779,929,5.2
17,123,Marshall,2017,5465,5170,295,5.4
17,125,Mason,2017,6433,6042,391,6.1
17,127,Massac,2017,5855,5476,379,6.5
17,129,Menard,2017,6516,6240,276,4.2
17,131,Mercer,2017,8080,7666,414,5.1
17,133,Monroe,2017,18507,17878,629,3.4
17,135,Montgomery,2017,11942,11261,681,5.7
17,137,Morgan,2017,16442,15722,720,4.4
17,139,Moultrie,2017,7339,7055,284,3.9
17,141,Ogle,2017,25427,24125,1302,5.1
17,143,Peoria,2017,86297,81234,5063,5.9
17,145,Perry,2017,8415,7909,506,6.0
17,147,Piatt,2017,8572,8224,348,4.1
17,149,Pike,2017,7302,6971,331,4.5
17,151,Pope,2017,1786,1670,116,6.5
17,153,Pulaski,2017,2126,1958,168,7.9
17,155,Putnam,2017,3007,2858,149,5.0
17,157,Randolph,2017,14200,13575,625,4.4
17,159,Richland,2017,7560,7198,362,4.8
17,161,Rock Island,2017,71323,67679,3644,5.1
17,163,St. Clair,2017,126599,120182,6417,5.1
17,165,Saline,2017,9784,9153,631,6.4
17,167,Sangamon,2017,101842,97338,4504,4.4
17,169,Schuyler,2017,3340,3188,152,4.6
17,171,Scott,2017,2458,2329,129,5.2
17,173,Shelby,2017,10427,9967,460,4.4
17,175,Stark,2017,2571,2408,163,6.3
17,177,Stephenson,2017,21682,20670,1012,4.7
17,179,Tazewell,2017,64722,61266,3456,5.3
17,181,Union,2017,7371,6896,475,6.4
17,183,Vermilion,2017,34031,31822,2209,6.5
17,185,Wabash,2017,5654,5358,296,5.2
17,187,Warren,2017,8671,8309,362,4.2
17,189,Washington,2017,9572,9285,287,3.0
17,191,Wayne,2017,6961,6532,429,6.2
17,193,White,2017,6693,6363,330,4.9
17,195,Whiteside,2017,28229,26870,1359,4.8
17,197,Will,2017,360262,341945,18317,5.1
17,199,Williamson,2017,31852,30214,1638,5.1
17,201,Winnebago,2017,139230,130261,8969,6.4
17,203,Woodford,2017,18957,18126,831,4.4
18,1,Adams,2017,17228,16783,445,2.6
18,3,Allen,2017,180852,174902,5950,3.3
18,5,Bartholomew,2017,44427,43227,1200,2.7
18,7,Benton,2017,4488,4337,151,3.4
18,9,Blackford,2017,5330,5118,212,4.0
18,11,Boone,2017,35330,34339,991,2.8
18,13,Brown,2017,7542,7288,254,3.4
18,15,Carroll,2017,10054,9714,340,3.4
18,17,Cass,2017,17856,17183,673,3.8
18,19,Clark,2017,60775,58679,2096,3.4
18,21,Clay,2017,12262,11810,452,3.7
18,23,Clinton,2017,16945,16432,513,3.0
18,25,Crawford,2017,4937,4720,217,4.4
18,27,Daviess,2017,15914,15474,440,2.8
18,29,Dearborn,2017,25707,24727,980,3.8
18,31,Decatur,2017,14673,14249,424,2.9
18,33,DeKalb,2017,22226,21584,642,2.9
18,35,Delaware,2017,54256,51971,2285,4.2
18,37,Dubois,2017,23159,22568,591,2.6
18,39,Elkhart,2017,112151,109343,2808,2.5
18,41,Fayette,2017,9058,8609,449,5.0
18,43,Floyd,2017,40814,39469,1345,3.3
18,45,Fountain,2017,7895,7584,311,3.9
18,47,Franklin,2017,11197,10798,399,3.6
18,49,Fulton,2017,9747,9412,335,3.4
18,51,Gibson,2017,19075,18521,554,2.9
18,53,Grant,2017,31788,30570,1218,3.8
18,55,Greene,2017,13580,12944,636,4.7
18,57,Hamilton,2017,178016,173185,4831,2.7
18,59,Hancock,2017,39072,37907,1165,3.0
18,61,Harrison,2017,19886,19204,682,3.4
18,63,Hendricks,2017,87046,84556,2490,2.9
18,65,Henry,2017,22138,21337,801,3.6
18,67,Howard,2017,37904,36475,1429,3.8
18,69,Huntington,2017,18369,17721,648,3.5
18,71,Jackson,2017,22411,21750,661,2.9
18,73,Jasper,2017,16365,15668,697,4.3
18,75,Jay,2017,9770,9429,341,3.5
18,77,Jefferson,2017,15048,14496,552,3.7
18,79,Jennings,2017,13218,12722,496,3.8
18,81,Johnson,2017,80793,78433,2360,2.9
18,83,Knox,2017,18593,17965,628,3.4
18,85,Kosciusko,2017,41499,40381,1118,2.7
18,87,LaGrange,2017,19952,19450,502,2.5
18,89,Lake,2017,229639,218058,11581,5.0
18,91,LaPorte,2017,47720,45617,2103,4.4
18,93,Lawrence,2017,20778,19877,901,4.3
18,95,Madison,2017,58450,56151,2299,3.9
18,97,Marion,2017,482600,465367,17233,3.6
18,99,Marshall,2017,23634,22919,715,3.0
18,101,Martin,2017,5127,4976,151,2.9
18,103,Miami,2017,15833,15220,613,3.9
18,105,Monroe,2017,68370,65918,2452,3.6
18,107,Montgomery,2017,18957,18385,572,3.0
18,109,Morgan,2017,35802,34558,1244,3.5
18,111,Newton,2017,7059,6725,334,4.7
18,113,Noble,2017,23089,22386,703,3.0
18,115,Ohio,2017,3146,3033,113,3.6
18,117,Orange,2017,8700,8359,341,3.9
18,119,Owen,2017,9173,8779,394,4.3
18,121,Parke,2017,7177,6893,284,4.0
18,123,Perry,2017,9247,8898,349,3.8
18,125,Pike,2017,6437,6225,212,3.3
18,127,Porter,2017,85807,82367,3440,4.0
18,129,Posey,2017,13511,13111,400,3.0
18,131,Pulaski,2017,6369,6151,218,3.4
18,133,Putnam,2017,16565,15970,595,3.6
18,135,Randolph,2017,11712,11231,481,4.1
18,137,Ripley,2017,14042,13551,491,3.5
18,139,Rush,2017,8916,8647,269,3.0
18,141,St. Joseph,2017,134366,129621,4745,3.5
18,143,Scott,2017,10447,10056,391,3.7
18,145,Shelby,2017,22845,22094,751,3.3
18,147,Spencer,2017,10899,10539,360,3.3
18,149,Starke,2017,10434,9981,453,4.3
18,151,Steuben,2017,19925,19352,573,2.9
18,153,Sullivan,2017,8562,8188,374,4.4
18,155,Switzerland,2017,4989,4792,197,3.9
18,157,Tippecanoe,2017,95421,92393,3028,3.2
18,159,Tipton,2017,8530,8273,257,3.0
18,161,Union,2017,3604,3494,110,3.1
18,163,Vanderburgh,2017,93544,90546,2998,3.2
18,165,Vermillion,2017,7131,6751,380,5.3
18,167,Vigo,2017,48866,46834,2032,4.2
18,169,Wabash,2017,15103,14583,520,3.4
18,171,Warren,2017,4084,3948,136,3.3
18,173,Warrick,2017,32607,31596,1011,3.1
18,175,Washington,2017,13607,13106,501,3.7
18,177,Wayne,2017,30789,29650,1139,3.7
18,179,Wells,2017,14093,13682,411,2.9
18,181,White,2017,13325,12893,432,3.2
18,183,Whitley,2017,17252,16752,500,2.9
19,1,Adair,2017,4148,4033,115,2.8
19,3,Adams,2017,2139,2089,50,2.3
19,5,Allamakee,2017,7537,7238,299,4.0
19,7,Appanoose,2017,6053,5825,228,3.8
19,9,Audubon,2017,3166,3069,97,3.1
19,11,Benton,2017,13396,12959,437,3.3
19,13,Black Hawk,2017,68624,66058,2566,3.7
19,15,Boone,2017,14879,14517,362,2.4
19,17,Bremer,2017,13822,13437,385,2.8
19,19,Buchanan,2017,11132,10778,354,3.2
19,21,Buena Vista,2017,11584,11283,301,2.6
19,23,Butler,2017,7882,7600,282,3.6
19,25,Calhoun,2017,4305,4175,130,3.0
19,27,Carroll,2017,11065,10813,252,2.3
19,29,Cass,2017,7151,6895,256,3.6
19,31,Cedar,2017,10826,10514,312,2.9
19,33,Cerro Gordo,2017,23297,22587,710,3.0
19,35,Cherokee,2017,6065,5913,152,2.5
19,37,Chickasaw,2017,6390,6187,203,3.2
19,39,Clarke,2017,4800,4651,149,3.1
19,41,Clay,2017,8589,8270,319,3.7
19,43,Clayton,2017,10210,9809,401,3.9
19,45,Clinton,2017,23248,22308,940,4.0
19,47,Crawford,2017,8279,7941,338,4.1
19,49,Dallas,2017,47060,46062,998,2.1
19,51,Davis,2017,4278,4136,142,3.3
19,53,Decatur,2017,4290,4177,113,2.6
19,55,Delaware,2017,10533,10254,279,2.6
19,57,Des Moines,2017,19707,18878,829,4.2
19,59,Dickinson,2017,10133,9764,369,3.6
19,61,Dubuque,2017,54694,53070,1624,3.0
19,63,Emmet,2017,5420,5248,172,3.2
19,65,Fayette,2017,10518,10137,381,3.6
19,67,Floyd,2017,8803,8521,282,3.2
19,69,Franklin,2017,5801,5643,158,2.7
19,71,Fremont,2017,3822,3723,99,2.6
19,73,Greene,2017,5445,5296,149,2.7
19,75,Grundy,2017,6555,6365,190,2.9
19,77,Guthrie,2017,5576,5398,178,3.2
19,79,Hamilton,2017,7083,6855,228,3.2
19,81,Hancock,2017,6150,5991,159,2.6
19,83,Hardin,2017,8466,8196,270,3.2
19,85,Harrison,2017,7326,7126,200,2.7
19,87,Henry,2017,9700,9412,288,3.0
19,89,Howard,2017,5112,4959,153,3.0
19,91,Humboldt,2017,5276,5117,159,3.0
19,93,Ida,2017,4037,3943,94,2.3
19,95,Iowa,2017,10464,10192,272,2.6
19,97,Jackson,2017,10917,10548,369,3.4
19,99,Jasper,2017,19350,18748,602,3.1
19,101,Jefferson,2017,9173,8892,281,3.1
19,103,Johnson,2017,85657,83542,2115,2.5
19,105,Jones,2017,10550,10166,384,3.6
19,107,Keokuk,2017,5210,5024,186,3.6
19,109,Kossuth,2017,8769,8562,207,2.4
19,111,Lee,2017,16260,15379,881,5.4
19,113,Linn,2017,119153,115184,3969,3.3
19,115,Louisa,2017,6090,5891,199,3.3
19,117,Lucas,2017,4378,4256,122,2.8
19,119,Lyon,2017,7015,6893,122,1.7
19,121,Madison,2017,8323,8024,299,3.6
19,123,Mahaska,2017,11655,11283,372,3.2
19,125,Marion,2017,17418,16962,456,2.6
19,127,Marshall,2017,18274,17439,835,4.6
19,129,Mills,2017,7333,7132,201,2.7
19,131,Mitchell,2017,5790,5667,123,2.1
19,133,Monona,2017,4529,4365,164,3.6
19,135,Monroe,2017,3905,3757,148,3.8
19,137,Montgomery,2017,4966,4811,155,3.1
19,139,Muscatine,2017,21937,21220,717,3.3
19,141,O'Brien,2017,8050,7857,193,2.4
19,143,Osceola,2017,3602,3527,75,2.1
19,145,Page,2017,6367,6121,246,3.9
19,147,Palo Alto,2017,4909,4778,131,2.7
19,149,Plymouth,2017,14720,14370,350,2.4
19,151,Pocahontas,2017,4186,4086,100,2.4
19,153,Polk,2017,260908,252948,7960,3.1
19,155,Pottawattamie,2017,47697,46371,1326,2.8
19,157,Poweshiek,2017,10448,10123,325,3.1
19,159,Ringgold,2017,2557,2479,78,3.1
19,161,Sac,2017,5356,5206,150,2.8
19,163,Scott,2017,86668,83523,3145,3.6
19,165,Shelby,2017,6699,6540,159,2.4
19,167,Sioux,2017,20415,20007,408,2.0
19,169,Story,2017,57524,56388,1136,2.0
19,171,Tama,2017,9615,9283,332,3.5
19,173,Taylor,2017,3246,3174,72,2.2
19,175,Union,2017,6449,6249,200,3.1
19,177,Van Buren,2017,3732,3619,113,3.0
19,179,Wapello,2017,17690,16890,800,4.5
19,181,Warren,2017,27274,26526,748,2.7
19,183,Washington,2017,12268,11910,358,2.9
19,185,Wayne,2017,2784,2699,85,3.1
19,187,Webster,2017,19426,18704,722,3.7
19,189,Winnebago,2017,5177,5014,163,3.1
19,191,Winneshiek,2017,11879,11516,363,3.1
19,193,Woodbury,2017,54575,52852,1723,3.2
19,195,Worth,2017,4216,4089,127,3.0
19,197,Wright,2017,6548,6324,224,3.4
20,1,Allen,2017,6303,5998,305,4.8
20,3,Anderson,2017,4166,4003,163,3.9
20,5,Atchison,2017,7052,6687,365,5.2
20,7,Barber,2017,2455,2386,69,2.8
20,9,Barton,2017,14088,13581,507,3.6
20,11,Bourbon,2017,7039,6729,310,4.4
20,13,Brown,2017,5344,5173,171,3.2
20,15,Butler,2017,31773,30581,1192,3.8
20,17,Chase,2017,1430,1393,37,2.6
20,19,Chautauqua,2017,1448,1380,68,4.7
20,21,Cherokee,2017,10137,9743,394,3.9
20,23,Cheyenne,2017,1315,1282,33,2.5
20,25,Clark,2017,1088,1061,27,2.5
20,27,Clay,2017,3822,3680,142,3.7
20,29,Cloud,2017,3896,3729,167,4.3
20,31,Coffey,2017,4122,3907,215,5.2
20,33,Comanche,2017,908,882,26,2.9
20,35,Cowley,2017,16986,16344,642,3.8
20,37,Crawford,2017,19142,18342,800,4.2
20,39,Decatur,2017,1283,1243,40,3.1
20,41,Dickinson,2017,9282,8930,352,3.8
20,43,Doniphan,2017,4204,4058,146,3.5
20,45,Douglas,2017,65405,63323,2082,3.2
20,47,Edwards,2017,1516,1469,47,3.1
20,49,Elk,2017,1190,1140,50,4.2
20,51,Ellis,2017,17009,16584,425,2.5
20,53,Ellsworth,2017,2719,2636,83,3.1
20,55,Finney,2017,20135,19585,550,2.7
20,57,Ford,2017,17844,17341,503,2.8
20,59,Franklin,2017,14197,13669,528,3.7
20,61,Geary,2017,11512,10945,567,4.9
20,63,Gove,2017,1426,1393,33,2.3
20,65,Graham,2017,1116,1076,40,3.6
20,67,Grant,2017,3474,3363,111,3.2
20,69,Gray,2017,3411,3344,67,2.0
20,71,Greeley,2017,871,855,16,1.8
20,73,Greenwood,2017,3221,3086,135,4.2
20,75,Hamilton,2017,1633,1595,38,2.3
20,77,Harper,2017,2649,2551,98,3.7
20,79,Harvey,2017,16873,16186,687,4.1
20,81,Haskell,2017,2233,2183,50,2.2
20,83,Hodgeman,2017,989,964,25,2.5
20,85,Jackson,2017,7233,7007,226,3.1
20,87,Jefferson,2017,10205,9845,360,3.5
20,89,Jewell,2017,1304,1259,45,3.5
20,91,Johnson,2017,334399,324297,10102,3.0
20,93,Kearny,2017,2064,2013,51,2.5
20,95,Kingman,2017,3396,3271,125,3.7
20,97,Kiowa,2017,1347,1313,34,2.5
20,99,Labette,2017,10354,9888,466,4.5
20,101,Lane,2017,787,761,26,3.3
20,103,Leavenworth,2017,36339,34921,1418,3.9
20,105,Lincoln,2017,1687,1639,48,2.8
20,107,Linn,2017,4412,4154,258,5.8
20,109,Logan,2017,1675,1640,35,2.1
20,111,Lyon,2017,16811,16176,635,3.8
20,113,McPherson,2017,16328,15879,449,2.7
20,115,Marion,2017,6270,6044,226,3.6
20,117,Marshall,2017,5488,5335,153,2.8
20,119,Meade,2017,2280,2224,56,2.5
20,121,Miami,2017,17348,16702,646,3.7
20,123,Mitchell,2017,3448,3354,94,2.7
20,125,Montgomery,2017,14998,14214,784,5.2
20,127,Morris,2017,2998,2904,94,3.1
20,129,Morton,2017,1199,1154,45,3.8
20,131,Nemaha,2017,5579,5446,133,2.4
20,133,Neosho,2017,6051,5734,317,5.2
20,135,Ness,2017,1359,1320,39,2.9
20,137,Norton,2017,2815,2752,63,2.2
20,139,Osage,2017,7964,7650,314,3.9
20,141,Osborne,2017,2016,1961,55,2.7
20,143,Ottawa,2017,3059,2965,94,3.1
20,145,Pawnee,2017,3032,2931,101,3.3
20,147,Phillips,2017,2812,2729,83,3.0
20,149,Pottawatomie,2017,12212,11837,375,3.1
20,151,Pratt,2017,4956,4795,161,3.2
20,153,Rawlins,2017,1458,1425,33,2.3
20,155,Reno,2017,30064,28903,1161,3.9
20,157,Republic,2017,2459,2390,69,2.8
20,159,Rice,2017,5397,5225,172,3.2
20,161,Riley,2017,35184,34114,1070,3.0
20,163,Rooks,2017,2498,2402,96,3.8
20,165,Rush,2017,1652,1599,53,3.2
20,167,Russell,2017,3509,3392,117,3.3
20,169,Saline,2017,30644,29666,978,3.2
20,171,Scott,2017,2853,2791,62,2.2
20,173,Sedgwick,2017,245719,235335,10384,4.2
20,175,Seward,2017,9839,9496,343,3.5
20,177,Shawnee,2017,91396,88059,3337,3.7
20,179,Sheridan,2017,1373,1342,31,2.3
20,181,Sherman,2017,2898,2815,83,2.9
20,183,Smith,2017,1972,1917,55,2.8
20,185,Stafford,2017,2005,1939,66,3.3
20,187,Stanton,2017,1001,973,28,2.8
20,189,Stevens,2017,2673,2588,85,3.2
20,191,Sumner,2017,10721,10314,407,3.8
20,193,Thomas,2017,4258,4149,109,2.6
20,195,Trego,2017,1437,1389,48,3.3
20,197,Wabaunsee,2017,3647,3531,116,3.2
20,199,Wallace,2017,851,829,22,2.6
20,201,Washington,2017,2956,2869,87,2.9
20,203,Wichita,2017,1171,1143,28,2.4
20,205,Wilson,2017,3995,3807,188,4.7
20,207,Woodson,2017,1592,1522,70,4.4
20,209,Wyandotte,2017,77503,73478,4025,5.2
21,1,Adair,2017,7156,6734,422,5.9
21,3,Allen,2017,8965,8605,360,4.0
21,5,Anderson,2017,11818,11349,469,4.0
21,7,Ballard,2017,3628,3357,271,7.5
21,9,Barren,2017,18981,18126,855,4.5
21,11,Bath,2017,4712,4348,364,7.7
21,13,Bell,2017,8644,7977,667,7.7
21,15,Boone,2017,69774,67149,2625,3.8
21,17,Bourbon,2017,9874,9432,442,4.5
21,19,Boyd,2017,18267,16989,1278,7.0
21,21,Boyle,2017,12590,11969,621,4.9
21,23,Bracken,2017,3826,3609,217,5.7
21,25,Breathitt,2017,3734,3414,320,8.6
21,27,Breckinridge,2017,8005,7537,468,5.8
21,29,Bullitt,2017,41771,40050,1721,4.1
21,31,Butler,2017,5177,4899,278,5.4
21,33,Caldwell,2017,5332,5055,277,5.2
21,35,Calloway,2017,18766,17960,806,4.3
21,37,Campbell,2017,49801,47969,1832,3.7
21,39,Carlisle,2017,2380,2219,161,6.8
21,41,Carroll,2017,4996,4770,226,4.5
21,43,Carter,2017,9892,8942,950,9.6
21,45,Casey,2017,6674,6359,315,4.7
21,47,Christian,2017,24429,22966,1463,6.0
21,49,Clark,2017,17256,16476,780,4.5
21,51,Clay,2017,5347,4887,460,8.6
21,53,Clinton,2017,3854,3608,246,6.4
21,55,Crittenden,2017,3976,3762,214,5.4
21,57,Cumberland,2017,2935,2783,152,5.2
21,59,Daviess,2017,47867,45829,2038,4.3
21,61,Edmonson,2017,4852,4568,284,5.9
21,63,Elliott,2017,2110,1891,219,10.4
21,65,Estill,2017,5340,5028,312,5.8
21,67,Fayette,2017,175111,168906,6205,3.5
21,69,Fleming,2017,6052,5693,359,5.9
21,71,Floyd,2017,11250,10334,916,8.1
21,73,Franklin,2017,24741,23751,990,4.0
21,75,Fulton,2017,2062,1917,145,7.0
21,77,Gallatin,2017,4032,3854,178,4.4
21,79,Garrard,2017,7647,7282,365,4.8
21,81,Grant,2017,11588,11036,552,4.8
21,83,Graves,2017,15654,14740,914,5.8
21,85,Grayson,2017,10874,10227,647,5.9
21,87,Green,2017,5142,4909,233,4.5
21,89,Greenup,2017,13568,12549,1019,7.5
21,91,Hancock,2017,4098,3896,202,4.9
21,93,Hardin,2017,48671,46495,2176,4.5
21,95,Harlan,2017,6462,5833,629,9.7
21,97,Harrison,2017,8673,8282,391,4.5
21,99,Hart,2017,8087,7737,350,4.3
21,101,Henderson,2017,21940,20966,974,4.4
21,103,Henry,2017,8123,7797,326,4.0
21,105,Hickman,2017,1815,1682,133,7.3
21,107,Hopkins,2017,19443,18498,945,4.9
21,109,Jackson,2017,4093,3755,338,8.3
21,111,Jefferson,2017,395932,378916,17016,4.3
21,113,Jessamine,2017,26389,25413,976,3.7
21,115,Johnson,2017,6903,6322,581,8.4
21,117,Kenton,2017,86485,83137,3348,3.9
21,119,Knott,2017,4494,4120,374,8.3
21,121,Knox,2017,10041,9296,745,7.4
21,123,Larue,2017,6009,5733,276,4.6
21,125,Laurel,2017,24621,23210,1411,5.7
21,127,Lawrence,2017,4993,4550,443,8.9
21,129,Lee,2017,1892,1735,157,8.3
21,131,Leslie,2017,2728,2459,269,9.9
21,133,Letcher,2017,6280,5705,575,9.2
21,135,Lewis,2017,4693,4269,424,9.0
21,137,Lincoln,2017,9359,8842,517,5.5
21,139,Livingston,2017,3749,3473,276,7.4
21,141,Logan,2017,12145,11624,521,4.3
21,143,Lyon,2017,2988,2818,170,5.7
21,145,McCracken,2017,29616,27862,1754,5.9
21,147,McCreary,2017,4683,4368,315,6.7
21,149,McLean,2017,4294,4070,224,5.2
21,151,Madison,2017,46103,44177,1926,4.2
21,153,Magoffin,2017,2979,2505,474,15.9
21,155,Marion,2017,9448,9064,384,4.1
21,157,Marshall,2017,15009,14138,871,5.8
21,159,Martin,2017,3069,2840,229,7.5
21,161,Mason,2017,7211,6772,439,6.1
21,163,Meade,2017,12215,11600,615,5.0
21,165,Menifee,2017,2362,2161,201,8.5
21,167,Mercer,2017,9962,9484,478,4.8
21,169,Metcalfe,2017,4175,4008,167,4.0
21,171,Monroe,2017,4720,4540,180,3.8
21,173,Montgomery,2017,11710,10954,756,6.5
21,175,Morgan,2017,4500,4175,325,7.2
21,177,Muhlenberg,2017,11225,10465,760,6.8
21,179,Nelson,2017,22248,21291,957,4.3
21,181,Nicholas,2017,3309,3128,181,5.5
21,183,Ohio,2017,9769,9165,604,6.2
21,185,Oldham,2017,32883,31759,1124,3.4
21,187,Owen,2017,5444,5210,234,4.3
21,189,Owsley,2017,1097,1008,89,8.1
21,191,Pendleton,2017,6975,6654,321,4.6
21,193,Perry,2017,8384,7705,679,8.1
21,195,Pike,2017,20315,18776,1539,7.6
21,197,Powell,2017,5018,4692,326,6.5
21,199,Pulaski,2017,25348,23955,1393,5.5
21,201,Robertson,2017,817,767,50,6.1
21,203,Rockcastle,2017,6613,6238,375,5.7
21,205,Rowan,2017,10637,10035,602,5.7
21,207,Russell,2017,6246,5811,435,7.0
21,209,Scott,2017,28677,27651,1026,3.6
21,211,Shelby,2017,24673,23806,867,3.5
21,213,Simpson,2017,8718,8330,388,4.5
21,215,Spencer,2017,9936,9564,372,3.7
21,217,Taylor,2017,12853,12305,548,4.3
21,219,Todd,2017,5320,5101,219,4.1
21,221,Trigg,2017,5934,5604,330,5.6
21,223,Trimble,2017,3878,3689,189,4.9
21,225,Union,2017,6094,5737,357,5.9
21,227,Warren,2017,63926,61398,2528,4.0
21,229,Washington,2017,6170,5918,252,4.1
21,231,Wayne,2017,7393,6832,561,7.6
21,233,Webster,2017,5799,5504,295,5.1
21,235,Whitley,2017,13738,12965,773,5.6
21,237,Wolfe,2017,1922,1750,172,8.9
21,239,Woodford,2017,14947,14473,474,3.2
22,1,Acadia Parish,2017,24068,22646,1422,5.9
22,3,Allen Parish,2017,8988,8515,473,5.3
22,5,Ascension Parish,2017,62884,60199,2685,4.3
22,7,Assumption Parish,2017,8954,8296,658,7.3
22,9,Avoyelles Parish,2017,15639,14681,958,6.1
22,11,Beauregard Parish,2017,14692,13906,786,5.3
22,13,Bienville Parish,2017,5642,5304,338,6.0
22,15,Bossier Parish,2017,57713,55138,2575,4.5
22,17,Caddo Parish,2017,105029,98948,6081,5.8
22,19,Calcasieu Parish,2017,108615,104312,4303,4.0
22,21,Caldwell Parish,2017,3864,3644,220,5.7
22,23,Cameron Parish,2017,4011,3867,144,3.6
22,25,Catahoula Parish,2017,3439,3197,242,7.0
22,27,Claiborne Parish,2017,5866,5553,313,5.3
22,29,Concordia Parish,2017,7165,6602,563,7.9
22,31,De Soto Parish,2017,10800,10145,655,6.1
22,33,East Baton Rouge Parish,2017,232154,221954,10200,4.4
22,35,East Carroll Parish,2017,2058,1829,229,11.1
22,37,East Feliciana Parish,2017,7992,7608,384,4.8
22,39,Evangeline Parish,2017,12560,11818,742,5.9
22,41,Franklin Parish,2017,7318,6772,546,7.5
22,43,Grant Parish,2017,8197,7681,516,6.3
22,45,Iberia Parish,2017,28987,26870,2117,7.3
22,47,Iberville Parish,2017,14179,13305,874,6.2
22,49,Jackson Parish,2017,6994,6678,316,4.5
22,51,Jefferson Parish,2017,215342,205580,9762,4.5
22,53,Jefferson Davis Parish,2017,13644,12979,665,4.9
22,55,Lafayette Parish,2017,113286,107751,5535,4.9
22,57,Lafourche Parish,2017,41995,39812,2183,5.2
22,59,LaSalle Parish,2017,6152,5863,289,4.7
22,61,Lincoln Parish,2017,21597,20479,1118,5.2
22,63,Livingston Parish,2017,67822,64962,2860,4.2
22,65,Madison Parish,2017,3785,3479,306,8.1
22,67,Morehouse Parish,2017,10376,9549,827,8.0
22,69,Natchitoches Parish,2017,16368,15389,979,6.0
22,71,Orleans Parish,2017,178925,169716,9209,5.1
22,73,Ouachita Parish,2017,70733,67014,3719,5.3
22,75,Plaquemines Parish,2017,10026,9559,467,4.7
22,77,Pointe Coupee Parish,2017,10013,9454,559,5.6
22,79,Rapides Parish,2017,56169,53016,3153,5.6
22,81,Red River Parish,2017,3865,3664,201,5.2
22,83,Richland Parish,2017,8327,7817,510,6.1
22,85,Sabine Parish,2017,8842,8355,487,5.5
22,87,St. Bernard Parish,2017,19547,18523,1024,5.2
22,89,St. Charles Parish,2017,24942,23819,1123,4.5
22,91,St. Helena Parish,2017,4322,4035,287,6.6
22,93,St. James Parish,2017,9395,8770,625,6.7
22,95,St. John the Baptist Parish,2017,19746,18532,1214,6.1
22,97,St. Landry Parish,2017,32112,29969,2143,6.7
22,99,St. Martin Parish,2017,22572,21201,1371,6.1
22,101,St. Mary Parish,2017,20396,18792,1604,7.9
22,103,St. Tammany Parish,2017,117601,112570,5031,4.3
22,105,Tangipahoa Parish,2017,54897,51766,3131,5.7
22,107,Tensas Parish,2017,1555,1423,132,8.5
22,109,Terrebonne Parish,2017,46818,44155,2663,5.7
22,111,Union Parish,2017,9214,8702,512,5.6
22,113,Vermilion Parish,2017,24261,22807,1454,6.0
22,115,Vernon Parish,2017,16396,15328,1068,6.5
22,117,Washington Parish,2017,16953,15974,979,5.8
22,119,Webster Parish,2017,14785,13771,1014,6.9
22,121,West Baton Rouge Parish,2017,13508,12888,620,4.6
22,123,West Carroll Parish,2017,4004,3613,391,9.8
22,125,West Feliciana Parish,2017,5336,5114,222,4.2
22,127,Winn Parish,2017,5060,4734,326,6.4
23,1,Androscoggin,2017,55660,53874,1786,3.2
23,3,Aroostook,2017,31583,30033,1550,4.9
23,5,Cumberland,2017,164877,160549,4328,2.6
23,7,Franklin,2017,14472,13872,600,4.1
23,9,Hancock,2017,29368,28225,1143,3.9
23,11,Kennebec,2017,62835,60749,2086,3.3
23,13,Knox,2017,20761,20094,667,3.2
23,15,Lincoln,2017,17080,16516,564,3.3
23,17,Oxford,2017,26887,25845,1042,3.9
23,19,Penobscot,2017,77108,74158,2950,3.8
23,21,Piscataquis,2017,7515,7207,308,4.1
23,23,Sagadahoc,2017,19434,18898,536,2.8
23,25,Somerset,2017,23114,21968,1146,5.0
23,27,Waldo,2017,21203,20422,781,3.7
23,29,Washington,2017,14077,13369,708,5.0
23,31,York,2017,113561,110155,3406,3.0
24,1,Allegany,2017,32244,30414,1830,5.7
24,3,Anne Arundel,2017,309654,298823,10831,3.5
24,5,Baltimore,2017,450777,431563,19214,4.3
24,9,Calvert,2017,49391,47628,1763,3.6
24,11,Caroline,2017,17984,17227,757,4.2
24,13,Carroll,2017,94258,91121,3137,3.3
24,15,Cecil,2017,52896,50400,2496,4.7
24,17,Charles,2017,85696,82334,3362,3.9
24,19,Dorchester,2017,15649,14769,880,5.6
24,21,Frederick,2017,130931,126222,4709,3.6
24,23,Garrett,2017,15505,14712,793,5.1
24,25,Harford,2017,138369,133074,5295,3.8
24,27,Howard,2017,183725,178072,5653,3.1
24,29,Kent,2017,10235,9787,448,4.4
24,31,Montgomery,2017,554112,536053,18059,3.3
24,33,Prince George's,2017,507478,486591,20887,4.1
24,35,Queen Anne's,2017,27379,26393,986,3.6
24,37,St. Mary's,2017,55118,52957,2161,3.9
24,39,Somerset,2017,9285,8658,627,6.8
24,41,Talbot,2017,19714,18945,769,3.9
24,43,Washington,2017,75298,71850,3448,4.6
24,45,Wicomico,2017,50855,47994,2861,5.6
24,47,Worcester,2017,25411,23269,2142,8.4
24,510,Baltimore city,2017,290741,273107,17634,6.1
25,1,Barnstable,2017,112932,107543,5389,4.8
25,3,Berkshire,2017,64638,61719,2919,4.5
25,5,Bristol,2017,295578,281220,14358,4.9
25,7,Dukes,2017,9529,9052,477,5.0
25,9,Essex,2017,417019,400796,16223,3.9
25,11,Franklin,2017,40197,38820,1377,3.4
25,13,Hampden,2017,224886,213211,11675,5.2
25,15,Hampshire,2017,88915,85778,3137,3.5
25,17,Middlesex,2017,890661,862731,27930,3.1
25,19,Nantucket/town,2017,7182,6856,326,4.5
25,21,Norfolk,2017,378672,365783,12889,3.4
25,23,Plymouth,2017,275032,263992,11040,4.0
25,25,Suffolk,2017,439417,424133,15284,3.5
25,27,Worcester,2017,437381,419879,17502,4.0
26,1,Alcona,2017,3841,3568,273,7.1
26,3,Alger,2017,3292,3020,272,8.3
26,5,Allegan,2017,61232,58937,2295,3.7
26,7,Alpena,2017,13616,12841,775,5.7
26,9,Antrim,2017,10076,9417,659,6.5
26,11,Arenac,2017,6025,5541,484,8.0
26,13,Baraga,2017,3179,2934,245,7.7
26,15,Barry,2017,31288,30064,1224,3.9
26,17,Bay,2017,50944,48146,2798,5.5
26,19,Benzie,2017,8844,8273,571,6.5
26,21,Berrien,2017,74069,70509,3560,4.8
26,23,Branch,2017,19245,18364,881,4.6
26,25,Calhoun,2017,63964,60859,3105,4.9
26,27,Cass,2017,24297,23188,1109,4.6
26,29,Charlevoix,2017,13076,12351,725,5.5
26,31,Cheboygan,2017,10811,9735,1076,10.0
26,33,Chippewa,2017,16356,15109,1247,7.6
26,35,Clare,2017,11961,11132,829,6.9
26,37,Clinton,2017,40972,39494,1478,3.6
26,39,Crawford,2017,5418,5044,374,6.9
26,41,Delta,2017,17051,15987,1064,6.2
26,43,Dickinson,2017,12550,11961,589,4.7
26,45,Eaton,2017,57263,54932,2331,4.1
26,47,Emmet,2017,17650,16508,1142,6.5
26,49,Genesee,2017,180578,170347,10231,5.7
26,51,Gladwin,2017,9890,9249,641,6.5
26,53,Gogebic,2017,6315,5941,374,5.9
26,55,Grand Traverse,2017,49331,47275,2056,4.2
26,57,Gratiot,2017,17851,16887,964,5.4
26,59,Hillsdale,2017,20926,19906,1020,4.9
26,61,Houghton,2017,16467,15495,972,5.9
26,63,Huron,2017,15609,14809,800,5.1
26,65,Ingham,2017,151220,144785,6435,4.3
26,67,Ionia,2017,29834,28663,1171,3.9
26,69,Iosco,2017,10133,9392,741,7.3
26,71,Iron,2017,5165,4836,329,6.4
26,73,Isabella,2017,35171,33606,1565,4.4
26,75,Jackson,2017,74365,70954,3411,4.6
26,77,Kalamazoo,2017,132816,127518,5298,4.0
26,79,Kalkaska,2017,7884,7342,542,6.9
26,81,Kent,2017,355638,343435,12203,3.4
26,83,Keweenaw,2017,901,823,78,8.7
26,85,Lake,2017,3727,3425,302,8.1
26,87,Lapeer,2017,40963,38725,2238,5.5
26,89,Leelanau,2017,10502,10001,501,4.8
26,91,Lenawee,2017,47139,44932,2207,4.7
26,93,Livingston,2017,101791,98370,3421,3.4
26,95,Luce,2017,2413,2249,164,6.8
26,97,Mackinac,2017,5199,4676,523,10.1
26,99,Macomb,2017,442859,423607,19252,4.3
26,101,Manistee,2017,10422,9748,674,6.5
26,103,Marquette,2017,32908,31084,1824,5.5
26,105,Mason,2017,14035,13233,802,5.7
26,107,Mecosta,2017,18800,17732,1068,5.7
26,109,Menominee,2017,11001,10471,530,4.8
26,111,Midland,2017,40546,38680,1866,4.6
26,113,Missaukee,2017,6922,6519,403,5.8
26,115,Monroe,2017,76078,72490,3588,4.7
26,117,Montcalm,2017,28165,26767,1398,5.0
26,119,Montmorency,2017,3060,2742,318,10.4
26,121,Muskegon,2017,77900,73783,4117,5.3
26,123,Newaygo,2017,23291,22150,1141,4.9
26,125,Oakland,2017,665629,642418,23211,3.5
26,127,Oceana,2017,12223,11362,861,7.0
26,129,Ogemaw,2017,8179,7556,623,7.6
26,131,Ontonagon,2017,2166,1977,189,8.7
26,133,Osceola,2017,10631,10000,631,5.9
26,135,Oscoda,2017,2914,2701,213,7.3
26,137,Otsego,2017,11661,10966,695,6.0
26,139,Ottawa,2017,158140,152991,5149,3.3
26,141,Presque Isle,2017,5172,4696,476,9.2
26,143,Roscommon,2017,7840,7152,688,8.8
26,145,Saginaw,2017,87728,83027,4701,5.4
26,147,St. Clair,2017,75220,71414,3806,5.1
26,149,St. Joseph,2017,28732,27530,1202,4.2
26,151,Sanilac,2017,19307,18180,1127,5.8
26,153,Schoolcraft,2017,3361,3083,278,8.3
26,155,Shiawassee,2017,33376,31666,1710,5.1
26,157,Tuscola,2017,23936,22457,1479,6.2
26,159,Van Buren,2017,35301,33305,1996,5.7
26,161,Washtenaw,2017,194295,187505,6790,3.5
26,163,Wayne,2017,791929,748541,43388,5.5
26,165,Wexford,2017,14779,13960,819,5.5
27,1,Aitkin,2017,7160,6716,444,6.2
27,3,Anoka,2017,194905,188411,6494,3.3
27,5,Becker,2017,18526,17756,770,4.2
27,7,Beltrami,2017,23606,22459,1147,4.9
27,9,Benton,2017,21690,20815,875,4.0
27,11,Big Stone,2017,2565,2452,113,4.4
27,13,Blue Earth,2017,39945,38785,1160,2.9
27,15,Brown,2017,14351,13820,531,3.7
27,17,Carlton,2017,17657,16822,835,4.7
27,19,Carver,2017,57302,55634,1668,2.9
27,21,Cass,2017,14319,13468,851,5.9
27,23,Chippewa,2017,6911,6638,273,4.0
27,25,Chisago,2017,29421,28258,1163,4.0
27,27,Clay,2017,35589,34450,1139,3.2
27,29,Clearwater,2017,4592,4190,402,8.8
27,31,Cook,2017,3102,2983,119,3.8
27,33,Cottonwood,2017,5704,5408,296,5.2
27,35,Crow Wing,2017,32145,30716,1429,4.4
27,37,Dakota,2017,237561,230388,7173,3.0
27,39,Dodge,2017,11675,11283,392,3.4
27,41,Douglas,2017,20488,19839,649,3.2
27,43,Faribault,2017,7125,6828,297,4.2
27,45,Fillmore,2017,11389,10991,398,3.5
27,47,Freeborn,2017,16113,15527,586,3.6
27,49,Goodhue,2017,26795,25933,862,3.2
27,51,Grant,2017,3274,3140,134,4.1
27,53,Hennepin,2017,697098,676040,21058,3.0
27,55,Houston,2017,10435,10078,357,3.4
27,57,Hubbard,2017,9801,9252,549,5.6
27,59,Isanti,2017,20955,20056,899,4.3
27,61,Itasca,2017,21696,20188,1508,7.0
27,63,Jackson,2017,5744,5536,208,3.6
27,65,Kanabec,2017,9014,8467,547,6.1
27,67,Kandiyohi,2017,24783,23979,804,3.2
27,69,Kittson,2017,2362,2274,88,3.7
27,71,Koochiching,2017,5960,5538,422,7.1
27,73,Lac qui Parle,2017,3516,3395,121,3.4
27,75,Lake,2017,5496,5284,212,3.9
27,77,Lake of the Woods,2017,2379,2268,111,4.7
27,79,Le Sueur,2017,15822,15086,736,4.7
27,81,Lincoln,2017,3350,3243,107,3.2
27,83,Lyon,2017,14935,14460,475,3.2
27,85,McLeod,2017,19465,18729,736,3.8
27,87,Mahnomen,2017,2356,2238,118,5.0
27,89,Marshall,2017,5465,5087,378,6.9
27,91,Martin,2017,10388,10032,356,3.4
27,93,Meeker,2017,13215,12682,533,4.0
27,95,Mille Lacs,2017,12701,11997,704,5.5
27,97,Morrison,2017,17628,16693,935,5.3
27,99,Mower,2017,20520,19943,577,2.8
27,101,Murray,2017,4874,4661,213,4.4
27,103,Nicollet,2017,20574,20054,520,2.5
27,105,Nobles,2017,11318,10960,358,3.2
27,107,Norman,2017,3389,3230,159,4.7
27,109,Olmsted,2017,86538,84212,2326,2.7
27,111,Otter Tail,2017,31473,30227,1246,4.0
27,113,Pennington,2017,8778,8283,495,5.6
27,115,Pine,2017,14954,14104,850,5.7
27,117,Pipestone,2017,4848,4687,161,3.3
27,119,Polk,2017,16958,16248,710,4.2
27,121,Pope,2017,6346,6152,194,3.1
27,123,Ramsey,2017,286276,277047,9229,3.2
27,125,Red Lake,2017,2246,2098,148,6.6
27,127,Redwood,2017,7660,7349,311,4.1
27,129,Renville,2017,8861,8471,390,4.4
27,131,Rice,2017,36455,35301,1154,3.2
27,133,Rock,2017,5860,5738,122,2.1
27,135,Roseau,2017,8124,7729,395,4.9
27,137,St. Louis,2017,102315,97605,4710,4.6
27,139,Scott,2017,81969,79601,2368,2.9
27,141,Sherburne,2017,51261,49352,1909,3.7
27,143,Sibley,2017,8395,8095,300,3.6
27,145,Stearns,2017,89876,86844,3032,3.4
27,147,Steele,2017,20491,19803,688,3.4
27,149,Stevens,2017,5495,5350,145,2.6
27,151,Swift,2017,5038,4832,206,4.1
27,153,Todd,2017,13471,12942,529,3.9
27,155,Traverse,2017,1768,1705,63,3.6
27,157,Wabasha,2017,12138,11734,404,3.3
27,159,Wadena,2017,5820,5497,323,5.5
27,161,Waseca,2017,9276,8917,359,3.9
27,163,Washington,2017,140632,136430,4202,3.0
27,165,Watonwan,2017,6486,6207,279,4.3
27,167,Wilkin,2017,3545,3435,110,3.1
27,169,Winona,2017,28910,28015,895,3.1
27,171,Wright,2017,74022,71425,2597,3.5
27,173,Yellow Medicine,2017,5340,5156,184,3.4
28,1,Adams,2017,11219,10380,839,7.5
28,3,Alcorn,2017,16014,15288,726,4.5
28,5,Amite,2017,4458,4149,309,6.9
28,7,Attala,2017,6953,6522,431,6.2
28,9,Benton,2017,3032,2858,174,5.7
28,11,Bolivar,2017,12883,12036,847,6.6
28,13,Calhoun,2017,5624,5354,270,4.8
28,15,Carroll,2017,3530,3319,211,6.0
28,17,Chickasaw,2017,7060,6681,379,5.4
28,19,Choctaw,2017,3613,3429,184,5.1
28,21,Claiborne,2017,3025,2722,303,10.0
28,23,Clarke,2017,6152,5772,380,6.2
28,25,Clay,2017,7731,7193,538,7.0
28,27,Coahoma,2017,8612,7955,657,7.6
28,29,Copiah,2017,11237,10581,656,5.8
28,31,Covington,2017,8091,7691,400,4.9
28,33,DeSoto,2017,88549,85062,3487,3.9
28,35,Forrest,2017,33428,31766,1662,5.0
28,37,Franklin,2017,2859,2660,199,7.0
28,39,George,2017,8829,8181,648,7.3
28,41,Greene,2017,4372,4037,335,7.7
28,43,Grenada,2017,9635,9182,453,4.7
28,45,Hancock,2017,18706,17640,1066,5.7
28,47,Harrison,2017,85993,81709,4284,5.0
28,49,Hinds,2017,109099,103668,5431,5.0
28,51,Holmes,2017,5816,5256,560,9.6
28,53,Humphreys,2017,2202,1989,213,9.7
28,55,Issaquena,2017,392,344,48,12.2
28,57,Itawamba,2017,10501,10049,452,4.3
28,59,Jackson,2017,58454,54904,3550,6.1
28,61,Jasper,2017,6079,5671,408,6.7
28,63,Jefferson,2017,2121,1804,317,14.9
28,65,Jefferson Davis,2017,4234,3938,296,7.0
28,67,Jones,2017,25378,24031,1347,5.3
28,69,Kemper,2017,3592,3306,286,8.0
28,71,Lafayette,2017,27495,26324,1171,4.3
28,73,Lamar,2017,30127,28945,1182,3.9
28,75,Lauderdale,2017,31755,30021,1734,5.5
28,77,Lawrence,2017,4682,4369,313,6.7
28,79,Leake,2017,7583,7138,445,5.9
28,81,Lee,2017,41079,39389,1690,4.1
28,83,Leflore,2017,10125,9352,773,7.6
28,85,Lincoln,2017,14531,13755,776,5.3
28,87,Lowndes,2017,25267,23878,1389,5.5
28,89,Madison,2017,53149,51029,2120,4.0
28,91,Marion,2017,10189,9614,575,5.6
28,93,Marshall,2017,14365,13604,761,5.3
28,95,Monroe,2017,15560,14737,823,5.3
28,97,Montgomery,2017,4158,3941,217,5.2
28,99,Neshoba,2017,10374,9824,550,5.3
28,101,Newton,2017,8909,8445,464,5.2
28,103,Noxubee,2017,3898,3606,292,7.5
28,105,Oktibbeha,2017,22204,21071,1133,5.1
28,107,Panola,2017,13049,12149,900,6.9
28,109,Pearl River,2017,23428,22162,1266,5.4
28,111,Perry,2017,4317,4037,280,6.5
28,113,Pike,2017,14455,13554,901,6.2
28,115,Pontotoc,2017,14635,14056,579,4.0
28,117,Prentiss,2017,11190,10668,522,4.7
28,119,Quitman,2017,2428,2206,222,9.1
28,121,Rankin,2017,75933,73147,2786,3.7
28,123,Scott,2017,13010,12459,551,4.2
28,125,Sharkey,2017,1613,1481,132,8.2
28,127,Simpson,2017,10927,10380,547,5.0
28,129,Smith,2017,6748,6420,328,4.9
28,131,Stone,2017,6566,6154,412,6.3
28,133,Sunflower,2017,7953,7276,677,8.5
28,135,Tallahatchie,2017,5469,5168,301,5.5
28,137,Tate,2017,12082,11454,628,5.2
28,139,Tippah,2017,9451,9018,433,4.6
28,141,Tishomingo,2017,8345,7921,424,5.1
28,143,Tunica,2017,4449,4178,271,6.1
28,145,Union,2017,13961,13445,516,3.7
28,147,Walthall,2017,5057,4707,350,6.9
28,149,Warren,2017,20824,19621,1203,5.8
28,151,Washington,2017,17739,16439,1300,7.3
28,153,Wayne,2017,7381,6901,480,6.5
28,155,Webster,2017,3870,3662,208,5.4
28,157,Wilkinson,2017,2830,2574,256,9.0
28,159,Winston,2017,7209,6764,445,6.2
28,161,Yalobusha,2017,5071,4788,283,5.6
28,163,Yazoo,2017,9079,8511,568,6.3
29,1,Adair,2017,10474,10026,448,4.3
29,3,Andrew,2017,9794,9480,314,3.2
29,5,Atchison,2017,2851,2751,100,3.5
29,7,Audrain,2017,11077,10691,386,3.5
29,9,Barry,2017,15479,14960,519,3.4
29,11,Barton,2017,5203,4986,217,4.2
29,13,Bates,2017,7973,7617,356,4.5
29,15,Benton,2017,7285,6912,373,5.1
29,17,Bollinger,2017,5496,5254,242,4.4
29,19,Boone,2017,97342,94780,2562,2.6
29,21,Buchanan,2017,45081,43471,1610,3.6
29,23,Butler,2017,18511,17673,838,4.5
29,25,Caldwell,2017,4427,4247,180,4.1
29,27,Callaway,2017,21433,20684,749,3.5
29,29,Camden,2017,18885,17979,906,4.8
29,31,Cape Girardeau,2017,39828,38443,1385,3.5
29,33,Carroll,2017,4786,4591,195,4.1
29,35,Carter,2017,2531,2382,149,5.9
29,37,Cass,2017,54185,52272,1913,3.5
29,39,Cedar,2017,5754,5520,234,4.1
29,41,Chariton,2017,3849,3716,133,3.5
29,43,Christian,2017,43171,41828,1343,3.1
29,45,Clark,2017,3205,3025,180,5.6
29,47,Clay,2017,134697,129805,4892,3.6
29,49,Clinton,2017,10872,10437,435,4.0
29,51,Cole,2017,38787,37644,1143,2.9
29,53,Cooper,2017,7457,7185,272,3.6
29,55,Crawford,2017,10807,10307,500,4.6
29,57,Dade,2017,3574,3452,122,3.4
29,59,Dallas,2017,6941,6613,328,4.7
29,61,Daviess,2017,4074,3938,136,3.3
29,63,DeKalb,2017,4904,4713,191,3.9
29,65,Dent,2017,6176,5917,259,4.2
29,67,Douglas,2017,5070,4835,235,4.6
29,69,Dunklin,2017,12432,11623,809,6.5
29,71,Franklin,2017,52427,50526,1901,3.6
29,73,Gasconade,2017,7788,7487,301,3.9
29,75,Gentry,2017,3620,3517,103,2.8
29,77,Greene,2017,146967,142434,4533,3.1
29,79,Grundy,2017,4799,4628,171,3.6
29,81,Harrison,2017,3918,3780,138,3.5
29,83,Henry,2017,9893,9485,408,4.1
29,85,Hickory,2017,3761,3593,168,4.5
29,87,Holt,2017,2693,2615,78,2.9
29,89,Howard,2017,5080,4886,194,3.8
29,91,Howell,2017,15905,15148,757,4.8
29,93,Iron,2017,3583,3352,231,6.4
29,95,Jackson,2017,362327,346310,16017,4.4
29,97,Jasper,2017,56803,54881,1922,3.4
29,99,Jefferson,2017,116325,112154,4171,3.6
29,101,Johnson,2017,23284,22259,1025,4.4
29,103,Knox,2017,1992,1928,64,3.2
29,105,Laclede,2017,16607,15817,790,4.8
29,107,Lafayette,2017,16980,16338,642,3.8
29,109,Lawrence,2017,17861,17227,634,3.5
29,111,Lewis,2017,5111,4936,175,3.4
29,113,Lincoln,2017,27377,26393,984,3.6
29,115,Linn,2017,5263,4956,307,5.8
29,117,Livingston,2017,7462,7242,220,2.9
29,119,McDonald,2017,10393,10013,380,3.7
29,121,Macon,2017,7580,7305,275,3.6
29,123,Madison,2017,5493,5246,247,4.5
29,125,Maries,2017,3918,3749,169,4.3
29,127,Marion,2017,14545,14023,522,3.6
29,129,Mercer,2017,1946,1873,73,3.8
29,131,Miller,2017,12021,11486,535,4.5
29,133,Mississippi,2017,6053,5749,304,5.0
29,135,Moniteau,2017,7362,7095,267,3.6
29,137,Monroe,2017,4069,3895,174,4.3
29,139,Montgomery,2017,5654,5468,186,3.3
29,141,Morgan,2017,7944,7553,391,4.9
29,143,New Madrid,2017,8005,7477,528,6.6
29,145,Newton,2017,27346,26347,999,3.7
29,147,Nodaway,2017,10647,10264,383,3.6
29,149,Oregon,2017,4018,3833,185,4.6
29,151,Osage,2017,7117,6904,213,3.0
29,153,Ozark,2017,3569,3361,208,5.8
29,155,Pemiscot,2017,6561,6071,490,7.5
29,157,Perry,2017,10113,9844,269,2.7
29,159,Pettis,2017,20877,20007,870,4.2
29,161,Phelps,2017,19702,18965,737,3.7
29,163,Pike,2017,7933,7660,273,3.4
29,165,Platte,2017,57666,55823,1843,3.2
29,167,Polk,2017,14197,13629,568,4.0
29,169,Pulaski,2017,14715,14084,631,4.3
29,171,Putnam,2017,2447,2354,93,3.8
29,173,Ralls,2017,5648,5472,176,3.1
29,175,Randolph,2017,10278,9812,466,4.5
29,177,Ray,2017,11100,10563,537,4.8
29,179,Reynolds,2017,3130,3008,122,3.9
29,181,Ripley,2017,5251,4960,291,5.5
29,183,St. Charles,2017,221975,215608,6367,2.9
29,185,St. Clair,2017,3882,3684,198,5.1
29,186,Ste. Genevieve,2017,9094,8768,326,3.6
29,187,St. Francois,2017,26742,25570,1172,4.4
29,189,St. Louis,2017,525600,507484,18116,3.4
29,195,Saline,2017,10679,10299,380,3.6
29,197,Schuyler,2017,1958,1863,95,4.9
29,199,Scotland,2017,2454,2377,77,3.1
29,201,Scott,2017,20130,19233,897,4.5
29,203,Shannon,2017,3284,3085,199,6.1
29,205,Shelby,2017,3096,2989,107,3.5
29,207,Stoddard,2017,13239,12570,669,5.1
29,209,Stone,2017,13833,13067,766,5.5
29,211,Sullivan,2017,2755,2643,112,4.1
29,213,Taney,2017,26963,25334,1629,6.0
29,215,Texas,2017,9377,8911,466,5.0
29,217,Vernon,2017,9654,9287,367,3.8
29,219,Warren,2017,17583,17019,564,3.2
29,221,Washington,2017,10311,9753,558,5.4
29,223,Wayne,2017,5542,5260,282,5.1
29,225,Webster,2017,16833,16179,654,3.9
29,227,Worth,2017,1191,1161,30,2.5
29,229,Wright,2017,7619,7241,378,5.0
29,510,St. Louis city,2017,154137,147268,6869,4.5
30,1,Beaverhead,2017,5050,4890,160,3.2
30,3,Big Horn,2017,5537,4783,754,13.6
30,5,Blaine,2017,2355,2256,99,4.2
30,7,Broadwater,2017,2587,2462,125,4.8
30,9,Carbon,2017,5503,5300,203,3.7
30,11,Carter,2017,696,678,18,2.6
30,13,Cascade,2017,37784,36339,1445,3.8
30,15,Chouteau,2017,2492,2409,83,3.3
30,17,Custer,2017,6162,5964,198,3.2
30,19,Daniels,2017,907,886,21,2.3
30,21,Dawson,2017,4681,4534,147,3.1
30,23,Deer Lodge,2017,5137,4951,186,3.6
30,25,Fallon,2017,1737,1690,47,2.7
30,27,Fergus,2017,5765,5529,236,4.1
30,29,Flathead,2017,46823,44318,2505,5.3
30,31,Gallatin,2017,64548,62734,1814,2.8
30,33,Garfield,2017,761,739,22,2.9
30,35,Glacier,2017,5733,5270,463,8.1
30,37,Golden Valley,2017,374,355,19,5.1
30,39,Granite,2017,1619,1523,96,5.9
30,41,Hill,2017,7798,7497,301,3.9
30,43,Jefferson,2017,5630,5384,246,4.4
30,45,Judith Basin,2017,923,889,34,3.7
30,47,Lake,2017,13147,12548,599,4.6
30,49,Lewis and Clark,2017,35273,34033,1240,3.5
30,51,Liberty,2017,979,949,30,3.1
30,53,Lincoln,2017,7908,7228,680,8.6
30,55,McCone,2017,1022,1000,22,2.2
30,57,Madison,2017,4395,4221,174,4.0
30,59,Meagher,2017,930,889,41,4.4
30,61,Mineral,2017,1689,1560,129,7.6
30,63,Missoula,2017,62371,60075,2296,3.7
30,65,Musselshell,2017,2291,2187,104,4.5
30,67,Park,2017,8628,8284,344,4.0
30,69,Petroleum,2017,292,279,13,4.5
30,71,Phillips,2017,1893,1805,88,4.6
30,73,Pondera,2017,2742,2635,107,3.9
30,75,Powder River,2017,1006,980,26,2.6
30,77,Powell,2017,2889,2762,127,4.4
30,79,Prairie,2017,486,468,18,3.7
30,81,Ravalli,2017,19787,18844,943,4.8
30,83,Richland,2017,5978,5747,231,3.9
30,85,Roosevelt,2017,4572,4356,216,4.7
30,87,Rosebud,2017,4025,3814,211,5.2
30,89,Sanders,2017,4786,4447,339,7.1
30,91,Sheridan,2017,1863,1812,51,2.7
30,93,Silver Bow,2017,17153,16420,733,4.3
30,95,Stillwater,2017,4845,4655,190,3.9
30,97,Sweet Grass,2017,1797,1740,57,3.2
30,99,Teton,2017,2782,2671,111,4.0
30,101,Toole,2017,2150,2084,66,3.1
30,103,Treasure,2017,340,327,13,3.8
30,105,Valley,2017,4161,4022,139,3.3
30,107,Wheatland,2017,785,750,35,4.5
30,109,Wibaux,2017,483,467,16,3.3
30,111,Yellowstone,2017,81346,78447,2899,3.6
31,1,Adams,2017,16667,16150,517,3.1
31,3,Antelope,2017,3573,3484,89,2.5
31,5,Arthur,2017,222,209,13,5.9
31,7,Banner,2017,390,376,14,3.6
31,9,Blaine,2017,262,251,11,4.2
31,11,Boone,2017,2937,2865,72,2.5
31,13,Box Butte,2017,5442,5262,180,3.3
31,15,Boyd,2017,1082,1046,36,3.3
31,17,Brown,2017,1406,1360,46,3.3
31,19,Buffalo,2017,27350,26686,664,2.4
31,21,Burt,2017,3514,3385,129,3.7
31,23,Butler,2017,4577,4449,128,2.8
31,25,Cass,2017,13204,12786,418,3.2
31,27,Cedar,2017,4483,4383,100,2.2
31,29,Chase,2017,2310,2267,43,1.9
31,31,Cherry,2017,3402,3323,79,2.3
31,33,Cheyenne,2017,5113,4966,147,2.9
31,35,Clay,2017,3286,3184,102,3.1
31,37,Colfax,2017,5615,5479,136,2.4
31,39,Cuming,2017,4744,4615,129,2.7
31,41,Custer,2017,6403,6265,138,2.2
31,43,Dakota,2017,10663,10229,434,4.1
31,45,Dawes,2017,5176,5035,141,2.7
31,47,Dawson,2017,12975,12603,372,2.9
31,49,Deuel,2017,1039,1012,27,2.6
31,51,Dixon,2017,3024,2929,95,3.1
31,53,Dodge,2017,19411,18865,546,2.8
31,55,Douglas,2017,291875,282565,9310,3.2
31,57,Dundy,2017,1184,1156,28,2.4
31,59,Fillmore,2017,3114,3036,78,2.5
31,61,Franklin,2017,1480,1436,44,3.0
31,63,Frontier,2017,1565,1525,40,2.6
31,65,Furnas,2017,2685,2620,65,2.4
31,67,Gage,2017,10990,10607,383,3.5
31,69,Garden,2017,1193,1160,33,2.8
31,71,Garfield,2017,1160,1130,30,2.6
31,73,Gosper,2017,1047,1019,28,2.7
31,75,Grant,2017,440,430,10,2.3
31,77,Greeley,2017,1224,1187,37,3.0
31,79,Hall,2017,31681,30593,1088,3.4
31,81,Hamilton,2017,4695,4577,118,2.5
31,83,Harlan,2017,1778,1733,45,2.5
31,85,Hayes,2017,574,560,14,2.4
31,87,Hitchcock,2017,1266,1223,43,3.4
31,89,Holt,2017,5768,5627,141,2.4
31,91,Hooker,2017,397,382,15,3.8
31,93,Howard,2017,3328,3226,102,3.1
31,95,Jefferson,2017,4208,4106,102,2.4
31,97,Johnson,2017,2080,2010,70,3.4
31,99,Kearney,2017,3766,3683,83,2.2
31,101,Keith,2017,4602,4463,139,3.0
31,103,Keya Paha,2017,608,593,15,2.5
31,105,Kimball,2017,1978,1922,56,2.8
31,107,Knox,2017,4704,4541,163,3.5
31,109,Lancaster,2017,171022,166479,4543,2.7
31,111,Lincoln,2017,18505,17941,564,3.0
31,113,Logan,2017,472,459,13,2.8
31,115,Loup,2017,399,387,12,3.0
31,117,McPherson,2017,454,444,10,2.2
31,119,Madison,2017,19309,18802,507,2.6
31,121,Merrick,2017,4065,3952,113,2.8
31,123,Morrill,2017,2613,2536,77,2.9
31,125,Nance,2017,2024,1974,50,2.5
31,127,Nemaha,2017,3614,3473,141,3.9
31,129,Nuckolls,2017,2368,2305,63,2.7
31,131,Otoe,2017,8179,7906,273,3.3
31,133,Pawnee,2017,1508,1462,46,3.1
31,135,Perkins,2017,1812,1777,35,1.9
31,137,Phelps,2017,4919,4805,114,2.3
31,139,Pierce,2017,4128,4016,112,2.7
31,141,Platte,2017,17294,16797,497,2.9
31,143,Polk,2017,2901,2832,69,2.4
31,145,Red Willow,2017,5857,5708,149,2.5
31,147,Richardson,2017,4223,4086,137,3.2
31,149,Rock,2017,906,883,23,2.5
31,151,Saline,2017,7416,7187,229,3.1
31,153,Sarpy,2017,93443,90831,2612,2.8
31,155,Saunders,2017,10867,10562,305,2.8
31,157,Scotts Bluff,2017,18437,17804,633,3.4
31,159,Seward,2017,8638,8406,232,2.7
31,161,Sheridan,2017,2722,2650,72,2.6
31,163,Sherman,2017,1698,1649,49,2.9
31,165,Sioux,2017,757,735,22,2.9
31,167,Stanton,2017,3487,3388,99,2.8
31,169,Thayer,2017,2869,2805,64,2.2
31,171,Thomas,2017,437,423,14,3.2
31,173,Thurston,2017,3021,2871,150,5.0
31,175,Valley,2017,2117,2061,56,2.6
31,177,Washington,2017,11175,10828,347,3.1
31,179,Wayne,2017,5670,5534,136,2.4
31,181,Webster,2017,1667,1618,49,2.9
31,183,Wheeler,2017,585,572,13,2.2
31,185,York,2017,7348,7160,188,2.6
32,1,Churchill,2017,10507,10037,470,4.5
32,3,Clark,2017,1067135,1011367,55768,5.2
32,5,Douglas,2017,22336,21257,1079,4.8
32,7,Elko,2017,26727,25740,987,3.7
32,9,Esmeralda,2017,484,464,20,4.1
32,11,Eureka,2017,1042,1011,31,3.0
32,13,Humboldt,2017,8036,7694,342,4.3
32,15,Lander,2017,3103,2962,141,4.5
32,17,Lincoln,2017,2009,1913,96,4.8
32,19,Lyon,2017,21612,20311,1301,6.0
32,21,Mineral,2017,1974,1866,108,5.5
32,23,Nye,2017,16086,15051,1035,6.4
32,27,Pershing,2017,2534,2418,116,4.6
32,29,Storey,2017,1910,1814,96,5.0
32,31,Washoe,2017,237893,228009,9884,4.2
32,33,White Pine,2017,4450,4269,181,4.1
32,510,Carson City,2017,25296,24024,1272,5.0
33,1,Belknap,2017,31136,30277,859,2.8
33,3,Carroll,2017,23576,22921,655,2.8
33,5,Cheshire,2017,41002,39895,1107,2.7
33,7,Coos,2017,14479,13961,518,3.6
33,9,Grafton,2017,49332,48206,1126,2.3
33,11,Hillsborough,2017,234248,227293,6955,3.0
33,13,Merrimack,2017,82112,80087,2025,2.5
33,15,Rockingham,2017,183287,177716,5571,3.0
33,17,Strafford,2017,72573,70758,1815,2.5
33,19,Sullivan,2017,23259,22721,538,2.3
34,1,Atlantic,2017,119015,110604,8411,7.1
34,3,Bergen,2017,477850,459708,18142,3.8
34,5,Burlington,2017,230628,221396,9232,4.0
34,7,Camden,2017,253650,241028,12622,5.0
34,9,Cape May,2017,46216,42042,4174,9.0
34,11,Cumberland,2017,65511,61052,4459,6.8
34,13,Essex,2017,369606,349236,20370,5.5
34,15,Gloucester,2017,149423,142533,6890,4.6
34,17,Hudson,2017,362060,346697,15363,4.2
34,19,Hunterdon,2017,63894,61691,2203,3.4
34,21,Mercer,2017,197962,190066,7896,4.0
34,23,Middlesex,2017,438909,421423,17486,4.0
34,25,Monmouth,2017,326136,313015,13121,4.0
34,27,Morris,2017,256465,247368,9097,3.5
34,29,Ocean,2017,269527,256890,12637,4.7
34,31,Passaic,2017,242491,228942,13549,5.6
34,33,Salem,2017,29289,27527,1762,6.0
34,35,Somerset,2017,171450,165100,6350,3.7
34,37,Sussex,2017,73664,70488,3176,4.3
34,39,Union,2017,276546,263736,12810,4.6
34,41,Warren,2017,55839,53557,2282,4.1
35,1,Bernalillo,2017,331263,313343,17920,5.4
35,3,Catron,2017,1174,1093,81,6.9
35,5,Chaves,2017,27699,25937,1762,6.4
35,6,Cibola,2017,9185,8481,704,7.7
35,7,Colfax,2017,5738,5398,340,5.9
35,9,Curry,2017,22470,21405,1065,4.7
35,11,De Baca,2017,855,816,39,4.6
35,13,Dona Ana,2017,96581,90089,6492,6.7
35,15,Eddy,2017,29408,27888,1520,5.2
35,17,Grant,2017,12349,11607,742,6.0
35,19,Guadalupe,2017,1657,1550,107,6.5
35,21,Harding,2017,284,267,17,6.0
35,23,Hidalgo,2017,2149,2040,109,5.1
35,25,Lea,2017,28068,26250,1818,6.5
35,27,Lincoln,2017,8786,8307,479,5.5
35,28,Los Alamos,2017,9200,8850,350,3.8
35,29,Luna,2017,10633,9156,1477,13.9
35,31,McKinley,2017,24502,22415,2087,8.5
35,33,Mora,2017,2227,2052,175,7.9
35,35,Otero,2017,25158,23639,1519,6.0
35,37,Quay,2017,3280,3081,199,6.1
35,39,Rio Arriba,2017,16934,15864,1070,6.3
35,41,Roosevelt,2017,8064,7649,415,5.1
35,43,Sandoval,2017,65112,61147,3965,6.1
35,45,San Juan,2017,54430,50373,4057,7.5
35,47,San Miguel,2017,11066,10254,812,7.3
35,49,Santa Fe,2017,74071,70347,3724,5.0
35,51,Sierra,2017,4204,3880,324,7.7
35,53,Socorro,2017,6654,6233,421,6.3
35,55,Taos,2017,15212,14024,1188,7.8
35,57,Torrance,2017,5632,5155,477,8.5
35,59,Union,2017,1928,1856,72,3.7
35,61,Valencia,2017,30416,28419,1997,6.6
36,1,Albany,2017,157989,151338,6651,4.2
36,3,Allegany,2017,19675,18378,1297,6.6
36,5,Bronx,2017,606026,568662,37364,6.2
36,7,Broome,2017,84447,79765,4682,5.5
36,9,Cattaraugus,2017,34247,32132,2115,6.2
36,11,Cayuga,2017,35838,34045,1793,5.0
36,13,Chautauqua,2017,55376,52071,3305,6.0
36,15,Chemung,2017,35631,33674,1957,5.5
36,17,Chenango,2017,22309,21121,1188,5.3
36,19,Clinton,2017,36102,34207,1895,5.2
36,21,Columbia,2017,31077,29904,1173,3.8
36,23,Cortland,2017,22930,21609,1321,5.8
36,25,Delaware,2017,18943,17900,1043,5.5
36,27,Dutchess,2017,143179,137070,6109,4.3
36,29,Erie,2017,443713,420911,22802,5.1
36,31,Essex,2017,17147,16212,935,5.5
36,33,Franklin,2017,19726,18537,1189,6.0
36,35,Fulton,2017,23134,21806,1328,5.7
36,37,Genesee,2017,29501,28097,1404,4.8
36,39,Greene,2017,20488,19425,1063,5.2
36,41,Hamilton,2017,2314,2143,171,7.4
36,43,Herkimer,2017,27993,26404,1589,5.7
36,45,Jefferson,2017,44946,42032,2914,6.5
36,47,Kings,2017,1210854,1154942,55912,4.6
36,49,Lewis,2017,11587,10821,766,6.6
36,51,Livingston,2017,30608,29074,1534,5.0
36,53,Madison,2017,32353,30576,1777,5.5
36,55,Monroe,2017,361593,343851,17742,4.9
36,57,Montgomery,2017,22501,21220,1281,5.7
36,59,Nassau,2017,705684,677032,28652,4.1
36,61,New York,2017,917941,881150,36791,4.0
36,63,Niagara,2017,99339,93214,6125,6.2
36,65,Oneida,2017,101666,96606,5060,5.0
36,67,Onondaga,2017,219498,209278,10220,4.7
36,69,Ontario,2017,54782,52335,2447,4.5
36,71,Orange,2017,180525,172362,8163,4.5
36,73,Orleans,2017,17504,16476,1028,5.9
36,75,Oswego,2017,52655,49262,3393,6.4
36,77,Otsego,2017,27993,26596,1397,5.0
36,79,Putnam,2017,50809,48684,2125,4.2
36,81,Queens,2017,1160804,1114985,45819,3.9
36,83,Rensselaer,2017,80897,77322,3575,4.4
36,85,Richmond,2017,220553,210468,10085,4.6
36,87,Rockland,2017,153365,146742,6623,4.3
36,89,St. Lawrence,2017,43269,40393,2876,6.6
36,91,Saratoga,2017,118163,113489,4674,4.0
36,93,Schenectady,2017,75825,72444,3381,4.5
36,95,Schoharie,2017,14650,13851,799,5.5
36,97,Schuyler,2017,8203,7729,474,5.8
36,99,Seneca,2017,16057,15329,728,4.5
36,101,Steuben,2017,42624,40193,2431,5.7
36,103,Suffolk,2017,775835,741257,34578,4.5
36,105,Sullivan,2017,34263,32591,1672,4.9
36,107,Tioga,2017,22722,21560,1162,5.1
36,109,Tompkins,2017,49860,47707,2153,4.3
36,111,Ulster,2017,87953,83969,3984,4.5
36,113,Warren,2017,31812,30140,1672,5.3
36,115,Washington,2017,28098,26798,1300,4.6
36,117,Wayne,2017,43615,41457,2158,4.9
36,119,Westchester,2017,480281,458710,21571,4.5
36,121,Wyoming,2017,17889,16887,1002,5.6
36,123,Yates,2017,11611,11104,507,4.4
37,1,Alamance,2017,79821,76418,3403,4.3
37,3,Alexander,2017,17946,17291,655,3.6
37,5,Alleghany,2017,4356,4135,221,5.1
37,7,Anson,2017,10510,9966,544,5.2
37,9,Ashe,2017,12643,12122,521,4.1
37,11,Avery,2017,7626,7299,327,4.3
37,13,Beaufort,2017,19961,18950,1011,5.1
37,15,Bertie,2017,8068,7590,478,5.9
37,17,Bladen,2017,14401,13559,842,5.8
37,19,Brunswick,2017,51261,48352,2909,5.7
37,21,Buncombe,2017,136382,131668,4714,3.5
37,23,Burke,2017,40435,38736,1699,4.2
37,25,Cabarrus,2017,104533,100188,4345,4.2
37,27,Caldwell,2017,36458,34829,1629,4.5
37,29,Camden,2017,4720,4514,206,4.4
37,31,Carteret,2017,31882,30464,1418,4.4
37,33,Caswell,2017,9753,9292,461,4.7
37,35,Catawba,2017,78531,75261,3270,4.2
37,37,Chatham,2017,34112,32786,1326,3.9
37,39,Cherokee,2017,11158,10601,557,5.0
37,41,Chowan,2017,5592,5295,297,5.3
37,43,Clay,2017,3946,3749,197,5.0
37,45,Cleveland,2017,47415,45216,2199,4.6
37,47,Columbus,2017,22255,21036,1219,5.5
37,49,Craven,2017,41691,39752,1939,4.7
37,51,Cumberland,2017,127517,120173,7344,5.8
37,53,Currituck,2017,13560,12969,591,4.4
37,55,Dare,2017,20081,18898,1183,5.9
37,57,Davidson,2017,79503,76081,3422,4.3
37,59,Davie,2017,20313,19501,812,4.0
37,61,Duplin,2017,25416,24177,1239,4.9
37,63,Durham,2017,165001,158303,6698,4.1
37,65,Edgecombe,2017,21912,20221,1691,7.7
37,67,Forsyth,2017,184510,176426,8084,4.4
37,69,Franklin,2017,30064,28657,1407,4.7
37,71,Gaston,2017,107635,102647,4988,4.6
37,73,Gates,2017,5272,5038,234,4.4
37,75,Graham,2017,3124,2911,213,6.8
37,77,Granville,2017,29976,28829,1147,3.8
37,79,Greene,2017,9536,9112,424,4.4
37,81,Guilford,2017,260400,247975,12425,4.8
37,83,Halifax,2017,20537,19038,1499,7.3
37,85,Harnett,2017,52496,49808,2688,5.1
37,87,Haywood,2017,28904,27738,1166,4.0
37,89,Henderson,2017,53417,51377,2040,3.8
37,91,Hertford,2017,9173,8644,529,5.8
37,93,Hoke,2017,19888,18738,1150,5.8
37,95,Hyde,2017,2096,1920,176,8.4
37,97,Iredell,2017,86366,82687,3679,4.3
37,99,Jackson,2017,19037,18125,912,4.8
37,101,Johnston,2017,94257,90334,3923,4.2
37,103,Jones,2017,4401,4205,196,4.5
37,105,Lee,2017,26535,25174,1361,5.1
37,107,Lenoir,2017,27970,26721,1249,4.5
37,109,Lincoln,2017,41848,40157,1691,4.0
37,111,McDowell,2017,20940,20089,851,4.1
37,113,Macon,2017,15207,14499,708,4.7
37,115,Madison,2017,9953,9528,425,4.3
37,117,Martin,2017,9575,9036,539,5.6
37,119,Mecklenburg,2017,599636,573746,25890,4.3
37,121,Mitchell,2017,6087,5770,317,5.2
37,123,Montgomery,2017,11733,11198,535,4.6
37,125,Moore,2017,39810,38023,1787,4.5
37,127,Nash,2017,43601,40968,2633,6.0
37,129,New Hanover,2017,119218,114285,4933,4.1
37,131,Northampton,2017,7732,7249,483,6.2
37,133,Onslow,2017,64456,61066,3390,5.3
37,135,Orange,2017,76541,73641,2900,3.8
37,137,Pamlico,2017,5380,5131,249,4.6
37,139,Pasquotank,2017,17329,16368,961,5.5
37,141,Pender,2017,27928,26633,1295,4.6
37,143,Perquimans,2017,5130,4840,290,5.7
37,145,Person,2017,17997,17156,841,4.7
37,147,Pitt,2017,89162,84809,4353,4.9
37,149,Polk,2017,8903,8532,371,4.2
37,151,Randolph,2017,66520,63603,2917,4.4
37,153,Richmond,2017,16687,15681,1006,6.0
37,155,Robeson,2017,50112,46841,3271,6.5
37,157,Rockingham,2017,40503,38396,2107,5.2
37,159,Rowan,2017,64649,61601,3048,4.7
37,161,Rutherford,2017,24553,23060,1493,6.1
37,163,Sampson,2017,29357,27957,1400,4.8
37,165,Scotland,2017,11487,10603,884,7.7
37,167,Stanly,2017,29723,28494,1229,4.1
37,169,Stokes,2017,21604,20686,918,4.2
37,171,Surry,2017,33554,32151,1403,4.2
37,173,Swain,2017,6834,6487,347,5.1
37,175,Transylvania,2017,14193,13580,613,4.3
37,177,Tyrrell,2017,1492,1378,114,7.6
37,179,Union,2017,118928,114149,4779,4.0
37,181,Vance,2017,17865,16753,1112,6.2
37,183,Wake,2017,572462,550037,22425,3.9
37,185,Warren,2017,6815,6348,467,6.9
37,187,Washington,2017,4764,4449,315,6.6
37,189,Watauga,2017,28525,27363,1162,4.1
37,191,Wayne,2017,53320,50630,2690,5.0
37,193,Wilkes,2017,30868,29550,1318,4.3
37,195,Wilson,2017,35914,33312,2602,7.2
37,197,Yadkin,2017,17666,16968,698,4.0
37,199,Yancey,2017,7415,7076,339,4.6
38,1,Adams,2017,1117,1089,28,2.5
38,3,Barnes,2017,5426,5273,153,2.8
38,5,Benson,2017,2392,2305,87,3.6
38,7,Billings,2017,441,427,14,3.2
38,9,Bottineau,2017,3113,3009,104,3.3
38,11,Bowman,2017,1756,1725,31,1.8
38,13,Burke,2017,1092,1058,34,3.1
38,15,Burleigh,2017,50516,49268,1248,2.5
38,17,Cass,2017,101966,99784,2182,2.1
38,19,Cavalier,2017,2058,2003,55,2.7
38,21,Dickey,2017,2509,2465,44,1.8
38,23,Divide,2017,1584,1558,26,1.6
38,25,Dunn,2017,3167,3098,69,2.2
38,27,Eddy,2017,1272,1211,61,4.8
38,29,Emmons,2017,1552,1489,63,4.1
38,31,Foster,2017,1658,1617,41,2.5
38,33,Golden Valley,2017,935,915,20,2.1
38,35,Grand Forks,2017,38996,38125,871,2.2
38,37,Grant,2017,1280,1242,38,3.0
38,39,Griggs,2017,1124,1091,33,2.9
38,41,Hettinger,2017,1477,1448,29,2.0
38,43,Kidder,2017,1364,1315,49,3.6
38,45,LaMoure,2017,2271,2227,44,1.9
38,47,Logan,2017,947,922,25,2.6
38,49,McHenry,2017,3294,3152,142,4.3
38,51,McIntosh,2017,1225,1193,32,2.6
38,53,McKenzie,2017,8160,7954,206,2.5
38,55,McLean,2017,5014,4854,160,3.2
38,57,Mercer,2017,4447,4266,181,4.1
38,59,Morton,2017,16643,16123,520,3.1
38,61,Mountrail,2017,7012,6866,146,2.1
38,63,Nelson,2017,1490,1443,47,3.2
38,65,Oliver,2017,913,875,38,4.2
38,67,Pembina,2017,3522,3373,149,4.2
38,69,Pierce,2017,1883,1822,61,3.2
38,71,Ramsey,2017,5866,5706,160,2.7
38,73,Ransom,2017,2816,2761,55,2.0
38,75,Renville,2017,1271,1238,33,2.6
38,77,Richland,2017,8818,8605,213,2.4
38,79,Rolette,2017,4834,4327,507,10.5
38,81,Sargent,2017,2384,2335,49,2.1
38,83,Sheridan,2017,733,700,33,4.5
38,85,Sioux,2017,1294,1245,49,3.8
38,87,Slope,2017,427,418,9,2.1
38,89,Stark,2017,17997,17504,493,2.7
38,91,Steele,2017,1057,1039,18,1.7
38,93,Stutsman,2017,10962,10700,262,2.4
38,95,Towner,2017,1246,1214,32,2.6
38,97,Traill,2017,4591,4477,114,2.5
38,99,Walsh,2017,5587,5397,190,3.4
38,101,Ward,2017,32560,31488,1072,3.3
38,103,Wells,2017,2143,2073,70,3.3
38,105,Williams,2017,22756,22177,579,2.5
39,1,Adams,2017,10937,10153,784,7.2
39,3,Allen,2017,48773,46344,2429,5.0
39,5,Ashland,2017,26334,25040,1294,4.9
39,7,Ashtabula,2017,44309,41699,2610,5.9
39,9,Athens,2017,28439,26719,1720,6.0
39,11,Auglaize,2017,24782,23868,914,3.7
39,13,Belmont,2017,30467,28539,1928,6.3
39,15,Brown,2017,19567,18449,1118,5.7
39,17,Butler,2017,193123,184571,8552,4.4
39,19,Carroll,2017,13295,12518,777,5.8
39,21,Champaign,2017,19981,19159,822,4.1
39,23,Clark,2017,63904,60809,3095,4.8
39,25,Clermont,2017,105642,101012,4630,4.4
39,27,Clinton,2017,17488,16531,957,5.5
39,29,Columbiana,2017,47850,45004,2846,5.9
39,31,Coshocton,2017,14730,13729,1001,6.8
39,33,Crawford,2017,18886,17802,1084,5.7
39,35,Cuyahoga,2017,616111,580686,35425,5.7
39,37,Darke,2017,26385,25279,1106,4.2
39,39,Defiance,2017,18466,17570,896,4.9
39,41,Delaware,2017,107516,103700,3816,3.5
39,43,Erie,2017,38271,35932,2339,6.1
39,45,Fairfield,2017,77374,74069,3305,4.3
39,47,Fayette,2017,14435,13825,610,4.2
39,49,Franklin,2017,685088,657313,27775,4.1
39,51,Fulton,2017,22544,21439,1105,4.9
39,53,Gallia,2017,12324,11510,814,6.6
39,55,Geauga,2017,49193,46879,2314,4.7
39,57,Greene,2017,82768,79248,3520,4.3
39,59,Guernsey,2017,19012,17868,1144,6.0
39,61,Hamilton,2017,411950,393927,18023,4.4
39,63,Hancock,2017,41743,40236,1507,3.6
39,65,Hardin,2017,14399,13688,711,4.9
39,67,Harrison,2017,7158,6731,427,6.0
39,69,Henry,2017,13569,12867,702,5.2
39,71,Highland,2017,17198,16176,1022,5.9
39,73,Hocking,2017,13122,12410,712,5.4
39,75,Holmes,2017,20870,20132,738,3.5
39,77,Huron,2017,28251,26443,1808,6.4
39,79,Jackson,2017,12936,12015,921,7.1
39,81,Jefferson,2017,27916,25867,2049,7.3
39,83,Knox,2017,31424,30013,1411,4.5
39,85,Lake,2017,126176,119786,6390,5.1
39,87,Lawrence,2017,24117,22687,1430,5.9
39,89,Licking,2017,89155,85392,3763,4.2
39,91,Logan,2017,23604,22643,961,4.1
39,93,Lorain,2017,153808,144483,9325,6.1
39,95,Lucas,2017,211112,198713,12399,5.9
39,97,Madison,2017,20673,19871,802,3.9
39,99,Mahoning,2017,105516,98277,7239,6.9
39,101,Marion,2017,28174,26754,1420,5.0
39,103,Medina,2017,97139,92627,4512,4.6
39,105,Meigs,2017,8998,8266,732,8.1
39,107,Mercer,2017,23585,22863,722,3.1
39,109,Miami,2017,53683,51408,2275,4.2
39,111,Monroe,2017,5176,4742,434,8.4
39,113,Montgomery,2017,252627,240315,12312,4.9
39,115,Morgan,2017,6722,6267,455,6.8
39,117,Morrow,2017,16797,15967,830,4.9
39,119,Muskingum,2017,39928,37669,2259,5.7
39,121,Noble,2017,4783,4439,344,7.2
39,123,Ottawa,2017,21284,19855,1429,6.7
39,125,Paulding,2017,8918,8525,393,4.4
39,127,Perry,2017,15950,14986,964,6.0
39,129,Pickaway,2017,26381,25154,1227,4.7
39,131,Pike,2017,10897,10138,759,7.0
39,133,Portage,2017,87775,83363,4412,5.0
39,135,Preble,2017,21261,20315,946,4.4
39,137,Putnam,2017,18951,18280,671,3.5
39,139,Richland,2017,53399,50492,2907,5.4
39,141,Ross,2017,34336,32581,1755,5.1
39,143,Sandusky,2017,31432,29947,1485,4.7
39,145,Scioto,2017,29705,27611,2094,7.0
39,147,Seneca,2017,27487,26188,1299,4.7
39,149,Shelby,2017,24113,23118,995,4.1
39,151,Stark,2017,187852,178086,9766,5.2
39,153,Summit,2017,274303,260426,13877,5.1
39,155,Trumbull,2017,89433,83012,6421,7.2
39,157,Tuscarawas,2017,45562,43281,2281,5.0
39,159,Union,2017,28485,27423,1062,3.7
39,161,Van Wert,2017,14553,13984,569,3.9
39,163,Vinton,2017,5479,5104,375,6.8
39,165,Warren,2017,116810,112013,4797,4.1
39,167,Washington,2017,27396,25688,1708,6.2
39,169,Wayne,2017,61884,59473,2411,3.9
39,171,Williams,2017,19068,18235,833,4.4
39,173,Wood,2017,70898,67788,3110,4.4
39,175,Wyandot,2017,12693,12225,468,3.7
40,1,Adair,2017,8216,7830,386,4.7
40,3,Alfalfa,2017,2955,2881,74,2.5
40,5,Atoka,2017,5180,4920,260,5.0
40,7,Beaver,2017,3034,2960,74,2.4
40,9,Beckham,2017,11286,10873,413,3.7
40,11,Blaine,2017,4618,4496,122,2.6
40,13,Bryan,2017,20366,19626,740,3.6
40,15,Caddo,2017,12361,11845,516,4.2
40,17,Canadian,2017,71021,68657,2364,3.3
40,19,Carter,2017,22431,21472,959,4.3
40,21,Cherokee,2017,19135,18159,976,5.1
40,23,Choctaw,2017,5712,5379,333,5.8
40,25,Cimarron,2017,1418,1386,32,2.3
40,27,Cleveland,2017,139666,135022,4644,3.3
40,29,Coal,2017,2269,2154,115,5.1
40,31,Comanche,2017,48871,46833,2038,4.2
40,33,Cotton,2017,2797,2690,107,3.8
40,35,Craig,2017,6086,5835,251,4.1
40,37,Creek,2017,31454,29967,1487,4.7
40,39,Custer,2017,15409,14938,471,3.1
40,41,Delaware,2017,18557,17785,772,4.2
40,43,Dewey,2017,2522,2453,69,2.7
40,45,Ellis,2017,2223,2156,67,3.0
40,47,Garfield,2017,27780,26765,1015,3.7
40,49,Garvin,2017,12620,12122,498,3.9
40,51,Grady,2017,26040,25042,998,3.8
40,53,Grant,2017,2887,2817,70,2.4
40,55,Greer,2017,2056,1954,102,5.0
40,57,Harmon,2017,1272,1226,46,3.6
40,59,Harper,2017,1873,1819,54,2.9
40,61,Haskell,2017,4356,4084,272,6.2
40,63,Hughes,2017,5397,5112,285,5.3
40,65,Jackson,2017,10836,10448,388,3.6
40,67,Jefferson,2017,2491,2360,131,5.3
40,69,Johnston,2017,5034,4845,189,3.8
40,71,Kay,2017,19185,18202,983,5.1
40,73,Kingfisher,2017,8708,8480,228,2.6
40,75,Kiowa,2017,3921,3726,195,5.0
40,77,Latimer,2017,3385,3145,240,7.1
40,79,Le Flore,2017,19314,18255,1059,5.5
40,81,Lincoln,2017,15756,15106,650,4.1
40,83,Logan,2017,21649,20894,755,3.5
40,85,Love,2017,6579,6394,185,2.8
40,87,McClain,2017,19214,18572,642,3.3
40,89,McCurtain,2017,14724,13847,877,6.0
40,91,McIntosh,2017,6924,6418,506,7.3
40,93,Major,2017,4017,3897,120,3.0
40,95,Marshall,2017,6565,6275,290,4.4
40,97,Mayes,2017,19211,18350,861,4.5
40,99,Murray,2017,6394,6169,225,3.5
40,101,Muskogee,2017,29505,28083,1422,4.8
40,103,Noble,2017,5754,5575,179,3.1
40,105,Nowata,2017,4607,4371,236,5.1
40,107,Okfuskee,2017,4452,4198,254,5.7
40,109,Oklahoma,2017,377491,363206,14285,3.8
40,111,Okmulgee,2017,15904,14955,949,6.0
40,113,Osage,2017,20727,19714,1013,4.9
40,115,Ottawa,2017,14468,13873,595,4.1
40,117,Pawnee,2017,7391,7017,374,5.1
40,119,Payne,2017,38854,37543,1311,3.4
40,121,Pittsburg,2017,17735,16851,884,5.0
40,123,Pontotoc,2017,18568,17906,662,3.6
40,125,Pottawatomie,2017,32997,31708,1289,3.9
40,127,Pushmataha,2017,4722,4445,277,5.9
40,129,Roger Mills,2017,1881,1823,58,3.1
40,131,Rogers,2017,44557,42699,1858,4.2
40,133,Seminole,2017,9429,8921,508,5.4
40,135,Sequoyah,2017,16554,15696,858,5.2
40,137,Stephens,2017,18159,17096,1063,5.9
40,139,Texas,2017,9361,9085,276,2.9
40,141,Tillman,2017,3266,3135,131,4.0
40,143,Tulsa,2017,319301,306400,12901,4.0
40,145,Wagoner,2017,37009,35477,1532,4.1
40,147,Washington,2017,23205,22214,991,4.3
40,149,Washita,2017,5364,5140,224,4.2
40,151,Woods,2017,4921,4800,121,2.5
40,153,Woodward,2017,9431,9062,369,3.9
41,1,Baker,2017,6977,6602,375,5.4
41,3,Benton,2017,48106,46569,1537,3.2
41,5,Clackamas,2017,216622,208678,7944,3.7
41,7,Clatsop,2017,19145,18370,775,4.0
41,9,Columbia,2017,24155,22932,1223,5.1
41,11,Coos,2017,26353,24927,1426,5.4
41,13,Crook,2017,9378,8793,585,6.2
41,15,Curry,2017,8928,8395,533,6.0
41,17,Deschutes,2017,92876,89000,3876,4.2
41,19,Douglas,2017,46030,43607,2423,5.3
41,21,Gilliam,2017,852,816,36,4.2
41,23,Grant,2017,3118,2907,211,6.8
41,25,Harney,2017,3395,3186,209,6.2
41,27,Hood River,2017,14290,13786,504,3.5
41,29,Jackson,2017,102833,98038,4795,4.7
41,31,Jefferson,2017,9933,9385,548,5.5
41,33,Josephine,2017,35028,33181,1847,5.3
41,35,Klamath,2017,29423,27711,1712,5.8
41,37,Lake,2017,3495,3299,196,5.6
41,39,Lane,2017,180766,172855,7911,4.4
41,41,Lincoln,2017,21011,20023,988,4.7
41,43,Linn,2017,57577,54886,2691,4.7
41,45,Malheur,2017,12496,11925,571,4.6
41,47,Marion,2017,159480,152677,6803,4.3
41,49,Morrow,2017,5733,5484,249,4.3
41,51,Multnomah,2017,451727,435571,16156,3.6
41,53,Polk,2017,39162,37488,1674,4.3
41,55,Sherman,2017,895,853,42,4.7
41,57,Tillamook,2017,11703,11213,490,4.2
41,59,Umatilla,2017,36555,34820,1735,4.7
41,61,Union,2017,11923,11306,617,5.2
41,63,Wallowa,2017,3303,3120,183,5.5
41,65,Wasco,2017,13749,13186,563,4.1
41,67,Washington,2017,319253,308269,10984,3.4
41,69,Wheeler,2017,730,702,28,3.8
41,71,Yamhill,2017,53804,51814,1990,3.7
42,1,Adams,2017,55331,53269,2062,3.7
42,3,Allegheny,2017,645603,614522,31081,4.8
42,5,Armstrong,2017,32322,30299,2023,6.3
42,7,Beaver,2017,84406,79650,4756,5.6
42,9,Bedford,2017,23748,22501,1247,5.3
42,11,Berks,2017,212331,202393,9938,4.7
42,13,Blair,2017,60105,57158,2947,4.9
42,15,Bradford,2017,29285,27757,1528,5.2
42,17,Bucks,2017,340117,325430,14687,4.3
42,19,Butler,2017,98580,94003,4577,4.6
42,21,Cambria,2017,59628,55975,3653,6.1
42,23,Cameron,2017,2194,2041,153,7.0
42,25,Carbon,2017,31478,29700,1778,5.6
42,27,Centre,2017,79022,76058,2964,3.8
42,29,Chester,2017,280801,270536,10265,3.7
42,31,Clarion,2017,17715,16701,1014,5.7
42,33,Clearfield,2017,35845,33691,2154,6.0
42,35,Clinton,2017,18343,17202,1141,6.2
42,37,Columbia,2017,33695,31921,1774,5.3
42,39,Crawford,2017,39419,37220,2199,5.6
42,41,Cumberland,2017,130121,125082,5039,3.9
42,43,Dauphin,2017,142287,135768,6519,4.6
42,45,Delaware,2017,294869,281315,13554,4.6
42,47,Elk,2017,16004,15219,785,4.9
42,49,Erie,2017,130659,123019,7640,5.8
42,51,Fayette,2017,57386,53348,4038,7.0
42,53,Forest,2017,1833,1709,124,6.8
42,55,Franklin,2017,76543,73084,3459,4.5
42,57,Fulton,2017,7245,6871,374,5.2
42,59,Greene,2017,16787,15782,1005,6.0
42,61,Huntingdon,2017,19788,18586,1202,6.1
42,63,Indiana,2017,39221,36900,2321,5.9
42,65,Jefferson,2017,20557,19395,1162,5.7
42,67,Juniata,2017,12370,11793,577,4.7
42,69,Lackawanna,2017,105883,100356,5527,5.2
42,71,Lancaster,2017,278795,267902,10893,3.9
42,73,Lawrence,2017,40615,38117,2498,6.2
42,75,Lebanon,2017,70694,67725,2969,4.2
42,77,Lehigh,2017,189581,179921,9660,5.1
42,79,Luzerne,2017,158501,149023,9478,6.0
42,81,Lycoming,2017,57817,54535,3282,5.7
42,83,McKean,2017,18158,17033,1125,6.2
42,85,Mercer,2017,50661,47851,2810,5.5
42,87,Mifflin,2017,20664,19548,1116,5.4
42,89,Monroe,2017,82192,77296,4896,6.0
42,91,Montgomery,2017,447870,430296,17574,3.9
42,93,Montour,2017,9097,8741,356,3.9
42,95,Northampton,2017,158545,150643,7902,5.0
42,97,Northumberland,2017,43642,41132,2510,5.8
42,99,Perry,2017,24275,23219,1056,4.4
42,101,Philadelphia/city,2017,704810,660066,44744,6.3
42,103,Pike,2017,24755,23264,1491,6.0
42,105,Potter,2017,7265,6785,480,6.6
42,107,Schuylkill,2017,66241,62311,3930,5.9
42,109,Snyder,2017,20702,19775,927,4.5
42,111,Somerset,2017,33622,31557,2065,6.1
42,113,Sullivan,2017,2689,2526,163,6.1
42,115,Susquehanna,2017,20583,19594,989,4.8
42,117,Tioga,2017,19106,17949,1157,6.1
42,119,Union,2017,19660,18789,871,4.4
42,121,Venango,2017,22947,21526,1421,6.2
42,123,Warren,2017,19291,18257,1034,5.4
42,125,Washington,2017,106290,100641,5649,5.3
42,127,Wayne,2017,22401,21239,1162,5.2
42,129,Westmoreland,2017,180678,171172,9506,5.3
42,131,Wyoming,2017,13839,13098,741,5.4
42,133,York,2017,234490,224076,10414,4.4
44,1,Bristol,2017,26079,25067,1012,3.9
44,3,Kent,2017,90483,86739,3744,4.1
44,5,Newport,2017,44637,42879,1758,3.9
44,7,Providence,2017,325587,309860,15727,4.8
44,9,Washington,2017,69115,66317,2798,4.0
45,1,Abbeville,2017,9910,9462,448,4.5
45,3,Aiken,2017,73618,70651,2967,4.0
45,5,Allendale,2017,2687,2505,182,6.8
45,7,Anderson,2017,88946,85516,3430,3.9
45,9,Bamberg,2017,5109,4734,375,7.3
45,11,Barnwell,2017,7966,7494,472,5.9
45,13,Beaufort,2017,73913,70955,2958,4.0
45,15,Berkeley,2017,99320,95591,3729,3.8
45,17,Calhoun,2017,6701,6357,344,5.1
45,19,Charleston,2017,202633,195661,6972,3.4
45,21,Cherokee,2017,23689,22534,1155,4.9
45,23,Chester,2017,13232,12436,796,6.0
45,25,Chesterfield,2017,21373,20465,908,4.2
45,27,Clarendon,2017,12309,11587,722,5.9
45,29,Colleton,2017,16512,15733,779,4.7
45,31,Darlington,2017,29730,28192,1538,5.2
45,33,Dillon,2017,12382,11686,696,5.6
45,35,Dorchester,2017,73776,70981,2795,3.8
45,37,Edgefield,2017,10524,10052,472,4.5
45,39,Fairfield,2017,9864,9150,714,7.2
45,41,Florence,2017,65040,62147,2893,4.4
45,43,Georgetown,2017,24741,23382,1359,5.5
45,45,Greenville,2017,247120,238242,8878,3.6
45,47,Greenwood,2017,30564,29207,1357,4.4
45,49,Hampton,2017,8069,7716,353,4.4
45,51,Horry,2017,142854,135804,7050,4.9
45,53,Jasper,2017,11958,11523,435,3.6
45,55,Kershaw,2017,29088,27803,1285,4.4
45,57,Lancaster,2017,39167,37375,1792,4.6
45,59,Laurens,2017,29685,28405,1280,4.3
45,61,Lee,2017,6360,5987,373,5.9
45,63,Lexington,2017,147836,142611,5225,3.5
45,65,McCormick,2017,3350,3201,149,4.4
45,67,Marion,2017,12388,11488,900,7.3
45,69,Marlboro,2017,9092,8507,585,6.4
45,71,Newberry,2017,18302,17551,751,4.1
45,73,Oconee,2017,33894,32437,1457,4.3
45,75,Orangeburg,2017,34417,31993,2424,7.0
45,77,Pickens,2017,55926,53657,2269,4.1
45,79,Richland,2017,197899,189618,8281,4.2
45,81,Saluda,2017,8827,8487,340,3.9
45,83,Spartanburg,2017,145765,140007,5758,4.0
45,85,Sumter,2017,43743,41503,2240,5.1
45,87,Union,2017,11457,10849,608,5.3
45,89,Williamsburg,2017,12077,11322,755,6.3
45,91,York,2017,133268,128038,5230,3.9
46,3,Aurora,2017,1525,1484,41,2.7
46,5,Beadle,2017,9405,9154,251,2.7
46,7,Bennett,2017,1114,1068,46,4.1
46,9,Bon Homme,2017,2920,2839,81,2.8
46,11,Brookings,2017,18850,18295,555,2.9
46,13,Brown,2017,20976,20387,589,2.8
46,15,Brule,2017,2483,2413,70,2.8
46,17,Buffalo,2017,708,658,50,7.1
46,19,Butte,2017,5033,4865,168,3.3
46,21,Campbell,2017,834,807,27,3.2
46,23,Charles Mix,2017,3892,3758,134,3.4
46,25,Clark,2017,1888,1806,82,4.3
46,27,Clay,2017,7135,6916,219,3.1
46,29,Codington,2017,15242,14763,479,3.1
46,31,Corson,2017,1424,1368,56,3.9
46,33,Custer,2017,4040,3877,163,4.0
46,35,Davison,2017,11047,10747,300,2.7
46,37,Day,2017,2830,2722,108,3.8
46,39,Deuel,2017,2199,2098,101,4.6
46,41,Dewey,2017,2245,2031,214,9.5
46,43,Douglas,2017,1599,1554,45,2.8
46,45,Edmunds,2017,2117,2061,56,2.6
46,47,Fall River,2017,2983,2870,113,3.8
46,49,Faulk,2017,1102,1070,32,2.9
46,51,Grant,2017,4461,4313,148,3.3
46,53,Gregory,2017,2056,1988,68,3.3
46,55,Haakon,2017,1105,1076,29,2.6
46,57,Hamlin,2017,3155,3047,108,3.4
46,59,Hand,2017,1827,1785,42,2.3
46,61,Hanson,2017,1774,1706,68,3.8
46,63,Harding,2017,727,707,20,2.8
46,65,Hughes,2017,10036,9776,260,2.6
46,67,Hutchinson,2017,3617,3513,104,2.9
46,69,Hyde,2017,685,665,20,2.9
46,71,Jackson,2017,1325,1254,71,5.4
46,73,Jerauld,2017,1142,1116,26,2.3
46,75,Jones,2017,562,547,15,2.7
46,77,Kingsbury,2017,2683,2603,80,3.0
46,79,Lake,2017,6511,6276,235,3.6
46,81,Lawrence,2017,13067,12665,402,3.1
46,83,Lincoln,2017,33013,32246,767,2.3
46,85,Lyman,2017,1748,1666,82,4.7
46,87,McCook,2017,3065,2984,81,2.6
46,89,McPherson,2017,1051,1017,34,3.2
46,91,Marshall,2017,2402,2300,102,4.2
46,93,Meade,2017,13982,13533,449,3.2
46,95,Mellette,2017,765,730,35,4.6
46,97,Miner,2017,1197,1164,33,2.8
46,99,Minnehaha,2017,109469,106549,2920,2.7
46,101,Moody,2017,3989,3850,139,3.5
46,102,Oglala Lakota,2017,3619,3224,395,10.9
46,103,Pennington,2017,55798,54027,1771,3.2
46,105,Perkins,2017,1595,1552,43,2.7
46,107,Potter,2017,1124,1089,35,3.1
46,109,Roberts,2017,4826,4607,219,4.5
46,111,Sanborn,2017,1177,1138,39,3.3
46,115,Spink,2017,3236,3132,104,3.2
46,117,Stanley,2017,1869,1810,59,3.2
46,119,Sully,2017,836,811,25,3.0
46,121,Todd,2017,3138,2942,196,6.2
46,123,Tripp,2017,3042,2961,81,2.7
46,125,Turner,2017,4680,4538,142,3.0
46,127,Union,2017,8053,7779,274,3.4
46,129,Walworth,2017,2240,2132,108,4.8
46,135,Yankton,2017,11626,11308,318,2.7
46,137,Ziebach,2017,939,892,47,5.0
47,1,Anderson,2017,33815,32486,1329,3.9
47,3,Bedford,2017,20492,19686,806,3.9
47,5,Benton,2017,6706,6345,361,5.4
47,7,Bledsoe,2017,4287,4036,251,5.9
47,9,Blount,2017,61508,59346,2162,3.5
47,11,Bradley,2017,50764,48922,1842,3.6
47,13,Campbell,2017,14590,13832,758,5.2
47,15,Cannon,2017,6187,5968,219,3.5
47,17,Carroll,2017,11911,11299,612,5.1
47,19,Carter,2017,23830,22747,1083,4.5
47,21,Cheatham,2017,20807,20171,636,3.1
47,23,Chester,2017,8317,7987,330,4.0
47,25,Claiborne,2017,12683,12085,598,4.7
47,27,Clay,2017,3027,2872,155,5.1
47,29,Cocke,2017,14574,13810,764,5.2
47,31,Coffee,2017,24899,23989,910,3.7
47,33,Crockett,2017,6946,6659,287,4.1
47,35,Cumberland,2017,23344,22258,1086,4.7
47,37,Davidson,2017,383948,373231,10717,2.8
47,39,Decatur,2017,4660,4418,242,5.2
47,41,DeKalb,2017,7647,7280,367,4.8
47,43,Dickson,2017,25479,24626,853,3.3
47,45,Dyer,2017,16058,15281,777,4.8
47,47,Fayette,2017,18550,17809,741,4.0
47,49,Fentress,2017,7074,6754,320,4.5
47,51,Franklin,2017,19798,19050,748,3.8
47,53,Gibson,2017,21233,20262,971,4.6
47,55,Giles,2017,15510,14982,528,3.4
47,57,Grainger,2017,9301,8906,395,4.2
47,59,Greene,2017,30284,28903,1381,4.6
47,61,Grundy,2017,4819,4578,241,5.0
47,63,Hamblen,2017,27239,26139,1100,4.0
47,65,Hamilton,2017,176207,169785,6422,3.6
47,67,Hancock,2017,2041,1923,118,5.8
47,69,Hardeman,2017,9194,8716,478,5.2
47,71,Hardin,2017,10374,9885,489,4.7
47,73,Hawkins,2017,23617,22612,1005,4.3
47,75,Haywood,2017,7780,7375,405,5.2
47,77,Henderson,2017,11865,11255,610,5.1
47,79,Henry,2017,13947,13314,633,4.5
47,81,Hickman,2017,10816,10445,371,3.4
47,83,Houston,2017,3194,3008,186,5.8
47,85,Humphreys,2017,8773,8393,380,4.3
47,87,Jackson,2017,4587,4342,245,5.3
47,89,Jefferson,2017,23851,22887,964,4.0
47,91,Johnson,2017,7579,7282,297,3.9
47,93,Knox,2017,236943,229432,7511,3.2
47,95,Lake,2017,1837,1734,103,5.6
47,97,Lauderdale,2017,9380,8839,541,5.8
47,99,Lawrence,2017,17748,16969,779,4.4
47,101,Lewis,2017,4935,4710,225,4.6
47,103,Lincoln,2017,16255,15725,530,3.3
47,105,Loudon,2017,22595,21764,831,3.7
47,107,McMinn,2017,22620,21631,989,4.4
47,109,McNairy,2017,8524,8044,480,5.6
47,111,Macon,2017,10687,10321,366,3.4
47,113,Madison,2017,47984,46099,1885,3.9
47,115,Marion,2017,12017,11433,584,4.9
47,117,Marshall,2017,15060,14535,525,3.5
47,119,Maury,2017,45925,44436,1489,3.2
47,121,Meigs,2017,4988,4727,261,5.2
47,123,Monroe,2017,19609,18822,787,4.0
47,125,Montgomery,2017,81814,78470,3344,4.1
47,127,Moore,2017,3473,3365,108,3.1
47,129,Morgan,2017,7786,7405,381,4.9
47,131,Obion,2017,12191,11522,669,5.5
47,133,Overton,2017,9506,9113,393,4.1
47,135,Perry,2017,3231,3075,156,4.8
47,137,Pickett,2017,2444,2336,108,4.4
47,139,Polk,2017,7375,7041,334,4.5
47,141,Putnam,2017,33921,32630,1291,3.8
47,143,Rhea,2017,13203,12348,855,6.5
47,145,Roane,2017,22883,21875,1008,4.4
47,147,Robertson,2017,35900,34675,1225,3.4
47,149,Rutherford,2017,171238,166259,4979,2.9
47,151,Scott,2017,8151,7736,415,5.1
47,153,Sequatchie,2017,5949,5649,300,5.0
47,155,Sevier,2017,52052,49959,2093,4.0
47,157,Shelby,2017,436408,417469,18939,4.3
47,159,Smith,2017,8898,8579,319,3.6
47,161,Stewart,2017,5174,4896,278,5.4
47,163,Sullivan,2017,69846,67031,2815,4.0
47,165,Sumner,2017,95611,92756,2855,3.0
47,167,Tipton,2017,27542,26325,1217,4.4
47,169,Trousdale,2017,4740,4576,164,3.5
47,171,Unicoi,2017,7037,6659,378,5.4
47,173,Union,2017,7363,7040,323,4.4
47,175,Van Buren,2017,2085,1996,89,4.3
47,177,Warren,2017,17121,16446,675,3.9
47,179,Washington,2017,59393,57155,2238,3.8
47,181,Wayne,2017,6111,5790,321,5.3
47,183,Weakley,2017,15734,14970,764,4.9
47,185,White,2017,11879,11407,472,4.0
47,187,Williamson,2017,119346,116130,3216,2.7
47,189,Wilson,2017,70831,68730,2101,3.0
48,1,Anderson,2017,23255,22403,852,3.7
48,3,Andrews,2017,8999,8720,279,3.1
48,5,Angelina,2017,36645,34769,1876,5.1
48,7,Aransas,2017,10332,9624,708,6.9
48,9,Archer,2017,4141,4001,140,3.4
48,11,Armstrong,2017,918,894,24,2.6
48,13,Atascosa,2017,20939,20042,897,4.3
48,15,Austin,2017,13803,13191,612,4.4
48,17,Bailey,2017,2661,2546,115,4.3
48,19,Bandera,2017,9738,9384,354,3.6
48,21,Bastrop,2017,40188,38737,1451,3.6
48,23,Baylor,2017,1588,1534,54,3.4
48,25,Bee,2017,9970,9321,649,6.5
48,27,Bell,2017,142097,136005,6092,4.3
48,29,Bexar,2017,924065,891138,32927,3.6
48,31,Blanco,2017,6227,6054,173,2.8
48,33,Borden,2017,323,311,12,3.7
48,35,Bosque,2017,8195,7866,329,4.0
48,37,Bowie,2017,39271,37461,1810,4.6
48,39,Brazoria,2017,173264,164010,9254,5.3
48,41,Brazos,2017,113012,109505,3507,3.1
48,43,Brewster,2017,3967,3827,140,3.5
48,45,Briscoe,2017,554,530,24,4.3
48,47,Brooks,2017,2433,2231,202,8.3
48,49,Brown,2017,16088,15461,627,3.9
48,51,Burleson,2017,7991,7653,338,4.2
48,53,Burnet,2017,22269,21557,712,3.2
48,55,Caldwell,2017,18506,17776,730,3.9
48,57,Calhoun,2017,10496,9886,610,5.8
48,59,Callahan,2017,5910,5694,216,3.7
48,61,Cameron,2017,166255,154636,11619,7.0
48,63,Camp,2017,5027,4741,286,5.7
48,65,Carson,2017,3029,2931,98,3.2
48,67,Cass,2017,12193,11462,731,6.0
48,69,Castro,2017,3393,3280,113,3.3
48,71,Chambers,2017,18922,17684,1238,6.5
48,73,Cherokee,2017,20777,19828,949,4.6
48,75,Childress,2017,2908,2822,86,3.0
48,77,Clay,2017,4903,4729,174,3.5
48,79,Cochran,2017,1133,1081,52,4.6
48,81,Coke,2017,1400,1348,52,3.7
48,83,Coleman,2017,3067,2929,138,4.5
48,85,Collin,2017,532035,513526,18509,3.5
48,87,Collingsworth,2017,1167,1125,42,3.6
48,89,Colorado,2017,9746,9354,392,4.0
48,91,Comal,2017,68780,66452,2328,3.4
48,93,Comanche,2017,5304,5107,197,3.7
48,95,Concho,2017,1213,1162,51,4.2
48,97,Cooke,2017,18850,18167,683,3.6
48,99,Coryell,2017,24396,23321,1075,4.4
48,101,Cottle,2017,520,498,22,4.2
48,103,Crane,2017,1593,1509,84,5.3
48,105,Crockett,2017,1680,1611,69,4.1
48,107,Crosby,2017,2547,2439,108,4.2
48,109,Culberson,2017,923,889,34,3.7
48,111,Dallam,2017,4058,3970,88,2.2
48,113,Dallas,2017,1326734,1274361,52373,3.9
48,115,Dawson,2017,4630,4404,226,4.9
48,117,Deaf Smith,2017,8348,8092,256,3.1
48,119,Delta,2017,2547,2461,86,3.4
48,121,Denton,2017,471075,455245,15830,3.4
48,123,DeWitt,2017,9582,9159,423,4.4
48,125,Dickens,2017,680,647,33,4.9
48,127,Dimmit,2017,6488,6158,330,5.1
48,129,Donley,2017,1504,1449,55,3.7
48,131,Duval,2017,4802,4431,371,7.7
48,133,Eastland,2017,7941,7599,342,4.3
48,135,Ector,2017,78553,75309,3244,4.1
48,137,Edwards,2017,905,876,29,3.2
48,139,Ellis,2017,87784,84716,3068,3.5
48,141,El Paso,2017,354118,337646,16472,4.7
48,143,Erath,2017,20683,19972,711,3.4
48,145,Falls,2017,6647,6364,283,4.3
48,147,Fannin,2017,15949,15413,536,3.4
48,149,Fayette,2017,12575,12171,404,3.2
48,151,Fisher,2017,1703,1642,61,3.6
48,153,Floyd,2017,2701,2553,148,5.5
48,155,Foard,2017,594,573,21,3.5
48,157,Fort Bend,2017,375587,358014,17573,4.7
48,159,Franklin,2017,4543,4331,212,4.7
48,161,Freestone,2017,6755,6322,433,6.4
48,163,Frio,2017,9363,8992,371,4.0
48,165,Gaines,2017,9247,8964,283,3.1
48,167,Galveston,2017,161960,153389,8571,5.3
48,169,Garza,2017,2121,2050,71,3.3
48,171,Gillespie,2017,13132,12789,343,2.6
48,173,Glasscock,2017,709,690,19,2.7
48,175,Goliad,2017,3276,3114,162,4.9
48,177,Gonzales,2017,9371,9042,329,3.5
48,179,Gray,2017,8233,7798,435,5.3
48,181,Grayson,2017,61933,59721,2212,3.6
48,183,Gregg,2017,57399,54416,2983,5.2
48,185,Grimes,2017,10883,10297,586,5.4
48,187,Guadalupe,2017,78427,75794,2633,3.4
48,189,Hale,2017,12513,11868,645,5.2
48,191,Hall,2017,1130,1060,70,6.2
48,193,Hamilton,2017,3621,3477,144,4.0
48,195,Hansford,2017,2861,2788,73,2.6
48,197,Hardeman,2017,1658,1592,66,4.0
48,199,Hardin,2017,25302,23740,1562,6.2
48,201,Harris,2017,2265507,2149903,115604,5.1
48,203,Harrison,2017,29462,27913,1549,5.3
48,205,Hartley,2017,2940,2882,58,2.0
48,207,Haskell,2017,2437,2319,118,4.8
48,209,Hays,2017,110693,107183,3510,3.2
48,211,Hemphill,2017,2314,2256,58,2.5
48,213,Henderson,2017,35634,34136,1498,4.2
48,215,Hidalgo,2017,343003,317246,25757,7.5
48,217,Hill,2017,16166,15526,640,4.0
48,219,Hockley,2017,11260,10839,421,3.7
48,221,Hood,2017,25921,24823,1098,4.2
48,223,Hopkins,2017,17167,16545,622,3.6
48,225,Houston,2017,10385,9932,453,4.4
48,227,Howard,2017,13218,12651,567,4.3
48,229,Hudspeth,2017,1664,1567,97,5.8
48,231,Hunt,2017,41375,39714,1661,4.0
48,233,Hutchinson,2017,9397,8827,570,6.1
48,235,Irion,2017,757,733,24,3.2
48,237,Jack,2017,3952,3804,148,3.7
48,239,Jackson,2017,7372,7076,296,4.0
48,241,Jasper,2017,13449,12440,1009,7.5
48,243,Jeff Davis,2017,1066,1032,34,3.2
48,245,Jefferson,2017,107611,99628,7983,7.4
48,247,Jim Hogg,2017,1906,1766,140,7.3
48,249,Jim Wells,2017,16656,15384,1272,7.6
48,251,Johnson,2017,78073,75092,2981,3.8
48,253,Jones,2017,5649,5346,303,5.4
48,255,Karnes,2017,6446,6220,226,3.5
48,257,Kaufman,2017,60321,58168,2153,3.6
48,259,Kendall,2017,21090,20437,653,3.1
48,261,Kenedy,2017,241,233,8,3.3
48,263,Kent,2017,454,442,12,2.6
48,265,Kerr,2017,21332,20600,732,3.4
48,267,Kimble,2017,1890,1823,67,3.5
48,269,King,2017,165,159,6,3.6
48,271,Kinney,2017,1165,1100,65,5.6
48,273,Kleberg,2017,13396,12598,798,6.0
48,275,Knox,2017,1483,1424,59,4.0
48,277,Lamar,2017,23751,22748,1003,4.2
48,279,Lamb,2017,5191,4921,270,5.2
48,281,Lampasas,2017,9212,8865,347,3.8
48,283,La Salle,2017,4206,4051,155,3.7
48,285,Lavaca,2017,8733,8416,317,3.6
48,287,Lee,2017,9537,9221,316,3.3
48,289,Leon,2017,6188,5794,394,6.4
48,291,Liberty,2017,31982,29688,2294,7.2
48,293,Limestone,2017,8315,7849,466,5.6
48,295,Lipscomb,2017,1624,1572,52,3.2
48,297,Live Oak,2017,5416,5162,254,4.7
48,299,Llano,2017,8365,8044,321,3.8
48,301,Loving,2017,100,95,5,5.0
48,303,Lubbock,2017,155955,150960,4995,3.2
48,305,Lynn,2017,2773,2668,105,3.8
48,307,McCulloch,2017,3684,3553,131,3.6
48,309,McLennan,2017,118049,113439,4610,3.9
48,311,McMullen,2017,748,734,14,1.9
48,313,Madison,2017,4686,4463,223,4.8
48,315,Marion,2017,4337,4089,248,5.7
48,317,Martin,2017,2524,2442,82,3.2
48,319,Mason,2017,1813,1752,61,3.4
48,321,Matagorda,2017,16904,15664,1240,7.3
48,323,Maverick,2017,23930,21679,2251,9.4
48,325,Medina,2017,21277,20447,830,3.9
48,327,Menard,2017,806,767,39,4.8
48,329,Midland,2017,90736,88005,2731,3.0
48,331,Milam,2017,10094,9582,512,5.1
48,333,Mills,2017,1911,1843,68,3.6
48,335,Mitchell,2017,2498,2361,137,5.5
48,337,Montague,2017,9087,8721,366,4.0
48,339,Montgomery,2017,270174,258320,11854,4.4
48,341,Moore,2017,11068,10747,321,2.9
48,343,Morris,2017,4679,4274,405,8.7
48,345,Motley,2017,494,476,18,3.6
48,347,Nacogdoches,2017,28553,27332,1221,4.3
48,349,Navarro,2017,22814,21911,903,4.0
48,351,Newton,2017,5278,4854,424,8.0
48,353,Nolan,2017,6778,6503,275,4.1
48,355,Nueces,2017,167972,158821,9151,5.4
48,357,Ochiltree,2017,4522,4357,165,3.6
48,359,Oldham,2017,902,879,23,2.5
48,361,Orange,2017,37146,34560,2586,7.0
48,363,Palo Pinto,2017,13398,12845,553,4.1
48,365,Panola,2017,10406,9838,568,5.5
48,367,Parker,2017,63220,61016,2204,3.5
48,369,Parmer,2017,4918,4796,122,2.5
48,371,Pecos,2017,6269,5975,294,4.7
48,373,Polk,2017,17526,16451,1075,6.1
48,375,Potter,2017,55424,53630,1794,3.2
48,377,Presidio,2017,3043,2754,289,9.5
48,379,Rains,2017,5700,5494,206,3.6
48,381,Randall,2017,70898,68885,2013,2.8
48,383,Reagan,2017,1793,1724,69,3.8
48,385,Real,2017,1054,994,60,5.7
48,387,Red River,2017,5198,4924,274,5.3
48,389,Reeves,2017,6993,6742,251,3.6
48,391,Refugio,2017,3241,3059,182,5.6
48,393,Roberts,2017,441,424,17,3.9
48,395,Robertson,2017,7446,7092,354,4.8
48,397,Rockwall,2017,48964,47308,1656,3.4
48,399,Runnels,2017,4579,4409,170,3.7
48,401,Rusk,2017,22123,20992,1131,5.1
48,403,Sabine,2017,3574,3265,309,8.6
48,405,San Augustine,2017,2868,2652,216,7.5
48,407,San Jacinto,2017,11461,10802,659,5.7
48,409,San Patricio,2017,30565,28204,2361,7.7
48,411,San Saba,2017,2417,2339,78,3.2
48,413,Schleicher,2017,1334,1284,50,3.7
48,415,Scurry,2017,6986,6682,304,4.4
48,417,Shackelford,2017,1888,1832,56,3.0
48,419,Shelby,2017,10778,10218,560,5.2
48,421,Sherman,2017,1289,1249,40,3.1
48,423,Smith,2017,106021,101649,4372,4.1
48,425,Somervell,2017,4187,3995,192,4.6
48,427,Starr,2017,26116,23023,3093,11.8
48,429,Stephens,2017,4004,3821,183,4.6
48,431,Sterling,2017,593,571,22,3.7
48,433,Stonewall,2017,614,592,22,3.6
48,435,Sutton,2017,1507,1430,77,5.1
48,437,Swisher,2017,2691,2580,111,4.1
48,439,Tarrant,2017,1036145,997323,38822,3.7
48,441,Taylor,2017,64201,61918,2283,3.6
48,443,Terrell,2017,394,375,19,4.8
48,445,Terry,2017,5243,4978,265,5.1
48,447,Throckmorton,2017,691,661,30,4.3
48,449,Titus,2017,12948,12246,702,5.4
48,451,Tom Green,2017,54154,52153,2001,3.7
48,453,Travis,2017,698527,677081,21446,3.1
48,455,Trinity,2017,5376,5077,299,5.6
48,457,Tyler,2017,7073,6550,523,7.4
48,459,Upshur,2017,17717,16782,935,5.3
48,461,Upton,2017,1547,1489,58,3.7
48,463,Uvalde,2017,11702,11151,551,4.7
48,465,Val Verde,2017,20089,19061,1028,5.1
48,467,Van Zandt,2017,25382,24422,960,3.8
48,469,Victoria,2017,42943,40854,2089,4.9
48,471,Walker,2017,23685,22580,1105,4.7
48,473,Waller,2017,22381,21278,1103,4.9
48,475,Ward,2017,5585,5358,227,4.1
48,477,Washington,2017,14870,14239,631,4.2
48,479,Webb,2017,115099,110220,4879,4.2
48,481,Wharton,2017,21098,20144,954,4.5
48,483,Wheeler,2017,2352,2258,94,4.0
48,485,Wichita,2017,56068,53985,2083,3.7
48,487,Wilbarger,2017,4961,4728,233,4.7
48,489,Willacy,2017,6325,5623,702,11.1
48,491,Williamson,2017,290728,281162,9566,3.3
48,493,Wilson,2017,24179,23329,850,3.5
48,495,Winkler,2017,3258,3090,168,5.2
48,497,Wise,2017,30168,28951,1217,4.0
48,499,Wood,2017,17339,16522,817,4.7
48,501,Yoakum,2017,3822,3686,136,3.6
48,503,Young,2017,8074,7768,306,3.8
48,505,Zapata,2017,5390,4986,404,7.5
48,507,Zavala,2017,3733,3313,420,11.3
49,1,Beaver,2017,3036,2917,119,3.9
49,3,Box Elder,2017,25290,24491,799,3.2
49,5,Cache,2017,62541,60867,1674,2.7
49,7,Carbon,2017,8264,7860,404,4.9
49,9,Daggett,2017,429,408,21,4.9
49,11,Davis,2017,168380,163381,4999,3.0
49,13,Duchesne,2017,7960,7520,440,5.5
49,15,Emery,2017,4181,3974,207,5.0
49,17,Garfield,2017,2893,2682,211,7.3
49,19,Grand,2017,5923,5618,305,5.1
49,21,Iron,2017,22208,21313,895,4.0
49,23,Juab,2017,5413,5237,176,3.3
49,25,Kane,2017,3739,3615,124,3.3
49,27,Millard,2017,6424,6221,203,3.2
49,29,Morgan,2017,5382,5234,148,2.7
49,31,Piute,2017,482,459,23,4.8
49,33,Rich,2017,1140,1104,36,3.2
49,35,Salt Lake,2017,613878,595463,18415,3.0
49,37,San Juan,2017,5681,5296,385,6.8
49,39,Sanpete,2017,11995,11539,456,3.8
49,41,Sevier,2017,9771,9408,363,3.7
49,43,Summit,2017,24298,23570,728,3.0
49,45,Tooele,2017,32267,31145,1122,3.5
49,47,Uintah,2017,13651,12853,798,5.8
49,49,Utah,2017,290366,282148,8218,2.8
49,51,Wasatch,2017,14587,14119,468,3.2
49,53,Washington,2017,70633,68251,2382,3.4
49,55,Wayne,2017,1458,1354,104,7.1
49,57,Weber,2017,123075,118714,4361,3.5
50,1,Addison,2017,20853,20263,590,2.8
50,3,Bennington,2017,18344,17673,671,3.7
50,5,Caledonia,2017,14759,14211,548,3.7
50,7,Chittenden,2017,97146,94942,2204,2.3
50,9,Essex,2017,2707,2581,126,4.7
50,11,Franklin,2017,27745,26897,848,3.1
50,13,Grand Isle,2017,4078,3935,143,3.5
50,15,Lamoille,2017,14136,13569,567,4.0
50,17,Orange,2017,15997,15504,493,3.1
50,19,Orleans,2017,13665,12962,703,5.1
50,21,Rutland,2017,31226,30129,1097,3.5
50,23,Washington,2017,34396,33380,1016,3.0
50,25,Windham,2017,22914,22203,711,3.1
50,27,Windsor,2017,29162,28410,752,2.6
51,1,Accomack,2017,16714,15963,751,4.5
51,3,Albemarle,2017,55627,53812,1815,3.3
51,5,Alleghany,2017,7039,6719,320,4.5
51,7,Amelia,2017,6240,5993,247,4.0
51,9,Amherst,2017,15080,14468,612,4.1
51,11,Appomattox,2017,7118,6811,307,4.3
51,13,Arlington,2017,150686,146973,3713,2.5
51,15,Augusta,2017,36907,35662,1245,3.4
51,17,Bath,2017,2574,2497,77,3.0
51,19,Bedford,2017,38287,36820,1467,3.8
51,21,Bland,2017,2883,2765,118,4.1
51,23,Botetourt,2017,17357,16752,605,3.5
51,25,Brunswick,2017,6150,5826,324,5.3
51,27,Buchanan,2017,7023,6531,492,7.0
51,29,Buckingham,2017,6348,6010,338,5.3
51,31,Campbell,2017,26185,25110,1075,4.1
51,33,Caroline,2017,15096,14454,642,4.3
51,35,Carroll,2017,13577,12982,595,4.4
51,36,Charles City,2017,3701,3526,175,4.7
51,37,Charlotte,2017,5347,5105,242,4.5
51,41,Chesterfield,2017,184565,177975,6590,3.6
51,43,Clarke,2017,7488,7234,254,3.4
51,45,Craig,2017,2299,2200,99,4.3
51,47,Culpeper,2017,24024,23163,861,3.6
51,49,Cumberland,2017,4709,4515,194,4.1
51,51,Dickenson,2017,4654,4342,312,6.7
51,53,Dinwiddie,2017,13491,12892,599,4.4
51,57,Essex,2017,5617,5349,268,4.8
51,59,Fairfax,2017,626254,607365,18889,3.0
51,61,Fauquier,2017,36107,34934,1173,3.2
51,63,Floyd,2017,8118,7823,295,3.6
51,65,Fluvanna,2017,13479,13072,407,3.0
51,67,Franklin,2017,26443,25420,1023,3.9
51,69,Frederick,2017,46614,45142,1472,3.2
51,71,Giles,2017,7907,7540,367,4.6
51,73,Gloucester,2017,19451,18814,637,3.3
51,75,Goochland,2017,10877,10500,377,3.5
51,77,Grayson,2017,7710,7408,302,3.9
51,79,Greene,2017,10195,9888,307,3.0
51,81,Greensville,2017,4447,4256,191,4.3
51,83,Halifax,2017,15623,14866,757,4.8
51,85,Hanover,2017,58416,56495,1921,3.3
51,87,Henrico,2017,181093,174534,6559,3.6
51,89,Henry,2017,23871,22773,1098,4.6
51,91,Highland,2017,1299,1257,42,3.2
51,93,Isle of Wight,2017,19182,18453,729,3.8
51,95,James City,2017,36074,34819,1255,3.5
51,97,King and Queen,2017,3818,3686,132,3.5
51,99,King George,2017,13001,12518,483,3.7
51,101,King William,2017,8973,8668,305,3.4
51,103,Lancaster,2017,5359,5082,277,5.2
51,105,Lee,2017,8589,8149,440,5.1
51,107,Loudoun,2017,215207,208739,6468,3.0
51,109,Louisa,2017,19676,19012,664,3.4
51,111,Lunenburg,2017,5380,5159,221,4.1
51,113,Madison,2017,7300,7088,212,2.9
51,115,Mathews,2017,4114,3962,152,3.7
51,117,Mecklenburg,2017,12801,12181,620,4.8
51,119,Middlesex,2017,5342,5170,172,3.2
51,121,Montgomery,2017,49922,48064,1858,3.7
51,125,Nelson,2017,7322,7068,254,3.5
51,127,New Kent,2017,12041,11661,380,3.2
51,131,Northampton,2017,5542,5234,308,5.6
51,133,Northumberland,2017,5587,5298,289,5.2
51,135,Nottoway,2017,7159,6889,270,3.8
51,137,Orange,2017,16939,16306,633,3.7
51,139,Page,2017,11926,11321,605,5.1
51,141,Patrick,2017,7728,7403,325,4.2
51,143,Pittsylvania,2017,30809,29499,1310,4.3
51,145,Powhatan,2017,13802,13348,454,3.3
51,147,Prince Edward,2017,10290,9797,493,4.8
51,149,Prince George,2017,14995,14333,662,4.4
51,153,Prince William,2017,240516,232404,8112,3.4
51,155,Pulaski,2017,16281,15422,859,5.3
51,157,Rappahannock,2017,3665,3538,127,3.5
51,159,Richmond,2017,4064,3918,146,3.6
51,161,Roanoke,2017,49148,47489,1659,3.4
51,163,Rockbridge,2017,10624,10189,435,4.1
51,165,Rockingham,2017,40799,39486,1313,3.2
51,167,Russell,2017,11492,10899,593,5.2
51,169,Scott,2017,9350,8975,375,4.0
51,171,Shenandoah,2017,21733,21005,728,3.3
51,173,Smyth,2017,13947,13258,689,4.9
51,175,Southampton,2017,9080,8756,324,3.6
51,177,Spotsylvania,2017,65712,63282,2430,3.7
51,179,Stafford,2017,69784,67288,2496,3.6
51,181,Surry,2017,3756,3592,164,4.4
51,183,Sussex,2017,3837,3611,226,5.9
51,185,Tazewell,2017,16230,15322,908,5.6
51,187,Warren,2017,19963,19229,734,3.7
51,191,Washington,2017,26961,25863,1098,4.1
51,193,Westmoreland,2017,9402,8986,416,4.4
51,195,Wise,2017,13606,12747,859,6.3
51,197,Wythe,2017,14099,13397,702,5.0
51,199,York,2017,32671,31534,1137,3.5
51,510,Alexandria city,2017,99829,97008,2821,2.8
51,520,Bristol city,2017,7382,7052,330,4.5
51,530,Buena Vista city,2017,3372,3231,141,4.2
51,540,Charlottesville city,2017,25902,25111,791,3.1
51,550,Chesapeake city,2017,121483,116934,4549,3.7
51,570,Colonial Heights city,2017,8791,8439,352,4.0
51,580,Covington city,2017,2459,2312,147,6.0
51,590,Danville city,2017,20028,18906,1122,5.6
51,595,Emporia city,2017,2373,2249,124,5.2
51,600,Fairfax city,2017,13024,12653,371,2.8
51,610,Falls Church city,2017,8370,8151,219,2.6
51,620,Franklin city,2017,3588,3400,188,5.2
51,630,Fredericksburg city,2017,13661,13069,592,4.3
51,640,Galax city,2017,3021,2896,125,4.1
51,650,Hampton city,2017,64755,61517,3238,5.0
51,660,Harrisonburg city,2017,24895,23808,1087,4.4
51,670,Hopewell city,2017,9790,9195,595,6.1
51,678,Lexington city,2017,2133,2005,128,6.0
51,680,Lynchburg city,2017,36214,34450,1764,4.9
51,683,Manassas city,2017,21746,21019,727,3.3
51,685,Manassas Park city,2017,8886,8590,296,3.3
51,690,Martinsville city,2017,5536,5191,345,6.2
51,700,Newport News city,2017,89395,85315,4080,4.6
51,710,Norfolk city,2017,112164,107055,5109,4.6
51,720,Norton city,2017,1709,1620,89,5.2
51,730,Petersburg city,2017,13210,12253,957,7.2
51,735,Poquoson city,2017,6298,6086,212,3.4
51,740,Portsmouth city,2017,44481,42118,2363,5.3
51,750,Radford city,2017,8379,7970,409,4.9
51,760,Richmond city,2017,117421,112413,5008,4.3
51,770,Roanoke city,2017,49207,47184,2023,4.1
51,775,Salem city,2017,13101,12617,484,3.7
51,790,Staunton city,2017,11922,11499,423,3.5
51,800,Suffolk city,2017,44209,42424,1785,4.0
51,810,Virginia Beach city,2017,232751,224576,8175,3.5
51,820,Waynesboro city,2017,10473,10058,415,4.0
51,830,Williamsburg city,2017,6773,6425,348,5.1
51,840,Winchester city,2017,14544,14019,525,3.6
53,1,Adams,2017,8890,8390,500,5.6
53,3,Asotin,2017,10247,9824,423,4.1
53,5,Benton,2017,96950,91693,5257,5.4
53,7,Chelan,2017,44282,42177,2105,4.8
53,9,Clallam,2017,27756,25899,1857,6.7
53,11,Clark,2017,227797,216428,11369,5.0
53,13,Columbia,2017,1774,1676,98,5.5
53,15,Cowlitz,2017,45719,42990,2729,6.0
53,17,Douglas,2017,21103,19931,1172,5.6
53,19,Ferry,2017,2510,2238,272,10.8
53,21,Franklin,2017,40699,38162,2537,6.2
53,23,Garfield,2017,904,857,47,5.2
53,25,Grant,2017,45117,42344,2773,6.1
53,27,Grays Harbor,2017,27831,25898,1933,6.9
53,29,Island,2017,33946,32214,1732,5.1
53,31,Jefferson,2017,11913,11198,715,6.0
53,33,King,2017,1235923,1192366,43557,3.5
53,35,Kitsap,2017,120366,114597,5769,4.8
53,37,Kittitas,2017,22259,21096,1163,5.2
53,39,Klickitat,2017,9886,9308,578,5.8
53,41,Lewis,2017,33098,30947,2151,6.5
53,43,Lincoln,2017,4949,4708,241,4.9
53,45,Mason,2017,23782,22245,1537,6.5
53,47,Okanogan,2017,20920,19523,1397,6.7
53,49,Pacific,2017,8337,7758,579,6.9
53,51,Pend Oreille,2017,4729,4385,344,7.3
53,53,Pierce,2017,415999,394070,21929,5.3
53,55,San Juan,2017,8192,7874,318,3.9
53,57,Skagit,2017,59346,56153,3193,5.4
53,59,Skamania,2017,5288,4971,317,6.0
53,61,Snohomish,2017,423083,406480,16603,3.9
53,63,Spokane,2017,239651,226955,12696,5.3
53,65,Stevens,2017,18083,16792,1291,7.1
53,67,Thurston,2017,134309,127746,6563,4.9
53,69,Wahkiakum,2017,1305,1212,93,7.1
53,71,Walla Walla,2017,28859,27453,1406,4.9
53,73,Whatcom,2017,109989,104589,5400,4.9
53,75,Whitman,2017,23316,22312,1004,4.3
53,77,Yakima,2017,125530,117118,8412,6.7
54,1,Barbour,2017,6846,6445,401,5.9
54,3,Berkeley,2017,56463,54395,2068,3.7
54,5,Boone,2017,7591,7102,489,6.4
54,7,Braxton,2017,5277,4879,398,7.5
54,9,Brooke,2017,9822,9222,600,6.1
54,11,Cabell,2017,41718,39813,1905,4.6
54,13,Calhoun,2017,2419,2156,263,10.9
54,15,Clay,2017,3167,2892,275,8.7
54,17,Doddridge,2017,3906,3739,167,4.3
54,19,Fayette,2017,15814,14798,1016,6.4
54,21,Gilmer,2017,2415,2241,174,7.2
54,23,Grant,2017,5928,5594,334,5.6
54,25,Greenbrier,2017,15808,15036,772,4.9
54,27,Hampshire,2017,10381,9972,409,3.9
54,29,Hancock,2017,12880,12097,783,6.1
54,31,Hardy,2017,5933,5641,292,4.9
54,33,Harrison,2017,33330,31715,1615,4.8
54,35,Jackson,2017,12073,11382,691,5.7
54,37,Jefferson,2017,29432,28516,916,3.1
54,39,Kanawha,2017,83475,79220,4255,5.1
54,41,Lewis,2017,6556,6120,436,6.7
54,43,Lincoln,2017,7197,6702,495,6.9
54,45,Logan,2017,10832,10021,811,7.5
54,47,McDowell,2017,4696,4274,422,9.0
54,49,Marion,2017,25471,24119,1352,5.3
54,51,Marshall,2017,14042,13202,840,6.0
54,53,Mason,2017,10050,9371,679,6.8
54,55,Mercer,2017,21428,20172,1256,5.9
54,57,Mineral,2017,12268,11619,649,5.3
54,59,Mingo,2017,6791,6203,588,8.7
54,61,Monongalia,2017,53102,51119,1983,3.7
54,63,Monroe,2017,5924,5662,262,4.4
54,65,Morgan,2017,7854,7542,312,4.0
54,67,Nicholas,2017,9302,8634,668,7.2
54,69,Ohio,2017,21020,20027,993,4.7
54,71,Pendleton,2017,3578,3443,135,3.8
54,73,Pleasants,2017,2832,2631,201,7.1
54,75,Pocahontas,2017,3764,3540,224,6.0
54,77,Preston,2017,15288,14529,759,5.0
54,79,Putnam,2017,26362,25118,1244,4.7
54,81,Raleigh,2017,29543,27952,1591,5.4
54,83,Randolph,2017,12201,11540,661,5.4
54,85,Ritchie,2017,4425,4181,244,5.5
54,87,Roane,2017,5051,4609,442,8.8
54,89,Summers,2017,4401,4140,261,5.9
54,91,Taylor,2017,7845,7459,386,4.9
54,93,Tucker,2017,3418,3240,178,5.2
54,95,Tyler,2017,3232,2982,250,7.7
54,97,Upshur,2017,9456,8872,584,6.2
54,99,Wayne,2017,15663,14748,915,5.8
54,101,Webster,2017,3314,3104,210,6.3
54,103,Wetzel,2017,6773,6259,514,7.6
54,105,Wirt,2017,2208,2033,175,7.9
54,107,Wood,2017,36318,34315,2003,5.5
54,109,Wyoming,2017,6900,6410,490,7.1
55,1,Adams,2017,8208,7793,415,5.1
55,3,Ashland,2017,7868,7511,357,4.5
55,5,Barron,2017,24621,23765,856,3.5
55,7,Bayfield,2017,7555,7165,390,5.2
55,9,Brown,2017,142289,138115,4174,2.9
55,11,Buffalo,2017,6560,6315,245,3.7
55,13,Burnett,2017,7322,6970,352,4.8
55,15,Calumet,2017,27821,27046,775,2.8
55,17,Chippewa,2017,33340,32178,1162,3.5
55,19,Clark,2017,17909,17367,542,3.0
55,21,Columbia,2017,31619,30688,931,2.9
55,23,Crawford,2017,7855,7531,324,4.1
55,25,Dane,2017,319483,311811,7672,2.4
55,27,Dodge,2017,48256,46862,1394,2.9
55,29,Door,2017,15519,14928,591,3.8
55,31,Douglas,2017,23472,22432,1040,4.4
55,33,Dunn,2017,24372,23578,794,3.3
55,35,Eau Claire,2017,59115,57401,1714,2.9
55,37,Florence,2017,2280,2174,106,4.6
55,39,Fond du Lac,2017,56867,55260,1607,2.8
55,41,Forest,2017,4013,3812,201,5.0
55,43,Grant,2017,28104,27224,880,3.1
55,45,Green,2017,21061,20485,576,2.7
55,47,Green Lake,2017,9679,9318,361,3.7
55,49,Iowa,2017,13758,13355,403,2.9
55,51,Iron,2017,2599,2439,160,6.2
55,53,Jackson,2017,10391,10045,346,3.3
55,55,Jefferson,2017,45472,44028,1444,3.2
55,57,Juneau,2017,13546,13097,449,3.3
55,59,Kenosha,2017,89132,85691,3441,3.9
55,61,Kewaunee,2017,11152,10809,343,3.1
55,63,La Crosse,2017,67445,65484,1961,2.9
55,65,Lafayette,2017,10121,9867,254,2.5
55,67,Langlade,2017,9610,9208,402,4.2
55,69,Lincoln,2017,15447,14901,546,3.5
55,71,Manitowoc,2017,41575,40115,1460,3.5
55,73,Marathon,2017,73637,71482,2155,2.9
55,75,Marinette,2017,19695,18827,868,4.4
55,77,Marquette,2017,7581,7292,289,3.8
55,78,Menominee,2017,1602,1507,95,5.9
55,79,Milwaukee,2017,473509,454446,19063,4.0
55,81,Monroe,2017,23445,22759,686,2.9
55,83,Oconto,2017,20578,19854,724,3.5
55,85,Oneida,2017,18300,17604,696,3.8
55,87,Outagamie,2017,103647,100539,3108,3.0
55,89,Ozaukee,2017,49003,47657,1346,2.7
55,91,Pepin,2017,4202,4055,147,3.5
55,93,Pierce,2017,25084,24244,840,3.3
55,95,Polk,2017,24760,23833,927,3.7
55,97,Portage,2017,39492,38284,1208,3.1
55,99,Price,2017,6771,6519,252,3.7
55,101,Racine,2017,99344,95333,4011,4.0
55,103,Richland,2017,9256,8980,276,3.0
55,105,Rock,2017,84980,81855,3125,3.7
55,107,Rusk,2017,6965,6658,307,4.4
55,109,St. Croix,2017,49999,48447,1552,3.1
55,111,Sauk,2017,35422,34397,1025,2.9
55,113,Sawyer,2017,7970,7601,369,4.6
55,115,Shawano,2017,21377,20692,685,3.2
55,117,Sheboygan,2017,62367,60643,1724,2.8
55,119,Taylor,2017,11074,10691,383,3.5
55,121,Trempealeau,2017,16415,15916,499,3.0
55,123,Vernon,2017,15680,15198,482,3.1
55,125,Vilas,2017,10129,9692,437,4.3
55,127,Walworth,2017,57751,55868,1883,3.3
55,129,Washburn,2017,7889,7581,308,3.9
55,131,Washington,2017,77479,75334,2145,2.8
55,133,Waukesha,2017,225376,218875,6501,2.9
55,135,Waupaca,2017,26509,25670,839,3.2
55,137,Waushara,2017,11374,10925,449,3.9
55,139,Winnebago,2017,93311,90538,2773,3.0
55,141,Wood,2017,34902,33603,1299,3.7
56,1,Albany,2017,20665,20056,609,2.9
56,3,Big Horn,2017,5413,5177,236,4.4
56,5,Campbell,2017,23254,22090,1164,5.0
56,7,Carbon,2017,7979,7651,328,4.1
56,9,Converse,2017,7555,7209,346,4.6
56,11,Crook,2017,3720,3585,135,3.6
56,13,Fremont,2017,19549,18436,1113,5.7
56,15,Goshen,2017,6989,6782,207,3.0
56,17,Hot Springs,2017,2356,2261,95,4.0
56,19,Johnson,2017,4238,4056,182,4.3
56,21,Laramie,2017,48683,46850,1833,3.8
56,23,Lincoln,2017,8834,8500,334,3.8
56,25,Natrona,2017,39925,37776,2149,5.4
56,27,Niobrara,2017,1313,1276,37,2.8
56,29,Park,2017,15845,15152,693,4.4
56,31,Platte,2017,4821,4638,183,3.8
56,33,Sheridan,2017,15953,15313,640,4.0
56,35,Sublette,2017,4298,4100,198,4.6
56,37,Sweetwater,2017,21773,20758,1015,4.7
56,39,Teton,2017,15566,15114,452,2.9
56,41,Uinta,2017,9195,8765,430,4.7
56,43,Washakie,2017,4153,3982,171,4.1
56,45,Weston,2017,3791,3637,154,4.1
72,1,Adjuntas Municipio,2017,4368,3710,658,15.1
72,3,Aguada Municipio,2017,11868,10334,1534,12.9
72,5,Aguadilla Municipio,2017,14891,12732,2159,14.5
72,7,Aguas Buenas Municipio,2017,6616,5789,827,12.5
72,9,Aibonito Municipio,2017,6575,5643,932,14.2
72,11,Anasco Municipio,2017,8952,7831,1121,12.5
72,13,Arecibo Municipio,2017,23532,20772,2760,11.7
72,15,Arroyo Municipio,2017,5000,4113,887,17.7
72,17,Barceloneta Municipio,2017,5884,5060,824,14.0
72,19,Barranquitas Municipio,2017,7372,6535,837,11.4
72,21,Bayamon Municipio,2017,64846,59877,4969,7.7
72,23,Cabo Rojo Municipio,2017,13946,12047,1899,13.6
72,25,Caguas Municipio,2017,47504,43195,4309,9.1
72,27,Camuy Municipio,2017,9387,8297,1090,11.6
72,29,Canovanas Municipio,2017,16013,14452,1561,9.7
72,31,Carolina Municipio,2017,61105,56351,4754,7.8
72,33,Catano Municipio,2017,7782,7076,706,9.1
72,35,Cayey Municipio,2017,16107,14479,1628,10.1
72,37,Ceiba Municipio,2017,3774,3265,509,13.5
72,39,Ciales Municipio,2017,3834,3215,619,16.1
72,41,Cidra Municipio,2017,15246,13964,1282,8.4
72,43,Coamo Municipio,2017,10349,8669,1680,16.2
72,45,Comerio Municipio,2017,4948,4366,582,11.8
72,47,Corozal Municipio,2017,9013,7994,1019,11.3
72,49,Culebra Municipio,2017,912,872,40,4.4
72,51,Dorado Municipio,2017,12819,11936,883,6.9
72,53,Fajardo Municipio,2017,11112,9630,1482,13.3
72,54,Florida Municipio,2017,3359,2879,480,14.3
72,55,Guanica Municipio,2017,4053,3312,741,18.3
72,57,Guayama Municipio,2017,11746,9908,1838,15.6
72,59,Guayanilla Municipio,2017,5085,4251,834,16.4
72,61,Guaynabo Municipio,2017,36752,34813,1939,5.3
72,63,Gurabo Municipio,2017,17559,16277,1282,7.3
72,65,Hatillo Municipio,2017,13086,11258,1828,14.0
72,67,Hormigueros Municipio,2017,5538,4833,705,12.7
72,69,Humacao Municipio,2017,17374,14948,2426,14.0
72,71,Isabela Municipio,2017,12599,10912,1687,13.4
72,73,Jayuya Municipio,2017,4249,3697,552,13.0
72,75,Juana Diaz Municipio,2017,15029,13090,1939,12.9
72,77,Juncos Municipio,2017,12321,10898,1423,11.5
72,79,Lajas Municipio,2017,5473,4409,1064,19.4
72,81,Lares Municipio,2017,7235,5888,1347,18.6
72,83,Las Marias Municipio,2017,2802,2224,578,20.6
72,85,Las Piedras Municipio,2017,11244,9897,1347,12.0
72,87,Loiza Municipio,2017,8428,7619,809,9.6
72,89,Luquillo Municipio,2017,6223,5424,799,12.8
72,91,Manati Municipio,2017,11505,10282,1223,10.6
72,93,Maricao Municipio,2017,2024,1618,406,20.1
72,95,Maunabo Municipio,2017,2949,2439,510,17.3
72,97,Mayaguez Municipio,2017,22579,19422,3157,14.0
72,99,Moca Municipio,2017,10707,9133,1574,14.7
72,101,Morovis Municipio,2017,8028,7032,996,12.4
72,103,Naguabo Municipio,2017,8013,7120,893,11.1
72,105,Naranjito Municipio,2017,7155,6308,847,11.8
72,107,Orocovis Municipio,2017,5096,4369,727,14.3
72,109,Patillas Municipio,2017,4643,3728,915,19.7
72,111,Penuelas Municipio,2017,5994,4946,1048,17.5
72,113,Ponce Municipio,2017,45598,40291,5307,11.6
72,115,Quebradillas Municipio,2017,6062,5105,957,15.8
72,117,Rincon Municipio,2017,4664,3951,713,15.3
72,119,Rio Grande Municipio,2017,16953,15308,1645,9.7
72,121,Sabana Grande Municipio,2017,6369,5296,1073,16.8
72,123,Salinas Municipio,2017,7481,6080,1401,18.7
72,125,San German Municipio,2017,10017,8447,1570,15.7
72,127,San Juan Municipio,2017,132504,123201,9303,7.0
72,129,San Lorenzo Municipio,2017,11908,10381,1527,12.8
72,131,San Sebastian Municipio,2017,10576,8709,1867,17.7
72,133,Santa Isabel Municipio,2017,9738,8420,1318,13.5
72,135,Toa Alta Municipio,2017,26566,24512,2054,7.7
72,137,Toa Baja Municipio,2017,29185,26823,2362,8.1
72,139,Trujillo Alto Municipio,2017,26623,25045,1578,5.9
72,141,Utuado Municipio,2017,6756,5813,943,14.0
72,143,Vega Alta Municipio,2017,9785,8738,1047,10.7
72,145,Vega Baja Municipio,2017,13414,11746,1668,12.4
72,147,Vieques Municipio,2017,3027,2589,438,14.5
72,149,Villalba Municipio,2017,7557,6090,1467,19.4
72,151,Yabucoa Municipio,2017,9000,7512,1488,16.5
72,153,Yauco Municipio,2017,10160,8409,1751,17.2
1,1,Autauga,2018,26081,25140,941,3.6
1,3,Baldwin,2018,94820,91375,3445,3.6
1,5,Barbour,2018,8379,7949,430,5.1
1,7,Bibb,2018,8569,8229,340,4.0
1,9,Blount,2018,24960,24086,874,3.5
1,11,Bullock,2018,4770,4549,221,4.6
1,13,Butler,2018,8935,8512,423,4.7
1,15,Calhoun,2018,46110,43981,2129,4.6
1,17,Chambers,2018,15300,14705,595,3.9
1,19,Cherokee,2018,11637,11222,415,3.6
1,21,Chilton,2018,19538,18834,704,3.6
1,23,Choctaw,2018,4729,4471,258,5.5
1,25,Clarke,2018,7628,7062,566,7.4
1,27,Clay,2018,5985,5757,228,3.8
1,29,Cleburne,2018,5770,5525,245,4.2
1,31,Coffee,2018,20916,20096,820,3.9
1,33,Colbert,2018,23441,22371,1070,4.6
1,35,Conecuh,2018,4493,4261,232,5.2
1,37,Coosa,2018,4408,4226,182,4.1
1,39,Covington,2018,15585,14874,711,4.6
1,41,Crenshaw,2018,6341,6085,256,4.0
1,43,Cullman,2018,37942,36702,1240,3.3
1,45,Dale,2018,20169,19331,838,4.2
1,47,Dallas,2018,14819,13861,958,6.5
1,49,DeKalb,2018,30158,29014,1144,3.8
1,51,Elmore,2018,37424,36140,1284,3.4
1,53,Escambia,2018,14360,13714,646,4.5
1,55,Etowah,2018,43062,41304,1758,4.1
1,57,Fayette,2018,6501,6237,264,4.1
1,59,Franklin,2018,14229,13702,527,3.7
1,61,Geneva,2018,10825,10400,425,3.9
1,63,Greene,2018,2849,2660,189,6.6
1,65,Hale,2018,5954,5653,301,5.1
1,67,Henry,2018,6800,6500,300,4.4
1,69,Houston,2018,45384,43556,1828,4.0
1,71,Jackson,2018,23311,22361,950,4.1
1,73,Jefferson,2018,314427,302800,11627,3.7
1,75,Lamar,2018,5718,5502,216,3.8
1,77,Lauderdale,2018,42207,40450,1757,4.2
1,79,Lawrence,2018,13984,13406,578,4.1
1,81,Lee,2018,74914,72196,2718,3.6
1,83,Limestone,2018,42790,41274,1516,3.5
1,85,Lowndes,2018,3600,3338,262,7.3
1,87,Macon,2018,7829,7407,422,5.4
1,89,Madison,2018,180767,174517,6250,3.5
1,91,Marengo,2018,7576,7203,373,4.9
1,93,Marion,2018,12567,12057,510,4.1
1,95,Marshall,2018,42737,41299,1438,3.4
1,97,Mobile,2018,188203,179435,8768,4.7
1,99,Monroe,2018,7157,6720,437,6.1
1,101,Montgomery,2018,105494,101297,4197,4.0
1,103,Morgan,2018,56908,54930,1978,3.5
1,105,Perry,2018,3397,3177,220,6.5
1,107,Pickens,2018,7713,7360,353,4.6
1,109,Pike,2018,15195,14510,685,4.5
1,111,Randolph,2018,9541,9159,382,4.0
1,113,Russell,2018,23915,22957,958,4.0
1,115,St. Clair,2018,39944,38558,1386,3.5
1,117,Shelby,2018,114122,110895,3227,2.8
1,119,Sumter,2018,4801,4522,279,5.8
1,121,Talladega,2018,35180,33686,1494,4.2
1,123,Tallapoosa,2018,17880,17144,736,4.1
1,125,Tuscaloosa,2018,102058,98355,3703,3.6
1,127,Walker,2018,25021,23964,1057,4.2
1,129,Washington,2018,6682,6296,386,5.8
1,131,Wilcox,2018,2746,2486,260,9.5
1,133,Winston,2018,9767,9360,407,4.2
2,13,Aleutians East Borough,2018,2321,2256,65,2.8
2,16,Aleutians West Census Area,2018,3647,3531,116,3.2
2,20,Anchorage Borough/municipality,2018,151067,143566,7501,5.0
2,50,Bethel Census Area,2018,7144,6305,839,11.7
2,60,Bristol Bay Borough,2018,448,423,25,5.6
2,68,Denali Borough,2018,1066,989,77,7.2
2,70,Dillingham Census Area,2018,2022,1873,149,7.4
2,90,Fairbanks North Star Borough,2018,45962,43569,2393,5.2
2,100,Haines Borough,2018,1104,1007,97,8.8
2,105,Hoonah-Angoon Census Area,2018,1151,1019,132,11.5
2,110,Juneau Borough/city,2018,17248,16559,689,4.0
2,122,Kenai Peninsula Borough,2018,26611,24762,1849,6.9
2,130,Ketchikan Gateway Borough,2018,7042,6657,385,5.5
2,150,Kodiak Island Borough,2018,6164,5834,330,5.4
2,158,Kusilvak Census Area,2018,2681,2193,488,18.2
2,164,Lake and Peninsula Borough,2018,746,670,76,10.2
2,170,Matanuska-Susitna Borough,2018,48169,44872,3297,6.8
2,180,Nome Census Area,2018,4106,3678,428,10.4
2,185,North Slope Borough,2018,3420,3206,214,6.3
2,188,Northwest Arctic Borough,2018,2927,2557,370,12.6
2,195,Petersburg Borough,2018,1390,1280,110,7.9
2,198,Prince of Wales-Hyder Census Area,2018,2891,2607,284,9.8
2,220,Sitka Borough/city,2018,4382,4216,166,3.8
2,230,Skagway Municipality,2018,836,763,73,8.7
2,240,Southeast Fairbanks Census Area,2018,2947,2688,259,8.8
2,261,Valdez-Cordova Census Area,2018,4872,4546,326,6.7
2,275,Wrangell Borough/city,2018,1043,977,66,6.3
2,282,Yakutat Borough/city,2018,248,230,18,7.3
2,290,Yukon-Koyukuk Census Area,2018,2544,2199,345,13.6
4,1,Apache,2018,20542,18500,2042,9.9
4,3,Cochise,2018,49567,46789,2778,5.6
4,5,Coconino,2018,76266,72059,4207,5.5
4,7,Gila,2018,21396,20150,1246,5.8
4,9,Graham,2018,14836,14082,754,5.1
4,11,Greenlee,2018,4269,4092,177,4.1
4,12,La Paz,2018,8913,8357,556,6.2
4,13,Maricopa,2018,2220491,2128730,91761,4.1
4,15,Mohave,2018,85087,80237,4850,5.7
4,17,Navajo,2018,40309,37203,3106,7.7
4,19,Pima,2018,484943,463428,21515,4.4
4,21,Pinal,2018,180081,171088,8993,5.0
4,23,Santa Cruz,2018,19297,17519,1778,9.2
4,25,Yavapai,2018,104761,100105,4656,4.4
4,27,Yuma,2018,97308,80799,16509,17.0
5,1,Arkansas,2018,9075,8774,301,3.3
5,3,Ashley,2018,7833,7421,412,5.3
5,5,Baxter,2018,16391,15720,671,4.1
5,7,Benton,2018,134697,130818,3879,2.9
5,9,Boone,2018,15905,15353,552,3.5
5,11,Bradley,2018,4484,4291,193,4.3
5,13,Calhoun,2018,2444,2351,93,3.8
5,15,Carroll,2018,12613,12210,403,3.2
5,17,Chicot,2018,3358,3132,226,6.7
5,19,Clark,2018,9696,9341,355,3.7
5,21,Clay,2018,5803,5553,250,4.3
5,23,Cleburne,2018,9125,8716,409,4.5
5,25,Cleveland,2018,3267,3143,124,3.8
5,27,Columbia,2018,9021,8599,422,4.7
5,29,Conway,2018,8169,7816,353,4.3
5,31,Craighead,2018,54536,52890,1646,3.0
5,33,Crawford,2018,26992,26040,952,3.5
5,35,Crittenden,2018,21194,20282,912,4.3
5,37,Cross,2018,7450,7146,304,4.1
5,39,Dallas,2018,2847,2728,119,4.2
5,41,Desha,2018,5425,5183,242,4.5
5,43,Drew,2018,7844,7464,380,4.8
5,45,Faulkner,2018,62021,60025,1996,3.2
5,47,Franklin,2018,7382,7121,261,3.5
5,49,Fulton,2018,4820,4629,191,4.0
5,51,Garland,2018,40809,39179,1630,4.0
5,53,Grant,2018,8329,8074,255,3.1
5,55,Greene,2018,19839,19155,684,3.4
5,57,Hempstead,2018,9946,9602,344,3.5
5,59,Hot Spring,2018,13960,13440,520,3.7
5,61,Howard,2018,5904,5703,201,3.4
5,63,Independence,2018,16294,15640,654,4.0
5,65,Izard,2018,4872,4607,265,5.4
5,67,Jackson,2018,5782,5434,348,6.0
5,69,Jefferson,2018,28032,26580,1452,5.2
5,71,Johnson,2018,10396,9927,469,4.5
5,73,Lafayette,2018,2490,2363,127,5.1
5,75,Lawrence,2018,6825,6559,266,3.9
5,77,Lee,2018,2901,2763,138,4.8
5,79,Lincoln,2018,4011,3841,170,4.2
5,81,Little River,2018,5463,5179,284,5.2
5,83,Logan,2018,8740,8393,347,4.0
5,85,Lonoke,2018,34189,33112,1077,3.2
5,87,Madison,2018,7347,7136,211,2.9
5,89,Marion,2018,6494,6228,266,4.1
5,91,Miller,2018,19525,18592,933,4.8
5,93,Mississippi,2018,17351,16377,974,5.6
5,95,Monroe,2018,2742,2628,114,4.2
5,97,Montgomery,2018,3053,2910,143,4.7
5,99,Nevada,2018,3648,3523,125,3.4
5,101,Newton,2018,3303,3193,110,3.3
5,103,Ouachita,2018,9763,9318,445,4.6
5,105,Perry,2018,4246,4073,173,4.1
5,107,Phillips,2018,6577,6181,396,6.0
5,109,Pike,2018,4301,4127,174,4.0
5,111,Poinsett,2018,10137,9751,386,3.8
5,113,Polk,2018,8069,7741,328,4.1
5,115,Pope,2018,29001,27724,1277,4.4
5,117,Prairie,2018,3558,3422,136,3.8
5,119,Pulaski,2018,188549,182065,6484,3.4
5,121,Randolph,2018,7166,6882,284,4.0
5,123,St. Francis,2018,8290,7871,419,5.1
5,125,Saline,2018,58704,56918,1786,3.0
5,127,Scott,2018,4391,4233,158,3.6
5,129,Searcy,2018,2926,2800,126,4.3
5,131,Sebastian,2018,56832,54823,2009,3.5
5,133,Sevier,2018,5599,5344,255,4.6
5,135,Sharp,2018,5785,5511,274,4.7
5,137,Stone,2018,4790,4576,214,4.5
5,139,Union,2018,15977,15105,872,5.5
5,141,Van Buren,2018,5887,5579,308,5.2
5,143,Washington,2018,122567,119377,3190,2.6
5,145,White,2018,33630,32172,1458,4.3
5,147,Woodruff,2018,2802,2671,131,4.7
5,149,Yell,2018,8490,8138,352,4.1
6,1,Alameda,2018,841484,815690,25794,3.1
6,3,Alpine,2018,547,522,25,4.6
6,5,Amador,2018,14670,14068,602,4.1
6,7,Butte,2018,101820,96640,5180,5.1
6,9,Calaveras,2018,21164,20306,858,4.1
6,11,Colusa,2018,10852,9410,1442,13.3
6,13,Contra Costa,2018,560286,542200,18086,3.2
6,15,Del Norte,2018,9712,9153,559,5.8
6,17,El Dorado,2018,91029,87705,3324,3.7
6,19,Fresno,2018,446268,412330,33938,7.6
6,21,Glenn,2018,12769,11925,844,6.6
6,23,Humboldt,2018,62535,60261,2274,3.6
6,25,Imperial,2018,71152,57746,13406,18.8
6,27,Inyo,2018,8703,8362,341,3.9
6,29,Kern,2018,385818,354488,31330,8.1
6,31,Kings,2018,57507,52958,4549,7.9
6,33,Lake,2018,29073,27527,1546,5.3
6,35,Lassen,2018,9854,9377,477,4.8
6,37,Los Angeles,2018,5121279,4885329,235950,4.6
6,39,Madera,2018,61266,56891,4375,7.1
6,41,Marin,2018,139699,136279,3420,2.4
6,43,Mariposa,2018,7651,7240,411,5.4
6,45,Mendocino,2018,39456,37870,1586,4.0
6,47,Merced,2018,115261,105519,9742,8.5
6,49,Modoc,2018,3156,2916,240,7.6
6,51,Mono,2018,8426,8083,343,4.1
6,53,Monterey,2018,221941,207683,14258,6.4
6,55,Napa,2018,73780,71584,2196,3.0
6,57,Nevada,2018,48564,46851,1713,3.5
6,59,Orange,2018,1616049,1567983,48066,3.0
6,61,Placer,2018,185623,179656,5967,3.2
6,63,Plumas,2018,7816,7221,595,7.6
6,65,Riverside,2018,1090129,1041495,48634,4.5
6,67,Sacramento,2018,704188,676779,27409,3.9
6,69,San Benito,2018,31202,29610,1592,5.1
6,71,San Bernardino,2018,955061,915670,39391,4.1
6,73,San Diego,2018,1579734,1526341,53393,3.4
6,75,San Francisco/city,2018,568680,554981,13699,2.4
6,77,San Joaquin,2018,324177,304277,19900,6.1
6,79,San Luis Obispo,2018,140099,135867,4232,3.0
6,81,San Mateo,2018,448971,438826,10145,2.3
6,83,Santa Barbara,2018,215246,206676,8570,4.0
6,85,Santa Clara,2018,1042464,1014782,27682,2.7
6,87,Santa Cruz,2018,141283,134198,7085,5.0
6,89,Shasta,2018,73897,70175,3722,5.0
6,91,Sierra,2018,1277,1199,78,6.1
6,93,Siskiyou,2018,17366,16187,1179,6.8
6,95,Solano,2018,209055,200770,8285,4.0
6,97,Sonoma,2018,260622,253340,7282,2.8
6,99,Stanislaus,2018,243090,227268,15822,6.5
6,101,Sutter,2018,44844,41402,3442,7.7
6,103,Tehama,2018,25487,24018,1469,5.8
6,105,Trinity,2018,4676,4406,270,5.8
6,107,Tulare,2018,203051,183096,19955,9.8
6,109,Tuolumne,2018,21189,20194,995,4.7
6,111,Ventura,2018,423085,406819,16266,3.8
6,113,Yolo,2018,107549,102903,4646,4.3
6,115,Yuba,2018,29244,27350,1894,6.5
8,1,Adams,2018,268394,259776,8618,3.2
8,3,Alamosa,2018,8538,8218,320,3.7
8,5,Arapahoe,2018,359083,348382,10701,3.0
8,7,Archuleta,2018,6847,6628,219,3.2
8,9,Baca,2018,2166,2129,37,1.7
8,11,Bent,2018,1902,1844,58,3.0
8,13,Boulder,2018,192258,187195,5063,2.6
8,14,Broomfield/city,2018,39465,38396,1069,2.7
8,15,Chaffee,2018,9593,9352,241,2.5
8,17,Cheyenne,2018,1137,1118,19,1.7
8,19,Clear Creek,2018,5960,5792,168,2.8
8,21,Conejos,2018,4084,3923,161,3.9
8,23,Costilla,2018,1834,1759,75,4.1
8,25,Crowley,2018,1488,1427,61,4.1
8,27,Custer,2018,2077,2006,71,3.4
8,29,Delta,2018,14364,13827,537,3.7
8,31,Denver/city,2018,410392,398316,12076,2.9
8,33,Dolores,2018,1145,1114,31,2.7
8,35,Douglas,2018,191178,186132,5046,2.6
8,37,Eagle,2018,36036,35133,903,2.5
8,39,Elbert,2018,14991,14602,389,2.6
8,41,El Paso,2018,334131,321943,12188,3.6
8,43,Fremont,2018,14997,14269,728,4.9
8,45,Garfield,2018,32278,31324,954,3.0
8,47,Gilpin,2018,3713,3626,87,2.3
8,49,Grand,2018,9884,9639,245,2.5
8,51,Gunnison,2018,11319,11057,262,2.3
8,53,Hinsdale,2018,442,431,11,2.5
8,55,Huerfano,2018,2573,2414,159,6.2
8,57,Jackson,2018,986,962,24,2.4
8,59,Jefferson,2018,330021,320774,9247,2.8
8,61,Kiowa,2018,941,925,16,1.7
8,63,Kit Carson,2018,4282,4200,82,1.9
8,65,Lake,2018,4787,4670,117,2.4
8,67,La Plata,2018,32184,31298,886,2.8
8,69,Larimer,2018,200725,195500,5225,2.6
8,71,Las Animas,2018,6531,6245,286,4.4
8,73,Lincoln,2018,2453,2398,55,2.2
8,75,Logan,2018,11184,10894,290,2.6
8,77,Mesa,2018,75367,72523,2844,3.8
8,79,Mineral,2018,510,497,13,2.5
8,81,Moffat,2018,7411,7158,253,3.4
8,83,Montezuma,2018,12935,12356,579,4.5
8,85,Montrose,2018,21562,20824,738,3.4
8,87,Morgan,2018,16305,15864,441,2.7
8,89,Otero,2018,8371,7976,395,4.7
8,91,Ouray,2018,2380,2303,77,3.2
8,93,Park,2018,10999,10710,289,2.6
8,95,Phillips,2018,2588,2542,46,1.8
8,97,Pitkin,2018,11197,10802,395,3.5
8,99,Prowers,2018,6269,6076,193,3.1
8,101,Pueblo,2018,75283,71877,3406,4.5
8,103,Rio Blanco,2018,2929,2814,115,3.9
8,105,Rio Grande,2018,5405,5157,248,4.6
8,107,Routt,2018,16192,15787,405,2.5
8,109,Saguache,2018,3522,3368,154,4.4
8,111,San Juan,2018,522,507,15,2.9
8,113,San Miguel,2018,5544,5367,177,3.2
8,115,Sedgwick,2018,1186,1157,29,2.4
8,117,Summit,2018,22448,21992,456,2.0
8,119,Teller,2018,12502,12074,428,3.4
8,121,Washington,2018,3047,2977,70,2.3
8,123,Weld,2018,164567,159967,4600,2.8
8,125,Yuma,2018,5994,5882,112,1.9
9,1,Fairfield,2018,479362,461294,18068,3.8
9,3,Hartford,2018,479997,460614,19383,4.0
9,5,Litchfield,2018,104803,100992,3811,3.6
9,7,Middlesex,2018,93205,90093,3112,3.3
9,9,New Haven,2018,460748,441560,19188,4.2
9,11,New London,2018,137239,132087,5152,3.8
9,13,Tolland,2018,86463,83517,2946,3.4
9,15,Windham,2018,63569,60838,2731,4.3
10,1,Kent,2018,77964,74783,3181,4.1
10,3,New Castle,2018,297424,286739,10685,3.6
10,5,Sussex,2018,105790,101894,3896,3.7
11,1,District of Colu,2018,396039,373772,22267,5.6
12,1,Alachua,2018,137230,132658,4572,3.3
12,3,Baker,2018,11635,11228,407,3.5
12,5,Bay,2018,87934,84306,3628,4.1
12,7,Bradford,2018,11137,10754,383,3.4
12,9,Brevard,2018,276488,266546,9942,3.6
12,11,Broward,2018,1031568,996114,35454,3.4
12,13,Calhoun,2018,4940,4726,214,4.3
12,15,Charlotte,2018,70743,67839,2904,4.1
12,17,Citrus,2018,47473,44941,2532,5.3
12,19,Clay,2018,105747,102183,3564,3.4
12,21,Collier,2018,177597,171332,6265,3.5
12,23,Columbia,2018,29398,28267,1131,3.8
12,27,DeSoto,2018,13699,13148,551,4.0
12,29,Dixie,2018,5775,5528,247,4.3
12,31,Duval,2018,483192,465411,17781,3.7
12,33,Escambia,2018,142974,137755,5219,3.7
12,35,Flagler,2018,46622,44670,1952,4.2
12,37,Franklin,2018,4722,4554,168,3.6
12,39,Gadsden,2018,18364,17511,853,4.6
12,41,Gilchrist,2018,7023,6754,269,3.8
12,43,Glades,2018,5224,5014,210,4.0
12,45,Gulf,2018,5993,5720,273,4.6
12,47,Hamilton,2018,4368,4182,186,4.3
12,49,Hardee,2018,8802,8334,468,5.3
12,51,Hendry,2018,15618,14643,975,6.2
12,53,Hernando,2018,70594,67324,3270,4.6
12,55,Highlands,2018,36460,34656,1804,4.9
12,57,Hillsborough,2018,735930,710408,25522,3.5
12,59,Holmes,2018,6880,6603,277,4.0
12,61,Indian River,2018,64901,62044,2857,4.4
12,63,Jackson,2018,17227,16524,703,4.1
12,65,Jefferson,2018,5567,5352,215,3.9
12,67,Lafayette,2018,2825,2729,96,3.4
12,69,Lake,2018,155447,149808,5639,3.6
12,71,Lee,2018,341068,329120,11948,3.5
12,73,Leon,2018,153810,148505,5305,3.4
12,75,Levy,2018,16802,16136,666,4.0
12,77,Liberty,2018,2612,2508,104,4.0
12,79,Madison,2018,7286,6996,290,4.0
12,81,Manatee,2018,177921,171719,6202,3.5
12,83,Marion,2018,135674,129708,5966,4.4
12,85,Martin,2018,72805,70174,2631,3.6
12,86,Miami-Dade,2018,1354308,1302089,52219,3.9
12,87,Monroe,2018,45085,43910,1175,2.6
12,89,Nassau,2018,40474,39148,1326,3.3
12,91,Okaloosa,2018,95191,92280,2911,3.1
12,93,Okeechobee,2018,17700,17031,669,3.8
12,95,Orange,2018,745904,721325,24579,3.3
12,97,Osceola,2018,180485,173744,6741,3.7
12,99,Palm Beach,2018,726479,699897,26582,3.7
12,101,Pasco,2018,233371,224188,9183,3.9
12,103,Pinellas,2018,484718,468312,16406,3.4
12,105,Polk,2018,298622,286050,12572,4.2
12,107,Putnam,2018,26735,25410,1325,5.0
12,109,St. Johns,2018,130054,126213,3841,3.0
12,111,St. Lucie,2018,142627,136218,6409,4.5
12,113,Santa Rosa,2018,81273,78518,2755,3.4
12,115,Sarasota,2018,187032,180552,6480,3.5
12,117,Seminole,2018,249994,241785,8209,3.3
12,119,Sumter,2018,31299,29657,1642,5.2
12,121,Suwannee,2018,18158,17474,684,3.8
12,123,Taylor,2018,8652,8316,336,3.9
12,125,Union,2018,4610,4458,152,3.3
12,127,Volusia,2018,252558,242874,9684,3.8
12,129,Wakulla,2018,14730,14258,472,3.2
12,131,Walton,2018,30984,29992,992,3.2
12,133,Washington,2018,9749,9365,384,3.9
13,1,Appling,2018,9070,8673,397,4.4
13,3,Atkinson,2018,4365,4209,156,3.6
13,5,Bacon,2018,5043,4849,194,3.8
13,7,Baker,2018,1166,1104,62,5.3
13,9,Baldwin,2018,17716,16826,890,5.0
13,11,Banks,2018,9561,9255,306,3.2
13,13,Barrow,2018,40197,38853,1344,3.3
13,15,Bartow,2018,50334,48395,1939,3.9
13,17,Ben Hill,2018,5495,5167,328,6.0
13,19,Berrien,2018,7486,7169,317,4.2
13,21,Bibb,2018,69251,66068,3183,4.6
13,23,Bleckley,2018,4623,4352,271,5.9
13,25,Brantley,2018,7384,7048,336,4.6
13,27,Brooks,2018,6980,6700,280,4.0
13,29,Bryan,2018,18366,17736,630,3.4
13,31,Bulloch,2018,37154,35544,1610,4.3
13,33,Burke,2018,9287,8713,574,6.2
13,35,Butts,2018,10716,10272,444,4.1
13,37,Calhoun,2018,2249,2153,96,4.3
13,39,Camden,2018,20955,20062,893,4.3
13,43,Candler,2018,5359,5173,186,3.5
13,45,Carroll,2018,55063,52819,2244,4.1
13,47,Catoosa,2018,33547,32387,1160,3.5
13,49,Charlton,2018,4818,4606,212,4.4
13,51,Chatham,2018,140342,135020,5322,3.8
13,53,Chattahoochee,2018,2040,1926,114,5.6
13,55,Chattooga,2018,10518,10082,436,4.1
13,57,Cherokee,2018,135162,130875,4287,3.2
13,59,Clarke,2018,60985,58519,2466,4.0
13,61,Clay,2018,851,786,65,7.6
13,63,Clayton,2018,137491,130639,6852,5.0
13,65,Clinch,2018,2768,2641,127,4.6
13,67,Cobb,2018,423381,408648,14733,3.5
13,69,Coffee,2018,18866,18005,861,4.6
13,71,Colquitt,2018,21583,20760,823,3.8
13,73,Columbia,2018,75852,73178,2674,3.5
13,75,Cook,2018,7864,7563,301,3.8
13,77,Coweta,2018,74286,71690,2596,3.5
13,79,Crawford,2018,5706,5465,241,4.2
13,81,Crisp,2018,9420,8957,463,4.9
13,83,Dade,2018,8233,7928,305,3.7
13,85,Dawson,2018,12282,11867,415,3.4
13,87,Decatur,2018,11520,10974,546,4.7
13,89,DeKalb,2018,398301,381927,16374,4.1
13,91,Dodge,2018,7181,6803,378,5.3
13,93,Dooly,2018,5134,4891,243,4.7
13,95,Dougherty,2018,38689,36578,2111,5.5
13,97,Douglas,2018,73033,69955,3078,4.2
13,99,Early,2018,4545,4332,213,4.7
13,101,Echols,2018,1922,1860,62,3.2
13,103,Effingham,2018,31011,29983,1028,3.3
13,105,Elbert,2018,7850,7467,383,4.9
13,107,Emanuel,2018,8349,7847,502,6.0
13,109,Evans,2018,4917,4733,184,3.7
13,111,Fannin,2018,11314,10858,456,4.0
13,113,Fayette,2018,57745,55695,2050,3.6
13,115,Floyd,2018,44477,42542,1935,4.4
13,117,Forsyth,2018,121485,117584,3901,3.2
13,119,Franklin,2018,10048,9656,392,3.9
13,121,Fulton,2018,555178,532352,22826,4.1
13,123,Gilmer,2018,12017,11504,513,4.3
13,125,Glascock,2018,1290,1236,54,4.2
13,127,Glynn,2018,40034,38531,1503,3.8
13,129,Gordon,2018,27566,26485,1081,3.9
13,131,Grady,2018,10669,10252,417,3.9
13,133,Greene,2018,7054,6748,306,4.3
13,135,Gwinnett,2018,487901,470425,17476,3.6
13,137,Habersham,2018,19461,18722,739,3.8
13,139,Hall,2018,102283,98957,3326,3.3
13,141,Hancock,2018,2475,2325,150,6.1
13,143,Haralson,2018,12521,12030,491,3.9
13,145,Harris,2018,16908,16323,585,3.5
13,147,Hart,2018,11748,11313,435,3.7
13,149,Heard,2018,5230,5024,206,3.9
13,151,Henry,2018,115072,110238,4834,4.2
13,153,Houston,2018,70350,67476,2874,4.1
13,155,Irwin,2018,3330,3139,191,5.7
13,157,Jackson,2018,36442,35302,1140,3.1
13,159,Jasper,2018,6908,6662,246,3.6
13,161,Jeff Davis,2018,6093,5793,300,4.9
13,163,Jefferson,2018,6727,6364,363,5.4
13,165,Jenkins,2018,3188,3015,173,5.4
13,167,Johnson,2018,4106,3942,164,4.0
13,169,Jones,2018,13939,13422,517,3.7
13,171,Lamar,2018,8230,7843,387,4.7
13,173,Lanier,2018,3799,3627,172,4.5
13,175,Laurens,2018,19491,18540,951,4.9
13,177,Lee,2018,14834,14295,539,3.6
13,179,Liberty,2018,25910,24786,1124,4.3
13,181,Lincoln,2018,3608,3427,181,5.0
13,183,Long,2018,8066,7741,325,4.0
13,185,Lowndes,2018,51885,49739,2146,4.1
13,187,Lumpkin,2018,16749,16143,606,3.6
13,189,McDuffie,2018,8941,8435,506,5.7
13,191,McIntosh,2018,6267,6013,254,4.1
13,193,Macon,2018,4710,4413,297,6.3
13,195,Madison,2018,13710,13218,492,3.6
13,197,Marion,2018,3378,3201,177,5.2
13,199,Meriwether,2018,8884,8432,452,5.1
13,201,Miller,2018,2776,2672,104,3.7
13,205,Mitchell,2018,8389,7929,460,5.5
13,207,Monroe,2018,13218,12728,490,3.7
13,209,Montgomery,2018,3868,3642,226,5.8
13,211,Morgan,2018,9209,8875,334,3.6
13,213,Murray,2018,16027,15164,863,5.4
13,215,Muscogee,2018,78950,74861,4089,5.2
13,217,Newton,2018,52056,49687,2369,4.6
13,219,Oconee,2018,20121,19516,605,3.0
13,221,Oglethorpe,2018,7138,6870,268,3.8
13,223,Paulding,2018,85545,82555,2990,3.5
13,225,Peach,2018,11884,11259,625,5.3
13,227,Pickens,2018,15219,14671,548,3.6
13,229,Pierce,2018,8739,8403,336,3.8
13,231,Pike,2018,8875,8551,324,3.7
13,233,Polk,2018,18581,17788,793,4.3
13,235,Pulaski,2018,4046,3867,179,4.4
13,237,Putnam,2018,8274,7856,418,5.1
13,239,Quitman,2018,827,780,47,5.7
13,241,Rabun,2018,7133,6843,290,4.1
13,243,Randolph,2018,2487,2347,140,5.6
13,245,Richmond,2018,86102,81560,4542,5.3
13,247,Rockdale,2018,44645,42642,2003,4.5
13,249,Schley,2018,2200,2097,103,4.7
13,251,Screven,2018,5295,5005,290,5.5
13,253,Seminole,2018,3049,2884,165,5.4
13,255,Spalding,2018,28631,27259,1372,4.8
13,257,Stephens,2018,10974,10464,510,4.6
13,259,Stewart,2018,2371,2255,116,4.9
13,261,Sumter,2018,12727,11959,768,6.0
13,263,Talbot,2018,2839,2694,145,5.1
13,265,Taliaferro,2018,570,539,31,5.4
13,267,Tattnall,2018,9701,9287,414,4.3
13,269,Taylor,2018,2789,2606,183,6.6
13,271,Telfair,2018,4368,4070,298,6.8
13,273,Terrell,2018,3581,3338,243,6.8
13,275,Thomas,2018,16910,16105,805,4.8
13,277,Tift,2018,19384,18597,787,4.1
13,279,Toombs,2018,11891,11189,702,5.9
13,281,Towns,2018,3919,3696,223,5.7
13,283,Treutlen,2018,2713,2553,160,5.9
13,285,Troup,2018,36732,35358,1374,3.7
13,287,Turner,2018,3181,3018,163,5.1
13,289,Twiggs,2018,2929,2753,176,6.0
13,291,Union,2018,10347,9962,385,3.7
13,293,Upson,2018,11392,10884,508,4.5
13,295,Walker,2018,31344,30116,1228,3.9
13,297,Walton,2018,45815,44154,1661,3.6
13,299,Ware,2018,15602,14981,621,4.0
13,301,Warren,2018,2759,2621,138,5.0
13,303,Washington,2018,7161,6797,364,5.1
13,305,Wayne,2018,11419,10879,540,4.7
13,307,Webster,2018,1000,937,63,6.3
13,309,Wheeler,2018,1671,1546,125,7.5
13,311,White,2018,16189,15689,500,3.1
13,313,Whitfield,2018,45093,42911,2182,4.8
13,315,Wilcox,2018,2686,2543,143,5.3
13,317,Wilkes,2018,3831,3650,181,4.7
13,319,Wilkinson,2018,3850,3677,173,4.5
13,321,Worth,2018,8964,8559,405,4.5
15,1,Hawaii,2018,92425,89795,2630,2.8
15,3,Honolulu/city,2018,458079,447676,10403,2.3
15,7,Kauai,2018,36599,35725,874,2.4
15,9,Maui,2018,88084,86053,2031,2.3
16,1,Ada,2018,244253,238271,5982,2.4
16,3,Adams,2018,1714,1622,92,5.4
16,5,Bannock,2018,41643,40514,1129,2.7
16,7,Bear Lake,2018,2850,2770,80,2.8
16,9,Benewah,2018,4005,3826,179,4.5
16,11,Bingham,2018,23251,22627,624,2.7
16,13,Blaine,2018,12309,12020,289,2.3
16,15,Boise,2018,3379,3239,140,4.1
16,17,Bonner,2018,19620,18827,793,4.0
16,19,Bonneville,2018,55083,53773,1310,2.4
16,21,Boundary,2018,5249,5022,227,4.3
16,23,Butte,2018,1360,1316,44,3.2
16,25,Camas,2018,687,671,16,2.3
16,27,Canyon,2018,100397,97322,3075,3.1
16,29,Caribou,2018,3863,3757,106,2.7
16,31,Cassia,2018,11759,11501,258,2.2
16,33,Clark,2018,380,369,11,2.9
16,35,Clearwater,2018,2905,2711,194,6.7
16,37,Custer,2018,2178,2092,86,3.9
16,39,Elmore,2018,11374,11007,367,3.2
16,41,Franklin,2018,6858,6712,146,2.1
16,43,Fremont,2018,7760,7575,185,2.4
16,45,Gem,2018,8033,7759,274,3.4
16,47,Gooding,2018,8079,7888,191,2.4
16,49,Idaho,2018,6414,6120,294,4.6
16,51,Jefferson,2018,13582,13279,303,2.2
16,53,Jerome,2018,11951,11652,299,2.5
16,55,Kootenai,2018,77564,74900,2664,3.4
16,57,Latah,2018,20143,19650,493,2.4
16,59,Lemhi,2018,3498,3345,153,4.4
16,61,Lewis,2018,1615,1526,89,5.5
16,63,Lincoln,2018,2699,2608,91,3.4
16,65,Madison,2018,21602,21236,366,1.7
16,67,Minidoka,2018,11010,10738,272,2.5
16,69,Nez Perce,2018,20914,20347,567,2.7
16,71,Oneida,2018,2326,2276,50,2.1
16,73,Owyhee,2018,5397,5205,192,3.6
16,75,Payette,2018,11524,11116,408,3.5
16,77,Power,2018,4071,3954,117,2.9
16,79,Shoshone,2018,5055,4769,286,5.7
16,81,Teton,2018,6396,6254,142,2.2
16,83,Twin Falls,2018,40572,39492,1080,2.7
16,85,Valley,2018,5335,5137,198,3.7
16,87,Washington,2018,4615,4428,187,4.1
17,1,Adams,2018,32983,31725,1258,3.8
17,3,Alexander,2018,2074,1906,168,8.1
17,5,Bond,2018,7821,7483,338,4.3
17,7,Boone,2018,26669,25154,1515,5.7
17,9,Brown,2018,2890,2815,75,2.6
17,11,Bureau,2018,17540,16678,862,4.9
17,13,Calhoun,2018,2332,2212,120,5.1
17,15,Carroll,2018,7496,7165,331,4.4
17,17,Cass,2018,6135,5862,273,4.4
17,19,Champaign,2018,108895,104263,4632,4.3
17,21,Christian,2018,14809,14037,772,5.2
17,23,Clark,2018,7833,7417,416,5.3
17,25,Clay,2018,6697,6350,347,5.2
17,27,Clinton,2018,20494,19772,722,3.5
17,29,Coles,2018,24262,23132,1130,4.7
17,31,Cook,2018,2605439,2495786,109653,4.2
17,33,Crawford,2018,8746,8280,466,5.3
17,35,Cumberland,2018,6117,5874,243,4.0
17,37,DeKalb,2018,55377,52961,2416,4.4
17,39,De Witt,2018,7588,7208,380,5.0
17,41,Douglas,2018,10340,9924,416,4.0
17,43,DuPage,2018,509362,492794,16568,3.3
17,45,Edgar,2018,9317,8876,441,4.7
17,47,Edwards,2018,2792,2663,129,4.6
17,49,Effingham,2018,19237,18526,711,3.7
17,51,Fayette,2018,9825,9318,507,5.2
17,53,Ford,2018,6486,6184,302,4.7
17,55,Franklin,2018,16936,15902,1034,6.1
17,57,Fulton,2018,15308,14370,938,6.1
17,59,Gallatin,2018,2455,2310,145,5.9
17,61,Greene,2018,6030,5739,291,4.8
17,63,Grundy,2018,25544,24299,1245,4.9
17,65,Hamilton,2018,4487,4292,195,4.3
17,67,Hancock,2018,8519,8124,395,4.6
17,69,Hardin,2018,1334,1235,99,7.4
17,71,Henderson,2018,3666,3489,177,4.8
17,73,Henry,2018,25089,23845,1244,5.0
17,75,Iroquois,2018,14511,13871,640,4.4
17,77,Jackson,2018,28121,26861,1260,4.5
17,79,Jasper,2018,4624,4396,228,4.9
17,81,Jefferson,2018,17807,16882,925,5.2
17,83,Jersey,2018,11014,10486,528,4.8
17,85,Jo Daviess,2018,11072,10597,475,4.3
17,87,Johnson,2018,4128,3818,310,7.5
17,89,Kane,2018,274586,261262,13324,4.9
17,91,Kankakee,2018,55668,52635,3033,5.4
17,93,Kendall,2018,68771,66277,2494,3.6
17,95,Knox,2018,22214,21052,1162,5.2
17,97,Lake,2018,378390,361435,16955,4.5
17,99,LaSalle,2018,56215,53001,3214,5.7
17,101,Lawrence,2018,6037,5664,373,6.2
17,103,Lee,2018,17959,17183,776,4.3
17,105,Livingston,2018,16700,15981,719,4.3
17,107,Logan,2018,12930,12332,598,4.6
17,109,McDonough,2018,13403,12745,658,4.9
17,111,McHenry,2018,166100,160053,6047,3.6
17,113,McLean,2018,89230,85567,3663,4.1
17,115,Macon,2018,50032,47275,2757,5.5
17,117,Macoupin,2018,23111,21991,1120,4.8
17,119,Madison,2018,134755,128719,6036,4.5
17,121,Marion,2018,17901,17032,869,4.9
17,123,Marshall,2018,5448,5163,285,5.2
17,125,Mason,2018,6330,5956,374,5.9
17,127,Massac,2018,5731,5336,395,6.9
17,129,Menard,2018,6541,6276,265,4.1
17,131,Mercer,2018,8135,7712,423,5.2
17,133,Monroe,2018,18815,18174,641,3.4
17,135,Montgomery,2018,11931,11235,696,5.8
17,137,Morgan,2018,16406,15687,719,4.4
17,139,Moultrie,2018,7532,7249,283,3.8
17,141,Ogle,2018,25523,24263,1260,4.9
17,143,Peoria,2018,86662,81873,4789,5.5
17,145,Perry,2018,8477,7976,501,5.9
17,147,Piatt,2018,8631,8271,360,4.2
17,149,Pike,2018,7237,6891,346,4.8
17,151,Pope,2018,1765,1659,106,6.0
17,153,Pulaski,2018,2078,1912,166,8.0
17,155,Putnam,2018,3048,2889,159,5.2
17,157,Randolph,2018,14232,13613,619,4.3
17,159,Richland,2018,7523,7176,347,4.6
17,161,Rock Island,2018,71546,67843,3703,5.2
17,163,St. Clair,2018,127125,120764,6361,5.0
17,165,Saline,2018,9883,9249,634,6.4
17,167,Sangamon,2018,101666,97195,4471,4.4
17,169,Schuyler,2018,3345,3199,146,4.4
17,171,Scott,2018,2486,2358,128,5.1
17,173,Shelby,2018,10759,10304,455,4.2
17,175,Stark,2018,2595,2434,161,6.2
17,177,Stephenson,2018,22224,21196,1028,4.6
17,179,Tazewell,2018,65086,61944,3142,4.8
17,181,Union,2018,7468,6992,476,6.4
17,183,Vermilion,2018,33666,31613,2053,6.1
17,185,Wabash,2018,5825,5539,286,4.9
17,187,Warren,2018,8732,8370,362,4.1
17,189,Washington,2018,9892,9603,289,2.9
17,191,Wayne,2018,6925,6545,380,5.5
17,193,White,2018,6738,6452,286,4.2
17,195,Whiteside,2018,28659,27379,1280,4.5
17,197,Will,2018,358318,343223,15095,4.2
17,199,Williamson,2018,32205,30585,1620,5.0
17,201,Winnebago,2018,141687,133700,7987,5.6
17,203,Woodford,2018,19120,18346,774,4.0
18,1,Adams,2018,17476,17028,448,2.6
18,3,Allen,2018,184463,178717,5746,3.1
18,5,Bartholomew,2018,45083,43914,1169,2.6
18,7,Benton,2018,4557,4412,145,3.2
18,9,Blackford,2018,5315,5114,201,3.8
18,11,Boone,2018,36161,35199,962,2.7
18,13,Brown,2018,7685,7445,240,3.1
18,15,Carroll,2018,10215,9886,329,3.2
18,17,Cass,2018,18235,17575,660,3.6
18,19,Clark,2018,61812,59731,2081,3.4
18,21,Clay,2018,12311,11839,472,3.8
18,23,Clinton,2018,17166,16689,477,2.8
18,25,Crawford,2018,4944,4726,218,4.4
18,27,Daviess,2018,16495,16056,439,2.7
18,29,Dearborn,2018,25845,24917,928,3.6
18,31,Decatur,2018,14931,14493,438,2.9
18,33,DeKalb,2018,22478,21852,626,2.8
18,35,Delaware,2018,54080,51944,2136,3.9
18,37,Dubois,2018,23312,22745,567,2.4
18,39,Elkhart,2018,115910,112958,2952,2.5
18,41,Fayette,2018,9143,8727,416,4.5
18,43,Floyd,2018,41765,40412,1353,3.2
18,45,Fountain,2018,8086,7799,287,3.5
18,47,Franklin,2018,11388,10974,414,3.6
18,49,Fulton,2018,9989,9660,329,3.3
18,51,Gibson,2018,19411,18904,507,2.6
18,53,Grant,2018,32132,30920,1212,3.8
18,55,Greene,2018,13721,13126,595,4.3
18,57,Hamilton,2018,182844,177985,4859,2.7
18,59,Hancock,2018,40096,38903,1193,3.0
18,61,Harrison,2018,20393,19702,691,3.4
18,63,Hendricks,2018,89502,86961,2541,2.8
18,65,Henry,2018,22395,21624,771,3.4
18,67,Howard,2018,37382,35880,1502,4.0
18,69,Huntington,2018,18359,17721,638,3.5
18,71,Jackson,2018,22799,22161,638,2.8
18,73,Jasper,2018,16451,15817,634,3.9
18,75,Jay,2018,9767,9450,317,3.2
18,77,Jefferson,2018,15093,14587,506,3.4
18,79,Jennings,2018,13585,13100,485,3.6
18,81,Johnson,2018,82587,80249,2338,2.8
18,83,Knox,2018,18833,18248,585,3.1
18,85,Kosciusko,2018,42699,41597,1102,2.6
18,87,LaGrange,2018,20627,20121,506,2.5
18,89,Lake,2018,231511,220267,11244,4.9
18,91,LaPorte,2018,48023,45966,2057,4.3
18,93,Lawrence,2018,21106,20309,797,3.8
18,95,Madison,2018,58916,56656,2260,3.8
18,97,Marion,2018,488185,471374,16811,3.4
18,99,Marshall,2018,23342,22616,726,3.1
18,101,Martin,2018,5213,5072,141,2.7
18,103,Miami,2018,15813,15190,623,3.9
18,105,Monroe,2018,69481,67024,2457,3.5
18,107,Montgomery,2018,19087,18519,568,3.0
18,109,Morgan,2018,36244,35035,1209,3.3
18,111,Newton,2018,7046,6746,300,4.3
18,113,Noble,2018,23630,22950,680,2.9
18,115,Ohio,2018,3186,3076,110,3.5
18,117,Orange,2018,8560,8233,327,3.8
18,119,Owen,2018,9326,8927,399,4.3
18,121,Parke,2018,7143,6862,281,3.9
18,123,Perry,2018,9320,8982,338,3.6
18,125,Pike,2018,6130,5920,210,3.4
18,127,Porter,2018,87272,83998,3274,3.8
18,129,Posey,2018,13703,13324,379,2.8
18,131,Pulaski,2018,6501,6304,197,3.0
18,133,Putnam,2018,16750,16128,622,3.7
18,135,Randolph,2018,11601,11157,444,3.8
18,137,Ripley,2018,14091,13594,497,3.5
18,139,Rush,2018,9030,8776,254,2.8
18,141,St. Joseph,2018,136348,131584,4764,3.5
18,143,Scott,2018,10611,10206,405,3.8
18,145,Shelby,2018,23074,22368,706,3.1
18,147,Spencer,2018,10969,10616,353,3.2
18,149,Starke,2018,10396,9950,446,4.3
18,151,Steuben,2018,20299,19768,531,2.6
18,153,Sullivan,2018,8585,8192,393,4.6
18,155,Switzerland,2018,5067,4873,194,3.8
18,157,Tippecanoe,2018,98039,94973,3066,3.1
18,159,Tipton,2018,9228,8975,253,2.7
18,161,Union,2018,3560,3450,110,3.1
18,163,Vanderburgh,2018,94940,91979,2961,3.1
18,165,Vermillion,2018,7149,6762,387,5.4
18,167,Vigo,2018,49059,46946,2113,4.3
18,169,Wabash,2018,14977,14469,508,3.4
18,171,Warren,2018,4203,4070,133,3.2
18,173,Warrick,2018,33182,32225,957,2.9
18,175,Washington,2018,13817,13337,480,3.5
18,177,Wayne,2018,31228,30128,1100,3.5
18,179,Wells,2018,14385,13987,398,2.8
18,181,White,2018,13670,13259,411,3.0
18,183,Whitley,2018,17657,17159,498,2.8
19,1,Adair,2018,4162,4061,101,2.4
19,3,Adams,2018,2132,2089,43,2.0
19,5,Allamakee,2018,7422,7189,233,3.1
19,7,Appanoose,2018,5927,5725,202,3.4
19,9,Audubon,2018,3110,3032,78,2.5
19,11,Benton,2018,13425,13051,374,2.8
19,13,Black Hawk,2018,68990,67012,1978,2.9
19,15,Boone,2018,14940,14612,328,2.2
19,17,Bremer,2018,13897,13606,291,2.1
19,19,Buchanan,2018,11294,10997,297,2.6
19,21,Buena Vista,2018,11618,11368,250,2.2
19,23,Butler,2018,7870,7648,222,2.8
19,25,Calhoun,2018,4312,4201,111,2.6
19,27,Carroll,2018,10890,10682,208,1.9
19,29,Cass,2018,7151,6956,195,2.7
19,31,Cedar,2018,10854,10584,270,2.5
19,33,Cerro Gordo,2018,23444,22817,627,2.7
19,35,Cherokee,2018,6022,5890,132,2.2
19,37,Chickasaw,2018,6459,6281,178,2.8
19,39,Clarke,2018,4848,4707,141,2.9
19,41,Clay,2018,8583,8301,282,3.3
19,43,Clayton,2018,10210,9878,332,3.3
19,45,Clinton,2018,22818,22067,751,3.3
19,47,Crawford,2018,8220,7933,287,3.5
19,49,Dallas,2018,48973,48109,864,1.8
19,51,Davis,2018,4239,4122,117,2.8
19,53,Decatur,2018,4360,4259,101,2.3
19,55,Delaware,2018,10502,10279,223,2.1
19,57,Des Moines,2018,19567,18910,657,3.4
19,59,Dickinson,2018,9907,9585,322,3.3
19,61,Dubuque,2018,55692,54310,1382,2.5
19,63,Emmet,2018,5333,5183,150,2.8
19,65,Fayette,2018,10584,10262,322,3.0
19,67,Floyd,2018,8882,8637,245,2.8
19,69,Franklin,2018,5817,5691,126,2.2
19,71,Fremont,2018,3741,3669,72,1.9
19,73,Greene,2018,5426,5300,126,2.3
19,75,Grundy,2018,6548,6381,167,2.6
19,77,Guthrie,2018,5575,5426,149,2.7
19,79,Hamilton,2018,6992,6799,193,2.8
19,81,Hancock,2018,6010,5867,143,2.4
19,83,Hardin,2018,8298,8056,242,2.9
19,85,Harrison,2018,7303,7136,167,2.3
19,87,Henry,2018,9781,9534,247,2.5
19,89,Howard,2018,5220,5085,135,2.6
19,91,Humboldt,2018,5225,5091,134,2.6
19,93,Ida,2018,4119,4036,83,2.0
19,95,Iowa,2018,10495,10272,223,2.1
19,97,Jackson,2018,11017,10704,313,2.8
19,99,Jasper,2018,19482,18954,528,2.7
19,101,Jefferson,2018,9787,9561,226,2.3
19,103,Johnson,2018,86247,84538,1709,2.0
19,105,Jones,2018,10645,10319,326,3.1
19,107,Keokuk,2018,5183,5030,153,3.0
19,109,Kossuth,2018,8564,8386,178,2.1
19,111,Lee,2018,16064,15404,660,4.1
19,113,Linn,2018,121068,117617,3451,2.9
19,115,Louisa,2018,6094,5929,165,2.7
19,117,Lucas,2018,4522,4430,92,2.0
19,119,Lyon,2018,7030,6919,111,1.6
19,121,Madison,2018,8479,8203,276,3.3
19,123,Mahaska,2018,11777,11478,299,2.5
19,125,Marion,2018,17993,17614,379,2.1
19,127,Marshall,2018,18157,17327,830,4.6
19,129,Mills,2018,7316,7159,157,2.1
19,131,Mitchell,2018,5958,5848,110,1.8
19,133,Monona,2018,4482,4356,126,2.8
19,135,Monroe,2018,3926,3808,118,3.0
19,137,Montgomery,2018,4960,4836,124,2.5
19,139,Muscatine,2018,21912,21315,597,2.7
19,141,O'Brien,2018,8162,7996,166,2.0
19,143,Osceola,2018,3542,3472,70,2.0
19,145,Page,2018,6435,6270,165,2.6
19,147,Palo Alto,2018,4894,4784,110,2.2
19,149,Plymouth,2018,14760,14471,289,2.0
19,151,Pocahontas,2018,4373,4292,81,1.9
19,153,Polk,2018,265798,258804,6994,2.6
19,155,Pottawattamie,2018,47979,46822,1157,2.4
19,157,Poweshiek,2018,10530,10276,254,2.4
19,159,Ringgold,2018,2542,2470,72,2.8
19,161,Sac,2018,5328,5200,128,2.4
19,163,Scott,2018,88126,85463,2663,3.0
19,165,Shelby,2018,6694,6557,137,2.0
19,167,Sioux,2018,20622,20245,377,1.8
19,169,Story,2018,58243,57290,953,1.6
19,171,Tama,2018,9548,9257,291,3.0
19,173,Taylor,2018,3257,3191,66,2.0
19,175,Union,2018,6413,6180,233,3.6
19,177,Van Buren,2018,3736,3634,102,2.7
19,179,Wapello,2018,17792,17165,627,3.5
19,181,Warren,2018,27968,27311,657,2.3
19,183,Washington,2018,12047,11754,293,2.4
19,185,Wayne,2018,2786,2708,78,2.8
19,187,Webster,2018,19287,18643,644,3.3
19,189,Winnebago,2018,5032,4899,133,2.6
19,191,Winneshiek,2018,11864,11540,324,2.7
19,193,Woodbury,2018,55366,53942,1424,2.6
19,195,Worth,2018,4194,4077,117,2.8
19,197,Wright,2018,6504,6331,173,2.7
20,1,Allen,2018,6348,6100,248,3.9
20,3,Anderson,2018,4130,3989,141,3.4
20,5,Atchison,2018,7023,6707,316,4.5
20,7,Barber,2018,2387,2328,59,2.5
20,9,Barton,2018,13562,13132,430,3.2
20,11,Bourbon,2018,7105,6814,291,4.1
20,13,Brown,2018,5380,5220,160,3.0
20,15,Butler,2018,32036,30957,1079,3.4
20,17,Chase,2018,1470,1432,38,2.6
20,19,Chautauqua,2018,1417,1362,55,3.9
20,21,Cherokee,2018,10058,9690,368,3.7
20,23,Cheyenne,2018,1313,1283,30,2.3
20,25,Clark,2018,1065,1040,25,2.3
20,27,Clay,2018,3794,3674,120,3.2
20,29,Cloud,2018,3794,3666,128,3.4
20,31,Coffey,2018,4094,3906,188,4.6
20,33,Comanche,2018,887,866,21,2.4
20,35,Cowley,2018,16835,16272,563,3.3
20,37,Crawford,2018,18806,18072,734,3.9
20,39,Decatur,2018,1255,1219,36,2.9
20,41,Dickinson,2018,9126,8813,313,3.4
20,43,Doniphan,2018,4159,4014,145,3.5
20,45,Douglas,2018,65375,63406,1969,3.0
20,47,Edwards,2018,1496,1461,35,2.3
20,49,Elk,2018,1172,1133,39,3.3
20,51,Ellis,2018,16952,16558,394,2.3
20,53,Ellsworth,2018,2691,2618,73,2.7
20,55,Finney,2018,20532,20033,499,2.4
20,57,Ford,2018,17296,16868,428,2.5
20,59,Franklin,2018,14054,13560,494,3.5
20,61,Geary,2018,11439,10910,529,4.6
20,63,Gove,2018,1421,1391,30,2.1
20,65,Graham,2018,1143,1108,35,3.1
20,67,Grant,2018,3349,3257,92,2.7
20,69,Gray,2018,3416,3349,67,2.0
20,71,Greeley,2018,859,842,17,2.0
20,73,Greenwood,2018,3241,3129,112,3.5
20,75,Hamilton,2018,1626,1595,31,1.9
20,77,Harper,2018,2742,2666,76,2.8
20,79,Harvey,2018,16783,16253,530,3.2
20,81,Haskell,2018,2198,2152,46,2.1
20,83,Hodgeman,2018,986,962,24,2.4
20,85,Jackson,2018,7205,6993,212,2.9
20,87,Jefferson,2018,10163,9841,322,3.2
20,89,Jewell,2018,1288,1253,35,2.7
20,91,Johnson,2018,336930,327350,9580,2.8
20,93,Kearny,2018,2087,2040,47,2.3
20,95,Kingman,2018,3403,3295,108,3.2
20,97,Kiowa,2018,1304,1273,31,2.4
20,99,Labette,2018,10220,9823,397,3.9
20,101,Lane,2018,791,769,22,2.8
20,103,Leavenworth,2018,36295,34993,1302,3.6
20,105,Lincoln,2018,1703,1662,41,2.4
20,107,Linn,2018,4419,4162,257,5.8
20,109,Logan,2018,1687,1652,35,2.1
20,111,Lyon,2018,16613,16038,575,3.5
20,113,McPherson,2018,16531,16121,410,2.5
20,115,Marion,2018,6039,5854,185,3.1
20,117,Marshall,2018,5487,5347,140,2.6
20,119,Meade,2018,2280,2234,46,2.0
20,121,Miami,2018,17409,16792,617,3.5
20,123,Mitchell,2018,3453,3378,75,2.2
20,125,Montgomery,2018,14783,14161,622,4.2
20,127,Morris,2018,3005,2925,80,2.7
20,129,Morton,2018,1170,1133,37,3.2
20,131,Nemaha,2018,5481,5357,124,2.3
20,133,Neosho,2018,5999,5714,285,4.8
20,135,Ness,2018,1336,1300,36,2.7
20,137,Norton,2018,2747,2689,58,2.1
20,139,Osage,2018,8033,7736,297,3.7
20,141,Osborne,2018,2045,1994,51,2.5
20,143,Ottawa,2018,3012,2928,84,2.8
20,145,Pawnee,2018,2913,2823,90,3.1
20,147,Phillips,2018,2777,2709,68,2.4
20,149,Pottawatomie,2018,12491,12153,338,2.7
20,151,Pratt,2018,4957,4825,132,2.7
20,153,Rawlins,2018,1476,1446,30,2.0
20,155,Reno,2018,29709,28657,1052,3.5
20,157,Republic,2018,2416,2352,64,2.6
20,159,Rice,2018,5293,5141,152,2.9
20,161,Riley,2018,35272,34281,991,2.8
20,163,Rooks,2018,2521,2442,79,3.1
20,165,Rush,2018,1654,1610,44,2.7
20,167,Russell,2018,3371,3274,97,2.9
20,169,Saline,2018,30284,29382,902,3.0
20,171,Scott,2018,2859,2804,55,1.9
20,173,Sedgwick,2018,247748,238570,9178,3.7
20,175,Seward,2018,9581,9278,303,3.2
20,177,Shawnee,2018,90853,87745,3108,3.4
20,179,Sheridan,2018,1423,1392,31,2.2
20,181,Sherman,2018,2898,2819,79,2.7
20,183,Smith,2018,1969,1921,48,2.4
20,185,Stafford,2018,1974,1923,51,2.6
20,187,Stanton,2018,1002,977,25,2.5
20,189,Stevens,2018,2602,2528,74,2.8
20,191,Sumner,2018,10761,10389,372,3.5
20,193,Thomas,2018,4273,4167,106,2.5
20,195,Trego,2018,1381,1339,42,3.0
20,197,Wabaunsee,2018,3666,3553,113,3.1
20,199,Wallace,2018,822,802,20,2.4
20,201,Washington,2018,2938,2860,78,2.7
20,203,Wichita,2018,1318,1291,27,2.0
20,205,Wilson,2018,4017,3845,172,4.3
20,207,Woodson,2018,1598,1530,68,4.3
20,209,Wyandotte,2018,77088,73411,3677,4.8
21,1,Adair,2018,7184,6838,346,4.8
21,3,Allen,2018,8905,8579,326,3.7
21,5,Anderson,2018,11890,11475,415,3.5
21,7,Ballard,2018,3527,3288,239,6.8
21,9,Barren,2018,19008,18189,819,4.3
21,11,Bath,2018,4600,4298,302,6.6
21,13,Bell,2018,8464,7949,515,6.1
21,15,Boone,2018,70547,68239,2308,3.3
21,17,Bourbon,2018,9677,9303,374,3.9
21,19,Boyd,2018,17893,16865,1028,5.7
21,21,Boyle,2018,12545,12004,541,4.3
21,23,Bracken,2018,3804,3623,181,4.8
21,25,Breathitt,2018,3610,3356,254,7.0
21,27,Breckinridge,2018,7932,7517,415,5.2
21,29,Bullitt,2018,42668,40998,1670,3.9
21,31,Butler,2018,5098,4854,244,4.8
21,33,Caldwell,2018,5377,5128,249,4.6
21,35,Calloway,2018,18717,18006,711,3.8
21,37,Campbell,2018,50439,48826,1613,3.2
21,39,Carlisle,2018,2253,2144,109,4.8
21,41,Carroll,2018,5242,5033,209,4.0
21,43,Carter,2018,9808,8929,879,9.0
21,45,Casey,2018,6703,6399,304,4.5
21,47,Christian,2018,24501,23226,1275,5.2
21,49,Clark,2018,17114,16429,685,4.0
21,51,Clay,2018,5203,4848,355,6.8
21,53,Clinton,2018,3861,3657,204,5.3
21,55,Crittenden,2018,3857,3664,193,5.0
21,57,Cumberland,2018,3115,2980,135,4.3
21,59,Daviess,2018,47396,45556,1840,3.9
21,61,Edmonson,2018,4804,4555,249,5.2
21,63,Elliott,2018,2045,1859,186,9.1
21,65,Estill,2018,5309,5028,281,5.3
21,67,Fayette,2018,174013,168398,5615,3.2
21,69,Fleming,2018,6070,5748,322,5.3
21,71,Floyd,2018,10895,10204,691,6.3
21,73,Franklin,2018,24950,24051,899,3.6
21,75,Fulton,2018,2028,1916,112,5.5
21,77,Gallatin,2018,4062,3902,160,3.9
21,79,Garrard,2018,7652,7320,332,4.3
21,81,Grant,2018,11682,11195,487,4.2
21,83,Graves,2018,15439,14689,750,4.9
21,85,Grayson,2018,10940,10420,520,4.8
21,87,Green,2018,5072,4863,209,4.1
21,89,Greenup,2018,13407,12548,859,6.4
21,91,Hancock,2018,3988,3824,164,4.1
21,93,Hardin,2018,48853,46913,1940,4.0
21,95,Harlan,2018,6527,6063,464,7.1
21,97,Harrison,2018,8637,8290,347,4.0
21,99,Hart,2018,8036,7724,312,3.9
21,101,Henderson,2018,21961,21145,816,3.7
21,103,Henry,2018,8214,7907,307,3.7
21,105,Hickman,2018,1791,1692,99,5.5
21,107,Hopkins,2018,18364,17543,821,4.5
21,109,Jackson,2018,4083,3805,278,6.8
21,111,Jefferson,2018,399534,383850,15684,3.9
21,113,Jessamine,2018,26417,25483,934,3.5
21,115,Johnson,2018,6748,6302,446,6.6
21,117,Kenton,2018,87238,84322,2916,3.3
21,119,Knott,2018,4397,4106,291,6.6
21,121,Knox,2018,9982,9372,610,6.1
21,123,Larue,2018,5967,5708,259,4.3
21,125,Laurel,2018,24767,23537,1230,5.0
21,127,Lawrence,2018,5054,4699,355,7.0
21,129,Lee,2018,2080,1950,130,6.3
21,131,Leslie,2018,2615,2435,180,6.9
21,133,Letcher,2018,6238,5849,389,6.2
21,135,Lewis,2018,4691,4310,381,8.1
21,137,Lincoln,2018,9330,8874,456,4.9
21,139,Livingston,2018,3659,3418,241,6.6
21,141,Logan,2018,12400,11935,465,3.8
21,143,Lyon,2018,3045,2896,149,4.9
21,145,McCracken,2018,29127,27544,1583,5.4
21,147,McCreary,2018,4623,4341,282,6.1
21,149,McLean,2018,4226,4022,204,4.8
21,151,Madison,2018,46826,45072,1754,3.7
21,153,Magoffin,2018,2918,2553,365,12.5
21,155,Marion,2018,9623,9273,350,3.6
21,157,Marshall,2018,14930,14161,769,5.2
21,159,Martin,2018,2791,2618,173,6.2
21,161,Mason,2018,7167,6781,386,5.4
21,163,Meade,2018,12230,11675,555,4.5
21,165,Menifee,2018,2312,2141,171,7.4
21,167,Mercer,2018,9888,9462,426,4.3
21,169,Metcalfe,2018,4110,3943,167,4.1
21,171,Monroe,2018,4690,4500,190,4.1
21,173,Montgomery,2018,11646,10973,673,5.8
21,175,Morgan,2018,4465,4189,276,6.2
21,177,Muhlenberg,2018,10524,9838,686,6.5
21,179,Nelson,2018,22670,21720,950,4.2
21,181,Nicholas,2018,3278,3131,147,4.5
21,183,Ohio,2018,9849,9304,545,5.5
21,185,Oldham,2018,33242,32185,1057,3.2
21,187,Owen,2018,5198,4949,249,4.8
21,189,Owsley,2018,1135,1054,81,7.1
21,191,Pendleton,2018,6975,6695,280,4.0
21,193,Perry,2018,8144,7647,497,6.1
21,195,Pike,2018,19945,18808,1137,5.7
21,197,Powell,2018,5007,4718,289,5.8
21,199,Pulaski,2018,25969,24702,1267,4.9
21,201,Robertson,2018,800,762,38,4.8
21,203,Rockcastle,2018,6624,6304,320,4.8
21,205,Rowan,2018,10509,9980,529,5.0
21,207,Russell,2018,6266,5914,352,5.6
21,209,Scott,2018,28907,27977,930,3.2
21,211,Shelby,2018,25440,24589,851,3.3
21,213,Simpson,2018,8842,8503,339,3.8
21,215,Spencer,2018,10197,9840,357,3.5
21,217,Taylor,2018,12529,12017,512,4.1
21,219,Todd,2018,5291,5086,205,3.9
21,221,Trigg,2018,5898,5621,277,4.7
21,223,Trimble,2018,3863,3703,160,4.1
21,225,Union,2018,5999,5710,289,4.8
21,227,Warren,2018,64479,62170,2309,3.6
21,229,Washington,2018,6130,5912,218,3.6
21,231,Wayne,2018,7562,7051,511,6.8
21,233,Webster,2018,5769,5532,237,4.1
21,235,Whitley,2018,13717,13046,671,4.9
21,237,Wolfe,2018,1896,1755,141,7.4
21,239,Woodford,2018,14738,14295,443,3.0
22,1,Acadia Parish,2018,24011,22736,1275,5.3
22,3,Allen Parish,2018,8803,8309,494,5.6
22,5,Ascension Parish,2018,64513,61895,2618,4.1
22,7,Assumption Parish,2018,9002,8410,592,6.6
22,9,Avoyelles Parish,2018,15376,14511,865,5.6
22,11,Beauregard Parish,2018,14644,13874,770,5.3
22,13,Bienville Parish,2018,5663,5337,326,5.8
22,15,Bossier Parish,2018,58238,55785,2453,4.2
22,17,Caddo Parish,2018,104704,99017,5687,5.4
22,19,Calcasieu Parish,2018,110299,106122,4177,3.8
22,21,Caldwell Parish,2018,3850,3631,219,5.7
22,23,Cameron Parish,2018,4093,3950,143,3.5
22,25,Catahoula Parish,2018,3373,3148,225,6.7
22,27,Claiborne Parish,2018,5833,5534,299,5.1
22,29,Concordia Parish,2018,7031,6548,483,6.9
22,31,De Soto Parish,2018,10943,10324,619,5.7
22,33,East Baton Rouge Parish,2018,232338,222408,9930,4.3
22,35,East Carroll Parish,2018,1961,1762,199,10.1
22,37,East Feliciana Parish,2018,8046,7676,370,4.6
22,39,Evangeline Parish,2018,12146,11458,688,5.7
22,41,Franklin Parish,2018,7302,6785,517,7.1
22,43,Grant Parish,2018,8243,7770,473,5.7
22,45,Iberia Parish,2018,28403,26755,1648,5.8
22,47,Iberville Parish,2018,14204,13335,869,6.1
22,49,Jackson Parish,2018,6907,6591,316,4.6
22,51,Jefferson Parish,2018,214328,205032,9296,4.3
22,53,Jefferson Davis Parish,2018,13565,12929,636,4.7
22,55,Lafayette Parish,2018,114483,109435,5048,4.4
22,57,Lafourche Parish,2018,42279,40313,1966,4.7
22,59,LaSalle Parish,2018,6380,6106,274,4.3
22,61,Lincoln Parish,2018,22086,20956,1130,5.1
22,63,Livingston Parish,2018,69279,66522,2757,4.0
22,65,Madison Parish,2018,3624,3327,297,8.2
22,67,Morehouse Parish,2018,10202,9376,826,8.1
22,69,Natchitoches Parish,2018,16498,15546,952,5.8
22,71,Orleans Parish,2018,179210,170320,8890,5.0
22,73,Ouachita Parish,2018,71179,67554,3625,5.1
22,75,Plaquemines Parish,2018,10099,9636,463,4.6
22,77,Pointe Coupee Parish,2018,9954,9425,529,5.3
22,79,Rapides Parish,2018,55687,52782,2905,5.2
22,81,Red River Parish,2018,4066,3887,179,4.4
22,83,Richland Parish,2018,8349,7835,514,6.2
22,85,Sabine Parish,2018,9072,8608,464,5.1
22,87,St. Bernard Parish,2018,19890,18907,983,4.9
22,89,St. Charles Parish,2018,25166,24080,1086,4.3
22,91,St. Helena Parish,2018,4330,4050,280,6.5
22,93,St. James Parish,2018,9259,8689,570,6.2
22,95,St. John the Baptist Parish,2018,19676,18570,1106,5.6
22,97,St. Landry Parish,2018,32068,30090,1978,6.2
22,99,St. Martin Parish,2018,22374,21213,1161,5.2
22,101,St. Mary Parish,2018,20150,18848,1302,6.5
22,103,St. Tammany Parish,2018,119398,114463,4935,4.1
22,105,Tangipahoa Parish,2018,54757,51777,2980,5.4
22,107,Tensas Parish,2018,1451,1340,111,7.6
22,109,Terrebonne Parish,2018,46661,44358,2303,4.9
22,111,Union Parish,2018,9238,8725,513,5.6
22,113,Vermilion Parish,2018,24296,23020,1276,5.3
22,115,Vernon Parish,2018,15993,14967,1026,6.4
22,117,Washington Parish,2018,16897,15934,963,5.7
22,119,Webster Parish,2018,14656,13772,884,6.0
22,121,West Baton Rouge Parish,2018,13751,13151,600,4.4
22,123,West Carroll Parish,2018,4017,3661,356,8.9
22,125,West Feliciana Parish,2018,5413,5205,208,3.8
22,127,Winn Parish,2018,4973,4669,304,6.1
23,1,Androscoggin,2018,55452,53762,1690,3.0
23,3,Aroostook,2018,30963,29588,1375,4.4
23,5,Cumberland,2018,165283,161178,4105,2.5
23,7,Franklin,2018,14432,13899,533,3.7
23,9,Hancock,2018,29468,28443,1025,3.5
23,11,Kennebec,2018,62416,60542,1874,3.0
23,13,Knox,2018,20650,20043,607,2.9
23,15,Lincoln,2018,16993,16471,522,3.1
23,17,Oxford,2018,26712,25731,981,3.7
23,19,Penobscot,2018,76877,74206,2671,3.5
23,21,Piscataquis,2018,7465,7179,286,3.8
23,23,Sagadahoc,2018,19557,19068,489,2.5
23,25,Somerset,2018,22802,21788,1014,4.4
23,27,Waldo,2018,21197,20507,690,3.3
23,29,Washington,2018,13892,13258,634,4.6
23,31,York,2018,114111,110903,3208,2.8
24,1,Allegany,2018,32102,30386,1716,5.3
24,3,Anne Arundel,2018,313391,303258,10133,3.2
24,5,Baltimore,2018,451429,433700,17729,3.9
24,9,Calvert,2018,49753,48044,1709,3.4
24,11,Caroline,2018,18236,17561,675,3.7
24,13,Carroll,2018,95389,92394,2995,3.1
24,15,Cecil,2018,52869,50597,2272,4.3
24,17,Charles,2018,86671,83431,3240,3.7
24,19,Dorchester,2018,15549,14767,782,5.0
24,21,Frederick,2018,133753,129224,4529,3.4
24,23,Garrett,2018,15560,14842,718,4.6
24,25,Harford,2018,140156,135239,4917,3.5
24,27,Howard,2018,186463,181032,5431,2.9
24,29,Kent,2018,10332,9897,435,4.2
24,31,Montgomery,2018,556234,539139,17095,3.1
24,33,Prince George's,2018,506145,486102,20043,4.0
24,35,Queen Anne's,2018,27838,26936,902,3.2
24,37,St. Mary's,2018,55790,53728,2062,3.7
24,39,Somerset,2018,9218,8591,627,6.8
24,41,Talbot,2018,19700,18986,714,3.6
24,43,Washington,2018,74713,71527,3186,4.3
24,45,Wicomico,2018,50891,48269,2622,5.2
24,47,Worcester,2018,25441,23434,2007,7.9
24,510,Baltimore city,2018,287486,271497,15989,5.6
25,1,Barnstable,2018,114753,109673,5080,4.4
25,3,Berkshire,2018,64749,62023,2726,4.2
25,5,Bristol,2018,301250,288030,13220,4.4
25,7,Dukes,2018,9672,9213,459,4.7
25,9,Essex,2018,424956,409929,15027,3.5
25,11,Franklin,2018,40910,39635,1275,3.1
25,13,Hampden,2018,228742,217868,10874,4.8
25,15,Hampshire,2018,90133,87321,2812,3.1
25,17,Middlesex,2018,912730,887225,25505,2.8
25,19,Nantucket/town,2018,7504,7162,342,4.6
25,21,Norfolk,2018,387976,376073,11903,3.1
25,23,Plymouth,2018,281649,271476,10173,3.6
25,25,Suffolk,2018,452001,437973,14028,3.1
25,27,Worcester,2018,446142,429840,16302,3.7
26,1,Alcona,2018,3816,3565,251,6.6
26,3,Alger,2018,3216,2961,255,7.9
26,5,Allegan,2018,62058,60014,2044,3.3
26,7,Alpena,2018,13363,12677,686,5.1
26,9,Antrim,2018,10077,9505,572,5.7
26,11,Arenac,2018,5978,5553,425,7.1
26,13,Baraga,2018,3163,2969,194,6.1
26,15,Barry,2018,31700,30615,1085,3.4
26,17,Bay,2018,50440,48014,2426,4.8
26,19,Benzie,2018,8798,8311,487,5.5
26,21,Berrien,2018,73395,70227,3168,4.3
26,23,Branch,2018,19358,18636,722,3.7
26,25,Calhoun,2018,63165,60496,2669,4.2
26,27,Cass,2018,24482,23482,1000,4.1
26,29,Charlevoix,2018,13128,12499,629,4.8
26,31,Cheboygan,2018,10724,9734,990,9.2
26,33,Chippewa,2018,16260,15176,1084,6.7
26,35,Clare,2018,11827,11102,725,6.1
26,37,Clinton,2018,41173,39857,1316,3.2
26,39,Crawford,2018,5546,5213,333,6.0
26,41,Delta,2018,17056,16146,910,5.3
26,43,Dickinson,2018,12546,12065,481,3.8
26,45,Eaton,2018,57291,55287,2004,3.5
26,47,Emmet,2018,17720,16674,1046,5.9
26,49,Genesee,2018,180899,171926,8973,5.0
26,51,Gladwin,2018,9923,9362,561,5.7
26,53,Gogebic,2018,6204,5889,315,5.1
26,55,Grand Traverse,2018,49265,47434,1831,3.7
26,57,Gratiot,2018,17825,16993,832,4.7
26,59,Hillsdale,2018,20605,19771,834,4.0
26,61,Houghton,2018,16185,15356,829,5.1
26,63,Huron,2018,15474,14755,719,4.6
26,65,Ingham,2018,151439,145915,5524,3.6
26,67,Ionia,2018,29973,28933,1040,3.5
26,69,Iosco,2018,10088,9444,644,6.4
26,71,Iron,2018,5142,4854,288,5.6
26,73,Isabella,2018,34920,33564,1356,3.9
26,75,Jackson,2018,74607,71660,2947,4.0
26,77,Kalamazoo,2018,133879,129282,4597,3.4
26,79,Kalkaska,2018,7843,7380,463,5.9
26,81,Kent,2018,360369,349583,10786,3.0
26,83,Keweenaw,2018,883,821,62,7.0
26,85,Lake,2018,3639,3390,249,6.8
26,87,Lapeer,2018,41078,38928,2150,5.2
26,89,Leelanau,2018,10434,9987,447,4.3
26,91,Lenawee,2018,46911,44995,1916,4.1
26,93,Livingston,2018,103388,99965,3423,3.3
26,95,Luce,2018,2383,2234,149,6.3
26,97,Mackinac,2018,5209,4713,496,9.5
26,99,Macomb,2018,446890,428693,18197,4.1
26,101,Manistee,2018,10359,9756,603,5.8
26,103,Marquette,2018,32548,30949,1599,4.9
26,105,Mason,2018,13799,13121,678,4.9
26,107,Mecosta,2018,18504,17576,928,5.0
26,109,Menominee,2018,11010,10563,447,4.1
26,111,Midland,2018,40745,39120,1625,4.0
26,113,Missaukee,2018,6885,6531,354,5.1
26,115,Monroe,2018,76065,72871,3194,4.2
26,117,Montcalm,2018,28372,27160,1212,4.3
26,119,Montmorency,2018,3021,2756,265,8.8
26,121,Muskegon,2018,78136,74557,3579,4.6
26,123,Newaygo,2018,23221,22202,1019,4.4
26,125,Oakland,2018,674814,652061,22753,3.4
26,127,Oceana,2018,12052,11298,754,6.3
26,129,Ogemaw,2018,8220,7650,570,6.9
26,131,Ontonagon,2018,2099,1935,164,7.8
26,133,Osceola,2018,10908,10422,486,4.5
26,135,Oscoda,2018,2954,2763,191,6.5
26,137,Otsego,2018,11616,11003,613,5.3
26,139,Ottawa,2018,161107,156538,4569,2.8
26,141,Presque Isle,2018,5047,4643,404,8.0
26,143,Roscommon,2018,7863,7248,615,7.8
26,145,Saginaw,2018,87212,83050,4162,4.8
26,147,St. Clair,2018,75593,71961,3632,4.8
26,149,St. Joseph,2018,28354,27293,1061,3.7
26,151,Sanilac,2018,19254,18257,997,5.2
26,153,Schoolcraft,2018,3372,3130,242,7.2
26,155,Shiawassee,2018,33255,31816,1439,4.3
26,157,Tuscola,2018,23783,22477,1306,5.5
26,159,Van Buren,2018,35148,33419,1729,4.9
26,161,Washtenaw,2018,196358,190343,6015,3.1
26,163,Wayne,2018,799564,757752,41812,5.2
26,165,Wexford,2018,14744,14051,693,4.7
27,1,Aitkin,2018,7162,6747,415,5.8
27,3,Anoka,2018,195919,190286,5633,2.9
27,5,Becker,2018,18536,17853,683,3.7
27,7,Beltrami,2018,24066,23047,1019,4.2
27,9,Benton,2018,21754,20971,783,3.6
27,11,Big Stone,2018,2493,2395,98,3.9
27,13,Blue Earth,2018,40142,39098,1044,2.6
27,15,Brown,2018,14421,13919,502,3.5
27,17,Carlton,2018,17765,17010,755,4.2
27,19,Carver,2018,58052,56574,1478,2.5
27,21,Cass,2018,14237,13479,758,5.3
27,23,Chippewa,2018,6853,6627,226,3.3
27,25,Chisago,2018,29681,28650,1031,3.5
27,27,Clay,2018,35512,34457,1055,3.0
27,29,Clearwater,2018,4454,4081,373,8.4
27,31,Cook,2018,3033,2925,108,3.6
27,33,Cottonwood,2018,5783,5569,214,3.7
27,35,Crow Wing,2018,32048,30739,1309,4.1
27,37,Dakota,2018,239402,233091,6311,2.6
27,39,Dodge,2018,11725,11360,365,3.1
27,41,Douglas,2018,20523,19923,600,2.9
27,43,Faribault,2018,6962,6714,248,3.6
27,45,Fillmore,2018,11435,11067,368,3.2
27,47,Freeborn,2018,15961,15434,527,3.3
27,49,Goodhue,2018,26674,25914,760,2.8
27,51,Grant,2018,3286,3150,136,4.1
27,53,Hennepin,2018,700134,682023,18111,2.6
27,55,Houston,2018,10353,10045,308,3.0
27,57,Hubbard,2018,9840,9334,506,5.1
27,59,Isanti,2018,21122,20309,813,3.8
27,61,Itasca,2018,21715,20501,1214,5.6
27,63,Jackson,2018,5691,5519,172,3.0
27,65,Kanabec,2018,8913,8409,504,5.7
27,67,Kandiyohi,2018,24632,23882,750,3.0
27,69,Kittson,2018,2325,2255,70,3.0
27,71,Koochiching,2018,5921,5546,375,6.3
27,73,Lac qui Parle,2018,3507,3375,132,3.8
27,75,Lake,2018,5455,5277,178,3.3
27,77,Lake of the Woods,2018,2390,2296,94,3.9
27,79,Le Sueur,2018,16015,15331,684,4.3
27,81,Lincoln,2018,3246,3146,100,3.1
27,83,Lyon,2018,14698,14265,433,2.9
27,85,McLeod,2018,19445,18815,630,3.2
27,87,Mahnomen,2018,2315,2205,110,4.8
27,89,Marshall,2018,5399,5077,322,6.0
27,91,Martin,2018,10220,9888,332,3.2
27,93,Meeker,2018,13109,12637,472,3.6
27,95,Mille Lacs,2018,12791,12154,637,5.0
27,97,Morrison,2018,17480,16632,848,4.9
27,99,Mower,2018,20304,19735,569,2.8
27,101,Murray,2018,4860,4673,187,3.8
27,103,Nicollet,2018,20699,20225,474,2.3
27,105,Nobles,2018,11245,10941,304,2.7
27,107,Norman,2018,3345,3196,149,4.5
27,109,Olmsted,2018,87396,85313,2083,2.4
27,111,Otter Tail,2018,31236,30072,1164,3.7
27,113,Pennington,2018,8733,8357,376,4.3
27,115,Pine,2018,14816,14072,744,5.0
27,117,Pipestone,2018,4910,4764,146,3.0
27,119,Polk,2018,16634,16000,634,3.8
27,121,Pope,2018,6385,6212,173,2.7
27,123,Ramsey,2018,286998,278997,8001,2.8
27,125,Red Lake,2018,2219,2101,118,5.3
27,127,Redwood,2018,7581,7300,281,3.7
27,129,Renville,2018,8682,8327,355,4.1
27,131,Rice,2018,36758,35704,1054,2.9
27,133,Rock,2018,5672,5537,135,2.4
27,135,Roseau,2018,7859,7587,272,3.5
27,137,St. Louis,2018,101527,97649,3878,3.8
27,139,Scott,2018,82832,80688,2144,2.6
27,141,Sherburne,2018,51959,50266,1693,3.3
27,143,Sibley,2018,8475,8198,277,3.3
27,145,Stearns,2018,89703,86969,2734,3.0
27,147,Steele,2018,20385,19760,625,3.1
27,149,Stevens,2018,5422,5289,133,2.5
27,151,Swift,2018,4995,4807,188,3.8
27,153,Todd,2018,13429,12887,542,4.0
27,155,Traverse,2018,1768,1709,59,3.3
27,157,Wabasha,2018,12165,11792,373,3.1
27,159,Wadena,2018,5887,5570,317,5.4
27,161,Waseca,2018,8941,8565,376,4.2
27,163,Washington,2018,142050,138361,3689,2.6
27,165,Watonwan,2018,6496,6265,231,3.6
27,167,Wilkin,2018,3507,3398,109,3.1
27,169,Winona,2018,28585,27809,776,2.7
27,171,Wright,2018,75033,72725,2308,3.1
27,173,Yellow Medicine,2018,5325,5160,165,3.1
28,1,Adams,2018,11236,10507,729,6.5
28,3,Alcorn,2018,16113,15426,687,4.3
28,5,Amite,2018,4388,4109,279,6.4
28,7,Attala,2018,6962,6558,404,5.8
28,9,Benton,2018,3031,2856,175,5.8
28,11,Bolivar,2018,12401,11623,778,6.3
28,13,Calhoun,2018,5562,5295,267,4.8
28,15,Carroll,2018,3448,3247,201,5.8
28,17,Chickasaw,2018,7011,6650,361,5.1
28,19,Choctaw,2018,3711,3525,186,5.0
28,21,Claiborne,2018,3019,2734,285,9.4
28,23,Clarke,2018,5953,5612,341,5.7
28,25,Clay,2018,7696,7215,481,6.3
28,27,Coahoma,2018,8391,7784,607,7.2
28,29,Copiah,2018,11144,10504,640,5.7
28,31,Covington,2018,8077,7706,371,4.6
28,33,DeSoto,2018,90600,87057,3543,3.9
28,35,Forrest,2018,33129,31602,1527,4.6
28,37,Franklin,2018,2809,2638,171,6.1
28,39,George,2018,8792,8203,589,6.7
28,41,Greene,2018,4290,4013,277,6.5
28,43,Grenada,2018,9562,9141,421,4.4
28,45,Hancock,2018,18670,17692,978,5.2
28,47,Harrison,2018,85918,81833,4085,4.8
28,49,Hinds,2018,106987,101801,5186,4.8
28,51,Holmes,2018,5694,5171,523,9.2
28,53,Humphreys,2018,2196,1997,199,9.1
28,55,Issaquena,2018,370,336,34,9.2
28,57,Itawamba,2018,10384,9951,433,4.2
28,59,Jackson,2018,58303,54917,3386,5.8
28,61,Jasper,2018,5996,5631,365,6.1
28,63,Jefferson,2018,2027,1754,273,13.5
28,65,Jefferson Davis,2018,4101,3819,282,6.9
28,67,Jones,2018,25585,24300,1285,5.0
28,69,Kemper,2018,3570,3297,273,7.6
28,71,Lafayette,2018,28132,26997,1135,4.0
28,73,Lamar,2018,30626,29466,1160,3.8
28,75,Lauderdale,2018,30777,29198,1579,5.1
28,77,Lawrence,2018,4643,4360,283,6.1
28,79,Leake,2018,7840,7434,406,5.2
28,81,Lee,2018,40742,39116,1626,4.0
28,83,Leflore,2018,9958,9247,711,7.1
28,85,Lincoln,2018,14596,13887,709,4.9
28,87,Lowndes,2018,25162,23903,1259,5.0
28,89,Madison,2018,53180,51144,2036,3.8
28,91,Marion,2018,10032,9499,533,5.3
28,93,Marshall,2018,14362,13621,741,5.2
28,95,Monroe,2018,15429,14653,776,5.0
28,97,Montgomery,2018,4005,3786,219,5.5
28,99,Neshoba,2018,10166,9641,525,5.2
28,101,Newton,2018,8770,8338,432,4.9
28,103,Noxubee,2018,3808,3544,264,6.9
28,105,Oktibbeha,2018,22364,21275,1089,4.9
28,107,Panola,2018,12840,12039,801,6.2
28,109,Pearl River,2018,23524,22374,1150,4.9
28,111,Perry,2018,4264,4005,259,6.1
28,113,Pike,2018,14469,13603,866,6.0
28,115,Pontotoc,2018,14611,14031,580,4.0
28,117,Prentiss,2018,11243,10743,500,4.4
28,119,Quitman,2018,2359,2172,187,7.9
28,121,Rankin,2018,76134,73422,2712,3.6
28,123,Scott,2018,12920,12393,527,4.1
28,125,Sharkey,2018,1608,1487,121,7.5
28,127,Simpson,2018,10734,10226,508,4.7
28,129,Smith,2018,6756,6448,308,4.6
28,131,Stone,2018,6718,6317,401,6.0
28,133,Sunflower,2018,7786,7158,628,8.1
28,135,Tallahatchie,2018,5266,4976,290,5.5
28,137,Tate,2018,12270,11642,628,5.1
28,139,Tippah,2018,9444,9022,422,4.5
28,141,Tishomingo,2018,8503,8103,400,4.7
28,143,Tunica,2018,4399,4155,244,5.5
28,145,Union,2018,14026,13515,511,3.6
28,147,Walthall,2018,5055,4721,334,6.6
28,149,Warren,2018,20473,19329,1144,5.6
28,151,Washington,2018,17252,16050,1202,7.0
28,153,Wayne,2018,7321,6909,412,5.6
28,155,Webster,2018,3903,3703,200,5.1
28,157,Wilkinson,2018,2778,2532,246,8.9
28,159,Winston,2018,7300,6872,428,5.9
28,161,Yalobusha,2018,5112,4854,258,5.0
28,163,Yazoo,2018,9366,8828,538,5.7
29,1,Adair,2018,10625,10246,379,3.6
29,3,Andrew,2018,9718,9460,258,2.7
29,5,Atchison,2018,2766,2697,69,2.5
29,7,Audrain,2018,10791,10456,335,3.1
29,9,Barry,2018,15613,15149,464,3.0
29,11,Barton,2018,5179,5018,161,3.1
29,13,Bates,2018,7857,7552,305,3.9
29,15,Benton,2018,7168,6842,326,4.5
29,17,Bollinger,2018,5432,5234,198,3.6
29,19,Boone,2018,97589,95355,2234,2.3
29,21,Buchanan,2018,44363,43038,1325,3.0
29,23,Butler,2018,18116,17284,832,4.6
29,25,Caldwell,2018,4354,4216,138,3.2
29,27,Callaway,2018,21131,20513,618,2.9
29,29,Camden,2018,18594,17807,787,4.2
29,31,Cape Girardeau,2018,40247,39134,1113,2.8
29,33,Carroll,2018,4664,4516,148,3.2
29,35,Carter,2018,2507,2379,128,5.1
29,37,Cass,2018,54270,52591,1679,3.1
29,39,Cedar,2018,5700,5503,197,3.5
29,41,Chariton,2018,3765,3659,106,2.8
29,43,Christian,2018,44045,42900,1145,2.6
29,45,Clark,2018,3203,3079,124,3.9
29,47,Clay,2018,134904,130942,3962,2.9
29,49,Clinton,2018,10667,10322,345,3.2
29,51,Cole,2018,38482,37519,963,2.5
29,53,Cooper,2018,7421,7189,232,3.1
29,55,Crawford,2018,10843,10419,424,3.9
29,57,Dade,2018,3566,3469,97,2.7
29,59,Dallas,2018,6954,6676,278,4.0
29,61,Daviess,2018,4036,3914,122,3.0
29,63,DeKalb,2018,4849,4696,153,3.2
29,65,Dent,2018,6209,6004,205,3.3
29,67,Douglas,2018,5065,4836,229,4.5
29,69,Dunklin,2018,12029,11365,664,5.5
29,71,Franklin,2018,52558,50942,1616,3.1
29,73,Gasconade,2018,7741,7515,226,2.9
29,75,Gentry,2018,3574,3488,86,2.4
29,77,Greene,2018,148343,144519,3824,2.6
29,79,Grundy,2018,4542,4378,164,3.6
29,81,Harrison,2018,3843,3725,118,3.1
29,83,Henry,2018,9789,9438,351,3.6
29,85,Hickory,2018,3842,3683,159,4.1
29,87,Holt,2018,2647,2584,63,2.4
29,89,Howard,2018,4969,4828,141,2.8
29,91,Howell,2018,16266,15684,582,3.6
29,93,Iron,2018,3537,3345,192,5.4
29,95,Jackson,2018,358816,345183,13633,3.8
29,97,Jasper,2018,56500,54927,1573,2.8
29,99,Jefferson,2018,116703,113055,3648,3.1
29,101,Johnson,2018,22759,21913,846,3.7
29,103,Knox,2018,1917,1862,55,2.9
29,105,Laclede,2018,16784,16159,625,3.7
29,107,Lafayette,2018,16747,16199,548,3.3
29,109,Lawrence,2018,18078,17523,555,3.1
29,111,Lewis,2018,5074,4929,145,2.9
29,113,Lincoln,2018,28139,27221,918,3.3
29,115,Linn,2018,5124,4883,241,4.7
29,117,Livingston,2018,7502,7315,187,2.5
29,119,McDonald,2018,10454,10131,323,3.1
29,121,Macon,2018,7613,7386,227,3.0
29,123,Madison,2018,5460,5267,193,3.5
29,125,Maries,2018,3875,3747,128,3.3
29,127,Marion,2018,14441,13992,449,3.1
29,129,Mercer,2018,1907,1848,59,3.1
29,131,Miller,2018,12126,11682,444,3.7
29,133,Mississippi,2018,5942,5714,228,3.8
29,135,Moniteau,2018,7284,7067,217,3.0
29,137,Monroe,2018,3960,3818,142,3.6
29,139,Montgomery,2018,5691,5525,166,2.9
29,141,Morgan,2018,7970,7628,342,4.3
29,143,New Madrid,2018,8033,7650,383,4.8
29,145,Newton,2018,27072,26245,827,3.1
29,147,Nodaway,2018,10654,10341,313,2.9
29,149,Oregon,2018,3942,3805,137,3.5
29,151,Osage,2018,7056,6886,170,2.4
29,153,Ozark,2018,3445,3267,178,5.2
29,155,Pemiscot,2018,6317,5970,347,5.5
29,157,Perry,2018,10176,9937,239,2.3
29,159,Pettis,2018,20753,19892,861,4.1
29,161,Phelps,2018,19675,19066,609,3.1
29,163,Pike,2018,7676,7397,279,3.6
29,165,Platte,2018,57998,56495,1503,2.6
29,167,Polk,2018,14404,13875,529,3.7
29,169,Pulaski,2018,14612,14082,530,3.6
29,171,Putnam,2018,2422,2338,84,3.5
29,173,Ralls,2018,5616,5457,159,2.8
29,175,Randolph,2018,10239,9846,393,3.8
29,177,Ray,2018,10912,10512,400,3.7
29,179,Reynolds,2018,3033,2938,95,3.1
29,181,Ripley,2018,5099,4831,268,5.3
29,183,St. Charles,2018,224427,218731,5696,2.5
29,185,St. Clair,2018,3792,3626,166,4.4
29,186,Ste. Genevieve,2018,9200,8941,259,2.8
29,187,St. Francois,2018,26519,25546,973,3.7
29,189,St. Louis,2018,526231,510372,15859,3.0
29,195,Saline,2018,10727,10395,332,3.1
29,197,Schuyler,2018,2012,1929,83,4.1
29,199,Scotland,2018,2391,2323,68,2.8
29,201,Scott,2018,20047,19359,688,3.4
29,203,Shannon,2018,3240,3078,162,5.0
29,205,Shelby,2018,3023,2929,94,3.1
29,207,Stoddard,2018,13089,12506,583,4.5
29,209,Stone,2018,13724,13080,644,4.7
29,211,Sullivan,2018,2797,2709,88,3.1
29,213,Taney,2018,26940,25539,1401,5.2
29,215,Texas,2018,9030,8661,369,4.1
29,217,Vernon,2018,9568,9265,303,3.2
29,219,Warren,2018,17765,17266,499,2.8
29,221,Washington,2018,10210,9754,456,4.5
29,223,Wayne,2018,5339,5082,257,4.8
29,225,Webster,2018,16977,16447,530,3.1
29,227,Worth,2018,1192,1158,34,2.9
29,229,Wright,2018,7425,7115,310,4.2
29,510,St. Louis city,2018,151168,145297,5871,3.9
30,1,Beaverhead,2018,5042,4883,159,3.2
30,3,Big Horn,2018,5110,4613,497,9.7
30,5,Blaine,2018,2298,2198,100,4.4
30,7,Broadwater,2018,2627,2521,106,4.0
30,9,Carbon,2018,5480,5285,195,3.6
30,11,Carter,2018,667,650,17,2.5
30,13,Cascade,2018,37852,36475,1377,3.6
30,15,Chouteau,2018,2475,2400,75,3.0
30,17,Custer,2018,6078,5888,190,3.1
30,19,Daniels,2018,884,865,19,2.1
30,21,Dawson,2018,4633,4508,125,2.7
30,23,Deer Lodge,2018,5133,4948,185,3.6
30,25,Fallon,2018,1696,1665,31,1.8
30,27,Fergus,2018,5815,5599,216,3.7
30,29,Flathead,2018,47875,45538,2337,4.9
30,31,Gallatin,2018,66901,65185,1716,2.6
30,33,Garfield,2018,738,717,21,2.8
30,35,Glacier,2018,5719,5267,452,7.9
30,37,Golden Valley,2018,369,352,17,4.6
30,39,Granite,2018,1696,1605,91,5.4
30,41,Hill,2018,7683,7408,275,3.6
30,43,Jefferson,2018,5648,5429,219,3.9
30,45,Judith Basin,2018,913,882,31,3.4
30,47,Lake,2018,13139,12570,569,4.3
30,49,Lewis and Clark,2018,35439,34242,1197,3.4
30,51,Liberty,2018,960,936,24,2.5
30,53,Lincoln,2018,8087,7481,606,7.5
30,55,McCone,2018,967,949,18,1.9
30,57,Madison,2018,4580,4414,166,3.6
30,59,Meagher,2018,957,920,37,3.9
30,61,Mineral,2018,1721,1596,125,7.3
30,63,Missoula,2018,63256,61123,2133,3.4
30,65,Musselshell,2018,2284,2186,98,4.3
30,67,Park,2018,8853,8509,344,3.9
30,69,Petroleum,2018,281,270,11,3.9
30,71,Phillips,2018,1905,1818,87,4.6
30,73,Pondera,2018,2719,2608,111,4.1
30,75,Powder River,2018,969,941,28,2.9
30,77,Powell,2018,2919,2797,122,4.2
30,79,Prairie,2018,487,469,18,3.7
30,81,Ravalli,2018,19968,19120,848,4.2
30,83,Richland,2018,5884,5702,182,3.1
30,85,Roosevelt,2018,4475,4269,206,4.6
30,87,Rosebud,2018,3871,3664,207,5.3
30,89,Sanders,2018,4788,4478,310,6.5
30,91,Sheridan,2018,1759,1718,41,2.3
30,93,Silver Bow,2018,17257,16557,700,4.1
30,95,Stillwater,2018,4947,4776,171,3.5
30,97,Sweet Grass,2018,1777,1722,55,3.1
30,99,Teton,2018,2700,2608,92,3.4
30,101,Toole,2018,2132,2077,55,2.6
30,103,Treasure,2018,334,324,10,3.0
30,105,Valley,2018,4125,3998,127,3.1
30,107,Wheatland,2018,802,762,40,5.0
30,109,Wibaux,2018,466,450,16,3.4
30,111,Yellowstone,2018,81674,78923,2751,3.4
31,1,Adams,2018,16621,16136,485,2.9
31,3,Antelope,2018,3580,3493,87,2.4
31,5,Arthur,2018,222,211,11,5.0
31,7,Banner,2018,380,367,13,3.4
31,9,Blaine,2018,262,250,12,4.6
31,11,Boone,2018,2922,2856,66,2.3
31,13,Box Butte,2018,5421,5267,154,2.8
31,15,Boyd,2018,1080,1048,32,3.0
31,17,Brown,2018,1393,1346,47,3.4
31,19,Buffalo,2018,27817,27156,661,2.4
31,21,Burt,2018,3475,3357,118,3.4
31,23,Butler,2018,4561,4454,107,2.3
31,25,Cass,2018,13371,12966,405,3.0
31,27,Cedar,2018,4485,4381,104,2.3
31,29,Chase,2018,2283,2233,50,2.2
31,31,Cherry,2018,3346,3273,73,2.2
31,33,Cheyenne,2018,4713,4581,132,2.8
31,35,Clay,2018,3259,3156,103,3.2
31,37,Colfax,2018,5608,5472,136,2.4
31,39,Cuming,2018,4705,4587,118,2.5
31,41,Custer,2018,6442,6304,138,2.1
31,43,Dakota,2018,10711,10328,383,3.6
31,45,Dawes,2018,5036,4902,134,2.7
31,47,Dawson,2018,12979,12614,365,2.8
31,49,Deuel,2018,963,935,28,2.9
31,51,Dixon,2018,3021,2929,92,3.0
31,53,Dodge,2018,19469,18924,545,2.8
31,55,Douglas,2018,295677,286408,9269,3.1
31,57,Dundy,2018,1154,1129,25,2.2
31,59,Fillmore,2018,3155,3075,80,2.5
31,61,Franklin,2018,1478,1433,45,3.0
31,63,Frontier,2018,1519,1480,39,2.6
31,65,Furnas,2018,2633,2565,68,2.6
31,67,Gage,2018,10971,10621,350,3.2
31,69,Garden,2018,1187,1158,29,2.4
31,71,Garfield,2018,1167,1139,28,2.4
31,73,Gosper,2018,1061,1034,27,2.5
31,75,Grant,2018,420,409,11,2.6
31,77,Greeley,2018,1216,1184,32,2.6
31,79,Hall,2018,31978,30957,1021,3.2
31,81,Hamilton,2018,4761,4642,119,2.5
31,83,Harlan,2018,1776,1735,41,2.3
31,85,Hayes,2018,601,588,13,2.2
31,87,Hitchcock,2018,1259,1216,43,3.4
31,89,Holt,2018,5762,5614,148,2.6
31,91,Hooker,2018,403,388,15,3.7
31,93,Howard,2018,3363,3260,103,3.1
31,95,Jefferson,2018,4167,4063,104,2.5
31,97,Johnson,2018,2080,2006,74,3.6
31,99,Kearney,2018,3770,3691,79,2.1
31,101,Keith,2018,4562,4424,138,3.0
31,103,Keya Paha,2018,596,583,13,2.2
31,105,Kimball,2018,2027,1972,55,2.7
31,107,Knox,2018,4647,4503,144,3.1
31,109,Lancaster,2018,175338,170795,4543,2.6
31,111,Lincoln,2018,18358,17803,555,3.0
31,113,Logan,2018,466,453,13,2.8
31,115,Loup,2018,399,387,12,3.0
31,117,McPherson,2018,444,432,12,2.7
31,119,Madison,2018,19532,19035,497,2.5
31,121,Merrick,2018,4013,3900,113,2.8
31,123,Morrill,2018,2591,2521,70,2.7
31,125,Nance,2018,2017,1968,49,2.4
31,127,Nemaha,2018,3623,3497,126,3.5
31,129,Nuckolls,2018,2387,2322,65,2.7
31,131,Otoe,2018,8187,7951,236,2.9
31,133,Pawnee,2018,1478,1440,38,2.6
31,135,Perkins,2018,1825,1789,36,2.0
31,137,Phelps,2018,4903,4791,112,2.3
31,139,Pierce,2018,4111,4002,109,2.7
31,141,Platte,2018,17469,16999,470,2.7
31,143,Polk,2018,2905,2835,70,2.4
31,145,Red Willow,2018,5852,5712,140,2.4
31,147,Richardson,2018,4252,4123,129,3.0
31,149,Rock,2018,890,869,21,2.4
31,151,Saline,2018,7452,7226,226,3.0
31,153,Sarpy,2018,95293,92695,2598,2.7
31,155,Saunders,2018,11044,10735,309,2.8
31,157,Scotts Bluff,2018,18455,17852,603,3.3
31,159,Seward,2018,8828,8597,231,2.6
31,161,Sheridan,2018,2686,2618,68,2.5
31,163,Sherman,2018,1699,1654,45,2.6
31,165,Sioux,2018,743,724,19,2.6
31,167,Stanton,2018,3493,3405,88,2.5
31,169,Thayer,2018,2863,2798,65,2.3
31,171,Thomas,2018,437,425,12,2.7
31,173,Thurston,2018,2984,2862,122,4.1
31,175,Valley,2018,2088,2027,61,2.9
31,177,Washington,2018,11141,10824,317,2.8
31,179,Wayne,2018,5708,5567,141,2.5
31,181,Webster,2018,1651,1604,47,2.8
31,183,Wheeler,2018,576,562,14,2.4
31,185,York,2018,7327,7142,185,2.5
32,1,Churchill,2018,11038,10618,420,3.8
32,3,Clark,2018,1103345,1052555,50790,4.6
32,5,Douglas,2018,22942,21984,958,4.2
32,7,Elko,2018,27493,26645,848,3.1
32,9,Esmeralda,2018,424,403,21,5.0
32,11,Eureka,2018,1095,1068,27,2.5
32,13,Humboldt,2018,8074,7806,268,3.3
32,15,Lander,2018,3148,3038,110,3.5
32,17,Lincoln,2018,2067,1978,89,4.3
32,19,Lyon,2018,22360,21178,1182,5.3
32,21,Mineral,2018,1973,1872,101,5.1
32,23,Nye,2018,16723,15793,930,5.6
32,27,Pershing,2018,2582,2479,103,4.0
32,29,Storey,2018,1994,1909,85,4.3
32,31,Washoe,2018,250031,241293,8738,3.5
32,33,White Pine,2018,4586,4423,163,3.6
32,510,Carson City,2018,25730,24558,1172,4.6
33,1,Belknap,2018,31336,30510,826,2.6
33,3,Carroll,2018,23757,23128,629,2.6
33,5,Cheshire,2018,40823,39743,1080,2.6
33,7,Coos,2018,14626,14138,488,3.3
33,9,Grafton,2018,49475,48396,1079,2.2
33,11,Hillsborough,2018,238660,232108,6552,2.7
33,13,Merrimack,2018,83164,81236,1928,2.3
33,15,Rockingham,2018,185768,180414,5354,2.9
33,17,Strafford,2018,73734,71970,1764,2.4
33,19,Sullivan,2018,23213,22699,514,2.2
34,1,Atlantic,2018,119394,112626,6768,5.7
34,3,Bergen,2018,477023,461356,15667,3.3
34,5,Burlington,2018,228342,220071,8271,3.6
34,7,Camden,2018,250869,239663,11206,4.5
34,9,Cape May,2018,45669,41941,3728,8.2
34,11,Cumberland,2018,64829,60799,4030,6.2
34,13,Essex,2018,367056,348849,18207,5.0
34,15,Gloucester,2018,148379,142339,6040,4.1
34,17,Hudson,2018,357748,344434,13314,3.7
34,19,Hunterdon,2018,64028,62043,1985,3.1
34,21,Mercer,2018,199846,192883,6963,3.5
34,23,Middlesex,2018,435591,420369,15222,3.5
34,25,Monmouth,2018,325921,314447,11474,3.5
34,27,Morris,2018,254977,246969,8008,3.1
34,29,Ocean,2018,272973,261780,11193,4.1
34,31,Passaic,2018,240230,228454,11776,4.9
34,33,Salem,2018,28887,27367,1520,5.3
34,35,Somerset,2018,170148,164541,5607,3.3
34,37,Sussex,2018,73448,70668,2780,3.8
34,39,Union,2018,274884,263533,11351,4.1
34,41,Warren,2018,55194,53140,2054,3.7
35,1,Bernalillo,2018,331465,316532,14933,4.5
35,3,Catron,2018,1125,1053,72,6.4
35,5,Chaves,2018,27327,26000,1327,4.9
35,6,Cibola,2018,8988,8428,560,6.2
35,7,Colfax,2018,5536,5265,271,4.9
35,9,Curry,2018,21746,20873,873,4.0
35,11,De Baca,2018,770,736,34,4.4
35,13,Dona Ana,2018,97154,91628,5526,5.7
35,15,Eddy,2018,31766,30709,1057,3.3
35,17,Grant,2018,12377,11779,598,4.8
35,19,Guadalupe,2018,1632,1542,90,5.5
35,21,Harding,2018,280,265,15,5.4
35,23,Hidalgo,2018,2226,2142,84,3.8
35,25,Lea,2018,30186,28936,1250,4.1
35,27,Lincoln,2018,8775,8375,400,4.6
35,28,Los Alamos,2018,9165,8853,312,3.4
35,29,Luna,2018,10213,9004,1209,11.8
35,31,McKinley,2018,23983,22281,1702,7.1
35,33,Mora,2018,2291,2152,139,6.1
35,35,Otero,2018,24846,23625,1221,4.9
35,37,Quay,2018,3233,3078,155,4.8
35,39,Rio Arriba,2018,16728,15858,870,5.2
35,41,Roosevelt,2018,7876,7535,341,4.3
35,43,Sandoval,2018,66038,62774,3264,4.9
35,45,San Juan,2018,52605,49572,3033,5.8
35,47,San Miguel,2018,10990,10339,651,5.9
35,49,Santa Fe,2018,74640,71548,3092,4.1
35,51,Sierra,2018,4119,3831,288,7.0
35,53,Socorro,2018,6487,6145,342,5.3
35,55,Taos,2018,15102,14120,982,6.5
35,57,Torrance,2018,5648,5218,430,7.6
35,59,Union,2018,1794,1735,59,3.3
35,61,Valencia,2018,30536,28875,1661,5.4
36,1,Albany,2018,157316,151510,5806,3.7
36,3,Allegany,2018,19454,18368,1086,5.6
36,5,Bronx,2018,599225,565369,33856,5.6
36,7,Broome,2018,84026,79945,4081,4.9
36,9,Cattaraugus,2018,33996,32188,1808,5.3
36,11,Cayuga,2018,35930,34331,1599,4.5
36,13,Chautauqua,2018,54704,51958,2746,5.0
36,15,Chemung,2018,35306,33679,1627,4.6
36,17,Chenango,2018,22297,21260,1037,4.7
36,19,Clinton,2018,36220,34637,1583,4.4
36,21,Columbia,2018,31215,30179,1036,3.3
36,23,Cortland,2018,22826,21665,1161,5.1
36,25,Delaware,2018,19052,18131,921,4.8
36,27,Dutchess,2018,143449,138174,5275,3.7
36,29,Erie,2018,441563,422118,19445,4.4
36,31,Essex,2018,17026,16204,822,4.8
36,33,Franklin,2018,19572,18569,1003,5.1
36,35,Fulton,2018,22780,21621,1159,5.1
36,37,Genesee,2018,29692,28458,1234,4.2
36,39,Greene,2018,20588,19652,936,4.5
36,41,Hamilton,2018,2285,2129,156,6.8
36,43,Herkimer,2018,27758,26396,1362,4.9
36,45,Jefferson,2018,44431,41960,2471,5.6
36,47,Kings,2018,1200369,1149788,50581,4.2
36,49,Lewis,2018,11607,10963,644,5.5
36,51,Livingston,2018,30650,29329,1321,4.3
36,53,Madison,2018,32617,31061,1556,4.8
36,55,Monroe,2018,361497,346144,15353,4.2
36,57,Montgomery,2018,22395,21243,1152,5.1
36,59,Nassau,2018,705627,680890,24737,3.5
36,61,New York,2018,913478,880081,33397,3.7
36,63,Niagara,2018,98908,93746,5162,5.2
36,65,Oneida,2018,100779,96309,4470,4.4
36,67,Onondaga,2018,219524,210760,8764,4.0
36,69,Ontario,2018,55308,53140,2168,3.9
36,71,Orange,2018,183316,176204,7112,3.9
36,73,Orleans,2018,17511,16647,864,4.9
36,75,Oswego,2018,52668,49797,2871,5.5
36,77,Otsego,2018,27999,26783,1216,4.3
36,79,Putnam,2018,51007,49133,1874,3.7
36,81,Queens,2018,1140984,1100026,40958,3.6
36,83,Rensselaer,2018,81083,77935,3148,3.9
36,85,Richmond,2018,222584,213495,9089,4.1
36,87,Rockland,2018,154249,148531,5718,3.7
36,89,St. Lawrence,2018,43322,40903,2419,5.6
36,91,Saratoga,2018,118958,114777,4181,3.5
36,93,Schenectady,2018,76064,73021,3043,4.0
36,95,Schoharie,2018,14603,13900,703,4.8
36,97,Schuyler,2018,8215,7795,420,5.1
36,99,Seneca,2018,16071,15453,618,3.8
36,101,Steuben,2018,42556,40461,2095,4.9
36,103,Suffolk,2018,775521,745813,29708,3.8
36,105,Sullivan,2018,35880,34414,1466,4.1
36,107,Tioga,2018,22839,21844,995,4.4
36,109,Tompkins,2018,49950,48148,1802,3.6
36,111,Ulster,2018,88151,84718,3433,3.9
36,113,Warren,2018,31486,30024,1462,4.6
36,115,Washington,2018,27901,26743,1158,4.2
36,117,Wayne,2018,43716,41909,1807,4.1
36,119,Westchester,2018,481431,462774,18657,3.9
36,121,Wyoming,2018,17945,17115,830,4.6
36,123,Yates,2018,11769,11326,443,3.8
37,1,Alamance,2018,80867,77754,3113,3.8
37,3,Alexander,2018,17946,17364,582,3.2
37,5,Alleghany,2018,4315,4116,199,4.6
37,7,Anson,2018,10420,9947,473,4.5
37,9,Ashe,2018,12701,12235,466,3.7
37,11,Avery,2018,7599,7316,283,3.7
37,13,Beaufort,2018,19685,18762,923,4.7
37,15,Bertie,2018,7838,7444,394,5.0
37,17,Bladen,2018,14384,13609,775,5.4
37,19,Brunswick,2018,53201,50332,2869,5.4
37,21,Buncombe,2018,139003,134767,4236,3.0
37,23,Burke,2018,40843,39335,1508,3.7
37,25,Cabarrus,2018,107094,103149,3945,3.7
37,27,Caldwell,2018,36397,34969,1428,3.9
37,29,Camden,2018,4706,4527,179,3.8
37,31,Carteret,2018,31897,30488,1409,4.4
37,33,Caswell,2018,9829,9389,440,4.5
37,35,Catawba,2018,78679,75845,2834,3.6
37,37,Chatham,2018,35110,33902,1208,3.4
37,39,Cherokee,2018,11271,10759,512,4.5
37,41,Chowan,2018,5586,5333,253,4.5
37,43,Clay,2018,4124,3941,183,4.4
37,45,Cleveland,2018,47902,45971,1931,4.0
37,47,Columbus,2018,22376,21238,1138,5.1
37,49,Craven,2018,41537,39745,1792,4.3
37,51,Cumberland,2018,127654,120924,6730,5.3
37,53,Currituck,2018,13999,13489,510,3.6
37,55,Dare,2018,19968,18930,1038,5.2
37,57,Davidson,2018,80408,77409,2999,3.7
37,59,Davie,2018,20543,19823,720,3.5
37,61,Duplin,2018,25045,23947,1098,4.4
37,63,Durham,2018,168774,162707,6067,3.6
37,65,Edgecombe,2018,21508,20008,1500,7.0
37,67,Forsyth,2018,186924,179623,7301,3.9
37,69,Franklin,2018,30767,29501,1266,4.1
37,71,Gaston,2018,109090,104720,4370,4.0
37,73,Gates,2018,5318,5101,217,4.1
37,75,Graham,2018,3183,2994,189,5.9
37,77,Granville,2018,29972,28931,1041,3.5
37,79,Greene,2018,9533,9160,373,3.9
37,81,Guilford,2018,262117,250958,11159,4.3
37,83,Halifax,2018,20190,18943,1247,6.2
37,85,Harnett,2018,52890,50365,2525,4.8
37,87,Haywood,2018,29656,28631,1025,3.5
37,89,Henderson,2018,54528,52717,1811,3.3
37,91,Hertford,2018,9129,8661,468,5.1
37,93,Hoke,2018,20115,19082,1033,5.1
37,95,Hyde,2018,2016,1848,168,8.3
37,97,Iredell,2018,87863,84618,3245,3.7
37,99,Jackson,2018,19556,18722,834,4.3
37,101,Johnston,2018,97408,93793,3615,3.7
37,103,Jones,2018,4382,4194,188,4.3
37,105,Lee,2018,26510,25330,1180,4.5
37,107,Lenoir,2018,27874,26759,1115,4.0
37,109,Lincoln,2018,42642,41140,1502,3.5
37,111,McDowell,2018,21118,20388,730,3.5
37,113,Macon,2018,15358,14743,615,4.0
37,115,Madison,2018,10072,9698,374,3.7
37,117,Martin,2018,9290,8819,471,5.1
37,119,Mecklenburg,2018,611136,587592,23544,3.9
37,121,Mitchell,2018,6028,5753,275,4.6
37,123,Montgomery,2018,11535,11065,470,4.1
37,125,Moore,2018,41084,39482,1602,3.9
37,127,Nash,2018,43404,41153,2251,5.2
37,129,New Hanover,2018,121263,116545,4718,3.9
37,131,Northampton,2018,7637,7241,396,5.2
37,133,Onslow,2018,64349,61182,3167,4.9
37,135,Orange,2018,77617,75032,2585,3.3
37,137,Pamlico,2018,5324,5100,224,4.2
37,139,Pasquotank,2018,17022,16196,826,4.9
37,141,Pender,2018,28264,27062,1202,4.3
37,143,Perquimans,2018,5026,4779,247,4.9
37,145,Person,2018,18161,17393,768,4.2
37,147,Pitt,2018,89567,85657,3910,4.4
37,149,Polk,2018,8951,8606,345,3.9
37,151,Randolph,2018,66093,63555,2538,3.8
37,153,Richmond,2018,16552,15632,920,5.6
37,155,Robeson,2018,49731,46756,2975,6.0
37,157,Rockingham,2018,40118,38247,1871,4.7
37,159,Rowan,2018,64995,62348,2647,4.1
37,161,Rutherford,2018,24798,23512,1286,5.2
37,163,Sampson,2018,29286,28087,1199,4.1
37,165,Scotland,2018,11482,10625,857,7.5
37,167,Stanly,2018,29869,28776,1093,3.7
37,169,Stokes,2018,21588,20786,802,3.7
37,171,Surry,2018,34036,32818,1218,3.6
37,173,Swain,2018,6921,6618,303,4.4
37,175,Transylvania,2018,14287,13738,549,3.8
37,177,Tyrrell,2018,1477,1383,94,6.4
37,179,Union,2018,121615,117279,4336,3.6
37,181,Vance,2018,17423,16394,1029,5.9
37,183,Wake,2018,585506,565174,20332,3.5
37,185,Warren,2018,6561,6162,399,6.1
37,187,Washington,2018,4621,4341,280,6.1
37,189,Watauga,2018,28908,27875,1033,3.6
37,191,Wayne,2018,52586,50275,2311,4.4
37,193,Wilkes,2018,30155,29000,1155,3.8
37,195,Wilson,2018,35296,33079,2217,6.3
37,197,Yadkin,2018,17624,17018,606,3.4
37,199,Yancey,2018,8246,7944,302,3.7
38,1,Adams,2018,1068,1048,20,1.9
38,3,Barnes,2018,5260,5126,134,2.5
38,5,Benson,2018,2311,2226,85,3.7
38,7,Billings,2018,426,415,11,2.6
38,9,Bottineau,2018,3002,2907,95,3.2
38,11,Bowman,2018,1647,1618,29,1.8
38,13,Burke,2018,1076,1052,24,2.2
38,15,Burleigh,2018,49630,48392,1238,2.5
38,17,Cass,2018,102727,100505,2222,2.2
38,19,Cavalier,2018,1982,1933,49,2.5
38,21,Dickey,2018,2408,2367,41,1.7
38,23,Divide,2018,1535,1516,19,1.2
38,25,Dunn,2018,3061,3014,47,1.5
38,27,Eddy,2018,1246,1187,59,4.7
38,29,Emmons,2018,1486,1418,68,4.6
38,31,Foster,2018,1599,1559,40,2.5
38,33,Golden Valley,2018,890,873,17,1.9
38,35,Grand Forks,2018,38081,37269,812,2.1
38,37,Grant,2018,1211,1181,30,2.5
38,39,Griggs,2018,1056,1034,22,2.1
38,41,Hettinger,2018,1407,1380,27,1.9
38,43,Kidder,2018,1303,1248,55,4.2
38,45,LaMoure,2018,2126,2086,40,1.9
38,47,Logan,2018,899,878,21,2.3
38,49,McHenry,2018,3131,3013,118,3.8
38,51,McIntosh,2018,1149,1120,29,2.5
38,53,McKenzie,2018,9111,8964,147,1.6
38,55,McLean,2018,4770,4620,150,3.1
38,57,Mercer,2018,3955,3796,159,4.0
38,59,Morton,2018,16396,15890,506,3.1
38,61,Mountrail,2018,7113,7006,107,1.5
38,63,Nelson,2018,1417,1372,45,3.2
38,65,Oliver,2018,881,847,34,3.9
38,67,Pembina,2018,3385,3257,128,3.8
38,69,Pierce,2018,1780,1726,54,3.0
38,71,Ramsey,2018,5680,5527,153,2.7
38,73,Ransom,2018,2843,2791,52,1.8
38,75,Renville,2018,1224,1196,28,2.3
38,77,Richland,2018,8755,8538,217,2.5
38,79,Rolette,2018,4690,4269,421,9.0
38,81,Sargent,2018,2561,2516,45,1.8
38,83,Sheridan,2018,689,659,30,4.4
38,85,Sioux,2018,1252,1202,50,4.0
38,87,Slope,2018,401,393,8,2.0
38,89,Stark,2018,18346,17926,420,2.3
38,91,Steele,2018,1006,987,19,1.9
38,93,Stutsman,2018,10610,10359,251,2.4
38,95,Towner,2018,1194,1165,29,2.4
38,97,Traill,2018,4464,4352,112,2.5
38,99,Walsh,2018,5312,5154,158,3.0
38,101,Ward,2018,32040,31172,868,2.7
38,103,Wells,2018,1996,1938,58,2.9
38,105,Williams,2018,23873,23418,455,1.9
39,1,Adams,2018,10924,10155,769,7.0
39,3,Allen,2018,48014,45870,2144,4.5
39,5,Ashland,2018,26240,25043,1197,4.6
39,7,Ashtabula,2018,44525,42193,2332,5.2
39,9,Athens,2018,27926,26348,1578,5.7
39,11,Auglaize,2018,24698,23889,809,3.3
39,13,Belmont,2018,30616,28941,1675,5.5
39,15,Brown,2018,19497,18450,1047,5.4
39,17,Butler,2018,194053,186022,8031,4.1
39,19,Carroll,2018,13007,12318,689,5.3
39,21,Champaign,2018,19952,19192,760,3.8
39,23,Clark,2018,63240,60354,2886,4.6
39,25,Clermont,2018,106265,101909,4356,4.1
39,27,Clinton,2018,17595,16672,923,5.2
39,29,Columbiana,2018,47357,44920,2437,5.1
39,31,Coshocton,2018,14443,13553,890,6.2
39,33,Crawford,2018,18068,17121,947,5.2
39,35,Cuyahoga,2018,614701,584797,29904,4.9
39,37,Darke,2018,25922,24915,1007,3.9
39,39,Defiance,2018,18246,17441,805,4.4
39,41,Delaware,2018,109288,105585,3703,3.4
39,43,Erie,2018,37999,35880,2119,5.6
39,45,Fairfield,2018,77352,74208,3144,4.1
39,47,Fayette,2018,14130,13547,583,4.1
39,49,Franklin,2018,691224,664827,26397,3.8
39,51,Fulton,2018,22379,21396,983,4.4
39,53,Gallia,2018,12322,11579,743,6.0
39,55,Geauga,2018,49240,47261,1979,4.0
39,57,Greene,2018,82916,79570,3346,4.0
39,59,Guernsey,2018,18802,17766,1036,5.5
39,61,Hamilton,2018,413703,396703,17000,4.1
39,63,Hancock,2018,41457,40043,1414,3.4
39,65,Hardin,2018,14052,13439,613,4.4
39,67,Harrison,2018,6945,6582,363,5.2
39,69,Henry,2018,13333,12676,657,4.9
39,71,Highland,2018,17184,16235,949,5.5
39,73,Hocking,2018,12994,12332,662,5.1
39,75,Holmes,2018,20706,20030,676,3.3
39,77,Huron,2018,28031,26383,1648,5.9
39,79,Jackson,2018,12822,11987,835,6.5
39,81,Jefferson,2018,27747,26005,1742,6.3
39,83,Knox,2018,31462,30097,1365,4.3
39,85,Lake,2018,126716,121198,5518,4.4
39,87,Lawrence,2018,23859,22528,1331,5.6
39,89,Licking,2018,89658,86104,3554,4.0
39,91,Logan,2018,23187,22326,861,3.7
39,93,Lorain,2018,154302,146567,7735,5.0
39,95,Lucas,2018,210182,199184,10998,5.2
39,97,Madison,2018,20640,19854,786,3.8
39,99,Mahoning,2018,104499,98339,6160,5.9
39,101,Marion,2018,28546,27285,1261,4.4
39,103,Medina,2018,97728,93868,3860,3.9
39,105,Meigs,2018,8989,8340,649,7.2
39,107,Mercer,2018,23686,23036,650,2.7
39,109,Miami,2018,53867,51763,2104,3.9
39,111,Monroe,2018,5202,4799,403,7.7
39,113,Montgomery,2018,251649,240245,11404,4.5
39,115,Morgan,2018,6729,6326,403,6.0
39,117,Morrow,2018,16698,15929,769,4.6
39,119,Muskingum,2018,39651,37552,2099,5.3
39,121,Noble,2018,4782,4463,319,6.7
39,123,Ottawa,2018,21156,19823,1333,6.3
39,125,Paulding,2018,8774,8417,357,4.1
39,127,Perry,2018,15796,14906,890,5.6
39,129,Pickaway,2018,26228,25099,1129,4.3
39,131,Pike,2018,10896,10188,708,6.5
39,133,Portage,2018,87176,83205,3971,4.6
39,135,Preble,2018,21221,20357,864,4.1
39,137,Putnam,2018,18711,18085,626,3.3
39,139,Richland,2018,52969,50372,2597,4.9
39,141,Ross,2018,34884,33305,1579,4.5
39,143,Sandusky,2018,30958,29558,1400,4.5
39,145,Scioto,2018,29046,27092,1954,6.7
39,147,Seneca,2018,27283,26081,1202,4.4
39,149,Shelby,2018,24039,23137,902,3.8
39,151,Stark,2018,186540,177403,9137,4.9
39,153,Summit,2018,272074,259399,12675,4.7
39,155,Trumbull,2018,87857,82400,5457,6.2
39,157,Tuscarawas,2018,44675,42641,2034,4.6
39,159,Union,2018,28704,27708,996,3.5
39,161,Van Wert,2018,14443,13936,507,3.5
39,163,Vinton,2018,5513,5171,342,6.2
39,165,Warren,2018,118515,113954,4561,3.8
39,167,Washington,2018,27227,25699,1528,5.6
39,169,Wayne,2018,61259,59054,2205,3.6
39,171,Williams,2018,19000,18311,689,3.6
39,173,Wood,2018,70969,68133,2836,4.0
39,175,Wyandot,2018,12744,12335,409,3.2
40,1,Adair,2018,8164,7838,326,4.0
40,3,Alfalfa,2018,2898,2838,60,2.1
40,5,Atoka,2018,5064,4863,201,4.0
40,7,Beaver,2018,3015,2957,58,1.9
40,9,Beckham,2018,11409,11126,283,2.5
40,11,Blaine,2018,4480,4394,86,1.9
40,13,Bryan,2018,20939,20303,636,3.0
40,15,Caddo,2018,12111,11695,416,3.4
40,17,Canadian,2018,73485,71538,1947,2.6
40,19,Carter,2018,22115,21369,746,3.4
40,21,Cherokee,2018,18794,18034,760,4.0
40,23,Choctaw,2018,5683,5411,272,4.8
40,25,Cimarron,2018,1377,1352,25,1.8
40,27,Cleveland,2018,141477,137546,3931,2.8
40,29,Coal,2018,2291,2209,82,3.6
40,31,Comanche,2018,48291,46481,1810,3.7
40,33,Cotton,2018,2734,2652,82,3.0
40,35,Craig,2018,6086,5884,202,3.3
40,37,Creek,2018,31449,30300,1149,3.7
40,39,Custer,2018,15665,15299,366,2.3
40,41,Delaware,2018,17940,17264,676,3.8
40,43,Dewey,2018,2767,2717,50,1.8
40,45,Ellis,2018,2199,2153,46,2.1
40,47,Garfield,2018,27201,26409,792,2.9
40,49,Garvin,2018,12665,12268,397,3.1
40,51,Grady,2018,26283,25510,773,2.9
40,53,Grant,2018,2735,2681,54,2.0
40,55,Greer,2018,1963,1887,76,3.9
40,57,Harmon,2018,1207,1173,34,2.8
40,59,Harper,2018,1793,1754,39,2.2
40,61,Haskell,2018,4212,4006,206,4.9
40,63,Hughes,2018,5350,5136,214,4.0
40,65,Jackson,2018,10745,10434,311,2.9
40,67,Jefferson,2018,2582,2499,83,3.2
40,69,Johnston,2018,5195,5048,147,2.8
40,71,Kay,2018,18898,18053,845,4.5
40,73,Kingfisher,2018,8921,8740,181,2.0
40,75,Kiowa,2018,3522,3382,140,4.0
40,77,Latimer,2018,3210,3026,184,5.7
40,79,Le Flore,2018,19161,18314,847,4.4
40,81,Lincoln,2018,15676,15142,534,3.4
40,83,Logan,2018,21940,21299,641,2.9
40,85,Love,2018,6429,6297,132,2.1
40,87,McClain,2018,19522,19004,518,2.7
40,89,McCurtain,2018,14125,13383,742,5.3
40,91,McIntosh,2018,6850,6464,386,5.6
40,93,Major,2018,4009,3927,82,2.0
40,95,Marshall,2018,6742,6498,244,3.6
40,97,Mayes,2018,19807,19170,637,3.2
40,99,Murray,2018,6480,6299,181,2.8
40,101,Muskogee,2018,29196,28072,1124,3.8
40,103,Noble,2018,5724,5582,142,2.5
40,105,Nowata,2018,4616,4431,185,4.0
40,107,Okfuskee,2018,4496,4292,204,4.5
40,109,Oklahoma,2018,381623,369491,12132,3.2
40,111,Okmulgee,2018,15614,14874,740,4.7
40,113,Osage,2018,20668,19816,852,4.1
40,115,Ottawa,2018,14355,13880,475,3.3
40,117,Pawnee,2018,7344,7052,292,4.0
40,119,Payne,2018,38647,37557,1090,2.8
40,121,Pittsburg,2018,17851,17191,660,3.7
40,123,Pontotoc,2018,18654,18104,550,2.9
40,125,Pottawatomie,2018,32566,31407,1159,3.6
40,127,Pushmataha,2018,4492,4268,224,5.0
40,129,Roger Mills,2018,1876,1833,43,2.3
40,131,Rogers,2018,44878,43457,1421,3.2
40,133,Seminole,2018,9488,9058,430,4.5
40,135,Sequoyah,2018,16332,15656,676,4.1
40,137,Stephens,2018,18510,17810,700,3.8
40,139,Texas,2018,9024,8788,236,2.6
40,141,Tillman,2018,3098,2987,111,3.6
40,143,Tulsa,2018,321834,311491,10343,3.2
40,145,Wagoner,2018,37784,36582,1202,3.2
40,147,Washington,2018,22911,22054,857,3.7
40,149,Washita,2018,5272,5118,154,2.9
40,151,Woods,2018,4643,4548,95,2.0
40,153,Woodward,2018,9264,9022,242,2.6
41,1,Baker,2018,7090,6722,368,5.2
41,3,Benton,2018,48005,46528,1477,3.1
41,5,Clackamas,2018,217156,209287,7869,3.6
41,7,Clatsop,2018,19178,18416,762,4.0
41,9,Columbia,2018,24210,23021,1189,4.9
41,11,Coos,2018,26118,24750,1368,5.2
41,13,Crook,2018,9461,8914,547,5.8
41,15,Curry,2018,8907,8383,524,5.9
41,17,Deschutes,2018,94640,90767,3873,4.1
41,19,Douglas,2018,46273,43865,2408,5.2
41,21,Gilliam,2018,854,822,32,3.7
41,23,Grant,2018,3123,2909,214,6.9
41,25,Harney,2018,3519,3314,205,5.8
41,27,Hood River,2018,14414,13949,465,3.2
41,29,Jackson,2018,103776,98976,4800,4.6
41,31,Jefferson,2018,10129,9594,535,5.3
41,33,Josephine,2018,35456,33548,1908,5.4
41,35,Klamath,2018,29412,27601,1811,6.2
41,37,Lake,2018,3562,3369,193,5.4
41,39,Lane,2018,180495,172655,7840,4.3
41,41,Lincoln,2018,20960,19969,991,4.7
41,43,Linn,2018,58482,55812,2670,4.6
41,45,Malheur,2018,12380,11831,549,4.4
41,47,Marion,2018,160293,153613,6680,4.2
41,49,Morrow,2018,5710,5472,238,4.2
41,51,Multnomah,2018,450380,434317,16063,3.6
41,53,Polk,2018,39493,37822,1671,4.2
41,55,Sherman,2018,895,860,35,3.9
41,57,Tillamook,2018,11793,11293,500,4.2
41,59,Umatilla,2018,36367,34626,1741,4.8
41,61,Union,2018,11894,11276,618,5.2
41,63,Wallowa,2018,3386,3190,196,5.8
41,65,Wasco,2018,13296,12746,550,4.1
41,67,Washington,2018,321225,310412,10813,3.4
41,69,Wheeler,2018,719,695,24,3.3
41,71,Yamhill,2018,54213,52253,1960,3.6
42,1,Adams,2018,55160,53282,1878,3.4
42,3,Allegheny,2018,644791,617815,26976,4.2
42,5,Armstrong,2018,32071,30405,1666,5.2
42,7,Beaver,2018,83640,79690,3950,4.7
42,9,Bedford,2018,23656,22555,1101,4.7
42,11,Berks,2018,212972,203774,9198,4.3
42,13,Blair,2018,59442,56851,2591,4.4
42,15,Bradford,2018,28888,27584,1304,4.5
42,17,Bucks,2018,340799,327529,13270,3.9
42,19,Butler,2018,99262,95269,3993,4.0
42,21,Cambria,2018,58243,55111,3132,5.4
42,23,Cameron,2018,2138,2027,111,5.2
42,25,Carbon,2018,31734,30073,1661,5.2
42,27,Centre,2018,79616,76931,2685,3.4
42,29,Chester,2018,282820,273520,9300,3.3
42,31,Clarion,2018,17404,16537,867,5.0
42,33,Clearfield,2018,35743,33896,1847,5.2
42,35,Clinton,2018,18366,17357,1009,5.5
42,37,Columbia,2018,33498,31854,1644,4.9
42,39,Crawford,2018,38909,37025,1884,4.8
42,41,Cumberland,2018,130673,126163,4510,3.5
42,43,Dauphin,2018,142727,136844,5883,4.1
42,45,Delaware,2018,296091,283764,12327,4.2
42,47,Elk,2018,15872,15240,632,4.0
42,49,Erie,2018,129236,122945,6291,4.9
42,51,Fayette,2018,56849,53407,3442,6.1
42,53,Forest,2018,1820,1703,117,6.4
42,55,Franklin,2018,76975,74022,2953,3.8
42,57,Fulton,2018,7866,7545,321,4.1
42,59,Greene,2018,16602,15765,837,5.0
42,61,Huntingdon,2018,19823,18735,1088,5.5
42,63,Indiana,2018,38785,36811,1974,5.1
42,65,Jefferson,2018,20520,19533,987,4.8
42,67,Juniata,2018,12460,11941,519,4.2
42,69,Lackawanna,2018,105349,100347,5002,4.7
42,71,Lancaster,2018,282318,272393,9925,3.5
42,73,Lawrence,2018,40815,38666,2149,5.3
42,75,Lebanon,2018,71256,68465,2791,3.9
42,77,Lehigh,2018,191107,181986,9121,4.8
42,79,Luzerne,2018,158003,149146,8857,5.6
42,81,Lycoming,2018,57343,54499,2844,5.0
42,83,McKean,2018,17825,16938,887,5.0
42,85,Mercer,2018,49952,47516,2436,4.9
42,87,Mifflin,2018,20783,19776,1007,4.8
42,89,Monroe,2018,82390,77819,4571,5.5
42,91,Montgomery,2018,450466,434392,16074,3.6
42,93,Montour,2018,9096,8768,328,3.6
42,95,Northampton,2018,159724,152400,7324,4.6
42,97,Northumberland,2018,43112,40773,2339,5.4
42,99,Perry,2018,24238,23299,939,3.9
42,101,Philadelphia/city,2018,710522,669685,40837,5.7
42,103,Pike,2018,25104,23723,1381,5.5
42,105,Potter,2018,7181,6785,396,5.5
42,107,Schuylkill,2018,66142,62598,3544,5.4
42,109,Snyder,2018,20311,19476,835,4.1
42,111,Somerset,2018,33556,31784,1772,5.3
42,113,Sullivan,2018,2691,2553,138,5.1
42,115,Susquehanna,2018,20466,19618,848,4.1
42,117,Tioga,2018,18849,17841,1008,5.3
42,119,Union,2018,19611,18849,762,3.9
42,121,Venango,2018,22441,21302,1139,5.1
42,123,Warren,2018,19061,18183,878,4.6
42,125,Washington,2018,106362,101602,4760,4.5
42,127,Wayne,2018,22401,21305,1096,4.9
42,129,Westmoreland,2018,180069,171832,8237,4.6
42,131,Wyoming,2018,13612,12973,639,4.7
42,133,York,2018,234556,225167,9389,4.0
44,1,Bristol,2018,26109,25205,904,3.5
44,3,Kent,2018,91101,87742,3359,3.7
44,5,Newport,2018,44452,42868,1584,3.6
44,7,Providence,2018,327036,312667,14369,4.4
44,9,Washington,2018,69525,67039,2486,3.6
45,1,Abbeville,2018,9893,9504,389,3.9
45,3,Aiken,2018,73715,71286,2429,3.3
45,5,Allendale,2018,2751,2596,155,5.6
45,7,Anderson,2018,89696,86838,2858,3.2
45,9,Bamberg,2018,4986,4667,319,6.4
45,11,Barnwell,2018,8273,7885,388,4.7
45,13,Beaufort,2018,75591,73184,2407,3.2
45,15,Berkeley,2018,101102,98081,3021,3.0
45,17,Calhoun,2018,6488,6213,275,4.2
45,19,Charleston,2018,205633,199983,5650,2.7
45,21,Cherokee,2018,24948,24055,893,3.6
45,23,Chester,2018,13032,12404,628,4.8
45,25,Chesterfield,2018,21783,21087,696,3.2
45,27,Clarendon,2018,12504,11927,577,4.6
45,29,Colleton,2018,16637,15980,657,3.9
45,31,Darlington,2018,29960,28768,1192,4.0
45,33,Dillon,2018,12503,11910,593,4.7
45,35,Dorchester,2018,75968,73709,2259,3.0
45,37,Edgefield,2018,10569,10206,363,3.4
45,39,Fairfield,2018,9560,8972,588,6.2
45,41,Florence,2018,65989,63635,2354,3.6
45,43,Georgetown,2018,25240,24101,1139,4.5
45,45,Greenville,2018,250548,243333,7215,2.9
45,47,Greenwood,2018,30840,29730,1110,3.6
45,49,Hampton,2018,8290,8011,279,3.4
45,51,Horry,2018,144473,138357,6116,4.2
45,53,Jasper,2018,12315,11951,364,3.0
45,55,Kershaw,2018,28753,27745,1008,3.5
45,57,Lancaster,2018,39963,38469,1494,3.7
45,59,Laurens,2018,29703,28656,1047,3.5
45,61,Lee,2018,6535,6239,296,4.5
45,63,Lexington,2018,147363,143194,4169,2.8
45,65,McCormick,2018,3378,3262,116,3.4
45,67,Marion,2018,12827,12129,698,5.4
45,69,Marlboro,2018,9107,8654,453,5.0
45,71,Newberry,2018,18821,18248,573,3.0
45,73,Oconee,2018,34508,33364,1144,3.3
45,75,Orangeburg,2018,34155,32213,1942,5.7
45,77,Pickens,2018,56507,54645,1862,3.3
45,79,Richland,2018,195532,188870,6662,3.4
45,81,Saluda,2018,8723,8455,268,3.1
45,83,Spartanburg,2018,148927,144350,4577,3.1
45,85,Sumter,2018,43478,41747,1731,4.0
45,87,Union,2018,11350,10882,468,4.1
45,89,Williamsburg,2018,12058,11407,651,5.4
45,91,York,2018,135905,131536,4369,3.2
46,3,Aurora,2018,1559,1515,44,2.8
46,5,Beadle,2018,9551,9309,242,2.5
46,7,Bennett,2018,1076,1030,46,4.3
46,9,Bon Homme,2018,2868,2798,70,2.4
46,11,Brookings,2018,19024,18504,520,2.7
46,13,Brown,2018,20830,20270,560,2.7
46,15,Brule,2018,2505,2441,64,2.6
46,17,Buffalo,2018,706,666,40,5.7
46,19,Butte,2018,5041,4883,158,3.1
46,21,Campbell,2018,784,754,30,3.8
46,23,Charles Mix,2018,3836,3720,116,3.0
46,25,Clark,2018,1906,1834,72,3.8
46,27,Clay,2018,7248,7049,199,2.7
46,29,Codington,2018,15342,14901,441,2.9
46,31,Corson,2018,1387,1333,54,3.9
46,33,Custer,2018,3998,3843,155,3.9
46,35,Davison,2018,11030,10756,274,2.5
46,37,Day,2018,2780,2666,114,4.1
46,39,Deuel,2018,2163,2071,92,4.3
46,41,Dewey,2018,2215,2030,185,8.4
46,43,Douglas,2018,1565,1526,39,2.5
46,45,Edmunds,2018,2062,2010,52,2.5
46,47,Fall River,2018,3002,2894,108,3.6
46,49,Faulk,2018,1095,1064,31,2.8
46,51,Grant,2018,4440,4304,136,3.1
46,53,Gregory,2018,2041,1978,63,3.1
46,55,Haakon,2018,1070,1043,27,2.5
46,57,Hamlin,2018,3244,3147,97,3.0
46,59,Hand,2018,1809,1770,39,2.2
46,61,Hanson,2018,1749,1671,78,4.5
46,63,Harding,2018,730,713,17,2.3
46,65,Hughes,2018,9885,9645,240,2.4
46,67,Hutchinson,2018,3572,3479,93,2.6
46,69,Hyde,2018,678,659,19,2.8
46,71,Jackson,2018,1280,1220,60,4.7
46,73,Jerauld,2018,1115,1089,26,2.3
46,75,Jones,2018,554,540,14,2.5
46,77,Kingsbury,2018,2657,2584,73,2.7
46,79,Lake,2018,6638,6423,215,3.2
46,81,Lawrence,2018,13055,12691,364,2.8
46,83,Lincoln,2018,33856,33107,749,2.2
46,85,Lyman,2018,1696,1629,67,4.0
46,87,McCook,2018,3039,2966,73,2.4
46,89,McPherson,2018,1021,984,37,3.6
46,91,Marshall,2018,2422,2334,88,3.6
46,93,Meade,2018,13998,13555,443,3.2
46,95,Mellette,2018,746,712,34,4.6
46,97,Miner,2018,1193,1162,31,2.6
46,99,Minnehaha,2018,110591,107816,2775,2.5
46,101,Moody,2018,4003,3889,114,2.8
46,102,Oglala Lakota,2018,3560,3208,352,9.9
46,103,Pennington,2018,56062,54418,1644,2.9
46,105,Perkins,2018,1441,1402,39,2.7
46,107,Potter,2018,1090,1053,37,3.4
46,109,Roberts,2018,4835,4637,198,4.1
46,111,Sanborn,2018,1149,1117,32,2.8
46,115,Spink,2018,3236,3128,108,3.3
46,117,Stanley,2018,1834,1788,46,2.5
46,119,Sully,2018,806,786,20,2.5
46,121,Todd,2018,3133,2947,186,5.9
46,123,Tripp,2018,3101,3027,74,2.4
46,125,Turner,2018,4649,4528,121,2.6
46,127,Union,2018,8395,8143,252,3.0
46,129,Walworth,2018,2211,2107,104,4.7
46,135,Yankton,2018,11821,11525,296,2.5
46,137,Ziebach,2018,921,875,46,5.0
47,1,Anderson,2018,34173,32891,1282,3.8
47,3,Bedford,2018,20732,19957,775,3.7
47,5,Benton,2018,6884,6548,336,4.9
47,7,Bledsoe,2018,4222,3973,249,5.9
47,9,Blount,2018,62563,60553,2010,3.2
47,11,Bradley,2018,50448,48651,1797,3.6
47,13,Campbell,2018,14637,13941,696,4.8
47,15,Cannon,2018,6416,6214,202,3.1
47,17,Carroll,2018,12019,11429,590,4.9
47,19,Carter,2018,23824,22839,985,4.1
47,21,Cheatham,2018,21311,20727,584,2.7
47,23,Chester,2018,8489,8173,316,3.7
47,25,Claiborne,2018,12960,12412,548,4.2
47,27,Clay,2018,2866,2726,140,4.9
47,29,Cocke,2018,14880,14187,693,4.7
47,31,Coffee,2018,24752,23881,871,3.5
47,33,Crockett,2018,6942,6674,268,3.9
47,35,Cumberland,2018,23295,22282,1013,4.3
47,37,Davidson,2018,393529,383138,10391,2.6
47,39,Decatur,2018,4490,4265,225,5.0
47,41,DeKalb,2018,7744,7398,346,4.5
47,43,Dickson,2018,26295,25500,795,3.0
47,45,Dyer,2018,16167,15431,736,4.6
47,47,Fayette,2018,18959,18255,704,3.7
47,49,Fentress,2018,7185,6888,297,4.1
47,51,Franklin,2018,19839,19172,667,3.4
47,53,Gibson,2018,21816,20868,948,4.3
47,55,Giles,2018,15265,14711,554,3.6
47,57,Grainger,2018,9359,8990,369,3.9
47,59,Greene,2018,29787,28415,1372,4.6
47,61,Grundy,2018,4888,4673,215,4.4
47,63,Hamblen,2018,27515,26468,1047,3.8
47,65,Hamilton,2018,180666,174582,6084,3.4
47,67,Hancock,2018,2122,2019,103,4.9
47,69,Hardeman,2018,9355,8900,455,4.9
47,71,Hardin,2018,10321,9870,451,4.4
47,73,Hawkins,2018,23716,22778,938,4.0
47,75,Haywood,2018,7718,7310,408,5.3
47,77,Henderson,2018,11985,11424,561,4.7
47,79,Henry,2018,14210,13618,592,4.2
47,81,Hickman,2018,11143,10784,359,3.2
47,83,Houston,2018,3234,3058,176,5.4
47,85,Humphreys,2018,8822,8445,377,4.3
47,87,Jackson,2018,4592,4378,214,4.7
47,89,Jefferson,2018,24067,23160,907,3.8
47,91,Johnson,2018,7562,7301,261,3.5
47,93,Knox,2018,240321,233285,7036,2.9
47,95,Lake,2018,1801,1709,92,5.1
47,97,Lauderdale,2018,9658,9100,558,5.8
47,99,Lawrence,2018,18434,17696,738,4.0
47,101,Lewis,2018,5058,4835,223,4.4
47,103,Lincoln,2018,16669,16162,507,3.0
47,105,Loudon,2018,23102,22323,779,3.4
47,107,McMinn,2018,22690,21766,924,4.1
47,109,McNairy,2018,8275,7823,452,5.5
47,111,Macon,2018,10967,10617,350,3.2
47,113,Madison,2018,48609,46786,1823,3.8
47,115,Marion,2018,12307,11734,573,4.7
47,117,Marshall,2018,15432,14900,532,3.4
47,119,Maury,2018,48125,46580,1545,3.2
47,121,Meigs,2018,5058,4828,230,4.5
47,123,Monroe,2018,19951,19217,734,3.7
47,125,Montgomery,2018,83908,80687,3221,3.8
47,127,Moore,2018,3494,3388,106,3.0
47,129,Morgan,2018,7792,7444,348,4.5
47,131,Obion,2018,12253,11650,603,4.9
47,133,Overton,2018,9782,9416,366,3.7
47,135,Perry,2018,3245,3107,138,4.3
47,137,Pickett,2018,2434,2341,93,3.8
47,139,Polk,2018,7292,6986,306,4.2
47,141,Putnam,2018,34380,33158,1222,3.6
47,143,Rhea,2018,13099,12367,732,5.6
47,145,Roane,2018,23054,22108,946,4.1
47,147,Robertson,2018,37055,35893,1162,3.1
47,149,Rutherford,2018,179223,174423,4800,2.7
47,151,Scott,2018,8263,7899,364,4.4
47,153,Sequatchie,2018,6086,5824,262,4.3
47,155,Sevier,2018,53129,51290,1839,3.5
47,157,Shelby,2018,441190,422970,18220,4.1
47,159,Smith,2018,9197,8918,279,3.0
47,161,Stewart,2018,5292,5031,261,4.9
47,163,Sullivan,2018,70267,67692,2575,3.7
47,165,Sumner,2018,99657,96899,2758,2.8
47,167,Tipton,2018,27952,26780,1172,4.2
47,169,Trousdale,2018,5286,5116,170,3.2
47,171,Unicoi,2018,7029,6685,344,4.9
47,173,Union,2018,7509,7205,304,4.0
47,175,Van Buren,2018,2059,1962,97,4.7
47,177,Warren,2018,16730,16068,662,4.0
47,179,Washington,2018,59929,57821,2108,3.5
47,181,Wayne,2018,6138,5844,294,4.8
47,183,Weakley,2018,15943,15272,671,4.2
47,185,White,2018,12243,11805,438,3.6
47,187,Williamson,2018,124964,121868,3096,2.5
47,189,Wilson,2018,74590,72529,2061,2.8
48,1,Anderson,2018,23388,22658,730,3.1
48,3,Andrews,2018,9410,9182,228,2.4
48,5,Angelina,2018,36038,34459,1579,4.4
48,7,Aransas,2018,9566,8995,571,6.0
48,9,Archer,2018,4140,4013,127,3.1
48,11,Armstrong,2018,921,896,25,2.7
48,13,Atascosa,2018,21406,20595,811,3.8
48,15,Austin,2018,13860,13349,511,3.7
48,17,Bailey,2018,2619,2503,116,4.4
48,19,Bandera,2018,9936,9596,340,3.4
48,21,Bastrop,2018,41659,40245,1414,3.4
48,23,Baylor,2018,1555,1505,50,3.2
48,25,Bee,2018,9939,9431,508,5.1
48,27,Bell,2018,142567,136627,5940,4.2
48,29,Bexar,2018,935933,904406,31527,3.4
48,31,Blanco,2018,6247,6083,164,2.6
48,33,Borden,2018,343,332,11,3.2
48,35,Bosque,2018,8215,7908,307,3.7
48,37,Bowie,2018,39469,37513,1956,5.0
48,39,Brazoria,2018,176525,168471,8054,4.6
48,41,Brazos,2018,116443,113099,3344,2.9
48,43,Brewster,2018,4043,3907,136,3.4
48,45,Briscoe,2018,559,537,22,3.9
48,47,Brooks,2018,2451,2293,158,6.4
48,49,Brown,2018,16017,15417,600,3.7
48,51,Burleson,2018,8222,7924,298,3.6
48,53,Burnet,2018,22912,22247,665,2.9
48,55,Caldwell,2018,19086,18385,701,3.7
48,57,Calhoun,2018,11207,10745,462,4.1
48,59,Callahan,2018,5982,5780,202,3.4
48,61,Cameron,2018,165896,155629,10267,6.2
48,63,Camp,2018,4999,4753,246,4.9
48,65,Carson,2018,2994,2909,85,2.8
48,67,Cass,2018,12294,11671,623,5.1
48,69,Castro,2018,3463,3363,100,2.9
48,71,Chambers,2018,19267,18224,1043,5.4
48,73,Cherokee,2018,20893,20028,865,4.1
48,75,Childress,2018,2950,2872,78,2.6
48,77,Clay,2018,4924,4767,157,3.2
48,79,Cochran,2018,1099,1051,48,4.4
48,81,Coke,2018,1454,1404,50,3.4
48,83,Coleman,2018,2938,2822,116,3.9
48,85,Collin,2018,551297,532841,18456,3.3
48,87,Collingsworth,2018,1181,1144,37,3.1
48,89,Colorado,2018,9672,9352,320,3.3
48,91,Comal,2018,72354,70032,2322,3.2
48,93,Comanche,2018,5370,5177,193,3.6
48,95,Concho,2018,1097,1057,40,3.6
48,97,Cooke,2018,19169,18573,596,3.1
48,99,Coryell,2018,23890,22883,1007,4.2
48,101,Cottle,2018,531,508,23,4.3
48,103,Crane,2018,1780,1711,69,3.9
48,105,Crockett,2018,1633,1585,48,2.9
48,107,Crosby,2018,2485,2369,116,4.7
48,109,Culberson,2018,975,945,30,3.1
48,111,Dallam,2018,4039,3956,83,2.1
48,113,Dallas,2018,1336429,1285401,51028,3.8
48,115,Dawson,2018,4562,4365,197,4.3
48,117,Deaf Smith,2018,8422,8185,237,2.8
48,119,Delta,2018,2445,2360,85,3.5
48,121,Denton,2018,483589,468029,15560,3.2
48,123,DeWitt,2018,9720,9415,305,3.1
48,125,Dickens,2018,673,644,29,4.3
48,127,Dimmit,2018,7356,7134,222,3.0
48,129,Donley,2018,1558,1504,54,3.5
48,131,Duval,2018,5064,4798,266,5.3
48,133,Eastland,2018,8670,8379,291,3.4
48,135,Ector,2018,85609,83282,2327,2.7
48,137,Edwards,2018,883,858,25,2.8
48,139,Ellis,2018,90662,87642,3020,3.3
48,141,El Paso,2018,358273,343062,15211,4.2
48,143,Erath,2018,20745,20102,643,3.1
48,145,Falls,2018,6511,6256,255,3.9
48,147,Fannin,2018,16453,15942,511,3.1
48,149,Fayette,2018,12593,12238,355,2.8
48,151,Fisher,2018,1650,1597,53,3.2
48,153,Floyd,2018,2670,2531,139,5.2
48,155,Foard,2018,584,567,17,2.9
48,157,Fort Bend,2018,386448,371033,15415,4.0
48,159,Franklin,2018,4565,4375,190,4.2
48,161,Freestone,2018,6552,6165,387,5.9
48,163,Frio,2018,10184,9892,292,2.9
48,165,Gaines,2018,9423,9181,242,2.6
48,167,Galveston,2018,163217,155611,7606,4.7
48,169,Garza,2018,2135,2072,63,3.0
48,171,Gillespie,2018,13375,13033,342,2.6
48,173,Glasscock,2018,852,834,18,2.1
48,175,Goliad,2018,3281,3155,126,3.8
48,177,Gonzales,2018,9482,9193,289,3.0
48,179,Gray,2018,8124,7807,317,3.9
48,181,Grayson,2018,63248,61158,2090,3.3
48,183,Gregg,2018,57461,55077,2384,4.1
48,185,Grimes,2018,11110,10650,460,4.1
48,187,Guadalupe,2018,80275,77741,2534,3.2
48,189,Hale,2018,12487,11888,599,4.8
48,191,Hall,2018,1109,1060,49,4.4
48,193,Hamilton,2018,3633,3513,120,3.3
48,195,Hansford,2018,2852,2786,66,2.3
48,197,Hardeman,2018,1677,1616,61,3.6
48,199,Hardin,2018,25385,24063,1322,5.2
48,201,Harris,2018,2285799,2184644,101155,4.4
48,203,Harrison,2018,29921,28612,1309,4.4
48,205,Hartley,2018,2862,2810,52,1.8
48,207,Haskell,2018,2355,2263,92,3.9
48,209,Hays,2018,116141,112689,3452,3.0
48,211,Hemphill,2018,2248,2201,47,2.1
48,213,Henderson,2018,36133,34763,1370,3.8
48,215,Hidalgo,2018,347614,324589,23025,6.6
48,217,Hill,2018,16283,15688,595,3.7
48,219,Hockley,2018,11429,11073,356,3.1
48,221,Hood,2018,27047,26043,1004,3.7
48,223,Hopkins,2018,17318,16729,589,3.4
48,225,Houston,2018,10198,9816,382,3.7
48,227,Howard,2018,13592,13142,450,3.3
48,229,Hudspeth,2018,1802,1719,83,4.6
48,231,Hunt,2018,42491,40865,1626,3.8
48,233,Hutchinson,2018,8994,8544,450,5.0
48,235,Irion,2018,767,743,24,3.1
48,237,Jack,2018,4376,4266,110,2.5
48,239,Jackson,2018,7365,7123,242,3.3
48,241,Jasper,2018,13233,12366,867,6.6
48,243,Jeff Davis,2018,1068,1037,31,2.9
48,245,Jefferson,2018,107199,100353,6846,6.4
48,247,Jim Hogg,2018,1879,1771,108,5.7
48,249,Jim Wells,2018,16984,16058,926,5.5
48,251,Johnson,2018,80439,77661,2778,3.5
48,253,Jones,2018,5619,5348,271,4.8
48,255,Karnes,2018,6858,6662,196,2.9
48,257,Kaufman,2018,63121,60923,2198,3.5
48,259,Kendall,2018,21850,21211,639,2.9
48,261,Kenedy,2018,246,237,9,3.7
48,263,Kent,2018,451,440,11,2.4
48,265,Kerr,2018,21793,21085,708,3.2
48,267,Kimble,2018,1874,1817,57,3.0
48,269,King,2018,211,205,6,2.8
48,271,Kinney,2018,1351,1292,59,4.4
48,273,Kleberg,2018,13310,12647,663,5.0
48,275,Knox,2018,1451,1399,52,3.6
48,277,Lamar,2018,23760,22857,903,3.8
48,279,Lamb,2018,5209,4978,231,4.4
48,281,Lampasas,2018,9148,8804,344,3.8
48,283,La Salle,2018,4583,4472,111,2.4
48,285,Lavaca,2018,8782,8507,275,3.1
48,287,Lee,2018,9469,9178,291,3.1
48,289,Leon,2018,6127,5819,308,5.0
48,291,Liberty,2018,32718,30807,1911,5.8
48,293,Limestone,2018,8405,8013,392,4.7
48,295,Lipscomb,2018,1651,1606,45,2.7
48,297,Live Oak,2018,5179,4983,196,3.8
48,299,Llano,2018,8517,8199,318,3.7
48,301,Loving,2018,268,264,4,1.5
48,303,Lubbock,2018,156474,151661,4813,3.1
48,305,Lynn,2018,2747,2657,90,3.3
48,307,McCulloch,2018,3748,3624,124,3.3
48,309,McLennan,2018,118175,113913,4262,3.6
48,311,McMullen,2018,717,703,14,2.0
48,313,Madison,2018,4564,4362,202,4.4
48,315,Marion,2018,4252,4059,193,4.5
48,317,Martin,2018,2769,2700,69,2.5
48,319,Mason,2018,1773,1718,55,3.1
48,321,Matagorda,2018,16802,15768,1034,6.2
48,323,Maverick,2018,23640,21703,1937,8.2
48,325,Medina,2018,21550,20797,753,3.5
48,327,Menard,2018,827,793,34,4.1
48,329,Midland,2018,102909,100707,2202,2.1
48,331,Milam,2018,9886,9340,546,5.5
48,333,Mills,2018,1870,1804,66,3.5
48,335,Mitchell,2018,2325,2228,97,4.2
48,337,Montague,2018,9136,8843,293,3.2
48,339,Montgomery,2018,279580,269052,10528,3.8
48,341,Moore,2018,10865,10575,290,2.7
48,343,Morris,2018,4708,4397,311,6.6
48,345,Motley,2018,462,445,17,3.7
48,347,Nacogdoches,2018,28645,27526,1119,3.9
48,349,Navarro,2018,23643,22766,877,3.7
48,351,Newton,2018,5187,4837,350,6.7
48,353,Nolan,2018,6716,6494,222,3.3
48,355,Nueces,2018,167819,159957,7862,4.7
48,357,Ochiltree,2018,4454,4329,125,2.8
48,359,Oldham,2018,906,882,24,2.6
48,361,Orange,2018,36515,34391,2124,5.8
48,363,Palo Pinto,2018,13496,13043,453,3.4
48,365,Panola,2018,10697,10248,449,4.2
48,367,Parker,2018,65925,63873,2052,3.1
48,369,Parmer,2018,4884,4769,115,2.4
48,371,Pecos,2018,6415,6180,235,3.7
48,373,Polk,2018,17834,16928,906,5.1
48,375,Potter,2018,54879,53264,1615,2.9
48,377,Presidio,2018,3041,2829,212,7.0
48,379,Rains,2018,5907,5700,207,3.5
48,381,Randall,2018,71612,69735,1877,2.6
48,383,Reagan,2018,1874,1827,47,2.5
48,385,Real,2018,1049,996,53,5.1
48,387,Red River,2018,5088,4811,277,5.4
48,389,Reeves,2018,9406,9210,196,2.1
48,391,Refugio,2018,3136,2991,145,4.6
48,393,Roberts,2018,428,416,12,2.8
48,395,Robertson,2018,7534,7218,316,4.2
48,397,Rockwall,2018,50910,49257,1653,3.2
48,399,Runnels,2018,4575,4431,144,3.1
48,401,Rusk,2018,22762,21830,932,4.1
48,403,Sabine,2018,3545,3263,282,8.0
48,405,San Augustine,2018,3006,2811,195,6.5
48,407,San Jacinto,2018,11516,10940,576,5.0
48,409,San Patricio,2018,30078,28163,1915,6.4
48,411,San Saba,2018,2537,2459,78,3.1
48,413,Schleicher,2018,1369,1330,39,2.8
48,415,Scurry,2018,6926,6690,236,3.4
48,417,Shackelford,2018,1942,1897,45,2.3
48,419,Shelby,2018,11020,10543,477,4.3
48,421,Sherman,2018,1329,1294,35,2.6
48,423,Smith,2018,106791,102871,3920,3.7
48,425,Somervell,2018,4291,4113,178,4.1
48,427,Starr,2018,25182,22624,2558,10.2
48,429,Stephens,2018,3992,3847,145,3.6
48,431,Sterling,2018,582,562,20,3.4
48,433,Stonewall,2018,589,569,20,3.4
48,435,Sutton,2018,1457,1401,56,3.8
48,437,Swisher,2018,2652,2538,114,4.3
48,439,Tarrant,2018,1059616,1022224,37392,3.5
48,441,Taylor,2018,65318,63243,2075,3.2
48,443,Terrell,2018,378,365,13,3.4
48,445,Terry,2018,5128,4919,209,4.1
48,447,Throckmorton,2018,700,677,23,3.3
48,449,Titus,2018,12895,12242,653,5.1
48,451,Tom Green,2018,54626,52898,1728,3.2
48,453,Travis,2018,718946,698327,20619,2.9
48,455,Trinity,2018,5313,5038,275,5.2
48,457,Tyler,2018,6980,6516,464,6.6
48,459,Upshur,2018,17670,16925,745,4.2
48,461,Upton,2018,1579,1525,54,3.4
48,463,Uvalde,2018,11463,10972,491,4.3
48,465,Val Verde,2018,22417,21544,873,3.9
48,467,Van Zandt,2018,25748,24840,908,3.5
48,469,Victoria,2018,42944,41289,1655,3.9
48,471,Walker,2018,23872,22865,1007,4.2
48,473,Waller,2018,23136,22145,991,4.3
48,475,Ward,2018,6770,6596,174,2.6
48,477,Washington,2018,14867,14325,542,3.6
48,479,Webb,2018,116260,111852,4408,3.8
48,481,Wharton,2018,21278,20484,794,3.7
48,483,Wheeler,2018,2426,2349,77,3.2
48,485,Wichita,2018,56349,54419,1930,3.4
48,487,Wilbarger,2018,4976,4768,208,4.2
48,489,Willacy,2018,6391,5757,634,9.9
48,491,Williamson,2018,304100,294742,9358,3.1
48,493,Wilson,2018,24538,23779,759,3.1
48,495,Winkler,2018,4024,3909,115,2.9
48,497,Wise,2018,31241,30160,1081,3.5
48,499,Wood,2018,17351,16608,743,4.3
48,501,Yoakum,2018,3712,3605,107,2.9
48,503,Young,2018,8163,7898,265,3.2
48,505,Zapata,2018,5358,5059,299,5.6
48,507,Zavala,2018,3560,3216,344,9.7
49,1,Beaver,2018,3013,2913,100,3.3
49,3,Box Elder,2018,25503,24781,722,2.8
49,5,Cache,2018,63410,61817,1593,2.5
49,7,Carbon,2018,8476,8119,357,4.2
49,9,Daggett,2018,400,383,17,4.3
49,11,Davis,2018,170378,165705,4673,2.7
49,13,Duchesne,2018,7725,7395,330,4.3
49,15,Emery,2018,4329,4134,195,4.5
49,17,Garfield,2018,2775,2570,205,7.4
49,19,Grand,2018,6068,5795,273,4.5
49,21,Iron,2018,22910,22141,769,3.4
49,23,Juab,2018,5578,5421,157,2.8
49,25,Kane,2018,3794,3679,115,3.0
49,27,Millard,2018,6214,6023,191,3.1
49,29,Morgan,2018,5452,5311,141,2.6
49,31,Piute,2018,481,457,24,5.0
49,33,Rich,2018,1175,1139,36,3.1
49,35,Salt Lake,2018,620857,603295,17562,2.8
49,37,San Juan,2018,5707,5372,335,5.9
49,39,Sanpete,2018,12475,12038,437,3.5
49,41,Sevier,2018,9883,9552,331,3.3
49,43,Summit,2018,24409,23716,693,2.8
49,45,Tooele,2018,33277,32213,1064,3.2
49,47,Uintah,2018,13606,13007,599,4.4
49,49,Utah,2018,299761,291774,7987,2.7
49,51,Wasatch,2018,15162,14712,450,3.0
49,53,Washington,2018,74196,71810,2386,3.2
49,55,Wayne,2018,1429,1348,81,5.7
49,57,Weber,2018,125177,121080,4097,3.3
50,1,Addison,2018,20806,20281,525,2.5
50,3,Bennington,2018,18381,17813,568,3.1
50,5,Caledonia,2018,14744,14265,479,3.2
50,7,Chittenden,2018,97469,95504,1965,2.0
50,9,Essex,2018,2705,2608,97,3.6
50,11,Franklin,2018,27683,26995,688,2.5
50,13,Grand Isle,2018,4088,3958,130,3.2
50,15,Lamoille,2018,14028,13538,490,3.5
50,17,Orange,2018,16001,15578,423,2.6
50,19,Orleans,2018,13568,12966,602,4.4
50,21,Rutland,2018,30882,29926,956,3.1
50,23,Washington,2018,34657,33770,887,2.6
50,25,Windham,2018,22561,21927,634,2.8
50,27,Windsor,2018,29148,28476,672,2.3
51,1,Accomack,2018,16821,16187,634,3.8
51,3,Albemarle,2018,56470,54975,1495,2.6
51,5,Alleghany,2018,6962,6707,255,3.7
51,7,Amelia,2018,6236,6034,202,3.2
51,9,Amherst,2018,15012,14524,488,3.3
51,11,Appomattox,2018,7151,6893,258,3.6
51,13,Arlington,2018,152972,149941,3031,2.0
51,15,Augusta,2018,36971,35981,990,2.7
51,17,Bath,2018,2526,2464,62,2.5
51,19,Bedford,2018,38448,37288,1160,3.0
51,21,Bland,2018,2846,2757,89,3.1
51,23,Botetourt,2018,17365,16904,461,2.7
51,25,Brunswick,2018,6024,5730,294,4.9
51,27,Buchanan,2018,6956,6581,375,5.4
51,29,Buckingham,2018,6339,6060,279,4.4
51,31,Campbell,2018,26008,25141,867,3.3
51,33,Caroline,2018,15213,14691,522,3.4
51,35,Carroll,2018,13348,12873,475,3.6
51,36,Charles City,2018,3659,3514,145,4.0
51,37,Charlotte,2018,5232,5043,189,3.6
51,41,Chesterfield,2018,186989,181588,5401,2.9
51,43,Clarke,2018,7535,7320,215,2.9
51,45,Craig,2018,2300,2219,81,3.5
51,47,Culpeper,2018,24392,23699,693,2.8
51,49,Cumberland,2018,4669,4519,150,3.2
51,51,Dickenson,2018,4540,4310,230,5.1
51,53,Dinwiddie,2018,13611,13141,470,3.5
51,57,Essex,2018,5530,5322,208,3.8
51,59,Fairfax,2018,629934,614669,15265,2.4
51,61,Fauquier,2018,36857,35907,950,2.6
51,63,Floyd,2018,8147,7928,219,2.7
51,65,Fluvanna,2018,13733,13393,340,2.5
51,67,Franklin,2018,26302,25503,799,3.0
51,69,Frederick,2018,47578,46353,1225,2.6
51,71,Giles,2018,7870,7611,259,3.3
51,73,Gloucester,2018,19573,19053,520,2.7
51,75,Goochland,2018,11176,10848,328,2.9
51,77,Grayson,2018,7703,7472,231,3.0
51,79,Greene,2018,10355,10097,258,2.5
51,81,Greensville,2018,4391,4233,158,3.6
51,83,Halifax,2018,15219,14605,614,4.0
51,85,Hanover,2018,59058,57535,1523,2.6
51,87,Henrico,2018,181605,176228,5377,3.0
51,89,Henry,2018,23777,22907,870,3.7
51,91,Highland,2018,1261,1227,34,2.7
51,93,Isle of Wight,2018,19438,18870,568,2.9
51,95,James City,2018,36666,35618,1048,2.9
51,97,King and Queen,2018,3868,3752,116,3.0
51,99,King George,2018,13256,12870,386,2.9
51,101,King William,2018,9124,8859,265,2.9
51,103,Lancaster,2018,5315,5087,228,4.3
51,105,Lee,2018,8344,8005,339,4.1
51,107,Loudoun,2018,220649,215251,5398,2.4
51,109,Louisa,2018,19852,19307,545,2.7
51,111,Lunenburg,2018,5344,5174,170,3.2
51,113,Madison,2018,7307,7131,176,2.4
51,115,Mathews,2018,4141,4019,122,2.9
51,117,Mecklenburg,2018,12723,12213,510,4.0
51,119,Middlesex,2018,5255,5115,140,2.7
51,121,Montgomery,2018,50092,48636,1456,2.9
51,125,Nelson,2018,7352,7127,225,3.1
51,127,New Kent,2018,12455,12122,333,2.7
51,131,Northampton,2018,5406,5118,288,5.3
51,133,Northumberland,2018,5565,5321,244,4.4
51,135,Nottoway,2018,7244,7024,220,3.0
51,137,Orange,2018,17092,16583,509,3.0
51,139,Page,2018,11944,11452,492,4.1
51,141,Patrick,2018,7468,7183,285,3.8
51,143,Pittsylvania,2018,30626,29554,1072,3.5
51,145,Powhatan,2018,14091,13719,372,2.6
51,147,Prince Edward,2018,10448,10052,396,3.8
51,149,Prince George,2018,15053,14514,539,3.6
51,153,Prince William,2018,243624,237019,6605,2.7
51,155,Pulaski,2018,16045,15498,547,3.4
51,157,Rappahannock,2018,3657,3558,99,2.7
51,159,Richmond,2018,4069,3944,125,3.1
51,161,Roanoke,2018,49298,47975,1323,2.7
51,163,Rockbridge,2018,10616,10302,314,3.0
51,165,Rockingham,2018,41277,40190,1087,2.6
51,167,Russell,2018,11234,10761,473,4.2
51,169,Scott,2018,9142,8848,294,3.2
51,171,Shenandoah,2018,22274,21648,626,2.8
51,173,Smyth,2018,13721,13182,539,3.9
51,175,Southampton,2018,9072,8823,249,2.7
51,177,Spotsylvania,2018,66458,64449,2009,3.0
51,179,Stafford,2018,71464,69378,2086,2.9
51,181,Surry,2018,3766,3640,126,3.3
51,183,Sussex,2018,3777,3592,185,4.9
51,185,Tazewell,2018,15978,15283,695,4.3
51,187,Warren,2018,20264,19649,615,3.0
51,191,Washington,2018,26785,25891,894,3.3
51,193,Westmoreland,2018,9413,9072,341,3.6
51,195,Wise,2018,13264,12617,647,4.9
51,197,Wythe,2018,13788,13281,507,3.7
51,199,York,2018,32809,31905,904,2.8
51,510,Alexandria city,2018,100466,98217,2249,2.2
51,520,Bristol city,2018,7210,6942,268,3.7
51,530,Buena Vista city,2018,3366,3262,104,3.1
51,540,Charlottesville city,2018,26087,25431,656,2.5
51,550,Chesapeake city,2018,122864,119190,3674,3.0
51,570,Colonial Heights city,2018,8778,8489,289,3.3
51,580,Covington city,2018,2410,2299,111,4.6
51,590,Danville city,2018,19656,18672,984,5.0
51,595,Emporia city,2018,2343,2233,110,4.7
51,600,Fairfax city,2018,13335,13035,300,2.2
51,610,Falls Church city,2018,8522,8341,181,2.1
51,620,Franklin city,2018,3604,3449,155,4.3
51,630,Fredericksburg city,2018,14027,13546,481,3.4
51,640,Galax city,2018,2943,2843,100,3.4
51,650,Hampton city,2018,64540,61960,2580,4.0
51,660,Harrisonburg city,2018,24667,23817,850,3.4
51,670,Hopewell city,2018,9688,9229,459,4.7
51,678,Lexington city,2018,2087,1990,97,4.6
51,680,Lynchburg city,2018,36407,34963,1444,4.0
51,683,Manassas city,2018,21873,21291,582,2.7
51,685,Manassas Park city,2018,9305,9055,250,2.7
51,690,Martinsville city,2018,5493,5244,249,4.5
51,700,Newport News city,2018,88970,85778,3192,3.6
51,710,Norfolk city,2018,111831,107819,4012,3.6
51,720,Norton city,2018,1672,1607,65,3.9
51,730,Petersburg city,2018,13038,12247,791,6.1
51,735,Poquoson city,2018,6390,6222,168,2.6
51,740,Portsmouth city,2018,44355,42566,1789,4.0
51,750,Radford city,2018,8653,8329,324,3.7
51,760,Richmond city,2018,118086,113965,4121,3.5
51,770,Roanoke city,2018,49103,47534,1569,3.2
51,775,Salem city,2018,12963,12583,380,2.9
51,790,Staunton city,2018,12072,11731,341,2.8
51,800,Suffolk city,2018,44705,43282,1423,3.2
51,810,Virginia Beach city,2018,233418,226811,6607,2.8
51,820,Waynesboro city,2018,10568,10231,337,3.2
51,830,Williamsburg city,2018,6702,6435,267,4.0
51,840,Winchester city,2018,14611,14183,428,2.9
53,1,Adams,2018,9381,8880,501,5.3
53,3,Asotin,2018,10196,9764,432,4.2
53,5,Benton,2018,99044,93932,5112,5.2
53,7,Chelan,2018,45142,43106,2036,4.5
53,9,Clallam,2018,28114,26346,1768,6.3
53,11,Clark,2018,233167,222162,11005,4.7
53,13,Columbia,2018,1793,1695,98,5.5
53,15,Cowlitz,2018,46336,43633,2703,5.8
53,17,Douglas,2018,21756,20617,1139,5.2
53,19,Ferry,2018,2506,2220,286,11.4
53,21,Franklin,2018,41665,39165,2500,6.0
53,23,Garfield,2018,905,853,52,5.7
53,25,Grant,2018,46531,43669,2862,6.2
53,27,Grays Harbor,2018,28251,26380,1871,6.6
53,29,Island,2018,34684,32898,1786,5.1
53,31,Jefferson,2018,12269,11571,698,5.7
53,33,King,2018,1268039,1226711,41328,3.3
53,35,Kitsap,2018,123558,117924,5634,4.6
53,37,Kittitas,2018,22034,20847,1187,5.4
53,39,Klickitat,2018,10094,9530,564,5.6
53,41,Lewis,2018,33933,31835,2098,6.2
53,43,Lincoln,2018,5076,4833,243,4.8
53,45,Mason,2018,24452,22930,1522,6.2
53,47,Okanogan,2018,20613,19305,1308,6.3
53,49,Pacific,2018,8414,7843,571,6.8
53,51,Pend Oreille,2018,4843,4503,340,7.0
53,53,Pierce,2018,425974,404253,21721,5.1
53,55,San Juan,2018,8286,7968,318,3.8
53,57,Skagit,2018,60578,57478,3100,5.1
53,59,Skamania,2018,5355,5061,294,5.5
53,61,Snohomish,2018,431981,416631,15350,3.6
53,63,Spokane,2018,245374,232770,12604,5.1
53,65,Stevens,2018,18381,17093,1288,7.0
53,67,Thurston,2018,138126,131616,6510,4.7
53,69,Wahkiakum,2018,1333,1245,88,6.6
53,71,Walla Walla,2018,29363,27999,1364,4.6
53,73,Whatcom,2018,111724,106483,5241,4.7
53,75,Whitman,2018,23561,22542,1019,4.3
53,77,Yakima,2018,129034,120972,8062,6.2
54,1,Barbour,2018,6930,6518,412,5.9
54,3,Berkeley,2018,58008,55668,2340,4.0
54,5,Boone,2018,7518,7063,455,6.1
54,7,Braxton,2018,5148,4788,360,7.0
54,9,Brooke,2018,9952,9351,601,6.0
54,11,Cabell,2018,41410,39471,1939,4.7
54,13,Calhoun,2018,2440,2187,253,10.4
54,15,Clay,2018,3149,2886,263,8.4
54,17,Doddridge,2018,3994,3838,156,3.9
54,19,Fayette,2018,16039,15028,1011,6.3
54,21,Gilmer,2018,2387,2237,150,6.3
54,23,Grant,2018,5872,5540,332,5.7
54,25,Greenbrier,2018,15776,14981,795,5.0
54,27,Hampshire,2018,10496,10051,445,4.2
54,29,Hancock,2018,13006,12247,759,5.8
54,31,Hardy,2018,5833,5515,318,5.5
54,33,Harrison,2018,34407,32864,1543,4.5
54,35,Jackson,2018,16344,15696,648,4.0
54,37,Jefferson,2018,29968,28972,996,3.3
54,39,Kanawha,2018,83215,78961,4254,5.1
54,41,Lewis,2018,6731,6359,372,5.5
54,43,Lincoln,2018,7185,6692,493,6.9
54,45,Logan,2018,10837,10094,743,6.9
54,47,McDowell,2018,4502,4083,419,9.3
54,49,Marion,2018,25456,24011,1445,5.7
54,51,Marshall,2018,14282,13459,823,5.8
54,53,Mason,2018,10020,9326,694,6.9
54,55,Mercer,2018,21188,19868,1320,6.2
54,57,Mineral,2018,12407,11731,676,5.4
54,59,Mingo,2018,6908,6388,520,7.5
54,61,Monongalia,2018,54206,52005,2201,4.1
54,63,Monroe,2018,5848,5569,279,4.8
54,65,Morgan,2018,8042,7698,344,4.3
54,67,Nicholas,2018,9380,8781,599,6.4
54,69,Ohio,2018,21534,20550,984,4.6
54,71,Pendleton,2018,3568,3436,132,3.7
54,73,Pleasants,2018,2872,2695,177,6.2
54,75,Pocahontas,2018,3835,3602,233,6.1
54,77,Preston,2018,15481,14677,804,5.2
54,79,Putnam,2018,26629,25331,1298,4.9
54,81,Raleigh,2018,29993,28439,1554,5.2
54,83,Randolph,2018,12148,11485,663,5.5
54,85,Ritchie,2018,4354,4123,231,5.3
54,87,Roane,2018,4994,4606,388,7.8
54,89,Summers,2018,4251,3993,258,6.1
54,91,Taylor,2018,7858,7480,378,4.8
54,93,Tucker,2018,3360,3177,183,5.4
54,95,Tyler,2018,3130,2904,226,7.2
54,97,Upshur,2018,9488,8950,538,5.7
54,99,Wayne,2018,15749,14819,930,5.9
54,101,Webster,2018,3201,2999,202,6.3
54,103,Wetzel,2018,6623,6153,470,7.1
54,105,Wirt,2018,2233,2079,154,6.9
54,107,Wood,2018,36399,34429,1970,5.4
54,109,Wyoming,2018,6871,6395,476,6.9
55,1,Adams,2018,8147,7761,386,4.7
55,3,Ashland,2018,7876,7539,337,4.3
55,5,Barron,2018,24809,23971,838,3.4
55,7,Bayfield,2018,7543,7175,368,4.9
55,9,Brown,2018,142099,138170,3929,2.8
55,11,Buffalo,2018,6571,6345,226,3.4
55,13,Burnett,2018,7266,6933,333,4.6
55,15,Calumet,2018,27598,26881,717,2.6
55,17,Chippewa,2018,33217,32122,1095,3.3
55,19,Clark,2018,17952,17435,517,2.9
55,21,Columbia,2018,31341,30489,852,2.7
55,23,Crawford,2018,7805,7517,288,3.7
55,25,Dane,2018,318740,311552,7188,2.3
55,27,Dodge,2018,47779,46519,1260,2.6
55,29,Door,2018,15356,14804,552,3.6
55,31,Douglas,2018,23127,22207,920,4.0
55,33,Dunn,2018,24272,23530,742,3.1
55,35,Eau Claire,2018,58828,57286,1542,2.6
55,37,Florence,2018,2257,2172,85,3.8
55,39,Fond du Lac,2018,57009,55492,1517,2.7
55,41,Forest,2018,3960,3769,191,4.8
55,43,Grant,2018,28130,27339,791,2.8
55,45,Green,2018,20978,20437,541,2.6
55,47,Green Lake,2018,9669,9346,323,3.3
55,49,Iowa,2018,13738,13378,360,2.6
55,51,Iron,2018,2564,2415,149,5.8
55,53,Jackson,2018,10526,10197,329,3.1
55,55,Jefferson,2018,45876,44556,1320,2.9
55,57,Juneau,2018,13453,13041,412,3.1
55,59,Kenosha,2018,89146,85986,3160,3.5
55,61,Kewaunee,2018,11157,10834,323,2.9
55,63,La Crosse,2018,66673,64918,1755,2.6
55,65,Lafayette,2018,10171,9937,234,2.3
55,67,Langlade,2018,9446,9071,375,4.0
55,69,Lincoln,2018,15208,14730,478,3.1
55,71,Manitowoc,2018,41054,39780,1274,3.1
55,73,Marathon,2018,73641,71682,1959,2.7
55,75,Marinette,2018,19528,18742,786,4.0
55,77,Marquette,2018,7665,7393,272,3.5
55,78,Menominee,2018,1618,1525,93,5.7
55,79,Milwaukee,2018,466786,449692,17094,3.7
55,81,Monroe,2018,23454,22809,645,2.8
55,83,Oconto,2018,20687,20001,686,3.3
55,85,Oneida,2018,18081,17435,646,3.6
55,87,Outagamie,2018,102950,100051,2899,2.8
55,89,Ozaukee,2018,49068,47823,1245,2.5
55,91,Pepin,2018,4207,4071,136,3.2
55,93,Pierce,2018,25366,24553,813,3.2
55,95,Polk,2018,24484,23577,907,3.7
55,97,Portage,2018,38922,37748,1174,3.0
55,99,Price,2018,6607,6361,246,3.7
55,101,Racine,2018,98765,95174,3591,3.6
55,103,Richland,2018,9258,9014,244,2.6
55,105,Rock,2018,84652,81889,2763,3.3
55,107,Rusk,2018,6927,6652,275,4.0
55,109,St. Croix,2018,50265,48738,1527,3.0
55,111,Sauk,2018,35420,34511,909,2.6
55,113,Sawyer,2018,7918,7577,341,4.3
55,115,Shawano,2018,21318,20674,644,3.0
55,117,Sheboygan,2018,62275,60708,1567,2.5
55,119,Taylor,2018,10990,10647,343,3.1
55,121,Trempealeau,2018,16248,15784,464,2.9
55,123,Vernon,2018,15401,14956,445,2.9
55,125,Vilas,2018,10110,9710,400,4.0
55,127,Walworth,2018,58021,56308,1713,3.0
55,129,Washburn,2018,7882,7576,306,3.9
55,131,Washington,2018,77263,75285,1978,2.6
55,133,Waukesha,2018,224836,218839,5997,2.7
55,135,Waupaca,2018,26152,25379,773,3.0
55,137,Waushara,2018,11557,11154,403,3.5
55,139,Winnebago,2018,91785,89260,2525,2.8
55,141,Wood,2018,35086,33872,1214,3.5
56,1,Albany,2018,20599,19917,682,3.3
56,3,Big Horn,2018,5327,5077,250,4.7
56,5,Campbell,2018,23268,22317,951,4.1
56,7,Carbon,2018,7943,7647,296,3.7
56,9,Converse,2018,7726,7444,282,3.7
56,11,Crook,2018,3769,3647,122,3.2
56,13,Fremont,2018,19123,18124,999,5.2
56,15,Goshen,2018,6911,6681,230,3.3
56,17,Hot Springs,2018,2255,2173,82,3.6
56,19,Johnson,2018,4286,4115,171,4.0
56,21,Laramie,2018,48759,46874,1885,3.9
56,23,Lincoln,2018,8889,8550,339,3.8
56,25,Natrona,2018,39735,37896,1839,4.6
56,27,Niobrara,2018,1296,1260,36,2.8
56,29,Park,2018,15777,15088,689,4.4
56,31,Platte,2018,4840,4659,181,3.7
56,33,Sheridan,2018,15920,15276,644,4.0
56,35,Sublette,2018,4301,4116,185,4.3
56,37,Sweetwater,2018,21539,20635,904,4.2
56,39,Teton,2018,15579,15111,468,3.0
56,41,Uinta,2018,9136,8739,397,4.3
56,43,Washakie,2018,4106,3932,174,4.2
56,45,Weston,2018,3810,3678,132,3.5
72,1,Adjuntas Municipio,2018,4036,3484,552,13.7
72,3,Aguada Municipio,2018,11848,10534,1314,11.1
72,5,Aguadilla Municipio,2018,14663,12846,1817,12.4
72,7,Aguas Buenas Municipio,2018,6485,5832,653,10.1
72,9,Aibonito Municipio,2018,6434,5667,767,11.9
72,11,Anasco Municipio,2018,8812,7966,846,9.6
72,13,Arecibo Municipio,2018,23268,20853,2415,10.4
72,15,Arroyo Municipio,2018,4629,3995,634,13.7
72,17,Barceloneta Municipio,2018,5829,5143,686,11.8
72,19,Barranquitas Municipio,2018,7360,6612,748,10.2
72,21,Bayamon Municipio,2018,64180,59816,4364,6.8
72,23,Cabo Rojo Municipio,2018,13617,12195,1422,10.4
72,25,Caguas Municipio,2018,47283,43609,3674,7.8
72,27,Camuy Municipio,2018,9312,8395,917,9.8
72,29,Canovanas Municipio,2018,15935,14682,1253,7.9
72,31,Carolina Municipio,2018,60752,56627,4125,6.8
72,33,Catano Municipio,2018,7723,7103,620,8.0
72,35,Cayey Municipio,2018,15884,14655,1229,7.7
72,37,Ceiba Municipio,2018,3777,3263,514,13.6
72,39,Ciales Municipio,2018,3682,3223,459,12.5
72,41,Cidra Municipio,2018,15273,14114,1159,7.6
72,43,Coamo Municipio,2018,9913,8540,1373,13.9
72,45,Comerio Municipio,2018,4869,4368,501,10.3
72,47,Corozal Municipio,2018,8884,8046,838,9.4
72,49,Culebra Municipio,2018,894,855,39,4.4
72,51,Dorado Municipio,2018,12884,12134,750,5.8
72,53,Fajardo Municipio,2018,11176,9601,1575,14.1
72,54,Florida Municipio,2018,3298,2906,392,11.9
72,55,Guanica Municipio,2018,3927,3320,607,15.5
72,57,Guayama Municipio,2018,11072,9599,1473,13.3
72,59,Guayanilla Municipio,2018,4929,4219,710,14.4
72,61,Guaynabo Municipio,2018,36813,35198,1615,4.4
72,63,Gurabo Municipio,2018,17832,16693,1139,6.4
72,65,Hatillo Municipio,2018,13158,11488,1670,12.7
72,67,Hormigueros Municipio,2018,5418,4886,532,9.8
72,69,Humacao Municipio,2018,17054,15084,1970,11.6
72,71,Isabela Municipio,2018,12379,11067,1312,10.6
72,73,Jayuya Municipio,2018,4119,3681,438,10.6
72,75,Juana Diaz Municipio,2018,14823,13270,1553,10.5
72,77,Juncos Municipio,2018,12184,11028,1156,9.5
72,79,Lajas Municipio,2018,5236,4434,802,15.3
72,81,Lares Municipio,2018,6975,5847,1128,16.2
72,83,Las Marias Municipio,2018,2620,2250,370,14.1
72,85,Las Piedras Municipio,2018,11147,10070,1077,9.7
72,87,Loiza Municipio,2018,8310,7619,691,8.3
72,89,Luquillo Municipio,2018,6337,5483,854,13.5
72,91,Manati Municipio,2018,11381,10401,980,8.6
72,93,Maricao Municipio,2018,1904,1617,287,15.1
72,95,Maunabo Municipio,2018,2895,2454,441,15.2
72,97,Mayaguez Municipio,2018,21958,19459,2499,11.4
72,99,Moca Municipio,2018,10516,9280,1236,11.8
72,101,Morovis Municipio,2018,7888,7122,766,9.7
72,103,Naguabo Municipio,2018,8157,7254,903,11.1
72,105,Naranjito Municipio,2018,7064,6371,693,9.8
72,107,Orocovis Municipio,2018,4995,4380,615,12.3
72,109,Patillas Municipio,2018,4380,3611,769,17.6
72,111,Penuelas Municipio,2018,5759,4965,794,13.8
72,113,Ponce Municipio,2018,44731,40331,4400,9.8
72,115,Quebradillas Municipio,2018,5998,5171,827,13.8
72,117,Rincon Municipio,2018,4713,4042,671,14.2
72,119,Rio Grande Municipio,2018,16916,15360,1556,9.2
72,121,Sabana Grande Municipio,2018,6119,5267,852,13.9
72,123,Salinas Municipio,2018,7149,6094,1055,14.8
72,125,San German Municipio,2018,9652,8474,1178,12.2
72,127,San Juan Municipio,2018,131883,123646,8237,6.2
72,129,San Lorenzo Municipio,2018,11626,10453,1173,10.1
72,131,San Sebastian Municipio,2018,10271,8767,1504,14.6
72,133,Santa Isabel Municipio,2018,8667,7553,1114,12.9
72,135,Toa Alta Municipio,2018,26687,25013,1674,6.3
72,137,Toa Baja Municipio,2018,28836,26929,1907,6.6
72,139,Trujillo Alto Municipio,2018,26549,25168,1381,5.2
72,141,Utuado Municipio,2018,6625,5858,767,11.6
72,143,Vega Alta Municipio,2018,9592,8747,845,8.8
72,145,Vega Baja Municipio,2018,13159,11787,1372,10.4
72,147,Vieques Municipio,2018,2726,2276,450,16.5
72,149,Villalba Municipio,2018,7335,6174,1161,15.8
72,151,Yabucoa Municipio,2018,8791,7534,1257,14.3
72,153,Yauco Municipio,2018,9748,8315,1433,14.7
1,1,Autauga,2019,26281,25561,720,2.7
1,3,Baldwin,2019,97424,94713,2711,2.8
1,5,Barbour,2019,8502,8177,325,3.8
1,7,Bibb,2019,8639,8371,268,3.1
1,9,Blount,2019,25196,24516,680,2.7
1,11,Bullock,2019,4785,4608,177,3.7
1,13,Butler,2019,9172,8832,340,3.7
1,15,Calhoun,2019,46082,44440,1642,3.6
1,17,Chambers,2019,15749,15287,462,2.9
1,19,Cherokee,2019,11726,11386,340,2.9
1,21,Chilton,2019,19841,19296,545,2.7
1,23,Choctaw,2019,4645,4427,218,4.7
1,25,Clarke,2019,7588,7151,437,5.8
1,27,Clay,2019,6068,5886,182,3.0
1,29,Cleburne,2019,5773,5590,183,3.2
1,31,Coffee,2019,21741,21108,633,2.9
1,33,Colbert,2019,23703,22811,892,3.8
1,35,Conecuh,2019,4499,4320,179,4.0
1,37,Coosa,2019,4505,4370,135,3.0
1,39,Covington,2019,15545,15007,538,3.5
1,41,Crenshaw,2019,6436,6253,183,2.8
1,43,Cullman,2019,38541,37533,1008,2.6
1,45,Dale,2019,20600,19951,649,3.2
1,47,Dallas,2019,14655,13850,805,5.5
1,49,DeKalb,2019,31148,30270,878,2.8
1,51,Elmore,2019,37236,36257,979,2.6
1,53,Escambia,2019,14613,14095,518,3.5
1,55,Etowah,2019,42462,41026,1436,3.4
1,57,Fayette,2019,6582,6376,206,3.1
1,59,Franklin,2019,14592,14185,407,2.8
1,61,Geneva,2019,10930,10606,324,3.0
1,63,Greene,2019,2889,2727,162,5.6
1,65,Hale,2019,6076,5834,242,4.0
1,67,Henry,2019,6882,6632,250,3.6
1,69,Houston,2019,46298,44892,1406,3.0
1,71,Jackson,2019,23326,22550,776,3.3
1,73,Jefferson,2019,316802,307648,9154,2.9
1,75,Lamar,2019,5802,5621,181,3.1
1,77,Lauderdale,2019,42448,41047,1401,3.3
1,79,Lawrence,2019,14230,13779,451,3.2
1,81,Lee,2019,76375,74272,2103,2.8
1,83,Limestone,2019,44272,43081,1191,2.7
1,85,Lowndes,2019,3499,3296,203,5.8
1,87,Macon,2019,7856,7522,334,4.3
1,89,Madison,2019,184941,180126,4815,2.6
1,91,Marengo,2019,7681,7409,272,3.5
1,93,Marion,2019,12748,12299,449,3.5
1,95,Marshall,2019,44060,42962,1098,2.5
1,97,Mobile,2019,188741,181682,7059,3.7
1,99,Monroe,2019,7320,6966,354,4.8
1,101,Montgomery,2019,106077,102780,3297,3.1
1,103,Morgan,2019,58288,56777,1511,2.6
1,105,Perry,2019,3381,3203,178,5.3
1,107,Pickens,2019,7904,7625,279,3.5
1,109,Pike,2019,15331,14825,506,3.3
1,111,Randolph,2019,9497,9204,293,3.1
1,113,Russell,2019,23708,23001,707,3.0
1,115,St. Clair,2019,40698,39591,1107,2.7
1,117,Shelby,2019,116412,113842,2570,2.2
1,119,Sumter,2019,4755,4537,218,4.6
1,121,Talladega,2019,35654,34428,1226,3.4
1,123,Tallapoosa,2019,18452,17894,558,3.0
1,125,Tuscaloosa,2019,104950,102096,2854,2.7
1,127,Walker,2019,25148,24311,837,3.3
1,129,Washington,2019,6699,6384,315,4.7
1,131,Wilcox,2019,2706,2512,194,7.2
1,133,Winston,2019,10122,9785,337,3.3
2,13,Aleutians East Borough,2019,2560,2502,58,2.3
2,16,Aleutians West Census Area,2019,3657,3544,113,3.1
2,20,Anchorage Borough/municipality,2019,149118,142485,6633,4.4
2,50,Bethel Census Area,2019,7098,6283,815,11.5
2,60,Bristol Bay Borough,2019,451,427,24,5.3
2,68,Denali Borough,2019,1102,1021,81,7.4
2,70,Dillingham Census Area,2019,1987,1847,140,7.0
2,90,Fairbanks North Star Borough,2019,45510,43373,2137,4.7
2,100,Haines Borough,2019,1133,1043,90,7.9
2,105,Hoonah-Angoon Census Area,2019,1193,1074,119,10.0
2,110,Juneau Borough/city,2019,17302,16625,677,3.9
2,122,Kenai Peninsula Borough,2019,26551,24947,1604,6.0
2,130,Ketchikan Gateway Borough,2019,7022,6637,385,5.5
2,150,Kodiak Island Borough,2019,5988,5695,293,4.9
2,158,Kusilvak Census Area,2019,2652,2186,466,17.6
2,164,Lake and Peninsula Borough,2019,710,647,63,8.9
2,170,Matanuska-Susitna Borough,2019,48361,45432,2929,6.1
2,180,Nome Census Area,2019,4032,3637,395,9.8
2,185,North Slope Borough,2019,3561,3360,201,5.6
2,188,Northwest Arctic Borough,2019,2908,2542,366,12.6
2,195,Petersburg Borough,2019,1414,1304,110,7.8
2,198,Prince of Wales-Hyder Census Area,2019,2889,2631,258,8.9
2,220,Sitka Borough/city,2019,4419,4258,161,3.6
2,230,Skagway Municipality,2019,784,715,69,8.8
2,240,Southeast Fairbanks Census Area,2019,2879,2652,227,7.9
2,261,Valdez-Cordova Census Area,2019,4877,4551,326,6.7
2,275,Wrangell Borough/city,2019,1034,965,69,6.7
2,282,Yakutat Borough/city,2019,252,235,17,6.7
2,290,Yukon-Koyukuk Census Area,2019,2445,2137,308,12.6
4,1,Apache,2019,20432,18373,2059,10.1
4,3,Cochise,2019,50300,47381,2919,5.8
4,5,Coconino,2019,77107,72664,4443,5.8
4,7,Gila,2019,21410,20191,1219,5.7
4,9,Graham,2019,15427,14665,762,4.9
4,11,Greenlee,2019,4482,4302,180,4.0
4,12,La Paz,2019,9283,8727,556,6.0
4,13,Maricopa,2019,2298810,2202716,96094,4.2
4,15,Mohave,2019,87211,82093,5118,5.9
4,17,Navajo,2019,40720,37641,3079,7.6
4,19,Pima,2019,497406,474779,22627,4.5
4,21,Pinal,2019,189834,180277,9557,5.0
4,23,Santa Cruz,2019,19600,17891,1709,8.7
4,25,Yavapai,2019,106514,101642,4872,4.6
4,27,Yuma,2019,100189,83320,16869,16.8
5,1,Arkansas,2019,9477,9195,282,3.0
5,3,Ashley,2019,7707,7293,414,5.4
5,5,Baxter,2019,16324,15674,650,4.0
5,7,Benton,2019,139120,135482,3638,2.6
5,9,Boone,2019,16064,15555,509,3.2
5,11,Bradley,2019,4480,4297,183,4.1
5,13,Calhoun,2019,2435,2329,106,4.4
5,15,Carroll,2019,12825,12427,398,3.1
5,17,Chicot,2019,3255,3031,224,6.9
5,19,Clark,2019,9700,9332,368,3.8
5,21,Clay,2019,5672,5397,275,4.8
5,23,Cleburne,2019,9229,8815,414,4.5
5,25,Cleveland,2019,3244,3117,127,3.9
5,27,Columbia,2019,9204,8797,407,4.4
5,29,Conway,2019,8298,7942,356,4.3
5,31,Craighead,2019,56193,54631,1562,2.8
5,33,Crawford,2019,26900,26011,889,3.3
5,35,Crittenden,2019,21242,20341,901,4.2
5,37,Cross,2019,7405,7095,310,4.2
5,39,Dallas,2019,2827,2697,130,4.6
5,41,Desha,2019,5410,5170,240,4.4
5,43,Drew,2019,7833,7429,404,5.2
5,45,Faulkner,2019,62942,61069,1873,3.0
5,47,Franklin,2019,7524,7274,250,3.3
5,49,Fulton,2019,4981,4783,198,4.0
5,51,Garland,2019,41474,39943,1531,3.7
5,53,Grant,2019,8428,8162,266,3.2
5,55,Greene,2019,20059,19366,693,3.5
5,57,Hempstead,2019,9921,9545,376,3.8
5,59,Hot Spring,2019,14058,13552,506,3.6
5,61,Howard,2019,5689,5505,184,3.2
5,63,Independence,2019,16580,15924,656,4.0
5,65,Izard,2019,4908,4641,267,5.4
5,67,Jackson,2019,5814,5437,377,6.5
5,69,Jefferson,2019,27664,26162,1502,5.4
5,71,Johnson,2019,10276,9810,466,4.5
5,73,Lafayette,2019,2458,2345,113,4.6
5,75,Lawrence,2019,6841,6560,281,4.1
5,77,Lee,2019,2823,2697,126,4.5
5,79,Lincoln,2019,3902,3734,168,4.3
5,81,Little River,2019,5529,5292,237,4.3
5,83,Logan,2019,8528,8160,368,4.3
5,85,Lonoke,2019,34268,33167,1101,3.2
5,87,Madison,2019,7407,7218,189,2.6
5,89,Marion,2019,6666,6401,265,4.0
5,91,Miller,2019,19743,18940,803,4.1
5,93,Mississippi,2019,17381,16501,880,5.1
5,95,Monroe,2019,2754,2637,117,4.2
5,97,Montgomery,2019,2980,2842,138,4.6
5,99,Nevada,2019,3653,3510,143,3.9
5,101,Newton,2019,3322,3206,116,3.5
5,103,Ouachita,2019,9845,9342,503,5.1
5,105,Perry,2019,4311,4137,174,4.0
5,107,Phillips,2019,6362,5986,376,5.9
5,109,Pike,2019,4247,4085,162,3.8
5,111,Poinsett,2019,10033,9688,345,3.4
5,113,Polk,2019,8077,7740,337,4.2
5,115,Pope,2019,29061,27820,1241,4.3
5,117,Prairie,2019,3610,3456,154,4.3
5,119,Pulaski,2019,189623,183196,6427,3.4
5,121,Randolph,2019,7310,7029,281,3.8
5,123,St. Francis,2019,8191,7773,418,5.1
5,125,Saline,2019,59520,57862,1658,2.8
5,127,Scott,2019,4330,4184,146,3.4
5,129,Searcy,2019,2907,2776,131,4.5
5,131,Sebastian,2019,56811,54957,1854,3.3
5,133,Sevier,2019,5526,5262,264,4.8
5,135,Sharp,2019,5762,5478,284,4.9
5,137,Stone,2019,4738,4515,223,4.7
5,139,Union,2019,15794,14974,820,5.2
5,141,Van Buren,2019,5780,5494,286,4.9
5,143,Washington,2019,124929,121868,3061,2.5
5,145,White,2019,33929,32420,1509,4.4
5,147,Woodruff,2019,2770,2626,144,5.2
5,149,Yell,2019,8389,8055,334,4.0
6,1,Alameda,2019,841075,815889,25186,3.0
6,3,Alpine,2019,541,512,29,5.4
6,5,Amador,2019,14801,14217,584,3.9
6,7,Butte,2019,97922,92858,5064,5.2
6,9,Calaveras,2019,21310,20485,825,3.9
6,11,Colusa,2019,10975,9549,1426,13.0
6,13,Contra Costa,2019,559710,542121,17589,3.1
6,15,Del Norte,2019,9617,9053,564,5.9
6,17,El Dorado,2019,92132,88833,3299,3.6
6,19,Fresno,2019,450505,417312,33193,7.4
6,21,Glenn,2019,12985,12174,811,6.2
6,23,Humboldt,2019,62103,59824,2279,3.7
6,25,Imperial,2019,73633,58253,15380,20.9
6,27,Inyo,2019,8752,8437,315,3.6
6,29,Kern,2019,388132,357458,30674,7.9
6,31,Kings,2019,57823,53185,4638,8.0
6,33,Lake,2019,29005,27506,1499,5.2
6,35,Lassen,2019,9714,9258,456,4.7
6,37,Los Angeles,2019,5153091,4926056,227035,4.4
6,39,Madera,2019,62095,57744,4351,7.0
6,41,Marin,2019,138563,135299,3264,2.4
6,43,Mariposa,2019,7621,7267,354,4.6
6,45,Mendocino,2019,38654,37093,1561,4.0
6,47,Merced,2019,115761,106231,9530,8.2
6,49,Modoc,2019,3174,2945,229,7.2
6,51,Mono,2019,8503,8183,320,3.8
6,53,Monterey,2019,221150,207085,14065,6.4
6,55,Napa,2019,73212,71082,2130,2.9
6,57,Nevada,2019,48392,46747,1645,3.4
6,59,Orange,2019,1613108,1567233,45875,2.8
6,61,Placer,2019,188564,182605,5959,3.2
6,63,Plumas,2019,7877,7262,615,7.8
6,65,Riverside,2019,1105704,1058717,46987,4.2
6,67,Sacramento,2019,710167,683551,26616,3.7
6,69,San Benito,2019,32258,30632,1626,5.0
6,71,San Bernardino,2019,965015,927370,37645,3.9
6,73,San Diego,2019,1580059,1528282,51777,3.3
6,75,San Francisco/city,2019,579559,566589,12970,2.2
6,77,San Joaquin,2019,326515,306904,19611,6.0
6,79,San Luis Obispo,2019,139591,135508,4083,2.9
6,81,San Mateo,2019,456317,446771,9546,2.1
6,83,Santa Barbara,2019,222283,214113,8170,3.7
6,85,Santa Clara,2019,1048221,1021586,26635,2.5
6,87,Santa Cruz,2019,141102,134100,7002,5.0
6,89,Shasta,2019,72827,69296,3531,4.8
6,91,Sierra,2019,1327,1255,72,5.4
6,93,Siskiyou,2019,17158,16027,1131,6.6
6,95,Solano,2019,208061,200065,7996,3.8
6,97,Sonoma,2019,257093,250036,7057,2.7
6,99,Stanislaus,2019,242458,227529,14929,6.2
6,101,Sutter,2019,45464,42066,3398,7.5
6,103,Tehama,2019,25551,24094,1457,5.7
6,105,Trinity,2019,4643,4385,258,5.6
6,107,Tulare,2019,202150,182228,19922,9.9
6,109,Tuolumne,2019,20931,19967,964,4.6
6,111,Ventura,2019,421365,405882,15483,3.7
6,113,Yolo,2019,107931,103397,4534,4.2
6,115,Yuba,2019,29740,27893,1847,6.2
8,1,Adams,2019,273351,265608,7743,2.8
8,3,Alamosa,2019,8489,8201,288,3.4
8,5,Arapahoe,2019,364820,355291,9529,2.6
8,7,Archuleta,2019,6901,6692,209,3.0
8,9,Baca,2019,2156,2121,35,1.6
8,11,Bent,2019,1866,1816,50,2.7
8,13,Boulder,2019,195471,191065,4406,2.3
8,14,Broomfield/city,2019,40475,39517,958,2.4
8,15,Chaffee,2019,9775,9550,225,2.3
8,17,Cheyenne,2019,1138,1120,18,1.6
8,19,Clear Creek,2019,6059,5915,144,2.4
8,21,Conejos,2019,4161,4016,145,3.5
8,23,Costilla,2019,1868,1797,71,3.8
8,25,Crowley,2019,1554,1491,63,4.1
8,27,Custer,2019,2062,2002,60,2.9
8,29,Delta,2019,14334,13871,463,3.2
8,31,Denver/city,2019,419794,408921,10873,2.6
8,33,Dolores,2019,1146,1113,33,2.9
8,35,Douglas,2019,197399,192880,4519,2.3
8,37,Eagle,2019,36622,35826,796,2.2
8,39,Elbert,2019,15323,15002,321,2.1
8,41,El Paso,2019,340870,330086,10784,3.2
8,43,Fremont,2019,15051,14385,666,4.4
8,45,Garfield,2019,32612,31762,850,2.6
8,47,Gilpin,2019,3826,3741,85,2.2
8,49,Grand,2019,9856,9653,203,2.1
8,51,Gunnison,2019,11449,11212,237,2.1
8,53,Hinsdale,2019,439,424,15,3.4
8,55,Huerfano,2019,2528,2388,140,5.5
8,57,Jackson,2019,980,958,22,2.2
8,59,Jefferson,2019,334092,325907,8185,2.4
8,61,Kiowa,2019,955,941,14,1.5
8,63,Kit Carson,2019,4317,4248,69,1.6
8,65,Lake,2019,4956,4843,113,2.3
8,67,La Plata,2019,31885,31115,770,2.4
8,69,Larimer,2019,204731,200050,4681,2.3
8,71,Las Animas,2019,6535,6288,247,3.8
8,73,Lincoln,2019,2418,2364,54,2.2
8,75,Logan,2019,11134,10875,259,2.3
8,77,Mesa,2019,76000,73490,2510,3.3
8,79,Mineral,2019,520,508,12,2.3
8,81,Moffat,2019,7397,7155,242,3.3
8,83,Montezuma,2019,12858,12333,525,4.1
8,85,Montrose,2019,21767,21116,651,3.0
8,87,Morgan,2019,16452,16035,417,2.5
8,89,Otero,2019,8305,7977,328,3.9
8,91,Ouray,2019,2437,2368,69,2.8
8,93,Park,2019,11259,10989,270,2.4
8,95,Phillips,2019,2599,2559,40,1.5
8,97,Pitkin,2019,11123,10786,337,3.0
8,99,Prowers,2019,6334,6175,159,2.5
8,101,Pueblo,2019,75800,72817,2983,3.9
8,103,Rio Blanco,2019,2988,2883,105,3.5
8,105,Rio Grande,2019,5447,5230,217,4.0
8,107,Routt,2019,16306,15965,341,2.1
8,109,Saguache,2019,3543,3405,138,3.9
8,111,San Juan,2019,556,540,16,2.9
8,113,San Miguel,2019,5757,5601,156,2.7
8,115,Sedgwick,2019,1196,1173,23,1.9
8,117,Summit,2019,22952,22554,398,1.7
8,119,Teller,2019,12788,12409,379,3.0
8,121,Washington,2019,2976,2920,56,1.9
8,123,Weld,2019,169253,165049,4204,2.5
8,125,Yuma,2019,6114,6020,94,1.5
9,1,Fairfield,2019,480817,463937,16880,3.5
9,3,Hartford,2019,484727,466636,18091,3.7
9,5,Litchfield,2019,105105,101595,3510,3.3
9,7,Middlesex,2019,94108,91217,2891,3.1
9,9,New Haven,2019,463581,446134,17447,3.8
9,11,New London,2019,137448,132673,4775,3.5
9,13,Tolland,2019,87324,84584,2740,3.1
9,15,Windham,2019,64192,61700,2492,3.9
10,1,Kent,2019,79120,75903,3217,4.1
10,3,New Castle,2019,300688,290044,10644,3.5
10,5,Sussex,2019,108232,104273,3959,3.7
11,1,District of Colu,2019,400577,379016,21561,5.4
12,1,Alachua,2019,138972,134690,4282,3.1
12,3,Baker,2019,12016,11624,392,3.3
12,5,Bay,2019,84487,81202,3285,3.9
12,7,Bradford,2019,10948,10577,371,3.4
12,9,Brevard,2019,283857,274329,9528,3.4
12,11,Broward,2019,1041334,1008095,33239,3.2
12,13,Calhoun,2019,4803,4604,199,4.1
12,15,Charlotte,2019,71946,69158,2788,3.9
12,17,Citrus,2019,47382,44971,2411,5.1
12,19,Clay,2019,107500,104069,3431,3.2
12,21,Collier,2019,180558,174635,5923,3.3
12,23,Columbia,2019,29825,28802,1023,3.4
12,27,DeSoto,2019,14222,13694,528,3.7
12,29,Dixie,2019,5855,5623,232,4.0
12,31,Duval,2019,487538,470643,16895,3.5
12,33,Escambia,2019,144858,139939,4919,3.4
12,35,Flagler,2019,47747,45827,1920,4.0
12,37,Franklin,2019,4665,4489,176,3.8
12,39,Gadsden,2019,18569,17764,805,4.3
12,41,Gilchrist,2019,7303,7043,260,3.6
12,43,Glades,2019,5350,5128,222,4.1
12,45,Gulf,2019,5201,4943,258,5.0
12,47,Hamilton,2019,4307,4120,187,4.3
12,49,Hardee,2019,8378,7932,446,5.3
12,51,Hendry,2019,15376,14412,964,6.3
12,53,Hernando,2019,71932,68756,3176,4.4
12,55,Highlands,2019,35813,34082,1731,4.8
12,57,Hillsborough,2019,757044,732354,24690,3.3
12,59,Holmes,2019,6947,6689,258,3.7
12,61,Indian River,2019,65635,62985,2650,4.0
12,63,Jackson,2019,17106,16477,629,3.7
12,65,Jefferson,2019,5541,5347,194,3.5
12,67,Lafayette,2019,2847,2760,87,3.1
12,69,Lake,2019,161784,156335,5449,3.4
12,71,Lee,2019,349001,337412,11589,3.3
12,73,Leon,2019,154954,149917,5037,3.3
12,75,Levy,2019,16722,16066,656,3.9
12,77,Liberty,2019,2653,2556,97,3.7
12,79,Madison,2019,7464,7168,296,4.0
12,81,Manatee,2019,180737,174772,5965,3.3
12,83,Marion,2019,139264,133676,5588,4.0
12,85,Martin,2019,73362,70924,2438,3.3
12,86,Miami-Dade,2019,1377449,1340491,36958,2.7
12,87,Monroe,2019,46557,45559,998,2.1
12,89,Nassau,2019,41854,40563,1291,3.1
12,91,Okaloosa,2019,96675,93926,2749,2.8
12,93,Okeechobee,2019,17753,17105,648,3.7
12,95,Orange,2019,759379,735997,23382,3.1
12,97,Osceola,2019,185694,179268,6426,3.5
12,99,Palm Beach,2019,735111,709883,25228,3.4
12,101,Pasco,2019,240250,231402,8848,3.7
12,103,Pinellas,2019,486091,470700,15391,3.2
12,105,Polk,2019,306541,294499,12042,3.9
12,107,Putnam,2019,26581,25376,1205,4.5
12,109,St. Johns,2019,135761,131995,3766,2.8
12,111,St. Lucie,2019,146578,140515,6063,4.1
12,113,Santa Rosa,2019,83819,81208,2611,3.1
12,115,Sarasota,2019,189004,182804,6200,3.3
12,117,Seminole,2019,254124,246300,7824,3.1
12,119,Sumter,2019,32638,31030,1608,4.9
12,121,Suwannee,2019,18288,17639,649,3.5
12,123,Taylor,2019,8231,7920,311,3.8
12,125,Union,2019,4609,4464,145,3.1
12,127,Volusia,2019,254049,244818,9231,3.6
12,129,Wakulla,2019,15402,14933,469,3.0
12,131,Walton,2019,32117,31156,961,3.0
12,133,Washington,2019,9709,9355,354,3.6
13,1,Appling,2019,9275,8904,371,4.0
13,3,Atkinson,2019,4562,4415,147,3.2
13,5,Bacon,2019,4957,4774,183,3.7
13,7,Baker,2019,1159,1104,55,4.7
13,9,Baldwin,2019,17711,16941,770,4.3
13,11,Banks,2019,9799,9525,274,2.8
13,13,Barrow,2019,41298,40096,1202,2.9
13,15,Bartow,2019,50824,49094,1730,3.4
13,17,Ben Hill,2019,5458,5154,304,5.6
13,19,Berrien,2019,7593,7281,312,4.1
13,21,Bibb,2019,67991,65238,2753,4.0
13,23,Bleckley,2019,4595,4355,240,5.2
13,25,Brantley,2019,7250,6943,307,4.2
13,27,Brooks,2019,6879,6639,240,3.5
13,29,Bryan,2019,19193,18615,578,3.0
13,31,Bulloch,2019,37544,36063,1481,3.9
13,33,Burke,2019,9132,8650,482,5.3
13,35,Butts,2019,10989,10610,379,3.4
13,37,Calhoun,2019,2264,2181,83,3.7
13,39,Camden,2019,21271,20484,787,3.7
13,43,Candler,2019,5619,5449,170,3.0
13,45,Carroll,2019,55720,53731,1989,3.6
13,47,Catoosa,2019,33507,32471,1036,3.1
13,49,Charlton,2019,4918,4728,190,3.9
13,51,Chatham,2019,141198,136432,4766,3.4
13,53,Chattahoochee,2019,2030,1936,94,4.6
13,55,Chattooga,2019,10389,9857,532,5.1
13,57,Cherokee,2019,137310,133427,3883,2.8
13,59,Clarke,2019,59737,57543,2194,3.7
13,61,Clay,2019,882,820,62,7.0
13,63,Clayton,2019,138140,132093,6047,4.4
13,65,Clinch,2019,2821,2715,106,3.8
13,67,Cobb,2019,424056,410994,13062,3.1
13,69,Coffee,2019,19232,18472,760,4.0
13,71,Colquitt,2019,21774,21076,698,3.2
13,73,Columbia,2019,76158,73783,2375,3.1
13,75,Cook,2019,8165,7885,280,3.4
13,77,Coweta,2019,75413,73121,2292,3.0
13,79,Crawford,2019,5647,5438,209,3.7
13,81,Crisp,2019,9597,9218,379,3.9
13,83,Dade,2019,8130,7856,274,3.4
13,85,Dawson,2019,12731,12360,371,2.9
13,87,Decatur,2019,11673,11224,449,3.8
13,89,DeKalb,2019,398089,383925,14164,3.6
13,91,Dodge,2019,7163,6772,391,5.5
13,93,Dooly,2019,5078,4883,195,3.8
13,95,Dougherty,2019,37709,35924,1785,4.7
13,97,Douglas,2019,73229,70551,2678,3.7
13,99,Early,2019,4385,4210,175,4.0
13,101,Echols,2019,1912,1858,54,2.8
13,103,Effingham,2019,32248,31311,937,2.9
13,105,Elbert,2019,7855,7540,315,4.0
13,107,Emanuel,2019,8420,7964,456,5.4
13,109,Evans,2019,4946,4776,170,3.4
13,111,Fannin,2019,11493,11099,394,3.4
13,113,Fayette,2019,58063,56269,1794,3.1
13,115,Floyd,2019,44155,42403,1752,4.0
13,117,Forsyth,2019,125115,121572,3543,2.8
13,119,Franklin,2019,10205,9839,366,3.6
13,121,Fulton,2019,560412,540233,20179,3.6
13,123,Gilmer,2019,12032,11599,433,3.6
13,125,Glascock,2019,1276,1228,48,3.8
13,127,Glynn,2019,38828,37478,1350,3.5
13,129,Gordon,2019,28488,27498,990,3.5
13,131,Grady,2019,10668,10301,367,3.4
13,133,Greene,2019,7307,7020,287,3.9
13,135,Gwinnett,2019,490677,475310,15367,3.1
13,137,Habersham,2019,19457,18779,678,3.5
13,139,Hall,2019,102798,99832,2966,2.9
13,141,Hancock,2019,2514,2371,143,5.7
13,143,Haralson,2019,12580,12147,433,3.4
13,145,Harris,2019,16936,16405,531,3.1
13,147,Hart,2019,11609,11195,414,3.6
13,149,Heard,2019,5228,5050,178,3.4
13,151,Henry,2019,116855,112575,4280,3.7
13,153,Houston,2019,71213,68770,2443,3.4
13,155,Irwin,2019,3403,3243,160,4.7
13,157,Jackson,2019,37771,36734,1037,2.7
13,159,Jasper,2019,6981,6757,224,3.2
13,161,Jeff Davis,2019,6188,5900,288,4.7
13,163,Jefferson,2019,6636,6314,322,4.9
13,165,Jenkins,2019,3209,3043,166,5.2
13,167,Johnson,2019,4076,3924,152,3.7
13,169,Jones,2019,13757,13308,449,3.3
13,171,Lamar,2019,8208,7881,327,4.0
13,173,Lanier,2019,3781,3627,154,4.1
13,175,Laurens,2019,19567,18658,909,4.6
13,177,Lee,2019,15140,14673,467,3.1
13,179,Liberty,2019,25970,24965,1005,3.9
13,181,Lincoln,2019,3552,3412,140,3.9
13,183,Long,2019,8345,8032,313,3.8
13,185,Lowndes,2019,51690,49820,1870,3.6
13,187,Lumpkin,2019,16946,16394,552,3.3
13,189,McDuffie,2019,8756,8293,463,5.3
13,191,McIntosh,2019,6102,5876,226,3.7
13,193,Macon,2019,4724,4503,221,4.7
13,195,Madison,2019,13419,12996,423,3.2
13,197,Marion,2019,3294,3151,143,4.3
13,199,Meriwether,2019,8895,8481,414,4.7
13,201,Miller,2019,2804,2711,93,3.3
13,205,Mitchell,2019,8490,8097,393,4.6
13,207,Monroe,2019,13028,12592,436,3.3
13,209,Montgomery,2019,3926,3721,205,5.2
13,211,Morgan,2019,9383,9082,301,3.2
13,213,Murray,2019,15625,14812,813,5.2
13,215,Muscogee,2019,77829,74179,3650,4.7
13,217,Newton,2019,52883,50779,2104,4.0
13,219,Oconee,2019,20054,19531,523,2.6
13,221,Oglethorpe,2019,7040,6808,232,3.3
13,223,Paulding,2019,87696,85048,2648,3.0
13,225,Peach,2019,11901,11402,499,4.2
13,227,Pickens,2019,15457,14977,480,3.1
13,229,Pierce,2019,8694,8390,304,3.5
13,231,Pike,2019,8992,8712,280,3.1
13,233,Polk,2019,18576,17884,692,3.7
13,235,Pulaski,2019,4066,3905,161,4.0
13,237,Putnam,2019,8326,7956,370,4.4
13,239,Quitman,2019,812,770,42,5.2
13,241,Rabun,2019,7321,7057,264,3.6
13,243,Randolph,2019,2556,2431,125,4.9
13,245,Richmond,2019,85378,81390,3988,4.7
13,247,Rockdale,2019,44606,42852,1754,3.9
13,249,Schley,2019,2258,2170,88,3.9
13,251,Screven,2019,5159,4874,285,5.5
13,253,Seminole,2019,3106,2971,135,4.3
13,255,Spalding,2019,28741,27555,1186,4.1
13,257,Stephens,2019,10838,10419,419,3.9
13,259,Stewart,2019,2497,2388,109,4.4
13,261,Sumter,2019,12877,12252,625,4.9
13,263,Talbot,2019,2827,2699,128,4.5
13,265,Taliaferro,2019,546,518,28,5.1
13,267,Tattnall,2019,9762,9384,378,3.9
13,269,Taylor,2019,3036,2908,128,4.2
13,271,Telfair,2019,4298,3893,405,9.4
13,273,Terrell,2019,3550,3368,182,5.1
13,275,Thomas,2019,17017,16334,683,4.0
13,277,Tift,2019,20323,19638,685,3.4
13,279,Toombs,2019,12015,11419,596,5.0
13,281,Towns,2019,3975,3780,195,4.9
13,283,Treutlen,2019,2729,2585,144,5.3
13,285,Troup,2019,38023,36795,1228,3.2
13,287,Turner,2019,3222,3098,124,3.8
13,289,Twiggs,2019,2860,2698,162,5.7
13,291,Union,2019,10505,10171,334,3.2
13,293,Upson,2019,11420,11005,415,3.6
13,295,Walker,2019,31433,30280,1153,3.7
13,297,Walton,2019,46218,44752,1466,3.2
13,299,Ware,2019,15507,14922,585,3.8
13,301,Warren,2019,2763,2629,134,4.8
13,303,Washington,2019,7063,6763,300,4.2
13,305,Wayne,2019,11523,11050,473,4.1
13,307,Webster,2019,1028,977,51,5.0
13,309,Wheeler,2019,1676,1552,124,7.4
13,311,White,2019,16570,16113,457,2.8
13,313,Whitfield,2019,43931,41929,2002,4.6
13,315,Wilcox,2019,2714,2593,121,4.5
13,317,Wilkes,2019,3812,3633,179,4.7
13,319,Wilkinson,2019,4053,3898,155,3.8
13,321,Worth,2019,9053,8697,356,3.9
15,1,Hawaii,2019,91486,88618,2868,3.1
15,3,Honolulu/city,2019,453387,442802,10585,2.3
15,7,Kauai,2019,36831,35936,895,2.4
15,9,Maui,2019,87486,85410,2076,2.4
16,1,Ada,2019,253677,247613,6064,2.4
16,3,Adams,2019,1711,1600,111,6.5
16,5,Bannock,2019,42485,41346,1139,2.7
16,7,Bear Lake,2019,2966,2884,82,2.8
16,9,Benewah,2019,4070,3867,203,5.0
16,11,Bingham,2019,23720,23121,599,2.5
16,13,Blaine,2019,12315,12008,307,2.5
16,15,Boise,2019,3507,3364,143,4.1
16,17,Bonner,2019,20008,19216,792,4.0
16,19,Bonneville,2019,56965,55670,1295,2.3
16,21,Boundary,2019,5343,5116,227,4.2
16,23,Butte,2019,1371,1337,34,2.5
16,25,Camas,2019,680,662,18,2.6
16,27,Canyon,2019,104471,101285,3186,3.0
16,29,Caribou,2019,4100,3996,104,2.5
16,31,Cassia,2019,12122,11843,279,2.3
16,33,Clark,2019,374,361,13,3.5
16,35,Clearwater,2019,2885,2699,186,6.4
16,37,Custer,2019,2214,2126,88,4.0
16,39,Elmore,2019,11532,11174,358,3.1
16,41,Franklin,2019,7060,6904,156,2.2
16,43,Fremont,2019,7736,7565,171,2.2
16,45,Gem,2019,8303,8042,261,3.1
16,47,Gooding,2019,8197,7994,203,2.5
16,49,Idaho,2019,6556,6275,281,4.3
16,51,Jefferson,2019,13959,13651,308,2.2
16,53,Jerome,2019,12216,11915,301,2.5
16,55,Kootenai,2019,79882,77179,2703,3.4
16,57,Latah,2019,20418,19902,516,2.5
16,59,Lemhi,2019,3542,3383,159,4.5
16,61,Lewis,2019,1627,1542,85,5.2
16,63,Lincoln,2019,2666,2576,90,3.4
16,65,Madison,2019,21960,21579,381,1.7
16,67,Minidoka,2019,11377,11105,272,2.4
16,69,Nez Perce,2019,20923,20365,558,2.7
16,71,Oneida,2019,2314,2264,50,2.2
16,73,Owyhee,2019,5408,5233,175,3.2
16,75,Payette,2019,11673,11278,395,3.4
16,77,Power,2019,4070,3951,119,2.9
16,79,Shoshone,2019,5133,4847,286,5.6
16,81,Teton,2019,6604,6464,140,2.1
16,83,Twin Falls,2019,41180,40087,1093,2.7
16,85,Valley,2019,5537,5331,206,3.7
16,87,Washington,2019,4592,4412,180,3.9
17,1,Adams,2019,32309,31255,1054,3.3
17,3,Alexander,2019,1948,1829,119,6.1
17,5,Bond,2019,7786,7501,285,3.7
17,7,Boone,2019,26413,24995,1418,5.4
17,9,Brown,2019,3011,2940,71,2.4
17,11,Bureau,2019,17235,16466,769,4.5
17,13,Calhoun,2019,2317,2214,103,4.4
17,15,Carroll,2019,7394,7105,289,3.9
17,17,Cass,2019,6089,5848,241,4.0
17,19,Champaign,2019,109862,105954,3908,3.6
17,21,Christian,2019,14528,13857,671,4.6
17,23,Clark,2019,7661,7319,342,4.5
17,25,Clay,2019,6481,6200,281,4.3
17,27,Clinton,2019,20645,20032,613,3.0
17,29,Coles,2019,23896,22978,918,3.8
17,31,Cook,2019,2597185,2493959,103226,4.0
17,33,Crawford,2019,8692,8332,360,4.1
17,35,Cumberland,2019,6124,5923,201,3.3
17,37,DeKalb,2019,55723,53536,2187,3.9
17,39,De Witt,2019,7465,7155,310,4.2
17,41,Douglas,2019,10278,9928,350,3.4
17,43,DuPage,2019,507948,492348,15600,3.1
17,45,Edgar,2019,8961,8592,369,4.1
17,47,Edwards,2019,2720,2608,112,4.1
17,49,Effingham,2019,19347,18748,599,3.1
17,51,Fayette,2019,9935,9519,416,4.2
17,53,Ford,2019,6391,6128,263,4.1
17,55,Franklin,2019,16427,15578,849,5.2
17,57,Fulton,2019,15215,14404,811,5.3
17,59,Gallatin,2019,2341,2228,113,4.8
17,61,Greene,2019,6063,5815,248,4.1
17,63,Grundy,2019,25664,24463,1201,4.7
17,65,Hamilton,2019,4431,4267,164,3.7
17,67,Hancock,2019,8424,8045,379,4.5
17,69,Hardin,2019,1307,1225,82,6.3
17,71,Henderson,2019,3636,3471,165,4.5
17,73,Henry,2019,25092,23946,1146,4.6
17,75,Iroquois,2019,14374,13796,578,4.0
17,77,Jackson,2019,28014,26999,1015,3.6
17,79,Jasper,2019,4658,4469,189,4.1
17,81,Jefferson,2019,17436,16671,765,4.4
17,83,Jersey,2019,11072,10607,465,4.2
17,85,Jo Daviess,2019,10833,10412,421,3.9
17,87,Johnson,2019,4144,3904,240,5.8
17,89,Kane,2019,273038,261403,11635,4.3
17,91,Kankakee,2019,55970,53286,2684,4.8
17,93,Kendall,2019,69650,67239,2411,3.5
17,95,Knox,2019,21791,20758,1033,4.7
17,97,Lake,2019,377813,362905,14908,3.9
17,99,LaSalle,2019,54796,52006,2790,5.1
17,101,Lawrence,2019,5924,5611,313,5.3
17,103,Lee,2019,17653,16981,672,3.8
17,105,Livingston,2019,16613,15967,646,3.9
17,107,Logan,2019,12680,12153,527,4.2
17,109,McDonough,2019,13457,12859,598,4.4
17,111,McHenry,2019,166214,160446,5768,3.5
17,113,McLean,2019,88256,85083,3173,3.6
17,115,Macon,2019,48773,46324,2449,5.0
17,117,Macoupin,2019,23070,22128,942,4.1
17,119,Madison,2019,135105,130057,5048,3.7
17,121,Marion,2019,17716,16967,749,4.2
17,123,Marshall,2019,5349,5104,245,4.6
17,125,Mason,2019,6300,5979,321,5.1
17,127,Massac,2019,5613,5314,299,5.3
17,129,Menard,2019,6413,6177,236,3.7
17,131,Mercer,2019,8073,7685,388,4.8
17,133,Monroe,2019,19192,18629,563,2.9
17,135,Montgomery,2019,11777,11190,587,5.0
17,137,Morgan,2019,16525,15890,635,3.8
17,139,Moultrie,2019,7623,7380,243,3.2
17,141,Ogle,2019,25016,23857,1159,4.6
17,143,Peoria,2019,85222,81063,4159,4.9
17,145,Perry,2019,8347,7936,411,4.9
17,147,Piatt,2019,8675,8376,299,3.4
17,149,Pike,2019,7059,6766,293,4.2
17,151,Pope,2019,1686,1597,89,5.3
17,153,Pulaski,2019,1955,1830,125,6.4
17,155,Putnam,2019,3042,2894,148,4.9
17,157,Randolph,2019,14349,13849,500,3.5
17,159,Richland,2019,7261,6977,284,3.9
17,161,Rock Island,2019,71037,67654,3383,4.8
17,163,St. Clair,2019,127448,122061,5387,4.2
17,165,Saline,2019,9667,9178,489,5.1
17,167,Sangamon,2019,99964,96057,3907,3.9
17,169,Schuyler,2019,3268,3138,130,4.0
17,171,Scott,2019,2514,2399,115,4.6
17,173,Shelby,2019,10652,10255,397,3.7
17,175,Stark,2019,2528,2389,139,5.5
17,177,Stephenson,2019,21829,20922,907,4.2
17,179,Tazewell,2019,64283,61576,2707,4.2
17,181,Union,2019,7470,7066,404,5.4
17,183,Vermilion,2019,33192,31561,1631,4.9
17,185,Wabash,2019,5856,5622,234,4.0
17,187,Warren,2019,8520,8188,332,3.9
17,189,Washington,2019,10029,9783,246,2.5
17,191,Wayne,2019,7005,6686,319,4.6
17,193,White,2019,6630,6384,246,3.7
17,195,Whiteside,2019,28775,27607,1168,4.1
17,197,Will,2019,358876,344488,14388,4.0
17,199,Williamson,2019,32221,30902,1319,4.1
17,201,Winnebago,2019,139782,132234,7548,5.4
17,203,Woodford,2019,18978,18303,675,3.6
18,1,Adams,2019,17339,16881,458,2.6
18,3,Allen,2019,187110,181369,5741,3.1
18,5,Bartholomew,2019,45082,43982,1100,2.4
18,7,Benton,2019,4525,4383,142,3.1
18,9,Blackford,2019,4996,4806,190,3.8
18,11,Boone,2019,36639,35759,880,2.4
18,13,Brown,2019,7622,7397,225,3.0
18,15,Carroll,2019,10097,9798,299,3.0
18,17,Cass,2019,18029,17420,609,3.4
18,19,Clark,2019,62311,60307,2004,3.2
18,21,Clay,2019,11781,11361,420,3.6
18,23,Clinton,2019,17219,16770,449,2.6
18,25,Crawford,2019,4872,4677,195,4.0
18,27,Daviess,2019,16763,16338,425,2.5
18,29,Dearborn,2019,25877,24984,893,3.5
18,31,Decatur,2019,15467,15046,421,2.7
18,33,DeKalb,2019,22672,22048,624,2.8
18,35,Delaware,2019,53512,51495,2017,3.8
18,37,Dubois,2019,23179,22641,538,2.3
18,39,Elkhart,2019,112608,109226,3382,3.0
18,41,Fayette,2019,8767,8364,403,4.6
18,43,Floyd,2019,42145,40857,1288,3.1
18,45,Fountain,2019,8028,7754,274,3.4
18,47,Franklin,2019,11478,11096,382,3.3
18,49,Fulton,2019,9891,9587,304,3.1
18,51,Gibson,2019,19565,19085,480,2.5
18,53,Grant,2019,31826,30681,1145,3.6
18,55,Greene,2019,13653,13102,551,4.0
18,57,Hamilton,2019,187675,183066,4609,2.5
18,59,Hancock,2019,41110,39979,1131,2.8
18,61,Harrison,2019,20443,19804,639,3.1
18,63,Hendricks,2019,91495,89090,2405,2.6
18,65,Henry,2019,22178,21473,705,3.2
18,67,Howard,2019,36472,35032,1440,3.9
18,69,Huntington,2019,18290,17708,582,3.2
18,71,Jackson,2019,22946,22354,592,2.6
18,73,Jasper,2019,16226,15638,588,3.6
18,75,Jay,2019,9425,9150,275,2.9
18,77,Jefferson,2019,15107,14612,495,3.3
18,79,Jennings,2019,13611,13178,433,3.2
18,81,Johnson,2019,83779,81583,2196,2.6
18,83,Knox,2019,18515,17967,548,3.0
18,85,Kosciusko,2019,42532,41378,1154,2.7
18,87,LaGrange,2019,20032,19489,543,2.7
18,89,Lake,2019,228477,217436,11041,4.8
18,91,LaPorte,2019,47456,45474,1982,4.2
18,93,Lawrence,2019,21121,20379,742,3.5
18,95,Madison,2019,58969,56842,2127,3.6
18,97,Marion,2019,494275,478497,15778,3.2
18,99,Marshall,2019,23299,22597,702,3.0
18,101,Martin,2019,5382,5244,138,2.6
18,103,Miami,2019,15308,14722,586,3.8
18,105,Monroe,2019,70367,68081,2286,3.2
18,107,Montgomery,2019,18850,18292,558,3.0
18,109,Morgan,2019,36442,35351,1091,3.0
18,111,Newton,2019,6897,6616,281,4.1
18,113,Noble,2019,23724,23009,715,3.0
18,115,Ohio,2019,3218,3109,109,3.4
18,117,Orange,2019,8669,8380,289,3.3
18,119,Owen,2019,9302,8939,363,3.9
18,121,Parke,2019,7031,6770,261,3.7
18,123,Perry,2019,9249,8950,299,3.2
18,125,Pike,2019,6124,5927,197,3.2
18,127,Porter,2019,86288,83116,3172,3.7
18,129,Posey,2019,13472,13112,360,2.7
18,131,Pulaski,2019,6545,6351,194,3.0
18,133,Putnam,2019,16649,16090,559,3.4
18,135,Randolph,2019,11313,10904,409,3.6
18,137,Ripley,2019,14336,13886,450,3.1
18,139,Rush,2019,9023,8789,234,2.6
18,141,St. Joseph,2019,138052,133249,4803,3.5
18,143,Scott,2019,10586,10218,368,3.5
18,145,Shelby,2019,23171,22515,656,2.8
18,147,Spencer,2019,10854,10526,328,3.0
18,149,Starke,2019,9904,9486,418,4.2
18,151,Steuben,2019,20690,20152,538,2.6
18,153,Sullivan,2019,8180,7833,347,4.2
18,155,Switzerland,2019,5026,4863,163,3.2
18,157,Tippecanoe,2019,97959,95087,2872,2.9
18,159,Tipton,2019,9333,9088,245,2.6
18,161,Union,2019,3584,3470,114,3.2
18,163,Vanderburgh,2019,94116,91289,2827,3.0
18,165,Vermillion,2019,6840,6484,356,5.2
18,167,Vigo,2019,46828,44813,2015,4.3
18,169,Wabash,2019,15022,14569,453,3.0
18,171,Warren,2019,4198,4076,122,2.9
18,173,Warrick,2019,33051,32114,937,2.8
18,175,Washington,2019,13799,13355,444,3.2
18,177,Wayne,2019,30941,29871,1070,3.5
18,179,Wells,2019,14442,14059,383,2.7
18,181,White,2019,13572,13216,356,2.6
18,183,Whitley,2019,17676,17162,514,2.9
19,1,Adair,2019,4305,4204,101,2.3
19,3,Adams,2019,2199,2161,38,1.7
19,5,Allamakee,2019,7455,7191,264,3.5
19,7,Appanoose,2019,6022,5806,216,3.6
19,9,Audubon,2019,3148,3069,79,2.5
19,11,Benton,2019,13678,13271,407,3.0
19,13,Black Hawk,2019,70154,67887,2267,3.2
19,15,Boone,2019,15094,14733,361,2.4
19,17,Bremer,2019,14261,13931,330,2.3
19,19,Buchanan,2019,11513,11194,319,2.8
19,21,Buena Vista,2019,11834,11582,252,2.1
19,23,Butler,2019,7986,7728,258,3.2
19,25,Calhoun,2019,4297,4187,110,2.6
19,27,Carroll,2019,11057,10840,217,2.0
19,29,Cass,2019,6990,6791,199,2.8
19,31,Cedar,2019,10948,10674,274,2.5
19,33,Cerro Gordo,2019,23837,23180,657,2.8
19,35,Cherokee,2019,6218,6061,157,2.5
19,37,Chickasaw,2019,6554,6364,190,2.9
19,39,Clarke,2019,4939,4795,144,2.9
19,41,Clay,2019,8589,8350,239,2.8
19,43,Clayton,2019,10260,9884,376,3.7
19,45,Clinton,2019,23077,22208,869,3.8
19,47,Crawford,2019,8222,7928,294,3.6
19,49,Dallas,2019,51649,50636,1013,2.0
19,51,Davis,2019,4265,4143,122,2.9
19,53,Decatur,2019,4415,4316,99,2.2
19,55,Delaware,2019,10706,10453,253,2.4
19,57,Des Moines,2019,19566,18783,783,4.0
19,59,Dickinson,2019,10174,9878,296,2.9
19,61,Dubuque,2019,56756,55244,1512,2.7
19,63,Emmet,2019,5313,5176,137,2.6
19,65,Fayette,2019,10712,10327,385,3.6
19,67,Floyd,2019,8926,8606,320,3.6
19,69,Franklin,2019,5766,5629,137,2.4
19,71,Fremont,2019,3752,3649,103,2.7
19,73,Greene,2019,5474,5342,132,2.4
19,75,Grundy,2019,6625,6442,183,2.8
19,77,Guthrie,2019,5640,5468,172,3.0
19,79,Hamilton,2019,6981,6781,200,2.9
19,81,Hancock,2019,5964,5819,145,2.4
19,83,Hardin,2019,8200,7937,263,3.2
19,85,Harrison,2019,7367,7182,185,2.5
19,87,Henry,2019,9914,9649,265,2.7
19,89,Howard,2019,5222,5074,148,2.8
19,91,Humboldt,2019,5178,5039,139,2.7
19,93,Ida,2019,4171,4088,83,2.0
19,95,Iowa,2019,10645,10407,238,2.2
19,97,Jackson,2019,11127,10774,353,3.2
19,99,Jasper,2019,19990,19398,592,3.0
19,101,Jefferson,2019,10155,9904,251,2.5
19,103,Johnson,2019,87744,85960,1784,2.0
19,105,Jones,2019,10794,10448,346,3.2
19,107,Keokuk,2019,5302,5128,174,3.3
19,109,Kossuth,2019,8527,8337,190,2.2
19,111,Lee,2019,16277,15633,644,4.0
19,113,Linn,2019,124057,120417,3640,2.9
19,115,Louisa,2019,6111,5923,188,3.1
19,117,Lucas,2019,4697,4600,97,2.1
19,119,Lyon,2019,7135,7016,119,1.7
19,121,Madison,2019,8687,8366,321,3.7
19,123,Mahaska,2019,12011,11705,306,2.5
19,125,Marion,2019,18550,18150,400,2.2
19,127,Marshall,2019,18128,17304,824,4.5
19,129,Mills,2019,7455,7279,176,2.4
19,131,Mitchell,2019,6821,6702,119,1.7
19,133,Monona,2019,4491,4357,134,3.0
19,135,Monroe,2019,4065,3940,125,3.1
19,137,Montgomery,2019,5045,4910,135,2.7
19,139,Muscatine,2019,22073,21435,638,2.9
19,141,O'Brien,2019,8337,8155,182,2.2
19,143,Osceola,2019,3563,3494,69,1.9
19,145,Page,2019,6448,6282,166,2.6
19,147,Palo Alto,2019,4849,4741,108,2.2
19,149,Plymouth,2019,15001,14661,340,2.3
19,151,Pocahontas,2019,4546,4458,88,1.9
19,153,Polk,2019,272480,264667,7813,2.9
19,155,Pottawattamie,2019,48626,47417,1209,2.5
19,157,Poweshiek,2019,10470,10191,279,2.7
19,159,Ringgold,2019,2485,2413,72,2.9
19,161,Sac,2019,5357,5229,128,2.4
19,163,Scott,2019,90375,87344,3031,3.4
19,165,Shelby,2019,6738,6594,144,2.1
19,167,Sioux,2019,21311,20908,403,1.9
19,169,Story,2019,58873,57784,1089,1.8
19,171,Tama,2019,9606,9306,300,3.1
19,173,Taylor,2019,3219,3158,61,1.9
19,175,Union,2019,6357,6151,206,3.2
19,177,Van Buren,2019,3706,3605,101,2.7
19,179,Wapello,2019,17946,17282,664,3.7
19,181,Warren,2019,28717,27982,735,2.6
19,183,Washington,2019,12127,11824,303,2.5
19,185,Wayne,2019,2848,2773,75,2.6
19,187,Webster,2019,19640,19023,617,3.1
19,189,Winnebago,2019,5173,5028,145,2.8
19,191,Winneshiek,2019,12045,11697,348,2.9
19,193,Woodbury,2019,56491,54945,1546,2.7
19,195,Worth,2019,4238,4118,120,2.8
19,197,Wright,2019,7043,6860,183,2.6
20,1,Allen,2019,6469,6242,227,3.5
20,3,Anderson,2019,4195,4058,137,3.3
20,5,Atchison,2019,7019,6657,362,5.2
20,7,Barber,2019,2324,2266,58,2.5
20,9,Barton,2019,13671,13249,422,3.1
20,11,Bourbon,2019,6723,6439,284,4.2
20,13,Brown,2019,5370,5202,168,3.1
20,15,Butler,2019,32671,31620,1051,3.2
20,17,Chase,2019,1539,1497,42,2.7
20,19,Chautauqua,2019,1438,1384,54,3.8
20,21,Cherokee,2019,10162,9813,349,3.4
20,23,Cheyenne,2019,1310,1278,32,2.4
20,25,Clark,2019,1071,1046,25,2.3
20,27,Clay,2019,3791,3670,121,3.2
20,29,Cloud,2019,3797,3675,122,3.2
20,31,Coffey,2019,4011,3830,181,4.5
20,33,Comanche,2019,870,847,23,2.6
20,35,Cowley,2019,16367,15821,546,3.3
20,37,Crawford,2019,18863,18137,726,3.8
20,39,Decatur,2019,1240,1203,37,3.0
20,41,Dickinson,2019,8893,8580,313,3.5
20,43,Doniphan,2019,4152,4014,138,3.3
20,45,Douglas,2019,65616,63685,1931,2.9
20,47,Edwards,2019,1467,1430,37,2.5
20,49,Elk,2019,1156,1113,43,3.7
20,51,Ellis,2019,17075,16688,387,2.3
20,53,Ellsworth,2019,2749,2673,76,2.8
20,55,Finney,2019,20639,20159,480,2.3
20,57,Ford,2019,17153,16728,425,2.5
20,59,Franklin,2019,14083,13619,464,3.3
20,61,Geary,2019,11335,10845,490,4.3
20,63,Gove,2019,1480,1449,31,2.1
20,65,Graham,2019,1116,1082,34,3.0
20,67,Grant,2019,3212,3121,91,2.8
20,69,Gray,2019,3242,3177,65,2.0
20,71,Greeley,2019,813,795,18,2.2
20,73,Greenwood,2019,3238,3136,102,3.2
20,75,Hamilton,2019,1598,1568,30,1.9
20,77,Harper,2019,2865,2792,73,2.5
20,79,Harvey,2019,17158,16660,498,2.9
20,81,Haskell,2019,2224,2174,50,2.2
20,83,Hodgeman,2019,992,968,24,2.4
20,85,Jackson,2019,7150,6943,207,2.9
20,87,Jefferson,2019,10194,9883,311,3.1
20,89,Jewell,2019,1304,1267,37,2.8
20,91,Johnson,2019,340852,331451,9401,2.8
20,93,Kearny,2019,2039,1992,47,2.3
20,95,Kingman,2019,3375,3267,108,3.2
20,97,Kiowa,2019,1290,1260,30,2.3
20,99,Labette,2019,10062,9664,398,4.0
20,101,Lane,2019,773,753,20,2.6
20,103,Leavenworth,2019,36585,35329,1256,3.4
20,105,Lincoln,2019,1671,1633,38,2.3
20,107,Linn,2019,4415,4150,265,6.0
20,109,Logan,2019,1625,1592,33,2.0
20,111,Lyon,2019,16755,16188,567,3.4
20,113,McPherson,2019,17243,16860,383,2.2
20,115,Marion,2019,6042,5864,178,2.9
20,117,Marshall,2019,5510,5353,157,2.8
20,119,Meade,2019,2154,2105,49,2.3
20,121,Miami,2019,17727,17143,584,3.3
20,123,Mitchell,2019,3374,3295,79,2.3
20,125,Montgomery,2019,14847,14243,604,4.1
20,127,Morris,2019,2997,2915,82,2.7
20,129,Morton,2019,1137,1104,33,2.9
20,131,Nemaha,2019,5379,5232,147,2.7
20,133,Neosho,2019,6135,5853,282,4.6
20,135,Ness,2019,1337,1304,33,2.5
20,137,Norton,2019,2696,2637,59,2.2
20,139,Osage,2019,8023,7738,285,3.6
20,141,Osborne,2019,2037,1996,41,2.0
20,143,Ottawa,2019,3016,2935,81,2.7
20,145,Pawnee,2019,2853,2772,81,2.8
20,147,Phillips,2019,2647,2578,69,2.6
20,149,Pottawatomie,2019,12423,12072,351,2.8
20,151,Pratt,2019,4915,4791,124,2.5
20,153,Rawlins,2019,1496,1463,33,2.2
20,155,Reno,2019,29788,28837,951,3.2
20,157,Republic,2019,2281,2223,58,2.5
20,159,Rice,2019,5247,5102,145,2.8
20,161,Riley,2019,35167,34171,996,2.8
20,163,Rooks,2019,2535,2447,88,3.5
20,165,Rush,2019,1632,1587,45,2.8
20,167,Russell,2019,3309,3213,96,2.9
20,169,Saline,2019,30309,29406,903,3.0
20,171,Scott,2019,2824,2771,53,1.9
20,173,Sedgwick,2019,253188,244453,8735,3.5
20,175,Seward,2019,9555,9261,294,3.1
20,177,Shawnee,2019,90615,87602,3013,3.3
20,179,Sheridan,2019,1414,1383,31,2.2
20,181,Sherman,2019,2865,2788,77,2.7
20,183,Smith,2019,1988,1938,50,2.5
20,185,Stafford,2019,2000,1946,54,2.7
20,187,Stanton,2019,993,968,25,2.5
20,189,Stevens,2019,2581,2515,66,2.6
20,191,Sumner,2019,10869,10502,367,3.4
20,193,Thomas,2019,4320,4223,97,2.2
20,195,Trego,2019,1413,1373,40,2.8
20,197,Wabaunsee,2019,3685,3568,117,3.2
20,199,Wallace,2019,817,796,21,2.6
20,201,Washington,2019,2934,2857,77,2.6
20,203,Wichita,2019,1382,1355,27,2.0
20,205,Wilson,2019,3945,3790,155,3.9
20,207,Woodson,2019,1621,1553,68,4.2
20,209,Wyandotte,2019,77163,73810,3353,4.3
21,1,Adair,2019,7145,6777,368,5.2
21,3,Allen,2019,9083,8718,365,4.0
21,5,Anderson,2019,12028,11596,432,3.6
21,7,Ballard,2019,3478,3286,192,5.5
21,9,Barren,2019,18833,18014,819,4.3
21,11,Bath,2019,4654,4376,278,6.0
21,13,Bell,2019,8402,7885,517,6.2
21,15,Boone,2019,72405,70048,2357,3.3
21,17,Bourbon,2019,9631,9275,356,3.7
21,19,Boyd,2019,17826,16856,970,5.4
21,21,Boyle,2019,12659,12094,565,4.5
21,23,Bracken,2019,3868,3687,181,4.7
21,25,Breathitt,2019,3471,3221,250,7.2
21,27,Breckinridge,2019,7942,7533,409,5.1
21,29,Bullitt,2019,43279,41561,1718,4.0
21,31,Butler,2019,5141,4902,239,4.6
21,33,Caldwell,2019,5479,5216,263,4.8
21,35,Calloway,2019,18725,17985,740,4.0
21,37,Campbell,2019,51262,49549,1713,3.3
21,39,Carlisle,2019,2238,2148,90,4.0
21,41,Carroll,2019,5334,5131,203,3.8
21,43,Carter,2019,9729,8950,779,8.0
21,45,Casey,2019,6736,6463,273,4.1
21,47,Christian,2019,24494,23163,1331,5.4
21,49,Clark,2019,17276,16623,653,3.8
21,51,Clay,2019,5172,4824,348,6.7
21,53,Clinton,2019,3989,3777,212,5.3
21,55,Crittenden,2019,3776,3599,177,4.7
21,57,Cumberland,2019,3223,3094,129,4.0
21,59,Daviess,2019,47215,45442,1773,3.8
21,61,Edmonson,2019,4760,4531,229,4.8
21,63,Elliott,2019,2027,1866,161,7.9
21,65,Estill,2019,5372,5115,257,4.8
21,67,Fayette,2019,175727,170118,5609,3.2
21,69,Fleming,2019,6222,5897,325,5.2
21,71,Floyd,2019,11089,10409,680,6.1
21,73,Franklin,2019,25195,24288,907,3.6
21,75,Fulton,2019,2035,1923,112,5.5
21,77,Gallatin,2019,4121,3963,158,3.8
21,79,Garrard,2019,7721,7375,346,4.5
21,81,Grant,2019,11755,11287,468,4.0
21,83,Graves,2019,15815,15118,697,4.4
21,85,Grayson,2019,10998,10465,533,4.8
21,87,Green,2019,5132,4917,215,4.2
21,89,Greenup,2019,13479,12629,850,6.3
21,91,Hancock,2019,3933,3786,147,3.7
21,93,Hardin,2019,49236,47280,1956,4.0
21,95,Harlan,2019,6734,6120,614,9.1
21,97,Harrison,2019,8839,8474,365,4.1
21,99,Hart,2019,7938,7573,365,4.6
21,101,Henderson,2019,21669,20859,810,3.7
21,103,Henry,2019,8266,7973,293,3.5
21,105,Hickman,2019,1766,1683,83,4.7
21,107,Hopkins,2019,18453,17643,810,4.4
21,109,Jackson,2019,4126,3872,254,6.2
21,111,Jefferson,2019,399608,384100,15508,3.9
21,113,Jessamine,2019,26793,25851,942,3.5
21,115,Johnson,2019,6751,6323,428,6.3
21,117,Kenton,2019,88741,85708,3033,3.4
21,119,Knott,2019,4483,4188,295,6.6
21,121,Knox,2019,9949,9379,570,5.7
21,123,Larue,2019,6007,5746,261,4.3
21,125,Laurel,2019,24896,23731,1165,4.7
21,127,Lawrence,2019,5193,4844,349,6.7
21,129,Lee,2019,2105,1989,116,5.5
21,131,Leslie,2019,2678,2466,212,7.9
21,133,Letcher,2019,6288,5841,447,7.1
21,135,Lewis,2019,4661,4264,397,8.5
21,137,Lincoln,2019,9377,8925,452,4.8
21,139,Livingston,2019,3643,3442,201,5.5
21,141,Logan,2019,12595,12105,490,3.9
21,143,Lyon,2019,3121,2977,144,4.6
21,145,McCracken,2019,29257,27864,1393,4.8
21,147,McCreary,2019,4722,4450,272,5.8
21,149,McLean,2019,4168,3988,180,4.3
21,151,Madison,2019,47652,45884,1768,3.7
21,153,Magoffin,2019,3118,2789,329,10.6
21,155,Marion,2019,9732,9372,360,3.7
21,157,Marshall,2019,15116,14437,679,4.5
21,159,Martin,2019,2678,2496,182,6.8
21,161,Mason,2019,7117,6724,393,5.5
21,163,Meade,2019,12201,11653,548,4.5
21,165,Menifee,2019,2330,2174,156,6.7
21,167,Mercer,2019,10072,9622,450,4.5
21,169,Metcalfe,2019,4113,3922,191,4.6
21,171,Monroe,2019,4670,4494,176,3.8
21,173,Montgomery,2019,11644,11045,599,5.1
21,175,Morgan,2019,4582,4346,236,5.2
21,177,Muhlenberg,2019,10508,9886,622,5.9
21,179,Nelson,2019,23254,22232,1022,4.4
21,181,Nicholas,2019,3314,3173,141,4.3
21,183,Ohio,2019,9758,9278,480,4.9
21,185,Oldham,2019,33590,32532,1058,3.1
21,187,Owen,2019,5141,4915,226,4.4
21,189,Owsley,2019,1091,1015,76,7.0
21,191,Pendleton,2019,7041,6784,257,3.7
21,193,Perry,2019,8340,7858,482,5.8
21,195,Pike,2019,20058,18952,1106,5.5
21,197,Powell,2019,5043,4784,259,5.1
21,199,Pulaski,2019,26677,25467,1210,4.5
21,201,Robertson,2019,811,769,42,5.2
21,203,Rockcastle,2019,6661,6353,308,4.6
21,205,Rowan,2019,10409,9878,531,5.1
21,207,Russell,2019,6265,5921,344,5.5
21,209,Scott,2019,29815,28818,997,3.3
21,211,Shelby,2019,25866,25017,849,3.3
21,213,Simpson,2019,8919,8531,388,4.4
21,215,Spencer,2019,10541,10185,356,3.4
21,217,Taylor,2019,12820,12298,522,4.1
21,219,Todd,2019,5434,5227,207,3.8
21,221,Trigg,2019,5988,5715,273,4.6
21,223,Trimble,2019,3874,3710,164,4.2
21,225,Union,2019,6091,5826,265,4.4
21,227,Warren,2019,65749,63266,2483,3.8
21,229,Washington,2019,6251,6015,236,3.8
21,231,Wayne,2019,7451,7038,413,5.5
21,233,Webster,2019,5751,5528,223,3.9
21,235,Whitley,2019,13829,13146,683,4.9
21,237,Wolfe,2019,1967,1832,135,6.9
21,239,Woodford,2019,15077,14622,455,3.0
22,1,Acadia Parish,2019,24110,22870,1240,5.1
22,3,Allen Parish,2019,8885,8402,483,5.4
22,5,Ascension Parish,2019,65554,62953,2601,4.0
22,7,Assumption Parish,2019,8970,8448,522,5.8
22,9,Avoyelles Parish,2019,15311,14454,857,5.6
22,11,Beauregard Parish,2019,14766,14023,743,5.0
22,13,Bienville Parish,2019,5562,5246,316,5.7
22,15,Bossier Parish,2019,58493,56067,2426,4.1
22,17,Caddo Parish,2019,103891,98523,5368,5.2
22,19,Calcasieu Parish,2019,107492,103255,4237,3.9
22,21,Caldwell Parish,2019,3810,3586,224,5.9
22,23,Cameron Parish,2019,3982,3839,143,3.6
22,25,Catahoula Parish,2019,3418,3207,211,6.2
22,27,Claiborne Parish,2019,5876,5559,317,5.4
22,29,Concordia Parish,2019,7050,6611,439,6.2
22,31,De Soto Parish,2019,11033,10397,636,5.8
22,33,East Baton Rouge Parish,2019,232201,222303,9898,4.3
22,35,East Carroll Parish,2019,1905,1711,194,10.2
22,37,East Feliciana Parish,2019,7980,7623,357,4.5
22,39,Evangeline Parish,2019,12018,11335,683,5.7
22,41,Franklin Parish,2019,7438,6921,517,7.0
22,43,Grant Parish,2019,8267,7804,463,5.6
22,45,Iberia Parish,2019,28034,26563,1471,5.2
22,47,Iberville Parish,2019,14077,13268,809,5.7
22,49,Jackson Parish,2019,6878,6563,315,4.6
22,51,Jefferson Parish,2019,215729,207033,8696,4.0
22,53,Jefferson Davis Parish,2019,13414,12807,607,4.5
22,55,Lafayette Parish,2019,115923,111100,4823,4.2
22,57,Lafourche Parish,2019,42379,40541,1838,4.3
22,59,LaSalle Parish,2019,6789,6509,280,4.1
22,61,Lincoln Parish,2019,22136,20988,1148,5.2
22,63,Livingston Parish,2019,69982,67224,2758,3.9
22,65,Madison Parish,2019,3563,3289,274,7.7
22,67,Morehouse Parish,2019,10054,9250,804,8.0
22,69,Natchitoches Parish,2019,16501,15539,962,5.8
22,71,Orleans Parish,2019,180729,172235,8494,4.7
22,73,Ouachita Parish,2019,70828,67208,3620,5.1
22,75,Plaquemines Parish,2019,10095,9673,422,4.2
22,77,Pointe Coupee Parish,2019,9865,9354,511,5.2
22,79,Rapides Parish,2019,55555,52841,2714,4.9
22,81,Red River Parish,2019,3783,3597,186,4.9
22,83,Richland Parish,2019,8303,7803,500,6.0
22,85,Sabine Parish,2019,9310,8854,456,4.9
22,87,St. Bernard Parish,2019,20332,19377,955,4.7
22,89,St. Charles Parish,2019,25565,24504,1061,4.2
22,91,St. Helena Parish,2019,4258,4005,253,5.9
22,93,St. James Parish,2019,9366,8827,539,5.8
22,95,St. John the Baptist Parish,2019,19733,18666,1067,5.4
22,97,St. Landry Parish,2019,32232,30284,1948,6.0
22,99,St. Martin Parish,2019,22411,21308,1103,4.9
22,101,St. Mary Parish,2019,19962,18829,1133,5.7
22,103,St. Tammany Parish,2019,121941,117050,4891,4.0
22,105,Tangipahoa Parish,2019,55256,52318,2938,5.3
22,107,Tensas Parish,2019,1404,1291,113,8.0
22,109,Terrebonne Parish,2019,46688,44602,2086,4.5
22,111,Union Parish,2019,9177,8662,515,5.6
22,113,Vermilion Parish,2019,24281,23100,1181,4.9
22,115,Vernon Parish,2019,15953,15028,925,5.8
22,117,Washington Parish,2019,16934,15974,960,5.7
22,119,Webster Parish,2019,14549,13693,856,5.9
22,121,West Baton Rouge Parish,2019,13793,13190,603,4.4
22,123,West Carroll Parish,2019,3665,3289,376,10.3
22,125,West Feliciana Parish,2019,5466,5251,215,3.9
22,127,Winn Parish,2019,4904,4606,298,6.1
23,1,Androscoggin,2019,55355,53870,1485,2.7
23,3,Aroostook,2019,30312,29058,1254,4.1
23,5,Cumberland,2019,165561,162001,3560,2.2
23,7,Franklin,2019,14423,13926,497,3.4
23,9,Hancock,2019,29222,28304,918,3.1
23,11,Kennebec,2019,62273,60628,1645,2.6
23,13,Knox,2019,20417,19884,533,2.6
23,15,Lincoln,2019,16970,16523,447,2.6
23,17,Oxford,2019,26576,25716,860,3.2
23,19,Penobscot,2019,76839,74560,2279,3.0
23,21,Piscataquis,2019,7291,7046,245,3.4
23,23,Sagadahoc,2019,19591,19185,406,2.1
23,25,Somerset,2019,22478,21577,901,4.0
23,27,Waldo,2019,20735,20141,594,2.9
23,29,Washington,2019,13700,13130,570,4.2
23,31,York,2019,114452,111658,2794,2.4
24,1,Allegany,2019,32253,30618,1635,5.1
24,3,Anne Arundel,2019,321069,311556,9513,3.0
24,5,Baltimore,2019,459091,442597,16494,3.6
24,9,Calvert,2019,50751,49192,1559,3.1
24,11,Caroline,2019,18361,17719,642,3.5
24,13,Carroll,2019,96933,94187,2746,2.8
24,15,Cecil,2019,53891,51812,2079,3.9
24,17,Charles,2019,89012,85871,3141,3.5
24,19,Dorchester,2019,16152,15424,728,4.5
24,21,Frederick,2019,137920,133683,4237,3.1
24,23,Garrett,2019,15981,15301,680,4.3
24,25,Harford,2019,143572,138927,4645,3.2
24,27,Howard,2019,191529,186427,5102,2.7
24,29,Kent,2019,10272,9873,399,3.9
24,31,Montgomery,2019,565463,549296,16167,2.9
24,33,Prince George's,2019,513748,494934,18814,3.7
24,35,Queen Anne's,2019,28284,27432,852,3.0
24,37,St. Mary's,2019,57283,55414,1869,3.3
24,39,Somerset,2019,9137,8585,552,6.0
24,41,Talbot,2019,19275,18626,649,3.4
24,43,Washington,2019,74861,72015,2846,3.8
24,45,Wicomico,2019,51370,49020,2350,4.6
24,47,Worcester,2019,25741,23880,1861,7.2
24,510,Baltimore city,2019,287760,273351,14409,5.0
25,1,Barnstable,2019,114087,109493,4594,4.0
25,3,Berkshire,2019,63980,61630,2350,3.7
25,5,Bristol,2019,301317,289623,11694,3.9
25,7,Dukes,2019,9575,9166,409,4.3
25,9,Essex,2019,426042,412856,13186,3.1
25,11,Franklin,2019,40781,39639,1142,2.8
25,13,Hampden,2019,227534,217841,9693,4.3
25,15,Hampshire,2019,90266,87730,2536,2.8
25,17,Middlesex,2019,920269,898135,22134,2.4
25,19,Nantucket/town,2019,7620,7288,332,4.4
25,21,Norfolk,2019,393344,383017,10327,2.6
25,23,Plymouth,2019,285619,276649,8970,3.1
25,25,Suffolk,2019,455973,443583,12390,2.7
25,27,Worcester,2019,445677,431084,14593,3.3
26,1,Alcona,2019,3890,3650,240,6.2
26,3,Alger,2019,3185,2942,243,7.6
26,5,Allegan,2019,62517,60603,1914,3.1
26,7,Alpena,2019,13203,12590,613,4.6
26,9,Antrim,2019,10311,9791,520,5.0
26,11,Arenac,2019,6051,5662,389,6.4
26,13,Baraga,2019,3208,3010,198,6.2
26,15,Barry,2019,31890,30877,1013,3.2
26,17,Bay,2019,50186,47905,2281,4.5
26,19,Benzie,2019,8837,8396,441,5.0
26,21,Berrien,2019,73996,71093,2903,3.9
26,23,Branch,2019,19396,18655,741,3.8
26,25,Calhoun,2019,62524,60018,2506,4.0
26,27,Cass,2019,24781,23754,1027,4.1
26,29,Charlevoix,2019,12901,12314,587,4.6
26,31,Cheboygan,2019,10510,9613,897,8.5
26,33,Chippewa,2019,16096,15109,987,6.1
26,35,Clare,2019,11800,11098,702,5.9
26,37,Clinton,2019,41338,40127,1211,2.9
26,39,Crawford,2019,5594,5287,307,5.5
26,41,Delta,2019,17138,16261,877,5.1
26,43,Dickinson,2019,12279,11771,508,4.1
26,45,Eaton,2019,57537,55625,1912,3.3
26,47,Emmet,2019,17722,16784,938,5.3
26,49,Genesee,2019,181385,172579,8806,4.9
26,51,Gladwin,2019,9912,9358,554,5.6
26,53,Gogebic,2019,6006,5708,298,5.0
26,55,Grand Traverse,2019,49807,48118,1689,3.4
26,57,Gratiot,2019,18052,17281,771,4.3
26,59,Hillsdale,2019,20512,19676,836,4.1
26,61,Houghton,2019,16248,15480,768,4.7
26,63,Huron,2019,15433,14770,663,4.3
26,65,Ingham,2019,151269,146061,5208,3.4
26,67,Ionia,2019,30387,29372,1015,3.3
26,69,Iosco,2019,10189,9594,595,5.8
26,71,Iron,2019,5119,4842,277,5.4
26,73,Isabella,2019,34732,33442,1290,3.7
26,75,Jackson,2019,74645,71919,2726,3.7
26,77,Kalamazoo,2019,134168,129857,4311,3.2
26,79,Kalkaska,2019,7978,7539,439,5.5
26,81,Kent,2019,361906,351699,10207,2.8
26,83,Keweenaw,2019,901,841,60,6.7
26,85,Lake,2019,3771,3539,232,6.2
26,87,Lapeer,2019,41504,39205,2299,5.5
26,89,Leelanau,2019,10475,10089,386,3.7
26,91,Lenawee,2019,46455,44693,1762,3.8
26,93,Livingston,2019,105037,101488,3549,3.4
26,95,Luce,2019,2268,2128,140,6.2
26,97,Mackinac,2019,5190,4722,468,9.0
26,99,Macomb,2019,452587,432975,19612,4.3
26,101,Manistee,2019,10414,9852,562,5.4
26,103,Marquette,2019,32487,30942,1545,4.8
26,105,Mason,2019,13655,12999,656,4.8
26,107,Mecosta,2019,18437,17598,839,4.6
26,109,Menominee,2019,11011,10580,431,3.9
26,111,Midland,2019,40188,38713,1475,3.7
26,113,Missaukee,2019,6937,6612,325,4.7
26,115,Monroe,2019,75785,72901,2884,3.8
26,117,Montcalm,2019,28330,27200,1130,4.0
26,119,Montmorency,2019,2993,2748,245,8.2
26,121,Muskegon,2019,77293,74071,3222,4.2
26,123,Newaygo,2019,23432,22463,969,4.1
26,125,Oakland,2019,682088,658244,23844,3.5
26,127,Oceana,2019,12067,11362,705,5.8
26,129,Ogemaw,2019,8040,7515,525,6.5
26,131,Ontonagon,2019,2082,1943,139,6.7
26,133,Osceola,2019,11267,10821,446,4.0
26,135,Oscoda,2019,2989,2784,205,6.9
26,137,Otsego,2019,11630,11065,565,4.9
26,139,Ottawa,2019,161960,157599,4361,2.7
26,141,Presque Isle,2019,4946,4581,365,7.4
26,143,Roscommon,2019,7766,7198,568,7.3
26,145,Saginaw,2019,86821,82780,4041,4.7
26,147,St. Clair,2019,76499,72675,3824,5.0
26,149,St. Joseph,2019,28195,27027,1168,4.1
26,151,Sanilac,2019,19574,18666,908,4.6
26,153,Schoolcraft,2019,3300,3073,227,6.9
26,155,Shiawassee,2019,33464,32068,1396,4.2
26,157,Tuscola,2019,23905,22715,1190,5.0
26,159,Van Buren,2019,35349,33776,1573,4.4
26,161,Washtenaw,2019,199028,193473,5555,2.8
26,163,Wayne,2019,809861,767852,42009,5.2
26,165,Wexford,2019,14861,14205,656,4.4
27,1,Aitkin,2019,7269,6830,439,6.0
27,3,Anoka,2019,198768,192801,5967,3.0
27,5,Becker,2019,18775,18049,726,3.9
27,7,Beltrami,2019,24357,23341,1016,4.2
27,9,Benton,2019,21941,21103,838,3.8
27,11,Big Stone,2019,2484,2383,101,4.1
27,13,Blue Earth,2019,40613,39513,1100,2.7
27,15,Brown,2019,14360,13851,509,3.5
27,17,Carlton,2019,17871,17092,779,4.4
27,19,Carver,2019,59272,57673,1599,2.7
27,21,Cass,2019,14391,13613,778,5.4
27,23,Chippewa,2019,6889,6627,262,3.8
27,25,Chisago,2019,30229,29118,1111,3.7
27,27,Clay,2019,36084,35009,1075,3.0
27,29,Clearwater,2019,4460,4099,361,8.1
27,31,Cook,2019,3116,2985,131,4.2
27,33,Cottonwood,2019,5913,5699,214,3.6
27,35,Crow Wing,2019,32228,30860,1368,4.2
27,37,Dakota,2019,242934,236094,6840,2.8
27,39,Dodge,2019,11879,11485,394,3.3
27,41,Douglas,2019,21028,20377,651,3.1
27,43,Faribault,2019,7017,6733,284,4.0
27,45,Fillmore,2019,11511,11137,374,3.2
27,47,Freeborn,2019,16083,15543,540,3.4
27,49,Goodhue,2019,26977,26170,807,3.0
27,51,Grant,2019,3306,3163,143,4.3
27,53,Hennepin,2019,707701,688531,19170,2.7
27,55,Houston,2019,10384,10057,327,3.1
27,57,Hubbard,2019,9972,9445,527,5.3
27,59,Isanti,2019,21570,20721,849,3.9
27,61,Itasca,2019,21909,20638,1271,5.8
27,63,Jackson,2019,5705,5513,192,3.4
27,65,Kanabec,2019,9059,8536,523,5.8
27,67,Kandiyohi,2019,24288,23450,838,3.5
27,69,Kittson,2019,2368,2284,84,3.5
27,71,Koochiching,2019,5970,5602,368,6.2
27,73,Lac qui Parle,2019,3538,3408,130,3.7
27,75,Lake,2019,5493,5299,194,3.5
27,77,Lake of the Woods,2019,2445,2345,100,4.1
27,79,Le Sueur,2019,16331,15615,716,4.4
27,81,Lincoln,2019,3250,3130,120,3.7
27,83,Lyon,2019,14501,14049,452,3.1
27,85,McLeod,2019,19309,18610,699,3.6
27,87,Mahnomen,2019,2294,2188,106,4.6
27,89,Marshall,2019,5396,5086,310,5.7
27,91,Martin,2019,10041,9671,370,3.7
27,93,Meeker,2019,13334,12829,505,3.8
27,95,Mille Lacs,2019,12962,12274,688,5.3
27,97,Morrison,2019,17544,16653,891,5.1
27,99,Mower,2019,20395,19793,602,3.0
27,101,Murray,2019,4841,4637,204,4.2
27,103,Nicollet,2019,20925,20405,520,2.5
27,105,Nobles,2019,11204,10879,325,2.9
27,107,Norman,2019,3249,3096,153,4.7
27,109,Olmsted,2019,89107,86871,2236,2.5
27,111,Otter Tail,2019,31375,30093,1282,4.1
27,113,Pennington,2019,8698,8309,389,4.5
27,115,Pine,2019,15036,14223,813,5.4
27,117,Pipestone,2019,4911,4742,169,3.4
27,119,Polk,2019,16672,16028,644,3.9
27,121,Pope,2019,6520,6321,199,3.1
27,123,Ramsey,2019,288732,280286,8446,2.9
27,125,Red Lake,2019,2223,2108,115,5.2
27,127,Redwood,2019,7597,7322,275,3.6
27,129,Renville,2019,8623,8241,382,4.4
27,131,Rice,2019,37182,36051,1131,3.0
27,133,Rock,2019,5642,5516,126,2.2
27,135,Roseau,2019,7829,7533,296,3.8
27,137,St. Louis,2019,101662,97689,3973,3.9
27,139,Scott,2019,84200,81941,2259,2.7
27,141,Sherburne,2019,52936,51120,1816,3.4
27,143,Sibley,2019,8470,8151,319,3.8
27,145,Stearns,2019,90597,87774,2823,3.1
27,147,Steele,2019,21136,20482,654,3.1
27,149,Stevens,2019,5442,5299,143,2.6
27,151,Swift,2019,4894,4685,209,4.3
27,153,Todd,2019,13530,12948,582,4.3
27,155,Traverse,2019,1763,1700,63,3.6
27,157,Wabasha,2019,12252,11852,400,3.3
27,159,Wadena,2019,5923,5566,357,6.0
27,161,Waseca,2019,9021,8682,339,3.8
27,163,Washington,2019,144689,140707,3982,2.8
27,165,Watonwan,2019,6502,6245,257,4.0
27,167,Wilkin,2019,3509,3393,116,3.3
27,169,Winona,2019,28587,27783,804,2.8
27,171,Wright,2019,76571,74140,2431,3.2
27,173,Yellow Medicine,2019,5349,5150,199,3.7
28,1,Adams,2019,11179,10370,809,7.2
28,3,Alcorn,2019,16205,15423,782,4.8
28,5,Amite,2019,4451,4135,316,7.1
28,7,Attala,2019,7041,6589,452,6.4
28,9,Benton,2019,3062,2868,194,6.3
28,11,Bolivar,2019,11980,11118,862,7.2
28,13,Calhoun,2019,5595,5276,319,5.7
28,15,Carroll,2019,3540,3316,224,6.3
28,17,Chickasaw,2019,6944,6542,402,5.8
28,19,Choctaw,2019,3715,3505,210,5.7
28,21,Claiborne,2019,3105,2770,335,10.8
28,23,Clarke,2019,5970,5592,378,6.3
28,25,Clay,2019,7872,7275,597,7.6
28,27,Coahoma,2019,8355,7703,652,7.8
28,29,Copiah,2019,11121,10369,752,6.8
28,31,Covington,2019,8226,7823,403,4.9
28,33,DeSoto,2019,93121,88908,4213,4.5
28,35,Forrest,2019,33216,31457,1759,5.3
28,37,Franklin,2019,2788,2592,196,7.0
28,39,George,2019,8959,8284,675,7.5
28,41,Greene,2019,4370,4019,351,8.0
28,43,Grenada,2019,9641,9151,490,5.1
28,45,Hancock,2019,18891,17803,1088,5.8
28,47,Harrison,2019,87046,82424,4622,5.3
28,49,Hinds,2019,105466,99796,5670,5.4
28,51,Holmes,2019,5624,5039,585,10.4
28,53,Humphreys,2019,2194,1966,228,10.4
28,55,Issaquena,2019,364,319,45,12.4
28,57,Itawamba,2019,10533,10025,508,4.8
28,59,Jackson,2019,58721,55070,3651,6.2
28,61,Jasper,2019,6258,5823,435,7.0
28,63,Jefferson,2019,2021,1698,323,16.0
28,65,Jefferson Davis,2019,4114,3823,291,7.1
28,67,Jones,2019,26471,25036,1435,5.4
28,69,Kemper,2019,3492,3213,279,8.0
28,71,Lafayette,2019,28081,26825,1256,4.5
28,73,Lamar,2019,31147,29799,1348,4.3
28,75,Lauderdale,2019,30424,28723,1701,5.6
28,77,Lawrence,2019,4652,4326,326,7.0
28,79,Leake,2019,8062,7605,457,5.7
28,81,Lee,2019,41544,39691,1853,4.5
28,83,Leflore,2019,9938,9172,766,7.7
28,85,Lincoln,2019,14675,13833,842,5.7
28,87,Lowndes,2019,25797,24415,1382,5.4
28,89,Madison,2019,53996,51578,2418,4.5
28,91,Marion,2019,10029,9465,564,5.6
28,93,Marshall,2019,14483,13631,852,5.9
28,95,Monroe,2019,15667,14800,867,5.5
28,97,Montgomery,2019,3957,3715,242,6.1
28,99,Neshoba,2019,10371,9745,626,6.0
28,101,Newton,2019,8395,7911,484,5.8
28,103,Noxubee,2019,3783,3502,281,7.4
28,105,Oktibbeha,2019,22812,21504,1308,5.7
28,107,Panola,2019,12696,11842,854,6.7
28,109,Pearl River,2019,23789,22507,1282,5.4
28,111,Perry,2019,4311,4012,299,6.9
28,113,Pike,2019,14571,13598,973,6.7
28,115,Pontotoc,2019,15015,14347,668,4.4
28,117,Prentiss,2019,11395,10829,566,5.0
28,119,Quitman,2019,2335,2140,195,8.4
28,121,Rankin,2019,77397,74263,3134,4.0
28,123,Scott,2019,12849,12265,584,4.5
28,125,Sharkey,2019,1484,1346,138,9.3
28,127,Simpson,2019,10798,10225,573,5.3
28,129,Smith,2019,6827,6463,364,5.3
28,131,Stone,2019,6926,6495,431,6.2
28,133,Sunflower,2019,7481,6785,696,9.3
28,135,Tallahatchie,2019,5382,5072,310,5.8
28,137,Tate,2019,12238,11536,702,5.7
28,139,Tippah,2019,9584,9085,499,5.2
28,141,Tishomingo,2019,8701,8248,453,5.2
28,143,Tunica,2019,4336,4057,279,6.4
28,145,Union,2019,14400,13785,615,4.3
28,147,Walthall,2019,4974,4606,368,7.4
28,149,Warren,2019,20530,19279,1251,6.1
28,151,Washington,2019,16251,14950,1301,8.0
28,153,Wayne,2019,7549,7080,469,6.2
28,155,Webster,2019,3974,3742,232,5.8
28,157,Wilkinson,2019,2823,2531,292,10.3
28,159,Winston,2019,7436,6976,460,6.2
28,161,Yalobusha,2019,4993,4701,292,5.8
28,163,Yazoo,2019,9966,9325,641,6.4
29,1,Adair,2019,10289,9889,400,3.9
29,3,Andrew,2019,9849,9578,271,2.8
29,5,Atchison,2019,2686,2587,99,3.7
29,7,Audrain,2019,10628,10271,357,3.4
29,9,Barry,2019,15511,14971,540,3.5
29,11,Barton,2019,5158,4984,174,3.4
29,13,Bates,2019,7765,7449,316,4.1
29,15,Benton,2019,7153,6807,346,4.8
29,17,Bollinger,2019,5439,5227,212,3.9
29,19,Boone,2019,98294,95949,2345,2.4
29,21,Buchanan,2019,44205,42855,1350,3.1
29,23,Butler,2019,17910,17072,838,4.7
29,25,Caldwell,2019,4286,4149,137,3.2
29,27,Callaway,2019,21344,20726,618,2.9
29,29,Camden,2019,18806,17962,844,4.5
29,31,Cape Girardeau,2019,40703,39512,1191,2.9
29,33,Carroll,2019,4779,4625,154,3.2
29,35,Carter,2019,2523,2399,124,4.9
29,37,Cass,2019,54768,53117,1651,3.0
29,39,Cedar,2019,5754,5540,214,3.7
29,41,Chariton,2019,3699,3588,111,3.0
29,43,Christian,2019,45391,44161,1230,2.7
29,45,Clark,2019,3176,3063,113,3.6
29,47,Clay,2019,137176,133261,3915,2.9
29,49,Clinton,2019,10592,10269,323,3.0
29,51,Cole,2019,39085,38077,1008,2.6
29,53,Cooper,2019,7421,7146,275,3.7
29,55,Crawford,2019,10938,10527,411,3.8
29,57,Dade,2019,3532,3421,111,3.1
29,59,Dallas,2019,7061,6746,315,4.5
29,61,Daviess,2019,4079,3943,136,3.3
29,63,DeKalb,2019,4817,4670,147,3.1
29,65,Dent,2019,6268,6045,223,3.6
29,67,Douglas,2019,5080,4823,257,5.1
29,69,Dunklin,2019,11482,10849,633,5.5
29,71,Franklin,2019,53512,51804,1708,3.2
29,73,Gasconade,2019,7722,7463,259,3.4
29,75,Gentry,2019,3485,3392,93,2.7
29,77,Greene,2019,150699,146642,4057,2.7
29,79,Grundy,2019,4364,4211,153,3.5
29,81,Harrison,2019,3784,3658,126,3.3
29,83,Henry,2019,9692,9331,361,3.7
29,85,Hickory,2019,3829,3669,160,4.2
29,87,Holt,2019,2575,2502,73,2.8
29,89,Howard,2019,4866,4717,149,3.1
29,91,Howell,2019,16418,15751,667,4.1
29,93,Iron,2019,3511,3343,168,4.8
29,95,Jackson,2019,361255,347783,13472,3.7
29,97,Jasper,2019,57058,55348,1710,3.0
29,99,Jefferson,2019,118862,115205,3657,3.1
29,101,Johnson,2019,23047,22194,853,3.7
29,103,Knox,2019,1764,1713,51,2.9
29,105,Laclede,2019,17295,16104,1191,6.9
29,107,Lafayette,2019,16736,16221,515,3.1
29,109,Lawrence,2019,17927,17298,629,3.5
29,111,Lewis,2019,4978,4821,157,3.2
29,113,Lincoln,2019,29157,28206,951,3.3
29,115,Linn,2019,5074,4828,246,4.8
29,117,Livingston,2019,7331,7145,186,2.5
29,119,McDonald,2019,10414,10063,351,3.4
29,121,Macon,2019,7481,7228,253,3.4
29,123,Madison,2019,5445,5260,185,3.4
29,125,Maries,2019,3862,3728,134,3.5
29,127,Marion,2019,14426,13969,457,3.2
29,129,Mercer,2019,1845,1787,58,3.1
29,131,Miller,2019,12238,11778,460,3.8
29,133,Mississippi,2019,5733,5500,233,4.1
29,135,Moniteau,2019,7324,7110,214,2.9
29,137,Monroe,2019,3823,3662,161,4.2
29,139,Montgomery,2019,5715,5536,179,3.1
29,141,Morgan,2019,8095,7745,350,4.3
29,143,New Madrid,2019,8181,7831,350,4.3
29,145,Newton,2019,27109,26222,887,3.3
29,147,Nodaway,2019,10745,10427,318,3.0
29,149,Oregon,2019,3952,3796,156,3.9
29,151,Osage,2019,7061,6893,168,2.4
29,153,Ozark,2019,3423,3226,197,5.8
29,155,Pemiscot,2019,6311,5996,315,5.0
29,157,Perry,2019,9998,9735,263,2.6
29,159,Pettis,2019,20844,20108,736,3.5
29,161,Phelps,2019,19682,19039,643,3.3
29,163,Pike,2019,7489,7225,264,3.5
29,165,Platte,2019,59015,57446,1569,2.7
29,167,Polk,2019,14429,13930,499,3.5
29,169,Pulaski,2019,14644,14046,598,4.1
29,171,Putnam,2019,2267,2185,82,3.6
29,173,Ralls,2019,5671,5495,176,3.1
29,175,Randolph,2019,10295,9897,398,3.9
29,177,Ray,2019,10985,10587,398,3.6
29,179,Reynolds,2019,3016,2904,112,3.7
29,181,Ripley,2019,4994,4718,276,5.5
29,183,St. Charles,2019,229322,223553,5769,2.5
29,185,St. Clair,2019,3735,3565,170,4.6
29,186,Ste. Genevieve,2019,9158,8913,245,2.7
29,187,St. Francois,2019,26521,25544,977,3.7
29,189,St. Louis,2019,533020,516814,16206,3.0
29,195,Saline,2019,10621,10283,338,3.2
29,197,Schuyler,2019,1961,1876,85,4.3
29,199,Scotland,2019,2357,2285,72,3.1
29,201,Scott,2019,19853,19152,701,3.5
29,203,Shannon,2019,3234,3057,177,5.5
29,205,Shelby,2019,3029,2941,88,2.9
29,207,Stoddard,2019,13031,12421,610,4.7
29,209,Stone,2019,13852,13171,681,4.9
29,211,Sullivan,2019,2658,2566,92,3.5
29,213,Taney,2019,26975,25600,1375,5.1
29,215,Texas,2019,8906,8508,398,4.5
29,217,Vernon,2019,9420,9089,331,3.5
29,219,Warren,2019,18496,17966,530,2.9
29,221,Washington,2019,10198,9742,456,4.5
29,223,Wayne,2019,5237,4985,252,4.8
29,225,Webster,2019,17360,16742,618,3.6
29,227,Worth,2019,1155,1124,31,2.7
29,229,Wright,2019,7417,7027,390,5.3
29,510,St. Louis city,2019,152325,146448,5877,3.9
30,1,Beaverhead,2019,5131,4976,155,3.0
30,3,Big Horn,2019,4905,4533,372,7.6
30,5,Blaine,2019,2294,2202,92,4.0
30,7,Broadwater,2019,2615,2509,106,4.1
30,9,Carbon,2019,5487,5290,197,3.6
30,11,Carter,2019,656,637,19,2.9
30,13,Cascade,2019,38090,36757,1333,3.5
30,15,Chouteau,2019,2460,2391,69,2.8
30,17,Custer,2019,6074,5895,179,2.9
30,19,Daniels,2019,885,867,18,2.0
30,21,Dawson,2019,4615,4500,115,2.5
30,23,Deer Lodge,2019,5083,4916,167,3.3
30,25,Fallon,2019,1704,1673,31,1.8
30,27,Fergus,2019,6039,5844,195,3.2
30,29,Flathead,2019,48408,46059,2349,4.9
30,31,Gallatin,2019,69389,67754,1635,2.4
30,33,Garfield,2019,743,724,19,2.6
30,35,Glacier,2019,5744,5300,444,7.7
30,37,Golden Valley,2019,365,350,15,4.1
30,39,Granite,2019,1708,1610,98,5.7
30,41,Hill,2019,7702,7410,292,3.8
30,43,Jefferson,2019,5749,5552,197,3.4
30,45,Judith Basin,2019,984,953,31,3.2
30,47,Lake,2019,13331,12749,582,4.4
30,49,Lewis and Clark,2019,36148,35035,1113,3.1
30,51,Liberty,2019,948,923,25,2.6
30,53,Lincoln,2019,8148,7536,612,7.5
30,55,McCone,2019,953,934,19,2.0
30,57,Madison,2019,4789,4630,159,3.3
30,59,Meagher,2019,961,927,34,3.5
30,61,Mineral,2019,1775,1671,104,5.9
30,63,Missoula,2019,64237,62103,2134,3.3
30,65,Musselshell,2019,2282,2191,91,4.0
30,67,Park,2019,8986,8670,316,3.5
30,69,Petroleum,2019,268,258,10,3.7
30,71,Phillips,2019,1884,1812,72,3.8
30,73,Pondera,2019,2685,2582,103,3.8
30,75,Powder River,2019,958,936,22,2.3
30,77,Powell,2019,2969,2858,111,3.7
30,79,Prairie,2019,476,458,18,3.8
30,81,Ravalli,2019,20400,19543,857,4.2
30,83,Richland,2019,5894,5733,161,2.7
30,85,Roosevelt,2019,4526,4325,201,4.4
30,87,Rosebud,2019,3841,3642,199,5.2
30,89,Sanders,2019,4913,4614,299,6.1
30,91,Sheridan,2019,1742,1702,40,2.3
30,93,Silver Bow,2019,17294,16620,674,3.9
30,95,Stillwater,2019,5243,5074,169,3.2
30,97,Sweet Grass,2019,1816,1764,52,2.9
30,99,Teton,2019,2760,2667,93,3.4
30,101,Toole,2019,2123,2071,52,2.4
30,103,Treasure,2019,342,332,10,2.9
30,105,Valley,2019,4116,3982,134,3.3
30,107,Wheatland,2019,766,737,29,3.8
30,109,Wibaux,2019,454,441,13,2.9
30,111,Yellowstone,2019,82301,79581,2720,3.3
31,1,Adams,2019,16839,16314,525,3.1
31,3,Antelope,2019,3602,3513,89,2.5
31,5,Arthur,2019,228,216,12,5.3
31,7,Banner,2019,381,367,14,3.7
31,9,Blaine,2019,256,244,12,4.7
31,11,Boone,2019,2971,2892,79,2.7
31,13,Box Butte,2019,5430,5261,169,3.1
31,15,Boyd,2019,1081,1046,35,3.2
31,17,Brown,2019,1402,1353,49,3.5
31,19,Buffalo,2019,27943,27227,716,2.6
31,21,Burt,2019,3509,3393,116,3.3
31,23,Butler,2019,4636,4519,117,2.5
31,25,Cass,2019,13583,13133,450,3.3
31,27,Cedar,2019,4539,4428,111,2.4
31,29,Chase,2019,2282,2232,50,2.2
31,31,Cherry,2019,3380,3301,79,2.3
31,33,Cheyenne,2019,4400,4244,156,3.5
31,35,Clay,2019,3306,3203,103,3.1
31,37,Colfax,2019,5606,5458,148,2.6
31,39,Cuming,2019,4763,4642,121,2.5
31,41,Custer,2019,6435,6285,150,2.3
31,43,Dakota,2019,10775,10365,410,3.8
31,45,Dawes,2019,5005,4865,140,2.8
31,47,Dawson,2019,13125,12740,385,2.9
31,49,Deuel,2019,958,930,28,2.9
31,51,Dixon,2019,3003,2913,90,3.0
31,53,Dodge,2019,19714,19151,563,2.9
31,55,Douglas,2019,301008,291332,9676,3.2
31,57,Dundy,2019,1156,1128,28,2.4
31,59,Fillmore,2019,3178,3098,80,2.5
31,61,Franklin,2019,1487,1439,48,3.2
31,63,Frontier,2019,1618,1567,51,3.2
31,65,Furnas,2019,2591,2521,70,2.7
31,67,Gage,2019,11054,10671,383,3.5
31,69,Garden,2019,1098,1067,31,2.8
31,71,Garfield,2019,1153,1123,30,2.6
31,73,Gosper,2019,1104,1075,29,2.6
31,75,Grant,2019,411,400,11,2.7
31,77,Greeley,2019,1229,1193,36,2.9
31,79,Hall,2019,32039,30935,1104,3.4
31,81,Hamilton,2019,4827,4685,142,2.9
31,83,Harlan,2019,1786,1737,49,2.7
31,85,Hayes,2019,620,604,16,2.6
31,87,Hitchcock,2019,1263,1222,41,3.2
31,89,Holt,2019,5755,5610,145,2.5
31,91,Hooker,2019,420,408,12,2.9
31,93,Howard,2019,3381,3264,117,3.5
31,95,Jefferson,2019,4161,4050,111,2.7
31,97,Johnson,2019,2069,1999,70,3.4
31,99,Kearney,2019,3801,3718,83,2.2
31,101,Keith,2019,4626,4479,147,3.2
31,103,Keya Paha,2019,589,574,15,2.5
31,105,Kimball,2019,2035,1975,60,2.9
31,107,Knox,2019,4623,4488,135,2.9
31,109,Lancaster,2019,178068,173232,4836,2.7
31,111,Lincoln,2019,18390,17769,621,3.4
31,113,Logan,2019,474,460,14,3.0
31,115,Loup,2019,417,400,17,4.1
31,117,McPherson,2019,447,436,11,2.5
31,119,Madison,2019,19903,19360,543,2.7
31,121,Merrick,2019,4056,3929,127,3.1
31,123,Morrill,2019,2614,2541,73,2.8
31,125,Nance,2019,1991,1932,59,3.0
31,127,Nemaha,2019,3638,3508,130,3.6
31,129,Nuckolls,2019,2405,2341,64,2.7
31,131,Otoe,2019,8446,8182,264,3.1
31,133,Pawnee,2019,1481,1440,41,2.8
31,135,Perkins,2019,1825,1785,40,2.2
31,137,Phelps,2019,4993,4865,128,2.6
31,139,Pierce,2019,4116,4008,108,2.6
31,141,Platte,2019,17758,17249,509,2.9
31,143,Polk,2019,2933,2853,80,2.7
31,145,Red Willow,2019,5874,5719,155,2.6
31,147,Richardson,2019,4258,4125,133,3.1
31,149,Rock,2019,874,848,26,3.0
31,151,Saline,2019,7416,7179,237,3.2
31,153,Sarpy,2019,97712,94941,2771,2.8
31,155,Saunders,2019,11288,10979,309,2.7
31,157,Scotts Bluff,2019,18325,17665,660,3.6
31,159,Seward,2019,8914,8657,257,2.9
31,161,Sheridan,2019,2687,2614,73,2.7
31,163,Sherman,2019,1682,1629,53,3.2
31,165,Sioux,2019,745,725,20,2.7
31,167,Stanton,2019,3524,3435,89,2.5
31,169,Thayer,2019,2792,2721,71,2.5
31,171,Thomas,2019,428,413,15,3.5
31,173,Thurston,2019,3057,2921,136,4.4
31,175,Valley,2019,2138,2070,68,3.2
31,177,Washington,2019,11281,10959,322,2.9
31,179,Wayne,2019,5786,5638,148,2.6
31,181,Webster,2019,1677,1621,56,3.3
31,183,Wheeler,2019,569,554,15,2.6
31,185,York,2019,7326,7136,190,2.6
32,1,Churchill,2019,11219,10822,397,3.5
32,3,Clark,2019,1150076,1103405,46671,4.1
32,5,Douglas,2019,23512,22587,925,3.9
32,7,Elko,2019,27691,26871,820,3.0
32,9,Esmeralda,2019,441,424,17,3.9
32,11,Eureka,2019,1115,1089,26,2.3
32,13,Humboldt,2019,8394,8149,245,2.9
32,15,Lander,2019,3255,3152,103,3.2
32,17,Lincoln,2019,2118,2034,84,4.0
32,19,Lyon,2019,23519,22393,1126,4.8
32,21,Mineral,2019,2068,1986,82,4.0
32,23,Nye,2019,17518,16617,901,5.1
32,27,Pershing,2019,2607,2503,104,4.0
32,29,Storey,2019,2088,2010,78,3.7
32,31,Washoe,2019,259464,251077,8387,3.2
32,33,White Pine,2019,4693,4553,140,3.0
32,510,Carson City,2019,26603,25556,1047,3.9
33,1,Belknap,2019,31571,30758,813,2.6
33,3,Carroll,2019,23990,23369,621,2.6
33,5,Cheshire,2019,40704,39623,1081,2.7
33,7,Coos,2019,14716,14239,477,3.2
33,9,Grafton,2019,49587,48467,1120,2.3
33,11,Hillsborough,2019,242758,236249,6509,2.7
33,13,Merrimack,2019,83811,81879,1932,2.3
33,15,Rockingham,2019,188612,183381,5231,2.8
33,17,Strafford,2019,74513,72725,1788,2.4
33,19,Sullivan,2019,23168,22626,542,2.3
34,1,Atlantic,2019,121729,115811,5918,4.9
34,3,Bergen,2019,484575,470940,13635,2.8
34,5,Burlington,2019,232247,224918,7329,3.2
34,7,Camden,2019,254506,244570,9936,3.9
34,9,Cape May,2019,46054,42868,3186,6.9
34,11,Cumberland,2019,65506,62056,3450,5.3
34,13,Essex,2019,372073,356132,15941,4.3
34,15,Gloucester,2019,150912,145571,5341,3.5
34,17,Hudson,2019,362822,351387,11435,3.2
34,19,Hunterdon,2019,65027,63304,1723,2.6
34,21,Mercer,2019,204413,198194,6219,3.0
34,23,Middlesex,2019,440256,427054,13202,3.0
34,25,Monmouth,2019,330003,319888,10115,3.1
34,27,Morris,2019,258190,251185,7005,2.7
34,29,Ocean,2019,279686,269814,9872,3.5
34,31,Passaic,2019,243830,233697,10133,4.2
34,33,Salem,2019,29355,27991,1364,4.6
34,35,Somerset,2019,172036,167057,4979,2.9
34,37,Sussex,2019,74565,72105,2460,3.3
34,39,Union,2019,278363,268496,9867,3.5
34,41,Warren,2019,56029,54212,1817,3.2
35,1,Bernalillo,2019,335633,320206,15427,4.6
35,3,Catron,2019,1143,1069,74,6.5
35,5,Chaves,2019,27495,26114,1381,5.0
35,6,Cibola,2019,9049,8464,585,6.5
35,7,Colfax,2019,5538,5272,266,4.8
35,9,Curry,2019,21785,20858,927,4.3
35,11,De Baca,2019,795,760,35,4.4
35,13,Dona Ana,2019,98591,92799,5792,5.9
35,15,Eddy,2019,34703,33593,1110,3.2
35,17,Grant,2019,12289,11683,606,4.9
35,19,Guadalupe,2019,1575,1490,85,5.4
35,21,Harding,2019,270,257,13,4.8
35,23,Hidalgo,2019,2099,2007,92,4.4
35,25,Lea,2019,31433,30138,1295,4.1
35,27,Lincoln,2019,9059,8629,430,4.7
35,28,Los Alamos,2019,9618,9302,316,3.3
35,29,Luna,2019,10446,9139,1307,12.5
35,31,McKinley,2019,24364,22605,1759,7.2
35,33,Mora,2019,2231,2093,138,6.2
35,35,Otero,2019,25047,23768,1279,5.1
35,37,Quay,2019,3236,3062,174,5.4
35,39,Rio Arriba,2019,16860,15941,919,5.5
35,41,Roosevelt,2019,7907,7543,364,4.6
35,43,Sandoval,2019,67492,64133,3359,5.0
35,45,San Juan,2019,52301,49222,3079,5.9
35,47,San Miguel,2019,10845,10199,646,6.0
35,49,Santa Fe,2019,74198,71109,3089,4.2
35,51,Sierra,2019,3943,3672,271,6.9
35,53,Socorro,2019,6493,6103,390,6.0
35,55,Taos,2019,15301,14353,948,6.2
35,57,Torrance,2019,5688,5292,396,7.0
35,59,Union,2019,1867,1801,66,3.5
35,61,Valencia,2019,30945,29250,1695,5.5
36,1,Albany,2019,156887,151417,5470,3.5
36,3,Allegany,2019,19188,18176,1012,5.3
36,5,Bronx,2019,596168,564818,31350,5.3
36,7,Broome,2019,83160,79389,3771,4.5
36,9,Cattaraugus,2019,33593,31964,1629,4.8
36,11,Cayuga,2019,35747,34281,1466,4.1
36,13,Chautauqua,2019,54049,51606,2443,4.5
36,15,Chemung,2019,35052,33650,1402,4.0
36,17,Chenango,2019,21843,20910,933,4.3
36,19,Clinton,2019,36068,34557,1511,4.2
36,21,Columbia,2019,31041,30086,955,3.1
36,23,Cortland,2019,22836,21766,1070,4.7
36,25,Delaware,2019,18941,18085,856,4.5
36,27,Dutchess,2019,144340,139358,4982,3.5
36,29,Erie,2019,440795,422846,17949,4.1
36,31,Essex,2019,16940,16174,766,4.5
36,33,Franklin,2019,19437,18515,922,4.7
36,35,Fulton,2019,22465,21380,1085,4.8
36,37,Genesee,2019,29631,28514,1117,3.8
36,39,Greene,2019,20162,19297,865,4.3
36,41,Hamilton,2019,2207,2081,126,5.7
36,43,Herkimer,2019,27816,26506,1310,4.7
36,45,Jefferson,2019,43737,41399,2338,5.3
36,47,Kings,2019,1196433,1148750,47683,4.0
36,49,Lewis,2019,11540,10926,614,5.3
36,51,Livingston,2019,30584,29339,1245,4.1
36,53,Madison,2019,32765,31355,1410,4.3
36,55,Monroe,2019,360928,346547,14381,4.0
36,57,Montgomery,2019,22185,21103,1082,4.9
36,59,Nassau,2019,708259,684992,23267,3.3
36,61,New York,2019,918438,886994,31444,3.4
36,63,Niagara,2019,98222,93554,4668,4.8
36,65,Oneida,2019,101213,97070,4143,4.1
36,67,Onondaga,2019,219487,211207,8280,3.8
36,69,Ontario,2019,55334,53276,2058,3.7
36,71,Orange,2019,186523,179768,6755,3.6
36,73,Orleans,2019,17459,16668,791,4.5
36,75,Oswego,2019,52479,49738,2741,5.2
36,77,Otsego,2019,27820,26687,1133,4.1
36,79,Putnam,2019,50954,49149,1805,3.5
36,81,Queens,2019,1135501,1096976,38525,3.4
36,83,Rensselaer,2019,80862,77940,2922,3.6
36,85,Richmond,2019,223957,215509,8448,3.8
36,87,Rockland,2019,155400,150107,5293,3.4
36,89,St. Lawrence,2019,42939,40645,2294,5.3
36,91,Saratoga,2019,118996,115147,3849,3.2
36,93,Schenectady,2019,76131,73332,2799,3.7
36,95,Schoharie,2019,14611,13959,652,4.5
36,97,Schuyler,2019,8041,7683,358,4.5
36,99,Seneca,2019,15901,15316,585,3.7
36,101,Steuben,2019,42364,40505,1859,4.4
36,103,Suffolk,2019,776768,749233,27535,3.5
36,105,Sullivan,2019,36480,35097,1383,3.8
36,107,Tioga,2019,22591,21692,899,4.0
36,109,Tompkins,2019,49122,47408,1714,3.5
36,111,Ulster,2019,87506,84352,3154,3.6
36,113,Warren,2019,31081,29714,1367,4.4
36,115,Washington,2019,27787,26703,1084,3.9
36,117,Wayne,2019,43773,42087,1686,3.9
36,119,Westchester,2019,484675,467237,17438,3.6
36,121,Wyoming,2019,18044,17284,760,4.2
36,123,Yates,2019,11892,11467,425,3.6
37,1,Alamance,2019,82991,79907,3084,3.7
37,3,Alexander,2019,18091,17508,583,3.2
37,5,Alleghany,2019,4419,4216,203,4.6
37,7,Anson,2019,10791,10356,435,4.0
37,9,Ashe,2019,12958,12495,463,3.6
37,11,Avery,2019,7578,7305,273,3.6
37,13,Beaufort,2019,19683,18810,873,4.4
37,15,Bertie,2019,7861,7499,362,4.6
37,17,Bladen,2019,14663,13987,676,4.6
37,19,Brunswick,2019,54986,52177,2809,5.1
37,21,Buncombe,2019,141707,137569,4138,2.9
37,23,Burke,2019,41057,39567,1490,3.6
37,25,Cabarrus,2019,110718,106850,3868,3.5
37,27,Caldwell,2019,36641,35199,1442,3.9
37,29,Camden,2019,4739,4564,175,3.7
37,31,Carteret,2019,32314,31019,1295,4.0
37,33,Caswell,2019,9927,9495,432,4.4
37,35,Catawba,2019,79385,76615,2770,3.5
37,37,Chatham,2019,36465,35268,1197,3.3
37,39,Cherokee,2019,11295,10805,490,4.3
37,41,Chowan,2019,5585,5334,251,4.5
37,43,Clay,2019,4178,3994,184,4.4
37,45,Cleveland,2019,48989,47106,1883,3.8
37,47,Columbus,2019,22931,21831,1100,4.8
37,49,Craven,2019,41938,40287,1651,3.9
37,51,Cumberland,2019,128825,122423,6402,5.0
37,53,Currituck,2019,14426,13927,499,3.5
37,55,Dare,2019,20207,19283,924,4.6
37,57,Davidson,2019,81637,78723,2914,3.6
37,59,Davie,2019,20776,20090,686,3.3
37,61,Duplin,2019,25557,24561,996,3.9
37,63,Durham,2019,174573,168779,5794,3.3
37,65,Edgecombe,2019,21091,19873,1218,5.8
37,67,Forsyth,2019,190021,183105,6916,3.6
37,69,Franklin,2019,31749,30498,1251,3.9
37,71,Gaston,2019,110926,106717,4209,3.8
37,73,Gates,2019,5338,5130,208,3.9
37,75,Graham,2019,3255,3085,170,5.2
37,77,Granville,2019,30426,29429,997,3.3
37,79,Greene,2019,9650,9302,348,3.6
37,81,Guilford,2019,264755,254165,10590,4.0
37,83,Halifax,2019,20545,19414,1131,5.5
37,85,Harnett,2019,53744,51333,2411,4.5
37,87,Haywood,2019,30149,29152,997,3.3
37,89,Henderson,2019,55467,53682,1785,3.2
37,91,Hertford,2019,9273,8811,462,5.0
37,93,Hoke,2019,20281,19305,976,4.8
37,95,Hyde,2019,1934,1772,162,8.4
37,97,Iredell,2019,90393,87204,3189,3.5
37,99,Jackson,2019,20085,19273,812,4.0
37,101,Johnston,2019,100706,97106,3600,3.6
37,103,Jones,2019,4344,4180,164,3.8
37,105,Lee,2019,26341,25195,1146,4.4
37,107,Lenoir,2019,28196,27163,1033,3.7
37,109,Lincoln,2019,44300,42781,1519,3.4
37,111,McDowell,2019,21039,20260,779,3.7
37,113,Macon,2019,15755,15158,597,3.8
37,115,Madison,2019,10176,9815,361,3.5
37,117,Martin,2019,9120,8678,442,4.8
37,119,Mecklenburg,2019,625637,603303,22334,3.6
37,121,Mitchell,2019,6105,5835,270,4.4
37,123,Montgomery,2019,11657,11209,448,3.8
37,125,Moore,2019,42429,40836,1593,3.8
37,127,Nash,2019,43462,41427,2035,4.7
37,129,New Hanover,2019,123739,119384,4355,3.5
37,131,Northampton,2019,7813,7424,389,5.0
37,133,Onslow,2019,64975,62059,2916,4.5
37,135,Orange,2019,80591,77968,2623,3.3
37,137,Pamlico,2019,5427,5229,198,3.6
37,139,Pasquotank,2019,16915,16159,756,4.5
37,141,Pender,2019,28974,27851,1123,3.9
37,143,Perquimans,2019,5010,4768,242,4.8
37,145,Person,2019,18521,17763,758,4.1
37,147,Pitt,2019,90233,86516,3717,4.1
37,149,Polk,2019,9170,8836,334,3.6
37,151,Randolph,2019,66535,64088,2447,3.7
37,153,Richmond,2019,16789,15939,850,5.1
37,155,Robeson,2019,50631,48009,2622,5.2
37,157,Rockingham,2019,40351,38623,1728,4.3
37,159,Rowan,2019,66041,63436,2605,3.9
37,161,Rutherford,2019,25447,24239,1208,4.7
37,163,Sampson,2019,29628,28537,1091,3.7
37,165,Scotland,2019,11582,10842,740,6.4
37,167,Stanly,2019,30569,29470,1099,3.6
37,169,Stokes,2019,21836,21074,762,3.5
37,171,Surry,2019,34232,33025,1207,3.5
37,173,Swain,2019,7089,6816,273,3.9
37,175,Transylvania,2019,14801,14268,533,3.6
37,177,Tyrrell,2019,1434,1350,84,5.9
37,179,Union,2019,124867,120622,4245,3.4
37,181,Vance,2019,17501,16521,980,5.6
37,183,Wake,2019,596307,576542,19765,3.3
37,185,Warren,2019,6619,6253,366,5.5
37,187,Washington,2019,4501,4249,252,5.6
37,189,Watauga,2019,29702,28698,1004,3.4
37,191,Wayne,2019,52278,50186,2092,4.0
37,193,Wilkes,2019,29566,28413,1153,3.9
37,195,Wilson,2019,35235,33267,1968,5.6
37,197,Yadkin,2019,17853,17256,597,3.3
37,199,Yancey,2019,8500,8191,309,3.6
38,1,Adams,2019,1047,1025,22,2.1
38,3,Barnes,2019,5197,5042,155,3.0
38,5,Benson,2019,2295,2201,94,4.1
38,7,Billings,2019,440,429,11,2.5
38,9,Bottineau,2019,2964,2868,96,3.2
38,11,Bowman,2019,1717,1689,28,1.6
38,13,Burke,2019,1068,1044,24,2.2
38,15,Burleigh,2019,49895,48718,1177,2.4
38,17,Cass,2019,103932,101865,2067,2.0
38,19,Cavalier,2019,1893,1842,51,2.7
38,21,Dickey,2019,2312,2269,43,1.9
38,23,Divide,2019,1458,1438,20,1.4
38,25,Dunn,2019,3229,3178,51,1.6
38,27,Eddy,2019,1223,1170,53,4.3
38,29,Emmons,2019,1438,1380,58,4.0
38,31,Foster,2019,1518,1477,41,2.7
38,33,Golden Valley,2019,841,826,15,1.8
38,35,Grand Forks,2019,37531,36773,758,2.0
38,37,Grant,2019,1183,1157,26,2.2
38,39,Griggs,2019,1028,1003,25,2.4
38,41,Hettinger,2019,1383,1357,26,1.9
38,43,Kidder,2019,1270,1220,50,3.9
38,45,LaMoure,2019,2062,2020,42,2.0
38,47,Logan,2019,862,843,19,2.2
38,49,McHenry,2019,3071,2966,105,3.4
38,51,McIntosh,2019,1107,1074,33,3.0
38,53,McKenzie,2019,10468,10302,166,1.6
38,55,McLean,2019,4721,4575,146,3.1
38,57,Mercer,2019,3639,3491,148,4.1
38,59,Morton,2019,16496,16019,477,2.9
38,61,Mountrail,2019,7423,7322,101,1.4
38,63,Nelson,2019,1389,1347,42,3.0
38,65,Oliver,2019,873,841,32,3.7
38,67,Pembina,2019,3335,3223,112,3.4
38,69,Pierce,2019,1719,1665,54,3.1
38,71,Ramsey,2019,5658,5496,162,2.9
38,73,Ransom,2019,2823,2775,48,1.7
38,75,Renville,2019,1211,1182,29,2.4
38,77,Richland,2019,8654,8455,199,2.3
38,79,Rolette,2019,4622,4249,373,8.1
38,81,Sargent,2019,2686,2639,47,1.7
38,83,Sheridan,2019,674,645,29,4.3
38,85,Sioux,2019,1210,1164,46,3.8
38,87,Slope,2019,393,384,9,2.3
38,89,Stark,2019,18791,18417,374,2.0
38,91,Steele,2019,984,964,20,2.0
38,93,Stutsman,2019,10396,10163,233,2.2
38,95,Towner,2019,1145,1114,31,2.7
38,97,Traill,2019,4414,4300,114,2.6
38,99,Walsh,2019,5173,5007,166,3.2
38,101,Ward,2019,31929,31155,774,2.4
38,103,Wells,2019,1894,1837,57,3.0
38,105,Williams,2019,24800,24354,446,1.8
39,1,Adams,2019,10853,10107,746,6.9
39,3,Allen,2019,48099,46140,1959,4.1
39,5,Ashland,2019,26936,25809,1127,4.2
39,7,Ashtabula,2019,44731,42575,2156,4.8
39,9,Athens,2019,28013,26528,1485,5.3
39,11,Auglaize,2019,25073,24313,760,3.0
39,13,Belmont,2019,30124,28417,1707,5.7
39,15,Brown,2019,19619,18633,986,5.0
39,17,Butler,2019,196475,188984,7491,3.8
39,19,Carroll,2019,12980,12331,649,5.0
39,21,Champaign,2019,20160,19406,754,3.7
39,23,Clark,2019,63632,60867,2765,4.3
39,25,Clermont,2019,107879,103812,4067,3.8
39,27,Clinton,2019,17785,16941,844,4.7
39,29,Columbiana,2019,47652,45336,2316,4.9
39,31,Coshocton,2019,14452,13598,854,5.9
39,33,Crawford,2019,18350,17486,864,4.7
39,35,Cuyahoga,2019,617183,590862,26321,4.3
39,37,Darke,2019,25921,24962,959,3.7
39,39,Defiance,2019,18139,17362,777,4.3
39,41,Delaware,2019,112702,109119,3583,3.2
39,43,Erie,2019,37543,35677,1866,5.0
39,45,Fairfield,2019,78926,75955,2971,3.8
39,47,Fayette,2019,13949,13403,546,3.9
39,49,Franklin,2019,701103,676089,25014,3.6
39,51,Fulton,2019,22564,21623,941,4.2
39,53,Gallia,2019,12288,11619,669,5.4
39,55,Geauga,2019,49637,47875,1762,3.5
39,57,Greene,2019,84010,80834,3176,3.8
39,59,Guernsey,2019,18711,17680,1031,5.5
39,61,Hamilton,2019,418668,402626,16042,3.8
39,63,Hancock,2019,42122,40776,1346,3.2
39,65,Hardin,2019,13977,13388,589,4.2
39,67,Harrison,2019,6859,6496,363,5.3
39,69,Henry,2019,13244,12625,619,4.7
39,71,Highland,2019,17167,16269,898,5.2
39,73,Hocking,2019,13035,12427,608,4.7
39,75,Holmes,2019,20944,20309,635,3.0
39,77,Huron,2019,28136,26505,1631,5.8
39,79,Jackson,2019,12821,12021,800,6.2
39,81,Jefferson,2019,27967,26324,1643,5.9
39,83,Knox,2019,31743,30473,1270,4.0
39,85,Lake,2019,127950,123124,4826,3.8
39,87,Lawrence,2019,23974,22728,1246,5.2
39,89,Licking,2019,91103,87674,3429,3.8
39,91,Logan,2019,22966,22122,844,3.7
39,93,Lorain,2019,156117,149305,6812,4.4
39,95,Lucas,2019,211263,201347,9916,4.7
39,97,Madison,2019,20961,20231,730,3.5
39,99,Mahoning,2019,103802,97807,5995,5.8
39,101,Marion,2019,28664,27497,1167,4.1
39,103,Medina,2019,99285,95823,3462,3.5
39,105,Meigs,2019,9171,8534,637,6.9
39,107,Mercer,2019,23556,22937,619,2.6
39,109,Miami,2019,54699,52665,2034,3.7
39,111,Monroe,2019,5374,4927,447,8.3
39,113,Montgomery,2019,253146,242410,10736,4.2
39,115,Morgan,2019,6764,6324,440,6.5
39,117,Morrow,2019,16924,16219,705,4.2
39,119,Muskingum,2019,39908,37939,1969,4.9
39,121,Noble,2019,4745,4414,331,7.0
39,123,Ottawa,2019,21142,19932,1210,5.7
39,125,Paulding,2019,8676,8341,335,3.9
39,127,Perry,2019,15963,15124,839,5.3
39,129,Pickaway,2019,26634,25559,1075,4.0
39,131,Pike,2019,10858,10181,677,6.2
39,133,Portage,2019,87755,84014,3741,4.3
39,135,Preble,2019,21268,20462,806,3.8
39,137,Putnam,2019,18925,18334,591,3.1
39,139,Richland,2019,52656,50255,2401,4.6
39,141,Ross,2019,35478,33975,1503,4.2
39,143,Sandusky,2019,30740,29407,1333,4.3
39,145,Scioto,2019,29088,27253,1835,6.3
39,147,Seneca,2019,27575,26425,1150,4.2
39,149,Shelby,2019,24303,23437,866,3.6
39,151,Stark,2019,186709,178207,8502,4.6
39,153,Summit,2019,274027,262228,11799,4.3
39,155,Trumbull,2019,87430,82037,5393,6.2
39,157,Tuscarawas,2019,45142,43180,1962,4.3
39,159,Union,2019,29554,28596,958,3.2
39,161,Van Wert,2019,15095,14600,495,3.3
39,163,Vinton,2019,5600,5282,318,5.7
39,165,Warren,2019,121033,116749,4284,3.5
39,167,Washington,2019,27573,26083,1490,5.4
39,169,Wayne,2019,62425,60382,2043,3.3
39,171,Williams,2019,19134,18494,640,3.3
39,173,Wood,2019,71829,69182,2647,3.7
39,175,Wyandot,2019,13105,12693,412,3.1
40,1,Adair,2019,8094,7779,315,3.9
40,3,Alfalfa,2019,2795,2742,53,1.9
40,5,Atoka,2019,4910,4709,201,4.1
40,7,Beaver,2019,2869,2814,55,1.9
40,9,Beckham,2019,10470,10158,312,3.0
40,11,Blaine,2019,4734,4645,89,1.9
40,13,Bryan,2019,21427,20810,617,2.9
40,15,Caddo,2019,11806,11410,396,3.4
40,17,Canadian,2019,75859,73828,2031,2.7
40,19,Carter,2019,21466,20770,696,3.2
40,21,Cherokee,2019,18773,18069,704,3.8
40,23,Choctaw,2019,5423,5175,248,4.6
40,25,Cimarron,2019,1326,1304,22,1.7
40,27,Cleveland,2019,143335,139496,3839,2.7
40,29,Coal,2019,2453,2362,91,3.7
40,31,Comanche,2019,48109,46451,1658,3.4
40,33,Cotton,2019,2659,2579,80,3.0
40,35,Craig,2019,5916,5718,198,3.3
40,37,Creek,2019,31530,30426,1104,3.5
40,39,Custer,2019,15608,15234,374,2.4
40,41,Delaware,2019,18113,17465,648,3.6
40,43,Dewey,2019,2895,2837,58,2.0
40,45,Ellis,2019,2135,2085,50,2.3
40,47,Garfield,2019,27068,26300,768,2.8
40,49,Garvin,2019,12576,12201,375,3.0
40,51,Grady,2019,26490,25716,774,2.9
40,53,Grant,2019,2660,2607,53,2.0
40,55,Greer,2019,1824,1751,73,4.0
40,57,Harmon,2019,1178,1146,32,2.7
40,59,Harper,2019,1728,1681,47,2.7
40,61,Haskell,2019,4226,4016,210,5.0
40,63,Hughes,2019,5321,5077,244,4.6
40,65,Jackson,2019,10644,10352,292,2.7
40,67,Jefferson,2019,2491,2415,76,3.1
40,69,Johnston,2019,3754,3601,153,4.1
40,71,Kay,2019,18268,17536,732,4.0
40,73,Kingfisher,2019,9094,8918,176,1.9
40,75,Kiowa,2019,3430,3308,122,3.6
40,77,Latimer,2019,3118,2933,185,5.9
40,79,Le Flore,2019,18996,18156,840,4.4
40,81,Lincoln,2019,15685,15159,526,3.4
40,83,Logan,2019,22315,21709,606,2.7
40,85,Love,2019,6172,6040,132,2.1
40,87,McClain,2019,19784,19273,511,2.6
40,89,McCurtain,2019,14388,13618,770,5.4
40,91,McIntosh,2019,7086,6697,389,5.5
40,93,Major,2019,3861,3783,78,2.0
40,95,Marshall,2019,6892,6666,226,3.3
40,97,Mayes,2019,19387,18817,570,2.9
40,99,Murray,2019,6315,6136,179,2.8
40,101,Muskogee,2019,29576,28496,1080,3.7
40,103,Noble,2019,5663,5534,129,2.3
40,105,Nowata,2019,4563,4415,148,3.2
40,107,Okfuskee,2019,4599,4401,198,4.3
40,109,Oklahoma,2019,385238,373758,11480,3.0
40,111,Okmulgee,2019,15721,14994,727,4.6
40,113,Osage,2019,20637,19900,737,3.6
40,115,Ottawa,2019,14216,13767,449,3.2
40,117,Pawnee,2019,7341,7068,273,3.7
40,119,Payne,2019,38114,37082,1032,2.7
40,121,Pittsburg,2019,17166,16490,676,3.9
40,123,Pontotoc,2019,18943,18381,562,3.0
40,125,Pottawatomie,2019,32367,31266,1101,3.4
40,127,Pushmataha,2019,4275,4076,199,4.7
40,129,Roger Mills,2019,1854,1802,52,2.8
40,131,Rogers,2019,45291,43980,1311,2.9
40,133,Seminole,2019,9419,8992,427,4.5
40,135,Sequoyah,2019,16326,15700,626,3.8
40,137,Stephens,2019,18567,17816,751,4.0
40,139,Texas,2019,11208,11006,202,1.8
40,141,Tillman,2019,2996,2892,104,3.5
40,143,Tulsa,2019,324588,314893,9695,3.0
40,145,Wagoner,2019,38475,37343,1132,2.9
40,147,Washington,2019,22340,21620,720,3.2
40,149,Washita,2019,5158,4995,163,3.2
40,151,Woods,2019,4594,4506,88,1.9
40,153,Woodward,2019,8972,8727,245,2.7
41,1,Baker,2019,7150,6827,323,4.5
41,3,Benton,2019,47696,46281,1415,3.0
41,5,Clackamas,2019,219631,212283,7348,3.3
41,7,Clatsop,2019,19411,18693,718,3.7
41,9,Columbia,2019,24332,23252,1080,4.4
41,11,Coos,2019,26265,25009,1256,4.8
41,13,Crook,2019,9863,9359,504,5.1
41,15,Curry,2019,8906,8451,455,5.1
41,17,Deschutes,2019,96470,92745,3725,3.9
41,19,Douglas,2019,46698,44456,2242,4.8
41,21,Gilliam,2019,947,913,34,3.6
41,23,Grant,2019,3193,2978,215,6.7
41,25,Harney,2019,3585,3399,186,5.2
41,27,Hood River,2019,14472,14021,451,3.1
41,29,Jackson,2019,104005,99563,4442,4.3
41,31,Jefferson,2019,10174,9667,507,5.0
41,33,Josephine,2019,35874,34123,1751,4.9
41,35,Klamath,2019,29493,27713,1780,6.0
41,37,Lake,2019,3626,3434,192,5.3
41,39,Lane,2019,181067,173840,7227,4.0
41,41,Lincoln,2019,20878,19986,892,4.3
41,43,Linn,2019,58841,56328,2513,4.3
41,45,Malheur,2019,12339,11840,499,4.0
41,47,Marion,2019,162391,156103,6288,3.9
41,49,Morrow,2019,5774,5541,233,4.0
41,51,Multnomah,2019,453933,439230,14703,3.2
41,53,Polk,2019,40247,38642,1605,4.0
41,55,Sherman,2019,930,898,32,3.4
41,57,Tillamook,2019,11920,11465,455,3.8
41,59,Umatilla,2019,36800,35058,1742,4.7
41,61,Union,2019,12020,11450,570,4.7
41,63,Wallowa,2019,3439,3243,196,5.7
41,65,Wasco,2019,13431,12888,543,4.0
41,67,Washington,2019,325772,315863,9909,3.0
41,69,Wheeler,2019,713,683,30,4.2
41,71,Yamhill,2019,54664,52829,1835,3.4
42,1,Adams,2019,55420,53560,1860,3.4
42,3,Allegheny,2019,650065,622714,27351,4.2
42,5,Armstrong,2019,32132,30466,1666,5.2
42,7,Beaver,2019,83973,80086,3887,4.6
42,9,Bedford,2019,23575,22442,1133,4.8
42,11,Berks,2019,215799,206204,9595,4.4
42,13,Blair,2019,59701,56957,2744,4.6
42,15,Bradford,2019,28766,27484,1282,4.5
42,17,Bucks,2019,345234,331721,13513,3.9
42,19,Butler,2019,100192,96209,3983,4.0
42,21,Cambria,2019,57942,54792,3150,5.4
42,23,Cameron,2019,2095,1968,127,6.1
42,25,Carbon,2019,32203,30430,1773,5.5
42,27,Centre,2019,80044,77307,2737,3.4
42,29,Chester,2019,287955,278597,9358,3.2
42,31,Clarion,2019,17103,16249,854,5.0
42,33,Clearfield,2019,35991,34080,1911,5.3
42,35,Clinton,2019,18320,17306,1014,5.5
42,37,Columbia,2019,33509,31881,1628,4.9
42,39,Crawford,2019,38656,36790,1866,4.8
42,41,Cumberland,2019,132897,128321,4576,3.4
42,43,Dauphin,2019,144659,138690,5969,4.1
42,45,Delaware,2019,300134,287722,12412,4.1
42,47,Elk,2019,15672,14896,776,5.0
42,49,Erie,2019,129087,123080,6007,4.7
42,51,Fayette,2019,56931,53463,3468,6.1
42,53,Forest,2019,1815,1688,127,7.0
42,55,Franklin,2019,77764,74714,3050,3.9
42,57,Fulton,2019,7877,7523,354,4.5
42,59,Greene,2019,16635,15764,871,5.2
42,61,Huntingdon,2019,19957,18755,1202,6.0
42,63,Indiana,2019,39104,37090,2014,5.2
42,65,Jefferson,2019,20578,19584,994,4.8
42,67,Juniata,2019,12620,12050,570,4.5
42,69,Lackawanna,2019,105266,100005,5261,5.0
42,71,Lancaster,2019,285560,275504,10056,3.5
42,73,Lawrence,2019,40744,38615,2129,5.2
42,75,Lebanon,2019,72430,69542,2888,4.0
42,77,Lehigh,2019,193827,184886,8941,4.6
42,79,Luzerne,2019,158500,149330,9170,5.8
42,81,Lycoming,2019,56997,54191,2806,4.9
42,83,McKean,2019,17348,16413,935,5.4
42,85,Mercer,2019,49073,46627,2446,5.0
42,87,Mifflin,2019,21071,20068,1003,4.8
42,89,Monroe,2019,83436,78856,4580,5.5
42,91,Montgomery,2019,457478,441097,16381,3.6
42,93,Montour,2019,9172,8837,335,3.7
42,95,Northampton,2019,161942,154559,7383,4.6
42,97,Northumberland,2019,43204,40735,2469,5.7
42,99,Perry,2019,24521,23592,929,3.8
42,101,Philadelphia/city,2019,724814,683903,40911,5.6
42,103,Pike,2019,25393,23953,1440,5.7
42,105,Potter,2019,7239,6806,433,6.0
42,107,Schuylkill,2019,66610,62928,3682,5.5
42,109,Snyder,2019,20121,19004,1117,5.6
42,111,Somerset,2019,33516,31694,1822,5.4
42,113,Sullivan,2019,2658,2516,142,5.3
42,115,Susquehanna,2019,20549,19645,904,4.4
42,117,Tioga,2019,19041,18011,1030,5.4
42,119,Union,2019,19937,19121,816,4.1
42,121,Venango,2019,22421,21315,1106,4.9
42,123,Warren,2019,18964,18088,876,4.6
42,125,Washington,2019,107303,102383,4920,4.6
42,127,Wayne,2019,22509,21421,1088,4.8
42,129,Westmoreland,2019,181017,172719,8298,4.6
42,131,Wyoming,2019,13561,12887,674,5.0
42,133,York,2019,236166,226878,9288,3.9
44,1,Bristol,2019,26013,25219,794,3.1
44,3,Kent,2019,91305,88333,2972,3.3
44,5,Newport,2019,44198,42803,1395,3.2
44,7,Providence,2019,328216,315398,12818,3.9
44,9,Washington,2019,69141,66949,2192,3.2
45,1,Abbeville,2019,10020,9697,323,3.2
45,3,Aiken,2019,74901,72812,2089,2.8
45,5,Allendale,2019,2645,2509,136,5.1
45,7,Anderson,2019,90715,88350,2365,2.6
45,9,Bamberg,2019,4924,4662,262,5.3
45,11,Barnwell,2019,8136,7802,334,4.1
45,13,Beaufort,2019,77263,75268,1995,2.6
45,15,Berkeley,2019,105463,102879,2584,2.5
45,17,Calhoun,2019,6533,6308,225,3.4
45,19,Charleston,2019,210879,206178,4701,2.2
45,21,Cherokee,2019,25135,24396,739,2.9
45,23,Chester,2019,13183,12651,532,4.0
45,25,Chesterfield,2019,21969,21354,615,2.8
45,27,Clarendon,2019,12633,12162,471,3.7
45,29,Colleton,2019,16741,16229,512,3.1
45,31,Darlington,2019,30284,29291,993,3.3
45,33,Dillon,2019,12909,12398,511,4.0
45,35,Dorchester,2019,77887,76013,1874,2.4
45,37,Edgefield,2019,10714,10424,290,2.7
45,39,Fairfield,2019,9472,9064,408,4.3
45,41,Florence,2019,66860,64974,1886,2.8
45,43,Georgetown,2019,25679,24747,932,3.6
45,45,Greenville,2019,255462,249454,6008,2.4
45,47,Greenwood,2019,31333,30403,930,3.0
45,49,Hampton,2019,8350,8134,216,2.6
45,51,Horry,2019,147445,142249,5196,3.5
45,53,Jasper,2019,12842,12526,316,2.5
45,55,Kershaw,2019,29339,28507,832,2.8
45,57,Lancaster,2019,41661,40312,1349,3.2
45,59,Laurens,2019,29938,29078,860,2.9
45,61,Lee,2019,6555,6304,251,3.8
45,63,Lexington,2019,150164,146785,3379,2.3
45,65,McCormick,2019,3371,3271,100,3.0
45,67,Marion,2019,12926,12387,539,4.2
45,69,Marlboro,2019,9091,8671,420,4.6
45,71,Newberry,2019,19052,18563,489,2.6
45,73,Oconee,2019,34824,33889,935,2.7
45,75,Orangeburg,2019,34538,32964,1574,4.6
45,77,Pickens,2019,57436,55873,1563,2.7
45,79,Richland,2019,196983,191692,5291,2.7
45,81,Saluda,2019,8784,8559,225,2.6
45,83,Spartanburg,2019,154621,150828,3793,2.5
45,85,Sumter,2019,43331,41923,1408,3.2
45,87,Union,2019,11506,11120,386,3.4
45,89,Williamsburg,2019,11995,11469,526,4.4
45,91,York,2019,141202,137449,3753,2.7
46,3,Aurora,2019,1511,1473,38,2.5
46,5,Beadle,2019,9561,9290,271,2.8
46,7,Bennett,2019,1075,1022,53,4.9
46,9,Bon Homme,2019,2855,2775,80,2.8
46,11,Brookings,2019,19047,18484,563,3.0
46,13,Brown,2019,20699,20122,577,2.8
46,15,Brule,2019,2441,2371,70,2.9
46,17,Buffalo,2019,671,631,40,6.0
46,19,Butte,2019,5053,4897,156,3.1
46,21,Campbell,2019,768,743,25,3.3
46,23,Charles Mix,2019,3749,3622,127,3.4
46,25,Clark,2019,1903,1833,70,3.7
46,27,Clay,2019,7414,7190,224,3.0
46,29,Codington,2019,15495,15051,444,2.9
46,31,Corson,2019,1349,1278,71,5.3
46,33,Custer,2019,4069,3904,165,4.1
46,35,Davison,2019,11045,10752,293,2.7
46,37,Day,2019,2732,2618,114,4.2
46,39,Deuel,2019,2173,2077,96,4.4
46,41,Dewey,2019,2211,2044,167,7.6
46,43,Douglas,2019,1569,1528,41,2.6
46,45,Edmunds,2019,2031,1975,56,2.8
46,47,Fall River,2019,2979,2864,115,3.9
46,49,Faulk,2019,1051,1020,31,2.9
46,51,Grant,2019,4412,4277,135,3.1
46,53,Gregory,2019,2028,1964,64,3.2
46,55,Haakon,2019,1048,1019,29,2.8
46,57,Hamlin,2019,3312,3213,99,3.0
46,59,Hand,2019,1768,1724,44,2.5
46,61,Hanson,2019,1775,1699,76,4.3
46,63,Harding,2019,737,718,19,2.6
46,65,Hughes,2019,9955,9714,241,2.4
46,67,Hutchinson,2019,3584,3484,100,2.8
46,69,Hyde,2019,686,665,21,3.1
46,71,Jackson,2019,1270,1205,65,5.1
46,73,Jerauld,2019,1117,1089,28,2.5
46,75,Jones,2019,538,523,15,2.8
46,77,Kingsbury,2019,2666,2592,74,2.8
46,79,Lake,2019,6632,6417,215,3.2
46,81,Lawrence,2019,13369,12981,388,2.9
46,83,Lincoln,2019,35633,34806,827,2.3
46,85,Lyman,2019,1677,1604,73,4.4
46,87,McCook,2019,3077,2996,81,2.6
46,89,McPherson,2019,996,957,39,3.9
46,91,Marshall,2019,2355,2274,81,3.4
46,93,Meade,2019,13951,13492,459,3.3
46,95,Mellette,2019,741,702,39,5.3
46,97,Miner,2019,1172,1139,33,2.8
46,99,Minnehaha,2019,112198,109256,2942,2.6
46,101,Moody,2019,4038,3906,132,3.3
46,102,Oglala Lakota,2019,3536,3223,313,8.9
46,103,Pennington,2019,56923,55157,1766,3.1
46,105,Perkins,2019,1413,1373,40,2.8
46,107,Potter,2019,1031,1002,29,2.8
46,109,Roberts,2019,4816,4628,188,3.9
46,111,Sanborn,2019,1135,1104,31,2.7
46,115,Spink,2019,3165,3067,98,3.1
46,117,Stanley,2019,1894,1843,51,2.7
46,119,Sully,2019,799,778,21,2.6
46,121,Todd,2019,3146,2960,186,5.9
46,123,Tripp,2019,3061,2981,80,2.6
46,125,Turner,2019,4645,4515,130,2.8
46,127,Union,2019,8607,8342,265,3.1
46,129,Walworth,2019,2103,1999,104,4.9
46,135,Yankton,2019,11898,11589,309,2.6
46,137,Ziebach,2019,931,884,47,5.0
47,1,Anderson,2019,34695,33468,1227,3.5
47,3,Bedford,2019,21082,20297,785,3.7
47,5,Benton,2019,6904,6598,306,4.4
47,7,Bledsoe,2019,4323,4088,235,5.4
47,9,Blount,2019,64072,62043,2029,3.2
47,11,Bradley,2019,52426,50628,1798,3.4
47,13,Campbell,2019,14869,14190,679,4.6
47,15,Cannon,2019,6653,6450,203,3.1
47,17,Carroll,2019,12018,11441,577,4.8
47,19,Carter,2019,24090,23119,971,4.0
47,21,Cheatham,2019,21882,21308,574,2.6
47,23,Chester,2019,8596,8303,293,3.4
47,25,Claiborne,2019,13103,12555,548,4.2
47,27,Clay,2019,2784,2619,165,5.9
47,29,Cocke,2019,15024,14343,681,4.5
47,31,Coffee,2019,25665,24813,852,3.3
47,33,Crockett,2019,6975,6734,241,3.5
47,35,Cumberland,2019,23438,22381,1057,4.5
47,37,Davidson,2019,402736,392552,10184,2.5
47,39,Decatur,2019,4550,4307,243,5.3
47,41,DeKalb,2019,7792,7453,339,4.4
47,43,Dickson,2019,27132,26318,814,3.0
47,45,Dyer,2019,16413,15619,794,4.8
47,47,Fayette,2019,19533,18828,705,3.6
47,49,Fentress,2019,7510,7195,315,4.2
47,51,Franklin,2019,20218,19542,676,3.3
47,53,Gibson,2019,22014,21083,931,4.2
47,55,Giles,2019,15035,14463,572,3.8
47,57,Grainger,2019,9550,9165,385,4.0
47,59,Greene,2019,29828,28451,1377,4.6
47,61,Grundy,2019,5009,4802,207,4.1
47,63,Hamblen,2019,28171,27090,1081,3.8
47,65,Hamilton,2019,185057,179097,5960,3.2
47,67,Hancock,2019,2125,2001,124,5.8
47,69,Hardeman,2019,9485,9015,470,5.0
47,71,Hardin,2019,10368,9927,441,4.3
47,73,Hawkins,2019,23903,22924,979,4.1
47,75,Haywood,2019,7714,7343,371,4.8
47,77,Henderson,2019,12207,11674,533,4.4
47,79,Henry,2019,14170,13584,586,4.1
47,81,Hickman,2019,11425,11076,349,3.1
47,83,Houston,2019,3275,3126,149,4.5
47,85,Humphreys,2019,8958,8616,342,3.8
47,87,Jackson,2019,4670,4456,214,4.6
47,89,Jefferson,2019,24694,23785,909,3.7
47,91,Johnson,2019,7729,7462,267,3.5
47,93,Knox,2019,245480,238396,7084,2.9
47,95,Lake,2019,1729,1635,94,5.4
47,97,Lauderdale,2019,9723,9199,524,5.4
47,99,Lawrence,2019,19195,18410,785,4.1
47,101,Lewis,2019,5204,4995,209,4.0
47,103,Lincoln,2019,16803,16202,601,3.6
47,105,Loudon,2019,23819,23017,802,3.4
47,107,McMinn,2019,23572,22683,889,3.8
47,109,McNairy,2019,8457,8011,446,5.3
47,111,Macon,2019,11370,11018,352,3.1
47,113,Madison,2019,49376,47635,1741,3.5
47,115,Marion,2019,12596,12061,535,4.2
47,117,Marshall,2019,15766,15211,555,3.5
47,119,Maury,2019,50244,48658,1586,3.2
47,121,Meigs,2019,5195,4960,235,4.5
47,123,Monroe,2019,20297,19563,734,3.6
47,125,Montgomery,2019,86537,83283,3254,3.8
47,127,Moore,2019,3623,3518,105,2.9
47,129,Morgan,2019,7786,7467,319,4.1
47,131,Obion,2019,12476,11870,606,4.9
47,133,Overton,2019,9942,9567,375,3.8
47,135,Perry,2019,3115,2960,155,5.0
47,137,Pickett,2019,2346,2237,109,4.6
47,139,Polk,2019,7446,7149,297,4.0
47,141,Putnam,2019,35134,33908,1226,3.5
47,143,Rhea,2019,13354,12599,755,5.7
47,145,Roane,2019,23402,22457,945,4.0
47,147,Robertson,2019,38227,37125,1102,2.9
47,149,Rutherford,2019,187178,182384,4794,2.6
47,151,Scott,2019,8396,8031,365,4.3
47,153,Sequatchie,2019,6240,5979,261,4.2
47,155,Sevier,2019,54962,53169,1793,3.3
47,157,Shelby,2019,447655,429816,17839,4.0
47,159,Smith,2019,9503,9218,285,3.0
47,161,Stewart,2019,5532,5286,246,4.4
47,163,Sullivan,2019,70708,68109,2599,3.7
47,165,Sumner,2019,104025,101247,2778,2.7
47,167,Tipton,2019,28281,27191,1090,3.9
47,169,Trousdale,2019,5527,5360,167,3.0
47,171,Unicoi,2019,7171,6817,354,4.9
47,173,Union,2019,7703,7392,311,4.0
47,175,Van Buren,2019,2059,1966,93,4.5
47,177,Warren,2019,16941,16253,688,4.1
47,179,Washington,2019,60905,58827,2078,3.4
47,181,Wayne,2019,6301,6011,290,4.6
47,183,Weakley,2019,16087,15443,644,4.0
47,185,White,2019,12283,11832,451,3.7
47,187,Williamson,2019,131365,128178,3187,2.4
47,189,Wilson,2019,78383,76285,2098,2.7
48,1,Anderson,2019,23466,22779,687,2.9
48,3,Andrews,2019,9911,9685,226,2.3
48,5,Angelina,2019,35760,34330,1430,4.0
48,7,Aransas,2019,9282,8885,397,4.3
48,9,Archer,2019,4008,3895,113,2.8
48,11,Armstrong,2019,930,905,25,2.7
48,13,Atascosa,2019,21740,20959,781,3.6
48,15,Austin,2019,13974,13493,481,3.4
48,17,Bailey,2019,2499,2407,92,3.7
48,19,Bandera,2019,10048,9717,331,3.3
48,21,Bastrop,2019,42689,41385,1304,3.1
48,23,Baylor,2019,1752,1712,40,2.3
48,25,Bee,2019,9823,9391,432,4.4
48,27,Bell,2019,143787,138259,5528,3.8
48,29,Bexar,2019,943335,913638,29697,3.1
48,31,Blanco,2019,6511,6352,159,2.4
48,33,Borden,2019,404,394,10,2.5
48,35,Bosque,2019,8313,8029,284,3.4
48,37,Bowie,2019,39613,37858,1755,4.4
48,39,Brazoria,2019,179690,172115,7575,4.2
48,41,Brazos,2019,118714,115510,3204,2.7
48,43,Brewster,2019,4190,4068,122,2.9
48,45,Briscoe,2019,579,558,21,3.6
48,47,Brooks,2019,2617,2484,133,5.1
48,49,Brown,2019,15665,15084,581,3.7
48,51,Burleson,2019,8279,8021,258,3.1
48,53,Burnet,2019,23586,22943,643,2.7
48,55,Caldwell,2019,19374,18715,659,3.4
48,57,Calhoun,2019,12126,11737,389,3.2
48,59,Callahan,2019,6059,5872,187,3.1
48,61,Cameron,2019,166625,157444,9181,5.5
48,63,Camp,2019,4970,4761,209,4.2
48,65,Carson,2019,2980,2903,77,2.6
48,67,Cass,2019,12375,11841,534,4.3
48,69,Castro,2019,3418,3324,94,2.8
48,71,Chambers,2019,19911,19013,898,4.5
48,73,Cherokee,2019,21007,20216,791,3.8
48,75,Childress,2019,2958,2878,80,2.7
48,77,Clay,2019,4911,4761,150,3.1
48,79,Cochran,2019,1127,1088,39,3.5
48,81,Coke,2019,1450,1403,47,3.2
48,83,Coleman,2019,2859,2743,116,4.1
48,85,Collin,2019,571831,554215,17616,3.1
48,87,Collingsworth,2019,1146,1111,35,3.1
48,89,Colorado,2019,9844,9541,303,3.1
48,91,Comal,2019,76021,73767,2254,3.0
48,93,Comanche,2019,5581,5401,180,3.2
48,95,Concho,2019,1255,1215,40,3.2
48,97,Cooke,2019,19830,19272,558,2.8
48,99,Coryell,2019,23990,23038,952,4.0
48,101,Cottle,2019,549,526,23,4.2
48,103,Crane,2019,1567,1504,63,4.0
48,105,Crockett,2019,1632,1584,48,2.9
48,107,Crosby,2019,2458,2361,97,3.9
48,109,Culberson,2019,1041,998,43,4.1
48,111,Dallam,2019,3938,3860,78,2.0
48,113,Dallas,2019,1344316,1297239,47077,3.5
48,115,Dawson,2019,4622,4442,180,3.9
48,117,Deaf Smith,2019,8434,8204,230,2.7
48,119,Delta,2019,2441,2358,83,3.4
48,121,Denton,2019,503398,488509,14889,3.0
48,123,DeWitt,2019,9739,9483,256,2.6
48,125,Dickens,2019,675,646,29,4.3
48,127,Dimmit,2019,7443,7254,189,2.5
48,129,Donley,2019,1441,1392,49,3.4
48,131,Duval,2019,4952,4732,220,4.4
48,133,Eastland,2019,8345,8068,277,3.3
48,135,Ector,2019,88315,85963,2352,2.7
48,137,Edwards,2019,1048,1024,24,2.3
48,139,Ellis,2019,94093,91180,2913,3.1
48,141,El Paso,2019,362434,348607,13827,3.8
48,143,Erath,2019,20851,20194,657,3.2
48,145,Falls,2019,6482,6270,212,3.3
48,147,Fannin,2019,17349,16873,476,2.7
48,149,Fayette,2019,12395,12070,325,2.6
48,151,Fisher,2019,1631,1583,48,2.9
48,153,Floyd,2019,2568,2456,112,4.4
48,155,Foard,2019,579,562,17,2.9
48,157,Fort Bend,2019,399949,386098,13851,3.5
48,159,Franklin,2019,4666,4497,169,3.6
48,161,Freestone,2019,6387,6081,306,4.8
48,163,Frio,2019,10433,10160,273,2.6
48,165,Gaines,2019,9877,9637,240,2.4
48,167,Galveston,2019,165860,159153,6707,4.0
48,169,Garza,2019,2136,2081,55,2.6
48,171,Gillespie,2019,13556,13226,330,2.4
48,173,Glasscock,2019,799,781,18,2.3
48,175,Goliad,2019,3268,3158,110,3.4
48,177,Gonzales,2019,9594,9336,258,2.7
48,179,Gray,2019,8046,7759,287,3.6
48,181,Grayson,2019,64272,62299,1973,3.1
48,183,Gregg,2019,58062,55891,2171,3.7
48,185,Grimes,2019,11253,10805,448,4.0
48,187,Guadalupe,2019,81793,79374,2419,3.0
48,189,Hale,2019,12184,11642,542,4.4
48,191,Hall,2019,1068,1024,44,4.1
48,193,Hamilton,2019,3679,3569,110,3.0
48,195,Hansford,2019,2767,2702,65,2.3
48,197,Hardeman,2019,1721,1669,52,3.0
48,199,Hardin,2019,25574,24410,1164,4.6
48,201,Harris,2019,2301343,2212656,88687,3.9
48,203,Harrison,2019,29429,28254,1175,4.0
48,205,Hartley,2019,2798,2752,46,1.6
48,207,Haskell,2019,2253,2180,73,3.2
48,209,Hays,2019,120848,117494,3354,2.8
48,211,Hemphill,2019,2006,1953,53,2.6
48,213,Henderson,2019,36634,35351,1283,3.5
48,215,Hidalgo,2019,351927,329880,22047,6.3
48,217,Hill,2019,16396,15851,545,3.3
48,219,Hockley,2019,11268,10936,332,2.9
48,221,Hood,2019,27751,26806,945,3.4
48,223,Hopkins,2019,17544,17007,537,3.1
48,225,Houston,2019,10280,9959,321,3.1
48,227,Howard,2019,14022,13589,433,3.1
48,229,Hudspeth,2019,1862,1781,81,4.4
48,231,Hunt,2019,43725,42164,1561,3.6
48,233,Hutchinson,2019,8665,8281,384,4.4
48,235,Irion,2019,762,744,18,2.4
48,237,Jack,2019,3469,3360,109,3.1
48,239,Jackson,2019,7529,7304,225,3.0
48,241,Jasper,2019,12827,12043,784,6.1
48,243,Jeff Davis,2019,1047,1016,31,3.0
48,245,Jefferson,2019,105902,99716,6186,5.8
48,247,Jim Hogg,2019,1881,1791,90,4.8
48,249,Jim Wells,2019,16855,16063,792,4.7
48,251,Johnson,2019,83351,80679,2672,3.2
48,253,Jones,2019,5785,5540,245,4.2
48,255,Karnes,2019,7156,6977,179,2.5
48,257,Kaufman,2019,67355,65182,2173,3.2
48,259,Kendall,2019,22658,22043,615,2.7
48,261,Kenedy,2019,231,223,8,3.5
48,263,Kent,2019,473,462,11,2.3
48,265,Kerr,2019,22243,21588,655,2.9
48,267,Kimble,2019,1855,1799,56,3.0
48,269,King,2019,235,230,5,2.1
48,271,Kinney,2019,1366,1317,49,3.6
48,273,Kleberg,2019,13484,12904,580,4.3
48,275,Knox,2019,1442,1396,46,3.2
48,277,Lamar,2019,23936,23128,808,3.4
48,279,Lamb,2019,5266,5066,200,3.8
48,281,Lampasas,2019,9112,8809,303,3.3
48,283,La Salle,2019,4388,4282,106,2.4
48,285,Lavaca,2019,8624,8369,255,3.0
48,287,Lee,2019,10126,9858,268,2.6
48,289,Leon,2019,6319,6044,275,4.4
48,291,Liberty,2019,33468,31793,1675,5.0
48,293,Limestone,2019,8604,8273,331,3.8
48,295,Lipscomb,2019,1629,1586,43,2.6
48,297,Live Oak,2019,5541,5370,171,3.1
48,299,Llano,2019,8648,8349,299,3.5
48,301,Loving,2019,504,500,4,0.8
48,303,Lubbock,2019,158157,153675,4482,2.8
48,305,Lynn,2019,2783,2700,83,3.0
48,307,McCulloch,2019,3476,3296,180,5.2
48,309,McLennan,2019,119193,115232,3961,3.3
48,311,McMullen,2019,815,802,13,1.6
48,313,Madison,2019,4535,4344,191,4.2
48,315,Marion,2019,4235,4057,178,4.2
48,317,Martin,2019,2814,2740,74,2.6
48,319,Mason,2019,1761,1705,56,3.2
48,321,Matagorda,2019,16707,15761,946,5.7
48,323,Maverick,2019,23641,21849,1792,7.6
48,325,Medina,2019,21785,21094,691,3.2
48,327,Menard,2019,865,835,30,3.5
48,329,Midland,2019,106714,104484,2230,2.1
48,331,Milam,2019,9754,9270,484,5.0
48,333,Mills,2019,1889,1828,61,3.2
48,335,Mitchell,2019,2334,2248,86,3.7
48,337,Montague,2019,9292,9025,267,2.9
48,339,Montgomery,2019,288950,279159,9791,3.4
48,341,Moore,2019,10817,10568,249,2.3
48,343,Morris,2019,4809,4554,255,5.3
48,345,Motley,2019,472,456,16,3.4
48,347,Nacogdoches,2019,28163,27117,1046,3.7
48,349,Navarro,2019,24047,23264,783,3.3
48,351,Newton,2019,5144,4820,324,6.3
48,353,Nolan,2019,7039,6832,207,2.9
48,355,Nueces,2019,166967,160110,6857,4.1
48,357,Ochiltree,2019,4302,4187,115,2.7
48,359,Oldham,2019,910,884,26,2.9
48,361,Orange,2019,36436,34561,1875,5.1
48,363,Palo Pinto,2019,13573,13146,427,3.1
48,365,Panola,2019,10118,9709,409,4.0
48,367,Parker,2019,68735,66740,1995,2.9
48,369,Parmer,2019,4868,4761,107,2.2
48,371,Pecos,2019,6374,6165,209,3.3
48,373,Polk,2019,18031,17166,865,4.8
48,375,Potter,2019,54356,52868,1488,2.7
48,377,Presidio,2019,3112,2912,200,6.4
48,379,Rains,2019,6055,5871,184,3.0
48,381,Randall,2019,73112,71362,1750,2.4
48,383,Reagan,2019,1893,1844,49,2.6
48,385,Real,2019,1061,1019,42,4.0
48,387,Red River,2019,5078,4844,234,4.6
48,389,Reeves,2019,11163,10966,197,1.8
48,391,Refugio,2019,3147,3030,117,3.7
48,393,Roberts,2019,417,405,12,2.9
48,395,Robertson,2019,7468,7198,270,3.6
48,397,Rockwall,2019,53490,51853,1637,3.1
48,399,Runnels,2019,4597,4469,128,2.8
48,401,Rusk,2019,22895,22076,819,3.6
48,403,Sabine,2019,3755,3509,246,6.6
48,405,San Augustine,2019,3373,3213,160,4.7
48,407,San Jacinto,2019,11744,11207,537,4.6
48,409,San Patricio,2019,29764,28135,1629,5.5
48,411,San Saba,2019,2533,2459,74,2.9
48,413,Schleicher,2019,1309,1272,37,2.8
48,415,Scurry,2019,6658,6443,215,3.2
48,417,Shackelford,2019,1905,1863,42,2.2
48,419,Shelby,2019,11148,10710,438,3.9
48,421,Sherman,2019,1368,1336,32,2.3
48,423,Smith,2019,108289,104682,3607,3.3
48,425,Somervell,2019,4369,4213,156,3.6
48,427,Starr,2019,25148,22664,2484,9.9
48,429,Stephens,2019,4093,3970,123,3.0
48,431,Sterling,2019,575,557,18,3.1
48,433,Stonewall,2019,583,566,17,2.9
48,435,Sutton,2019,1417,1364,53,3.7
48,437,Swisher,2019,2614,2519,95,3.6
48,439,Tarrant,2019,1079646,1043814,35832,3.3
48,441,Taylor,2019,66786,64876,1910,2.9
48,443,Terrell,2019,378,365,13,3.4
48,445,Terry,2019,4997,4815,182,3.6
48,447,Throckmorton,2019,648,624,24,3.7
48,449,Titus,2019,12934,12400,534,4.1
48,451,Tom Green,2019,54630,52981,1649,3.0
48,453,Travis,2019,737411,718128,19283,2.6
48,455,Trinity,2019,5297,5045,252,4.8
48,457,Tyler,2019,7156,6746,410,5.7
48,459,Upshur,2019,17999,17334,665,3.7
48,461,Upton,2019,1655,1606,49,3.0
48,463,Uvalde,2019,11482,11049,433,3.8
48,465,Val Verde,2019,22882,22120,762,3.3
48,467,Van Zandt,2019,26127,25276,851,3.3
48,469,Victoria,2019,42417,40948,1469,3.5
48,471,Walker,2019,24109,23163,946,3.9
48,473,Waller,2019,24164,23259,905,3.7
48,475,Ward,2019,7356,7182,174,2.4
48,477,Washington,2019,15177,14662,515,3.4
48,479,Webb,2019,118464,114077,4387,3.7
48,481,Wharton,2019,21665,20931,734,3.4
48,483,Wheeler,2019,2263,2196,67,3.0
48,485,Wichita,2019,56077,54292,1785,3.2
48,487,Wilbarger,2019,4952,4776,176,3.6
48,489,Willacy,2019,6548,6009,539,8.2
48,491,Williamson,2019,318841,309869,8972,2.8
48,493,Wilson,2019,24916,24208,708,2.8
48,495,Winkler,2019,4057,3941,116,2.9
48,497,Wise,2019,32306,31267,1039,3.2
48,499,Wood,2019,17700,17012,688,3.9
48,501,Yoakum,2019,3747,3639,108,2.9
48,503,Young,2019,7996,7760,236,3.0
48,505,Zapata,2019,5118,4860,258,5.0
48,507,Zavala,2019,3348,3066,282,8.4
49,1,Beaver,2019,2880,2795,85,3.0
49,3,Box Elder,2019,26092,25423,669,2.6
49,5,Cache,2019,64758,63398,1360,2.1
49,7,Carbon,2019,8537,8230,307,3.6
49,9,Daggett,2019,390,375,15,3.8
49,11,Davis,2019,173497,169395,4102,2.4
49,13,Duchesne,2019,7743,7448,295,3.8
49,15,Emery,2019,4308,4140,168,3.9
49,17,Garfield,2019,2773,2604,169,6.1
49,19,Grand,2019,6211,5975,236,3.8
49,21,Iron,2019,24188,23488,700,2.9
49,23,Juab,2019,5827,5685,142,2.4
49,25,Kane,2019,3830,3721,109,2.8
49,27,Millard,2019,6042,5883,159,2.6
49,29,Morgan,2019,5531,5400,131,2.4
49,31,Piute,2019,481,459,22,4.6
49,33,Rich,2019,1170,1135,35,3.0
49,35,Salt Lake,2019,633757,618281,15476,2.4
49,37,San Juan,2019,5723,5442,281,4.9
49,39,Sanpete,2019,12473,12086,387,3.1
49,41,Sevier,2019,9756,9464,292,3.0
49,43,Summit,2019,24949,24355,594,2.4
49,45,Tooele,2019,34843,33881,962,2.8
49,47,Uintah,2019,13664,13101,563,4.1
49,49,Utah,2019,308208,301005,7203,2.3
49,51,Wasatch,2019,16077,15647,430,2.7
49,53,Washington,2019,76370,74147,2223,2.9
49,55,Wayne,2019,1428,1352,76,5.3
49,57,Weber,2019,127870,124192,3678,2.9
50,1,Addison,2019,20656,20190,466,2.3
50,3,Bennington,2019,18209,17690,519,2.9
50,5,Caledonia,2019,14502,14086,416,2.9
50,7,Chittenden,2019,96971,95279,1692,1.7
50,9,Essex,2019,2685,2601,84,3.1
50,11,Franklin,2019,27571,26945,626,2.3
50,13,Grand Isle,2019,4162,4047,115,2.8
50,15,Lamoille,2019,13995,13571,424,3.0
50,17,Orange,2019,16004,15635,369,2.3
50,19,Orleans,2019,13324,12775,549,4.1
50,21,Rutland,2019,30591,29773,818,2.7
50,23,Washington,2019,34586,33822,764,2.2
50,25,Windham,2019,22059,21513,546,2.5
50,27,Windsor,2019,29069,28477,592,2.0
51,1,Accomack,2019,16686,16116,570,3.4
51,3,Albemarle,2019,58320,56939,1381,2.4
51,5,Alleghany,2019,7011,6784,227,3.2
51,7,Amelia,2019,6363,6171,192,3.0
51,9,Amherst,2019,15153,14690,463,3.1
51,11,Appomattox,2019,7263,7021,242,3.3
51,13,Arlington,2019,155298,152444,2854,1.8
51,15,Augusta,2019,37770,36884,886,2.3
51,17,Bath,2019,2489,2431,58,2.3
51,19,Bedford,2019,38964,37897,1067,2.7
51,21,Bland,2019,2858,2782,76,2.7
51,23,Botetourt,2019,17685,17255,430,2.4
51,25,Brunswick,2019,6073,5800,273,4.5
51,27,Buchanan,2019,6833,6469,364,5.3
51,29,Buckingham,2019,6561,6300,261,4.0
51,31,Campbell,2019,26205,25424,781,3.0
51,33,Caroline,2019,15288,14816,472,3.1
51,35,Carroll,2019,13361,12904,457,3.4
51,36,Charles City,2019,3689,3567,122,3.3
51,37,Charlotte,2019,5291,5112,179,3.4
51,41,Chesterfield,2019,190548,185534,5014,2.6
51,43,Clarke,2019,7713,7531,182,2.4
51,45,Craig,2019,2357,2286,71,3.0
51,47,Culpeper,2019,25164,24539,625,2.5
51,49,Cumberland,2019,4695,4559,136,2.9
51,51,Dickenson,2019,4711,4487,224,4.8
51,53,Dinwiddie,2019,13724,13292,432,3.1
51,57,Essex,2019,5539,5350,189,3.4
51,59,Fairfax,2019,639038,624958,14080,2.2
51,61,Fauquier,2019,37846,36962,884,2.3
51,63,Floyd,2019,8293,8089,204,2.5
51,65,Fluvanna,2019,14354,14038,316,2.2
51,67,Franklin,2019,26617,25868,749,2.8
51,69,Frederick,2019,48919,47782,1137,2.3
51,71,Giles,2019,7960,7712,248,3.1
51,73,Gloucester,2019,19767,19281,486,2.5
51,75,Goochland,2019,11508,11204,304,2.6
51,77,Grayson,2019,8121,7897,224,2.8
51,79,Greene,2019,10658,10419,239,2.2
51,81,Greensville,2019,4309,4169,140,3.2
51,83,Halifax,2019,15651,15062,589,3.8
51,85,Hanover,2019,59775,58387,1388,2.3
51,87,Henrico,2019,183651,178702,4949,2.7
51,89,Henry,2019,23909,23143,766,3.2
51,91,Highland,2019,1258,1226,32,2.5
51,93,Isle of Wight,2019,19710,19180,530,2.7
51,95,James City,2019,37020,36076,944,2.5
51,97,King and Queen,2019,3892,3788,104,2.7
51,99,King George,2019,13549,13202,347,2.6
51,101,King William,2019,9308,9064,244,2.6
51,103,Lancaster,2019,5434,5208,226,4.2
51,105,Lee,2019,8352,8028,324,3.9
51,107,Loudoun,2019,228192,223136,5056,2.2
51,109,Louisa,2019,20220,19700,520,2.6
51,111,Lunenburg,2019,5353,5190,163,3.0
51,113,Madison,2019,7486,7327,159,2.1
51,115,Mathews,2019,4196,4080,116,2.8
51,117,Mecklenburg,2019,12747,12258,489,3.8
51,119,Middlesex,2019,5295,5165,130,2.5
51,121,Montgomery,2019,50741,49375,1366,2.7
51,125,Nelson,2019,7593,7392,201,2.6
51,127,New Kent,2019,12919,12626,293,2.3
51,131,Northampton,2019,5475,5241,234,4.3
51,133,Northumberland,2019,5700,5464,236,4.1
51,135,Nottoway,2019,7324,7130,194,2.6
51,137,Orange,2019,17476,16974,502,2.9
51,139,Page,2019,12110,11661,449,3.7
51,141,Patrick,2019,7415,7169,246,3.3
51,143,Pittsylvania,2019,30249,29277,972,3.2
51,145,Powhatan,2019,14425,14075,350,2.4
51,147,Prince Edward,2019,10489,10111,378,3.6
51,149,Prince George,2019,15248,14758,490,3.2
51,153,Prince William,2019,248954,242881,6073,2.4
51,155,Pulaski,2019,16316,15786,530,3.2
51,157,Rappahannock,2019,3787,3696,91,2.4
51,159,Richmond,2019,4092,3975,117,2.9
51,161,Roanoke,2019,50002,48789,1213,2.4
51,163,Rockbridge,2019,10870,10587,283,2.6
51,165,Rockingham,2019,42804,41832,972,2.3
51,167,Russell,2019,11306,10853,453,4.0
51,169,Scott,2019,9161,8887,274,3.0
51,171,Shenandoah,2019,22410,21865,545,2.4
51,173,Smyth,2019,13784,13292,492,3.6
51,175,Southampton,2019,9187,8953,234,2.5
51,177,Spotsylvania,2019,68615,66700,1915,2.8
51,179,Stafford,2019,74084,72123,1961,2.6
51,181,Surry,2019,3693,3571,122,3.3
51,183,Sussex,2019,3792,3626,166,4.4
51,185,Tazewell,2019,15759,15101,658,4.2
51,187,Warren,2019,20684,20124,560,2.7
51,191,Washington,2019,26483,25633,850,3.2
51,193,Westmoreland,2019,9574,9249,325,3.4
51,195,Wise,2019,13419,12824,595,4.4
51,197,Wythe,2019,13809,13336,473,3.4
51,199,York,2019,33308,32457,851,2.6
51,510,Alexandria city,2019,101532,99457,2075,2.0
51,520,Bristol city,2019,7337,7073,264,3.6
51,530,Buena Vista city,2019,3486,3396,90,2.6
51,540,Charlottesville city,2019,26318,25720,598,2.3
51,550,Chesapeake city,2019,125020,121576,3444,2.8
51,570,Colonial Heights city,2019,8615,8346,269,3.1
51,580,Covington city,2019,2421,2326,95,3.9
51,590,Danville city,2019,19223,18300,923,4.8
51,595,Emporia city,2019,2316,2205,111,4.8
51,600,Fairfax city,2019,13264,12990,274,2.1
51,610,Falls Church city,2019,8587,8415,172,2.0
51,620,Franklin city,2019,3608,3470,138,3.8
51,630,Fredericksburg city,2019,14218,13758,460,3.2
51,640,Galax city,2019,2935,2844,91,3.1
51,650,Hampton city,2019,65080,62719,2361,3.6
51,660,Harrisonburg city,2019,24855,24084,771,3.1
51,670,Hopewell city,2019,9688,9286,402,4.1
51,678,Lexington city,2019,2101,2006,95,4.5
51,680,Lynchburg city,2019,36729,35419,1310,3.6
51,683,Manassas city,2019,21950,21418,532,2.4
51,685,Manassas Park city,2019,9553,9325,228,2.4
51,690,Martinsville city,2019,5500,5284,216,3.9
51,700,Newport News city,2019,89963,86981,2982,3.3
51,710,Norfolk city,2019,112092,108369,3723,3.3
51,720,Norton city,2019,1688,1629,59,3.5
51,730,Petersburg city,2019,12976,12275,701,5.4
51,735,Poquoson city,2019,6491,6341,150,2.3
51,740,Portsmouth city,2019,44585,42913,1672,3.8
51,750,Radford city,2019,8750,8451,299,3.4
51,760,Richmond city,2019,119638,115867,3771,3.2
51,770,Roanoke city,2019,49345,47903,1442,2.9
51,775,Salem city,2019,12953,12607,346,2.7
51,790,Staunton city,2019,12318,11999,319,2.6
51,800,Suffolk city,2019,45522,44198,1324,2.9
51,810,Virginia Beach city,2019,235250,229159,6091,2.6
51,820,Waynesboro city,2019,10757,10459,298,2.8
51,830,Williamsburg city,2019,6781,6529,252,3.7
51,840,Winchester city,2019,14858,14459,399,2.7
53,1,Adams,2019,9860,9305,555,5.6
53,3,Asotin,2019,10339,9916,423,4.1
53,5,Benton,2019,102839,97473,5366,5.2
53,7,Chelan,2019,44928,42750,2178,4.8
53,9,Clallam,2019,28756,26869,1887,6.6
53,11,Clark,2019,244191,232780,11411,4.7
53,13,Columbia,2019,1815,1717,98,5.4
53,15,Cowlitz,2019,47843,44997,2846,5.9
53,17,Douglas,2019,22054,20826,1228,5.6
53,19,Ferry,2019,2497,2218,279,11.2
53,21,Franklin,2019,42905,40166,2739,6.4
53,23,Garfield,2019,906,856,50,5.5
53,25,Grant,2019,47150,43951,3199,6.8
53,27,Grays Harbor,2019,28868,26834,2034,7.0
53,29,Island,2019,35871,34065,1806,5.0
53,31,Jefferson,2019,12835,12111,724,5.6
53,33,King,2019,1288635,1255340,33295,2.6
53,35,Kitsap,2019,128164,122344,5820,4.5
53,37,Kittitas,2019,23551,22291,1260,5.4
53,39,Klickitat,2019,10257,9657,600,5.8
53,41,Lewis,2019,34808,32676,2132,6.1
53,43,Lincoln,2019,5027,4776,251,5.0
53,45,Mason,2019,25159,23576,1583,6.3
53,47,Okanogan,2019,20388,19024,1364,6.7
53,49,Pacific,2019,8516,7922,594,7.0
53,51,Pend Oreille,2019,5030,4634,396,7.9
53,53,Pierce,2019,441661,419058,22603,5.1
53,55,San Juan,2019,8630,8304,326,3.8
53,57,Skagit,2019,63098,59702,3396,5.4
53,59,Skamania,2019,5607,5306,301,5.4
53,61,Snohomish,2019,438741,426319,12422,2.8
53,63,Spokane,2019,254575,241263,13312,5.2
53,65,Stevens,2019,18932,17612,1320,7.0
53,67,Thurston,2019,142325,135461,6864,4.8
53,69,Wahkiakum,2019,1371,1281,90,6.6
53,71,Walla Walla,2019,30123,28656,1467,4.9
53,73,Whatcom,2019,115163,109443,5720,5.0
53,75,Whitman,2019,24127,23082,1045,4.3
53,77,Yakima,2019,131779,122601,9178,7.0
54,1,Barbour,2019,7215,6786,429,5.9
54,3,Berkeley,2019,59163,57053,2110,3.6
54,5,Boone,2019,7400,6996,404,5.5
54,7,Braxton,2019,5251,4862,389,7.4
54,9,Brooke,2019,10007,9486,521,5.2
54,11,Cabell,2019,41525,39793,1732,4.2
54,13,Calhoun,2019,2566,2233,333,13.0
54,15,Clay,2019,3155,2885,270,8.6
54,17,Doddridge,2019,4012,3833,179,4.5
54,19,Fayette,2019,16277,15352,925,5.7
54,21,Gilmer,2019,2379,2218,161,6.8
54,23,Grant,2019,5979,5650,329,5.5
54,25,Greenbrier,2019,16029,15285,744,4.6
54,27,Hampshire,2019,10702,10287,415,3.9
54,29,Hancock,2019,13124,12446,678,5.2
54,31,Hardy,2019,5819,5519,300,5.2
54,33,Harrison,2019,34654,33109,1545,4.5
54,35,Jackson,2019,13389,12713,676,5.0
54,37,Jefferson,2019,30629,29674,955,3.1
54,39,Kanawha,2019,82765,78956,3809,4.6
54,41,Lewis,2019,6819,6395,424,6.2
54,43,Lincoln,2019,7230,6771,459,6.3
54,45,Logan,2019,11190,10526,664,5.9
54,47,McDowell,2019,4469,4060,409,9.2
54,49,Marion,2019,25782,24471,1311,5.1
54,51,Marshall,2019,14189,13284,905,6.4
54,53,Mason,2019,10310,9695,615,6.0
54,55,Mercer,2019,21023,19824,1199,5.7
54,57,Mineral,2019,12650,11927,723,5.7
54,59,Mingo,2019,6914,6445,469,6.8
54,61,Monongalia,2019,54894,52896,1998,3.6
54,63,Monroe,2019,6013,5750,263,4.4
54,65,Morgan,2019,8234,7913,321,3.9
54,67,Nicholas,2019,9493,8891,602,6.3
54,69,Ohio,2019,21242,20281,961,4.5
54,71,Pendleton,2019,3706,3562,144,3.9
54,73,Pleasants,2019,2917,2717,200,6.9
54,75,Pocahontas,2019,3908,3687,221,5.7
54,77,Preston,2019,15593,14878,715,4.6
54,79,Putnam,2019,26996,25819,1177,4.4
54,81,Raleigh,2019,30572,29138,1434,4.7
54,83,Randolph,2019,12424,11685,739,5.9
54,85,Ritchie,2019,4414,4162,252,5.7
54,87,Roane,2019,5136,4643,493,9.6
54,89,Summers,2019,4358,4118,240,5.5
54,91,Taylor,2019,7932,7546,386,4.9
54,93,Tucker,2019,3357,3183,174,5.2
54,95,Tyler,2019,3169,2924,245,7.7
54,97,Upshur,2019,9671,9095,576,6.0
54,99,Wayne,2019,15806,14950,856,5.4
54,101,Webster,2019,3322,3113,209,6.3
54,103,Wetzel,2019,6642,6160,482,7.3
54,105,Wirt,2019,2319,2137,182,7.8
54,107,Wood,2019,36878,34994,1884,5.1
54,109,Wyoming,2019,6679,6212,467,7.0
55,1,Adams,2019,8120,7717,403,5.0
55,3,Ashland,2019,7841,7473,368,4.7
55,5,Barron,2019,24276,23332,944,3.9
55,7,Bayfield,2019,7531,7120,411,5.5
55,9,Brown,2019,141022,136714,4308,3.1
55,11,Buffalo,2019,6422,6160,262,4.1
55,13,Burnett,2019,7103,6735,368,5.2
55,15,Calumet,2019,27379,26622,757,2.8
55,17,Chippewa,2019,33240,32004,1236,3.7
55,19,Clark,2019,17650,17081,569,3.2
55,21,Columbia,2019,31552,30599,953,3.0
55,23,Crawford,2019,7551,7239,312,4.1
55,25,Dane,2019,323055,315338,7717,2.4
55,27,Dodge,2019,47281,45884,1397,3.0
55,29,Door,2019,15262,14700,562,3.7
55,31,Douglas,2019,22949,22008,941,4.1
55,33,Dunn,2019,24043,23209,834,3.5
55,35,Eau Claire,2019,58591,56839,1752,3.0
55,37,Florence,2019,2202,2100,102,4.6
55,39,Fond du Lac,2019,57008,55360,1648,2.9
55,41,Forest,2019,3994,3792,202,5.1
55,43,Grant,2019,27658,26782,876,3.2
55,45,Green,2019,20979,20389,590,2.8
55,47,Green Lake,2019,9417,9058,359,3.8
55,49,Iowa,2019,13620,13236,384,2.8
55,51,Iron,2019,2529,2380,149,5.9
55,53,Jackson,2019,10205,9817,388,3.8
55,55,Jefferson,2019,45660,44264,1396,3.1
55,57,Juneau,2019,13399,12965,434,3.2
55,59,Kenosha,2019,89666,86204,3462,3.9
55,61,Kewaunee,2019,10957,10611,346,3.2
55,63,La Crosse,2019,65843,63970,1873,2.8
55,65,Lafayette,2019,10048,9787,261,2.6
55,67,Langlade,2019,9261,8885,376,4.1
55,69,Lincoln,2019,14988,14444,544,3.6
55,71,Manitowoc,2019,40745,39387,1358,3.3
55,73,Marathon,2019,73092,71013,2079,2.8
55,75,Marinette,2019,19336,18469,867,4.5
55,77,Marquette,2019,7697,7402,295,3.8
55,78,Menominee,2019,1587,1459,128,8.1
55,79,Milwaukee,2019,463698,445487,18211,3.9
55,81,Monroe,2019,23269,22583,686,2.9
55,83,Oconto,2019,20413,19689,724,3.5
55,85,Oneida,2019,17802,17051,751,4.2
55,87,Outagamie,2019,102842,99842,3000,2.9
55,89,Ozaukee,2019,48862,47492,1370,2.8
55,91,Pepin,2019,4131,3982,149,3.6
55,93,Pierce,2019,25228,24393,835,3.3
55,95,Polk,2019,24441,23476,965,3.9
55,97,Portage,2019,38352,37127,1225,3.2
55,99,Price,2019,6427,6149,278,4.3
55,101,Racine,2019,98071,94146,3925,4.0
55,103,Richland,2019,9156,8873,283,3.1
55,105,Rock,2019,85141,82033,3108,3.7
55,107,Rusk,2019,6693,6373,320,4.8
55,109,St. Croix,2019,50489,48838,1651,3.3
55,111,Sauk,2019,35475,34460,1015,2.9
55,113,Sawyer,2019,7958,7591,367,4.6
55,115,Shawano,2019,20969,20306,663,3.2
55,117,Sheboygan,2019,61926,60261,1665,2.7
55,119,Taylor,2019,10885,10494,391,3.6
55,121,Trempealeau,2019,15880,15320,560,3.5
55,123,Vernon,2019,15325,14834,491,3.2
55,125,Vilas,2019,10171,9751,420,4.1
55,127,Walworth,2019,57540,55686,1854,3.2
55,129,Washburn,2019,7785,7474,311,4.0
55,131,Washington,2019,77028,74867,2161,2.8
55,133,Waukesha,2019,224406,217978,6428,2.9
55,135,Waupaca,2019,25795,24970,825,3.2
55,137,Waushara,2019,11376,10922,454,4.0
55,139,Winnebago,2019,91079,88386,2693,3.0
55,141,Wood,2019,34956,33647,1309,3.7
56,1,Albany,2019,20647,19996,651,3.2
56,3,Big Horn,2019,5258,5027,231,4.4
56,5,Campbell,2019,23466,22575,891,3.8
56,7,Carbon,2019,7849,7577,272,3.5
56,9,Converse,2019,8713,8463,250,2.9
56,11,Crook,2019,3771,3647,124,3.3
56,13,Fremont,2019,18921,18062,859,4.5
56,15,Goshen,2019,6520,6274,246,3.8
56,17,Hot Springs,2019,2209,2131,78,3.5
56,19,Johnson,2019,4196,4039,157,3.7
56,21,Laramie,2019,49776,48017,1759,3.5
56,23,Lincoln,2019,9099,8787,312,3.4
56,25,Natrona,2019,40380,38760,1620,4.0
56,27,Niobrara,2019,1236,1201,35,2.8
56,29,Park,2019,15465,14819,646,4.2
56,31,Platte,2019,4597,4433,164,3.6
56,33,Sheridan,2019,15693,15122,571,3.6
56,35,Sublette,2019,4110,3917,193,4.7
56,37,Sweetwater,2019,21424,20568,856,4.0
56,39,Teton,2019,15970,15521,449,2.8
56,41,Uinta,2019,9280,8912,368,4.0
56,43,Washakie,2019,3904,3742,162,4.1
56,45,Weston,2019,3819,3704,115,3.0
72,1,Adjuntas Municipio,2019,4162,3525,637,15.3
72,3,Aguada Municipio,2019,11946,10743,1203,10.1
72,5,Aguadilla Municipio,2019,14492,13002,1490,10.3
72,7,Aguas Buenas Municipio,2019,6517,5917,600,9.2
72,9,Aibonito Municipio,2019,6469,5793,676,10.4
72,11,Anasco Municipio,2019,8884,8136,748,8.4
72,13,Arecibo Municipio,2019,23904,21615,2289,9.6
72,15,Arroyo Municipio,2019,4718,4088,630,13.4
72,17,Barceloneta Municipio,2019,5961,5290,671,11.3
72,19,Barranquitas Municipio,2019,7417,6776,641,8.6
72,21,Bayamon Municipio,2019,64570,60505,4065,6.3
72,23,Cabo Rojo Municipio,2019,13595,12416,1179,8.7
72,25,Caguas Municipio,2019,47657,44425,3232,6.8
72,27,Camuy Municipio,2019,9507,8694,813,8.6
72,29,Canovanas Municipio,2019,16114,15056,1058,6.6
72,31,Carolina Municipio,2019,60960,57370,3590,5.9
72,33,Catano Municipio,2019,7761,7201,560,7.2
72,35,Cayey Municipio,2019,16082,14952,1130,7.0
72,37,Ceiba Municipio,2019,3673,3289,384,10.5
72,39,Ciales Municipio,2019,3677,3270,407,11.1
72,41,Cidra Municipio,2019,15452,14397,1055,6.8
72,43,Coamo Municipio,2019,9981,8758,1223,12.3
72,45,Comerio Municipio,2019,4898,4461,437,8.9
72,47,Corozal Municipio,2019,8920,8105,815,9.1
72,49,Culebra Municipio,2019,906,878,28,3.1
72,51,Dorado Municipio,2019,13253,12500,753,5.7
72,53,Fajardo Municipio,2019,10865,9696,1169,10.8
72,54,Florida Municipio,2019,3310,2950,360,10.9
72,55,Guanica Municipio,2019,3977,3387,590,14.8
72,57,Guayama Municipio,2019,11148,9805,1343,12.0
72,59,Guayanilla Municipio,2019,5065,4364,701,13.8
72,61,Guaynabo Municipio,2019,37411,35875,1536,4.1
72,63,Gurabo Municipio,2019,18385,17346,1039,5.7
72,65,Hatillo Municipio,2019,13700,12033,1667,12.2
72,67,Hormigueros Municipio,2019,5406,4942,464,8.6
72,69,Humacao Municipio,2019,17172,15441,1731,10.1
72,71,Isabela Municipio,2019,12451,11329,1122,9.0
72,73,Jayuya Municipio,2019,4248,3650,598,14.1
72,75,Juana Diaz Municipio,2019,15144,13640,1504,9.9
72,77,Juncos Municipio,2019,12366,11337,1029,8.3
72,79,Lajas Municipio,2019,5183,4520,663,12.8
72,81,Lares Municipio,2019,6962,5936,1026,14.7
72,83,Las Marias Municipio,2019,2643,2336,307,11.6
72,85,Las Piedras Municipio,2019,11415,10402,1013,8.9
72,87,Loiza Municipio,2019,8346,7707,639,7.7
72,89,Luquillo Municipio,2019,6201,5612,589,9.5
72,91,Manati Municipio,2019,11446,10532,914,8.0
72,93,Maricao Municipio,2019,1917,1655,262,13.7
72,95,Maunabo Municipio,2019,2928,2486,442,15.1
72,97,Mayaguez Municipio,2019,21765,19459,2306,10.6
72,99,Moca Municipio,2019,10497,9400,1097,10.5
72,101,Morovis Municipio,2019,8013,7286,727,9.1
72,103,Naguabo Municipio,2019,8236,7508,728,8.8
72,105,Naranjito Municipio,2019,7079,6482,597,8.4
72,107,Orocovis Municipio,2019,4946,4440,506,10.2
72,109,Patillas Municipio,2019,4340,3663,677,15.6
72,111,Penuelas Municipio,2019,5884,5052,832,14.1
72,113,Ponce Municipio,2019,45320,40924,4396,9.7
72,115,Quebradillas Municipio,2019,6089,5380,709,11.6
72,117,Rincon Municipio,2019,4774,4120,654,13.7
72,119,Rio Grande Municipio,2019,16901,15667,1234,7.3
72,121,Sabana Grande Municipio,2019,6105,5307,798,13.1
72,123,Salinas Municipio,2019,7153,6120,1033,14.4
72,125,San German Municipio,2019,9672,8578,1094,11.3
72,127,San Juan Municipio,2019,132528,125141,7387,5.6
72,129,San Lorenzo Municipio,2019,11685,10660,1025,8.8
72,131,San Sebastian Municipio,2019,10329,8922,1407,13.6
72,133,Santa Isabel Municipio,2019,8837,7867,970,11.0
72,135,Toa Alta Municipio,2019,27320,25782,1538,5.6
72,137,Toa Baja Municipio,2019,28938,27261,1677,5.8
72,139,Trujillo Alto Municipio,2019,26910,25600,1310,4.9
72,141,Utuado Municipio,2019,6654,5903,751,11.3
72,143,Vega Alta Municipio,2019,9751,8959,792,8.1
72,145,Vega Baja Municipio,2019,13172,11910,1262,9.6
72,147,Vieques Municipio,2019,2616,2433,183,7.0
72,149,Villalba Municipio,2019,7492,6307,1185,15.8
72,151,Yabucoa Municipio,2019,8840,7685,1155,13.1
72,153,Yauco Municipio,2019,9849,8407,1442,14.6
1,1,Autauga,2020,25838,24576,1262,4.9
1,3,Baldwin,2020,96763,91338,5425,5.6
1,5,Barbour,2020,8587,7982,605,7.0
1,7,Bibb,2020,8640,8067,573,6.6
1,9,Blount,2020,24661,23653,1008,4.1
1,11,Bullock,2020,4818,4553,265,5.5
1,13,Butler,2020,9056,8255,801,8.8
1,15,Calhoun,2020,46240,42980,3260,7.1
1,17,Chambers,2020,15865,14787,1078,6.8
1,19,Cherokee,2020,11513,10983,530,4.6
1,21,Chilton,2020,19592,18618,974,5.0
1,23,Choctaw,2020,4621,4313,308,6.7
1,25,Clarke,2020,7769,7069,700,9.0
1,27,Clay,2020,6083,5838,245,4.0
1,29,Cleburne,2020,5737,5475,262,4.6
1,31,Coffee,2020,21502,20558,944,4.4
1,33,Colbert,2020,23558,22008,1550,6.6
1,35,Conecuh,2020,4529,4198,331,7.3
1,37,Coosa,2020,4392,4150,242,5.5
1,39,Covington,2020,15172,14434,738,4.9
1,41,Crenshaw,2020,6253,5896,357,5.7
1,43,Cullman,2020,38310,36660,1650,4.3
1,45,Dale,2020,20710,19701,1009,4.9
1,47,Dallas,2020,14619,13049,1570,10.7
1,49,DeKalb,2020,30736,29348,1388,4.5
1,51,Elmore,2020,36620,34843,1777,4.9
1,53,Escambia,2020,14453,13589,864,6.0
1,55,Etowah,2020,40724,37598,3126,7.7
1,57,Fayette,2020,6562,6236,326,5.0
1,59,Franklin,2020,14424,13786,638,4.4
1,61,Geneva,2020,10835,10391,444,4.1
1,63,Greene,2020,3015,2687,328,10.9
1,65,Hale,2020,6075,5503,572,9.4
1,67,Henry,2020,6814,6487,327,4.8
1,69,Houston,2020,46358,43861,2497,5.4
1,71,Jackson,2020,22840,21637,1203,5.3
1,73,Jefferson,2020,315957,296282,19675,6.2
1,75,Lamar,2020,5730,5452,278,4.9
1,77,Lauderdale,2020,41931,39610,2321,5.5
1,79,Lawrence,2020,14363,13660,703,4.9
1,81,Lee,2020,75564,71629,3935,5.2
1,83,Limestone,2020,44624,42724,1900,4.3
1,85,Lowndes,2020,3661,3173,488,13.3
1,87,Macon,2020,8063,7290,773,9.6
1,89,Madison,2020,187247,178579,8668,4.6
1,91,Marengo,2020,7766,7281,485,6.2
1,93,Marion,2020,13034,12373,661,5.1
1,95,Marshall,2020,44275,42430,1845,4.2
1,97,Mobile,2020,190882,175761,15121,7.9
1,99,Monroe,2020,7474,6864,610,8.2
1,101,Montgomery,2020,107103,98735,8368,7.8
1,103,Morgan,2020,58899,56265,2634,4.5
1,105,Perry,2020,3437,3064,373,10.9
1,107,Pickens,2020,7660,7161,499,6.5
1,109,Pike,2020,15636,14864,772,4.9
1,111,Randolph,2020,9414,8967,447,4.7
1,113,Russell,2020,23500,22290,1210,5.1
1,115,St. Clair,2020,40132,38146,1986,4.9
1,117,Shelby,2020,114048,109646,4402,3.9
1,119,Sumter,2020,4745,4414,331,7.0
1,121,Talladega,2020,36123,33591,2532,7.0
1,123,Tallapoosa,2020,17864,16625,1239,6.9
1,125,Tuscaloosa,2020,102222,95473,6749,6.6
1,127,Walker,2020,24877,23431,1446,5.8
1,129,Washington,2020,6729,6190,539,8.0
1,131,Wilcox,2020,2871,2448,423,14.7
1,133,Winston,2020,10017,9542,475,4.7
2,13,Aleutians East Borough,2020,2523,2423,100,4.0
2,16,Aleutians West Census Area,2020,3732,3563,169,4.5
2,20,Anchorage Borough/municipality,2020,148392,137421,10971,7.4
2,50,Bethel Census Area,2020,6963,6158,805,11.6
2,60,Bristol Bay Borough,2020,417,386,31,7.4
2,68,Denali Borough,2020,680,573,107,15.7
2,70,Dillingham Census Area,2020,1742,1599,143,8.2
2,90,Fairbanks North Star Borough,2020,44679,41838,2841,6.4
2,100,Haines Borough,2020,1018,859,159,15.6
2,105,Hoonah-Angoon Census Area,2020,1050,908,142,13.5
2,110,Juneau Borough/city,2020,16374,15293,1081,6.6
2,122,Kenai Peninsula Borough,2020,26341,23948,2393,9.1
2,130,Ketchikan Gateway Borough,2020,6520,5893,627,9.6
2,150,Kodiak Island Borough,2020,6090,5710,380,6.2
2,158,Kusilvak Census Area,2020,2299,1854,445,19.4
2,164,Lake and Peninsula Borough,2020,689,624,65,9.4
2,170,Matanuska-Susitna Borough,2020,47848,43858,3990,8.3
2,180,Nome Census Area,2020,3927,3516,411,10.5
2,185,North Slope Borough,2020,3200,3011,189,5.9
2,188,Northwest Arctic Borough,2020,2942,2590,352,12.0
2,195,Petersburg Borough,2020,1415,1292,123,8.7
2,198,Prince of Wales-Hyder Census Area,2020,2828,2568,260,9.2
2,220,Sitka Borough/city,2020,4132,3847,285,6.9
2,230,Skagway Municipality,2020,606,476,130,21.5
2,240,Southeast Fairbanks Census Area,2020,2934,2717,217,7.4
2,261,Valdez-Cordova Census Area,2020,4522,4127,395,8.7
2,275,Wrangell Borough/city,2020,984,901,83,8.4
2,282,Yakutat Borough/city,2020,260,238,22,8.5
2,290,Yukon-Koyukuk Census Area,2020,2308,2028,280,12.1
4,1,Apache,2020,20195,17614,2581,12.8
4,3,Cochise,2020,51995,48368,3627,7.0
4,5,Coconino,2020,75280,67985,7295,9.7
4,7,Gila,2020,21008,19387,1621,7.7
4,9,Graham,2020,15919,14911,1008,6.3
4,11,Greenlee,2020,4454,4210,244,5.5
4,12,La Paz,2020,8979,8343,636,7.1
4,13,Maricopa,2020,2331628,2159267,172361,7.4
4,15,Mohave,2020,88743,79889,8854,10.0
4,17,Navajo,2020,40419,36322,4097,10.1
4,19,Pima,2020,495991,457683,38308,7.7
4,21,Pinal,2020,191074,176674,14400,7.5
4,23,Santa Cruz,2020,19429,17209,2220,11.4
4,25,Yavapai,2020,106985,98978,8007,7.5
4,27,Yuma,2020,98120,81310,16810,17.1
5,1,Arkansas,2020,9422,9044,378,4.0
5,3,Ashley,2020,7186,6518,668,9.3
5,5,Baxter,2020,16528,15547,981,5.9
5,7,Benton,2020,140015,133784,6231,4.5
5,9,Boone,2020,15764,14934,830,5.3
5,11,Bradley,2020,4386,4130,256,5.8
5,13,Calhoun,2020,2426,2301,125,5.2
5,15,Carroll,2020,12709,11989,720,5.7
5,17,Chicot,2020,3250,2914,336,10.3
5,19,Clark,2020,9314,8765,549,5.9
5,21,Clay,2020,5519,5186,333,6.0
5,23,Cleburne,2020,9157,8460,697,7.6
5,25,Cleveland,2020,3203,3008,195,6.1
5,27,Columbia,2020,9053,8433,620,6.8
5,29,Conway,2020,8392,7888,504,6.0
5,31,Craighead,2020,55775,52803,2972,5.3
5,33,Crawford,2020,26436,24998,1438,5.4
5,35,Crittenden,2020,21209,19459,1750,8.3
5,37,Cross,2020,7291,6847,444,6.1
5,39,Dallas,2020,2832,2681,151,5.3
5,41,Desha,2020,5321,4948,373,7.0
5,43,Drew,2020,7730,7196,534,6.9
5,45,Faulkner,2020,61682,58321,3361,5.4
5,47,Franklin,2020,7478,7059,419,5.6
5,49,Fulton,2020,4924,4671,253,5.1
5,51,Garland,2020,41347,38052,3295,8.0
5,53,Grant,2020,8222,7796,426,5.2
5,55,Greene,2020,19450,18292,1158,6.0
5,57,Hempstead,2020,9593,9094,499,5.2
5,59,Hot Spring,2020,14100,13285,815,5.8
5,61,Howard,2020,5533,5257,276,5.0
5,63,Independence,2020,16670,15711,959,5.8
5,65,Izard,2020,4640,4249,391,8.4
5,67,Jackson,2020,5863,5444,419,7.1
5,69,Jefferson,2020,27398,25194,2204,8.0
5,71,Johnson,2020,10120,9482,638,6.3
5,73,Lafayette,2020,2421,2236,185,7.6
5,75,Lawrence,2020,6786,6369,417,6.1
5,77,Lee,2020,2805,2595,210,7.5
5,79,Lincoln,2020,3834,3605,229,6.0
5,81,Little River,2020,5385,5038,347,6.4
5,83,Logan,2020,8656,8081,575,6.6
5,85,Lonoke,2020,33550,31692,1858,5.5
5,87,Madison,2020,7413,7126,287,3.9
5,89,Marion,2020,6251,5848,403,6.4
5,91,Miller,2020,19379,18047,1332,6.9
5,93,Mississippi,2020,17264,15705,1559,9.0
5,95,Monroe,2020,2721,2539,182,6.7
5,97,Montgomery,2020,2981,2778,203,6.8
5,99,Nevada,2020,3550,3342,208,5.9
5,101,Newton,2020,3246,3084,162,5.0
5,103,Ouachita,2020,9821,9229,592,6.0
5,105,Perry,2020,4188,3956,232,5.5
5,107,Phillips,2020,6402,5822,580,9.1
5,109,Pike,2020,4272,4020,252,5.9
5,111,Poinsett,2020,9919,9374,545,5.5
5,113,Polk,2020,8013,7482,531,6.6
5,115,Pope,2020,27775,26138,1637,5.9
5,117,Prairie,2020,3608,3415,193,5.3
5,119,Pulaski,2020,188928,174884,14044,7.4
5,121,Randolph,2020,7444,7005,439,5.9
5,123,St. Francis,2020,8028,7394,634,7.9
5,125,Saline,2020,58181,55241,2940,5.1
5,127,Scott,2020,4354,4159,195,4.5
5,129,Searcy,2020,2885,2701,184,6.4
5,131,Sebastian,2020,56158,52803,3355,6.0
5,133,Sevier,2020,5524,5202,322,5.8
5,135,Sharp,2020,5717,5309,408,7.1
5,137,Stone,2020,4618,4290,328,7.1
5,139,Union,2020,15622,14325,1297,8.3
5,141,Van Buren,2020,5758,5349,409,7.1
5,143,Washington,2020,126141,120346,5795,4.6
5,145,White,2020,33972,31855,2117,6.2
5,147,Woodruff,2020,2794,2631,163,5.8
5,149,Yell,2020,7997,7592,405,5.1
6,1,Alameda,2020,813807,742411,71396,8.8
6,3,Alpine,2020,517,459,58,11.2
6,5,Amador,2020,14424,13107,1317,9.1
6,7,Butte,2020,92604,84095,8509,9.2
6,9,Calaveras,2020,21207,19588,1619,7.6
6,11,Colusa,2020,10499,8824,1675,16.0
6,13,Contra Costa,2020,541256,493236,48020,8.9
6,15,Del Norte,2020,9350,8466,884,9.5
6,17,El Dorado,2020,90752,83262,7490,8.3
6,19,Fresno,2020,445518,395258,50260,11.3
6,21,Glenn,2020,12568,11455,1113,8.9
6,23,Humboldt,2020,59411,54446,4965,8.4
6,25,Imperial,2020,69602,53949,15653,22.5
6,27,Inyo,2020,8305,7658,647,7.8
6,29,Kern,2020,383769,335707,48062,12.5
6,31,Kings,2020,56416,49883,6533,11.6
6,33,Lake,2020,28267,25567,2700,9.6
6,35,Lassen,2020,9461,8785,676,7.1
6,37,Los Angeles,2020,4968912,4355926,612986,12.3
6,39,Madera,2020,61738,55089,6649,10.8
6,41,Marin,2020,130138,121476,8662,6.7
6,43,Mariposa,2020,7162,6381,781,10.9
6,45,Mendocino,2020,37015,33723,3292,8.9
6,47,Merced,2020,114736,100755,13981,12.2
6,49,Modoc,2020,3170,2900,270,8.5
6,51,Mono,2020,7846,6917,929,11.8
6,53,Monterey,2020,213471,190389,23082,10.8
6,55,Napa,2020,68867,62853,6014,8.7
6,57,Nevada,2020,46489,42787,3702,8.0
6,59,Orange,2020,1553301,1416738,136563,8.8
6,61,Placer,2020,184892,171319,13573,7.3
6,63,Plumas,2020,7559,6753,806,10.7
6,65,Riverside,2020,1107723,997725,109998,9.9
6,67,Sacramento,2020,707182,641624,65558,9.3
6,69,San Benito,2020,31528,28409,3119,9.9
6,71,San Bernardino,2020,966206,874911,91295,9.4
6,73,San Diego,2020,1538361,1396547,141814,9.2
6,75,San Francisco/city,2020,556056,512531,43525,7.8
6,77,San Joaquin,2020,331828,294454,37374,11.3
6,79,San Luis Obispo,2020,132690,122495,10195,7.7
6,81,San Mateo,2020,433876,404128,29748,6.9
6,83,Santa Barbara,2020,217510,200175,17335,8.0
6,85,Santa Clara,2020,1020693,949353,71340,7.0
6,87,Santa Cruz,2020,133646,120932,12714,9.5
6,89,Shasta,2020,72827,66484,6343,8.7
6,91,Sierra,2020,1282,1179,103,8.0
6,93,Siskiyou,2020,16923,15286,1637,9.7
6,95,Solano,2020,202812,183607,19205,9.5
6,97,Sonoma,2020,245091,225791,19300,7.9
6,99,Stanislaus,2020,240641,214885,25756,10.7
6,101,Sutter,2020,45467,40472,4995,11.0
6,103,Tehama,2020,25579,23317,2262,8.8
6,105,Trinity,2020,4515,4155,360,8.0
6,107,Tulare,2020,199151,172852,26299,13.2
6,109,Tuolumne,2020,20038,17954,2084,10.4
6,111,Ventura,2020,408867,373903,34964,8.6
6,113,Yolo,2020,105026,97111,7915,7.5
6,115,Yuba,2020,30042,26879,3163,10.5
8,1,Adams,2020,274498,252469,22029,8.0
8,3,Alamosa,2020,8403,7868,535,6.4
8,5,Arapahoe,2020,366768,337943,28825,7.9
8,7,Archuleta,2020,7123,6585,538,7.6
8,9,Baca,2020,2132,2082,50,2.3
8,11,Bent,2020,1828,1748,80,4.4
8,13,Boulder,2020,192879,180992,11887,6.2
8,14,Broomfield/city,2020,40226,37556,2670,6.6
8,15,Chaffee,2020,9741,9126,615,6.3
8,17,Cheyenne,2020,1103,1076,27,2.4
8,19,Clear Creek,2020,6151,5628,523,8.5
8,21,Conejos,2020,4071,3844,227,5.6
8,23,Costilla,2020,1823,1691,132,7.2
8,25,Crowley,2020,1528,1445,83,5.4
8,27,Custer,2020,2087,1982,105,5.0
8,29,Delta,2020,14340,13400,940,6.6
8,31,Denver/city,2020,423824,388924,34900,8.2
8,33,Dolores,2020,1137,1059,78,6.9
8,35,Douglas,2020,194649,183412,11237,5.8
8,37,Eagle,2020,35708,32319,3389,9.5
8,39,Elbert,2020,14961,14264,697,4.7
8,41,El Paso,2020,344120,319084,25036,7.3
8,43,Fremont,2020,15393,14203,1190,7.7
8,45,Garfield,2020,31762,29606,2156,6.8
8,47,Gilpin,2020,4016,3562,454,11.3
8,49,Grand,2020,9364,8576,788,8.4
8,51,Gunnison,2020,11347,10596,751,6.6
8,53,Hinsdale,2020,426,408,18,4.2
8,55,Huerfano,2020,2644,2395,249,9.4
8,57,Jackson,2020,940,900,40,4.3
8,59,Jefferson,2020,333682,310057,23625,7.1
8,61,Kiowa,2020,956,934,22,2.3
8,63,Kit Carson,2020,4249,4130,119,2.8
8,65,Lake,2020,4853,4454,399,8.2
8,67,La Plata,2020,31366,29219,2147,6.8
8,69,Larimer,2020,203683,190842,12841,6.3
8,71,Las Animas,2020,6497,6014,483,7.4
8,73,Lincoln,2020,2375,2269,106,4.5
8,75,Logan,2020,11017,10495,522,4.7
8,77,Mesa,2020,75551,69917,5634,7.5
8,79,Mineral,2020,469,442,27,5.8
8,81,Moffat,2020,7285,6849,436,6.0
8,83,Montezuma,2020,12703,11795,908,7.1
8,85,Montrose,2020,21639,20208,1431,6.6
8,87,Morgan,2020,16125,15254,871,5.4
8,89,Otero,2020,8228,7720,508,6.2
8,91,Ouray,2020,2493,2292,201,8.1
8,93,Park,2020,11114,10480,634,5.7
8,95,Phillips,2020,2467,2401,66,2.7
8,97,Pitkin,2020,11253,10077,1176,10.5
8,99,Prowers,2020,6213,5937,276,4.4
8,101,Pueblo,2020,77355,71037,6318,8.2
8,103,Rio Blanco,2020,2949,2789,160,5.4
8,105,Rio Grande,2020,5453,5068,385,7.1
8,107,Routt,2020,16206,14929,1277,7.9
8,109,Saguache,2020,3438,3196,242,7.0
8,111,San Juan,2020,509,475,34,6.7
8,113,San Miguel,2020,5410,4818,592,10.9
8,115,Sedgwick,2020,1166,1126,40,3.4
8,117,Summit,2020,22402,20204,2198,9.8
8,119,Teller,2020,12984,12016,968,7.5
8,121,Washington,2020,2895,2804,91,3.1
8,123,Weld,2020,166666,155042,11624,7.0
8,125,Yuma,2020,5604,5445,159,2.8
9,1,Fairfield,2020,466208,429164,37044,7.9
9,3,Hartford,2020,476115,437433,38682,8.1
9,5,Litchfield,2020,102109,95102,7007,6.9
9,7,Middlesex,2020,92221,86211,6010,6.5
9,9,New Haven,2020,457171,420669,36502,8.0
9,11,New London,2020,131992,119313,12679,9.6
9,13,Tolland,2020,84598,79362,5236,6.2
9,15,Windham,2020,62218,57369,4849,7.8
10,1,Kent,2020,79715,72843,6872,8.6
10,3,New Castle,2020,298640,275601,23039,7.7
10,5,Sussex,2020,106004,98014,7990,7.5
11,1,District of Colu,2020,389384,358370,31014,8.0
12,1,Alachua,2020,134931,127696,7235,5.4
12,3,Baker,2020,11759,11179,580,4.9
12,5,Bay,2020,82763,77746,5017,6.1
12,7,Bradford,2020,10791,10150,641,5.9
12,9,Brevard,2020,281591,262867,18724,6.6
12,11,Broward,2020,1020586,930297,90289,8.8
12,13,Calhoun,2020,4754,4508,246,5.2
12,15,Charlotte,2020,71182,65968,5214,7.3
12,17,Citrus,2020,46500,42582,3918,8.4
12,19,Clay,2020,105658,100004,5654,5.4
12,21,Collier,2020,177497,165287,12210,6.9
12,23,Columbia,2020,29566,27840,1726,5.8
12,27,DeSoto,2020,14356,13615,741,5.2
12,29,Dixie,2020,5886,5565,321,5.5
12,31,Duval,2020,485114,452481,32633,6.7
12,33,Escambia,2020,144779,135108,9671,6.7
12,35,Flagler,2020,46636,43083,3553,7.6
12,37,Franklin,2020,4681,4429,252,5.4
12,39,Gadsden,2020,18421,17176,1245,6.8
12,41,Gilchrist,2020,7028,6683,345,4.9
12,43,Glades,2020,5192,4903,289,5.6
12,45,Gulf,2020,5022,4724,298,5.9
12,47,Hamilton,2020,4199,3880,319,7.6
12,49,Hardee,2020,8466,7915,551,6.5
12,51,Hendry,2020,15589,14332,1257,8.1
12,53,Hernando,2020,71534,65765,5769,8.1
12,55,Highlands,2020,34641,31967,2674,7.7
12,57,Hillsborough,2020,754552,700764,53788,7.1
12,59,Holmes,2020,6850,6472,378,5.5
12,61,Indian River,2020,64233,59482,4751,7.4
12,63,Jackson,2020,17231,16298,933,5.4
12,65,Jefferson,2020,5347,5049,298,5.6
12,67,Lafayette,2020,2781,2664,117,4.2
12,69,Lake,2020,154028,140383,13645,8.9
12,71,Lee,2020,345417,320161,25256,7.3
12,73,Leon,2020,150626,141883,8743,5.8
12,75,Levy,2020,16569,15568,1001,6.0
12,77,Liberty,2020,2598,2473,125,4.8
12,79,Madison,2020,7599,7140,459,6.0
12,81,Manatee,2020,176496,164571,11925,6.8
12,83,Marion,2020,138469,128709,9760,7.0
12,85,Martin,2020,72180,67796,4384,6.1
12,86,Miami-Dade,2020,1271646,1177701,93945,7.4
12,87,Monroe,2020,44755,41223,3532,7.9
12,89,Nassau,2020,41338,38991,2347,5.7
12,91,Okaloosa,2020,96010,90729,5281,5.5
12,93,Okeechobee,2020,17138,16217,921,5.4
12,95,Orange,2020,737546,659050,78496,10.6
12,97,Osceola,2020,185793,160638,25155,13.5
12,99,Palm Beach,2020,717379,662945,54434,7.6
12,101,Pasco,2020,238327,221185,17142,7.2
12,103,Pinellas,2020,484330,450266,34064,7.0
12,105,Polk,2020,316626,287979,28647,9.0
12,107,Putnam,2020,26470,24378,2092,7.9
12,109,St. Johns,2020,133843,126772,7071,5.3
12,111,St. Lucie,2020,145363,134060,11303,7.8
12,113,Santa Rosa,2020,82647,78348,4299,5.2
12,115,Sarasota,2020,184464,171875,12589,6.8
12,117,Seminole,2020,237769,220602,17167,7.2
12,119,Sumter,2020,32225,29691,2534,7.9
12,121,Suwannee,2020,17758,16758,1000,5.6
12,123,Taylor,2020,8169,7659,510,6.2
12,125,Union,2020,4552,4336,216,4.7
12,127,Volusia,2020,249560,230585,18975,7.6
12,129,Wakulla,2020,14885,14216,669,4.5
12,131,Walton,2020,31957,30070,1887,5.9
12,133,Washington,2020,9478,8929,549,5.8
13,1,Appling,2020,9105,8674,431,4.7
13,3,Atkinson,2020,4434,4262,172,3.9
13,5,Bacon,2020,4652,4425,227,4.9
13,7,Baker,2020,1145,1076,69,6.0
13,9,Baldwin,2020,17607,16388,1219,6.9
13,11,Banks,2020,9778,9359,419,4.3
13,13,Barrow,2020,40112,38057,2055,5.1
13,15,Bartow,2020,49719,46612,3107,6.2
13,17,Ben Hill,2020,5460,5083,377,6.9
13,19,Berrien,2020,7405,6977,428,5.8
13,21,Bibb,2020,67421,62371,5050,7.5
13,23,Bleckley,2020,4501,4209,292,6.5
13,25,Brantley,2020,6995,6618,377,5.4
13,27,Brooks,2020,6842,6488,354,5.2
13,29,Bryan,2020,18718,17732,986,5.3
13,31,Bulloch,2020,37020,34601,2419,6.5
13,33,Burke,2020,9026,8379,647,7.2
13,35,Butts,2020,10739,10075,664,6.2
13,37,Calhoun,2020,2237,2124,113,5.1
13,39,Camden,2020,21089,20092,997,4.7
13,43,Candler,2020,5633,5383,250,4.4
13,45,Carroll,2020,54475,51009,3466,6.4
13,47,Catoosa,2020,32611,31194,1417,4.3
13,49,Charlton,2020,4842,4660,182,3.8
13,51,Chatham,2020,140631,129918,10713,7.6
13,53,Chattahoochee,2020,1988,1864,124,6.2
13,55,Chattooga,2020,9767,8947,820,8.4
13,57,Cherokee,2020,133045,126581,6464,4.9
13,59,Clarke,2020,58206,54453,3753,6.4
13,61,Clay,2020,896,785,111,12.4
13,63,Clayton,2020,139790,125357,14433,10.3
13,65,Clinch,2020,2943,2826,117,4.0
13,67,Cobb,2020,414357,389904,24453,5.9
13,69,Coffee,2020,18938,17835,1103,5.8
13,71,Colquitt,2020,21917,20938,979,4.5
13,73,Columbia,2020,74411,71266,3145,4.2
13,75,Cook,2020,8102,7718,384,4.7
13,77,Coweta,2020,73981,69397,4584,6.2
13,79,Crawford,2020,5488,5211,277,5.0
13,81,Crisp,2020,9515,8767,748,7.9
13,83,Dade,2020,7860,7538,322,4.1
13,85,Dawson,2020,12319,11735,584,4.7
13,87,Decatur,2020,11304,10763,541,4.8
13,89,DeKalb,2020,395683,364209,31474,8.0
13,91,Dodge,2020,6957,6542,415,6.0
13,93,Dooly,2020,4925,4547,378,7.7
13,95,Dougherty,2020,37712,34469,3243,8.6
13,97,Douglas,2020,72297,66930,5367,7.4
13,99,Early,2020,4424,4168,256,5.8
13,101,Echols,2020,1899,1825,74,3.9
13,103,Effingham,2020,31400,29827,1573,5.0
13,105,Elbert,2020,7969,7418,551,6.9
13,107,Emanuel,2020,8518,7915,603,7.1
13,109,Evans,2020,5002,4745,257,5.1
13,111,Fannin,2020,11066,10542,524,4.7
13,113,Fayette,2020,56444,53389,3055,5.4
13,115,Floyd,2020,43234,40522,2712,6.3
13,117,Forsyth,2020,120904,115371,5533,4.6
13,119,Franklin,2020,9892,9308,584,5.9
13,121,Fulton,2020,557232,512593,44639,8.0
13,123,Gilmer,2020,11963,11401,562,4.7
13,125,Glascock,2020,1244,1193,51,4.1
13,127,Glynn,2020,38215,35610,2605,6.8
13,129,Gordon,2020,28062,26531,1531,5.5
13,131,Grady,2020,10601,10139,462,4.4
13,133,Greene,2020,7080,6663,417,5.9
13,135,Gwinnett,2020,481453,450909,30544,6.3
13,137,Habersham,2020,18691,17675,1016,5.4
13,139,Hall,2020,101949,97133,4816,4.7
13,141,Hancock,2020,2532,2309,223,8.8
13,143,Haralson,2020,12245,11525,720,5.9
13,145,Harris,2020,16527,15763,764,4.6
13,147,Hart,2020,11373,10757,616,5.4
13,149,Heard,2020,5132,4798,334,6.5
13,151,Henry,2020,115352,106831,8521,7.4
13,153,Houston,2020,70418,66769,3649,5.2
13,155,Irwin,2020,3467,3276,191,5.5
13,157,Jackson,2020,39648,37910,1738,4.4
13,159,Jasper,2020,6756,6422,334,4.9
13,161,Jeff Davis,2020,6099,5785,314,5.1
13,163,Jefferson,2020,6658,6209,449,6.7
13,165,Jenkins,2020,3178,2978,200,6.3
13,167,Johnson,2020,4006,3808,198,4.9
13,169,Jones,2020,13346,12737,609,4.6
13,171,Lamar,2020,7980,7476,504,6.3
13,173,Lanier,2020,3723,3529,194,5.2
13,175,Laurens,2020,19367,18075,1292,6.7
13,177,Lee,2020,14763,14081,682,4.6
13,179,Liberty,2020,25741,24140,1601,6.2
13,181,Lincoln,2020,3497,3307,190,5.4
13,183,Long,2020,8139,7782,357,4.4
13,185,Lowndes,2020,51599,48484,3115,6.0
13,187,Lumpkin,2020,16463,15671,792,4.8
13,189,McDuffie,2020,8695,8016,679,7.8
13,191,McIntosh,2020,5949,5609,340,5.7
13,193,Macon,2020,4614,4303,311,6.7
13,195,Madison,2020,12972,12302,670,5.2
13,197,Marion,2020,3192,3029,163,5.1
13,199,Meriwether,2020,8816,8061,755,8.6
13,201,Miller,2020,2772,2660,112,4.0
13,205,Mitchell,2020,8289,7751,538,6.5
13,207,Monroe,2020,12700,12050,650,5.1
13,209,Montgomery,2020,3891,3681,210,5.4
13,211,Morgan,2020,9142,8645,497,5.4
13,213,Murray,2020,15350,14191,1159,7.6
13,215,Muscogee,2020,77258,71209,6049,7.8
13,217,Newton,2020,51901,48202,3699,7.1
13,219,Oconee,2020,19208,18487,721,3.8
13,221,Oglethorpe,2020,6791,6464,327,4.8
13,223,Paulding,2020,85313,80718,4595,5.4
13,225,Peach,2020,11814,11084,730,6.2
13,227,Pickens,2020,14927,14210,717,4.8
13,229,Pierce,2020,8500,8115,385,4.5
13,231,Pike,2020,8705,8273,432,5.0
13,233,Polk,2020,18292,17200,1092,6.0
13,235,Pulaski,2020,3976,3797,179,4.5
13,237,Putnam,2020,8210,7671,539,6.6
13,239,Quitman,2020,800,748,52,6.5
13,241,Rabun,2020,7215,6831,384,5.3
13,243,Randolph,2020,2490,2343,147,5.9
13,245,Richmond,2020,85112,78649,6463,7.6
13,247,Rockdale,2020,43989,40657,3332,7.6
13,249,Schley,2020,2145,2052,93,4.3
13,251,Screven,2020,5047,4635,412,8.2
13,253,Seminole,2020,3093,2938,155,5.0
13,255,Spalding,2020,28305,26156,2149,7.6
13,257,Stephens,2020,10414,9745,669,6.4
13,259,Stewart,2020,2509,2367,142,5.7
13,261,Sumter,2020,12525,11601,924,7.4
13,263,Talbot,2020,2757,2568,189,6.9
13,265,Taliaferro,2020,530,492,38,7.2
13,267,Tattnall,2020,9651,9237,414,4.3
13,269,Taylor,2020,2746,2563,183,6.7
13,271,Telfair,2020,3782,3408,374,9.9
13,273,Terrell,2020,3497,3235,262,7.5
13,275,Thomas,2020,16930,15874,1056,6.2
13,277,Tift,2020,20500,19463,1037,5.1
13,279,Toombs,2020,12081,11287,794,6.6
13,281,Towns,2020,3841,3585,256,6.7
13,283,Treutlen,2020,2710,2547,163,6.0
13,285,Troup,2020,37448,34727,2721,7.3
13,287,Turner,2020,3264,3028,236,7.2
13,289,Twiggs,2020,2790,2583,207,7.4
13,291,Union,2020,10464,10006,458,4.4
13,293,Upson,2020,11328,10578,750,6.6
13,295,Walker,2020,30601,29106,1495,4.9
13,297,Walton,2020,44917,42476,2441,5.4
13,299,Ware,2020,15284,14432,852,5.6
13,301,Warren,2020,2635,2456,179,6.8
13,303,Washington,2020,6931,6486,445,6.4
13,305,Wayne,2020,11540,10894,646,5.6
13,307,Webster,2020,1008,951,57,5.7
13,309,Wheeler,2020,1608,1492,116,7.2
13,311,White,2020,16197,15491,706,4.4
13,313,Whitfield,2020,43275,40137,3138,7.3
13,315,Wilcox,2020,2737,2581,156,5.7
13,317,Wilkes,2020,3712,3464,248,6.7
13,319,Wilkinson,2020,3790,3587,203,5.4
13,321,Worth,2020,8844,8369,475,5.4
15,1,Hawaii,2020,89119,78986,10133,11.4
15,3,Honolulu/city,2020,440915,396136,44779,10.2
15,7,Kauai,2020,35337,29618,5719,16.2
15,9,Maui,2020,82820,68056,14764,17.8
16,1,Ada,2020,257677,243784,13893,5.4
16,3,Adams,2020,1758,1594,164,9.3
16,5,Bannock,2020,42560,40495,2065,4.9
16,7,Bear Lake,2020,3075,2946,129,4.2
16,9,Benewah,2020,4140,3830,310,7.5
16,11,Bingham,2020,23776,22860,916,3.9
16,13,Blaine,2020,12666,11679,987,7.8
16,15,Boise,2020,3609,3321,288,8.0
16,17,Bonner,2020,21119,19527,1592,7.5
16,19,Bonneville,2020,58136,55789,2347,4.0
16,21,Boundary,2020,5502,5163,339,6.2
16,23,Butte,2020,1393,1343,50,3.6
16,25,Camas,2020,684,651,33,4.8
16,27,Canyon,2020,105981,99763,6218,5.9
16,29,Caribou,2020,4110,3962,148,3.6
16,31,Cassia,2020,12384,11930,454,3.7
16,33,Clark,2020,378,363,15,4.0
16,35,Clearwater,2020,3021,2772,249,8.2
16,37,Custer,2020,2218,2106,112,5.0
16,39,Elmore,2020,11897,11321,576,4.8
16,41,Franklin,2020,7060,6807,253,3.6
16,43,Fremont,2020,7894,7606,288,3.6
16,45,Gem,2020,8422,7924,498,5.9
16,47,Gooding,2020,8256,7944,312,3.8
16,49,Idaho,2020,6709,6260,449,6.7
16,51,Jefferson,2020,14142,13659,483,3.4
16,53,Jerome,2020,12198,11711,487,4.0
16,55,Kootenai,2020,81286,75654,5632,6.9
16,57,Latah,2020,19756,18818,938,4.7
16,59,Lemhi,2020,3651,3408,243,6.7
16,61,Lewis,2020,1662,1534,128,7.7
16,63,Lincoln,2020,2667,2511,156,5.8
16,65,Madison,2020,22306,21700,606,2.7
16,67,Minidoka,2020,11642,11194,448,3.8
16,69,Nez Perce,2020,20793,19780,1013,4.9
16,71,Oneida,2020,2342,2244,98,4.2
16,73,Owyhee,2020,5493,5166,327,6.0
16,75,Payette,2020,11941,11309,632,5.3
16,77,Power,2020,4132,3964,168,4.1
16,79,Shoshone,2020,5444,4946,498,9.1
16,81,Teton,2020,6632,6256,376,5.7
16,83,Twin Falls,2020,41250,39083,2167,5.3
16,85,Valley,2020,5643,5195,448,7.9
16,87,Washington,2020,4752,4496,256,5.4
17,1,Adams,2020,31259,29287,1972,6.3
17,3,Alexander,2020,1918,1730,188,9.8
17,5,Bond,2020,7484,6972,512,6.8
17,7,Boone,2020,25580,22720,2860,11.2
17,9,Brown,2020,2996,2881,115,3.8
17,11,Bureau,2020,16363,15124,1239,7.6
17,13,Calhoun,2020,2228,2059,169,7.6
17,15,Carroll,2020,7376,6844,532,7.2
17,17,Cass,2020,5813,5426,387,6.7
17,19,Champaign,2020,108725,101732,6993,6.4
17,21,Christian,2020,13598,12497,1101,8.1
17,23,Clark,2020,7331,6752,579,7.9
17,25,Clay,2020,6231,5646,585,9.4
17,27,Clinton,2020,19796,18642,1154,5.8
17,29,Coles,2020,23148,21432,1716,7.4
17,31,Cook,2020,2539907,2258453,281454,11.1
17,33,Crawford,2020,8472,7882,590,7.0
17,35,Cumberland,2020,5944,5606,338,5.7
17,37,DeKalb,2020,53031,48678,4353,8.2
17,39,De Witt,2020,7120,6656,464,6.5
17,41,Douglas,2020,10036,9474,562,5.6
17,43,DuPage,2020,484215,445824,38391,7.9
17,45,Edgar,2020,8899,8311,588,6.6
17,47,Edwards,2020,2681,2462,219,8.2
17,49,Effingham,2020,19265,17988,1277,6.6
17,51,Fayette,2020,9700,8977,723,7.5
17,53,Ford,2020,6236,5834,402,6.4
17,55,Franklin,2020,15985,14299,1686,10.5
17,57,Fulton,2020,14615,13364,1251,8.6
17,59,Gallatin,2020,2032,1846,186,9.2
17,61,Greene,2020,5904,5522,382,6.5
17,63,Grundy,2020,24269,22138,2131,8.8
17,65,Hamilton,2020,4225,3944,281,6.7
17,67,Hancock,2020,8081,7521,560,6.9
17,69,Hardin,2020,1289,1171,118,9.2
17,71,Henderson,2020,3544,3298,246,6.9
17,73,Henry,2020,23925,22061,1864,7.8
17,75,Iroquois,2020,13582,12738,844,6.2
17,77,Jackson,2020,27251,25146,2105,7.7
17,79,Jasper,2020,4591,4315,276,6.0
17,81,Jefferson,2020,16993,15279,1714,10.1
17,83,Jersey,2020,10678,9883,795,7.4
17,85,Jo Daviess,2020,10426,9560,866,8.3
17,87,Johnson,2020,4098,3732,366,8.9
17,89,Kane,2020,261649,237738,23911,9.1
17,91,Kankakee,2020,53934,49164,4770,8.8
17,93,Kendall,2020,66386,60839,5547,8.4
17,95,Knox,2020,21110,19285,1825,8.6
17,97,Lake,2020,364544,335133,29411,8.1
17,99,LaSalle,2020,52663,47699,4964,9.4
17,101,Lawrence,2020,5781,5276,505,8.7
17,103,Lee,2020,17154,15982,1172,6.8
17,105,Livingston,2020,15909,14840,1069,6.7
17,107,Logan,2020,12122,11305,817,6.7
17,109,McDonough,2020,12819,11908,911,7.1
17,111,McHenry,2020,158406,145249,13157,8.3
17,113,McLean,2020,85103,79341,5762,6.8
17,115,Macon,2020,47177,42512,4665,9.9
17,117,Macoupin,2020,22119,20596,1523,6.9
17,119,Madison,2020,131452,121270,10182,7.7
17,121,Marion,2020,17114,15523,1591,9.3
17,123,Marshall,2020,5085,4710,375,7.4
17,125,Mason,2020,5916,5440,476,8.0
17,127,Massac,2020,5424,4883,541,10.0
17,129,Menard,2020,6101,5710,391,6.4
17,131,Mercer,2020,7689,7072,617,8.0
17,133,Monroe,2020,18386,17363,1023,5.6
17,135,Montgomery,2020,11453,10455,998,8.7
17,137,Morgan,2020,15873,14784,1089,6.9
17,139,Moultrie,2020,7292,6925,367,5.0
17,141,Ogle,2020,24161,22199,1962,8.1
17,143,Peoria,2020,83684,75016,8668,10.4
17,145,Perry,2020,8093,7330,763,9.4
17,147,Piatt,2020,8462,8009,453,5.4
17,149,Pike,2020,6753,6348,405,6.0
17,151,Pope,2020,1643,1513,130,7.9
17,153,Pulaski,2020,1768,1562,206,11.7
17,155,Putnam,2020,2942,2698,244,8.3
17,157,Randolph,2020,13764,12786,978,7.1
17,159,Richland,2020,7362,6864,498,6.8
17,161,Rock Island,2020,68915,62443,6472,9.4
17,163,St. Clair,2020,125155,113836,11319,9.0
17,165,Saline,2020,9534,8605,929,9.7
17,167,Sangamon,2020,96869,88916,7953,8.2
17,169,Schuyler,2020,3126,2933,193,6.2
17,171,Scott,2020,2349,2194,155,6.6
17,173,Shelby,2020,10256,9596,660,6.4
17,175,Stark,2020,2373,2200,173,7.3
17,177,Stephenson,2020,21106,19560,1546,7.3
17,179,Tazewell,2020,61977,56948,5029,8.1
17,181,Union,2020,7192,6610,582,8.1
17,183,Vermilion,2020,32542,29671,2871,8.8
17,185,Wabash,2020,5718,5242,476,8.3
17,187,Warren,2020,8085,7587,498,6.2
17,189,Washington,2020,9576,9072,504,5.3
17,191,Wayne,2020,6795,6230,565,8.3
17,193,White,2020,6137,5671,466,7.6
17,195,Whiteside,2020,27673,25461,2212,8.0
17,197,Will,2020,344335,311763,32572,9.5
17,199,Williamson,2020,31533,28794,2739,8.7
17,201,Winnebago,2020,135759,120253,15506,11.4
17,203,Woodford,2020,18012,16917,1095,6.1
18,1,Adams,2020,16771,15836,935,5.6
18,3,Allen,2020,184986,170783,14203,7.7
18,5,Bartholomew,2020,43802,40975,2827,6.5
18,7,Benton,2020,4268,4047,221,5.2
18,9,Blackford,2020,4826,4442,384,8.0
18,11,Boone,2020,35586,34064,1522,4.3
18,13,Brown,2020,7568,7062,506,6.7
18,15,Carroll,2020,9659,9076,583,6.0
18,17,Cass,2020,17551,16360,1191,6.8
18,19,Clark,2020,61138,56726,4412,7.2
18,21,Clay,2020,11450,10689,761,6.6
18,23,Clinton,2020,16825,15886,939,5.6
18,25,Crawford,2020,4849,4506,343,7.1
18,27,Daviess,2020,16523,15891,632,3.8
18,29,Dearborn,2020,25224,23482,1742,6.9
18,31,Decatur,2020,14928,13813,1115,7.5
18,33,DeKalb,2020,22116,20591,1525,6.9
18,35,Delaware,2020,52466,48633,3833,7.3
18,37,Dubois,2020,22595,21569,1026,4.5
18,39,Elkhart,2020,110494,102155,8339,7.5
18,41,Fayette,2020,8543,7700,843,9.9
18,43,Floyd,2020,41093,38422,2671,6.5
18,45,Fountain,2020,7752,7247,505,6.5
18,47,Franklin,2020,11270,10608,662,5.9
18,49,Fulton,2020,9680,9040,640,6.6
18,51,Gibson,2020,19537,18332,1205,6.2
18,53,Grant,2020,31534,29538,1996,6.3
18,55,Greene,2020,13264,12442,822,6.2
18,57,Hamilton,2020,182979,174455,8524,4.7
18,59,Hancock,2020,40363,38084,2279,5.6
18,61,Harrison,2020,19874,18626,1248,6.3
18,63,Hendricks,2020,89386,84885,4501,5.0
18,65,Henry,2020,21866,20424,1442,6.6
18,67,Howard,2020,36931,32921,4010,10.9
18,69,Huntington,2020,18032,16846,1186,6.6
18,71,Jackson,2020,23066,21416,1650,7.2
18,73,Jasper,2020,15583,14490,1093,7.0
18,75,Jay,2020,8801,8224,577,6.6
18,77,Jefferson,2020,14965,13858,1107,7.4
18,79,Jennings,2020,13582,12549,1033,7.6
18,81,Johnson,2020,82335,77712,4623,5.6
18,83,Knox,2020,18228,17148,1080,5.9
18,85,Kosciusko,2020,41420,38879,2541,6.1
18,87,LaGrange,2020,19178,17945,1233,6.4
18,89,Lake,2020,225185,201989,23196,10.3
18,91,LaPorte,2020,47444,42924,4520,9.5
18,93,Lawrence,2020,20687,19252,1435,6.9
18,95,Madison,2020,58758,54137,4621,7.9
18,97,Marion,2020,495063,456145,38918,7.9
18,99,Marshall,2020,22646,21190,1456,6.4
18,101,Martin,2020,5410,5181,229,4.2
18,103,Miami,2020,15009,13772,1237,8.2
18,105,Monroe,2020,68155,64390,3765,5.5
18,107,Montgomery,2020,18538,17580,958,5.2
18,109,Morgan,2020,35605,33693,1912,5.4
18,111,Newton,2020,6591,6139,452,6.9
18,113,Noble,2020,22709,20804,1905,8.4
18,115,Ohio,2020,3157,2924,233,7.4
18,117,Orange,2020,8499,7558,941,11.1
18,119,Owen,2020,9015,8447,568,6.3
18,121,Parke,2020,6844,6468,376,5.5
18,123,Perry,2020,9089,8495,594,6.5
18,125,Pike,2020,6144,5782,362,5.9
18,127,Porter,2020,83987,77220,6767,8.1
18,129,Posey,2020,12834,12202,632,4.9
18,131,Pulaski,2020,6395,6007,388,6.1
18,133,Putnam,2020,16336,15318,1018,6.2
18,135,Randolph,2020,11191,10456,735,6.6
18,137,Ripley,2020,13875,12991,884,6.4
18,139,Rush,2020,8738,8191,547,6.3
18,141,St. Joseph,2020,133385,122197,11188,8.4
18,143,Scott,2020,10484,9606,878,8.4
18,145,Shelby,2020,23086,21443,1643,7.1
18,147,Spencer,2020,10333,9754,579,5.6
18,149,Starke,2020,9730,8947,783,8.0
18,151,Steuben,2020,19915,18673,1242,6.2
18,153,Sullivan,2020,7903,7352,551,7.0
18,155,Switzerland,2020,4782,4394,388,8.1
18,157,Tippecanoe,2020,94147,88211,5936,6.3
18,159,Tipton,2020,9019,8465,554,6.1
18,161,Union,2020,3443,3254,189,5.5
18,163,Vanderburgh,2020,91573,85014,6559,7.2
18,165,Vermillion,2020,6590,6094,496,7.5
18,167,Vigo,2020,45814,42198,3616,7.9
18,169,Wabash,2020,14499,13615,884,6.1
18,171,Warren,2020,4001,3785,216,5.4
18,173,Warrick,2020,31654,29930,1724,5.4
18,175,Washington,2020,13465,12533,932,6.9
18,177,Wayne,2020,29989,27951,2038,6.8
18,179,Wells,2020,14006,13211,795,5.7
18,181,White,2020,13254,12586,668,5.0
18,183,Whitley,2020,17155,16139,1016,5.9
19,1,Adair,2020,4179,4013,166,4.0
19,3,Adams,2020,2029,1952,77,3.8
19,5,Allamakee,2020,7034,6675,359,5.1
19,7,Appanoose,2020,5914,5601,313,5.3
19,9,Audubon,2020,3011,2908,103,3.4
19,11,Benton,2020,12924,12272,652,5.0
19,13,Black Hawk,2020,67318,63173,4145,6.2
19,15,Boone,2020,14468,13880,588,4.1
19,17,Bremer,2020,13500,12967,533,3.9
19,19,Buchanan,2020,11095,10588,507,4.6
19,21,Buena Vista,2020,11643,11217,426,3.7
19,23,Butler,2020,7675,7317,358,4.7
19,25,Calhoun,2020,4096,3928,168,4.1
19,27,Carroll,2020,10546,10129,417,4.0
19,29,Cass,2020,6752,6489,263,3.9
19,31,Cedar,2020,10368,9915,453,4.4
19,33,Cerro Gordo,2020,23096,21893,1203,5.2
19,35,Cherokee,2020,6192,5958,234,3.8
19,37,Chickasaw,2020,6271,5976,295,4.7
19,39,Clarke,2020,4761,4504,257,5.4
19,41,Clay,2020,8336,7958,378,4.5
19,43,Clayton,2020,9703,9150,553,5.7
19,45,Clinton,2020,21989,20509,1480,6.7
19,47,Crawford,2020,7931,7515,416,5.2
19,49,Dallas,2020,49406,47621,1785,3.6
19,51,Davis,2020,4108,3943,165,4.0
19,53,Decatur,2020,4266,4104,162,3.8
19,55,Delaware,2020,10381,9969,412,4.0
19,57,Des Moines,2020,18609,17222,1387,7.5
19,59,Dickinson,2020,9752,9255,497,5.1
19,61,Dubuque,2020,54877,51666,3211,5.9
19,63,Emmet,2020,5047,4797,250,5.0
19,65,Fayette,2020,10299,9735,564,5.5
19,67,Floyd,2020,8250,7751,499,6.0
19,69,Franklin,2020,5597,5385,212,3.8
19,71,Fremont,2020,3712,3597,115,3.1
19,73,Greene,2020,5333,5107,226,4.2
19,75,Grundy,2020,6273,5999,274,4.4
19,77,Guthrie,2020,5409,5140,269,5.0
19,79,Hamilton,2020,6779,6480,299,4.4
19,81,Hancock,2020,5764,5495,269,4.7
19,83,Hardin,2020,7767,7407,360,4.6
19,85,Harrison,2020,7060,6776,284,4.0
19,87,Henry,2020,9564,9060,504,5.3
19,89,Howard,2020,5070,4844,226,4.5
19,91,Humboldt,2020,4939,4730,209,4.2
19,93,Ida,2020,3966,3824,142,3.6
19,95,Iowa,2020,10009,9565,444,4.4
19,97,Jackson,2020,10622,9975,647,6.1
19,99,Jasper,2020,19177,18157,1020,5.3
19,101,Jefferson,2020,9487,8948,539,5.7
19,103,Johnson,2020,84088,80056,4032,4.8
19,105,Jones,2020,10253,9669,584,5.7
19,107,Keokuk,2020,5151,4897,254,4.9
19,109,Kossuth,2020,8087,7779,308,3.8
19,111,Lee,2020,15693,14666,1027,6.5
19,113,Linn,2020,118853,111300,7553,6.4
19,115,Louisa,2020,5916,5623,293,5.0
19,117,Lucas,2020,4644,4475,169,3.6
19,119,Lyon,2020,6823,6652,171,2.5
19,121,Madison,2020,8347,7868,479,5.7
19,123,Mahaska,2020,11798,11237,561,4.8
19,125,Marion,2020,17933,17182,751,4.2
19,127,Marshall,2020,17514,16278,1236,7.1
19,129,Mills,2020,7150,6869,281,3.9
19,131,Mitchell,2020,6061,5856,205,3.4
19,133,Monona,2020,4347,4139,208,4.8
19,135,Monroe,2020,3938,3734,204,5.2
19,137,Montgomery,2020,4847,4621,226,4.7
19,139,Muscatine,2020,21053,19796,1257,6.0
19,141,O'Brien,2020,8058,7786,272,3.4
19,143,Osceola,2020,3498,3397,101,2.9
19,145,Page,2020,6186,5878,308,5.0
19,147,Palo Alto,2020,4540,4330,210,4.6
19,149,Plymouth,2020,14284,13770,514,3.6
19,151,Pocahontas,2020,4220,4072,148,3.5
19,153,Polk,2020,264807,248931,15876,6.0
19,155,Pottawattamie,2020,47249,44771,2478,5.2
19,157,Poweshiek,2020,9727,9247,480,4.9
19,159,Ringgold,2020,2377,2285,92,3.9
19,161,Sac,2020,5167,4986,181,3.5
19,163,Scott,2020,86403,80541,5862,6.8
19,165,Shelby,2020,6318,6090,228,3.6
19,167,Sioux,2020,20757,20199,558,2.7
19,169,Story,2020,56458,54422,2036,3.6
19,171,Tama,2020,9225,8753,472,5.1
19,173,Taylor,2020,3064,2952,112,3.7
19,175,Union,2020,6147,5786,361,5.9
19,177,Van Buren,2020,3667,3497,170,4.6
19,179,Wapello,2020,17328,16293,1035,6.0
19,181,Warren,2020,27577,26321,1256,4.6
19,183,Washington,2020,11490,11021,469,4.1
19,185,Wayne,2020,2783,2658,125,4.5
19,187,Webster,2020,18615,17638,977,5.2
19,189,Winnebago,2020,5025,4703,322,6.4
19,191,Winneshiek,2020,11095,10550,545,4.9
19,193,Woodbury,2020,54467,51606,2861,5.3
19,195,Worth,2020,4082,3861,221,5.4
19,197,Wright,2020,6960,6684,276,4.0
20,1,Allen,2020,6392,6045,347,5.4
20,3,Anderson,2020,4250,4075,175,4.1
20,5,Atchison,2020,6856,6385,471,6.9
20,7,Barber,2020,2324,2246,78,3.4
20,9,Barton,2020,13680,13046,634,4.6
20,11,Bourbon,2020,6747,6367,380,5.6
20,13,Brown,2020,5153,4923,230,4.5
20,15,Butler,2020,32533,30403,2130,6.5
20,17,Chase,2020,1465,1384,81,5.5
20,19,Chautauqua,2020,1482,1392,90,6.1
20,21,Cherokee,2020,10016,9494,522,5.2
20,23,Cheyenne,2020,1314,1285,29,2.2
20,25,Clark,2020,1145,1122,23,2.0
20,27,Clay,2020,3807,3636,171,4.5
20,29,Cloud,2020,3865,3708,157,4.1
20,31,Coffey,2020,3901,3697,204,5.2
20,33,Comanche,2020,860,830,30,3.5
20,35,Cowley,2020,16807,15709,1098,6.5
20,37,Crawford,2020,18947,17901,1046,5.5
20,39,Decatur,2020,1241,1195,46,3.7
20,41,Dickinson,2020,8873,8442,431,4.9
20,43,Doniphan,2020,4153,3965,188,4.5
20,45,Douglas,2020,64225,60337,3888,6.1
20,47,Edwards,2020,1465,1421,44,3.0
20,49,Elk,2020,1171,1115,56,4.8
20,51,Ellis,2020,16920,16328,592,3.5
20,53,Ellsworth,2020,2725,2636,89,3.3
20,55,Finney,2020,20618,19906,712,3.5
20,57,Ford,2020,17224,16640,584,3.4
20,59,Franklin,2020,14228,13459,769,5.4
20,61,Geary,2020,11652,10852,800,6.9
20,63,Gove,2020,1465,1423,42,2.9
20,65,Graham,2020,1126,1074,52,4.6
20,67,Grant,2020,3097,2970,127,4.1
20,69,Gray,2020,3244,3172,72,2.2
20,71,Greeley,2020,825,810,15,1.8
20,73,Greenwood,2020,3129,2965,164,5.2
20,75,Hamilton,2020,1633,1605,28,1.7
20,77,Harper,2020,2792,2668,124,4.4
20,79,Harvey,2020,16930,16030,900,5.3
20,81,Haskell,2020,2250,2197,53,2.4
20,83,Hodgeman,2020,1008,981,27,2.7
20,85,Jackson,2020,7213,6820,393,5.4
20,87,Jefferson,2020,10207,9708,499,4.9
20,89,Jewell,2020,1249,1210,39,3.1
20,91,Johnson,2020,342146,324544,17602,5.1
20,93,Kearny,2020,2035,1980,55,2.7
20,95,Kingman,2020,3343,3169,174,5.2
20,97,Kiowa,2020,1256,1215,41,3.3
20,99,Labette,2020,9667,9123,544,5.6
20,101,Lane,2020,755,733,22,2.9
20,103,Leavenworth,2020,36746,34611,2135,5.8
20,105,Lincoln,2020,1705,1655,50,2.9
20,107,Linn,2020,4379,4073,306,7.0
20,109,Logan,2020,1614,1573,41,2.5
20,111,Lyon,2020,16598,15808,790,4.8
20,113,McPherson,2020,17211,16612,599,3.5
20,115,Marion,2020,5913,5668,245,4.1
20,117,Marshall,2020,5504,5331,173,3.1
20,119,Meade,2020,2150,2090,60,2.8
20,121,Miami,2020,17681,16793,888,5.0
20,123,Mitchell,2020,3429,3335,94,2.7
20,125,Montgomery,2020,14852,13774,1078,7.3
20,127,Morris,2020,3079,2958,121,3.9
20,129,Morton,2020,1139,1105,34,3.0
20,131,Nemaha,2020,5596,5430,166,3.0
20,133,Neosho,2020,6246,5845,401,6.4
20,135,Ness,2020,1334,1288,46,3.4
20,137,Norton,2020,2644,2573,71,2.7
20,139,Osage,2020,8009,7600,409,5.1
20,141,Osborne,2020,1965,1908,57,2.9
20,143,Ottawa,2020,2978,2851,127,4.3
20,145,Pawnee,2020,2846,2739,107,3.8
20,147,Phillips,2020,2651,2560,91,3.4
20,149,Pottawatomie,2020,11981,11461,520,4.3
20,151,Pratt,2020,4926,4748,178,3.6
20,153,Rawlins,2020,1547,1508,39,2.5
20,155,Reno,2020,29626,27997,1629,5.5
20,157,Republic,2020,2318,2241,77,3.3
20,159,Rice,2020,5080,4865,215,4.2
20,161,Riley,2020,34049,32361,1688,5.0
20,163,Rooks,2020,2509,2408,101,4.0
20,165,Rush,2020,1576,1503,73,4.6
20,167,Russell,2020,3317,3177,140,4.2
20,169,Saline,2020,29511,27893,1618,5.5
20,171,Scott,2020,2826,2754,72,2.5
20,173,Sedgwick,2020,257217,234769,22448,8.7
20,175,Seward,2020,9816,9386,430,4.4
20,177,Shawnee,2020,91343,85910,5433,5.9
20,179,Sheridan,2020,1462,1429,33,2.3
20,181,Sherman,2020,2894,2795,99,3.4
20,183,Smith,2020,1996,1943,53,2.7
20,185,Stafford,2020,2043,1967,76,3.7
20,187,Stanton,2020,1080,1054,26,2.4
20,189,Stevens,2020,2807,2727,80,2.9
20,191,Sumner,2020,11017,10126,891,8.1
20,193,Thomas,2020,4230,4108,122,2.9
20,195,Trego,2020,1470,1419,51,3.5
20,197,Wabaunsee,2020,3677,3522,155,4.2
20,199,Wallace,2020,825,807,18,2.2
20,201,Washington,2020,3062,2986,76,2.5
20,203,Wichita,2020,1258,1232,26,2.1
20,205,Wilson,2020,3913,3609,304,7.8
20,207,Woodson,2020,1567,1474,93,5.9
20,209,Wyandotte,2020,78392,72303,6089,7.8
21,1,Adair,2020,6961,6460,501,7.2
21,3,Allen,2020,8732,8256,476,5.5
21,5,Anderson,2020,11752,11034,718,6.1
21,7,Ballard,2020,3356,3134,222,6.6
21,9,Barren,2020,18195,16829,1366,7.5
21,11,Bath,2020,4561,4182,379,8.3
21,13,Bell,2020,8248,7606,642,7.8
21,15,Boone,2020,70071,66280,3791,5.4
21,17,Bourbon,2020,9577,9016,561,5.9
21,19,Boyd,2020,17551,16086,1465,8.3
21,21,Boyle,2020,12540,11618,922,7.4
21,23,Bracken,2020,3744,3511,233,6.2
21,25,Breathitt,2020,3285,2949,336,10.2
21,27,Breckinridge,2020,7846,7274,572,7.3
21,29,Bullitt,2020,42031,39359,2672,6.4
21,31,Butler,2020,4961,4619,342,6.9
21,33,Caldwell,2020,5570,5224,346,6.2
21,35,Calloway,2020,17865,16752,1113,6.2
21,37,Campbell,2020,49647,46886,2761,5.6
21,39,Carlisle,2020,2168,2066,102,4.7
21,41,Carroll,2020,5289,4978,311,5.9
21,43,Carter,2020,9586,8663,923,9.6
21,45,Casey,2020,6666,6250,416,6.2
21,47,Christian,2020,24587,22662,1925,7.8
21,49,Clark,2020,17006,15891,1115,6.6
21,51,Clay,2020,5199,4751,448,8.6
21,53,Clinton,2020,3978,3776,202,5.1
21,55,Crittenden,2020,3663,3460,203,5.5
21,57,Cumberland,2020,3271,3112,159,4.9
21,59,Daviess,2020,45710,42911,2799,6.1
21,61,Edmonson,2020,4599,4247,352,7.7
21,63,Elliott,2020,1967,1769,198,10.1
21,65,Estill,2020,5153,4766,387,7.5
21,67,Fayette,2020,172284,162405,9879,5.7
21,69,Fleming,2020,6135,5686,449,7.3
21,71,Floyd,2020,10688,9705,983,9.2
21,73,Franklin,2020,24745,23117,1628,6.6
21,75,Fulton,2020,1983,1854,129,6.5
21,77,Gallatin,2020,4012,3771,241,6.0
21,79,Garrard,2020,7528,7055,473,6.3
21,81,Grant,2020,11525,10707,818,7.1
21,83,Graves,2020,15631,14701,930,5.9
21,85,Grayson,2020,10704,9873,831,7.8
21,87,Green,2020,5142,4866,276,5.4
21,89,Greenup,2020,13238,12064,1174,8.9
21,91,Hancock,2020,3808,3575,233,6.1
21,93,Hardin,2020,47581,44196,3385,7.1
21,95,Harlan,2020,6548,5768,780,11.9
21,97,Harrison,2020,8712,8177,535,6.1
21,99,Hart,2020,7694,7198,496,6.4
21,101,Henderson,2020,20921,19643,1278,6.1
21,103,Henry,2020,8071,7611,460,5.7
21,105,Hickman,2020,1720,1625,95,5.5
21,107,Hopkins,2020,18149,16815,1334,7.4
21,109,Jackson,2020,4051,3700,351,8.7
21,111,Jefferson,2020,390487,363770,26717,6.8
21,113,Jessamine,2020,26160,24689,1471,5.6
21,115,Johnson,2020,6589,6016,573,8.7
21,117,Kenton,2020,86062,81077,4985,5.8
21,119,Knott,2020,4350,3979,371,8.5
21,121,Knox,2020,9962,9143,819,8.2
21,123,Larue,2020,5838,5417,421,7.2
21,125,Laurel,2020,24857,23130,1727,6.9
21,127,Lawrence,2020,5217,4784,433,8.3
21,129,Lee,2020,2047,1904,143,7.0
21,131,Leslie,2020,2628,2344,284,10.8
21,133,Letcher,2020,6111,5488,623,10.2
21,135,Lewis,2020,4648,4205,443,9.5
21,137,Lincoln,2020,9317,8578,739,7.9
21,139,Livingston,2020,3534,3268,266,7.5
21,141,Logan,2020,12136,11466,670,5.5
21,143,Lyon,2020,3095,2931,164,5.3
21,145,McCracken,2020,28486,26435,2051,7.2
21,147,McCreary,2020,4807,4457,350,7.3
21,149,McLean,2020,4023,3796,227,5.6
21,151,Madison,2020,45855,43091,2764,6.0
21,153,Magoffin,2020,3208,2692,516,16.1
21,155,Marion,2020,9233,8515,718,7.8
21,157,Marshall,2020,14831,13919,912,6.1
21,159,Martin,2020,2498,2208,290,11.6
21,161,Mason,2020,6909,6358,551,8.0
21,163,Meade,2020,11749,10913,836,7.1
21,165,Menifee,2020,2256,2055,201,8.9
21,167,Mercer,2020,9907,9187,720,7.3
21,169,Metcalfe,2020,4017,3704,313,7.8
21,171,Monroe,2020,4564,4318,246,5.4
21,173,Montgomery,2020,11355,10450,905,8.0
21,175,Morgan,2020,4352,4052,300,6.9
21,177,Muhlenberg,2020,10004,9138,866,8.7
21,179,Nelson,2020,22755,21185,1570,6.9
21,181,Nicholas,2020,3275,3053,222,6.8
21,183,Ohio,2020,9289,8620,669,7.2
21,185,Oldham,2020,32438,30867,1571,4.8
21,187,Owen,2020,5082,4757,325,6.4
21,189,Owsley,2020,1061,982,79,7.4
21,191,Pendleton,2020,6803,6447,356,5.2
21,193,Perry,2020,8181,7453,728,8.9
21,195,Pike,2020,19196,17574,1622,8.4
21,197,Powell,2020,5070,4698,372,7.3
21,199,Pulaski,2020,25795,23907,1888,7.3
21,201,Robertson,2020,788,740,48,6.1
21,203,Rockcastle,2020,6428,5971,457,7.1
21,205,Rowan,2020,9932,9191,741,7.5
21,207,Russell,2020,6085,5586,499,8.2
21,209,Scott,2020,29378,27523,1855,6.3
21,211,Shelby,2020,25191,23817,1374,5.5
21,213,Simpson,2020,8596,7979,617,7.2
21,215,Spencer,2020,10254,9662,592,5.8
21,217,Taylor,2020,12935,12160,775,6.0
21,219,Todd,2020,5391,5131,260,4.8
21,221,Trigg,2020,6030,5611,419,6.9
21,223,Trimble,2020,3789,3533,256,6.8
21,225,Union,2020,5939,5562,377,6.3
21,227,Warren,2020,63256,59108,4148,6.6
21,229,Washington,2020,6099,5718,381,6.2
21,231,Wayne,2020,7370,6888,482,6.5
21,233,Webster,2020,5424,5077,347,6.4
21,235,Whitley,2020,13784,12801,983,7.1
21,237,Wolfe,2020,2059,1901,158,7.7
21,239,Woodford,2020,14929,14182,747,5.0
22,1,Acadia Parish,2020,23463,21758,1705,7.3
22,3,Allen Parish,2020,8460,7682,778,9.2
22,5,Ascension Parish,2020,64136,59807,4329,6.7
22,7,Assumption Parish,2020,8822,7929,893,10.1
22,9,Avoyelles Parish,2020,15048,13846,1202,8.0
22,11,Beauregard Parish,2020,14405,13444,961,6.7
22,13,Bienville Parish,2020,5417,4999,418,7.7
22,15,Bossier Parish,2020,56750,53138,3612,6.4
22,17,Caddo Parish,2020,102615,93384,9231,9.0
22,19,Calcasieu Parish,2020,98110,89236,8874,9.0
22,21,Caldwell Parish,2020,3670,3403,267,7.3
22,23,Cameron Parish,2020,3520,3318,202,5.7
22,25,Catahoula Parish,2020,3495,3248,247,7.1
22,27,Claiborne Parish,2020,5495,5133,362,6.6
22,29,Concordia Parish,2020,6949,6385,564,8.1
22,31,De Soto Parish,2020,10623,9852,771,7.3
22,33,East Baton Rouge Parish,2020,228974,211197,17777,7.8
22,35,East Carroll Parish,2020,1824,1610,214,11.7
22,37,East Feliciana Parish,2020,7762,7244,518,6.7
22,39,Evangeline Parish,2020,11933,11013,920,7.7
22,41,Franklin Parish,2020,7380,6783,597,8.1
22,43,Grant Parish,2020,8168,7635,533,6.5
22,45,Iberia Parish,2020,27907,25284,2623,9.4
22,47,Iberville Parish,2020,13975,12601,1374,9.8
22,49,Jackson Parish,2020,6738,6378,360,5.3
22,51,Jefferson Parish,2020,211563,191934,19629,9.3
22,53,Jefferson Davis Parish,2020,12827,11863,964,7.5
22,55,Lafayette Parish,2020,113811,105742,8069,7.1
22,57,Lafourche Parish,2020,41475,38786,2689,6.5
22,59,LaSalle Parish,2020,6912,6584,328,4.7
22,61,Lincoln Parish,2020,20927,19613,1314,6.3
22,63,Livingston Parish,2020,68265,63874,4391,6.4
22,65,Madison Parish,2020,3573,3272,301,8.4
22,67,Morehouse Parish,2020,10096,9102,994,9.8
22,69,Natchitoches Parish,2020,16129,15028,1101,6.8
22,71,Orleans Parish,2020,181868,159734,22134,12.2
22,73,Ouachita Parish,2020,69823,64663,5160,7.4
22,75,Plaquemines Parish,2020,9649,8971,678,7.0
22,77,Pointe Coupee Parish,2020,9638,8888,750,7.8
22,79,Rapides Parish,2020,55157,51714,3443,6.2
22,81,Red River Parish,2020,3612,3389,223,6.2
22,83,Richland Parish,2020,8139,7518,621,7.6
22,85,Sabine Parish,2020,9236,8730,506,5.5
22,87,St. Bernard Parish,2020,20022,17984,2038,10.2
22,89,St. Charles Parish,2020,24644,22715,1929,7.8
22,91,St. Helena Parish,2020,4299,3805,494,11.5
22,93,St. James Parish,2020,9058,8176,882,9.7
22,95,St. John the Baptist Parish,2020,19473,17294,2179,11.2
22,97,St. Landry Parish,2020,32418,29611,2807,8.7
22,99,St. Martin Parish,2020,22057,20268,1789,8.1
22,101,St. Mary Parish,2020,19516,17722,1794,9.2
22,103,St. Tammany Parish,2020,116466,108590,7876,6.8
22,105,Tangipahoa Parish,2020,56389,51012,5377,9.5
22,107,Tensas Parish,2020,1359,1245,114,8.4
22,109,Terrebonne Parish,2020,46224,42663,3561,7.7
22,111,Union Parish,2020,8970,8330,640,7.1
22,113,Vermilion Parish,2020,23746,21993,1753,7.4
22,115,Vernon Parish,2020,15795,14677,1118,7.1
22,117,Washington Parish,2020,16660,15299,1361,8.2
22,119,Webster Parish,2020,14088,12977,1111,7.9
22,121,West Baton Rouge Parish,2020,13502,12530,972,7.2
22,123,West Carroll Parish,2020,3637,3270,367,10.1
22,125,West Feliciana Parish,2020,5276,4989,287,5.4
22,127,Winn Parish,2020,4709,4377,332,7.1
23,1,Androscoggin,2020,54470,51486,2984,5.5
23,3,Aroostook,2020,29255,27642,1613,5.5
23,5,Cumberland,2020,160863,152368,8495,5.3
23,7,Franklin,2020,13795,12956,839,6.1
23,9,Hancock,2020,27648,26059,1589,5.7
23,11,Kennebec,2020,61376,58332,3044,5.0
23,13,Knox,2020,19535,18481,1054,5.4
23,15,Lincoln,2020,16386,15516,870,5.3
23,17,Oxford,2020,25815,24097,1718,6.7
23,19,Penobscot,2020,74717,70710,4007,5.4
23,21,Piscataquis,2020,7151,6760,391,5.5
23,23,Sagadahoc,2020,19259,18348,911,4.7
23,25,Somerset,2020,22024,20563,1461,6.6
23,27,Waldo,2020,19961,18933,1028,5.2
23,29,Washington,2020,13408,12575,833,6.2
23,31,York,2020,110884,104935,5949,5.4
24,1,Allegany,2020,30835,28437,2398,7.8
24,3,Anne Arundel,2020,310413,292309,18104,5.8
24,5,Baltimore,2020,445695,415263,30432,6.8
24,9,Calvert,2020,48543,46006,2537,5.2
24,11,Caroline,2020,17436,16469,967,5.5
24,13,Carroll,2020,93073,88333,4740,5.1
24,15,Cecil,2020,52083,48988,3095,5.9
24,17,Charles,2020,86099,80309,5790,6.7
24,19,Dorchester,2020,15990,14923,1067,6.7
24,21,Frederick,2020,132867,124969,7898,5.9
24,23,Garrett,2020,15274,14261,1013,6.6
24,25,Harford,2020,138337,130336,8001,5.8
24,27,Howard,2020,184474,174916,9558,5.2
24,29,Kent,2020,9664,9026,638,6.6
24,31,Montgomery,2020,548398,513663,34735,6.3
24,33,Prince George's,2020,504276,462879,41397,8.2
24,35,Queen Anne's,2020,27202,25712,1490,5.5
24,37,St. Mary's,2020,57281,54513,2768,4.8
24,39,Somerset,2020,8720,7996,724,8.3
24,41,Talbot,2020,17776,16707,1069,6.0
24,43,Washington,2020,72703,67799,4904,6.7
24,45,Wicomico,2020,49403,45722,3681,7.5
24,47,Worcester,2020,25069,22270,2799,11.2
24,510,Baltimore city,2020,281187,256482,24705,8.8
25,1,Barnstable,2020,108128,97073,11055,10.2
25,3,Berkshire,2020,61645,56016,5629,9.1
25,5,Bristol,2020,293532,263456,30076,10.2
25,7,Dukes,2020,9517,8640,877,9.2
25,9,Essex,2020,414660,374075,40585,9.8
25,11,Franklin,2020,39501,36565,2936,7.4
25,13,Hampden,2020,220259,197372,22887,10.4
25,15,Hampshire,2020,85661,79477,6184,7.2
25,17,Middlesex,2020,882398,818205,64193,7.3
25,19,Nantucket/town,2020,7664,6873,791,10.3
25,21,Norfolk,2020,380061,348328,31733,8.3
25,23,Plymouth,2020,276733,250579,26154,9.5
25,25,Suffolk,2020,446558,403388,43170,9.7
25,27,Worcester,2020,432005,394081,37924,8.8
26,1,Alcona,2020,3861,3479,382,9.9
26,3,Alger,2020,3147,2809,338,10.7
26,5,Allegan,2020,62253,57710,4543,7.3
26,7,Alpena,2020,13245,12224,1021,7.7
26,9,Antrim,2020,10207,9213,994,9.7
26,11,Arenac,2020,5909,5234,675,11.4
26,13,Baraga,2020,3163,2793,370,11.7
26,15,Barry,2020,31350,29033,2317,7.4
26,17,Bay,2020,49573,45009,4564,9.2
26,19,Benzie,2020,8655,7838,817,9.4
26,21,Berrien,2020,72765,66476,6289,8.6
26,23,Branch,2020,19739,18148,1591,8.1
26,25,Calhoun,2020,61838,55844,5994,9.7
26,27,Cass,2020,24470,22327,2143,8.8
26,29,Charlevoix,2020,12649,11405,1244,9.8
26,31,Cheboygan,2020,10277,8779,1498,14.6
26,33,Chippewa,2020,16121,14684,1437,8.9
26,35,Clare,2020,11798,10440,1358,11.5
26,37,Clinton,2020,40089,37463,2626,6.6
26,39,Crawford,2020,5660,5070,590,10.4
26,41,Delta,2020,16948,15466,1482,8.7
26,43,Dickinson,2020,12206,11347,859,7.0
26,45,Eaton,2020,56112,51803,4309,7.7
26,47,Emmet,2020,17219,15415,1804,10.5
26,49,Genesee,2020,179933,159859,20074,11.2
26,51,Gladwin,2020,9876,8915,961,9.7
26,53,Gogebic,2020,5852,5402,450,7.7
26,55,Grand Traverse,2020,48974,44869,4105,8.4
26,57,Gratiot,2020,17927,16497,1430,8.0
26,59,Hillsdale,2020,20088,18261,1827,9.1
26,61,Houghton,2020,15945,14789,1156,7.2
26,63,Huron,2020,15554,14231,1323,8.5
26,65,Ingham,2020,146960,136006,10954,7.5
26,67,Ionia,2020,30414,28000,2414,7.9
26,69,Iosco,2020,10152,9089,1063,10.5
26,71,Iron,2020,4985,4581,404,8.1
26,73,Isabella,2020,33122,30354,2768,8.4
26,75,Jackson,2020,74075,67407,6668,9.0
26,77,Kalamazoo,2020,131618,122130,9488,7.2
26,79,Kalkaska,2020,7904,7029,875,11.1
26,81,Kent,2020,357123,330032,27091,7.6
26,83,Keweenaw,2020,884,805,79,8.9
26,85,Lake,2020,3989,3560,429,10.8
26,87,Lapeer,2020,40138,35123,5015,12.5
26,89,Leelanau,2020,10261,9445,816,8.0
26,91,Lenawee,2020,45597,41492,4105,9.0
26,93,Livingston,2020,99598,90819,8779,8.8
26,95,Luce,2020,2257,2063,194,8.6
26,97,Mackinac,2020,5003,4335,668,13.4
26,99,Macomb,2020,439510,386942,52568,12.0
26,101,Manistee,2020,10270,9164,1106,10.8
26,103,Marquette,2020,31758,29121,2637,8.3
26,105,Mason,2020,13374,12142,1232,9.2
26,107,Mecosta,2020,18415,16740,1675,9.1
26,109,Menominee,2020,10694,10008,686,6.4
26,111,Midland,2020,39706,36742,2964,7.5
26,113,Missaukee,2020,6923,6291,632,9.1
26,115,Monroe,2020,74397,67764,6633,8.9
26,117,Montcalm,2020,28133,25578,2555,9.1
26,119,Montmorency,2020,3021,2624,397,13.1
26,121,Muskegon,2020,77540,68681,8859,11.4
26,123,Newaygo,2020,23340,21319,2021,8.7
26,125,Oakland,2020,648742,588572,60170,9.3
26,127,Oceana,2020,12024,10783,1241,10.3
26,129,Ogemaw,2020,8048,7167,881,10.9
26,131,Ontonagon,2020,2053,1841,212,10.3
26,133,Osceola,2020,11606,10641,965,8.3
26,135,Oscoda,2020,2910,2563,347,11.9
26,137,Otsego,2020,11651,10455,1196,10.3
26,139,Ottawa,2020,158936,148077,10859,6.8
26,141,Presque Isle,2020,4951,4402,549,11.1
26,143,Roscommon,2020,7835,6885,950,12.1
26,145,Saginaw,2020,84807,76397,8410,9.9
26,147,St. Clair,2020,73897,65042,8855,12.0
26,149,St. Joseph,2020,29052,26418,2634,9.1
26,151,Sanilac,2020,19541,17641,1900,9.7
26,153,Schoolcraft,2020,3248,2934,314,9.7
26,155,Shiawassee,2020,32859,29839,3020,9.2
26,157,Tuscola,2020,23739,21344,2395,10.1
26,159,Van Buren,2020,34835,31932,2903,8.3
26,161,Washtenaw,2020,193659,181294,12365,6.4
26,163,Wayne,2020,796974,686888,110086,13.8
26,165,Wexford,2020,14918,13402,1516,10.2
27,1,Aitkin,2020,7487,6884,603,8.1
27,3,Anoka,2020,198304,185714,12590,6.3
27,5,Becker,2020,18817,17644,1173,6.2
27,7,Beltrami,2020,24865,23306,1559,6.3
27,9,Benton,2020,22062,20597,1465,6.6
27,11,Big Stone,2020,2517,2398,119,4.7
27,13,Blue Earth,2020,40363,38182,2181,5.4
27,15,Brown,2020,14270,13539,731,5.1
27,17,Carlton,2020,17715,16435,1280,7.2
27,19,Carver,2020,58673,55626,3047,5.2
27,21,Cass,2020,14206,12905,1301,9.2
27,23,Chippewa,2020,6779,6435,344,5.1
27,25,Chisago,2020,30083,28103,1980,6.6
27,27,Clay,2020,36323,34762,1561,4.3
27,29,Clearwater,2020,4507,4084,423,9.4
27,31,Cook,2020,2948,2699,249,8.4
27,33,Cottonwood,2020,6265,5974,291,4.6
27,35,Crow Wing,2020,32291,29954,2337,7.2
27,37,Dakota,2020,242394,227375,15019,6.2
27,39,Dodge,2020,12042,11395,647,5.4
27,41,Douglas,2020,21271,20252,1019,4.8
27,43,Faribault,2020,7087,6651,436,6.2
27,45,Fillmore,2020,11654,11069,585,5.0
27,47,Freeborn,2020,16258,15344,914,5.6
27,49,Goodhue,2020,26659,25099,1560,5.9
27,51,Grant,2020,3337,3161,176,5.3
27,53,Hennepin,2020,710270,663738,46532,6.6
27,55,Houston,2020,10311,9869,442,4.3
27,57,Hubbard,2020,9907,9207,700,7.1
27,59,Isanti,2020,21430,19976,1454,6.8
27,61,Itasca,2020,22100,20240,1860,8.4
27,63,Jackson,2020,5772,5493,279,4.8
27,65,Kanabec,2020,9109,8380,729,8.0
27,67,Kandiyohi,2020,24696,23512,1184,4.8
27,69,Kittson,2020,2411,2300,111,4.6
27,71,Koochiching,2020,5796,5367,429,7.4
27,73,Lac qui Parle,2020,3529,3363,166,4.7
27,75,Lake,2020,5273,4889,384,7.3
27,77,Lake of the Woods,2020,2442,2292,150,6.1
27,79,Le Sueur,2020,16186,15092,1094,6.8
27,81,Lincoln,2020,3125,2986,139,4.4
27,83,Lyon,2020,14364,13719,645,4.5
27,85,McLeod,2020,19236,18145,1091,5.7
27,87,Mahnomen,2020,2198,1912,286,13.0
27,89,Marshall,2020,5451,5098,353,6.5
27,91,Martin,2020,9994,9474,520,5.2
27,93,Meeker,2020,13251,12567,684,5.2
27,95,Mille Lacs,2020,12937,11847,1090,8.4
27,97,Morrison,2020,17936,16724,1212,6.8
27,99,Mower,2020,20929,19889,1040,5.0
27,101,Murray,2020,4834,4589,245,5.1
27,103,Nicollet,2020,20752,19755,997,4.8
27,105,Nobles,2020,11602,11114,488,4.2
27,107,Norman,2020,3287,3079,208,6.3
27,109,Olmsted,2020,91030,86093,4937,5.4
27,111,Otter Tail,2020,31488,29790,1698,5.4
27,113,Pennington,2020,8663,8130,533,6.2
27,115,Pine,2020,14581,13326,1255,8.6
27,117,Pipestone,2020,4670,4481,189,4.0
27,119,Polk,2020,16403,15485,918,5.6
27,121,Pope,2020,6512,6222,290,4.5
27,123,Ramsey,2020,290181,270117,20064,6.9
27,125,Red Lake,2020,2230,2087,143,6.4
27,127,Redwood,2020,7782,7352,430,5.5
27,129,Renville,2020,8598,8122,476,5.5
27,131,Rice,2020,37193,35242,1951,5.2
27,133,Rock,2020,5808,5632,176,3.0
27,135,Roseau,2020,7917,7462,455,5.7
27,137,St. Louis,2020,101110,93824,7286,7.2
27,139,Scott,2020,83897,78940,4957,5.9
27,141,Sherburne,2020,52434,49247,3187,6.1
27,143,Sibley,2020,8373,7912,461,5.5
27,145,Stearns,2020,90863,85650,5213,5.7
27,147,Steele,2020,20330,19218,1112,5.5
27,149,Stevens,2020,5446,5269,177,3.3
27,151,Swift,2020,4881,4599,282,5.8
27,153,Todd,2020,13786,13057,729,5.3
27,155,Traverse,2020,1753,1676,77,4.4
27,157,Wabasha,2020,12439,11780,659,5.3
27,159,Wadena,2020,6024,5564,460,7.6
27,161,Waseca,2020,9081,8515,566,6.2
27,163,Washington,2020,143583,135509,8074,5.6
27,165,Watonwan,2020,6664,6356,308,4.6
27,167,Wilkin,2020,3458,3316,142,4.1
27,169,Winona,2020,28193,26800,1393,4.9
27,171,Wright,2020,75721,71523,4198,5.5
27,173,Yellow Medicine,2020,5314,5069,245,4.6
28,1,Adams,2020,10609,9441,1168,11.0
28,3,Alcorn,2020,15419,14458,961,6.2
28,5,Amite,2020,4460,4084,376,8.4
28,7,Attala,2020,6977,6397,580,8.3
28,9,Benton,2020,2995,2745,250,8.3
28,11,Bolivar,2020,11537,10531,1006,8.7
28,13,Calhoun,2020,5598,5146,452,8.1
28,15,Carroll,2020,3462,3195,267,7.7
28,17,Chickasaw,2020,6964,6207,757,10.9
28,19,Choctaw,2020,3601,3370,231,6.4
28,21,Claiborne,2020,3105,2657,448,14.4
28,23,Clarke,2020,5846,5355,491,8.4
28,25,Clay,2020,7946,7021,925,11.6
28,27,Coahoma,2020,8362,7314,1048,12.5
28,29,Copiah,2020,10759,9871,888,8.3
28,31,Covington,2020,8379,7803,576,6.9
28,33,DeSoto,2020,90498,85029,5469,6.0
28,35,Forrest,2020,32983,30328,2655,8.0
28,37,Franklin,2020,2770,2541,229,8.3
28,39,George,2020,9013,8195,818,9.1
28,41,Greene,2020,4337,3917,420,9.7
28,43,Grenada,2020,9305,8638,667,7.2
28,45,Hancock,2020,18692,17106,1586,8.5
28,47,Harrison,2020,87410,79148,8262,9.5
28,49,Hinds,2020,104391,94636,9755,9.3
28,51,Holmes,2020,5530,4634,896,16.2
28,53,Humphreys,2020,2225,1897,328,14.7
28,55,Issaquena,2020,338,307,31,9.2
28,57,Itawamba,2020,10343,9621,722,7.0
28,59,Jackson,2020,58435,52868,5567,9.5
28,61,Jasper,2020,6094,5551,543,8.9
28,63,Jefferson,2020,1989,1623,366,18.4
28,65,Jefferson Davis,2020,4022,3636,386,9.6
28,67,Jones,2020,25621,23813,1808,7.1
28,69,Kemper,2020,3423,3093,330,9.6
28,71,Lafayette,2020,26570,24955,1615,6.1
28,73,Lamar,2020,30544,28709,1835,6.0
28,75,Lauderdale,2020,29638,27416,2222,7.5
28,77,Lawrence,2020,4683,4276,407,8.7
28,79,Leake,2020,8058,7424,634,7.9
28,81,Lee,2020,41347,37985,3362,8.1
28,83,Leflore,2020,9873,8816,1057,10.7
28,85,Lincoln,2020,14553,13484,1069,7.3
28,87,Lowndes,2020,25123,23038,2085,8.3
28,89,Madison,2020,52376,48927,3449,6.6
28,91,Marion,2020,10178,9459,719,7.1
28,93,Marshall,2020,14119,13053,1066,7.6
28,95,Monroe,2020,15692,14297,1395,8.9
28,97,Montgomery,2020,3926,3610,316,8.0
28,99,Neshoba,2020,10382,9415,967,9.3
28,101,Newton,2020,8010,7374,636,7.9
28,103,Noxubee,2020,3888,3459,429,11.0
28,105,Oktibbeha,2020,22096,20414,1682,7.6
28,107,Panola,2020,12739,11488,1251,9.8
28,109,Pearl River,2020,23200,21502,1698,7.3
28,111,Perry,2020,4245,3876,369,8.7
28,113,Pike,2020,14674,13366,1308,8.9
28,115,Pontotoc,2020,14911,13755,1156,7.8
28,117,Prentiss,2020,11207,10428,779,7.0
28,119,Quitman,2020,2355,2099,256,10.9
28,121,Rankin,2020,74377,70428,3949,5.3
28,123,Scott,2020,12681,11942,739,5.8
28,125,Sharkey,2020,1475,1314,161,10.9
28,127,Simpson,2020,10445,9730,715,6.8
28,129,Smith,2020,6631,6248,383,5.8
28,131,Stone,2020,7012,6483,529,7.5
28,133,Sunflower,2020,7491,6651,840,11.2
28,135,Tallahatchie,2020,5197,4810,387,7.4
28,137,Tate,2020,11990,11070,920,7.7
28,139,Tippah,2020,9394,8739,655,7.0
28,141,Tishomingo,2020,8399,7849,550,6.5
28,143,Tunica,2020,4590,3908,682,14.9
28,145,Union,2020,14156,13150,1006,7.1
28,147,Walthall,2020,4997,4575,422,8.4
28,149,Warren,2020,20215,18448,1767,8.7
28,151,Washington,2020,16182,14397,1785,11.0
28,153,Wayne,2020,7494,6843,651,8.7
28,155,Webster,2020,3891,3603,288,7.4
28,157,Wilkinson,2020,2777,2406,371,13.4
28,159,Winston,2020,7360,6723,637,8.7
28,161,Yalobusha,2020,4900,4513,387,7.9
28,163,Yazoo,2020,9877,8917,960,9.7
29,1,Adair,2020,10086,9572,514,5.1
29,3,Andrew,2020,9749,9355,394,4.0
29,5,Atchison,2020,2744,2634,110,4.0
29,7,Audrain,2020,10339,9728,611,5.9
29,9,Barry,2020,15692,14673,1019,6.5
29,11,Barton,2020,5187,4931,256,4.9
29,13,Bates,2020,7662,7255,407,5.3
29,15,Benton,2020,7235,6709,526,7.3
29,17,Bollinger,2020,5409,5105,304,5.6
29,19,Boone,2020,96381,92311,4070,4.2
29,21,Buchanan,2020,43827,41667,2160,4.9
29,23,Butler,2020,18183,17032,1151,6.3
29,25,Caldwell,2020,4279,4050,229,5.4
29,27,Callaway,2020,21366,20410,956,4.5
29,29,Camden,2020,18829,17502,1327,7.0
29,31,Cape Girardeau,2020,40333,38254,2079,5.2
29,33,Carroll,2020,4680,4397,283,6.0
29,35,Carter,2020,2524,2359,165,6.5
29,37,Cass,2020,54079,51203,2876,5.3
29,39,Cedar,2020,5734,5478,256,4.5
29,41,Chariton,2020,3781,3628,153,4.0
29,43,Christian,2020,45241,43008,2233,4.9
29,45,Clark,2020,3169,2979,190,6.0
29,47,Clay,2020,136568,128194,8374,6.1
29,49,Clinton,2020,10564,9936,628,5.9
29,51,Cole,2020,39151,37432,1719,4.4
29,53,Cooper,2020,7219,6818,401,5.6
29,55,Crawford,2020,10852,10157,695,6.4
29,57,Dade,2020,3560,3405,155,4.4
29,59,Dallas,2020,7034,6620,414,5.9
29,61,Daviess,2020,4123,3948,175,4.2
29,63,DeKalb,2020,4791,4585,206,4.3
29,65,Dent,2020,6351,6045,306,4.8
29,67,Douglas,2020,5167,4768,399,7.7
29,69,Dunklin,2020,11562,10718,844,7.3
29,71,Franklin,2020,52661,49396,3265,6.2
29,73,Gasconade,2020,7606,7168,438,5.8
29,75,Gentry,2020,3405,3289,116,3.4
29,77,Greene,2020,150766,142704,8062,5.3
29,79,Grundy,2020,4333,4134,199,4.6
29,81,Harrison,2020,3811,3639,172,4.5
29,83,Henry,2020,9673,9106,567,5.9
29,85,Hickory,2020,3879,3683,196,5.1
29,87,Holt,2020,2578,2491,87,3.4
29,89,Howard,2020,4822,4622,200,4.1
29,91,Howell,2020,16201,15118,1083,6.7
29,93,Iron,2020,3500,3254,246,7.0
29,95,Jackson,2020,360213,334471,25742,7.1
29,97,Jasper,2020,56154,52968,3186,5.7
29,99,Jefferson,2020,116774,109655,7119,6.1
29,101,Johnson,2020,23108,21796,1312,5.7
29,103,Knox,2020,1757,1686,71,4.0
29,105,Laclede,2020,16731,15343,1388,8.3
29,107,Lafayette,2020,16582,15711,871,5.3
29,109,Lawrence,2020,17672,16599,1073,6.1
29,111,Lewis,2020,4966,4723,243,4.9
29,113,Lincoln,2020,28723,26926,1797,6.3
29,115,Linn,2020,5093,4781,312,6.1
29,117,Livingston,2020,7389,7107,282,3.8
29,119,McDonald,2020,10578,10052,526,5.0
29,121,Macon,2020,7435,7079,356,4.8
29,123,Madison,2020,5475,5117,358,6.5
29,125,Maries,2020,3909,3720,189,4.8
29,127,Marion,2020,14299,13612,687,4.8
29,129,Mercer,2020,1889,1821,68,3.6
29,131,Miller,2020,12308,11547,761,6.2
29,133,Mississippi,2020,5701,5396,305,5.3
29,135,Moniteau,2020,7368,7055,313,4.2
29,137,Monroe,2020,3789,3564,225,5.9
29,139,Montgomery,2020,5750,5464,286,5.0
29,141,Morgan,2020,8273,7755,518,6.3
29,143,New Madrid,2020,8483,7991,492,5.8
29,145,Newton,2020,26732,25179,1553,5.8
29,147,Nodaway,2020,10722,10232,490,4.6
29,149,Oregon,2020,3938,3673,265,6.7
29,151,Osage,2020,7078,6824,254,3.6
29,153,Ozark,2020,3467,3216,251,7.2
29,155,Pemiscot,2020,6271,5770,501,8.0
29,157,Perry,2020,9826,9264,562,5.7
29,159,Pettis,2020,20626,19218,1408,6.8
29,161,Phelps,2020,19776,18833,943,4.8
29,163,Pike,2020,7549,7137,412,5.5
29,165,Platte,2020,58458,55275,3183,5.4
29,167,Polk,2020,14331,13661,670,4.7
29,169,Pulaski,2020,14583,13761,822,5.6
29,171,Putnam,2020,2275,2175,100,4.4
29,173,Ralls,2020,5627,5376,251,4.5
29,175,Randolph,2020,10210,9605,605,5.9
29,177,Ray,2020,10966,10213,753,6.9
29,179,Reynolds,2020,2922,2756,166,5.7
29,181,Ripley,2020,4987,4593,394,7.9
29,183,St. Charles,2020,224521,212786,11735,5.2
29,185,St. Clair,2020,3764,3534,230,6.1
29,186,Ste. Genevieve,2020,9239,8782,457,4.9
29,187,St. Francois,2020,26414,24562,1852,7.0
29,189,St. Louis,2020,524721,491901,32820,6.3
29,195,Saline,2020,10597,10118,479,4.5
29,197,Schuyler,2020,1961,1849,112,5.7
29,199,Scotland,2020,2393,2315,78,3.3
29,201,Scott,2020,19872,18814,1058,5.3
29,203,Shannon,2020,3343,3098,245,7.3
29,205,Shelby,2020,3047,2911,136,4.5
29,207,Stoddard,2020,13238,12450,788,6.0
29,209,Stone,2020,13120,11836,1284,9.8
29,211,Sullivan,2020,2785,2664,121,4.3
29,213,Taney,2020,26259,22866,3393,12.9
29,215,Texas,2020,8953,8434,519,5.8
29,217,Vernon,2020,9436,9025,411,4.4
29,219,Warren,2020,18207,17150,1057,5.8
29,221,Washington,2020,10143,9415,728,7.2
29,223,Wayne,2020,5085,4775,310,6.1
29,225,Webster,2020,17322,16396,926,5.3
29,227,Worth,2020,1180,1131,49,4.2
29,229,Wright,2020,7369,6851,518,7.0
29,510,St. Louis city,2020,152292,139334,12958,8.5
30,1,Beaverhead,2020,5050,4847,203,4.0
30,3,Big Horn,2020,4874,4517,357,7.3
30,5,Blaine,2020,2278,2169,109,4.8
30,7,Broadwater,2020,2605,2442,163,6.3
30,9,Carbon,2020,5567,5233,334,6.0
30,11,Carter,2020,649,630,19,2.9
30,13,Cascade,2020,37797,35561,2236,5.9
30,15,Chouteau,2020,2454,2359,95,3.9
30,17,Custer,2020,6230,5930,300,4.8
30,19,Daniels,2020,898,873,25,2.8
30,21,Dawson,2020,4668,4408,260,5.6
30,23,Deer Lodge,2020,5035,4779,256,5.1
30,25,Fallon,2020,1648,1582,66,4.0
30,27,Fergus,2020,5844,5578,266,4.6
30,29,Flathead,2020,49357,45499,3858,7.8
30,31,Gallatin,2020,70434,66898,3536,5.0
30,33,Garfield,2020,741,721,20,2.7
30,35,Glacier,2020,5443,4907,536,9.8
30,37,Golden Valley,2020,363,346,17,4.7
30,39,Granite,2020,1606,1475,131,8.2
30,41,Hill,2020,7608,7229,379,5.0
30,43,Jefferson,2020,5789,5492,297,5.1
30,45,Judith Basin,2020,987,939,48,4.9
30,47,Lake,2020,13659,12815,844,6.2
30,49,Lewis and Clark,2020,36479,34666,1813,5.0
30,51,Liberty,2020,969,942,27,2.8
30,53,Lincoln,2020,8097,7278,819,10.1
30,55,McCone,2020,961,933,28,2.9
30,57,Madison,2020,4551,4319,232,5.1
30,59,Meagher,2020,966,921,45,4.7
30,61,Mineral,2020,1778,1597,181,10.2
30,63,Missoula,2020,64123,60106,4017,6.3
30,65,Musselshell,2020,2328,2185,143,6.1
30,67,Park,2020,8938,8273,665,7.4
30,69,Petroleum,2020,264,255,9,3.4
30,71,Phillips,2020,1891,1798,93,4.9
30,73,Pondera,2020,2685,2553,132,4.9
30,75,Powder River,2020,976,946,30,3.1
30,77,Powell,2020,2956,2819,137,4.6
30,79,Prairie,2020,471,439,32,6.8
30,81,Ravalli,2020,20684,19493,1191,5.8
30,83,Richland,2020,5938,5556,382,6.4
30,85,Roosevelt,2020,4451,4185,266,6.0
30,87,Rosebud,2020,3742,3530,212,5.7
30,89,Sanders,2020,5086,4691,395,7.8
30,91,Sheridan,2020,1769,1684,85,4.8
30,93,Silver Bow,2020,17295,16153,1142,6.6
30,95,Stillwater,2020,5332,5062,270,5.1
30,97,Sweet Grass,2020,1861,1794,67,3.6
30,99,Teton,2020,2765,2644,121,4.4
30,101,Toole,2020,2141,2034,107,5.0
30,103,Treasure,2020,338,326,12,3.6
30,105,Valley,2020,4056,3880,176,4.3
30,107,Wheatland,2020,754,699,55,7.3
30,109,Wibaux,2020,454,431,23,5.1
30,111,Yellowstone,2020,83203,78676,4527,5.4
31,1,Adams,2020,16839,16169,670,4.0
31,3,Antelope,2020,3909,3821,88,2.3
31,5,Arthur,2020,231,219,12,5.2
31,7,Banner,2020,380,370,10,2.6
31,9,Blaine,2020,255,246,9,3.5
31,11,Boone,2020,2937,2864,73,2.5
31,13,Box Butte,2020,5405,5148,257,4.8
31,15,Boyd,2020,1057,1027,30,2.8
31,17,Brown,2020,1397,1359,38,2.7
31,19,Buffalo,2020,27519,26430,1089,4.0
31,21,Burt,2020,3556,3419,137,3.9
31,23,Butler,2020,4589,4433,156,3.4
31,25,Cass,2020,13432,12851,581,4.3
31,27,Cedar,2020,4506,4384,122,2.7
31,29,Chase,2020,2285,2244,41,1.8
31,31,Cherry,2020,3334,3253,81,2.4
31,33,Cheyenne,2020,4224,4038,186,4.4
31,35,Clay,2020,3256,3152,104,3.2
31,37,Colfax,2020,5620,5457,163,2.9
31,39,Cuming,2020,4830,4708,122,2.5
31,41,Custer,2020,6348,6174,174,2.7
31,43,Dakota,2020,10598,10089,509,4.8
31,45,Dawes,2020,4952,4812,140,2.8
31,47,Dawson,2020,13302,12846,456,3.4
31,49,Deuel,2020,956,927,29,3.0
31,51,Dixon,2020,2945,2850,95,3.2
31,53,Dodge,2020,20100,19391,709,3.5
31,55,Douglas,2020,300140,284846,15294,5.1
31,57,Dundy,2020,1158,1133,25,2.2
31,59,Fillmore,2020,3154,3067,87,2.8
31,61,Franklin,2020,1473,1422,51,3.5
31,63,Frontier,2020,1539,1494,45,2.9
31,65,Furnas,2020,2593,2521,72,2.8
31,67,Gage,2020,10872,10438,434,4.0
31,69,Garden,2020,1061,1024,37,3.5
31,71,Garfield,2020,1147,1124,23,2.0
31,73,Gosper,2020,1094,1066,28,2.6
31,75,Grant,2020,409,401,8,2.0
31,77,Greeley,2020,1232,1196,36,2.9
31,79,Hall,2020,32030,30179,1851,5.8
31,81,Hamilton,2020,4760,4585,175,3.7
31,83,Harlan,2020,1731,1681,50,2.9
31,85,Hayes,2020,630,616,14,2.2
31,87,Hitchcock,2020,1304,1259,45,3.5
31,89,Holt,2020,5730,5590,140,2.4
31,91,Hooker,2020,412,401,11,2.7
31,93,Howard,2020,3340,3193,147,4.4
31,95,Jefferson,2020,4193,4078,115,2.7
31,97,Johnson,2020,2058,1977,81,3.9
31,99,Kearney,2020,3776,3655,121,3.2
31,101,Keith,2020,4547,4400,147,3.2
31,103,Keya Paha,2020,597,585,12,2.0
31,105,Kimball,2020,1975,1905,70,3.5
31,107,Knox,2020,4655,4517,138,3.0
31,109,Lancaster,2020,177006,169507,7499,4.2
31,111,Lincoln,2020,18367,17645,722,3.9
31,113,Logan,2020,471,459,12,2.5
31,115,Loup,2020,409,397,12,2.9
31,117,McPherson,2020,443,431,12,2.7
31,119,Madison,2020,19665,18898,767,3.9
31,121,Merrick,2020,4004,3845,159,4.0
31,123,Morrill,2020,2605,2512,93,3.6
31,125,Nance,2020,1946,1883,63,3.2
31,127,Nemaha,2020,3581,3453,128,3.6
31,129,Nuckolls,2020,2454,2388,66,2.7
31,131,Otoe,2020,8369,8072,297,3.5
31,133,Pawnee,2020,1486,1445,41,2.8
31,135,Perkins,2020,1834,1801,33,1.8
31,137,Phelps,2020,4953,4805,148,3.0
31,139,Pierce,2020,4125,3989,136,3.3
31,141,Platte,2020,17741,17090,651,3.7
31,143,Polk,2020,2912,2824,88,3.0
31,145,Red Willow,2020,5854,5663,191,3.3
31,147,Richardson,2020,4197,4062,135,3.2
31,149,Rock,2020,873,855,18,2.1
31,151,Saline,2020,7310,7047,263,3.6
31,153,Sarpy,2020,96776,92833,3943,4.1
31,155,Saunders,2020,11155,10746,409,3.7
31,157,Scotts Bluff,2020,18160,17402,758,4.2
31,159,Seward,2020,8852,8489,363,4.1
31,161,Sheridan,2020,2708,2643,65,2.4
31,163,Sherman,2020,1667,1614,53,3.2
31,165,Sioux,2020,747,730,17,2.3
31,167,Stanton,2020,3531,3412,119,3.4
31,169,Thayer,2020,2781,2705,76,2.7
31,171,Thomas,2020,420,403,17,4.0
31,173,Thurston,2020,3070,2909,161,5.2
31,175,Valley,2020,2124,2064,60,2.8
31,177,Washington,2020,11136,10729,407,3.7
31,179,Wayne,2020,5610,5454,156,2.8
31,181,Webster,2020,1653,1591,62,3.8
31,183,Wheeler,2020,550,540,10,1.8
31,185,York,2020,7265,7021,244,3.4
32,1,Churchill,2020,11074,10451,623,5.6
32,3,Clark,2020,1123582,958069,165513,14.7
32,5,Douglas,2020,22465,20531,1934,8.6
32,7,Elko,2020,26791,25264,1527,5.7
32,9,Esmeralda,2020,406,385,21,5.2
32,11,Eureka,2020,1040,1004,36,3.5
32,13,Humboldt,2020,8036,7641,395,4.9
32,15,Lander,2020,3149,2999,150,4.8
32,17,Lincoln,2020,2013,1910,103,5.1
32,19,Lyon,2020,23045,21077,1968,8.5
32,21,Mineral,2020,2093,1976,117,5.6
32,23,Nye,2020,17596,15889,1707,9.7
32,27,Pershing,2020,2530,2407,123,4.9
32,29,Storey,2020,2050,1879,171,8.3
32,31,Washoe,2020,254278,234544,19734,7.8
32,33,White Pine,2020,4595,4403,192,4.2
32,510,Carson City,2020,26130,23987,2143,8.2
33,1,Belknap,2020,31128,28971,2157,6.9
33,3,Carroll,2020,23134,21358,1776,7.7
33,5,Cheshire,2020,39851,37407,2444,6.1
33,7,Coos,2020,14399,13263,1136,7.9
33,9,Grafton,2020,48154,45341,2813,5.8
33,11,Hillsborough,2020,240135,223343,16792,7.0
33,13,Merrimack,2020,82622,77822,4800,5.8
33,15,Rockingham,2020,185979,172832,13147,7.1
33,17,Strafford,2020,73223,68613,4610,6.3
33,19,Sullivan,2020,23105,21866,1239,5.4
34,1,Atlantic,2020,121037,99546,21491,17.8
34,3,Bergen,2020,477892,432189,45703,9.6
34,5,Burlington,2020,230784,211788,18996,8.2
34,7,Camden,2020,256048,230287,25761,10.1
34,9,Cape May,2020,45492,39206,6286,13.8
34,11,Cumberland,2020,66277,59148,7129,10.8
34,13,Essex,2020,373943,330269,43674,11.7
34,15,Gloucester,2020,151080,137052,14028,9.3
34,17,Hudson,2020,360498,322277,38221,10.6
34,19,Hunterdon,2020,63295,58730,4565,7.2
34,21,Mercer,2020,205405,190150,15255,7.4
34,23,Middlesex,2020,436329,398298,38031,8.7
34,25,Monmouth,2020,327712,298748,28964,8.8
34,27,Morris,2020,252588,232958,19630,7.8
34,29,Ocean,2020,278413,252016,26397,9.5
34,31,Passaic,2020,245187,214293,30894,12.6
34,33,Salem,2020,29532,26715,2817,9.5
34,35,Somerset,2020,167938,154873,13065,7.8
34,37,Sussex,2020,73836,66900,6936,9.4
34,39,Union,2020,276211,248871,27340,9.9
34,41,Warren,2020,55670,50947,4723,8.5
35,1,Bernalillo,2020,330645,303820,26825,8.1
35,3,Catron,2020,1159,1075,84,7.2
35,5,Chaves,2020,28106,25832,2274,8.1
35,6,Cibola,2020,9120,8278,842,9.2
35,7,Colfax,2020,5191,4824,367,7.1
35,9,Curry,2020,22292,21068,1224,5.5
35,11,De Baca,2020,710,675,35,4.9
35,13,Dona Ana,2020,97153,89080,8073,8.3
35,15,Eddy,2020,33700,31384,2316,6.9
35,17,Grant,2020,11893,10819,1074,9.0
35,19,Guadalupe,2020,1531,1428,103,6.7
35,21,Harding,2020,276,264,12,4.3
35,23,Hidalgo,2020,1956,1842,114,5.8
35,25,Lea,2020,29545,26281,3264,11.0
35,27,Lincoln,2020,8943,8154,789,8.8
35,28,Los Alamos,2020,9974,9603,371,3.7
35,29,Luna,2020,10372,8727,1645,15.9
35,31,McKinley,2020,24035,21557,2478,10.3
35,33,Mora,2020,2064,1898,166,8.0
35,35,Otero,2020,25696,23556,2140,8.3
35,37,Quay,2020,3099,2870,229,7.4
35,39,Rio Arriba,2020,16816,15455,1361,8.1
35,41,Roosevelt,2020,7934,7443,491,6.2
35,43,Sandoval,2020,66325,60627,5698,8.6
35,45,San Juan,2020,50367,45321,5046,10.0
35,47,San Miguel,2020,10516,9646,870,8.3
35,49,Santa Fe,2020,71346,65455,5891,8.3
35,51,Sierra,2020,4127,3749,378,9.2
35,53,Socorro,2020,6248,5805,443,7.1
35,55,Taos,2020,14967,13238,1729,11.6
35,57,Torrance,2020,5365,4854,511,9.5
35,59,Union,2020,1653,1569,84,5.1
35,61,Valencia,2020,30167,27681,2486,8.2
36,1,Albany,2020,157326,146027,11299,7.2
36,3,Allegany,2020,19038,17502,1536,8.1
36,5,Bronx,2020,589087,494651,94436,16.0
36,7,Broome,2020,81897,74798,7099,8.7
36,9,Cattaraugus,2020,33142,30022,3120,9.4
36,11,Cayuga,2020,35417,32618,2799,7.9
36,13,Chautauqua,2020,52729,48027,4702,8.9
36,15,Chemung,2020,35430,32328,3102,8.8
36,17,Chenango,2020,21760,20261,1499,6.9
36,19,Clinton,2020,35447,32623,2824,8.0
36,21,Columbia,2020,30309,28431,1878,6.2
36,23,Cortland,2020,22453,20668,1785,7.9
36,25,Delaware,2020,18614,17274,1340,7.2
36,27,Dutchess,2020,142061,131173,10888,7.7
36,29,Erie,2020,439291,397536,41755,9.5
36,31,Essex,2020,16518,15174,1344,8.1
36,33,Franklin,2020,19197,17622,1575,8.2
36,35,Fulton,2020,22509,20569,1940,8.6
36,37,Genesee,2020,28962,26833,2129,7.4
36,39,Greene,2020,20281,18598,1683,8.3
36,41,Hamilton,2020,2141,1972,169,7.9
36,43,Herkimer,2020,27477,25227,2250,8.2
36,45,Jefferson,2020,43295,39542,3753,8.7
36,47,Kings,2020,1151130,1006852,144278,12.5
36,49,Lewis,2020,11389,10515,874,7.7
36,51,Livingston,2020,29831,27727,2104,7.1
36,53,Madison,2020,32437,29908,2529,7.8
36,55,Monroe,2020,359299,328525,30774,8.6
36,57,Montgomery,2020,22032,20098,1934,8.8
36,59,Nassau,2020,698942,640035,58907,8.4
36,61,New York,2020,859618,777583,82035,9.5
36,63,Niagara,2020,98105,87906,10199,10.4
36,65,Oneida,2020,100648,92473,8175,8.1
36,67,Onondaga,2020,220483,202037,18446,8.4
36,69,Ontario,2020,54401,50447,3954,7.3
36,71,Orange,2020,183265,167957,15308,8.4
36,73,Orleans,2020,17146,15713,1433,8.4
36,75,Oswego,2020,52209,47549,4660,8.9
36,77,Otsego,2020,26607,24686,1921,7.2
36,79,Putnam,2020,50079,46294,3785,7.6
36,81,Queens,2020,1098937,961214,137723,12.5
36,83,Rensselaer,2020,80795,75155,5640,7.0
36,85,Richmond,2020,211064,188608,22456,10.6
36,87,Rockland,2020,152903,140547,12356,8.1
36,89,St. Lawrence,2020,42854,39353,3501,8.2
36,91,Saratoga,2020,119009,111029,7980,6.7
36,93,Schenectady,2020,76925,70723,6202,8.1
36,95,Schoharie,2020,14440,13412,1028,7.1
36,97,Schuyler,2020,8008,7319,689,8.6
36,99,Seneca,2020,15214,13970,1244,8.2
36,101,Steuben,2020,42022,38592,3430,8.2
36,103,Suffolk,2020,764564,699613,64951,8.5
36,105,Sullivan,2020,35758,32601,3157,8.8
36,107,Tioga,2020,22142,20410,1732,7.8
36,109,Tompkins,2020,47929,44967,2962,6.2
36,111,Ulster,2020,86186,79285,6901,8.0
36,113,Warren,2020,30901,28308,2593,8.4
36,115,Washington,2020,27302,25348,1954,7.2
36,117,Wayne,2020,42921,39749,3172,7.4
36,119,Westchester,2020,477959,437772,40187,8.4
36,121,Wyoming,2020,17793,16457,1336,7.5
36,123,Yates,2020,11546,10794,752,6.5
37,1,Alamance,2020,80457,74625,5832,7.2
37,3,Alexander,2020,17694,16377,1317,7.4
37,5,Alleghany,2020,4210,3903,307,7.3
37,7,Anson,2020,10422,9617,805,7.7
37,9,Ashe,2020,12664,11878,786,6.2
37,11,Avery,2020,7287,6825,462,6.3
37,13,Beaufort,2020,19387,18159,1228,6.3
37,15,Bertie,2020,7618,7132,486,6.4
37,17,Bladen,2020,14485,13439,1046,7.2
37,19,Brunswick,2020,52246,47641,4605,8.8
37,21,Buncombe,2020,136480,125114,11366,8.3
37,23,Burke,2020,39888,37019,2869,7.2
37,25,Cabarrus,2020,108444,100873,7571,7.0
37,27,Caldwell,2020,35754,32931,2823,7.9
37,29,Camden,2020,4574,4323,251,5.5
37,31,Carteret,2020,31320,29373,1947,6.2
37,33,Caswell,2020,9621,8869,752,7.8
37,35,Catawba,2020,77852,71632,6220,8.0
37,37,Chatham,2020,35248,33338,1910,5.4
37,39,Cherokee,2020,10952,10084,868,7.9
37,41,Chowan,2020,5476,5140,336,6.1
37,43,Clay,2020,4079,3778,301,7.4
37,45,Cleveland,2020,48435,44634,3801,7.8
37,47,Columbus,2020,22501,20662,1839,8.2
37,49,Craven,2020,40820,38121,2699,6.6
37,51,Cumberland,2020,126387,114386,12001,9.5
37,53,Currituck,2020,13851,12976,875,6.3
37,55,Dare,2020,19548,17636,1912,9.8
37,57,Davidson,2020,78916,73311,5605,7.1
37,59,Davie,2020,20079,18709,1370,6.8
37,61,Duplin,2020,24812,23420,1392,5.6
37,63,Durham,2020,170422,159304,11118,6.5
37,65,Edgecombe,2020,20702,18511,2191,10.6
37,67,Forsyth,2020,184149,170449,13700,7.4
37,69,Franklin,2020,31029,28909,2120,6.8
37,71,Gaston,2020,109526,100744,8782,8.0
37,73,Gates,2020,5069,4779,290,5.7
37,75,Graham,2020,3077,2772,305,9.9
37,77,Granville,2020,29566,27832,1734,5.9
37,79,Greene,2020,9551,9012,539,5.6
37,81,Guilford,2020,256997,234933,22064,8.6
37,83,Halifax,2020,20081,18237,1844,9.2
37,85,Harnett,2020,52873,48916,3957,7.5
37,87,Haywood,2020,28663,26503,2160,7.5
37,89,Henderson,2020,52454,48836,3618,6.9
37,91,Hertford,2020,9016,8389,627,7.0
37,93,Hoke,2020,19759,18049,1710,8.7
37,95,Hyde,2020,1797,1614,183,10.2
37,97,Iredell,2020,88855,82336,6519,7.3
37,99,Jackson,2020,19785,18286,1499,7.6
37,101,Johnston,2020,98297,92056,6241,6.3
37,103,Jones,2020,4199,3957,242,5.8
37,105,Lee,2020,25965,23894,2071,8.0
37,107,Lenoir,2020,27600,25892,1708,6.2
37,109,Lincoln,2020,43262,40410,2852,6.6
37,111,McDowell,2020,20555,19123,1432,7.0
37,113,Macon,2020,15449,14416,1033,6.7
37,115,Madison,2020,9587,8926,661,6.9
37,117,Martin,2020,8884,8267,617,6.9
37,119,Mecklenburg,2020,617543,569616,47927,7.8
37,121,Mitchell,2020,5886,5427,459,7.8
37,123,Montgomery,2020,11328,10573,755,6.7
37,125,Moore,2020,40734,37796,2938,7.2
37,127,Nash,2020,42129,38590,3539,8.4
37,129,New Hanover,2020,120839,112078,8761,7.3
37,131,Northampton,2020,7528,6978,550,7.3
37,133,Onslow,2020,63899,59276,4623,7.2
37,135,Orange,2020,77808,73636,4172,5.4
37,137,Pamlico,2020,5242,4947,295,5.6
37,139,Pasquotank,2020,16517,15306,1211,7.3
37,141,Pender,2020,28001,26157,1844,6.6
37,143,Perquimans,2020,4845,4521,324,6.7
37,145,Person,2020,18098,16766,1332,7.4
37,147,Pitt,2020,87450,81504,5946,6.8
37,149,Polk,2020,8948,8392,556,6.2
37,151,Randolph,2020,63993,59268,4725,7.4
37,153,Richmond,2020,16733,15200,1533,9.2
37,155,Robeson,2020,49951,45531,4420,8.8
37,157,Rockingham,2020,38983,35723,3260,8.4
37,159,Rowan,2020,65083,59909,5174,7.9
37,161,Rutherford,2020,24588,22307,2281,9.3
37,163,Sampson,2020,28498,26837,1661,5.8
37,165,Scotland,2020,11407,10034,1373,12.0
37,167,Stanly,2020,29630,27757,1873,6.3
37,169,Stokes,2020,20991,19638,1353,6.4
37,171,Surry,2020,32640,30404,2236,6.9
37,173,Swain,2020,6939,6351,588,8.5
37,175,Transylvania,2020,14146,13278,868,6.1
37,177,Tyrrell,2020,1359,1238,121,8.9
37,179,Union,2020,121173,113926,7247,6.0
37,181,Vance,2020,17119,15388,1731,10.1
37,183,Wake,2020,584088,546490,37598,6.4
37,185,Warren,2020,6560,5919,641,9.8
37,187,Washington,2020,4392,4034,358,8.2
37,189,Watauga,2020,27997,26261,1736,6.2
37,191,Wayne,2020,50708,47430,3278,6.5
37,193,Wilkes,2020,28483,26544,1939,6.8
37,195,Wilson,2020,34442,31380,3062,8.9
37,197,Yadkin,2020,17305,16074,1231,7.1
37,199,Yancey,2020,8189,7649,540,6.6
38,1,Adams,2020,999,961,38,3.8
38,3,Barnes,2020,5165,4965,200,3.9
38,5,Benson,2020,2322,2165,157,6.8
38,7,Billings,2020,438,422,16,3.7
38,9,Bottineau,2020,2959,2800,159,5.4
38,11,Bowman,2020,1639,1584,55,3.4
38,13,Burke,2020,1022,968,54,5.3
38,15,Burleigh,2020,50588,48386,2202,4.4
38,17,Cass,2020,104926,100334,4592,4.4
38,19,Cavalier,2020,1911,1845,66,3.5
38,21,Dickey,2020,2318,2241,77,3.3
38,23,Divide,2020,1418,1373,45,3.2
38,25,Dunn,2020,3097,2956,141,4.6
38,27,Eddy,2020,1206,1149,57,4.7
38,29,Emmons,2020,1493,1419,74,5.0
38,31,Foster,2020,1555,1501,54,3.5
38,33,Golden Valley,2020,853,826,27,3.2
38,35,Grand Forks,2020,36730,35031,1699,4.6
38,37,Grant,2020,1189,1156,33,2.8
38,39,Griggs,2020,1014,983,31,3.1
38,41,Hettinger,2020,1392,1337,55,4.0
38,43,Kidder,2020,1284,1218,66,5.1
38,45,LaMoure,2020,2055,2001,54,2.6
38,47,Logan,2020,854,827,27,3.2
38,49,McHenry,2020,3088,2919,169,5.5
38,51,McIntosh,2020,1097,1061,36,3.3
38,53,McKenzie,2020,9367,8659,708,7.6
38,55,McLean,2020,4789,4573,216,4.5
38,57,Mercer,2020,3616,3408,208,5.8
38,59,Morton,2020,16746,15896,850,5.1
38,61,Mountrail,2020,6880,6526,354,5.1
38,63,Nelson,2020,1398,1335,63,4.5
38,65,Oliver,2020,882,836,46,5.2
38,67,Pembina,2020,3386,3190,196,5.8
38,69,Pierce,2020,1710,1637,73,4.3
38,71,Ramsey,2020,5703,5447,256,4.5
38,73,Ransom,2020,2867,2749,118,4.1
38,75,Renville,2020,1225,1165,60,4.9
38,77,Richland,2020,8580,8248,332,3.9
38,79,Rolette,2020,4743,4106,637,13.4
38,81,Sargent,2020,2770,2649,121,4.4
38,83,Sheridan,2020,685,644,41,6.0
38,85,Sioux,2020,1205,1158,47,3.9
38,87,Slope,2020,391,379,12,3.1
38,89,Stark,2020,18332,17024,1308,7.1
38,91,Steele,2020,949,921,28,3.0
38,93,Stutsman,2020,10495,10131,364,3.5
38,95,Towner,2020,1157,1125,32,2.8
38,97,Traill,2020,4458,4296,162,3.6
38,99,Walsh,2020,5135,4902,233,4.5
38,101,Ward,2020,31847,29948,1899,6.0
38,103,Wells,2020,1920,1836,84,4.4
38,105,Williams,2020,23001,20796,2205,9.6
39,1,Adams,2020,10981,9968,1013,9.2
39,3,Allen,2020,48303,44181,4122,8.5
39,5,Ashland,2020,26492,24783,1709,6.5
39,7,Ashtabula,2020,43807,40162,3645,8.3
39,9,Athens,2020,27207,25214,1993,7.3
39,11,Auglaize,2020,24698,22997,1701,6.9
39,13,Belmont,2020,28888,25970,2918,10.1
39,15,Brown,2020,19407,17806,1601,8.2
39,17,Butler,2020,194077,180029,14048,7.2
39,19,Carroll,2020,12883,11747,1136,8.8
39,21,Champaign,2020,19995,18574,1421,7.1
39,23,Clark,2020,62945,57829,5116,8.1
39,25,Clermont,2020,106237,98953,7284,6.9
39,27,Clinton,2020,17778,16299,1479,8.3
39,29,Columbiana,2020,47380,42928,4452,9.4
39,31,Coshocton,2020,14138,12880,1258,8.9
39,33,Crawford,2020,18698,16949,1749,9.4
39,35,Cuyahoga,2020,592890,531193,61697,10.4
39,37,Darke,2020,25836,24093,1743,6.7
39,39,Defiance,2020,17908,16437,1471,8.2
39,41,Delaware,2020,111352,105395,5957,5.3
39,43,Erie,2020,36560,32734,3826,10.5
39,45,Fairfield,2020,78604,73406,5198,6.6
39,47,Fayette,2020,14023,12991,1032,7.4
39,49,Franklin,2020,705149,652631,52518,7.4
39,51,Fulton,2020,21991,20251,1740,7.9
39,53,Gallia,2020,12229,11253,976,8.0
39,55,Geauga,2020,46329,43210,3119,6.7
39,57,Greene,2020,82640,77337,5303,6.4
39,59,Guernsey,2020,18296,16708,1588,8.7
39,61,Hamilton,2020,415866,383560,32306,7.8
39,63,Hancock,2020,41803,38943,2860,6.8
39,65,Hardin,2020,14080,12942,1138,8.1
39,67,Harrison,2020,6754,6133,621,9.2
39,69,Henry,2020,13093,12028,1065,8.1
39,71,Highland,2020,17504,15988,1516,8.7
39,73,Hocking,2020,12961,12002,959,7.4
39,75,Holmes,2020,20977,20163,814,3.9
39,77,Huron,2020,27701,25075,2626,9.5
39,79,Jackson,2020,13157,12008,1149,8.7
39,81,Jefferson,2020,27496,24721,2775,10.1
39,83,Knox,2020,31244,29315,1929,6.2
39,85,Lake,2020,120876,110740,10136,8.4
39,87,Lawrence,2020,23849,21825,2024,8.5
39,89,Licking,2020,90688,84753,5935,6.5
39,91,Logan,2020,22803,20911,1892,8.3
39,93,Lorain,2020,149061,134333,14728,9.9
39,95,Lucas,2020,209345,187666,21679,10.4
39,97,Madison,2020,20834,19598,1236,5.9
39,99,Mahoning,2020,101288,90990,10298,10.2
39,101,Marion,2020,28331,26171,2160,7.6
39,103,Medina,2020,93378,86254,7124,7.6
39,105,Meigs,2020,9072,8200,872,9.6
39,107,Mercer,2020,23515,22250,1265,5.4
39,109,Miami,2020,54163,50380,3783,7.0
39,111,Monroe,2020,5719,5113,606,10.6
39,113,Montgomery,2020,253421,231691,21730,8.6
39,115,Morgan,2020,6697,6077,620,9.3
39,117,Morrow,2020,16890,15686,1204,7.1
39,119,Muskingum,2020,40389,37257,3132,7.8
39,121,Noble,2020,4656,4207,449,9.6
39,123,Ottawa,2020,20729,18843,1886,9.1
39,125,Paulding,2020,8784,8128,656,7.5
39,127,Perry,2020,15961,14622,1339,8.4
39,129,Pickaway,2020,26523,24726,1797,6.8
39,131,Pike,2020,10915,9890,1025,9.4
39,133,Portage,2020,85783,79554,6229,7.3
39,135,Preble,2020,21175,19757,1418,6.7
39,137,Putnam,2020,18720,17669,1051,5.6
39,139,Richland,2020,52087,47406,4681,9.0
39,141,Ross,2020,35399,32560,2839,8.0
39,143,Sandusky,2020,30192,27737,2455,8.1
39,145,Scioto,2020,29354,26808,2546,8.7
39,147,Seneca,2020,27352,25132,2220,8.1
39,149,Shelby,2020,24162,22295,1867,7.7
39,151,Stark,2020,184149,169291,14858,8.1
39,153,Summit,2020,270407,248140,22267,8.2
39,155,Trumbull,2020,85195,76338,8857,10.4
39,157,Tuscarawas,2020,44612,41240,3372,7.6
39,159,Union,2020,29408,27702,1706,5.8
39,161,Van Wert,2020,14811,13773,1038,7.0
39,163,Vinton,2020,5655,5138,517,9.1
39,165,Warren,2020,118838,111257,7581,6.4
39,167,Washington,2020,26944,24633,2311,8.6
39,169,Wayne,2020,60568,57008,3560,5.9
39,171,Williams,2020,18829,17365,1464,7.8
39,173,Wood,2020,69444,64533,4911,7.1
39,175,Wyandot,2020,12964,12056,908,7.0
40,1,Adair,2020,8392,7904,488,5.8
40,3,Alfalfa,2020,2766,2667,99,3.6
40,5,Atoka,2020,5179,4814,365,7.0
40,7,Beaver,2020,2582,2513,69,2.7
40,9,Beckham,2020,10075,9315,760,7.5
40,11,Blaine,2020,4421,4160,261,5.9
40,13,Bryan,2020,22473,21330,1143,5.1
40,15,Caddo,2020,12049,11341,708,5.9
40,17,Canadian,2020,76026,71482,4544,6.0
40,19,Carter,2020,21557,20051,1506,7.0
40,21,Cherokee,2020,19669,18598,1071,5.4
40,23,Choctaw,2020,5590,5167,423,7.6
40,25,Cimarron,2020,1420,1392,28,2.0
40,27,Cleveland,2020,142684,134700,7984,5.6
40,29,Coal,2020,2313,2160,153,6.6
40,31,Comanche,2020,48267,45028,3239,6.7
40,33,Cotton,2020,2733,2541,192,7.0
40,35,Craig,2020,5859,5544,315,5.4
40,37,Creek,2020,31327,29298,2029,6.5
40,39,Custer,2020,15210,14388,822,5.4
40,41,Delaware,2020,18521,17540,981,5.3
40,43,Dewey,2020,2735,2604,131,4.8
40,45,Ellis,2020,2161,2064,97,4.5
40,47,Garfield,2020,27007,25532,1475,5.5
40,49,Garvin,2020,12841,12045,796,6.2
40,51,Grady,2020,26633,25011,1622,6.1
40,53,Grant,2020,2786,2694,92,3.3
40,55,Greer,2020,1904,1764,140,7.4
40,57,Harmon,2020,1199,1157,42,3.5
40,59,Harper,2020,1807,1747,60,3.3
40,61,Haskell,2020,4279,3945,334,7.8
40,63,Hughes,2020,5392,4989,403,7.5
40,65,Jackson,2020,10766,10327,439,4.1
40,67,Jefferson,2020,2578,2406,172,6.7
40,69,Johnston,2020,3753,3465,288,7.7
40,71,Kay,2020,18314,17094,1220,6.7
40,73,Kingfisher,2020,8808,8428,380,4.3
40,75,Kiowa,2020,3544,3367,177,5.0
40,77,Latimer,2020,3172,2854,318,10.0
40,79,Le Flore,2020,19186,17848,1338,7.0
40,81,Lincoln,2020,15609,14740,869,5.6
40,83,Logan,2020,22207,21068,1139,5.1
40,85,Love,2020,6605,6328,277,4.2
40,87,McClain,2020,19882,18783,1099,5.5
40,89,McCurtain,2020,15143,14141,1002,6.6
40,91,McIntosh,2020,7142,6541,601,8.4
40,93,Major,2020,3726,3550,176,4.7
40,95,Marshall,2020,6850,6409,441,6.4
40,97,Mayes,2020,19460,18480,980,5.0
40,99,Murray,2020,6186,5804,382,6.2
40,101,Muskogee,2020,29421,27643,1778,6.0
40,103,Noble,2020,5527,5303,224,4.1
40,105,Nowata,2020,4636,4393,243,5.2
40,107,Okfuskee,2020,4457,4161,296,6.6
40,109,Oklahoma,2020,385860,361100,24760,6.4
40,111,Okmulgee,2020,15612,14484,1128,7.2
40,113,Osage,2020,20529,19209,1320,6.4
40,115,Ottawa,2020,14399,13581,818,5.7
40,117,Pawnee,2020,7317,6842,475,6.5
40,119,Payne,2020,37979,35983,1996,5.3
40,121,Pittsburg,2020,16762,15489,1273,7.6
40,123,Pontotoc,2020,19341,18341,1000,5.2
40,125,Pottawatomie,2020,32454,30479,1975,6.1
40,127,Pushmataha,2020,4474,4176,298,6.7
40,129,Roger Mills,2020,1856,1766,90,4.8
40,131,Rogers,2020,44897,42291,2606,5.8
40,133,Seminole,2020,9292,8608,684,7.4
40,135,Sequoyah,2020,16555,15431,1124,6.8
40,137,Stephens,2020,18635,17198,1437,7.7
40,139,Texas,2020,11361,11099,262,2.3
40,141,Tillman,2020,3054,2863,191,6.3
40,143,Tulsa,2020,324010,302728,21282,6.6
40,145,Wagoner,2020,38146,35929,2217,5.8
40,147,Washington,2020,22360,21049,1311,5.9
40,149,Washita,2020,5154,4809,345,6.7
40,151,Woods,2020,4621,4462,159,3.4
40,153,Woodward,2020,8998,8395,603,6.7
41,1,Baker,2020,7285,6763,522,7.2
41,3,Benton,2020,46257,43645,2612,5.6
41,5,Clackamas,2020,218040,202243,15797,7.2
41,7,Clatsop,2020,19084,17261,1823,9.6
41,9,Columbia,2020,24061,22155,1906,7.9
41,11,Coos,2020,26525,24235,2290,8.6
41,13,Crook,2020,10328,9417,911,8.8
41,15,Curry,2020,8944,8170,774,8.7
41,17,Deschutes,2020,97975,90211,7764,7.9
41,19,Douglas,2020,47415,43757,3658,7.7
41,21,Gilliam,2020,997,936,61,6.1
41,23,Grant,2020,3211,2944,267,8.3
41,25,Harney,2020,3670,3454,216,5.9
41,27,Hood River,2020,14154,13269,885,6.3
41,29,Jackson,2020,105147,96937,8210,7.8
41,31,Jefferson,2020,10330,9482,848,8.2
41,33,Josephine,2020,36124,33277,2847,7.9
41,35,Klamath,2020,29511,26957,2554,8.7
41,37,Lake,2020,3647,3441,206,5.6
41,39,Lane,2020,178467,164364,14103,7.9
41,41,Lincoln,2020,20598,18355,2243,10.9
41,43,Linn,2020,58819,54251,4568,7.8
41,45,Malheur,2020,12617,11963,654,5.2
41,47,Marion,2020,163017,151713,11304,6.9
41,49,Morrow,2020,5717,5422,295,5.2
41,51,Multnomah,2020,457372,418070,39302,8.6
41,53,Polk,2020,40205,37566,2639,6.6
41,55,Sherman,2020,983,923,60,6.1
41,57,Tillamook,2020,11710,10762,948,8.1
41,59,Umatilla,2020,37001,34496,2505,6.8
41,61,Union,2020,12053,11109,944,7.8
41,63,Wallowa,2020,3473,3227,246,7.1
41,65,Wasco,2020,13430,12477,953,7.1
41,67,Washington,2020,321579,300742,20837,6.5
41,69,Wheeler,2020,693,663,30,4.3
41,71,Yamhill,2020,54221,50557,3664,6.8
42,1,Adams,2020,54035,50293,3742,6.9
42,3,Allegheny,2020,635957,578590,57367,9.0
42,5,Armstrong,2020,31451,28377,3074,9.8
42,7,Beaver,2020,82963,74445,8518,10.3
42,9,Bedford,2020,23383,21250,2133,9.1
42,11,Berks,2020,211486,191443,20043,9.5
42,13,Blair,2020,59205,54053,5152,8.7
42,15,Bradford,2020,28099,25992,2107,7.5
42,17,Bucks,2020,338801,310681,28120,8.3
42,19,Butler,2020,97152,89514,7638,7.9
42,21,Cambria,2020,56235,50872,5363,9.5
42,23,Cameron,2020,2036,1780,256,12.6
42,25,Carbon,2020,31589,28502,3087,9.8
42,27,Centre,2020,76416,71955,4461,5.8
42,29,Chester,2020,280096,262061,18035,6.4
42,31,Clarion,2020,16871,15482,1389,8.2
42,33,Clearfield,2020,35582,32307,3275,9.2
42,35,Clinton,2020,17701,16159,1542,8.7
42,37,Columbia,2020,33324,30623,2701,8.1
42,39,Crawford,2020,38254,34856,3398,8.9
42,41,Cumberland,2020,130651,121949,8702,6.7
42,43,Dauphin,2020,144428,131661,12767,8.8
42,45,Delaware,2020,294706,267759,26947,9.1
42,47,Elk,2020,15208,13337,1871,12.3
42,49,Erie,2020,126749,114331,12418,9.8
42,51,Fayette,2020,56337,49743,6594,11.7
42,53,Forest,2020,1799,1608,191,10.6
42,55,Franklin,2020,77184,71308,5876,7.6
42,57,Fulton,2020,7710,6820,890,11.5
42,59,Greene,2020,15981,14425,1556,9.7
42,61,Huntingdon,2020,19763,17700,2063,10.4
42,63,Indiana,2020,37666,34238,3428,9.1
42,65,Jefferson,2020,20056,18293,1763,8.8
42,67,Juniata,2020,12595,11693,902,7.2
42,69,Lackawanna,2020,103832,93870,9962,9.6
42,71,Lancaster,2020,281736,260618,21118,7.5
42,73,Lawrence,2020,40232,36080,4152,10.3
42,75,Lebanon,2020,71763,66060,5703,7.9
42,77,Lehigh,2020,191388,173080,18308,9.6
42,79,Luzerne,2020,157274,140183,17091,10.9
42,81,Lycoming,2020,55883,50970,4913,8.8
42,83,McKean,2020,17054,15369,1685,9.9
42,85,Mercer,2020,48048,43397,4651,9.7
42,87,Mifflin,2020,21146,19379,1767,8.4
42,89,Monroe,2020,81386,71996,9390,11.5
42,91,Montgomery,2020,446961,412925,34036,7.6
42,93,Montour,2020,9043,8489,554,6.1
42,95,Northampton,2020,158928,144689,14239,9.0
42,97,Northumberland,2020,42240,38281,3959,9.4
42,99,Perry,2020,24128,22499,1629,6.8
42,101,Philadelphia/city,2020,723938,634409,89529,12.4
42,103,Pike,2020,24852,22213,2639,10.6
42,105,Potter,2020,7185,6516,669,9.3
42,107,Schuylkill,2020,66129,60022,6107,9.2
42,109,Snyder,2020,19389,17906,1483,7.6
42,111,Somerset,2020,32661,29567,3094,9.5
42,113,Sullivan,2020,2597,2376,221,8.5
42,115,Susquehanna,2020,19774,18323,1451,7.3
42,117,Tioga,2020,18831,17128,1703,9.0
42,119,Union,2020,19314,18009,1305,6.8
42,121,Venango,2020,22047,20079,1968,8.9
42,123,Warren,2020,18668,17163,1505,8.1
42,125,Washington,2020,105089,95218,9871,9.4
42,127,Wayne,2020,22103,20076,2027,9.2
42,129,Westmoreland,2020,176723,160646,16077,9.1
42,131,Wyoming,2020,13254,12144,1110,8.4
42,133,York,2020,232812,214165,18647,8.0
44,1,Bristol,2020,24895,22999,1896,7.6
44,3,Kent,2020,88283,80562,7721,8.7
44,5,Newport,2020,42502,39038,3464,8.2
44,7,Providence,2020,320264,287648,32616,10.2
44,9,Washington,2020,65736,60597,5139,7.8
45,1,Abbeville,2020,10124,9454,670,6.6
45,3,Aiken,2020,75531,71743,3788,5.0
45,5,Allendale,2020,2641,2392,249,9.4
45,7,Anderson,2020,90877,85475,5402,5.9
45,9,Bamberg,2020,4846,4408,438,9.0
45,11,Barnwell,2020,7972,7385,587,7.4
45,13,Beaufort,2020,77127,72961,4166,5.4
45,15,Berkeley,2020,104916,99042,5874,5.6
45,17,Calhoun,2020,6572,6173,399,6.1
45,19,Charleston,2020,211939,198552,13387,6.3
45,21,Cherokee,2020,25302,23263,2039,8.1
45,23,Chester,2020,13646,12426,1220,8.9
45,25,Chesterfield,2020,21834,20511,1323,6.1
45,27,Clarendon,2020,12737,11874,863,6.8
45,29,Colleton,2020,16732,15717,1015,6.1
45,31,Darlington,2020,30521,28542,1979,6.5
45,33,Dillon,2020,13238,12424,814,6.1
45,35,Dorchester,2020,77693,73174,4519,5.8
45,37,Edgefield,2020,10799,10247,552,5.1
45,39,Fairfield,2020,9637,8877,760,7.9
45,41,Florence,2020,67150,63406,3744,5.6
45,43,Georgetown,2020,26175,24210,1965,7.5
45,45,Greenville,2020,255984,241371,14613,5.7
45,47,Greenwood,2020,31628,29616,2012,6.4
45,49,Hampton,2020,8234,7823,411,5.0
45,51,Horry,2020,147697,134956,12741,8.6
45,53,Jasper,2020,12804,12147,657,5.1
45,55,Kershaw,2020,29490,27924,1566,5.3
45,57,Lancaster,2020,42533,39610,2923,6.9
45,59,Laurens,2020,30197,28122,2075,6.9
45,61,Lee,2020,6812,6293,519,7.6
45,63,Lexington,2020,150439,143882,6557,4.4
45,65,McCormick,2020,3359,3135,224,6.7
45,67,Marion,2020,13251,12214,1037,7.8
45,69,Marlboro,2020,9294,8383,911,9.8
45,71,Newberry,2020,19201,18280,921,4.8
45,73,Oconee,2020,35056,33180,1876,5.4
45,75,Orangeburg,2020,34945,31790,3155,9.0
45,77,Pickens,2020,57109,54072,3037,5.3
45,79,Richland,2020,199718,188057,11661,5.8
45,81,Saluda,2020,8698,8328,370,4.3
45,83,Spartanburg,2020,158701,148274,10427,6.6
45,85,Sumter,2020,43534,40587,2947,6.8
45,87,Union,2020,12008,10931,1077,9.0
45,89,Williamsburg,2020,12004,11032,972,8.1
45,91,York,2020,143890,135143,8747,6.1
46,3,Aurora,2020,1477,1429,48,3.2
46,5,Beadle,2020,9352,8991,361,3.9
46,7,Bennett,2020,1070,1016,54,5.0
46,9,Bon Homme,2020,2859,2742,117,4.1
46,11,Brookings,2020,18480,17669,811,4.4
46,13,Brown,2020,20582,19678,904,4.4
46,15,Brule,2020,2462,2353,109,4.4
46,17,Buffalo,2020,691,636,55,8.0
46,19,Butte,2020,4986,4718,268,5.4
46,21,Campbell,2020,783,754,29,3.7
46,23,Charles Mix,2020,3788,3548,240,6.3
46,25,Clark,2020,2181,2095,86,3.9
46,27,Clay,2020,7157,6834,323,4.5
46,29,Codington,2020,15416,14662,754,4.9
46,31,Corson,2020,1343,1276,67,5.0
46,33,Custer,2020,4077,3834,243,6.0
46,35,Davison,2020,10942,10487,455,4.2
46,37,Day,2020,2706,2552,154,5.7
46,39,Deuel,2020,2336,2211,125,5.4
46,41,Dewey,2020,2255,2081,174,7.7
46,43,Douglas,2020,1558,1512,46,3.0
46,45,Edmunds,2020,1993,1935,58,2.9
46,47,Fall River,2020,2996,2817,179,6.0
46,49,Faulk,2020,1039,1003,36,3.5
46,51,Grant,2020,4382,4206,176,4.0
46,53,Gregory,2020,2038,1960,78,3.8
46,55,Haakon,2020,1069,1042,27,2.5
46,57,Hamlin,2020,3355,3239,116,3.5
46,59,Hand,2020,1768,1721,47,2.7
46,61,Hanson,2020,1750,1659,91,5.2
46,63,Harding,2020,718,692,26,3.6
46,65,Hughes,2020,9909,9574,335,3.4
46,67,Hutchinson,2020,3618,3481,137,3.8
46,69,Hyde,2020,680,659,21,3.1
46,71,Jackson,2020,1207,1155,52,4.3
46,73,Jerauld,2020,1176,1147,29,2.5
46,75,Jones,2020,508,489,19,3.7
46,77,Kingsbury,2020,2661,2563,98,3.7
46,79,Lake,2020,6485,6239,246,3.8
46,81,Lawrence,2020,13567,12726,841,6.2
46,83,Lincoln,2020,35711,34417,1294,3.6
46,85,Lyman,2020,1648,1554,94,5.7
46,87,McCook,2020,3076,2963,113,3.7
46,89,McPherson,2020,1010,958,52,5.1
46,91,Marshall,2020,2429,2313,116,4.8
46,93,Meade,2020,13918,13235,683,4.9
46,95,Mellette,2020,708,664,44,6.2
46,97,Miner,2020,1144,1089,55,4.8
46,99,Minnehaha,2020,113168,108033,5135,4.5
46,101,Moody,2020,4008,3797,211,5.3
46,102,Oglala Lakota,2020,3677,3304,373,10.1
46,103,Pennington,2020,57094,54074,3020,5.3
46,105,Perkins,2020,1382,1330,52,3.8
46,107,Potter,2020,1019,986,33,3.2
46,109,Roberts,2020,4807,4499,308,6.4
46,111,Sanborn,2020,1159,1112,47,4.1
46,115,Spink,2020,3111,2985,126,4.1
46,117,Stanley,2020,1891,1817,74,3.9
46,119,Sully,2020,789,767,22,2.8
46,121,Todd,2020,3066,2869,197,6.4
46,123,Tripp,2020,3013,2919,94,3.1
46,125,Turner,2020,4650,4467,183,3.9
46,127,Union,2020,8522,8088,434,5.1
46,129,Walworth,2020,2132,2001,131,6.1
46,135,Yankton,2020,11761,11220,541,4.6
46,137,Ziebach,2020,944,899,45,4.8
47,1,Anderson,2020,34360,32049,2311,6.7
47,3,Bedford,2020,20956,19293,1663,7.9
47,5,Benton,2020,6714,6165,549,8.2
47,7,Bledsoe,2020,4264,3897,367,8.6
47,9,Blount,2020,63505,59440,4065,6.4
47,11,Bradley,2020,52651,49151,3500,6.6
47,13,Campbell,2020,14717,13597,1120,7.6
47,15,Cannon,2020,6506,6083,423,6.5
47,17,Carroll,2020,11851,10977,874,7.4
47,19,Carter,2020,23655,22001,1654,7.0
47,21,Cheatham,2020,21313,20113,1200,5.6
47,23,Chester,2020,8390,7912,478,5.7
47,25,Claiborne,2020,12727,11838,889,7.0
47,27,Clay,2020,2721,2500,221,8.1
47,29,Cocke,2020,14713,13205,1508,10.2
47,31,Coffee,2020,25612,23620,1992,7.8
47,33,Crockett,2020,6836,6436,400,5.9
47,35,Cumberland,2020,22733,20988,1745,7.7
47,37,Davidson,2020,402058,369787,32271,8.0
47,39,Decatur,2020,4455,4072,383,8.6
47,41,DeKalb,2020,7651,6957,694,9.1
47,43,Dickson,2020,26354,24799,1555,5.9
47,45,Dyer,2020,15879,14603,1276,8.0
47,47,Fayette,2020,18987,17774,1213,6.4
47,49,Fentress,2020,7503,7014,489,6.5
47,51,Franklin,2020,19782,18213,1569,7.9
47,53,Gibson,2020,21795,20274,1521,7.0
47,55,Giles,2020,14634,13408,1226,8.4
47,57,Grainger,2020,9480,8793,687,7.2
47,59,Greene,2020,28769,26372,2397,8.3
47,61,Grundy,2020,5131,4629,502,9.8
47,63,Hamblen,2020,28020,26027,1993,7.1
47,65,Hamilton,2020,182352,169337,13015,7.1
47,67,Hancock,2020,2147,1966,181,8.4
47,69,Hardeman,2020,9318,8552,766,8.2
47,71,Hardin,2020,10276,9548,728,7.1
47,73,Hawkins,2020,23468,21663,1805,7.7
47,75,Haywood,2020,7777,7084,693,8.9
47,77,Henderson,2020,12010,11051,959,8.0
47,79,Henry,2020,13668,12642,1026,7.5
47,81,Hickman,2020,11103,10458,645,5.8
47,83,Houston,2020,3234,2970,264,8.2
47,85,Humphreys,2020,8670,8111,559,6.4
47,87,Jackson,2020,4740,4363,377,8.0
47,89,Jefferson,2020,24697,22853,1844,7.5
47,91,Johnson,2020,7682,7186,496,6.5
47,93,Knox,2020,242643,228282,14361,5.9
47,95,Lake,2020,1691,1542,149,8.8
47,97,Lauderdale,2020,9737,8846,891,9.2
47,99,Lawrence,2020,19092,17603,1489,7.8
47,101,Lewis,2020,5325,4924,401,7.5
47,103,Lincoln,2020,16026,14655,1371,8.6
47,105,Loudon,2020,23572,22072,1500,6.4
47,107,McMinn,2020,23393,21579,1814,7.8
47,109,McNairy,2020,8348,7622,726,8.7
47,111,Macon,2020,11156,10428,728,6.5
47,113,Madison,2020,49028,45343,3685,7.5
47,115,Marion,2020,12344,11409,935,7.6
47,117,Marshall,2020,15374,13978,1396,9.1
47,119,Maury,2020,49915,45854,4061,8.1
47,121,Meigs,2020,5195,4746,449,8.6
47,123,Monroe,2020,20090,18479,1611,8.0
47,125,Montgomery,2020,86234,79666,6568,7.6
47,127,Moore,2020,3610,3416,194,5.4
47,129,Morgan,2020,7654,7153,501,6.5
47,131,Obion,2020,12180,11322,858,7.0
47,133,Overton,2020,9689,9074,615,6.3
47,135,Perry,2020,2989,2705,284,9.5
47,137,Pickett,2020,2241,2104,137,6.1
47,139,Polk,2020,7455,6943,512,6.9
47,141,Putnam,2020,34970,32661,2309,6.6
47,143,Rhea,2020,13011,11732,1279,9.8
47,145,Roane,2020,23021,21508,1513,6.6
47,147,Robertson,2020,37300,35018,2282,6.1
47,149,Rutherford,2020,184368,171731,12637,6.9
47,151,Scott,2020,8170,7470,700,8.6
47,153,Sequatchie,2020,6146,5664,482,7.8
47,155,Sevier,2020,53721,48540,5181,9.6
47,157,Shelby,2020,447769,404507,43262,9.7
47,159,Smith,2020,9259,8701,558,6.0
47,161,Stewart,2020,5412,5053,359,6.6
47,163,Sullivan,2020,69352,64370,4982,7.2
47,165,Sumner,2020,102069,95424,6645,6.5
47,167,Tipton,2020,27498,25612,1886,6.9
47,169,Trousdale,2020,5383,5055,328,6.1
47,171,Unicoi,2020,7083,6497,586,8.3
47,173,Union,2020,7610,7088,522,6.9
47,175,Van Buren,2020,2011,1836,175,8.7
47,177,Warren,2020,17076,15564,1512,8.9
47,179,Washington,2020,59783,55928,3855,6.4
47,181,Wayne,2020,6414,5957,457,7.1
47,183,Weakley,2020,15456,14554,902,5.8
47,185,White,2020,12011,11155,856,7.1
47,187,Williamson,2020,126997,120874,6123,4.8
47,189,Wilson,2020,76694,71882,4812,6.3
48,1,Anderson,2020,23325,22013,1312,5.6
48,3,Andrews,2020,9220,8466,754,8.2
48,5,Angelina,2020,35495,32783,2712,7.6
48,7,Aransas,2020,9058,8291,767,8.5
48,9,Archer,2020,3911,3703,208,5.3
48,11,Armstrong,2020,914,875,39,4.3
48,13,Atascosa,2020,21822,19979,1843,8.4
48,15,Austin,2020,13638,12741,897,6.6
48,17,Bailey,2020,2440,2323,117,4.8
48,19,Bandera,2020,9835,9261,574,5.8
48,21,Bastrop,2020,42573,40016,2557,6.0
48,23,Baylor,2020,1767,1705,62,3.5
48,25,Bee,2020,9906,8932,974,9.8
48,27,Bell,2020,144558,134459,10099,7.0
48,29,Bexar,2020,942127,871017,71110,7.5
48,31,Blanco,2020,6573,6322,251,3.8
48,33,Borden,2020,430,416,14,3.3
48,35,Bosque,2020,8330,7876,454,5.5
48,37,Bowie,2020,38755,35891,2864,7.4
48,39,Brazoria,2020,177709,162442,15267,8.6
48,41,Brazos,2020,116599,110366,6233,5.3
48,43,Brewster,2020,4083,3811,272,6.7
48,45,Briscoe,2020,567,540,27,4.8
48,47,Brooks,2020,2601,2323,278,10.7
48,49,Brown,2020,15245,14253,992,6.5
48,51,Burleson,2020,8180,7661,519,6.3
48,53,Burnet,2020,23686,22567,1119,4.7
48,55,Caldwell,2020,19322,18096,1226,6.3
48,57,Calhoun,2020,11995,11296,699,5.8
48,59,Callahan,2020,5979,5654,325,5.4
48,61,Cameron,2020,169074,151855,17219,10.2
48,63,Camp,2020,5008,4639,369,7.4
48,65,Carson,2020,2930,2808,122,4.2
48,67,Cass,2020,12269,11299,970,7.9
48,69,Castro,2020,3320,3200,120,3.6
48,71,Chambers,2020,19836,17944,1892,9.5
48,73,Cherokee,2020,21303,19624,1679,7.9
48,75,Childress,2020,3054,2940,114,3.7
48,77,Clay,2020,4793,4528,265,5.5
48,79,Cochran,2020,1114,1035,79,7.1
48,81,Coke,2020,1374,1298,76,5.5
48,83,Coleman,2020,2886,2673,213,7.4
48,85,Collin,2020,570623,534617,36006,6.3
48,87,Collingsworth,2020,1081,1035,46,4.3
48,89,Colorado,2020,9693,9155,538,5.6
48,91,Comal,2020,74950,70311,4639,6.2
48,93,Comanche,2020,5618,5309,309,5.5
48,95,Concho,2020,1320,1261,59,4.5
48,97,Cooke,2020,19370,18001,1369,7.1
48,99,Coryell,2020,23974,22401,1573,6.6
48,101,Cottle,2020,570,542,28,4.9
48,103,Crane,2020,1624,1403,221,13.6
48,105,Crockett,2020,1559,1421,138,8.9
48,107,Crosby,2020,2389,2265,124,5.2
48,109,Culberson,2020,1150,1075,75,6.5
48,111,Dallam,2020,3750,3645,105,2.8
48,113,Dallas,2020,1355033,1251192,103841,7.7
48,115,Dawson,2020,4558,4160,398,8.7
48,117,Deaf Smith,2020,8567,8257,310,3.6
48,119,Delta,2020,2401,2268,133,5.5
48,121,Denton,2020,503962,471296,32666,6.5
48,123,DeWitt,2020,9253,8695,558,6.0
48,125,Dickens,2020,671,629,42,6.3
48,127,Dimmit,2020,6487,6074,413,6.4
48,129,Donley,2020,1423,1360,63,4.4
48,131,Duval,2020,4864,4275,589,12.1
48,133,Eastland,2020,7390,6893,497,6.7
48,135,Ector,2020,82852,73736,9116,11.0
48,137,Edwards,2020,1251,1207,44,3.5
48,139,Ellis,2020,93578,87937,5641,6.0
48,141,El Paso,2020,364085,333991,30094,8.3
48,143,Erath,2020,20013,18863,1150,5.7
48,145,Falls,2020,6531,6141,390,6.0
48,147,Fannin,2020,16772,15984,788,4.7
48,149,Fayette,2020,11793,11238,555,4.7
48,151,Fisher,2020,1605,1533,72,4.5
48,153,Floyd,2020,2516,2361,155,6.2
48,155,Foard,2020,576,552,24,4.2
48,157,Fort Bend,2020,394948,364410,30538,7.7
48,159,Franklin,2020,4827,4570,257,5.3
48,161,Freestone,2020,6348,5820,528,8.3
48,163,Frio,2020,9537,8996,541,5.7
48,165,Gaines,2020,9720,9177,543,5.6
48,167,Galveston,2020,164608,150218,14390,8.7
48,169,Garza,2020,2020,1883,137,6.8
48,171,Gillespie,2020,13265,12630,635,4.8
48,173,Glasscock,2020,797,768,29,3.6
48,175,Goliad,2020,3161,2917,244,7.7
48,177,Gonzales,2020,9561,9046,515,5.4
48,179,Gray,2020,7783,7150,633,8.1
48,181,Grayson,2020,64214,60453,3761,5.9
48,183,Gregg,2020,56565,51883,4682,8.3
48,185,Grimes,2020,11082,10191,891,8.0
48,187,Guadalupe,2020,80610,75677,4933,6.1
48,189,Hale,2020,11826,11027,799,6.8
48,191,Hall,2020,1076,1014,62,5.8
48,193,Hamilton,2020,3759,3589,170,4.5
48,195,Hansford,2020,2502,2415,87,3.5
48,197,Hardeman,2020,1710,1635,75,4.4
48,199,Hardin,2020,25019,22768,2251,9.0
48,201,Harris,2020,2292759,2088449,204310,8.9
48,203,Harrison,2020,29133,26843,2290,7.9
48,205,Hartley,2020,2633,2579,54,2.1
48,207,Haskell,2020,2653,2539,114,4.3
48,209,Hays,2020,121304,113639,7665,6.3
48,211,Hemphill,2020,1850,1768,82,4.4
48,213,Henderson,2020,37123,34746,2377,6.4
48,215,Hidalgo,2020,359969,318076,41893,11.6
48,217,Hill,2020,16294,15271,1023,6.3
48,219,Hockley,2020,10671,9826,845,7.9
48,221,Hood,2020,27578,25745,1833,6.6
48,223,Hopkins,2020,17484,16589,895,5.1
48,225,Houston,2020,10010,9481,529,5.3
48,227,Howard,2020,13502,12409,1093,8.1
48,229,Hudspeth,2020,1855,1706,149,8.0
48,231,Hunt,2020,43506,40659,2847,6.5
48,233,Hutchinson,2020,8539,7926,613,7.2
48,235,Irion,2020,752,707,45,6.0
48,237,Jack,2020,3393,3155,238,7.0
48,239,Jackson,2020,7329,6907,422,5.8
48,241,Jasper,2020,12883,11440,1443,11.2
48,243,Jeff Davis,2020,975,925,50,5.1
48,245,Jefferson,2020,105592,93022,12570,11.9
48,247,Jim Hogg,2020,1891,1711,180,9.5
48,249,Jim Wells,2020,16127,14033,2094,13.0
48,251,Johnson,2020,82931,77541,5390,6.5
48,253,Jones,2020,5738,5337,401,7.0
48,255,Karnes,2020,7007,6567,440,6.3
48,257,Kaufman,2020,67263,62886,4377,6.5
48,259,Kendall,2020,22123,21007,1116,5.0
48,261,Kenedy,2020,184,174,10,5.4
48,263,Kent,2020,458,440,18,3.9
48,265,Kerr,2020,21636,20365,1271,5.9
48,267,Kimble,2020,1809,1717,92,5.1
48,269,King,2020,236,232,4,1.7
48,271,Kinney,2020,1312,1233,79,6.0
48,273,Kleberg,2020,13402,12277,1125,8.4
48,275,Knox,2020,1454,1372,82,5.6
48,277,Lamar,2020,23507,21989,1518,6.5
48,279,Lamb,2020,5234,4960,274,5.2
48,281,Lampasas,2020,9041,8556,485,5.4
48,283,La Salle,2020,3693,3442,251,6.8
48,285,Lavaca,2020,8406,7965,441,5.2
48,287,Lee,2020,9158,8706,452,4.9
48,289,Leon,2020,6121,5644,477,7.8
48,291,Liberty,2020,33582,30011,3571,10.6
48,293,Limestone,2020,8363,7767,596,7.1
48,295,Lipscomb,2020,1541,1477,64,4.2
48,297,Live Oak,2020,5177,4791,386,7.5
48,299,Llano,2020,8479,7993,486,5.7
48,301,Loving,2020,289,284,5,1.7
48,303,Lubbock,2020,156625,147629,8996,5.7
48,305,Lynn,2020,2740,2591,149,5.4
48,307,McCulloch,2020,3260,3016,244,7.5
48,309,McLennan,2020,120347,112937,7410,6.2
48,311,McMullen,2020,727,707,20,2.8
48,313,Madison,2020,4462,4141,321,7.2
48,315,Marion,2020,4271,3920,351,8.2
48,317,Martin,2020,2546,2391,155,6.1
48,319,Mason,2020,1726,1630,96,5.6
48,321,Matagorda,2020,16529,14792,1737,10.5
48,323,Maverick,2020,24494,20821,3673,15.0
48,325,Medina,2020,21461,20110,1351,6.3
48,327,Menard,2020,866,821,45,5.2
48,329,Midland,2020,98237,90313,7924,8.1
48,331,Milam,2020,9750,9054,696,7.1
48,333,Mills,2020,1889,1811,78,4.1
48,335,Mitchell,2020,2381,2192,189,7.9
48,337,Montague,2020,9081,8479,602,6.6
48,339,Montgomery,2020,284994,263501,21493,7.5
48,341,Moore,2020,10578,10180,398,3.8
48,343,Morris,2020,4793,4248,545,11.4
48,345,Motley,2020,437,417,20,4.6
48,347,Nacogdoches,2020,27987,26145,1842,6.6
48,349,Navarro,2020,23245,21803,1442,6.2
48,351,Newton,2020,5054,4497,557,11.0
48,353,Nolan,2020,7151,6774,377,5.3
48,355,Nueces,2020,163920,149232,14688,9.0
48,357,Ochiltree,2020,4071,3835,236,5.8
48,359,Oldham,2020,890,855,35,3.9
48,361,Orange,2020,36027,32241,3786,10.5
48,363,Palo Pinto,2020,13267,12339,928,7.0
48,365,Panola,2020,9437,8645,792,8.4
48,367,Parker,2020,68141,64129,4012,5.9
48,369,Parmer,2020,4915,4788,127,2.6
48,371,Pecos,2020,6517,5987,530,8.1
48,373,Polk,2020,18357,16755,1602,8.7
48,375,Potter,2020,54150,51189,2961,5.5
48,377,Presidio,2020,3231,2755,476,14.7
48,379,Rains,2020,6027,5744,283,4.7
48,381,Randall,2020,72380,69134,3246,4.5
48,383,Reagan,2020,1815,1639,176,9.7
48,385,Real,2020,1072,1000,72,6.7
48,387,Red River,2020,5144,4817,327,6.4
48,389,Reeves,2020,8858,8227,631,7.1
48,391,Refugio,2020,3083,2831,252,8.2
48,393,Roberts,2020,414,395,19,4.6
48,395,Robertson,2020,7345,6875,470,6.4
48,397,Rockwall,2020,53209,50009,3200,6.0
48,399,Runnels,2020,4529,4306,223,4.9
48,401,Rusk,2020,22127,20508,1619,7.3
48,403,Sabine,2020,3923,3500,423,10.8
48,405,San Augustine,2020,3020,2730,290,9.6
48,407,San Jacinto,2020,11650,10710,940,8.1
48,409,San Patricio,2020,29221,26223,2998,10.3
48,411,San Saba,2020,2193,2079,114,5.2
48,413,Schleicher,2020,1209,1125,84,6.9
48,415,Scurry,2020,6251,5739,512,8.2
48,417,Shackelford,2020,1782,1688,94,5.3
48,419,Shelby,2020,11274,10502,772,6.8
48,421,Sherman,2020,1307,1267,40,3.1
48,423,Smith,2020,108544,101201,7343,6.8
48,425,Somervell,2020,4328,4048,280,6.5
48,427,Starr,2020,26319,21760,4559,17.3
48,429,Stephens,2020,4020,3775,245,6.1
48,431,Sterling,2020,560,524,36,6.4
48,433,Stonewall,2020,576,547,29,5.0
48,435,Sutton,2020,1229,1109,120,9.8
48,437,Swisher,2020,2533,2401,132,5.2
48,439,Tarrant,2020,1082822,1003269,79553,7.3
48,441,Taylor,2020,66148,62540,3608,5.5
48,443,Terrell,2020,393,375,18,4.6
48,445,Terry,2020,4840,4486,354,7.3
48,447,Throckmorton,2020,635,604,31,4.9
48,449,Titus,2020,13303,12412,891,6.7
48,451,Tom Green,2020,53742,50336,3406,6.3
48,453,Travis,2020,741012,694433,46579,6.3
48,455,Trinity,2020,5313,4884,429,8.1
48,457,Tyler,2020,7372,6645,727,9.9
48,459,Upshur,2020,17448,16103,1345,7.7
48,461,Upton,2020,1835,1732,103,5.6
48,463,Uvalde,2020,11333,10605,728,6.4
48,465,Val Verde,2020,22589,20795,1794,7.9
48,467,Van Zandt,2020,26130,24529,1601,6.1
48,469,Victoria,2020,41172,37761,3411,8.3
48,471,Walker,2020,24085,22343,1742,7.2
48,473,Waller,2020,23804,21958,1846,7.8
48,475,Ward,2020,6171,5589,582,9.4
48,477,Washington,2020,15329,14463,866,5.6
48,479,Webb,2020,116195,106376,9819,8.5
48,481,Wharton,2020,21376,19928,1448,6.8
48,483,Wheeler,2020,2226,2092,134,6.0
48,485,Wichita,2020,55306,51620,3686,6.7
48,487,Wilbarger,2020,4949,4659,290,5.9
48,489,Willacy,2020,6597,5807,790,12.0
48,491,Williamson,2020,318447,299801,18646,5.9
48,493,Wilson,2020,24473,23077,1396,5.7
48,495,Winkler,2020,4039,3663,376,9.3
48,497,Wise,2020,32140,30041,2099,6.5
48,499,Wood,2020,17919,16740,1179,6.6
48,501,Yoakum,2020,3528,3107,421,11.9
48,503,Young,2020,7803,7393,410,5.3
48,505,Zapata,2020,4600,4029,571,12.4
48,507,Zavala,2020,3430,2946,484,14.1
49,1,Beaver,2020,2831,2719,112,4.0
49,3,Box Elder,2020,26424,25272,1152,4.4
49,5,Cache,2020,65407,63497,1910,2.9
49,7,Carbon,2020,8575,8130,445,5.2
49,9,Daggett,2020,401,383,18,4.5
49,11,Davis,2020,175905,168737,7168,4.1
49,13,Duchesne,2020,7782,7179,603,7.7
49,15,Emery,2020,4372,4166,206,4.7
49,17,Garfield,2020,2634,2365,269,10.2
49,19,Grand,2020,6161,5574,587,9.5
49,21,Iron,2020,24994,23879,1115,4.5
49,23,Juab,2020,5881,5709,172,2.9
49,25,Kane,2020,3835,3629,206,5.4
49,27,Millard,2020,5941,5749,192,3.2
49,29,Morgan,2020,5561,5375,186,3.3
49,31,Piute,2020,477,447,30,6.3
49,33,Rich,2020,1162,1122,40,3.4
49,35,Salt Lake,2020,642357,609766,32591,5.1
49,37,San Juan,2020,5457,4903,554,10.2
49,39,Sanpete,2020,12640,12168,472,3.7
49,41,Sevier,2020,9811,9395,416,4.2
49,43,Summit,2020,24314,22554,1760,7.2
49,45,Tooele,2020,35084,33417,1667,4.8
49,47,Uintah,2020,13385,12157,1228,9.2
49,49,Utah,2020,314022,302248,11774,3.7
49,51,Wasatch,2020,16269,15223,1046,6.4
49,53,Washington,2020,79208,75007,4201,5.3
49,55,Wayne,2020,1428,1320,108,7.6
49,57,Weber,2020,129907,123697,6210,4.8
50,1,Addison,2020,19936,18947,989,5.0
50,3,Bennington,2020,17132,16004,1128,6.6
50,5,Caledonia,2020,14156,13337,819,5.8
50,7,Chittenden,2020,93110,88659,4451,4.8
50,9,Essex,2020,2596,2426,170,6.5
50,11,Franklin,2020,26329,24946,1383,5.3
50,13,Grand Isle,2020,4003,3766,237,5.9
50,15,Lamoille,2020,13376,12328,1048,7.8
50,17,Orange,2020,15395,14652,743,4.8
50,19,Orleans,2020,12702,11694,1008,7.9
50,21,Rutland,2020,29383,27352,2031,6.9
50,23,Washington,2020,33025,31429,1596,4.8
50,25,Windham,2020,21014,19687,1327,6.3
50,27,Windsor,2020,27903,26420,1483,5.3
51,1,Accomack,2020,16052,15011,1041,6.5
51,3,Albemarle,2020,55794,52792,3002,5.4
51,5,Alleghany,2020,6820,6376,444,6.5
51,7,Amelia,2020,6202,5845,357,5.8
51,9,Amherst,2020,14695,13872,823,5.6
51,11,Appomattox,2020,7046,6636,410,5.8
51,13,Arlington,2020,151080,144307,6773,4.5
51,15,Augusta,2020,37046,35344,1702,4.6
51,17,Bath,2020,2290,2063,227,9.9
51,19,Bedford,2020,37737,35800,1937,5.1
51,21,Bland,2020,2811,2653,158,5.6
51,23,Botetourt,2020,17140,16363,777,4.5
51,25,Brunswick,2020,5951,5477,474,8.0
51,27,Buchanan,2020,6450,5836,614,9.5
51,29,Buckingham,2020,6317,5850,467,7.4
51,31,Campbell,2020,25507,24001,1506,5.9
51,33,Caroline,2020,15004,13995,1009,6.7
51,35,Carroll,2020,13153,12078,1075,8.2
51,36,Charles City,2020,3610,3375,235,6.5
51,37,Charlotte,2020,5084,4799,285,5.6
51,41,Chesterfield,2020,186087,175116,10971,5.9
51,43,Clarke,2020,7498,7157,341,4.5
51,45,Craig,2020,2286,2170,116,5.1
51,47,Culpeper,2020,24511,23297,1214,5.0
51,49,Cumberland,2020,4569,4289,280,6.1
51,51,Dickenson,2020,4746,4368,378,8.0
51,53,Dinwiddie,2020,13439,12578,861,6.4
51,57,Essex,2020,5488,5106,382,7.0
51,59,Fairfax,2020,628397,591882,36515,5.8
51,61,Fauquier,2020,36812,35091,1721,4.7
51,63,Floyd,2020,8054,7645,409,5.1
51,65,Fluvanna,2020,13723,13001,722,5.3
51,67,Franklin,2020,25985,24563,1422,5.5
51,69,Frederick,2020,48636,46376,2260,4.6
51,71,Giles,2020,7739,7255,484,6.3
51,73,Gloucester,2020,19249,18204,1045,5.4
51,75,Goochland,2020,11142,10600,542,4.9
51,77,Grayson,2020,8104,7644,460,5.7
51,79,Greene,2020,10198,9664,534,5.2
51,81,Greensville,2020,4239,3952,287,6.8
51,83,Halifax,2020,15176,14109,1067,7.0
51,85,Hanover,2020,57934,55136,2798,4.8
51,87,Henrico,2020,180321,168617,11704,6.5
51,89,Henry,2020,23810,21994,1816,7.6
51,91,Highland,2020,1239,1193,46,3.7
51,93,Isle of Wight,2020,19092,18115,977,5.1
51,95,James City,2020,36558,34031,2527,6.9
51,97,King and Queen,2020,3867,3669,198,5.1
51,99,King George,2020,13819,13202,617,4.5
51,101,King William,2020,9067,8576,491,5.4
51,103,Lancaster,2020,5370,4981,389,7.2
51,105,Lee,2020,8304,7772,532,6.4
51,107,Loudoun,2020,223194,211258,11936,5.3
51,109,Louisa,2020,19944,18909,1035,5.2
51,111,Lunenburg,2020,5266,4988,278,5.3
51,113,Madison,2020,7306,7026,280,3.8
51,115,Mathews,2020,4052,3852,200,4.9
51,117,Mecklenburg,2020,12679,11818,861,6.8
51,119,Middlesex,2020,5134,4872,262,5.1
51,121,Montgomery,2020,48670,46340,2330,4.8
51,125,Nelson,2020,7304,6895,409,5.6
51,127,New Kent,2020,12503,11930,573,4.6
51,131,Northampton,2020,5409,4988,421,7.8
51,133,Northumberland,2020,5686,5326,360,6.3
51,135,Nottoway,2020,7150,6784,366,5.1
51,137,Orange,2020,17061,16102,959,5.6
51,139,Page,2020,12021,11147,874,7.3
51,141,Patrick,2020,7235,6739,496,6.9
51,143,Pittsylvania,2020,29943,28010,1933,6.5
51,145,Powhatan,2020,13976,13299,677,4.8
51,147,Prince Edward,2020,10067,9415,652,6.5
51,149,Prince George,2020,14897,13928,969,6.5
51,153,Prince William,2020,245929,229901,16028,6.5
51,155,Pulaski,2020,16092,14824,1268,7.9
51,157,Rappahannock,2020,3688,3521,167,4.5
51,159,Richmond,2020,4048,3851,197,4.9
51,161,Roanoke,2020,48720,46231,2489,5.1
51,163,Rockbridge,2020,10467,9892,575,5.5
51,165,Rockingham,2020,41525,39573,1952,4.7
51,167,Russell,2020,11210,10468,742,6.6
51,169,Scott,2020,8958,8484,474,5.3
51,171,Shenandoah,2020,22129,20963,1166,5.3
51,173,Smyth,2020,13384,12523,861,6.4
51,175,Southampton,2020,9063,8614,449,5.0
51,177,Spotsylvania,2020,67201,63166,4035,6.0
51,179,Stafford,2020,72341,68242,4099,5.7
51,181,Surry,2020,3603,3396,207,5.7
51,183,Sussex,2020,3771,3450,321,8.5
51,185,Tazewell,2020,15520,14335,1185,7.6
51,187,Warren,2020,20258,19077,1181,5.8
51,191,Washington,2020,25953,24457,1496,5.8
51,193,Westmoreland,2020,9473,8915,558,5.9
51,195,Wise,2020,13076,12080,996,7.6
51,197,Wythe,2020,13827,12760,1067,7.7
51,199,York,2020,32390,30587,1803,5.6
51,510,Alexandria city,2020,100168,94157,6011,6.0
51,520,Bristol city,2020,7316,6750,566,7.7
51,530,Buena Vista city,2020,3114,2935,179,5.7
51,540,Charlottesville city,2020,25424,23785,1639,6.4
51,550,Chesapeake city,2020,122036,114556,7480,6.1
51,570,Colonial Heights city,2020,8480,7877,603,7.1
51,580,Covington city,2020,2412,2181,231,9.6
51,590,Danville city,2020,19250,17379,1871,9.7
51,595,Emporia city,2020,2344,2083,261,11.1
51,600,Fairfax city,2020,13038,12304,734,5.6
51,610,Falls Church city,2020,8284,7970,314,3.8
51,620,Franklin city,2020,3640,3332,308,8.5
51,630,Fredericksburg city,2020,14020,13017,1003,7.2
51,640,Galax city,2020,2881,2658,223,7.7
51,650,Hampton city,2020,64604,59090,5514,8.5
51,660,Harrisonburg city,2020,24259,22712,1547,6.4
51,670,Hopewell city,2020,9811,8758,1053,10.7
51,678,Lexington city,2020,2049,1906,143,7.0
51,680,Lynchburg city,2020,36015,33405,2610,7.2
51,683,Manassas city,2020,21684,20278,1406,6.5
51,685,Manassas Park city,2020,9483,8835,648,6.8
51,690,Martinsville city,2020,5670,5051,619,10.9
51,700,Newport News city,2020,89715,81929,7786,8.7
51,710,Norfolk city,2020,111825,102074,9751,8.7
51,720,Norton city,2020,1660,1536,124,7.5
51,730,Petersburg city,2020,13459,11582,1877,13.9
51,735,Poquoson city,2020,6249,5988,261,4.2
51,740,Portsmouth city,2020,44701,40428,4273,9.6
51,750,Radford city,2020,8457,7922,535,6.3
51,760,Richmond city,2020,119962,109370,10592,8.8
51,770,Roanoke city,2020,49174,45388,3786,7.7
51,775,Salem city,2020,12671,11938,733,5.8
51,790,Staunton city,2020,12247,11480,767,6.3
51,800,Suffolk city,2020,44546,41643,2903,6.5
51,810,Virginia Beach city,2020,230322,215991,14331,6.2
51,820,Waynesboro city,2020,10700,10002,698,6.5
51,830,Williamsburg city,2020,6705,6153,552,8.2
51,840,Winchester city,2020,14912,14041,871,5.8
53,1,Adams,2020,9261,8584,677,7.3
53,3,Asotin,2020,10383,9845,538,5.2
53,5,Benton,2020,103143,94682,8461,8.2
53,7,Chelan,2020,44190,40497,3693,8.4
53,9,Clallam,2020,29280,26303,2977,10.2
53,11,Clark,2020,242578,221896,20682,8.5
53,13,Columbia,2020,1724,1599,125,7.3
53,15,Cowlitz,2020,48522,43999,4523,9.3
53,17,Douglas,2020,21225,19420,1805,8.5
53,19,Ferry,2020,2469,2184,285,11.5
53,21,Franklin,2020,42497,38664,3833,9.0
53,23,Garfield,2020,819,750,69,8.4
53,25,Grant,2020,47442,43247,4195,8.8
53,27,Grays Harbor,2020,29055,25653,3402,11.7
53,29,Island,2020,36303,33305,2998,8.3
53,31,Jefferson,2020,13081,11850,1231,9.4
53,33,King,2020,1286608,1190168,96440,7.5
53,35,Kitsap,2020,129092,119140,9952,7.7
53,37,Kittitas,2020,22085,20087,1998,9.0
53,39,Klickitat,2020,9810,9002,808,8.2
53,41,Lewis,2020,35103,31819,3284,9.4
53,43,Lincoln,2020,4681,4363,318,6.8
53,45,Mason,2020,25517,23009,2508,9.8
53,47,Okanogan,2020,19581,17822,1759,9.0
53,49,Pacific,2020,8524,7610,914,10.7
53,51,Pend Oreille,2020,4958,4428,530,10.7
53,53,Pierce,2020,450196,406822,43374,9.6
53,55,San Juan,2020,8379,7714,665,7.9
53,57,Skagit,2020,62498,56374,6124,9.8
53,59,Skamania,2020,5515,5006,509,9.2
53,61,Snohomish,2020,441156,403863,37293,8.5
53,63,Spokane,2020,257308,234789,22519,8.8
53,65,Stevens,2020,18545,16799,1746,9.4
53,67,Thurston,2020,144312,132365,11947,8.3
53,69,Wahkiakum,2020,1409,1285,124,8.8
53,71,Walla Walla,2020,30165,28096,2069,6.9
53,73,Whatcom,2020,114716,103992,10724,9.3
53,75,Whitman,2020,21984,20683,1301,5.9
53,77,Yakima,2020,130759,118071,12688,9.7
54,1,Barbour,2020,7335,6729,606,8.3
54,3,Berkeley,2020,58337,54709,3628,6.2
54,5,Boone,2020,7469,6685,784,10.5
54,7,Braxton,2020,5220,4678,542,10.4
54,9,Brooke,2020,9901,9012,889,9.0
54,11,Cabell,2020,41946,38604,3342,8.0
54,13,Calhoun,2020,2535,2128,407,16.1
54,15,Clay,2020,3153,2759,394,12.5
54,17,Doddridge,2020,3847,3605,242,6.3
54,19,Fayette,2020,16264,14642,1622,10.0
54,21,Gilmer,2020,2342,2106,236,10.1
54,23,Grant,2020,5969,5580,389,6.5
54,25,Greenbrier,2020,15680,14416,1264,8.1
54,27,Hampshire,2020,10847,10253,594,5.5
54,29,Hancock,2020,13131,11814,1317,10.0
54,31,Hardy,2020,5865,5445,420,7.2
54,33,Harrison,2020,34090,31381,2709,7.9
54,35,Jackson,2020,12780,11684,1096,8.6
54,37,Jefferson,2020,30084,28298,1786,5.9
54,39,Kanawha,2020,82800,75431,7369,8.9
54,41,Lewis,2020,6337,5649,688,10.9
54,43,Lincoln,2020,7293,6564,729,10.0
54,45,Logan,2020,11181,9820,1361,12.2
54,47,McDowell,2020,4478,3914,564,12.6
54,49,Marion,2020,25363,23168,2195,8.7
54,51,Marshall,2020,13610,12260,1350,9.9
54,53,Mason,2020,10356,9479,877,8.5
54,55,Mercer,2020,20957,18989,1968,9.4
54,57,Mineral,2020,12249,11323,926,7.6
54,59,Mingo,2020,6862,5884,978,14.3
54,61,Monongalia,2020,54613,51146,3467,6.3
54,63,Monroe,2020,6079,5648,431,7.1
54,65,Morgan,2020,8362,7857,505,6.0
54,67,Nicholas,2020,9571,8587,984,10.3
54,69,Ohio,2020,20439,18715,1724,8.4
54,71,Pendleton,2020,3710,3529,181,4.9
54,73,Pleasants,2020,2720,2417,303,11.1
54,75,Pocahontas,2020,3827,3473,354,9.3
54,77,Preston,2020,15525,14394,1131,7.3
54,79,Putnam,2020,27080,25075,2005,7.4
54,81,Raleigh,2020,30524,27800,2724,8.9
54,83,Randolph,2020,12364,11230,1134,9.2
54,85,Ritchie,2020,4399,4031,368,8.4
54,87,Roane,2020,5128,4490,638,12.4
54,89,Summers,2020,4376,4033,343,7.8
54,91,Taylor,2020,7816,7240,576,7.4
54,93,Tucker,2020,3292,3013,279,8.5
54,95,Tyler,2020,3173,2845,328,10.3
54,97,Upshur,2020,9650,8726,924,9.6
54,99,Wayne,2020,15838,14510,1328,8.4
54,101,Webster,2020,3328,3016,312,9.4
54,103,Wetzel,2020,6747,6083,664,9.8
54,105,Wirt,2020,2282,2037,245,10.7
54,107,Wood,2020,36445,33221,3224,8.8
54,109,Wyoming,2020,6591,5901,690,10.5
55,1,Adams,2020,8047,7281,766,9.5
55,3,Ashland,2020,7686,7035,651,8.5
55,5,Barron,2020,23873,22413,1460,6.1
55,7,Bayfield,2020,7399,6711,688,9.3
55,9,Brown,2020,140454,132013,8441,6.0
55,11,Buffalo,2020,6336,5865,471,7.4
55,13,Burnett,2020,7157,6509,648,9.1
55,15,Calumet,2020,27096,25825,1271,4.7
55,17,Chippewa,2020,32978,30930,2048,6.2
55,19,Clark,2020,17401,16615,786,4.5
55,21,Columbia,2020,31281,29438,1843,5.9
55,23,Crawford,2020,7453,6908,545,7.3
55,25,Dane,2020,319433,304154,15279,4.8
55,27,Dodge,2020,47213,44729,2484,5.3
55,29,Door,2020,14905,13886,1019,6.8
55,31,Douglas,2020,22886,20786,2100,9.2
55,33,Dunn,2020,23606,22303,1303,5.5
55,35,Eau Claire,2020,58299,55064,3235,5.5
55,37,Florence,2020,2191,2016,175,8.0
55,39,Fond du Lac,2020,56114,52828,3286,5.9
55,41,Forest,2020,3890,3407,483,12.4
55,43,Grant,2020,27311,25875,1436,5.3
55,45,Green,2020,20555,19570,985,4.8
55,47,Green Lake,2020,9253,8616,637,6.9
55,49,Iowa,2020,13502,12678,824,6.1
55,51,Iron,2020,2547,2261,286,11.2
55,53,Jackson,2020,9877,8959,918,9.3
55,55,Jefferson,2020,45213,42762,2451,5.4
55,57,Juneau,2020,13280,12327,953,7.2
55,59,Kenosha,2020,88499,82200,6299,7.1
55,61,Kewaunee,2020,10661,10172,489,4.6
55,63,La Crosse,2020,64982,61467,3515,5.4
55,65,Lafayette,2020,9785,9365,420,4.3
55,67,Langlade,2020,9285,8684,601,6.5
55,69,Lincoln,2020,14677,13805,872,5.9
55,71,Manitowoc,2020,40419,37911,2508,6.2
55,73,Marathon,2020,72313,68711,3602,5.0
55,75,Marinette,2020,19504,17981,1523,7.8
55,77,Marquette,2020,7650,7136,514,6.7
55,78,Menominee,2020,1649,1396,253,15.3
55,79,Milwaukee,2020,463420,425483,37937,8.2
55,81,Monroe,2020,23363,22075,1288,5.5
55,83,Oconto,2020,20241,18962,1279,6.3
55,85,Oneida,2020,17800,16508,1292,7.3
55,87,Outagamie,2020,102786,97137,5649,5.5
55,89,Ozaukee,2020,47963,45366,2597,5.4
55,91,Pepin,2020,4080,3839,241,5.9
55,93,Pierce,2020,24779,23054,1725,7.0
55,95,Polk,2020,24408,22658,1750,7.2
55,97,Portage,2020,37491,35475,2016,5.4
55,99,Price,2020,6209,5785,424,6.8
55,101,Racine,2020,97155,90104,7051,7.3
55,103,Richland,2020,9009,8551,458,5.1
55,105,Rock,2020,84935,78908,6027,7.1
55,107,Rusk,2020,6581,6144,437,6.6
55,109,St. Croix,2020,49739,46223,3516,7.1
55,111,Sauk,2020,34355,31770,2585,7.5
55,113,Sawyer,2020,7910,7289,621,7.9
55,115,Shawano,2020,20791,19463,1328,6.4
55,117,Sheboygan,2020,61510,57996,3514,5.7
55,119,Taylor,2020,10905,10372,533,4.9
55,121,Trempealeau,2020,15607,14512,1095,7.0
55,123,Vernon,2020,14896,14119,777,5.2
55,125,Vilas,2020,10221,9480,741,7.2
55,127,Walworth,2020,56322,52906,3416,6.1
55,129,Washburn,2020,7777,7240,537,6.9
55,131,Washington,2020,75700,71445,4255,5.6
55,133,Waukesha,2020,220498,208246,12252,5.6
55,135,Waupaca,2020,25439,24028,1411,5.5
55,137,Waushara,2020,11080,10378,702,6.3
55,139,Winnebago,2020,91236,86270,4966,5.4
55,141,Wood,2020,34538,32233,2305,6.7
56,1,Albany,2020,19726,18946,780,4.0
56,3,Big Horn,2020,5381,5112,269,5.0
56,5,Campbell,2020,23439,21822,1617,6.9
56,7,Carbon,2020,8111,7743,368,4.5
56,9,Converse,2020,8163,7677,486,6.0
56,11,Crook,2020,3908,3757,151,3.9
56,13,Fremont,2020,19326,18120,1206,6.2
56,15,Goshen,2020,6639,6355,284,4.3
56,17,Hot Springs,2020,2249,2136,113,5.0
56,19,Johnson,2020,4192,3960,232,5.5
56,21,Laramie,2020,50826,48231,2595,5.1
56,23,Lincoln,2020,9373,8907,466,5.0
56,25,Natrona,2020,40710,37529,3181,7.8
56,27,Niobrara,2020,1265,1217,48,3.8
56,29,Park,2020,15380,14549,831,5.4
56,31,Platte,2020,4651,4418,233,5.0
56,33,Sheridan,2020,16210,15409,801,4.9
56,35,Sublette,2020,4059,3765,294,7.2
56,37,Sweetwater,2020,20840,19308,1532,7.4
56,39,Teton,2020,15204,14292,912,6.0
56,41,Uinta,2020,9312,8730,582,6.3
56,43,Washakie,2020,4004,3793,211,5.3
56,45,Weston,2020,3836,3688,148,3.9
1,1,Autauga,1990,16936,15831,1105,6.5
1,3,Baldwin,1990,46896,44429,2467,5.3
1,5,Barbour,1990,11510,10604,906,7.9
1,7,Bibb,1990,7449,6766,683,9.2
1,9,Blount,1990,19196,17975,1221,6.4
1,11,Bullock,1990,4416,3863,553,12.5
1,13,Butler,1990,8857,7714,1143,12.9
1,15,Calhoun,1990,51604,47895,3709,7.2
1,17,Chambers,1990,17736,16452,1284,7.2
1,19,Cherokee,1990,9659,8702,957,9.9
1,21,Chilton,1990,15217,13850,1367,9.0
1,23,Choctaw,1990,6723,5874,849,12.6
1,25,Clarke,1990,11732,10768,964,8.2
1,27,Clay,1990,6348,5896,452,7.1
1,29,Cleburne,1990,6289,5875,414,6.6
1,31,Coffee,1990,18866,17667,1199,6.4
1,33,Colbert,1990,24545,22552,1993,8.1
1,35,Conecuh,1990,5775,5208,567,9.8
1,37,Coosa,1990,4990,4668,322,6.5
1,39,Covington,1990,17189,15853,1336,7.8
1,41,Crenshaw,1990,6092,5635,457,7.5
1,43,Cullman,1990,32905,30563,2342,7.1
1,45,Dale,1990,20566,19406,1160,5.6
1,47,Dallas,1990,19501,17116,2385,12.2
1,49,DeKalb,1990,27431,25378,2053,7.5
1,51,Elmore,1990,22568,21174,1394,6.2
1,53,Escambia,1990,15030,13722,1308,8.7
1,55,Etowah,1990,46721,41570,5151,11.0
1,57,Fayette,1990,8507,7667,840,9.9
1,59,Franklin,1990,13665,12111,1554,11.4
1,61,Geneva,1990,11126,10596,530,4.8
1,63,Greene,1990,3785,3342,443,11.7
1,65,Hale,1990,6213,5731,482,7.8
1,67,Henry,1990,6878,6547,331,4.8
1,69,Houston,1990,40907,39110,1797,4.4
1,71,Jackson,1990,23721,21543,2178,9.2
1,73,Jefferson,1990,311494,295655,15839,5.1
1,75,Lamar,1990,7703,7085,618,8.0
1,77,Lauderdale,1990,38093,35429,2664,7.0
1,79,Lawrence,1990,15166,13891,1275,8.4
1,81,Lee,1990,43517,40847,2670,6.1
1,83,Limestone,1990,26696,24943,1753,6.6
1,85,Lowndes,1990,4838,4073,765,15.8
1,87,Macon,1990,9237,8406,831,9.0
1,89,Madison,1990,128972,122728,6244,4.8
1,91,Marengo,1990,9851,9188,663,6.7
1,93,Marion,1990,14433,12388,2045,14.2
1,95,Marshall,1990,35317,32139,3178,9.0
1,97,Mobile,1990,171301,159374,11927,7.0
1,99,Monroe,1990,10340,9247,1093,10.6
1,101,Montgomery,1990,101090,94745,6345,6.3
1,103,Morgan,1990,50544,47288,3256,6.4
1,105,Perry,1990,4872,4234,638,13.1
1,107,Pickens,1990,8621,7826,795,9.2
1,109,Pike,1990,12329,11578,751,6.1
1,111,Randolph,1990,9294,8571,723,7.8
1,113,Russell,1990,21726,19949,1777,8.2
1,115,St. Clair,1990,23432,22127,1305,5.6
1,117,Shelby,1990,53345,51596,1749,3.3
1,119,Sumter,1990,6010,5422,588,9.8
1,121,Talladega,1990,33707,30584,3123,9.3
1,123,Tallapoosa,1990,19272,18027,1245,6.5
1,125,Tuscaloosa,1990,70117,66890,3227,4.6
1,127,Walker,1990,30264,27418,2846,9.4
1,129,Washington,1990,6610,5900,710,10.7
1,131,Wilcox,1990,4249,3719,530,12.5
1,133,Winston,1990,10504,9252,1252,11.9
2,13,Aleutians East Borough,1990,1313,1308,5,0.4
2,16,Aleutians West Census Area,1990,3568,3551,17,0.5
2,20,Anchorage Borough/municipality,1990,122990,116530,6460,5.3
2,50,Bethel Census Area,1990,4072,3775,297,7.3
2,60,Bristol Bay Borough,1990,476,456,20,4.2
2,68,Denali Borough,1990,1000,866,134,13.4
2,70,Dillingham Census Area,1990,1221,1139,82,6.7
2,90,Fairbanks North Star Borough,1990,35856,32736,3120,8.7
2,100,Haines Borough,1990,1092,1013,79,7.2
2,110,Juneau Borough/city,1990,15202,14400,802,5.3
2,122,Kenai Peninsula Borough,1990,18949,16663,2286,12.1
2,130,Ketchikan Gateway Borough,1990,7489,6894,595,7.9
2,150,Kodiak Island Borough,1990,6346,6006,340,5.4
2,158,Kusilvak Census Area,1990,1376,1209,167,12.1
2,164,Lake and Peninsula Borough,1990,444,417,27,6.1
2,170,Matanuska-Susitna Borough,1990,18002,15803,2199,12.2
2,180,Nome Census Area,1990,3181,2887,294,9.2
2,185,North Slope Borough,1990,2818,2715,103,3.7
2,188,Northwest Arctic Borough,1990,2121,1804,317,14.9
2,201,Prince of Wales-Outer Ketchikan Census Area,1990,2907,2582,325,11.2
2,220,Sitka Borough/city,1990,4498,4263,235,5.2
2,232,Skagway-Hoonah-Angoon Census Area,1990,2526,2263,263,10.4
2,240,Southeast Fairbanks Census Area,1990,2247,1958,289,12.9
2,261,Valdez-Cordova Census Area,1990,5211,4617,594,11.4
2,280,Wrangell-Petersburg Census Area,1990,3617,3297,320,8.8
2,290,Yukon-Koyukuk Census Area,1990,1961,1674,287,14.6
4,1,Apache,1990,17278,15030,2248,13.0
4,3,Cochise,1990,36811,34447,2364,6.4
4,5,Coconino,1990,48102,44512,3590,7.5
4,7,Gila,1990,15548,14408,1140,7.3
4,9,Graham,1990,8994,8367,627,7.0
4,11,Greenlee,1990,3374,3155,219,6.5
4,12,La Paz,1990,5442,5074,368,6.8
4,13,Maricopa,1990,1114896,1067168,47728,4.3
4,15,Mohave,1990,44554,42400,2154,4.8
4,17,Navajo,1990,26420,23574,2846,10.8
4,19,Pima,1990,314153,299929,14224,4.5
4,21,Pinal,1990,45470,42658,2812,6.2
4,23,Santa Cruz,1990,12801,11079,1722,13.5
4,25,Yavapai,1990,44949,42929,2020,4.5
4,27,Yuma,1990,46921,37265,9656,20.6
5,1,Arkansas,1990,10223,9745,478,4.7
5,3,Ashley,1990,10946,10296,650,5.9
5,5,Baxter,1990,11917,11198,719,6.0
5,7,Benton,1990,48987,47218,1769,3.6
5,9,Boone,1990,13868,13087,781,5.6
5,11,Bradley,1990,5194,4707,487,9.4
5,13,Calhoun,1990,2636,2332,304,11.5
5,15,Carroll,1990,9938,9348,590,5.9
5,17,Chicot,1990,5982,5361,621,10.4
5,19,Clark,1990,10002,9260,742,7.4
5,21,Clay,1990,8135,7567,568,7.0
5,23,Cleburne,1990,8743,8130,613,7.0
5,25,Cleveland,1990,3505,3270,235,6.7
5,27,Columbia,1990,11823,10948,875,7.4
5,29,Conway,1990,8950,8393,557,6.2
5,31,Craighead,1990,37005,34851,2154,5.8
5,33,Crawford,1990,20988,19247,1741,8.3
5,35,Crittenden,1990,22787,21095,1692,7.4
5,37,Cross,1990,8553,7841,712,8.3
5,39,Dallas,1990,4248,3893,355,8.4
5,41,Desha,1990,6865,6150,715,10.4
5,43,Drew,1990,8634,7876,758,8.8
5,45,Faulkner,1990,32034,29705,2329,7.3
5,47,Franklin,1990,7171,6588,583,8.1
5,49,Fulton,1990,4043,3791,252,6.2
5,51,Garland,1990,32211,30089,2122,6.6
5,53,Grant,1990,6850,6500,350,5.1
5,55,Greene,1990,15629,14548,1081,6.9
5,57,Hempstead,1990,10251,9353,898,8.8
5,59,Hot Spring,1990,11478,10467,1011,8.8
5,61,Howard,1990,6559,6035,524,8.0
5,63,Independence,1990,15690,14557,1133,7.2
5,65,Izard,1990,4545,4313,232,5.1
5,67,Jackson,1990,8424,7461,963,11.4
5,69,Jefferson,1990,38193,34757,3436,9.0
5,71,Johnson,1990,8214,7536,678,8.3
5,73,Lafayette,1990,3708,3431,277,7.5
5,75,Lawrence,1990,7774,6941,833,10.7
5,77,Lee,1990,4621,4078,543,11.8
5,79,Lincoln,1990,4675,4314,361,7.7
5,81,Little River,1990,7178,6852,326,4.5
5,83,Logan,1990,9280,8694,586,6.3
5,85,Lonoke,1990,19710,18539,1171,5.9
5,87,Madison,1990,6034,5746,288,4.8
5,89,Marion,1990,4930,4591,339,6.9
5,91,Miller,1990,17134,16109,1025,6.0
5,93,Mississippi,1990,24953,22603,2350,9.4
5,95,Monroe,1990,4459,4119,340,7.6
5,97,Montgomery,1990,3391,3265,126,3.7
5,99,Nevada,1990,4619,4141,478,10.3
5,101,Newton,1990,2981,2743,238,8.0
5,103,Ouachita,1990,14646,12625,2021,13.8
5,105,Perry,1990,3783,3474,309,8.2
5,107,Phillips,1990,10660,9479,1181,11.1
5,109,Pike,1990,4633,4188,445,9.6
5,111,Poinsett,1990,11259,10172,1087,9.7
5,113,Polk,1990,7721,7360,361,4.7
5,115,Pope,1990,23674,22157,1517,6.4
5,117,Prairie,1990,4375,4093,282,6.4
5,119,Pulaski,1990,186923,176795,10128,5.4
5,121,Randolph,1990,7299,6614,685,9.4
5,123,St. Francis,1990,11512,10167,1345,11.7
5,125,Saline,1990,33692,31811,1881,5.6
5,127,Scott,1990,4738,4413,325,6.9
5,129,Searcy,1990,3189,2912,277,8.7
5,131,Sebastian,1990,52676,48872,3804,7.2
5,133,Sevier,1990,6457,6178,279,4.3
5,135,Sharp,1990,5023,4646,377,7.5
5,137,Stone,1990,4371,4066,305,7.0
5,139,Union,1990,20863,19419,1444,6.9
5,141,Van Buren,1990,5587,5082,505,9.0
5,143,Washington,1990,61339,59025,2314,3.8
5,145,White,1990,26418,23841,2577,9.8
5,147,Woodruff,1990,4058,3634,424,10.4
5,149,Yell,1990,8669,8197,472,5.4
6,1,Alameda,1990,677208,649849,27359,4.0
6,3,Alpine,1990,375,339,36,9.6
6,5,Amador,1990,11451,10859,592,5.2
6,7,Butte,1990,78770,72160,6610,8.4
6,9,Calaveras,1990,13443,12529,914,6.8
6,11,Colusa,1990,8002,6862,1140,14.2
6,13,Contra Costa,1990,435190,417764,17426,4.0
6,15,Del Norte,1990,9605,8451,1154,12.0
6,17,El Dorado,1990,63819,60979,2840,4.5
6,19,Fresno,1990,328546,290417,38129,11.6
6,21,Glenn,1990,11245,9845,1400,12.4
6,23,Humboldt,1990,56242,51802,4440,7.9
6,25,Imperial,1990,47275,35247,12028,25.4
6,27,Inyo,1990,7009,6510,499,7.1
6,29,Kern,1990,256691,228803,27888,10.9
6,31,Kings,1990,37558,33351,4207,11.2
6,33,Lake,1990,19965,18199,1766,8.8
6,35,Lassen,1990,9976,8999,977,9.8
6,37,Los Angeles,1990,4505158,4237818,267340,5.9
6,39,Madera,1990,41526,35945,5581,13.4
6,41,Marin,1990,131859,128546,3313,2.5
6,43,Mariposa,1990,6772,6390,382,5.6
6,45,Mendocino,1990,38734,35786,2948,7.6
6,47,Merced,1990,76862,67019,9843,12.8
6,49,Modoc,1990,3762,3400,362,9.6
6,51,Mono,1990,5716,5379,337,5.9
6,53,Monterey,1990,172654,156030,16624,9.6
6,55,Napa,1990,56406,54082,2324,4.1
6,57,Nevada,1990,36018,34293,1725,4.8
6,59,Orange,1990,1352652,1305545,47107,3.5
6,61,Placer,1990,89518,85752,3766,4.2
6,63,Plumas,1990,9465,8529,936,9.9
6,65,Riverside,1990,536428,498080,38348,7.1
6,67,Sacramento,1990,522132,498278,23854,4.6
6,69,San Benito,1990,20929,18389,2540,12.1
6,71,San Bernardino,1990,634972,599326,35646,5.6
6,73,San Diego,1990,1214754,1158747,56007,4.6
6,75,San Francisco/city,1990,409267,393892,15375,3.8
6,77,San Joaquin,1990,226952,204525,22427,9.9
6,79,San Luis Obispo,1990,99740,95134,4606,4.6
6,81,San Mateo,1990,370139,360459,9680,2.6
6,83,Santa Barbara,1990,192494,183102,9392,4.9
6,85,Santa Clara,1990,852141,818468,33673,4.0
6,87,Santa Cruz,1990,135642,125907,9735,7.2
6,89,Shasta,1990,67666,61845,5821,8.6
6,91,Sierra,1990,1628,1451,177,10.9
6,93,Siskiyou,1990,19427,17064,2363,12.2
6,95,Solano,1990,164840,156961,7879,4.8
6,97,Sonoma,1990,206224,198252,7972,3.9
6,99,Stanislaus,1990,180340,159040,21300,11.8
6,101,Sutter,1990,33112,28454,4658,14.1
6,103,Tehama,1990,19916,17929,1987,10.0
6,105,Trinity,1990,5341,4677,664,12.4
6,107,Tulare,1990,145704,127773,17931,12.3
6,109,Tuolumne,1990,19863,18530,1333,6.7
6,111,Ventura,1990,366467,345397,21070,5.7
6,113,Yolo,1990,73992,68929,5063,6.8
6,115,Yuba,1990,22135,19783,2352,10.6
8,1,Adams,1990,141131,133093,8038,5.7
8,3,Alamosa,1990,6762,6276,486,7.2
8,5,Arapahoe,1990,225937,217486,8451,3.7
8,7,Archuleta,1990,2691,2555,136,5.1
8,9,Baca,1990,2034,1996,38,1.9
8,11,Bent,1990,2083,2013,70,3.4
8,13,Boulder,1990,124858,118832,6026,4.8
8,14,Broomfield/city,1990,14295,13778,517,3.6
8,15,Chaffee,1990,5860,5464,396,6.8
8,17,Cheyenne,1990,1184,1169,15,1.3
8,19,Clear Creek,1990,4456,4281,175,3.9
8,21,Conejos,1990,3129,2761,368,11.8
8,23,Costilla,1990,1413,1264,149,10.5
8,25,Crowley,1990,1145,1100,45,3.9
8,27,Custer,1990,896,856,40,4.5
8,29,Delta,1990,8567,7971,596,7.0
8,31,Denver/city,1990,253222,239198,14024,5.5
8,33,Dolores,1990,672,640,32,4.8
8,35,Douglas,1990,35564,34461,1103,3.1
8,37,Eagle,1990,12579,12131,448,3.6
8,39,Elbert,1990,5533,5313,220,4.0
8,41,El Paso,1990,191688,178161,13527,7.1
8,43,Fremont,1990,12984,12153,831,6.4
8,45,Garfield,1990,16783,16101,682,4.1
8,47,Gilpin,1990,2402,2344,58,2.4
8,49,Grand,1990,4338,4205,133,3.1
8,51,Gunnison,1990,6031,5592,439,7.3
8,53,Hinsdale,1990,405,396,9,2.2
8,55,Huerfano,1990,2541,2339,202,7.9
8,57,Jackson,1990,890,865,25,2.8
8,59,Jefferson,1990,256595,246846,9749,3.8
8,61,Kiowa,1990,802,781,21,2.6
8,63,Kit Carson,1990,3336,3296,40,1.2
8,65,Lake,1990,2839,2666,173,6.1
8,67,La Plata,1990,17467,16445,1022,5.9
8,69,Larimer,1990,104304,99240,5064,4.9
8,71,Las Animas,1990,5528,5077,451,8.2
8,73,Lincoln,1990,2222,2163,59,2.7
8,75,Logan,1990,8806,8501,305,3.5
8,77,Mesa,1990,44898,42237,2661,5.9
8,79,Mineral,1990,300,280,20,6.7
8,81,Moffat,1990,5954,5619,335,5.6
8,83,Montezuma,1990,9274,8599,675,7.3
8,85,Montrose,1990,11710,10974,736,6.3
8,87,Morgan,1990,10359,9897,462,4.5
8,89,Otero,1990,8500,7899,601,7.1
8,91,Ouray,1990,1238,1118,120,9.7
8,93,Park,1990,4550,4379,171,3.8
8,95,Phillips,1990,1845,1818,27,1.5
8,97,Pitkin,1990,8163,7730,433,5.3
8,99,Prowers,1990,6184,5847,337,5.4
8,101,Pueblo,1990,52577,48801,3776,7.2
8,103,Rio Blanco,1990,3189,3055,134,4.2
8,105,Rio Grande,1990,5041,4542,499,9.9
8,107,Routt,1990,8282,7935,347,4.2
8,109,Saguache,1990,2265,1996,269,11.9
8,111,San Juan,1990,468,431,37,7.9
8,113,San Miguel,1990,2460,2335,125,5.1
8,115,Sedgwick,1990,1283,1260,23,1.8
8,117,Summit,1990,8150,7855,295,3.6
8,119,Teller,1990,7508,7171,337,4.5
8,121,Washington,1990,2220,2176,44,2.0
8,123,Weld,1990,66866,63055,3811,5.7
8,125,Yuma,1990,4030,3944,86,2.1
9,1,Fairfield,1990,461402,440480,20922,4.5
9,3,Hartford,1990,469404,446077,23327,5.0
9,5,Litchfield,1990,101896,97237,4659,4.6
9,7,Middlesex,1990,83556,80256,3300,3.9
9,9,New Haven,1990,439647,415982,23665,5.4
9,11,New London,1990,131105,123870,7235,5.5
9,13,Tolland,1990,74601,71707,2894,3.9
9,15,Windham,1990,55472,51637,3835,6.9
10,1,Kent,1990,58454,55923,2531,4.3
10,3,New Castle,1990,239872,228419,11453,4.8
10,5,Sussex,1990,61799,59825,1974,3.2
11,1,District of Colu,1990,331677,312071,19606,5.9
12,1,Alachua,1990,94437,90959,3478,3.7
12,3,Baker,1990,8103,7499,604,7.5
12,5,Bay,1990,61703,55966,5737,9.3
12,7,Bradford,1990,9291,8861,430,4.6
12,9,Brevard,1990,206268,194813,11455,5.6
12,11,Broward,1990,670701,631046,39655,5.9
12,13,Calhoun,1990,4513,4176,337,7.5
12,15,Charlotte,1990,41860,39806,2054,4.9
12,17,Citrus,1990,33298,30508,2790,8.4
12,19,Clay,1990,54297,51884,2413,4.4
12,21,Collier,1990,73707,69576,4131,5.6
12,23,Columbia,1990,20382,18600,1782,8.7
12,27,DeSoto,1990,9779,9061,718,7.3
12,29,Dixie,1990,3815,3524,291,7.6
12,31,Duval,1990,354310,335066,19244,5.4
12,33,Escambia,1990,122109,114861,7248,5.9
12,35,Flagler,1990,11862,11097,765,6.4
12,37,Franklin,1990,3897,3681,216,5.5
12,39,Gadsden,1990,18170,17236,934,5.1
12,41,Gilchrist,1990,4049,3725,324,8.0
12,43,Glades,1990,3251,2899,352,10.8
12,45,Gulf,1990,5332,4971,361,6.8
12,47,Hamilton,1990,4221,3876,345,8.2
12,49,Hardee,1990,9312,8195,1117,12.0
12,51,Hendry,1990,13032,11265,1767,13.6
12,53,Hernando,1990,36453,33718,2735,7.5
12,55,Highlands,1990,26047,23661,2386,9.2
12,57,Hillsborough,1990,457334,434635,22699,5.0
12,59,Holmes,1990,6796,6316,480,7.1
12,61,Indian River,1990,41486,36636,4850,11.7
12,63,Jackson,1990,18878,17732,1146,6.1
12,65,Jefferson,1990,5313,5083,230,4.3
12,67,Lafayette,1990,2341,2202,139,5.9
12,69,Lake,1990,67058,61483,5575,8.3
12,71,Lee,1990,155801,149605,6196,4.0
12,73,Leon,1990,113707,109945,3762,3.3
12,75,Levy,1990,10725,10116,609,5.7
12,77,Liberty,1990,2222,2132,90,4.1
12,79,Madison,1990,7092,6451,641,9.0
12,81,Manatee,1990,95915,92015,3900,4.1
12,83,Marion,1990,84048,78859,5189,6.2
12,85,Martin,1990,45811,42286,3525,7.7
12,86,Miami-Dade,1990,980820,906445,74375,7.6
12,87,Monroe,1990,41151,40030,1121,2.7
12,89,Nassau,1990,22829,21482,1347,5.9
12,91,Okaloosa,1990,66399,62397,4002,6.0
12,93,Okeechobee,1990,13824,12648,1176,8.5
12,95,Orange,1990,394839,372462,22377,5.7
12,97,Osceola,1990,59258,56268,2990,5.0
12,99,Palm Beach,1990,435540,403344,32196,7.4
12,101,Pasco,1990,110044,103012,7032,6.4
12,103,Pinellas,1990,423946,403741,20205,4.8
12,105,Polk,1990,202824,181823,21001,10.4
12,107,Putnam,1990,26397,24695,1702,6.4
12,109,St. Johns,1990,44413,42074,2339,5.3
12,111,St. Lucie,1990,72863,63211,9652,13.2
12,113,Santa Rosa,1990,39316,37106,2210,5.6
12,115,Sarasota,1990,124636,119851,4785,3.8
12,117,Seminole,1990,170279,160987,9292,5.5
12,119,Sumter,1990,12340,11357,983,8.0
12,121,Suwannee,1990,12108,11128,980,8.1
12,123,Taylor,1990,8350,7325,1025,12.3
12,125,Union,1990,3765,3571,194,5.2
12,127,Volusia,1990,169695,160719,8976,5.3
12,129,Wakulla,1990,7888,7578,310,3.9
12,131,Walton,1990,13025,12171,854,6.6
12,133,Washington,1990,7463,6937,526,7.0
13,1,Appling,1990,7470,6587,883,11.8
13,3,Atkinson,1990,2760,2556,204,7.4
13,5,Bacon,1990,4402,4146,256,5.8
13,7,Baker,1990,1578,1497,81,5.1
13,9,Baldwin,1990,16808,16120,688,4.1
13,11,Banks,1990,5575,5284,291,5.2
13,13,Barrow,1990,15231,14076,1155,7.6
13,15,Bartow,1990,29810,27685,2125,7.1
13,17,Ben Hill,1990,7218,6772,446,6.2
13,19,Berrien,1990,6939,6442,497,7.2
13,21,Bibb,1990,69504,66043,3461,5.0
13,23,Bleckley,1990,4898,4619,279,5.7
13,25,Brantley,1990,4789,4389,400,8.4
13,27,Brooks,1990,6392,6159,233,3.6
13,29,Bryan,1990,7104,6794,310,4.4
13,31,Bulloch,1990,19617,18606,1011,5.2
13,33,Burke,1990,8654,7735,919,10.6
13,35,Butts,1990,6465,6039,426,6.6
13,37,Calhoun,1990,2087,1973,114,5.5
13,39,Camden,1990,11570,10965,605,5.2
13,43,Candler,1990,3491,3319,172,4.9
13,45,Carroll,1990,36722,34507,2215,6.0
13,47,Catoosa,1990,21292,20335,957,4.5
13,49,Charlton,1990,3542,3374,168,4.7
13,51,Chatham,1990,100397,95812,4585,4.6
13,53,Chattahoochee,1990,2253,2023,230,10.2
13,55,Chattooga,1990,10704,9924,780,7.3
13,57,Cherokee,1990,51104,49017,2087,4.1
13,59,Clarke,1990,43368,40881,2487,5.7
13,61,Clay,1990,1322,1261,61,4.6
13,63,Clayton,1990,102805,97385,5420,5.3
13,65,Clinch,1990,2571,2444,127,4.9
13,67,Cobb,1990,266180,255600,10580,4.0
13,69,Coffee,1990,14363,13343,1020,7.1
13,71,Colquitt,1990,16611,15757,854,5.1
13,73,Columbia,1990,34658,33531,1127,3.3
13,75,Cook,1990,6346,5949,397,6.3
13,77,Coweta,1990,27606,26030,1576,5.7
13,79,Crawford,1990,4284,4001,283,6.6
13,81,Crisp,1990,8671,8080,591,6.8
13,83,Dade,1990,6240,5877,363,5.8
13,85,Dawson,1990,5236,4976,260,5.0
13,87,Decatur,1990,11020,10547,473,4.3
13,89,DeKalb,1990,317252,301886,15366,4.8
13,91,Dodge,1990,7611,7165,446,5.9
13,93,Dooly,1990,3970,3728,242,6.1
13,95,Dougherty,1990,42550,39320,3230,7.6
13,97,Douglas,1990,39634,37809,1825,4.6
13,99,Early,1990,5118,4811,307,6.0
13,101,Echols,1990,1038,988,50,4.8
13,103,Effingham,1990,12298,11837,461,3.7
13,105,Elbert,1990,8950,8225,725,8.1
13,107,Emanuel,1990,8884,8081,803,9.0
13,109,Evans,1990,3876,3719,157,4.1
13,111,Fannin,1990,6954,6422,532,7.7
13,113,Fayette,1990,33449,32373,1076,3.2
13,115,Floyd,1990,42212,39014,3198,7.6
13,117,Forsyth,1990,24803,23697,1106,4.5
13,119,Franklin,1990,8258,7612,646,7.8
13,121,Fulton,1990,339956,321323,18633,5.5
13,123,Gilmer,1990,6635,6153,482,7.3
13,125,Glascock,1990,1120,1055,65,5.8
13,127,Glynn,1990,30528,29228,1300,4.3
13,129,Gordon,1990,18971,17529,1442,7.6
13,131,Grady,1990,9391,8934,457,4.9
13,133,Greene,1990,5197,4851,346,6.7
13,135,Gwinnett,1990,214849,206134,8715,4.1
13,137,Habersham,1990,14084,13369,715,5.1
13,139,Hall,1990,52614,49755,2859,5.4
13,141,Hancock,1990,3622,3397,225,6.2
13,143,Haralson,1990,10404,9696,708,6.8
13,145,Harris,1990,8678,8240,438,5.0
13,147,Hart,1990,9730,9137,593,6.1
13,149,Heard,1990,3963,3762,201,5.1
13,151,Henry,1990,32311,30858,1453,4.5
13,153,Houston,1990,42820,41130,1690,3.9
13,155,Irwin,1990,3887,3663,224,5.8
13,157,Jackson,1990,15069,14133,936,6.2
13,159,Jasper,1990,3836,3615,221,5.8
13,161,Jeff Davis,1990,5854,5484,370,6.3
13,163,Jefferson,1990,7479,6888,591,7.9
13,165,Jenkins,1990,3556,3210,346,9.7
13,167,Johnson,1990,3675,3433,242,6.6
13,169,Jones,1990,10632,10199,433,4.1
13,171,Lamar,1990,6161,5842,319,5.2
13,173,Lanier,1990,2506,2390,116,4.6
13,175,Laurens,1990,18502,17519,983,5.3
13,177,Lee,1990,7896,7468,428,5.4
13,179,Liberty,1990,13869,12937,932,6.7
13,181,Lincoln,1990,3297,3111,186,5.6
13,183,Long,1990,2457,2340,117,4.8
13,185,Lowndes,1990,34016,32442,1574,4.6
13,187,Lumpkin,1990,7205,6845,360,5.0
13,189,McDuffie,1990,9538,9012,526,5.5
13,191,McIntosh,1990,3830,3550,280,7.3
13,193,Macon,1990,5827,5318,509,8.7
13,195,Madison,1990,11213,10445,768,6.8
13,197,Marion,1990,2266,1980,286,12.6
13,199,Meriwether,1990,9528,8828,700,7.3
13,201,Miller,1990,2676,2587,89,3.3
13,205,Mitchell,1990,9044,8188,856,9.5
13,207,Monroe,1990,8228,7721,507,6.2
13,209,Montgomery,1990,3345,3122,223,6.7
13,211,Morgan,1990,6392,5944,448,7.0
13,213,Murray,1990,14334,13364,970,6.8
13,215,Muscogee,1990,76554,71885,4669,6.1
13,217,Newton,1990,20769,19341,1428,6.9
13,219,Oconee,1990,9460,9059,401,4.2
13,221,Oglethorpe,1990,5153,4854,299,5.8
13,223,Paulding,1990,22104,21002,1102,5.0
13,225,Peach,1990,9476,8928,548,5.8
13,227,Pickens,1990,7662,7055,607,7.9
13,229,Pierce,1990,6344,5958,386,6.1
13,231,Pike,1990,5001,4728,273,5.5
13,233,Polk,1990,16481,14691,1790,10.9
13,235,Pulaski,1990,3604,3400,204,5.7
13,237,Putnam,1990,6842,6616,226,3.3
13,239,Quitman,1990,873,815,58,6.6
13,241,Rabun,1990,5770,5477,293,5.1
13,243,Randolph,1990,3083,2839,244,7.9
13,245,Richmond,1990,85378,80799,4579,5.4
13,247,Rockdale,1990,30112,28821,1291,4.3
13,249,Schley,1990,1659,1511,148,8.9
13,251,Screven,1990,6052,5591,461,7.6
13,253,Seminole,1990,4043,3882,161,4.0
13,255,Spalding,1990,26698,25205,1493,5.6
13,257,Stephens,1990,11935,11081,854,7.2
13,259,Stewart,1990,2143,1964,179,8.4
13,261,Sumter,1990,13698,12496,1202,8.8
13,263,Talbot,1990,2871,2676,195,6.8
13,265,Taliaferro,1990,753,714,39,5.2
13,267,Tattnall,1990,6859,6530,329,4.8
13,269,Taylor,1990,3191,2910,281,8.8
13,271,Telfair,1990,4729,4336,393,8.3
13,273,Terrell,1990,4584,4204,380,8.3
13,275,Thomas,1990,18150,17262,888,4.9
13,277,Tift,1990,17637,16373,1264,7.2
13,279,Toombs,1990,10802,10111,691,6.4
13,281,Towns,1990,2827,2648,179,6.3
13,283,Treutlen,1990,2670,2471,199,7.5
13,285,Troup,1990,26330,24753,1577,6.0
13,287,Turner,1990,3538,3265,273,7.7
13,289,Twiggs,1990,4029,3790,239,5.9
13,291,Union,1990,5179,4949,230,4.4
13,293,Upson,1990,12384,11704,680,5.5
13,295,Walker,1990,28470,26699,1771,6.2
13,297,Walton,1990,19534,18235,1299,6.6
13,299,Ware,1990,14791,13904,887,6.0
13,301,Warren,1990,2568,2353,215,8.4
13,303,Washington,1990,8507,8019,488,5.7
13,305,Wayne,1990,10331,9669,662,6.4
13,307,Webster,1990,1066,981,85,8.0
13,309,Wheeler,1990,2049,1902,147,7.2
13,311,White,1990,6845,6530,315,4.6
13,313,Whitfield,1990,39691,37578,2113,5.3
13,315,Wilcox,1990,2868,2730,138,4.8
13,317,Wilkes,1990,4846,4590,256,5.3
13,319,Wilkinson,1990,4634,4453,181,3.9
13,321,Worth,1990,9003,8463,540,6.0
15,1,Hawaii,1990,58347,56155,2192,3.8
15,3,Honolulu/city,1990,408718,400155,8563,2.1
15,7,Kauai,1990,26112,25111,1001,3.8
15,9,Maui,1990,57306,54736,2570,4.5
16,1,Ada,1990,111077,106882,4195,3.8
16,3,Adams,1990,1612,1417,195,12.1
16,5,Bannock,1990,31335,29156,2179,7.0
16,7,Bear Lake,1990,2378,2251,127,5.3
16,9,Benewah,1990,3556,3169,387,10.9
16,11,Bingham,1990,18383,17381,1002,5.5
16,13,Blaine,1990,8346,8095,251,3.0
16,15,Boise,1990,1530,1439,91,5.9
16,17,Bonner,1990,12042,10923,1119,9.3
16,19,Bonneville,1990,38686,37259,1427,3.7
16,21,Boundary,1990,3483,3174,309,8.9
16,23,Butte,1990,1448,1385,63,4.4
16,25,Camas,1990,465,436,29,6.2
16,27,Canyon,1990,42794,40007,2787,6.5
16,29,Caribou,1990,2964,2820,144,4.9
16,31,Cassia,1990,8433,7824,609,7.2
16,33,Clark,1990,551,535,16,2.9
16,35,Clearwater,1990,3919,3400,519,13.2
16,37,Custer,1990,2200,2099,101,4.6
16,39,Elmore,1990,7958,7500,458,5.8
16,41,Franklin,1990,3821,3689,132,3.5
16,43,Fremont,1990,4990,4578,412,8.3
16,45,Gem,1990,5242,4891,351,6.7
16,47,Gooding,1990,5220,5012,208,4.0
16,49,Idaho,1990,6103,5583,520,8.5
16,51,Jefferson,1990,8079,7660,419,5.2
16,53,Jerome,1990,6974,6649,325,4.7
16,55,Kootenai,1990,34863,32216,2647,7.6
16,57,Latah,1990,14033,13350,683,4.9
16,59,Lemhi,1990,3238,2980,258,8.0
16,61,Lewis,1990,1508,1389,119,7.9
16,63,Lincoln,1990,2012,1939,73,3.6
16,65,Madison,1990,8512,8134,378,4.4
16,67,Minidoka,1990,8920,8291,629,7.1
16,69,Nez Perce,1990,19526,18758,768,3.9
16,71,Oneida,1990,1402,1356,46,3.3
16,73,Owyhee,1990,3739,3556,183,4.9
16,75,Payette,1990,8674,7927,747,8.6
16,77,Power,1990,3312,3024,288,8.7
16,79,Shoshone,1990,6114,5538,576,9.4
16,81,Teton,1990,1827,1753,74,4.1
16,83,Twin Falls,1990,25454,24291,1163,4.6
16,85,Valley,1990,3266,2987,279,8.5
16,87,Washington,1990,4185,3772,413,9.9
17,1,Adams,1990,34002,32335,1667,4.9
17,3,Alexander,1990,4111,3609,502,12.2
17,5,Bond,1990,7668,7097,571,7.4
17,7,Boone,1990,17658,16419,1239,7.0
17,9,Brown,1990,2474,2319,155,6.3
17,11,Bureau,1990,17596,16651,945,5.4
17,13,Calhoun,1990,2249,2006,243,10.8
17,15,Carroll,1990,8490,8036,454,5.3
17,17,Cass,1990,6783,6210,573,8.4
17,19,Champaign,1990,94257,91503,2754,2.9
17,21,Christian,1990,18232,17314,918,5.0
17,23,Clark,1990,8652,8032,620,7.2
17,25,Clay,1990,6745,6101,644,9.5
17,27,Clinton,1990,16976,15923,1053,6.2
17,29,Coles,1990,26213,24802,1411,5.4
17,31,Cook,1990,2609450,2420642,188808,7.2
17,33,Crawford,1990,9032,8244,788,8.7
17,35,Cumberland,1990,5287,4825,462,8.7
17,37,DeKalb,1990,42473,40390,2083,4.9
17,39,De Witt,1990,8400,7937,463,5.5
17,41,Douglas,1990,10045,9621,424,4.2
17,43,DuPage,1990,454032,435861,18171,4.0
17,45,Edgar,1990,9654,8911,743,7.7
17,47,Edwards,1990,3673,3437,236,6.4
17,49,Effingham,1990,16580,15474,1106,6.7
17,51,Fayette,1990,9636,8788,848,8.8
17,53,Ford,1990,7138,6836,302,4.2
17,55,Franklin,1990,17475,15093,2382,13.6
17,57,Fulton,1990,15031,13816,1215,8.1
17,59,Gallatin,1990,2917,2675,242,8.3
17,61,Greene,1990,7194,6782,412,5.7
17,63,Grundy,1990,16748,15236,1512,9.0
17,65,Hamilton,1990,3600,3245,355,9.9
17,67,Hancock,1990,10913,10377,536,4.9
17,69,Hardin,1990,1943,1782,161,8.3
17,71,Henderson,1990,4181,3934,247,5.9
17,73,Henry,1990,26229,24808,1421,5.4
17,75,Iroquois,1990,15260,14529,731,4.8
17,77,Jackson,1990,30231,28358,1873,6.2
17,79,Jasper,1990,4992,4708,284,5.7
17,81,Jefferson,1990,17688,15864,1824,10.3
17,83,Jersey,1990,10257,9678,579,5.6
17,85,Jo Daviess,1990,11437,10958,479,4.2
17,87,Johnson,1990,4295,3841,454,10.6
17,89,Kane,1990,172650,162412,10238,5.9
17,91,Kankakee,1990,48766,45613,3153,6.5
17,93,Kendall,1990,21838,20861,977,4.5
17,95,Knox,1990,29268,27403,1865,6.4
17,97,Lake,1990,287625,276674,10951,3.8
17,99,LaSalle,1990,51420,47278,4142,8.1
17,101,Lawrence,1990,7099,6495,604,8.5
17,103,Lee,1990,16677,15870,807,4.8
17,105,Livingston,1990,19328,18726,602,3.1
17,107,Logan,1990,14150,13404,746,5.3
17,109,McDonough,1990,16803,16248,555,3.3
17,111,McHenry,1990,102523,96996,5527,5.4
17,113,McLean,1990,74315,71856,2459,3.3
17,115,Macon,1990,60055,56188,3867,6.4
17,117,Macoupin,1990,23389,21924,1465,6.3
17,119,Madison,1990,127831,120015,7816,6.1
17,121,Marion,1990,19741,17517,2224,11.3
17,123,Marshall,1990,6371,6099,272,4.3
17,125,Mason,1990,7675,7137,538,7.0
17,127,Massac,1990,6595,6139,456,6.9
17,129,Menard,1990,6067,5821,246,4.1
17,131,Mercer,1990,8606,8072,534,6.2
17,133,Monroe,1990,12303,11580,723,5.9
17,135,Montgomery,1990,14130,13096,1034,7.3
17,137,Morgan,1990,19106,18342,764,4.0
17,139,Moultrie,1990,6853,6457,396,5.8
17,141,Ogle,1990,25524,24228,1296,5.1
17,143,Peoria,1990,92225,87444,4781,5.2
17,145,Perry,1990,9488,8311,1177,12.4
17,147,Piatt,1990,8500,8099,401,4.7
17,149,Pike,1990,8703,8129,574,6.6
17,151,Pope,1990,1617,1456,161,10.0
17,153,Pulaski,1990,2886,2572,314,10.9
17,155,Putnam,1990,2922,2721,201,6.9
17,157,Randolph,1990,15711,14486,1225,7.8
17,159,Richland,1990,8286,7716,570,6.9
17,161,Rock Island,1990,74492,70740,3752,5.0
17,163,St. Clair,1990,120606,111740,8866,7.4
17,165,Saline,1990,10642,9611,1031,9.7
17,167,Sangamon,1990,103486,99888,3598,3.5
17,169,Schuyler,1990,3543,3242,301,8.5
17,171,Scott,1990,2881,2714,167,5.8
17,173,Shelby,1990,10733,10047,686,6.4
17,175,Stark,1990,2936,2751,185,6.3
17,177,Stephenson,1990,25911,24382,1529,5.9
17,179,Tazewell,1990,65086,61952,3134,4.8
17,181,Union,1990,8332,7451,881,10.6
17,183,Vermilion,1990,42303,38583,3720,8.8
17,185,Wabash,1990,6342,5881,461,7.3
17,187,Warren,1990,9971,9403,568,5.7
17,189,Washington,1990,7587,7080,507,6.7
17,191,Wayne,1990,8356,7572,784,9.4
17,193,White,1990,7301,6654,647,8.9
17,195,Whiteside,1990,30866,29166,1700,5.5
17,197,Will,1990,186562,174395,12167,6.5
17,199,Williamson,1990,27075,24592,2483,9.2
17,201,Winnebago,1990,142052,134364,7688,5.4
17,203,Woodford,1990,16971,16447,524,3.1
18,1,Adams,1990,15258,14301,957,6.3
18,3,Allen,1990,162210,154235,7975,4.9
18,5,Bartholomew,1990,33758,32197,1561,4.6
18,7,Benton,1990,4640,4491,149,3.2
18,9,Blackford,1990,6944,6328,616,8.9
18,11,Boone,1990,20415,19952,463,2.3
18,13,Brown,1990,7265,6951,314,4.3
18,15,Carroll,1990,9533,9160,373,3.9
18,17,Cass,1990,18791,17559,1232,6.6
18,19,Clark,1990,45810,43226,2584,5.6
18,21,Clay,1990,11178,10637,541,4.8
18,23,Clinton,1990,14573,13927,646,4.4
18,25,Crawford,1990,4395,3979,416,9.5
18,27,Daviess,1990,12391,11915,476,3.8
18,29,Dearborn,1990,19482,17953,1529,7.8
18,31,Decatur,1990,11991,11513,478,4.0
18,33,DeKalb,1990,19106,18008,1098,5.7
18,35,Delaware,1990,58703,55566,3137,5.3
18,37,Dubois,1990,20202,19588,614,3.0
18,39,Elkhart,1990,85101,80603,4498,5.3
18,41,Fayette,1990,13147,11485,1662,12.6
18,43,Floyd,1990,32654,31084,1570,4.8
18,45,Fountain,1990,8298,7778,520,6.3
18,47,Franklin,1990,9768,9001,767,7.9
18,49,Fulton,1990,9295,8855,440,4.7
18,51,Gibson,1990,15861,14892,969,6.1
18,53,Grant,1990,36476,33742,2734,7.5
18,55,Greene,1990,14037,12935,1102,7.9
18,57,Hamilton,1990,61001,59690,1311,2.1
18,59,Hancock,1990,24318,23589,729,3.0
18,61,Harrison,1990,14989,14224,765,5.1
18,63,Hendricks,1990,40462,39531,931,2.3
18,65,Henry,1990,23793,21697,2096,8.8
18,67,Howard,1990,40083,37315,2768,6.9
18,69,Huntington,1990,18770,17843,927,4.9
18,71,Jackson,1990,18786,17656,1130,6.0
18,73,Jasper,1990,12031,11275,756,6.3
18,75,Jay,1990,10759,9914,845,7.9
18,77,Jefferson,1990,14872,13896,976,6.6
18,79,Jennings,1990,11627,11000,627,5.4
18,81,Johnson,1990,47979,46594,1385,2.9
18,83,Knox,1990,18567,17248,1319,7.1
18,85,Kosciusko,1990,34140,32900,1240,3.6
18,87,LaGrange,1990,14035,13200,835,5.9
18,89,Lake,1990,222258,208524,13734,6.2
18,91,LaPorte,1990,52123,49424,2699,5.2
18,93,Lawrence,1990,21578,19592,1986,9.2
18,95,Madison,1990,63782,60121,3661,5.7
18,97,Marion,1990,423758,408761,14997,3.5
18,99,Marshall,1990,22403,21259,1144,5.1
18,101,Martin,1990,4935,4637,298,6.0
18,103,Miami,1990,15928,14972,956,6.0
18,105,Monroe,1990,54694,53021,1673,3.1
18,107,Montgomery,1990,17393,16787,606,3.5
18,109,Morgan,1990,29195,28019,1176,4.0
18,111,Newton,1990,6595,6309,286,4.3
18,113,Noble,1990,20062,18550,1512,7.5
18,115,Ohio,1990,2622,2420,202,7.7
18,117,Orange,1990,8717,7773,944,10.8
18,119,Owen,1990,8144,7705,439,5.4
18,121,Parke,1990,7199,6775,424,5.9
18,123,Perry,1990,8543,7764,779,9.1
18,125,Pike,1990,5929,5544,385,6.5
18,127,Porter,1990,65802,63308,2494,3.8
18,129,Posey,1990,12909,12332,577,4.5
18,131,Pulaski,1990,5876,5529,347,5.9
18,133,Putnam,1990,13849,13183,666,4.8
18,135,Randolph,1990,13087,11812,1275,9.7
18,137,Ripley,1990,11913,11245,668,5.6
18,139,Rush,1990,8796,8235,561,6.4
18,141,St. Joseph,1990,125361,118347,7014,5.6
18,143,Scott,1990,9617,8828,789,8.2
18,145,Shelby,1990,21370,20198,1172,5.5
18,147,Spencer,1990,9801,9196,605,6.2
18,149,Starke,1990,10288,9565,723,7.0
18,151,Steuben,1990,14790,13993,797,5.4
18,153,Sullivan,1990,8546,7965,581,6.8
18,155,Switzerland,1990,3588,3314,274,7.6
18,157,Tippecanoe,1990,65692,63975,1717,2.6
18,159,Tipton,1990,8295,7838,457,5.5
18,161,Union,1990,3481,3213,268,7.7
18,163,Vanderburgh,1990,84703,80256,4447,5.3
18,165,Vermillion,1990,7498,7030,468,6.2
18,167,Vigo,1990,49077,46743,2334,4.8
18,169,Wabash,1990,18175,17068,1107,6.1
18,171,Warren,1990,3776,3606,170,4.5
18,173,Warrick,1990,23549,22512,1037,4.4
18,175,Washington,1990,11198,10464,734,6.6
18,177,Wayne,1990,35755,32771,2984,8.3
18,179,Wells,1990,13666,13081,585,4.3
18,181,White,1990,12134,11443,691,5.7
18,183,Whitley,1990,14736,13902,834,5.7
19,1,Adair,1990,4027,3924,103,2.6
19,3,Adams,1990,2440,2346,94,3.9
19,5,Allamakee,1990,7186,6775,411,5.7
19,7,Appanoose,1990,6368,5927,441,6.9
19,9,Audubon,1990,3610,3488,122,3.4
19,11,Benton,1990,11450,10844,606,5.3
19,13,Black Hawk,1990,62364,58696,3668,5.9
19,15,Boone,1990,12649,12098,551,4.4
19,17,Bremer,1990,11442,11000,442,3.9
19,19,Buchanan,1990,9596,9055,541,5.6
19,21,Buena Vista,1990,10028,9760,268,2.7
19,23,Butler,1990,7350,7003,347,4.7
19,25,Calhoun,1990,4975,4853,122,2.5
19,27,Carroll,1990,10731,10274,457,4.3
19,29,Cass,1990,7557,7135,422,5.6
19,31,Cedar,1990,9097,8838,259,2.8
19,33,Cerro Gordo,1990,25283,23914,1369,5.4
19,35,Cherokee,1990,6730,6542,188,2.8
19,37,Chickasaw,1990,7094,6653,441,6.2
19,39,Clarke,1990,4233,4016,217,5.1
19,41,Clay,1990,8989,8777,212,2.4
19,43,Clayton,1990,9226,8707,519,5.6
19,45,Clinton,1990,25650,24117,1533,6.0
19,47,Crawford,1990,8542,8042,500,5.9
19,49,Dallas,1990,16171,15587,584,3.6
19,51,Davis,1990,3875,3730,145,3.7
19,53,Decatur,1990,3806,3559,247,6.5
19,55,Delaware,1990,8830,8415,415,4.7
19,57,Des Moines,1990,22127,20932,1195,5.4
19,59,Dickinson,1990,8063,7791,272,3.4
19,61,Dubuque,1990,46209,43381,2828,6.1
19,63,Emmet,1990,5566,5243,323,5.8
19,65,Fayette,1990,10298,9848,450,4.4
19,67,Floyd,1990,8582,8110,472,5.5
19,69,Franklin,1990,5747,5511,236,4.1
19,71,Fremont,1990,3742,3609,133,3.6
19,73,Greene,1990,4896,4646,250,5.1
19,75,Grundy,1990,5795,5643,152,2.6
19,77,Guthrie,1990,5458,5245,213,3.9
19,79,Hamilton,1990,8388,7979,409,4.9
19,81,Hancock,1990,6249,5870,379,6.1
19,83,Hardin,1990,9425,8969,456,4.8
19,85,Harrison,1990,7126,6830,296,4.2
19,87,Henry,1990,10052,9691,361,3.6
19,89,Howard,1990,4613,4428,185,4.0
19,91,Humboldt,1990,4973,4811,162,3.3
19,93,Ida,1990,3890,3791,99,2.5
19,95,Iowa,1990,8017,7809,208,2.6
19,97,Jackson,1990,10040,9368,672,6.7
19,99,Jasper,1990,17922,17267,655,3.7
19,101,Jefferson,1990,8525,8156,369,4.3
19,103,Johnson,1990,57734,55876,1858,3.2
19,105,Jones,1990,9335,8873,462,4.9
19,107,Keokuk,1990,5339,5091,248,4.6
19,109,Kossuth,1990,8864,8462,402,4.5
19,111,Lee,1990,18960,17703,1257,6.6
19,113,Linn,1990,97055,91537,5518,5.7
19,115,Louisa,1990,5925,5653,272,4.6
19,117,Lucas,1990,4275,4011,264,6.2
19,119,Lyon,1990,5668,5545,123,2.2
19,121,Madison,1990,6383,6099,284,4.4
19,123,Mahaska,1990,10571,10144,427,4.0
19,125,Marion,1990,15790,15188,602,3.8
19,127,Marshall,1990,20058,19366,692,3.4
19,129,Mills,1990,6440,6207,233,3.6
19,131,Mitchell,1990,5165,4959,206,4.0
19,133,Monona,1990,4471,4308,163,3.6
19,135,Monroe,1990,3748,3539,209,5.6
19,137,Montgomery,1990,6136,5850,286,4.7
19,139,Muscatine,1990,20917,19863,1054,5.0
19,141,O'Brien,1990,7333,7172,161,2.2
19,143,Osceola,1990,3520,3415,105,3.0
19,145,Page,1990,8156,7753,403,4.9
19,147,Palo Alto,1990,4855,4669,186,3.8
19,149,Plymouth,1990,11850,11478,372,3.1
19,151,Pocahontas,1990,4348,4253,95,2.2
19,153,Polk,1990,190157,183779,6378,3.4
19,155,Pottawattamie,1990,43720,41974,1746,4.0
19,157,Poweshiek,1990,10008,9543,465,4.6
19,159,Ringgold,1990,2563,2459,104,4.1
19,161,Sac,1990,5879,5640,239,4.1
19,163,Scott,1990,78923,75467,3456,4.4
19,165,Shelby,1990,6563,6289,274,4.2
19,167,Sioux,1990,15306,14874,432,2.8
19,169,Story,1990,41909,40326,1583,3.8
19,171,Tama,1990,8252,7879,373,4.5
19,173,Taylor,1990,3105,2990,115,3.7
19,175,Union,1990,6087,5779,308,5.1
19,177,Van Buren,1990,3623,3495,128,3.5
19,179,Wapello,1990,16961,15929,1032,6.1
19,181,Warren,1990,20403,19833,570,2.8
19,183,Washington,1990,10422,10129,293,2.8
19,185,Wayne,1990,3213,3119,94,2.9
19,187,Webster,1990,19543,18515,1028,5.3
19,189,Winnebago,1990,6440,5927,513,8.0
19,191,Winneshiek,1990,11328,10677,651,5.7
19,193,Woodbury,1990,50332,48064,2268,4.5
19,195,Worth,1990,4051,3781,270,6.7
19,197,Wright,1990,7130,6874,256,3.6
20,1,Allen,1990,6844,6450,394,5.8
20,3,Anderson,1990,3765,3550,215,5.7
20,5,Atchison,1990,8150,7650,500,6.1
20,7,Barber,1990,2829,2769,60,2.1
20,9,Barton,1990,15046,14550,496,3.3
20,11,Bourbon,1990,6745,6379,366,5.4
20,13,Brown,1990,5058,4874,184,3.6
20,15,Butler,1990,26014,25151,863,3.3
20,17,Chase,1990,1397,1315,82,5.9
20,19,Chautauqua,1990,1757,1686,71,4.0
20,21,Cherokee,1990,9690,8944,746,7.7
20,23,Cheyenne,1990,1518,1504,14,0.9
20,25,Clark,1990,1253,1239,14,1.1
20,27,Clay,1990,4332,4183,149,3.4
20,29,Cloud,1990,5417,5210,207,3.8
20,31,Coffey,1990,3982,3776,206,5.2
20,33,Comanche,1990,1076,1061,15,1.4
20,35,Cowley,1990,17933,16820,1113,6.2
20,37,Crawford,1990,16442,15406,1036,6.3
20,39,Decatur,1990,1991,1947,44,2.2
20,41,Dickinson,1990,9386,9046,340,3.6
20,43,Doniphan,1990,3783,3523,260,6.9
20,45,Douglas,1990,44656,42562,2094,4.7
20,47,Edwards,1990,1845,1806,39,2.1
20,49,Elk,1990,1448,1395,53,3.7
20,51,Ellis,1990,14140,13667,473,3.3
20,53,Ellsworth,1990,2899,2825,74,2.6
20,55,Finney,1990,17638,17107,531,3.0
20,57,Ford,1990,14149,13739,410,2.9
20,59,Franklin,1990,11167,10516,651,5.8
20,61,Geary,1990,10778,9965,813,7.5
20,63,Gove,1990,1481,1461,20,1.4
20,65,Graham,1990,1724,1686,38,2.2
20,67,Grant,1990,3659,3581,78,2.1
20,69,Gray,1990,2649,2595,54,2.0
20,71,Greeley,1990,904,889,15,1.7
20,73,Greenwood,1990,3589,3420,169,4.7
20,75,Hamilton,1990,1260,1247,13,1.0
20,77,Harper,1990,3299,3222,77,2.3
20,79,Harvey,1990,16145,15647,498,3.1
20,81,Haskell,1990,2008,1960,48,2.4
20,83,Hodgeman,1990,973,959,14,1.4
20,85,Jackson,1990,5659,5329,330,5.8
20,87,Jefferson,1990,8149,7745,404,5.0
20,89,Jewell,1990,2087,2044,43,2.1
20,91,Johnson,1990,210945,204820,6125,2.9
20,93,Kearny,1990,2033,1981,52,2.6
20,95,Kingman,1990,3922,3791,131,3.3
20,97,Kiowa,1990,1735,1708,27,1.6
20,99,Labette,1990,11571,10771,800,6.9
20,101,Lane,1990,1128,1110,18,1.6
20,103,Leavenworth,1990,25513,24254,1259,4.9
20,105,Lincoln,1990,1806,1736,70,3.9
20,107,Linn,1990,3357,3079,278,8.3
20,109,Logan,1990,1567,1541,26,1.7
20,111,Lyon,1990,18310,17419,891,4.9
20,113,McPherson,1990,14402,13990,412,2.9
20,115,Marion,1990,6350,6175,175,2.8
20,117,Marshall,1990,5345,5243,102,1.9
20,119,Meade,1990,2197,2161,36,1.6
20,121,Miami,1990,12149,11561,588,4.8
20,123,Mitchell,1990,3488,3383,105,3.0
20,125,Montgomery,1990,18079,17006,1073,5.9
20,127,Morris,1990,2933,2833,100,3.4
20,129,Morton,1990,1626,1596,30,1.8
20,131,Nemaha,1990,5098,5021,77,1.5
20,133,Neosho,1990,8355,7984,371,4.4
20,135,Ness,1990,1970,1934,36,1.8
20,137,Norton,1990,2897,2850,47,1.6
20,139,Osage,1990,7489,6992,497,6.6
20,141,Osborne,1990,2418,2379,39,1.6
20,143,Ottawa,1990,2784,2650,134,4.8
20,145,Pawnee,1990,3661,3585,76,2.1
20,147,Phillips,1990,3136,3081,55,1.8
20,149,Pottawatomie,1990,8357,7940,417,5.0
20,151,Pratt,1990,4845,4705,140,2.9
20,153,Rawlins,1990,1634,1607,27,1.7
20,155,Reno,1990,31335,29972,1363,4.3
20,157,Republic,1990,3205,3162,43,1.3
20,159,Rice,1990,4844,4695,149,3.1
20,161,Riley,1990,28238,27096,1142,4.0
20,163,Rooks,1990,2749,2676,73,2.7
20,165,Rush,1990,1815,1781,34,1.9
20,167,Russell,1990,3744,3650,94,2.5
20,169,Saline,1990,26966,25922,1044,3.9
20,171,Scott,1990,2696,2645,51,1.9
20,173,Sedgwick,1990,215921,206941,8980,4.2
20,175,Seward,1990,9845,9451,394,4.0
20,177,Shawnee,1990,86871,82758,4113,4.7
20,179,Sheridan,1990,1500,1481,19,1.3
20,181,Sherman,1990,3552,3457,95,2.7
20,183,Smith,1990,2439,2399,40,1.6
20,185,Stafford,1990,2413,2357,56,2.3
20,187,Stanton,1990,1118,1099,19,1.7
20,189,Stevens,1990,2459,2415,44,1.8
20,191,Sumner,1990,12314,11789,525,4.3
20,193,Thomas,1990,4274,4139,135,3.2
20,195,Trego,1990,1811,1780,31,1.7
20,197,Wabaunsee,1990,3278,3156,122,3.7
20,199,Wallace,1990,880,864,16,1.8
20,201,Washington,1990,3472,3397,75,2.2
20,203,Wichita,1990,1289,1267,22,1.7
20,205,Wilson,1990,4597,4397,200,4.4
20,207,Woodson,1990,1687,1635,52,3.1
20,209,Wyandotte,1990,79456,72901,6555,8.2
21,1,Adair,1990,7271,6834,437,6.0
21,3,Allen,1990,7290,6236,1054,14.5
21,5,Anderson,1990,8150,7858,292,3.6
21,7,Ballard,1990,3749,3414,335,8.9
21,9,Barren,1990,16380,15493,887,5.4
21,11,Bath,1990,4733,4172,561,11.9
21,13,Bell,1990,10519,9463,1056,10.0
21,15,Boone,1990,31792,30754,1038,3.3
21,17,Bourbon,1990,9713,9150,563,5.8
21,19,Boyd,1990,22531,21120,1411,6.3
21,21,Boyle,1990,12612,11814,798,6.3
21,23,Bracken,1990,3517,3272,245,7.0
21,25,Breathitt,1990,5136,4572,564,11.0
21,27,Breckinridge,1990,6962,6495,467,6.7
21,29,Bullitt,1990,25404,24235,1169,4.6
21,31,Butler,1990,5440,4852,588,10.8
21,33,Caldwell,1990,6151,5696,455,7.4
21,35,Calloway,1990,15469,14567,902,5.8
21,37,Campbell,1990,43312,41804,1508,3.5
21,39,Carlisle,1990,2547,2338,209,8.2
21,41,Carroll,1990,4217,4029,188,4.5
21,43,Carter,1990,10541,9130,1411,13.4
21,45,Casey,1990,6052,5739,313,5.2
21,47,Christian,1990,24308,22607,1701,7.0
21,49,Clark,1990,14818,13794,1024,6.9
21,51,Clay,1990,6596,6089,507,7.7
21,53,Clinton,1990,4152,3745,407,9.8
21,55,Crittenden,1990,3905,3560,345,8.8
21,57,Cumberland,1990,2986,2765,221,7.4
21,59,Daviess,1990,43799,41254,2545,5.8
21,61,Edmonson,1990,4366,3961,405,9.3
21,63,Elliott,1990,2246,1935,311,13.8
21,65,Estill,1990,5844,5116,728,12.5
21,67,Fayette,1990,127927,123233,4694,3.7
21,69,Fleming,1990,5858,5549,309,5.3
21,71,Floyd,1990,14661,13439,1222,8.3
21,73,Franklin,1990,24564,23831,733,3.0
21,75,Fulton,1990,3430,3123,307,9.0
21,77,Gallatin,1990,2703,2577,126,4.7
21,79,Garrard,1990,5671,5314,357,6.3
21,81,Grant,1990,7716,7367,349,4.5
21,83,Graves,1990,15961,14233,1728,10.8
21,85,Grayson,1990,9438,8610,828,8.8
21,87,Green,1990,5209,4960,249,4.8
21,89,Greenup,1990,15972,14951,1021,6.4
21,91,Hancock,1990,3575,3258,317,8.9
21,93,Hardin,1990,34827,32644,2183,6.3
21,95,Harlan,1990,11308,10242,1066,9.4
21,97,Harrison,1990,7682,7309,373,4.9
21,99,Hart,1990,6799,6364,435,6.4
21,101,Henderson,1990,22347,21103,1244,5.6
21,103,Henry,1990,6567,6331,236,3.6
21,105,Hickman,1990,2537,2351,186,7.3
21,107,Hopkins,1990,21120,19668,1452,6.9
21,109,Jackson,1990,4337,3846,491,11.3
21,111,Jefferson,1990,353241,334731,18510,5.2
21,113,Jessamine,1990,16676,16012,664,4.0
21,115,Johnson,1990,8743,8036,707,8.1
21,117,Kenton,1990,75828,73317,2511,3.3
21,119,Knott,1990,5491,4967,524,9.5
21,121,Knox,1990,10023,9222,801,8.0
21,123,Larue,1990,5450,5144,306,5.6
21,125,Laurel,1990,18689,17371,1318,7.1
21,127,Lawrence,1990,4552,4025,527,11.6
21,129,Lee,1990,2467,2209,258,10.5
21,131,Leslie,1990,4215,3868,347,8.2
21,133,Letcher,1990,8707,7877,830,9.5
21,135,Lewis,1990,5568,5031,537,9.6
21,137,Lincoln,1990,9155,8506,649,7.1
21,139,Livingston,1990,4503,4128,375,8.3
21,141,Logan,1990,11916,11215,701,5.9
21,143,Lyon,1990,2635,2432,203,7.7
21,145,McCracken,1990,30854,29328,1526,4.9
21,147,McCreary,1990,4883,4143,740,15.2
21,149,McLean,1990,4459,4080,379,8.5
21,151,Madison,1990,30320,28445,1875,6.2
21,153,Magoffin,1990,4306,3639,667,15.5
21,155,Marion,1990,7680,7227,453,5.9
21,157,Marshall,1990,12543,11571,972,7.7
21,159,Martin,1990,3610,3331,279,7.7
21,161,Mason,1990,8042,7698,344,4.3
21,163,Meade,1990,8914,8340,574,6.4
21,165,Menifee,1990,2329,1997,332,14.3
21,167,Mercer,1990,9596,9009,587,6.1
21,169,Metcalfe,1990,4348,4115,233,5.4
21,171,Monroe,1990,5297,4946,351,6.6
21,173,Montgomery,1990,10350,9217,1133,10.9
21,175,Morgan,1990,4036,3622,414,10.3
21,177,Muhlenberg,1990,12783,11649,1134,8.9
21,179,Nelson,1990,14746,13953,793,5.4
21,181,Nicholas,1990,3434,3240,194,5.6
21,183,Ohio,1990,8707,7967,740,8.5
21,185,Oldham,1990,17433,16901,532,3.1
21,187,Owen,1990,4286,4134,152,3.5
21,189,Owsley,1990,1377,1258,119,8.6
21,191,Pendleton,1990,5701,5475,226,4.0
21,193,Perry,1990,10683,9779,904,8.5
21,195,Pike,1990,25585,23582,2003,7.8
21,197,Powell,1990,5113,4517,596,11.7
21,199,Pulaski,1990,22931,20914,2017,8.8
21,201,Robertson,1990,923,877,46,5.0
21,203,Rockcastle,1990,6180,5558,622,10.1
21,205,Rowan,1990,9401,8540,861,9.2
21,207,Russell,1990,6908,6461,447,6.5
21,209,Scott,1990,12984,12408,576,4.4
21,211,Shelby,1990,13745,13350,395,2.9
21,213,Simpson,1990,7962,7453,509,6.4
21,215,Spencer,1990,3389,3273,116,3.4
21,217,Taylor,1990,10898,10430,468,4.3
21,219,Todd,1990,5145,4800,345,6.7
21,221,Trigg,1990,4960,4699,261,5.3
21,223,Trimble,1990,2885,2751,134,4.6
21,225,Union,1990,7080,6577,503,7.1
21,227,Warren,1990,42815,39719,3096,7.2
21,229,Washington,1990,4844,4572,272,5.6
21,231,Wayne,1990,7059,6424,635,9.0
21,233,Webster,1990,6011,5626,385,6.4
21,235,Whitley,1990,12746,11724,1022,8.0
21,237,Wolfe,1990,2374,2042,332,14.0
21,239,Woodford,1990,11344,10979,365,3.2
22,1,Acadia Parish,1990,21709,20317,1392,6.4
22,3,Allen Parish,1990,7526,6783,743,9.9
22,5,Ascension Parish,1990,27154,25391,1763,6.5
22,7,Assumption Parish,1990,9303,8687,616,6.6
22,9,Avoyelles Parish,1990,14483,13068,1415,9.8
22,11,Beauregard Parish,1990,11550,10828,722,6.3
22,13,Bienville Parish,1990,5988,5561,427,7.1
22,15,Bossier Parish,1990,40160,37730,2430,6.1
22,17,Caddo Parish,1990,113491,106292,7199,6.3
22,19,Calcasieu Parish,1990,78114,73614,4500,5.8
22,21,Caldwell Parish,1990,3912,3607,305,7.8
22,23,Cameron Parish,1990,4212,4036,176,4.2
22,25,Catahoula Parish,1990,4243,3905,338,8.0
22,27,Claiborne Parish,1990,6135,5771,364,5.9
22,29,Concordia Parish,1990,8428,7558,870,10.3
22,31,De Soto Parish,1990,9945,9101,844,8.5
22,33,East Baton Rouge Parish,1990,195384,185883,9501,4.9
22,35,East Carroll Parish,1990,3161,2735,426,13.5
22,37,East Feliciana Parish,1990,7202,6767,435,6.0
22,39,Evangeline Parish,1990,11400,10561,839,7.4
22,41,Franklin Parish,1990,8832,8113,719,8.1
22,43,Grant Parish,1990,7068,6605,463,6.6
22,45,Iberia Parish,1990,28908,27551,1357,4.7
22,47,Iberville Parish,1990,12708,11705,1003,7.9
22,49,Jackson Parish,1990,6018,5723,295,4.9
22,51,Jefferson Parish,1990,227512,214685,12827,5.6
22,53,Jefferson Davis Parish,1990,11972,11163,809,6.8
22,55,Lafayette Parish,1990,82613,79173,3440,4.2
22,57,Lafourche Parish,1990,36643,35133,1510,4.1
22,59,LaSalle Parish,1990,5747,5485,262,4.6
22,61,Lincoln Parish,1990,17742,16855,887,5.0
22,63,Livingston Parish,1990,33403,31046,2357,7.1
22,65,Madison Parish,1990,4618,4097,521,11.3
22,67,Morehouse Parish,1990,12340,11291,1049,8.5
22,69,Natchitoches Parish,1990,15019,13791,1228,8.2
22,71,Orleans Parish,1990,206396,191741,14655,7.1
22,73,Ouachita Parish,1990,65733,62104,3629,5.5
22,75,Plaquemines Parish,1990,10140,9513,627,6.2
22,77,Pointe Coupee Parish,1990,9009,8157,852,9.5
22,79,Rapides Parish,1990,55889,52556,3333,6.0
22,81,Red River Parish,1990,3699,3392,307,8.3
22,83,Richland Parish,1990,8404,7648,756,9.0
22,85,Sabine Parish,1990,8450,8072,378,4.5
22,87,St. Bernard Parish,1990,31289,28840,2449,7.8
22,89,St. Charles Parish,1990,19646,18448,1198,6.1
22,91,St. Helena Parish,1990,3633,3393,240,6.6
22,93,St. James Parish,1990,8867,8166,701,7.9
22,95,St. John the Baptist Parish,1990,17935,16503,1432,8.0
22,97,St. Landry Parish,1990,29759,27260,2499,8.4
22,99,St. Martin Parish,1990,18979,17905,1074,5.7
22,101,St. Mary Parish,1990,24652,23092,1560,6.3
22,103,St. Tammany Parish,1990,68225,64177,4048,5.9
22,105,Tangipahoa Parish,1990,35267,31977,3290,9.3
22,107,Tensas Parish,1990,2654,2456,198,7.5
22,109,Terrebonne Parish,1990,40453,38677,1776,4.4
22,111,Union Parish,1990,8539,8019,520,6.1
22,113,Vermilion Parish,1990,20152,19041,1111,5.5
22,115,Vernon Parish,1990,16497,15361,1136,6.9
22,117,Washington Parish,1990,15905,14587,1318,8.3
22,119,Webster Parish,1990,17772,16229,1543,8.7
22,121,West Baton Rouge Parish,1990,9190,8625,565,6.1
22,123,West Carroll Parish,1990,5030,4431,599,11.9
22,125,West Feliciana Parish,1990,3735,3479,256,6.9
22,127,Winn Parish,1990,6155,5894,261,4.2
23,1,Androscoggin,1990,56294,52465,3829,6.8
23,3,Aroostook,1990,38908,36205,2703,6.9
23,5,Cumberland,1990,133147,128068,5079,3.8
23,7,Franklin,1990,14467,13542,925,6.4
23,9,Hancock,1990,24576,23340,1236,5.0
23,11,Kennebec,1990,61088,58340,2748,4.5
23,13,Knox,1990,18097,17155,942,5.2
23,15,Lincoln,1990,15335,14800,535,3.5
23,17,Oxford,1990,25142,23382,1760,7.0
23,19,Penobscot,1990,74423,70082,4341,5.8
23,21,Piscataquis,1990,8672,8114,558,6.4
23,23,Sagadahoc,1990,16165,15597,568,3.5
23,25,Somerset,1990,24552,22853,1699,6.9
23,27,Waldo,1990,16156,14970,1186,7.3
23,29,Washington,1990,15515,14329,1186,7.6
23,31,York,1990,89403,85089,4314,4.8
24,1,Allegany,1990,32180,28730,3450,10.7
24,3,Anne Arundel,1990,229816,222400,7416,3.2
24,5,Baltimore,1990,379509,362772,16737,4.4
24,9,Calvert,1990,27697,26750,947,3.4
24,11,Caroline,1990,13840,13258,582,4.2
24,13,Carroll,1990,67914,65515,2399,3.5
24,15,Cecil,1990,35766,32314,3452,9.7
24,17,Charles,1990,53640,52200,1440,2.7
24,19,Dorchester,1990,15682,14573,1109,7.1
24,21,Frederick,1990,83485,80278,3207,3.8
24,23,Garrett,1990,13373,12154,1219,9.1
24,25,Harford,1990,97274,93158,4116,4.2
24,27,Howard,1990,112402,109730,2672,2.4
24,29,Kent,1990,9322,8812,510,5.5
24,31,Montgomery,1990,437040,426919,10121,2.3
24,33,Prince George's,1990,422730,408530,14200,3.4
24,35,Queen Anne's,1990,17946,17361,585,3.3
24,37,St. Mary's,1990,37907,36377,1530,4.0
24,39,Somerset,1990,11006,9408,1598,14.5
24,41,Talbot,1990,16287,15827,460,2.8
24,43,Washington,1990,60312,56397,3915,6.5
24,45,Wicomico,1990,41916,39198,2718,6.5
24,47,Worcester,1990,22142,20372,1770,8.0
24,510,Baltimore city,1990,335326,310266,25060,7.5
25,1,Barnstable,1990,97746,90453,7293,7.5
25,3,Berkshire,1990,70054,65051,5003,7.1
25,5,Bristol,1990,265868,241313,24555,9.2
25,7,Dukes,1990,7551,7164,387,5.1
25,9,Essex,1990,350609,327032,23577,6.7
25,11,Franklin,1990,37275,35329,1946,5.2
25,13,Hampden,1990,223335,208345,14990,6.7
25,15,Hampshire,1990,80368,76221,4147,5.2
25,17,Middlesex,1990,803142,761441,41701,5.2
25,19,Nantucket/town,1990,4772,4617,155,3.2
25,21,Norfolk,1990,345212,327340,17872,5.2
25,23,Plymouth,1990,230386,213643,16743,7.3
25,25,Suffolk,1990,350738,329124,21614,6.2
25,27,Worcester,1990,366017,340175,25842,7.1
26,1,Alcona,1990,3932,3417,515,13.1
26,3,Alger,1990,3812,3460,352,9.2
26,5,Allegan,1990,45958,43151,2807,6.1
26,7,Alpena,1990,14323,12856,1467,10.2
26,9,Antrim,1990,8885,7987,898,10.1
26,11,Arenac,1990,6173,5618,555,9.0
26,13,Baraga,1990,3349,2996,353,10.5
26,15,Barry,1990,25193,23622,1571,6.2
26,17,Bay,1990,53792,49504,4288,8.0
26,19,Benzie,1990,6069,5358,711,11.7
26,21,Berrien,1990,81342,75647,5695,7.0
26,23,Branch,1990,19741,18301,1440,7.3
26,25,Calhoun,1990,64936,60206,4730,7.3
26,27,Cass,1990,24731,22929,1802,7.3
26,29,Charlevoix,1990,11287,10343,944,8.4
26,31,Cheboygan,1990,10510,9254,1256,12.0
26,33,Chippewa,1990,14644,12982,1662,11.3
26,35,Clare,1990,9273,8280,993,10.7
26,37,Clinton,1990,31409,29414,1995,6.4
26,39,Crawford,1990,5374,5013,361,6.7
26,41,Delta,1990,16973,15387,1586,9.3
26,43,Dickinson,1990,12492,11548,944,7.6
26,45,Eaton,1990,51407,48362,3045,5.9
26,47,Emmet,1990,14147,12815,1332,9.4
26,49,Genesee,1990,200224,181180,19044,9.5
26,51,Gladwin,1990,8102,7317,785,9.7
26,53,Gogebic,1990,7276,6678,598,8.2
26,55,Grand Traverse,1990,36039,33582,2457,6.8
26,57,Gratiot,1990,18494,16851,1643,8.9
26,59,Hillsdale,1990,21097,19279,1818,8.6
26,61,Houghton,1990,14600,13512,1088,7.5
26,63,Huron,1990,15942,14292,1650,10.4
26,65,Ingham,1990,151107,141791,9316,6.2
26,67,Ionia,1990,27061,24372,2689,9.9
26,69,Iosco,1990,11166,10222,944,8.5
26,71,Iron,1990,5295,4824,471,8.9
26,73,Isabella,1990,25948,24355,1593,6.1
26,75,Jackson,1990,71454,66353,5101,7.1
26,77,Kalamazoo,1990,120174,113879,6295,5.2
26,79,Kalkaska,1990,6142,5538,604,9.8
26,81,Kent,1990,270099,254860,15239,5.6
26,83,Keweenaw,1990,605,516,89,14.7
26,85,Lake,1990,2731,2404,327,12.0
26,87,Lapeer,1990,37442,33643,3799,10.1
26,89,Leelanau,1990,8773,8224,549,6.3
26,91,Lenawee,1990,43858,40548,3310,7.5
26,93,Livingston,1990,61674,58167,3507,5.7
26,95,Luce,1990,2420,2199,221,9.1
26,97,Mackinac,1990,6224,5340,884,14.2
26,99,Macomb,1990,392525,362106,30419,7.7
26,101,Manistee,1990,9395,8394,1001,10.7
26,103,Marquette,1990,32117,29534,2583,8.0
26,105,Mason,1990,12193,11178,1015,8.3
26,107,Mecosta,1990,16460,15137,1323,8.0
26,109,Menominee,1990,12030,11206,824,6.8
26,111,Midland,1990,37770,35689,2081,5.5
26,113,Missaukee,1990,5384,4817,567,10.5
26,115,Monroe,1990,67709,62547,5162,7.6
26,117,Montcalm,1990,23787,20352,3435,14.4
26,119,Montmorency,1990,3243,2752,491,15.1
26,121,Muskegon,1990,73439,67226,6213,8.5
26,123,Newaygo,1990,17286,15617,1669,9.7
26,125,Oakland,1990,604016,567898,36118,6.0
26,127,Oceana,1990,11297,10059,1238,11.0
26,129,Ogemaw,1990,7217,6505,712,9.9
26,131,Ontonagon,1990,3879,3665,214,5.5
26,133,Osceola,1990,8798,7800,998,11.3
26,135,Oscoda,1990,2925,2686,239,8.2
26,137,Otsego,1990,9363,8782,581,6.2
26,139,Ottawa,1990,104839,99295,5544,5.3
26,141,Presque Isle,1990,6057,5349,708,11.7
26,143,Roscommon,1990,7151,6501,650,9.1
26,145,Saginaw,1990,97452,89952,7500,7.7
26,147,St. Clair,1990,72371,65553,6818,9.4
26,149,St. Joseph,1990,29722,27145,2577,8.7
26,151,Sanilac,1990,19030,16968,2062,10.8
26,153,Schoolcraft,1990,3816,3197,619,16.2
26,155,Shiawassee,1990,35163,31743,3420,9.7
26,157,Tuscola,1990,26103,23578,2525,9.7
26,159,Van Buren,1990,33782,30847,2935,8.7
26,161,Washtenaw,1990,158755,151090,7665,4.8
26,163,Wayne,1990,943308,856525,86783,9.2
26,165,Wexford,1990,12430,10895,1535,12.3
27,1,Aitkin,1990,5206,4668,538,10.3
27,3,Anoka,1990,145059,138648,6411,4.4
27,5,Becker,1990,12639,11717,922,7.3
27,7,Beltrami,1990,15650,14500,1150,7.3
27,9,Benton,1990,16909,15858,1051,6.2
27,11,Big Stone,1990,2927,2805,122,4.2
27,13,Blue Earth,1990,29848,28753,1095,3.7
27,15,Brown,1990,14297,13704,593,4.1
27,17,Carlton,1990,13348,12382,966,7.2
27,19,Carver,1990,28250,27244,1006,3.6
27,21,Cass,1990,9117,8246,871,9.6
27,23,Chippewa,1990,6426,6118,308,4.8
27,25,Chisago,1990,15647,14583,1064,6.8
27,27,Clay,1990,27561,26123,1438,5.2
27,29,Clearwater,1990,3521,2948,573,16.3
27,31,Cook,1990,2257,2061,196,8.7
27,33,Cottonwood,1990,5904,5544,360,6.1
27,35,Crow Wing,1990,20978,19519,1459,7.0
27,37,Dakota,1990,166377,160464,5913,3.6
27,39,Dodge,1990,8026,7611,415,5.2
27,41,Douglas,1990,14330,13526,804,5.6
27,43,Faribault,1990,8313,7908,405,4.9
27,45,Fillmore,1990,10353,9883,470,4.5
27,47,Freeborn,1990,17334,15392,1942,11.2
27,49,Goodhue,1990,20860,20125,735,3.5
27,51,Grant,1990,2839,2656,183,6.4
27,53,Hennepin,1990,616558,592537,24021,3.9
27,55,Houston,1990,9763,9429,334,3.4
27,57,Hubbard,1990,6700,6092,608,9.1
27,59,Isanti,1990,13213,12449,764,5.8
27,61,Itasca,1990,17592,15786,1806,10.3
27,63,Jackson,1990,5507,5270,237,4.3
27,65,Kanabec,1990,6542,5873,669,10.2
27,67,Kandiyohi,1990,19196,18323,873,4.5
27,69,Kittson,1990,2594,2393,201,7.7
27,71,Koochiching,1990,7940,7398,542,6.8
27,73,Lac qui Parle,1990,4047,3911,136,3.4
27,75,Lake,1990,5077,4746,331,6.5
27,77,Lake of the Woods,1990,2092,2026,66,3.2
27,79,Le Sueur,1990,12029,11339,690,5.7
27,81,Lincoln,1990,3233,3098,135,4.2
27,83,Lyon,1990,13132,12574,558,4.2
27,85,McLeod,1990,17967,17219,748,4.2
27,87,Mahnomen,1990,1846,1637,209,11.3
27,89,Marshall,1990,4957,4348,609,12.3
27,91,Martin,1990,11625,11115,510,4.4
27,93,Meeker,1990,10182,9533,649,6.4
27,95,Mille Lacs,1990,8978,8321,657,7.3
27,97,Morrison,1990,13890,12593,1297,9.3
27,99,Mower,1990,17500,16762,738,4.2
27,101,Murray,1990,4547,4326,221,4.9
27,103,Nicollet,1990,15756,15162,594,3.8
27,105,Nobles,1990,9969,9625,344,3.5
27,107,Norman,1990,3512,3307,205,5.8
27,109,Olmsted,1990,62055,60354,1701,2.7
27,111,Otter Tail,1990,24556,23081,1475,6.0
27,113,Pennington,1990,6746,6133,613,9.1
27,115,Pine,1990,9215,8250,965,10.5
27,117,Pipestone,1990,4861,4558,303,6.2
27,119,Polk,1990,15164,14112,1052,6.9
27,121,Pope,1990,4930,4661,269,5.5
27,123,Ramsey,1990,271833,261267,10566,3.9
27,125,Red Lake,1990,2074,1760,314,15.1
27,127,Redwood,1990,8403,8142,261,3.1
27,129,Renville,1990,8251,7754,497,6.0
27,131,Rice,1990,27325,26136,1189,4.4
27,133,Rock,1990,4816,4692,124,2.6
27,135,Roseau,1990,8054,7689,365,4.5
27,137,St. Louis,1990,93615,87716,5899,6.3
27,139,Scott,1990,33531,32056,1475,4.4
27,141,Sherburne,1990,22562,21337,1225,5.4
27,143,Sibley,1990,6907,6565,342,5.0
27,145,Stearns,1990,65860,62272,3588,5.4
27,147,Steele,1990,16791,16211,580,3.5
27,149,Stevens,1990,5247,4959,288,5.5
27,151,Swift,1990,4638,4424,214,4.6
27,153,Todd,1990,10328,9535,793,7.7
27,155,Traverse,1990,1887,1793,94,5.0
27,157,Wabasha,1990,10259,9817,442,4.3
27,159,Wadena,1990,5867,5464,403,6.9
27,161,Waseca,1990,9553,9198,355,3.7
27,163,Washington,1990,83047,80009,3038,3.7
27,165,Watonwan,1990,5691,5498,193,3.4
27,167,Wilkin,1990,3658,3486,172,4.7
27,169,Winona,1990,26668,25192,1476,5.5
27,171,Wright,1990,37507,35452,2055,5.5
27,173,Yellow Medicine,1990,5368,5139,229,4.3
28,1,Adams,1990,15022,13824,1198,8.0
28,3,Alcorn,1990,15555,14059,1496,9.6
28,5,Amite,1990,5003,4697,306,6.1
28,7,Attala,1990,7970,7153,817,10.3
28,9,Benton,1990,3316,2982,334,10.1
28,11,Bolivar,1990,16750,15277,1473,8.8
28,13,Calhoun,1990,7178,6554,624,8.7
28,15,Carroll,1990,4061,3753,308,7.6
28,17,Chickasaw,1990,9562,8219,1343,14.0
28,19,Choctaw,1990,3748,3401,347,9.3
28,21,Claiborne,1990,4100,3479,621,15.1
28,23,Clarke,1990,8195,7611,584,7.1
28,25,Clay,1990,9799,8738,1061,10.8
28,27,Coahoma,1990,11929,10564,1365,11.4
28,29,Copiah,1990,11579,10499,1080,9.3
28,31,Covington,1990,7302,6644,658,9.0
28,33,DeSoto,1990,37212,35228,1984,5.3
28,35,Forrest,1990,31753,29550,2203,6.9
28,37,Franklin,1990,3034,2813,221,7.3
28,39,George,1990,7204,6429,775,10.8
28,41,Greene,1990,3944,3494,450,11.4
28,43,Grenada,1990,10121,9052,1069,10.6
28,45,Hancock,1990,12828,11906,922,7.2
28,47,Harrison,1990,71921,67123,4798,6.7
28,49,Hinds,1990,128019,120878,7141,5.6
28,51,Holmes,1990,6838,5932,906,13.2
28,53,Humphreys,1990,5141,4728,413,8.0
28,55,Issaquena,1990,846,745,101,11.9
28,57,Itawamba,1990,10637,9902,735,6.9
28,59,Jackson,1990,55070,51121,3949,7.2
28,61,Jasper,1990,7106,6452,654,9.2
28,63,Jefferson,1990,2968,2288,680,22.9
28,65,Jefferson Davis,1990,5646,4882,764,13.5
28,67,Jones,1990,27683,25911,1772,6.4
28,69,Kemper,1990,4273,3842,431,10.1
28,71,Lafayette,1990,15181,14365,816,5.4
28,73,Lamar,1990,14529,13804,725,5.0
28,75,Lauderdale,1990,34579,32133,2446,7.1
28,77,Lawrence,1990,5184,4713,471,9.1
28,79,Leake,1990,7964,7386,578,7.3
28,81,Lee,1990,35196,32885,2311,6.6
28,83,Leflore,1990,15407,13833,1574,10.2
28,85,Lincoln,1990,13074,12077,997,7.6
28,87,Lowndes,1990,28257,26425,1832,6.5
28,89,Madison,1990,26777,25363,1414,5.3
28,91,Marion,1990,10225,9241,984,9.6
28,93,Marshall,1990,13574,12177,1397,10.3
28,95,Monroe,1990,18013,16608,1405,7.8
28,97,Montgomery,1990,5548,5054,494,8.9
28,99,Neshoba,1990,11545,10784,761,6.6
28,101,Newton,1990,9433,8841,592,6.3
28,103,Noxubee,1990,4923,4343,580,11.8
28,105,Oktibbeha,1990,18153,16977,1176,6.5
28,107,Panola,1990,12988,11802,1186,9.1
28,109,Pearl River,1990,16863,15398,1465,8.7
28,111,Perry,1990,4260,3872,388,9.1
28,113,Pike,1990,15043,13854,1189,7.9
28,115,Pontotoc,1990,11732,11018,714,6.1
28,117,Prentiss,1990,11809,10705,1104,9.3
28,119,Quitman,1990,4122,3672,450,10.9
28,121,Rankin,1990,46703,44698,2005,4.3
28,123,Scott,1990,11315,10635,680,6.0
28,125,Sharkey,1990,2958,2578,380,12.8
28,127,Simpson,1990,10314,9730,584,5.7
28,129,Smith,1990,6515,6146,369,5.7
28,131,Stone,1990,4811,4461,350,7.3
28,133,Sunflower,1990,12302,10875,1427,11.6
28,135,Tallahatchie,1990,6028,5349,679,11.3
28,137,Tate,1990,10411,9639,772,7.4
28,139,Tippah,1990,9610,8810,800,8.3
28,141,Tishomingo,1990,9047,7875,1172,13.0
28,143,Tunica,1990,2931,2539,392,13.4
28,145,Union,1990,11472,10681,791,6.9
28,147,Walthall,1990,5331,4968,363,6.8
28,149,Warren,1990,22357,20693,1664,7.4
28,151,Washington,1990,28927,25920,3007,10.4
28,153,Wayne,1990,8637,7872,765,8.9
28,155,Webster,1990,4351,3980,371,8.5
28,157,Wilkinson,1990,3435,3127,308,9.0
28,159,Winston,1990,8514,7849,665,7.8
28,161,Yalobusha,1990,5434,4938,496,9.1
28,163,Yazoo,1990,9362,8709,653,7.0
29,1,Adair,1990,13130,12319,811,6.2
29,3,Andrew,1990,7444,7029,415,5.6
29,5,Atchison,1990,3458,3352,106,3.1
29,7,Audrain,1990,11235,10676,559,5.0
29,9,Barry,1990,12651,12073,578,4.6
29,11,Barton,1990,5448,5291,157,2.9
29,13,Bates,1990,6550,6091,459,7.0
29,15,Benton,1990,5534,5071,463,8.4
29,17,Bollinger,1990,4706,4291,415,8.8
29,19,Boone,1990,67511,64919,2592,3.8
29,21,Buchanan,1990,40771,37929,2842,7.0
29,23,Butler,1990,16918,15620,1298,7.7
29,25,Caldwell,1990,3575,3354,221,6.2
29,27,Callaway,1990,17112,16360,752,4.4
29,29,Camden,1990,13264,12258,1006,7.6
29,31,Cape Girardeau,1990,32670,30892,1778,5.4
29,33,Carroll,1990,4714,4368,346,7.3
29,35,Carter,1990,2190,1962,228,10.4
29,37,Cass,1990,33863,32226,1637,4.8
29,39,Cedar,1990,5135,4839,296,5.8
29,41,Chariton,1990,4310,4104,206,4.8
29,43,Christian,1990,17313,16325,988,5.7
29,45,Clark,1990,3469,3347,122,3.5
29,47,Clay,1990,87899,84146,3753,4.3
29,49,Clinton,1990,8083,7672,411,5.1
29,51,Cole,1990,33576,32358,1218,3.6
29,53,Cooper,1990,7240,6758,482,6.7
29,55,Crawford,1990,8701,7917,784,9.0
29,57,Dade,1990,3035,2903,132,4.3
29,59,Dallas,1990,5521,5074,447,8.1
29,61,Daviess,1990,3300,3113,187,5.7
29,63,DeKalb,1990,3670,3479,191,5.2
29,65,Dent,1990,5546,5137,409,7.4
29,67,Douglas,1990,5307,4921,386,7.3
29,69,Dunklin,1990,13287,12041,1246,9.4
29,71,Franklin,1990,42723,38807,3916,9.2
29,73,Gasconade,1990,7108,6573,535,7.5
29,75,Gentry,1990,2990,2905,85,2.8
29,77,Greene,1990,109091,103704,5387,4.9
29,79,Grundy,1990,4678,4425,253,5.4
29,81,Harrison,1990,3995,3824,171,4.3
29,83,Henry,1990,9150,8431,719,7.9
29,85,Hickory,1990,2552,2382,170,6.7
29,87,Holt,1990,2671,2564,107,4.0
29,89,Howard,1990,4613,4395,218,4.7
29,91,Howell,1990,14135,13253,882,6.2
29,93,Iron,1990,4272,3832,440,10.3
29,95,Jackson,1990,335932,318061,17871,5.3
29,97,Jasper,1990,45108,42652,2456,5.4
29,99,Jefferson,1990,92345,85150,7195,7.8
29,101,Johnson,1990,21671,20367,1304,6.0
29,103,Knox,1990,2009,1920,89,4.4
29,105,Laclede,1990,13324,11804,1520,11.4
29,107,Lafayette,1990,15180,14232,948,6.2
29,109,Lawrence,1990,14342,13598,744,5.2
29,111,Lewis,1990,4872,4601,271,5.6
29,113,Lincoln,1990,14500,13489,1011,7.0
29,115,Linn,1990,6306,5800,506,8.0
29,117,Livingston,1990,6608,6344,264,4.0
29,119,McDonald,1990,7198,6788,410,5.7
29,121,Macon,1990,7251,6647,604,8.3
29,123,Madison,1990,4714,4264,450,9.5
29,125,Maries,1990,4022,3731,291,7.2
29,127,Marion,1990,13339,12622,717,5.4
29,129,Mercer,1990,1493,1424,69,4.6
29,131,Miller,1990,10362,9409,953,9.2
29,133,Mississippi,1990,6225,5588,637,10.2
29,135,Moniteau,1990,6407,5967,440,6.9
29,137,Monroe,1990,4092,3890,202,4.9
29,139,Montgomery,1990,5350,4991,359,6.7
29,141,Morgan,1990,7202,6625,577,8.0
29,143,New Madrid,1990,8710,7816,894,10.3
29,145,Newton,1990,22733,21197,1536,6.8
29,147,Nodaway,1990,12036,11535,501,4.2
29,149,Oregon,1990,3718,3509,209,5.6
29,151,Osage,1990,6445,6168,277,4.3
29,153,Ozark,1990,3516,3274,242,6.9
29,155,Pemiscot,1990,8191,7371,820,10.0
29,157,Perry,1990,8572,8145,427,5.0
29,159,Pettis,1990,17860,16570,1290,7.2
29,161,Phelps,1990,17229,16174,1055,6.1
29,163,Pike,1990,7182,6641,541,7.5
29,165,Platte,1990,34441,33138,1303,3.8
29,167,Polk,1990,9974,9298,676,6.8
29,169,Pulaski,1990,13032,11695,1337,10.3
29,171,Putnam,1990,2038,1962,76,3.7
29,173,Ralls,1990,4323,4069,254,5.9
29,175,Randolph,1990,10589,10020,569,5.4
29,177,Ray,1990,10400,9617,783,7.5
29,179,Reynolds,1990,2697,2497,200,7.4
29,181,Ripley,1990,4208,3894,314,7.5
29,183,St. Charles,1990,122238,116441,5797,4.7
29,185,St. Clair,1990,3644,3353,291,8.0
29,186,Ste. Genevieve,1990,7933,7483,450,5.7
29,187,St. Francois,1990,20438,18359,2079,10.2
29,189,St. Louis,1990,546535,522201,24334,4.5
29,195,Saline,1990,11537,10668,869,7.5
29,197,Schuyler,1990,2109,1987,122,5.8
29,199,Scotland,1990,2149,2085,64,3.0
29,201,Scott,1990,18793,17438,1355,7.2
29,203,Shannon,1990,3467,3118,349,10.1
29,205,Shelby,1990,3140,3005,135,4.3
29,207,Stoddard,1990,13007,11843,1164,8.9
29,209,Stone,1990,9374,8482,892,9.5
29,211,Sullivan,1990,2765,2663,102,3.7
29,213,Taney,1990,14712,13144,1568,10.7
29,215,Texas,1990,9450,8567,883,9.3
29,217,Vernon,1990,8718,8274,444,5.1
29,219,Warren,1990,10011,9264,747,7.5
29,221,Washington,1990,8145,7050,1095,13.4
29,223,Wayne,1990,4558,4017,541,11.9
29,225,Webster,1990,11167,10235,932,8.3
29,227,Worth,1990,1003,956,47,4.7
29,229,Wright,1990,7584,6869,715,9.4
29,510,St. Louis city,1990,180724,165332,15392,8.5
30,1,Beaverhead,1990,4314,4102,212,4.9
30,3,Big Horn,1990,4630,3998,632,13.7
30,5,Blaine,1990,3057,2813,244,8.0
30,7,Broadwater,1990,1672,1594,78,4.7
30,9,Carbon,1990,3750,3587,163,4.3
30,11,Carter,1990,896,879,17,1.9
30,13,Cascade,1990,35989,34008,1981,5.5
30,15,Chouteau,1990,2597,2529,68,2.6
30,17,Custer,1990,5967,5667,300,5.0
30,19,Daniels,1990,1157,1121,36,3.1
30,21,Dawson,1990,4874,4686,188,3.9
30,23,Deer Lodge,1990,4051,3654,397,9.8
30,25,Fallon,1990,1576,1536,40,2.5
30,27,Fergus,1990,5874,5553,321,5.5
30,29,Flathead,1990,30468,28129,2339,7.7
30,31,Gallatin,1990,28812,27422,1390,4.8
30,33,Garfield,1990,891,874,17,1.9
30,35,Glacier,1990,5348,4709,639,11.9
30,37,Golden Valley,1990,471,457,14,3.0
30,39,Granite,1990,1168,1075,93,8.0
30,41,Hill,1990,8416,7953,463,5.5
30,43,Jefferson,1990,4148,3940,208,5.0
30,45,Judith Basin,1990,1169,1129,40,3.4
30,47,Lake,1990,9706,8896,810,8.3
30,49,Lewis and Clark,1990,25685,24510,1175,4.6
30,51,Liberty,1990,958,940,18,1.9
30,53,Lincoln,1990,8393,7350,1043,12.4
30,55,McCone,1990,1151,1113,38,3.3
30,57,Madison,1990,3315,3208,107,3.2
30,59,Meagher,1990,915,881,34,3.7
30,61,Mineral,1990,1781,1622,159,8.9
30,63,Missoula,1990,42930,40353,2577,6.0
30,65,Musselshell,1990,1795,1665,130,7.2
30,67,Park,1990,7740,7317,423,5.5
30,69,Petroleum,1990,262,256,6,2.3
30,71,Phillips,1990,2611,2484,127,4.9
30,73,Pondera,1990,2954,2841,113,3.8
30,75,Powder River,1990,1173,1151,22,1.9
30,77,Powell,1990,2658,2526,132,5.0
30,79,Prairie,1990,674,648,26,3.9
30,81,Ravalli,1990,11791,10787,1004,8.5
30,83,Richland,1990,5350,5011,339,6.3
30,85,Roosevelt,1990,4534,4034,500,11.0
30,87,Rosebud,1990,4910,4549,361,7.4
30,89,Sanders,1990,3755,3334,421,11.2
30,91,Sheridan,1990,2059,1997,62,3.0
30,93,Silver Bow,1990,16107,14974,1133,7.0
30,95,Stillwater,1990,3307,3176,131,4.0
30,97,Sweet Grass,1990,1538,1500,38,2.5
30,99,Teton,1990,2966,2877,89,3.0
30,101,Toole,1990,2643,2561,82,3.1
30,103,Treasure,1990,479,462,17,3.5
30,105,Valley,1990,4169,3984,185,4.4
30,107,Wheatland,1990,1128,1082,46,4.1
30,109,Wibaux,1990,529,512,17,3.2
30,111,Yellowstone,1990,61970,58817,3153,5.1
31,1,Adams,1990,15012,14743,269,1.8
31,3,Antelope,1990,3397,3333,64,1.9
31,5,Arthur,1990,235,231,4,1.7
31,7,Banner,1990,423,418,5,1.2
31,9,Blaine,1990,380,373,7,1.8
31,11,Boone,1990,3050,3017,33,1.1
31,13,Box Butte,1990,6326,6133,193,3.1
31,15,Boyd,1990,1200,1182,18,1.5
31,17,Brown,1990,1660,1637,23,1.4
31,19,Buffalo,1990,20749,20234,515,2.5
31,21,Burt,1990,3539,3439,100,2.8
31,23,Butler,1990,4045,3958,87,2.2
31,25,Cass,1990,10602,10285,317,3.0
31,27,Cedar,1990,4785,4714,71,1.5
31,29,Chase,1990,1926,1906,20,1.0
31,31,Cherry,1990,3148,3100,48,1.5
31,33,Cheyenne,1990,4975,4887,88,1.8
31,35,Clay,1990,3289,3232,57,1.7
31,37,Colfax,1990,4380,4318,62,1.4
31,39,Cuming,1990,5042,4988,54,1.1
31,41,Custer,1990,5831,5741,90,1.5
31,43,Dakota,1990,8767,8464,303,3.5
31,45,Dawes,1990,4182,4026,156,3.7
31,47,Dawson,1990,10620,10314,306,2.9
31,49,Deuel,1990,1086,1068,18,1.7
31,51,Dixon,1990,2975,2913,62,2.1
31,53,Dodge,1990,17620,17083,537,3.0
31,55,Douglas,1990,226878,220789,6089,2.7
31,57,Dundy,1990,1257,1247,10,0.8
31,59,Fillmore,1990,3406,3367,39,1.1
31,61,Franklin,1990,1722,1702,20,1.2
31,63,Frontier,1990,1572,1552,20,1.3
31,65,Furnas,1990,2480,2432,48,1.9
31,67,Gage,1990,11452,11234,218,1.9
31,69,Garden,1990,1204,1182,22,1.8
31,71,Garfield,1990,1088,1063,25,2.3
31,73,Gosper,1990,1056,1040,16,1.5
31,75,Grant,1990,387,385,2,0.5
31,77,Greeley,1990,1489,1461,28,1.9
31,79,Hall,1990,27186,26609,577,2.1
31,81,Hamilton,1990,4672,4608,64,1.4
31,83,Harlan,1990,1847,1820,27,1.5
31,85,Hayes,1990,519,514,5,1.0
31,87,Hitchcock,1990,1664,1631,33,2.0
31,89,Holt,1990,6009,5917,92,1.5
31,91,Hooker,1990,373,367,6,1.6
31,93,Howard,1990,3007,2943,64,2.1
31,95,Jefferson,1990,4276,4200,76,1.8
31,97,Johnson,1990,2332,2263,69,3.0
31,99,Kearney,1990,3260,3200,60,1.8
31,101,Keith,1990,4658,4516,142,3.0
31,103,Keya Paha,1990,517,510,7,1.4
31,105,Kimball,1990,1989,1964,25,1.3
31,107,Knox,1990,4311,4204,107,2.5
31,109,Lancaster,1990,124271,121544,2727,2.2
31,111,Lincoln,1990,16254,15800,454,2.8
31,113,Logan,1990,419,413,6,1.4
31,115,Loup,1990,350,342,8,2.3
31,117,McPherson,1990,292,289,3,1.0
31,119,Madison,1990,17213,16857,356,2.1
31,121,Merrick,1990,4234,4157,77,1.8
31,123,Morrill,1990,2686,2597,89,3.3
31,125,Nance,1990,2007,1972,35,1.7
31,127,Nemaha,1990,3563,3419,144,4.0
31,129,Nuckolls,1990,2574,2544,30,1.2
31,131,Otoe,1990,7185,6994,191,2.7
31,133,Pawnee,1990,1581,1538,43,2.7
31,135,Perkins,1990,1471,1454,17,1.2
31,137,Phelps,1990,5089,5030,59,1.2
31,139,Pierce,1990,3631,3563,68,1.9
31,141,Platte,1990,15627,15341,286,1.8
31,143,Polk,1990,2699,2669,30,1.1
31,145,Red Willow,1990,5831,5714,117,2.0
31,147,Richardson,1990,4447,4310,137,3.1
31,149,Rock,1990,1029,1007,22,2.1
31,151,Saline,1990,6390,6272,118,1.8
31,153,Sarpy,1990,48905,47873,1032,2.1
31,155,Saunders,1990,9260,9052,208,2.2
31,157,Scotts Bluff,1990,17779,17078,701,3.9
31,159,Seward,1990,8418,8236,182,2.2
31,161,Sheridan,1990,3131,3073,58,1.9
31,163,Sherman,1990,1710,1659,51,3.0
31,165,Sioux,1990,791,783,8,1.0
31,167,Stanton,1990,3073,3026,47,1.5
31,169,Thayer,1990,3164,3132,32,1.0
31,171,Thomas,1990,406,392,14,3.4
31,173,Thurston,1990,2607,2426,181,6.9
31,175,Valley,1990,2769,2717,52,1.9
31,177,Washington,1990,9129,8916,213,2.3
31,179,Wayne,1990,4749,4626,123,2.6
31,181,Webster,1990,1807,1779,28,1.5
31,183,Wheeler,1990,450,445,5,1.1
31,185,York,1990,7594,7454,140,1.8
32,1,Churchill,1990,7735,7249,486,6.3
32,3,Clark,1990,414596,395979,18617,4.5
32,5,Douglas,1990,14848,14121,727,4.9
32,7,Elko,1990,17651,16811,840,4.8
32,9,Esmeralda,1990,623,587,36,5.8
32,11,Eureka,1990,846,800,46,5.4
32,13,Humboldt,1990,6776,6425,351,5.2
32,15,Lander,1990,3077,2882,195,6.3
32,17,Lincoln,1990,1486,1388,98,6.6
32,19,Lyon,1990,9309,8749,560,6.0
32,21,Mineral,1990,2926,2757,169,5.8
32,23,Nye,1990,9103,8795,308,3.4
32,27,Pershing,1990,2001,1909,92,4.6
32,29,Storey,1990,1425,1393,32,2.2
32,31,Washoe,1990,149541,142308,7233,4.8
32,33,White Pine,1990,4022,3765,257,6.4
32,510,Carson City,1990,20807,19604,1203,5.8
33,1,Belknap,1990,26735,25219,1516,5.7
33,3,Carroll,1990,19424,18522,902,4.6
33,5,Cheshire,1990,38620,37033,1587,4.1
33,7,Coos,1990,17333,16281,1052,6.1
33,9,Grafton,1990,40308,38268,2040,5.1
33,11,Hillsborough,1990,199091,189038,10053,5.0
33,13,Merrimack,1990,60565,57635,2930,4.8
33,15,Rockingham,1990,142688,134441,8247,5.8
33,17,Strafford,1990,57397,54238,3159,5.5
33,19,Sullivan,1990,20661,19442,1219,5.9
34,1,Atlantic,1990,122466,114889,7577,6.2
34,3,Bergen,1990,444942,427706,17236,3.9
34,5,Burlington,1990,207258,197674,9584,4.6
34,7,Camden,1990,253436,238464,14972,5.9
34,9,Cape May,1990,44476,41048,3428,7.7
34,11,Cumberland,1990,65625,60695,4930,7.5
34,13,Essex,1990,395195,370377,24818,6.3
34,15,Gloucester,1990,119460,112729,6731,5.6
34,17,Hudson,1990,287159,266220,20939,7.3
34,19,Hunterdon,1990,59045,57450,1595,2.7
34,21,Mercer,1990,170498,162921,7577,4.4
34,23,Middlesex,1990,370286,353724,16562,4.5
34,25,Monmouth,1990,285512,273694,11818,4.1
34,27,Morris,1990,246875,238937,7938,3.2
34,29,Ocean,1990,190285,180654,9631,5.1
34,31,Passaic,1990,236058,221041,15017,6.4
34,33,Salem,1990,31381,29727,1654,5.3
34,35,Somerset,1990,138637,134576,4061,2.9
34,37,Sussex,1990,71981,68968,3013,4.2
34,39,Union,1990,270951,256391,14560,5.4
34,41,Warren,1990,48898,46799,2099,4.3
35,1,Bernalillo,1990,251586,237732,13854,5.5
35,3,Catron,1990,1243,1053,190,15.3
35,5,Chaves,1990,25699,24248,1451,5.6
35,6,Cibola,1990,9174,7961,1213,13.2
35,7,Colfax,1990,6088,5509,579,9.5
35,9,Curry,1990,17747,16683,1064,6.0
35,11,De Baca,1990,905,859,46,5.1
35,13,Dona Ana,1990,60103,55321,4782,8.0
35,15,Eddy,1990,21523,20060,1463,6.8
35,17,Grant,1990,11508,10459,1049,9.1
35,19,Guadalupe,1990,1735,1524,211,12.2
35,21,Harding,1990,456,415,41,9.0
35,23,Hidalgo,1990,2589,2414,175,6.8
35,25,Lea,1990,23650,22511,1139,4.8
35,27,Lincoln,1990,6000,5646,354,5.9
35,28,Los Alamos,1990,10784,10618,166,1.5
35,29,Luna,1990,7536,6551,985,13.1
35,31,McKinley,1990,22647,20740,1907,8.4
35,33,Mora,1990,1515,1206,309,20.4
35,35,Otero,1990,19935,18488,1447,7.3
35,37,Quay,1990,4921,4563,358,7.3
35,39,Rio Arriba,1990,15351,13227,2124,13.8
35,41,Roosevelt,1990,7154,6699,455,6.4
35,43,Sandoval,1990,29612,27927,1685,5.7
35,45,San Juan,1990,38867,35466,3401,8.8
35,47,San Miguel,1990,10945,9784,1161,10.6
35,49,Santa Fe,1990,54888,53049,1839,3.4
35,51,Sierra,1990,3449,3300,149,4.3
35,53,Socorro,1990,6648,6145,503,7.6
35,55,Taos,1990,11154,9421,1733,15.5
35,57,Torrance,1990,4272,3939,333,7.8
35,59,Union,1990,1871,1783,88,4.7
35,61,Valencia,1990,19763,18488,1275,6.5
36,1,Albany,1990,158302,153615,4687,3.0
36,3,Allegany,1990,22453,20971,1482,6.6
36,5,Bronx,1990,461093,422257,38836,8.4
36,7,Broome,1990,105397,100947,4450,4.2
36,9,Cattaraugus,1990,39115,36607,2508,6.4
36,11,Cayuga,1990,39256,36857,2399,6.1
36,13,Chautauqua,1990,68278,64346,3932,5.8
36,15,Chemung,1990,44188,42052,2136,4.8
36,17,Chenango,1990,25254,23892,1362,5.4
36,19,Clinton,1990,39331,36967,2364,6.0
36,21,Columbia,1990,31363,30369,994,3.2
36,23,Cortland,1990,24693,23126,1567,6.3
36,25,Delaware,1990,21743,20623,1120,5.2
36,27,Dutchess,1990,133979,130032,3947,2.9
36,29,Erie,1990,479497,454449,25048,5.2
36,31,Essex,1990,18133,16677,1456,8.0
36,33,Franklin,1990,20667,18878,1789,8.7
36,35,Fulton,1990,26779,24475,2304,8.6
36,37,Genesee,1990,31370,29747,1623,5.2
36,39,Greene,1990,21091,20059,1032,4.9
36,41,Hamilton,1990,2759,2512,247,9.0
36,43,Herkimer,1990,30333,28462,1871,6.2
36,45,Jefferson,1990,47090,42992,4098,8.7
36,47,Kings,1990,962026,887154,74872,7.8
36,49,Lewis,1990,12348,11473,875,7.1
36,51,Livingston,1990,32263,30864,1399,4.3
36,53,Madison,1990,35391,33595,1796,5.1
36,55,Monroe,1990,377250,364550,12700,3.4
36,57,Montgomery,1990,24550,22832,1718,7.0
36,59,Nassau,1990,700789,674639,26150,3.7
36,61,New York,1990,782201,735633,46568,6.0
36,63,Niagara,1990,109659,103433,6226,5.7
36,65,Oneida,1990,114784,109689,5095,4.4
36,67,Onondaga,1990,244100,234779,9321,3.8
36,69,Ontario,1990,50847,48680,2167,4.3
36,71,Orange,1990,153079,146407,6672,4.4
36,73,Orleans,1990,19738,18437,1301,6.6
36,75,Oswego,1990,57489,53528,3961,6.9
36,77,Otsego,1990,29642,28143,1499,5.1
36,79,Putnam,1990,48090,46508,1582,3.3
36,81,Queens,1990,954691,897549,57142,6.0
36,83,Rensselaer,1990,81623,78323,3300,4.0
36,85,Richmond,1990,180923,169849,11074,6.1
36,87,Rockland,1990,144697,139878,4819,3.3
36,89,St. Lawrence,1990,49538,45611,3927,7.9
36,91,Saratoga,1990,96906,93395,3511,3.6
36,93,Schenectady,1990,75415,72506,2909,3.9
36,95,Schoharie,1990,15170,14391,779,5.1
36,97,Schuyler,1990,9181,8674,507,5.5
36,99,Seneca,1990,16411,15643,768,4.7
36,101,Steuben,1990,46569,44147,2422,5.2
36,103,Suffolk,1990,710989,679555,31434,4.4
36,105,Sullivan,1990,33393,31683,1710,5.1
36,107,Tioga,1990,26397,25253,1144,4.3
36,109,Tompkins,1990,49038,47209,1829,3.7
36,111,Ulster,1990,84664,81564,3100,3.7
36,113,Warren,1990,30934,29139,1795,5.8
36,115,Washington,1990,28614,27079,1535,5.4
36,117,Wayne,1990,46232,44019,2213,4.8
36,119,Westchester,1990,472796,456072,16724,3.5
36,121,Wyoming,1990,19812,18661,1151,5.8
36,123,Yates,1990,11031,10463,568,5.1
37,1,Alamance,1990,61537,59078,2459,4.0
37,3,Alexander,1990,16057,15468,589,3.7
37,5,Alleghany,1990,4855,4697,158,3.3
37,7,Anson,1990,11763,11261,502,4.3
37,9,Ashe,1990,11391,10738,653,5.7
37,11,Avery,1990,7315,6871,444,6.1
37,13,Beaufort,1990,20581,19585,996,4.8
37,15,Bertie,1990,9045,8575,470,5.2
37,17,Bladen,1990,13474,12565,909,6.7
37,19,Brunswick,1990,24717,23216,1501,6.1
37,21,Buncombe,1990,91589,88839,2750,3.0
37,23,Burke,1990,41968,40313,1655,3.9
37,25,Cabarrus,1990,55425,53422,2003,3.6
37,27,Caldwell,1990,40337,38728,1609,4.0
37,29,Camden,1990,2824,2733,91,3.2
37,31,Carteret,1990,25653,24580,1073,4.2
37,33,Caswell,1990,10209,9811,398,3.9
37,35,Catawba,1990,71497,68501,2996,4.2
37,37,Chatham,1990,22084,21460,624,2.8
37,39,Cherokee,1990,9508,8641,867,9.1
37,41,Chowan,1990,6210,5886,324,5.2
37,43,Clay,1990,3243,3059,184,5.7
37,45,Cleveland,1990,45837,43801,2036,4.4
37,47,Columbus,1990,22231,20918,1313,5.9
37,49,Craven,1990,33755,32203,1552,4.6
37,51,Cumberland,1990,103620,98567,5053,4.9
37,53,Currituck,1990,7008,6778,230,3.3
37,55,Dare,1990,14157,13520,637,4.5
37,57,Davidson,1990,73103,70234,2869,3.9
37,59,Davie,1990,15754,15053,701,4.4
37,61,Duplin,1990,19872,18779,1093,5.5
37,63,Durham,1990,102095,99368,2727,2.7
37,65,Edgecombe,1990,28270,26861,1409,5.0
37,67,Forsyth,1990,145762,139957,5805,4.0
37,69,Franklin,1990,18855,17971,884,4.7
37,71,Gaston,1990,95517,91643,3874,4.1
37,73,Gates,1990,4083,3976,107,2.6
37,75,Graham,1990,3443,2925,518,15.0
37,77,Granville,1990,19659,18758,901,4.6
37,79,Greene,1990,7500,7191,309,4.1
37,81,Guilford,1990,200756,193641,7115,3.5
37,83,Halifax,1990,23903,22510,1393,5.8
37,85,Harnett,1990,31649,30200,1449,4.6
37,87,Haywood,1990,23005,21898,1107,4.8
37,89,Henderson,1990,32437,31599,838,2.6
37,91,Hertford,1990,10110,9524,586,5.8
37,93,Hoke,1990,9727,9235,492,5.1
37,95,Hyde,1990,2565,2365,200,7.8
37,97,Iredell,1990,52436,50402,2034,3.9
37,99,Jackson,1990,13603,12847,756,5.6
37,101,Johnston,1990,44685,42816,1869,4.2
37,103,Jones,1990,4426,4217,209,4.7
37,105,Lee,1990,21248,20175,1073,5.0
37,107,Lenoir,1990,28280,26932,1348,4.8
37,109,Lincoln,1990,28168,27004,1164,4.1
37,111,McDowell,1990,19007,17863,1144,6.0
37,113,Macon,1990,11124,10731,393,3.5
37,115,Madison,1990,8220,7868,352,4.3
37,117,Martin,1990,12186,11541,645,5.3
37,119,Mecklenburg,1990,298317,290273,8044,2.7
37,121,Mitchell,1990,6939,6482,457,6.6
37,123,Montgomery,1990,12080,11341,739,6.1
37,125,Moore,1990,27859,26754,1105,4.0
37,127,Nash,1990,41454,39719,1735,4.2
37,129,New Hanover,1990,65588,62634,2954,4.5
37,131,Northampton,1990,8662,8260,402,4.6
37,133,Onslow,1990,41624,39577,2047,4.9
37,135,Orange,1990,53357,52061,1296,2.4
37,137,Pamlico,1990,5052,4848,204,4.0
37,139,Pasquotank,1990,13610,13017,593,4.4
37,141,Pender,1990,13740,13115,625,4.5
37,143,Perquimans,1990,4497,4333,164,3.6
37,145,Person,1990,16706,15663,1043,6.2
37,147,Pitt,1990,57276,54975,2301,4.0
37,149,Polk,1990,6931,6783,148,2.1
37,151,Randolph,1990,63156,61212,1944,3.1
37,153,Richmond,1990,22424,21122,1302,5.8
37,155,Robeson,1990,49239,45500,3739,7.6
37,157,Rockingham,1990,46743,44285,2458,5.3
37,159,Rowan,1990,58557,56271,2286,3.9
37,161,Rutherford,1990,30346,28750,1596,5.3
37,163,Sampson,1990,23642,22557,1085,4.6
37,165,Scotland,1990,16611,15169,1442,8.7
37,167,Stanly,1990,28413,27088,1325,4.7
37,169,Stokes,1990,20475,19614,861,4.2
37,171,Surry,1990,33773,32239,1534,4.5
37,173,Swain,1990,5808,5084,724,12.5
37,175,Transylvania,1990,11728,11313,415,3.5
37,177,Tyrrell,1990,1874,1684,190,10.1
37,179,Union,1990,46346,45043,1303,2.8
37,181,Vance,1990,20363,18713,1650,8.1
37,183,Wake,1990,254679,248247,6432,2.5
37,185,Warren,1990,7468,6944,524,7.0
37,187,Washington,1990,6174,5916,258,4.2
37,189,Watauga,1990,19796,18916,880,4.4
37,191,Wayne,1990,48028,45836,2192,4.6
37,193,Wilkes,1990,31807,30586,1221,3.8
37,195,Wilson,1990,35263,32460,2803,7.9
37,197,Yadkin,1990,16454,15713,741,4.5
37,199,Yancey,1990,6721,6201,520,7.7
38,1,Adams,1990,1780,1756,24,1.3
38,3,Barnes,1990,6070,5875,195,3.2
38,5,Benson,1990,2898,2666,232,8.0
38,7,Billings,1990,552,528,24,4.3
38,9,Bottineau,1990,3731,3576,155,4.2
38,11,Bowman,1990,1963,1931,32,1.6
38,13,Burke,1990,1249,1218,31,2.5
38,15,Burleigh,1990,33040,31770,1270,3.8
38,17,Cass,1990,59844,57974,1870,3.1
38,19,Cavalier,1990,2710,2598,112,4.1
38,21,Dickey,1990,3067,2990,77,2.5
38,23,Divide,1990,1179,1159,20,1.7
38,25,Dunn,1990,2550,2493,57,2.2
38,27,Eddy,1990,1441,1347,94,6.5
38,29,Emmons,1990,2125,2055,70,3.3
38,31,Foster,1990,1931,1862,69,3.6
38,33,Golden Valley,1990,925,903,22,2.4
38,35,Grand Forks,1990,33068,31563,1505,4.6
38,37,Grant,1990,2185,2153,32,1.5
38,39,Griggs,1990,1559,1525,34,2.2
38,41,Hettinger,1990,1562,1515,47,3.0
38,43,Kidder,1990,1606,1518,88,5.5
38,45,LaMoure,1990,2427,2371,56,2.3
38,47,Logan,1990,1232,1205,27,2.2
38,49,McHenry,1990,2774,2612,162,5.8
38,51,McIntosh,1990,1781,1757,24,1.3
38,53,McKenzie,1990,2934,2867,67,2.3
38,55,McLean,1990,4605,4390,215,4.7
38,57,Mercer,1990,4852,4553,299,6.2
38,59,Morton,1990,12097,11509,588,4.9
38,61,Mountrail,1990,3045,2880,165,5.4
38,63,Nelson,1990,1734,1668,66,3.8
38,65,Oliver,1990,1206,1159,47,3.9
38,67,Pembina,1990,4661,4255,406,8.7
38,69,Pierce,1990,2138,2077,61,2.9
38,71,Ramsey,1990,6214,5983,231,3.7
38,73,Ransom,1990,2699,2651,48,1.8
38,75,Renville,1990,1383,1350,33,2.4
38,77,Richland,1990,8579,8188,391,4.6
38,79,Rolette,1990,4867,4163,704,14.5
38,81,Sargent,1990,2071,2035,36,1.7
38,83,Sheridan,1990,778,757,21,2.7
38,85,Sioux,1990,1813,1542,271,14.9
38,87,Slope,1990,585,571,14,2.4
38,89,Stark,1990,12117,11661,456,3.8
38,91,Steele,1990,1258,1237,21,1.7
38,93,Stutsman,1990,11218,10825,393,3.5
38,95,Towner,1990,1628,1581,47,2.9
38,97,Traill,1990,4022,3862,160,4.0
38,99,Walsh,1990,6366,6074,292,4.6
38,101,Ward,1990,26321,25139,1182,4.5
38,103,Wells,1990,2527,2376,151,6.0
38,105,Williams,1990,9828,9483,345,3.5
39,1,Adams,1990,10001,8885,1116,11.2
39,3,Allen,1990,52775,48655,4120,7.8
39,5,Ashland,1990,24359,22949,1410,5.8
39,7,Ashtabula,1990,45857,42267,3590,7.8
39,9,Athens,1990,24696,23245,1451,5.9
39,11,Auglaize,1990,23275,21849,1426,6.1
39,13,Belmont,1990,30111,28149,1962,6.5
39,15,Brown,1990,16773,15693,1080,6.4
39,17,Butler,1990,149821,141057,8764,5.8
39,19,Carroll,1990,12214,11434,780,6.4
39,21,Champaign,1990,19040,17820,1220,6.4
39,23,Clark,1990,71500,67152,4348,6.1
39,25,Clermont,1990,80033,76221,3812,4.8
39,27,Clinton,1990,18116,17039,1077,5.9
39,29,Columbiana,1990,48953,46014,2939,6.0
39,31,Coshocton,1990,16377,15365,1012,6.2
39,33,Crawford,1990,23661,21308,2353,9.9
39,35,Cuyahoga,1990,670444,636200,34244,5.1
39,37,Darke,1990,27546,25619,1927,7.0
39,39,Defiance,1990,20828,19143,1685,8.1
39,41,Delaware,1990,36734,35454,1280,3.5
39,43,Erie,1990,41327,38675,2652,6.4
39,45,Fairfield,1990,53546,50715,2831,5.3
39,47,Fayette,1990,12991,12052,939,7.2
39,49,Franklin,1990,535154,517047,18107,3.4
39,51,Fulton,1990,20851,19194,1657,7.9
39,53,Gallia,1990,13207,12118,1089,8.2
39,55,Geauga,1990,42052,40377,1675,4.0
39,57,Greene,1990,68277,65055,3222,4.7
39,59,Guernsey,1990,17911,16340,1571,8.8
39,61,Hamilton,1990,440536,422642,17894,4.1
39,63,Hancock,1990,34939,33319,1620,4.6
39,65,Hardin,1990,14675,13569,1106,7.5
39,67,Harrison,1990,6477,5924,553,8.5
39,69,Henry,1990,15278,14106,1172,7.7
39,71,Highland,1990,16224,14982,1242,7.7
39,73,Hocking,1990,11754,10671,1083,9.2
39,75,Holmes,1990,14796,14144,652,4.4
39,77,Huron,1990,29335,26180,3155,10.8
39,79,Jackson,1990,12260,11103,1157,9.4
39,81,Jefferson,1990,32618,30561,2057,6.3
39,83,Knox,1990,23624,22173,1451,6.1
39,85,Lake,1990,116449,110683,5766,5.0
39,87,Lawrence,1990,24963,23192,1771,7.1
39,89,Licking,1990,65878,62199,3679,5.6
39,91,Logan,1990,21124,19861,1263,6.0
39,93,Lorain,1990,133554,123915,9639,7.2
39,95,Lucas,1990,229608,210635,18973,8.3
39,97,Madison,1990,17939,17171,768,4.3
39,99,Mahoning,1990,118961,110207,8754,7.4
39,101,Marion,1990,30550,28064,2486,8.1
39,103,Medina,1990,64382,61374,3008,4.7
39,105,Meigs,1990,8630,7963,667,7.7
39,107,Mercer,1990,20039,18904,1135,5.7
39,109,Miami,1990,49454,46486,2968,6.0
39,111,Monroe,1990,6148,5603,545,8.9
39,113,Montgomery,1990,289491,274538,14953,5.2
39,115,Morgan,1990,5684,5142,542,9.5
39,117,Morrow,1990,13915,12986,929,6.7
39,119,Muskingum,1990,40312,36392,3920,9.7
39,121,Noble,1990,4882,4496,386,7.9
39,123,Ottawa,1990,21575,19802,1773,8.2
39,125,Paulding,1990,9873,9186,687,7.0
39,127,Perry,1990,14524,12641,1883,13.0
39,129,Pickaway,1990,21665,20539,1126,5.2
39,131,Pike,1990,9359,8428,931,9.9
39,133,Portage,1990,75604,71568,4036,5.3
39,135,Preble,1990,19841,18644,1197,6.0
39,137,Putnam,1990,17286,16075,1211,7.0
39,139,Richland,1990,62879,57724,5155,8.2
39,141,Ross,1990,29813,27328,2485,8.3
39,143,Sandusky,1990,31778,29222,2556,8.0
39,145,Scioto,1990,29331,26534,2797,9.5
39,147,Seneca,1990,29845,27413,2432,8.1
39,149,Shelby,1990,23646,22385,1261,5.3
39,151,Stark,1990,184451,172627,11824,6.4
39,153,Summit,1990,259214,245615,13599,5.2
39,155,Trumbull,1990,110913,102267,8646,7.8
39,157,Tuscarawas,1990,40667,37945,2722,6.7
39,159,Union,1990,16292,15625,667,4.1
39,161,Van Wert,1990,15977,14911,1066,6.7
39,163,Vinton,1990,4410,3969,441,10.0
39,165,Warren,1990,60206,57408,2798,4.6
39,167,Washington,1990,30209,28279,1930,6.4
39,169,Wayne,1990,52590,49986,2604,5.0
39,171,Williams,1990,20165,18970,1195,5.9
39,173,Wood,1990,60987,57339,3648,6.0
39,175,Wyandot,1990,11455,10659,796,6.9
40,1,Adair,1990,8567,8058,509,5.9
40,3,Alfalfa,1990,2849,2763,86,3.0
40,5,Atoka,1990,4802,4422,380,7.9
40,7,Beaver,1990,3109,3033,76,2.4
40,9,Beckham,1990,8456,8000,456,5.4
40,11,Blaine,1990,5186,4929,257,5.0
40,13,Bryan,1990,13757,12988,769,5.6
40,15,Caddo,1990,12043,11136,907,7.5
40,17,Canadian,1990,39574,37928,1646,4.2
40,19,Carter,1990,19730,18576,1154,5.8
40,21,Cherokee,1990,15617,14447,1170,7.5
40,23,Choctaw,1990,5775,5205,570,9.9
40,25,Cimarron,1990,1690,1651,39,2.3
40,27,Cleveland,1990,95121,91272,3849,4.0
40,29,Coal,1990,2483,2192,291,11.7
40,31,Comanche,1990,42404,39627,2777,6.5
40,33,Cotton,1990,2844,2539,305,10.7
40,35,Craig,1990,6438,6140,298,4.6
40,37,Creek,1990,29516,27917,1599,5.4
40,39,Custer,1990,13580,12792,788,5.8
40,41,Delaware,1990,12117,11370,747,6.2
40,43,Dewey,1990,2320,2227,93,4.0
40,45,Ellis,1990,2196,2123,73,3.3
40,47,Garfield,1990,26945,25801,1144,4.2
40,49,Garvin,1990,11593,10804,789,6.8
40,51,Grady,1990,19597,18353,1244,6.3
40,53,Grant,1990,2569,2497,72,2.8
40,55,Greer,1990,2434,2347,87,3.6
40,57,Harmon,1990,1394,1330,64,4.6
40,59,Harper,1990,2041,1978,63,3.1
40,61,Haskell,1990,4364,3814,550,12.6
40,63,Hughes,1990,5285,4758,527,10.0
40,65,Jackson,1990,10839,9997,842,7.8
40,67,Jefferson,1990,2859,2644,215,7.5
40,69,Johnston,1990,3998,3735,263,6.6
40,71,Kay,1990,23344,22144,1200,5.1
40,73,Kingfisher,1990,6485,6219,266,4.1
40,75,Kiowa,1990,4819,4613,206,4.3
40,77,Latimer,1990,4107,3701,406,9.9
40,79,Le Flore,1990,18585,16809,1776,9.6
40,81,Lincoln,1990,13200,12373,827,6.3
40,83,Logan,1990,13472,12970,502,3.7
40,85,Love,1990,3669,3470,199,5.4
40,87,McClain,1990,11276,10717,559,5.0
40,89,McCurtain,1990,13905,12697,1208,8.7
40,91,McIntosh,1990,6538,6154,384,5.9
40,93,Major,1990,3710,3562,148,4.0
40,95,Marshall,1990,4553,4286,267,5.9
40,97,Mayes,1990,14813,13786,1027,6.9
40,99,Murray,1990,5453,5021,432,7.9
40,101,Muskogee,1990,29569,27811,1758,5.9
40,103,Noble,1990,5392,5180,212,3.9
40,105,Nowata,1990,4431,4222,209,4.7
40,107,Okfuskee,1990,4406,4094,312,7.1
40,109,Oklahoma,1990,309727,292921,16806,5.4
40,111,Okmulgee,1990,15337,13989,1348,8.8
40,113,Osage,1990,19100,18268,832,4.4
40,115,Ottawa,1990,13560,12383,1177,8.7
40,117,Pawnee,1990,7432,7006,426,5.7
40,119,Payne,1990,30783,29264,1519,4.9
40,121,Pittsburg,1990,17339,15870,1469,8.5
40,123,Pontotoc,1990,15899,14898,1001,6.3
40,125,Pottawatomie,1990,26674,25103,1571,5.9
40,127,Pushmataha,1990,4285,3910,375,8.8
40,129,Roger Mills,1990,1999,1913,86,4.3
40,131,Rogers,1990,28589,27011,1578,5.5
40,133,Seminole,1990,10405,9499,906,8.7
40,135,Sequoyah,1990,15516,14303,1213,7.8
40,137,Stephens,1990,18695,17820,875,4.7
40,139,Texas,1990,8504,8162,342,4.0
40,141,Tillman,1990,4309,4071,238,5.5
40,143,Tulsa,1990,269837,258749,11088,4.1
40,145,Wagoner,1990,24349,23300,1049,4.3
40,147,Washington,1990,23141,22432,709,3.1
40,149,Washita,1990,5171,4887,284,5.5
40,151,Woods,1990,4350,4224,126,2.9
40,153,Woodward,1990,9371,8951,420,4.5
41,1,Baker,1990,7076,6563,513,7.2
41,3,Benton,1990,36307,34536,1771,4.9
41,5,Clackamas,1990,157183,151866,5317,3.4
41,7,Clatsop,1990,16425,15297,1128,6.9
41,9,Columbia,1990,18465,17315,1150,6.2
41,11,Coos,1990,26851,24657,2194,8.2
41,13,Crook,1990,6790,6328,462,6.8
41,15,Curry,1990,8188,7677,511,6.2
41,17,Deschutes,1990,41230,39030,2200,5.3
41,19,Douglas,1990,43686,40177,3509,8.0
41,21,Gilliam,1990,910,877,33,3.6
41,23,Grant,1990,4236,3876,360,8.5
41,25,Harney,1990,3714,3388,326,8.8
41,27,Hood River,1990,9250,8510,740,8.0
41,29,Jackson,1990,73363,68607,4756,6.5
41,31,Jefferson,1990,6586,6171,415,6.3
41,33,Josephine,1990,26539,24695,1844,6.9
41,35,Klamath,1990,27236,24821,2415,8.9
41,37,Lake,1990,3734,3409,325,8.7
41,39,Lane,1990,147152,138213,8939,6.1
41,41,Lincoln,1990,19047,17930,1117,5.9
41,43,Linn,1990,44338,41054,3284,7.4
41,45,Malheur,1990,13840,13160,680,4.9
41,47,Marion,1990,117423,111172,6251,5.3
41,49,Morrow,1990,3863,3564,299,7.7
41,51,Multnomah,1990,320558,304601,15957,5.0
41,53,Polk,1990,25017,23654,1363,5.4
41,55,Sherman,1990,912,864,48,5.3
41,57,Tillamook,1990,9592,9043,549,5.7
41,59,Umatilla,1990,29890,27454,2436,8.1
41,61,Union,1990,11820,11018,802,6.8
41,63,Wallowa,1990,3546,3286,260,7.3
41,65,Wasco,1990,11006,10254,752,6.8
41,67,Washington,1990,186925,180816,6109,3.3
41,69,Wheeler,1990,592,531,61,10.3
41,71,Yamhill,1990,32677,30970,1707,5.2
42,1,Adams,1990,41368,39370,1998,4.8
42,3,Allegheny,1990,643107,614930,28177,4.4
42,5,Armstrong,1990,30680,28349,2331,7.6
42,7,Beaver,1990,82113,77266,4847,5.9
42,9,Bedford,1990,21827,19867,1960,9.0
42,11,Berks,1990,176851,167458,9393,5.3
42,13,Blair,1990,60704,56197,4507,7.4
42,15,Bradford,1990,28086,26480,1606,5.7
42,17,Bucks,1990,299570,286637,12933,4.3
42,19,Butler,1990,74337,70229,4108,5.5
42,21,Cambria,1990,66759,61758,5001,7.5
42,23,Cameron,1990,2600,2413,187,7.2
42,25,Carbon,1990,26404,24408,1996,7.6
42,27,Centre,1990,60824,58251,2573,4.2
42,29,Chester,1990,207467,200641,6826,3.3
42,31,Clarion,1990,18111,16647,1464,8.1
42,33,Clearfield,1990,34686,31338,3348,9.7
42,35,Clinton,1990,17058,15352,1706,10.0
42,37,Columbia,1990,31411,29188,2223,7.1
42,39,Crawford,1990,39244,36342,2902,7.4
42,41,Cumberland,1990,108886,104782,4104,3.8
42,43,Dauphin,1990,130137,123836,6301,4.8
42,45,Delaware,1990,278989,267822,11167,4.0
42,47,Elk,1990,16333,15327,1006,6.2
42,49,Erie,1990,133265,125437,7828,5.9
42,51,Fayette,1990,54759,50050,4709,8.6
42,53,Forest,1990,2054,1883,171,8.3
42,55,Franklin,1990,62670,59518,3152,5.0
42,57,Fulton,1990,6594,6118,476,7.2
42,59,Greene,1990,14801,13559,1242,8.4
42,61,Huntingdon,1990,19246,17332,1914,9.9
42,63,Indiana,1990,38645,35816,2829,7.3
42,65,Jefferson,1990,20109,18659,1450,7.2
42,67,Juniata,1990,10416,9451,965,9.3
42,69,Lackawanna,1990,105876,98267,7609,7.2
42,71,Lancaster,1990,226166,216619,9547,4.2
42,73,Lawrence,1990,40990,38304,2686,6.6
42,75,Lebanon,1990,61421,58416,3005,4.9
42,77,Lehigh,1990,152594,144787,7807,5.1
42,79,Luzerne,1990,156355,144503,11852,7.6
42,81,Lycoming,1990,57456,53178,4278,7.4
42,83,McKean,1990,20823,19431,1392,6.7
42,85,Mercer,1990,53615,50666,2949,5.5
42,87,Mifflin,1990,22440,20649,1791,8.0
42,89,Monroe,1990,49572,46114,3458,7.0
42,91,Montgomery,1990,376078,361547,14531,3.9
42,93,Montour,1990,8783,8342,441,5.0
42,95,Northampton,1990,125236,118473,6763,5.4
42,97,Northumberland,1990,46145,41931,4214,9.1
42,99,Perry,1990,21960,20709,1251,5.7
42,101,Philadelphia/city,1990,698381,653919,44462,6.4
42,103,Pike,1990,13717,12928,789,5.8
42,105,Potter,1990,7119,6597,522,7.3
42,107,Schuylkill,1990,69580,64096,5484,7.9
42,109,Snyder,1990,18793,17310,1483,7.9
42,111,Somerset,1990,34843,32340,2503,7.2
42,113,Sullivan,1990,2639,2445,194,7.4
42,115,Susquehanna,1990,18188,16939,1249,6.9
42,117,Tioga,1990,18693,17245,1448,7.7
42,119,Union,1990,16793,15788,1005,6.0
42,121,Venango,1990,25649,24178,1471,5.7
42,123,Warren,1990,21629,20648,981,4.5
42,125,Washington,1990,90381,85116,5265,5.8
42,127,Wayne,1990,19320,18013,1307,6.8
42,129,Westmoreland,1990,171435,161308,10127,5.9
42,131,Wyoming,1990,13808,12867,941,6.8
42,133,York,1990,187037,178264,8773,4.7
44,1,Bristol,1990,26353,24614,1739,6.6
44,3,Kent,1990,88380,83300,5080,5.7
44,5,Newport,1990,43556,41052,2504,5.7
44,7,Providence,1990,306196,285626,20570,6.7
44,9,Washington,1990,58859,56188,2671,4.5
45,1,Abbeville,1990,11916,11113,803,6.7
45,3,Aiken,1990,61012,58142,2870,4.7
45,5,Allendale,1990,4385,4066,319,7.3
45,7,Anderson,1990,76121,72015,4106,5.4
45,9,Bamberg,1990,7352,6668,684,9.3
45,11,Barnwell,1990,9819,8870,949,9.7
45,13,Beaufort,1990,36400,35050,1350,3.7
45,15,Berkeley,1990,55900,54257,1643,2.9
45,17,Calhoun,1990,6111,5719,392,6.4
45,19,Charleston,1990,141449,137206,4243,3.0
45,21,Cherokee,1990,22940,21624,1316,5.7
45,23,Chester,1990,16040,14401,1639,10.2
45,25,Chesterfield,1990,19002,17971,1031,5.4
45,27,Clarendon,1990,11914,11025,889,7.5
45,29,Colleton,1990,15243,14393,850,5.6
45,31,Darlington,1990,29947,28308,1639,5.5
45,33,Dillon,1990,13007,12033,974,7.5
45,35,Dorchester,1990,38815,37681,1134,2.9
45,37,Edgefield,1990,9110,8721,389,4.3
45,39,Fairfield,1990,10955,9851,1104,10.1
45,41,Florence,1990,56200,53563,2637,4.7
45,43,Georgetown,1990,22431,20564,1867,8.3
45,45,Greenville,1990,172670,166075,6595,3.8
45,47,Greenwood,1990,30526,28786,1740,5.7
45,49,Hampton,1990,7685,7273,412,5.4
45,51,Horry,1990,74278,69537,4741,6.4
45,53,Jasper,1990,6586,6332,254,3.9
45,55,Kershaw,1990,22620,21224,1396,6.2
45,57,Lancaster,1990,28287,26690,1597,5.6
45,59,Laurens,1990,29256,27672,1584,5.4
45,61,Lee,1990,7902,7431,471,6.0
45,63,Lexington,1990,96400,92933,3467,3.6
45,65,McCormick,1990,3700,3349,351,9.5
45,67,Marion,1990,15845,14382,1463,9.2
45,69,Marlboro,1990,13386,12087,1299,9.7
45,71,Newberry,1990,16503,15568,935,5.7
45,73,Oconee,1990,29161,27665,1496,5.1
45,75,Orangeburg,1990,39034,36033,3001,7.7
45,77,Pickens,1990,49154,46826,2328,4.7
45,79,Richland,1990,147063,141619,5444,3.7
45,81,Saluda,1990,8103,7608,495,6.1
45,83,Spartanburg,1990,119364,114022,5342,4.5
45,85,Sumter,1990,40684,38483,2201,5.4
45,87,Union,1990,15234,14047,1187,7.8
45,89,Williamsburg,1990,16677,15070,1607,9.6
45,91,York,1990,71646,69000,2646,3.7
46,3,Aurora,1990,1325,1302,23,1.7
46,5,Beadle,1990,9218,8839,379,4.1
46,7,Bennett,1990,1173,1112,61,5.2
46,9,Bon Homme,1990,3023,2988,35,1.2
46,11,Brookings,1990,14049,13360,689,4.9
46,13,Brown,1990,19905,18855,1050,5.3
46,15,Brule,1990,2812,2751,61,2.2
46,17,Buffalo,1990,598,544,54,9.0
46,19,Butte,1990,3657,3533,124,3.4
46,21,Campbell,1990,955,928,27,2.8
46,23,Charles Mix,1990,3831,3688,143,3.7
46,25,Clark,1990,1980,1914,66,3.3
46,27,Clay,1990,6879,6574,305,4.4
46,29,Codington,1990,12175,11653,522,4.3
46,31,Corson,1990,1644,1322,322,19.6
46,33,Custer,1990,3469,3381,88,2.5
46,35,Davison,1990,8969,8733,236,2.6
46,37,Day,1990,3048,2897,151,5.0
46,39,Deuel,1990,2170,2084,86,4.0
46,41,Dewey,1990,2069,1839,230,11.1
46,43,Douglas,1990,1573,1531,42,2.7
46,45,Edmunds,1990,2136,2060,76,3.6
46,47,Fall River,1990,3299,3155,144,4.4
46,49,Faulk,1990,1256,1234,22,1.8
46,51,Grant,1990,4166,3991,175,4.2
46,53,Gregory,1990,2462,2395,67,2.7
46,55,Haakon,1990,1190,1159,31,2.6
46,57,Hamlin,1990,2185,2102,83,3.8
46,59,Hand,1990,2019,1982,37,1.8
46,61,Hanson,1990,1545,1506,39,2.5
46,63,Harding,1990,869,848,21,2.4
46,65,Hughes,1990,8430,8218,212,2.5
46,67,Hutchinson,1990,3873,3791,82,2.1
46,69,Hyde,1990,816,787,29,3.6
46,71,Jackson,1990,1181,1114,67,5.7
46,73,Jerauld,1990,1100,1064,36,3.3
46,75,Jones,1990,751,714,37,4.9
46,77,Kingsbury,1990,2701,2635,66,2.4
46,79,Lake,1990,5533,5282,251,4.5
46,81,Lawrence,1990,11503,11015,488,4.2
46,83,Lincoln,1990,8433,8233,200,2.4
46,85,Lyman,1990,1855,1780,75,4.0
46,87,McCook,1990,2702,2624,78,2.9
46,89,McPherson,1990,1480,1434,46,3.1
46,91,Marshall,1990,2190,2096,94,4.3
46,93,Meade,1990,9615,9284,331,3.4
46,95,Mellette,1990,797,748,49,6.1
46,97,Miner,1990,1574,1534,40,2.5
46,99,Minnehaha,1990,71139,69288,1851,2.6
46,101,Moody,1990,3269,3128,141,4.3
46,102,Oglala Lakota,1990,2232,1931,301,13.5
46,103,Pennington,1990,40007,38754,1253,3.1
46,105,Perkins,1990,2171,2119,52,2.4
46,107,Potter,1990,1528,1489,39,2.6
46,109,Roberts,1990,4596,4335,261,5.7
46,111,Sanborn,1990,1263,1241,22,1.7
46,115,Spink,1990,3610,3519,91,2.5
46,117,Stanley,1990,1424,1364,60,4.2
46,119,Sully,1990,894,874,20,2.2
46,121,Todd,1990,2419,2177,242,10.0
46,123,Tripp,1990,3295,3204,91,2.8
46,125,Turner,1990,4256,4160,96,2.3
46,127,Union,1990,3355,3111,244,7.3
46,129,Walworth,1990,3032,2939,93,3.1
46,135,Yankton,1990,9897,9705,192,1.9
46,137,Ziebach,1990,729,671,58,8.0
47,1,Anderson,1990,32881,31289,1592,4.8
47,3,Bedford,1990,15369,14501,868,5.6
47,5,Benton,1990,6715,6202,513,7.6
47,7,Bledsoe,1990,3852,3612,240,6.2
47,9,Blount,1990,41753,39572,2181,5.2
47,11,Bradley,1990,38803,36824,1979,5.1
47,13,Campbell,1990,13752,12341,1411,10.3
47,15,Cannon,1990,5426,5101,325,6.0
47,17,Carroll,1990,12883,11928,955,7.4
47,19,Carter,1990,24054,22833,1221,5.1
47,21,Cheatham,1990,14068,13577,491,3.5
47,23,Chester,1990,5815,5467,348,6.0
47,25,Claiborne,1990,10805,10024,781,7.2
47,27,Clay,1990,3395,3204,191,5.6
47,29,Cocke,1990,14024,12568,1456,10.4
47,31,Coffee,1990,18781,17792,989,5.3
47,33,Crockett,1990,6487,6152,335,5.2
47,35,Cumberland,1990,15267,14190,1077,7.1
47,37,Davidson,1990,275571,265588,9983,3.6
47,39,Decatur,1990,4824,4430,394,8.2
47,41,DeKalb,1990,7321,6907,414,5.7
47,43,Dickson,1990,17165,16185,980,5.7
47,45,Dyer,1990,16731,15849,882,5.3
47,47,Fayette,1990,11425,10651,774,6.8
47,49,Fentress,1990,6298,5707,591,9.4
47,51,Franklin,1990,15916,15101,815,5.1
47,53,Gibson,1990,21839,20149,1690,7.7
47,55,Giles,1990,12492,11817,675,5.4
47,57,Grainger,1990,8004,7475,529,6.6
47,59,Greene,1990,28744,26277,2467,8.6
47,61,Grundy,1990,5381,4918,463,8.6
47,63,Hamblen,1990,25903,24274,1629,6.3
47,65,Hamilton,1990,140970,135311,5659,4.0
47,67,Hancock,1990,2220,2082,138,6.2
47,69,Hardeman,1990,9543,8921,622,6.5
47,71,Hardin,1990,10630,9844,786,7.4
47,73,Hawkins,1990,20604,19594,1010,4.9
47,75,Haywood,1990,8280,7525,755,9.1
47,77,Henderson,1990,11122,10231,891,8.0
47,79,Henry,1990,12477,11661,816,6.5
47,81,Hickman,1990,7757,7166,591,7.6
47,83,Houston,1990,3030,2722,308,10.2
47,85,Humphreys,1990,7306,6489,817,11.2
47,87,Jackson,1990,4235,3915,320,7.6
47,89,Jefferson,1990,16550,15336,1214,7.3
47,91,Johnson,1990,5995,5619,376,6.3
47,93,Knox,1990,173667,166481,7186,4.1
47,95,Lake,1990,2604,2441,163,6.3
47,97,Lauderdale,1990,9921,9144,777,7.8
47,99,Lawrence,1990,17062,15605,1457,8.5
47,101,Lewis,1990,4238,3896,342,8.1
47,103,Lincoln,1990,14109,13470,639,4.5
47,105,Loudon,1990,15959,15047,912,5.7
47,107,McMinn,1990,20630,18864,1766,8.6
47,109,McNairy,1990,10318,9550,768,7.4
47,111,Macon,1990,7953,7433,520,6.5
47,113,Madison,1990,38199,36179,2020,5.3
47,115,Marion,1990,11342,10674,668,5.9
47,117,Marshall,1990,11340,10743,597,5.3
47,119,Maury,1990,28633,26723,1910,6.7
47,121,Meigs,1990,3864,3469,395,10.2
47,123,Monroe,1990,14534,13009,1525,10.5
47,125,Montgomery,1990,40527,38218,2309,5.7
47,127,Moore,1990,2510,2419,91,3.6
47,129,Morgan,1990,6827,6222,605,8.9
47,131,Obion,1990,15107,14168,939,6.2
47,133,Overton,1990,8638,7866,772,8.9
47,135,Perry,1990,3015,2801,214,7.1
47,137,Pickett,1990,2035,1899,136,6.7
47,139,Polk,1990,6460,5930,530,8.2
47,141,Putnam,1990,26435,24574,1861,7.0
47,143,Rhea,1990,11158,10349,809,7.3
47,145,Roane,1990,21781,19967,1814,8.3
47,147,Robertson,1990,21195,20075,1120,5.3
47,149,Rutherford,1990,64514,61739,2775,4.3
47,151,Scott,1990,7153,6470,683,9.5
47,153,Sequatchie,1990,4056,3863,193,4.8
47,155,Sevier,1990,27190,24835,2355,8.7
47,157,Shelby,1990,397372,379596,17776,4.5
47,159,Smith,1990,6763,6312,451,6.7
47,161,Stewart,1990,4428,4125,303,6.8
47,163,Sullivan,1990,69151,66396,2755,4.0
47,165,Sumner,1990,54585,51805,2780,5.1
47,167,Tipton,1990,16840,15985,855,5.1
47,169,Trousdale,1990,2889,2714,175,6.1
47,171,Unicoi,1990,7520,6934,586,7.8
47,173,Union,1990,6309,5976,333,5.3
47,175,Van Buren,1990,2253,2026,227,10.1
47,177,Warren,1990,16962,15711,1251,7.4
47,179,Washington,1990,45827,43799,2028,4.4
47,181,Wayne,1990,6903,6405,498,7.2
47,183,Weakley,1990,16167,15113,1054,6.5
47,185,White,1990,9785,8925,860,8.8
47,187,Williamson,1990,42928,41718,1210,2.8
47,189,Wilson,1990,36107,34316,1791,5.0
48,1,Anderson,1990,17834,16575,1259,7.1
48,3,Andrews,1990,6327,6093,234,3.7
48,5,Angelina,1990,32122,30038,2084,6.5
48,7,Aransas,1990,7403,7104,299,4.0
48,9,Archer,1990,3851,3704,147,3.8
48,11,Armstrong,1990,994,946,48,4.8
48,13,Atascosa,1990,12717,11833,884,7.0
48,15,Austin,1990,9182,8843,339,3.7
48,17,Bailey,1990,3646,3543,103,2.8
48,19,Bandera,1990,5505,5412,93,1.7
48,21,Bastrop,1990,18494,17612,882,4.8
48,23,Baylor,1990,1984,1909,75,3.8
48,25,Bee,1990,9708,9019,689,7.1
48,27,Bell,1990,76761,71183,5578,7.3
48,29,Bexar,1990,563126,521769,41357,7.3
48,31,Blanco,1990,2855,2808,47,1.6
48,33,Borden,1990,438,424,14,3.2
48,35,Bosque,1990,6373,5934,439,6.9
48,37,Bowie,1990,38061,35501,2560,6.7
48,39,Brazoria,1990,97994,93434,4560,4.7
48,41,Brazos,1990,61528,58220,3308,5.4
48,43,Brewster,1990,4248,4047,201,4.7
48,45,Briscoe,1990,921,909,12,1.3
48,47,Brooks,1990,3057,2785,272,8.9
48,49,Brown,1990,15386,14258,1128,7.3
48,51,Burleson,1990,6112,5798,314,5.1
48,53,Burnet,1990,9374,9030,344,3.7
48,55,Caldwell,1990,11770,11067,703,6.0
48,57,Calhoun,1990,8425,7890,535,6.4
48,59,Callahan,1990,5290,5065,225,4.3
48,61,Cameron,1990,104100,90753,13347,12.8
48,63,Camp,1990,4727,4361,366,7.7
48,65,Carson,1990,3045,2948,97,3.2
48,67,Cass,1990,13276,12262,1014,7.6
48,69,Castro,1990,4056,3888,168,4.1
48,71,Chambers,1990,9823,9451,372,3.8
48,73,Cherokee,1990,18833,17649,1184,6.3
48,75,Childress,1990,2594,2466,128,4.9
48,77,Clay,1990,4726,4547,179,3.8
48,79,Cochran,1990,1941,1861,80,4.1
48,81,Coke,1990,1392,1370,22,1.6
48,83,Coleman,1990,3973,3626,347,8.7
48,85,Collin,1990,161035,154840,6195,3.8
48,87,Collingsworth,1990,1788,1725,63,3.5
48,89,Colorado,1990,7987,7774,213,2.7
48,91,Comal,1990,25737,24346,1391,5.4
48,93,Comanche,1990,5967,5666,301,5.0
48,95,Concho,1990,1447,1402,45,3.1
48,97,Cooke,1990,14758,14036,722,4.9
48,99,Coryell,1990,17926,16433,1493,8.3
48,101,Cottle,1990,1006,974,32,3.2
48,103,Crane,1990,2223,2141,82,3.7
48,105,Crockett,1990,1866,1789,77,4.1
48,107,Crosby,1990,3229,3088,141,4.4
48,109,Culberson,1990,1613,1497,116,7.2
48,111,Dallam,1990,2497,2440,57,2.3
48,113,Dallas,1990,1072131,1015140,56991,5.3
48,115,Dawson,1990,5952,5465,487,8.2
48,117,Deaf Smith,1990,8972,8486,486,5.4
48,119,Delta,1990,2264,2145,119,5.3
48,121,Denton,1990,169664,162642,7022,4.1
48,123,DeWitt,1990,7806,7389,417,5.3
48,125,Dickens,1990,1090,1040,50,4.6
48,127,Dimmit,1990,3922,3369,553,14.1
48,129,Donley,1990,1684,1594,90,5.3
48,131,Duval,1990,4443,3982,461,10.4
48,133,Eastland,1990,8022,7437,585,7.3
48,135,Ector,1990,55870,52713,3157,5.7
48,137,Edwards,1990,942,883,59,6.3
48,139,Ellis,1990,43880,41476,2404,5.5
48,141,El Paso,1990,259601,229077,30524,11.8
48,143,Erath,1990,14123,13238,885,6.3
48,145,Falls,1990,7088,6756,332,4.7
48,147,Fannin,1990,11105,10315,790,7.1
48,149,Fayette,1990,9414,9186,228,2.4
48,151,Fisher,1990,2192,2055,137,6.3
48,153,Floyd,1990,3942,3787,155,3.9
48,155,Foard,1990,838,824,14,1.7
48,157,Fort Bend,1990,122223,117930,4293,3.5
48,159,Franklin,1990,3510,3299,211,6.0
48,161,Freestone,1990,7053,6661,392,5.6
48,163,Frio,1990,6102,5677,425,7.0
48,165,Gaines,1990,6455,6201,254,3.9
48,167,Galveston,1990,113315,105293,8022,7.1
48,169,Garza,1990,2226,2129,97,4.4
48,171,Gillespie,1990,8031,7900,131,1.6
48,173,Glasscock,1990,661,649,12,1.8
48,175,Goliad,1990,2614,2494,120,4.6
48,177,Gonzales,1990,7680,7447,233,3.0
48,179,Gray,1990,11128,10652,476,4.3
48,181,Grayson,1990,46388,43751,2637,5.7
48,183,Gregg,1990,53252,48929,4323,8.1
48,185,Grimes,1990,7357,6973,384,5.2
48,187,Guadalupe,1990,32179,30748,1431,4.4
48,189,Hale,1990,16813,15976,837,5.0
48,191,Hall,1990,2060,1935,125,6.1
48,193,Hamilton,1990,3407,3237,170,5.0
48,195,Hansford,1990,2745,2677,68,2.5
48,197,Hardeman,1990,2245,2106,139,6.2
48,199,Hardin,1990,19093,17880,1213,6.4
48,201,Harris,1990,1549581,1469693,79888,5.2
48,203,Harrison,1990,25486,23791,1695,6.7
48,205,Hartley,1990,1727,1699,28,1.6
48,207,Haskell,1990,3071,2973,98,3.2
48,209,Hays,1990,33968,32196,1772,5.2
48,211,Hemphill,1990,1801,1755,46,2.6
48,213,Henderson,1990,25951,23486,2465,9.5
48,215,Hidalgo,1990,165820,128406,37414,22.6
48,217,Hill,1990,11769,11016,753,6.4
48,219,Hockley,1990,11263,10697,566,5.0
48,221,Hood,1990,13753,12283,1470,10.7
48,223,Hopkins,1990,13968,13159,809,5.8
48,225,Houston,1990,8483,8045,438,5.2
48,227,Howard,1990,14717,13999,718,4.9
48,229,Hudspeth,1990,1259,1225,34,2.7
48,231,Hunt,1990,32481,30292,2189,6.7
48,233,Hutchinson,1990,10840,10315,525,4.8
48,235,Irion,1990,772,756,16,2.1
48,237,Jack,1990,3064,2951,113,3.7
48,239,Jackson,1990,5504,5328,176,3.2
48,241,Jasper,1990,12487,11320,1167,9.3
48,243,Jeff Davis,1990,861,835,26,3.0
48,245,Jefferson,1990,112579,104546,8033,7.1
48,247,Jim Hogg,1990,2167,1925,242,11.2
48,249,Jim Wells,1990,15208,14074,1134,7.5
48,251,Johnson,1990,49732,46945,2787,5.6
48,253,Jones,1990,7383,7044,339,4.6
48,255,Karnes,1990,4973,4755,218,4.4
48,257,Kaufman,1990,25315,23911,1404,5.5
48,259,Kendall,1990,7409,7243,166,2.2
48,261,Kenedy,1990,231,222,9,3.9
48,263,Kent,1990,457,449,8,1.8
48,265,Kerr,1990,15549,15131,418,2.7
48,267,Kimble,1990,2039,1999,40,2.0
48,269,King,1990,210,206,4,1.9
48,271,Kinney,1990,1041,1003,38,3.7
48,273,Kleberg,1990,12645,11739,906,7.2
48,275,Knox,1990,2085,2020,65,3.1
48,277,Lamar,1990,20378,18949,1429,7.0
48,279,Lamb,1990,6409,6124,285,4.4
48,281,Lampasas,1990,6208,5825,383,6.2
48,283,La Salle,1990,2246,2095,151,6.7
48,285,Lavaca,1990,8471,8355,116,1.4
48,287,Lee,1990,6143,5826,317,5.2
48,289,Leon,1990,5109,4797,312,6.1
48,291,Liberty,1990,23088,21531,1557,6.7
48,293,Limestone,1990,8955,8563,392,4.4
48,295,Lipscomb,1990,1423,1389,34,2.4
48,297,Live Oak,1990,4141,3981,160,3.9
48,299,Llano,1990,3873,3753,120,3.1
48,301,Loving,1990,64,61,3,4.7
48,303,Lubbock,1990,113542,107690,5852,5.2
48,305,Lynn,1990,3019,2934,85,2.8
48,307,McCulloch,1990,3607,3216,391,10.8
48,309,McLennan,1990,92606,86242,6364,6.9
48,311,McMullen,1990,366,363,3,0.8
48,313,Madison,1990,3945,3730,215,5.4
48,315,Marion,1990,3789,3508,281,7.4
48,317,Martin,1990,2019,1984,35,1.7
48,319,Mason,1990,1542,1500,42,2.7
48,321,Matagorda,1990,17380,15577,1803,10.4
48,323,Maverick,1990,15629,10881,4748,30.4
48,325,Medina,1990,11692,11055,637,5.4
48,327,Menard,1990,942,904,38,4.0
48,329,Midland,1990,54492,51559,2933,5.4
48,331,Milam,1990,9541,8964,577,6.0
48,333,Mills,1990,1971,1914,57,2.9
48,335,Mitchell,1990,3294,3070,224,6.8
48,337,Montague,1990,7483,7160,323,4.3
48,339,Montgomery,1990,93851,89185,4666,5.0
48,341,Moore,1990,8541,8285,256,3.0
48,343,Morris,1990,5945,5383,562,9.5
48,345,Motley,1990,723,709,14,1.9
48,347,Nacogdoches,1990,26122,24363,1759,6.7
48,349,Navarro,1990,18640,17198,1442,7.7
48,351,Newton,1990,4956,4484,472,9.5
48,353,Nolan,1990,7729,7127,602,7.8
48,355,Nueces,1990,135990,126739,9251,6.8
48,357,Ochiltree,1990,4494,4367,127,2.8
48,359,Oldham,1990,1049,997,52,5.0
48,361,Orange,1990,38267,34814,3453,9.0
48,363,Palo Pinto,1990,11299,10566,733,6.5
48,365,Panola,1990,8967,8380,587,6.5
48,367,Parker,1990,32786,31273,1513,4.6
48,369,Parmer,1990,4402,4234,168,3.8
48,371,Pecos,1990,6212,5845,367,5.9
48,373,Polk,1990,11655,10932,723,6.2
48,375,Potter,1990,47239,44293,2946,6.2
48,377,Presidio,1990,3113,2649,464,14.9
48,379,Rains,1990,2956,2798,158,5.3
48,381,Randall,1990,50443,48559,1884,3.7
48,383,Reagan,1990,1987,1922,65,3.3
48,385,Real,1990,1029,956,73,7.1
48,387,Red River,1990,5758,5323,435,7.6
48,389,Reeves,1990,6615,6045,570,8.6
48,391,Refugio,1990,3374,3263,111,3.3
48,393,Roberts,1990,576,549,27,4.7
48,395,Robertson,1990,6282,5888,394,6.3
48,397,Rockwall,1990,14624,14068,556,3.8
48,399,Runnels,1990,5214,5021,193,3.7
48,401,Rusk,1990,19740,18334,1406,7.1
48,403,Sabine,1990,3374,3134,240,7.1
48,405,San Augustine,1990,3006,2855,151,5.0
48,407,San Jacinto,1990,6070,5812,258,4.3
48,409,San Patricio,1990,24972,23219,1753,7.0
48,411,San Saba,1990,2195,2055,140,6.4
48,413,Schleicher,1990,1284,1222,62,4.8
48,415,Scurry,1990,8066,7707,359,4.5
48,417,Shackelford,1990,1521,1480,41,2.7
48,419,Shelby,1990,8719,8195,524,6.0
48,421,Sherman,1990,1421,1396,25,1.8
48,423,Smith,1990,75661,70883,4778,6.3
48,425,Somervell,1990,2640,2199,441,16.7
48,427,Starr,1990,18546,11009,7537,40.6
48,429,Stephens,1990,3789,3629,160,4.2
48,431,Sterling,1990,652,639,13,2.0
48,433,Stonewall,1990,895,859,36,4.0
48,435,Sutton,1990,2059,1955,104,5.1
48,437,Swisher,1990,3721,3603,118,3.2
48,439,Tarrant,1990,665695,630485,35210,5.3
48,441,Taylor,1990,55857,52326,3531,6.3
48,443,Terrell,1990,649,639,10,1.5
48,445,Terry,1990,5921,5547,374,6.3
48,447,Throckmorton,1990,876,864,12,1.4
48,449,Titus,1990,11645,10838,807,6.9
48,451,Tom Green,1990,46308,43534,2774,6.0
48,453,Travis,1990,334802,318122,16680,5.0
48,455,Trinity,1990,4436,4226,210,4.7
48,457,Tyler,1990,6520,6108,412,6.3
48,459,Upshur,1990,14069,13222,847,6.0
48,461,Upton,1990,1873,1825,48,2.6
48,463,Uvalde,1990,10811,9456,1355,12.5
48,465,Val Verde,1990,15126,13137,1989,13.1
48,467,Van Zandt,1990,16535,15585,950,5.7
48,469,Victoria,1990,36259,34604,1655,4.6
48,471,Walker,1990,19708,18798,910,4.6
48,473,Waller,1990,10758,10215,543,5.0
48,475,Ward,1990,5393,5057,336,6.2
48,477,Washington,1990,12825,12403,422,3.3
48,479,Webb,1990,55421,48705,6716,12.1
48,481,Wharton,1990,19048,18262,786,4.1
48,483,Wheeler,1990,2746,2675,71,2.6
48,485,Wichita,1990,56965,53123,3842,6.7
48,487,Wilbarger,1990,7138,6836,302,4.2
48,489,Willacy,1990,7203,5994,1209,16.8
48,491,Williamson,1990,78432,75058,3374,4.3
48,493,Wilson,1990,10395,9968,427,4.1
48,495,Winkler,1990,3423,3244,179,5.2
48,497,Wise,1990,15872,15169,703,4.4
48,499,Wood,1990,12665,11926,739,5.8
48,501,Yoakum,1990,3924,3801,123,3.1
48,503,Young,1990,8589,8297,292,3.4
48,505,Zapata,1990,2998,2612,386,12.9
48,507,Zavala,1990,4717,3731,986,20.9
49,1,Beaver,1990,1855,1780,75,4.0
49,3,Box Elder,1990,16125,15401,724,4.5
49,5,Cache,1990,33117,31804,1313,4.0
49,7,Carbon,1990,8619,7948,671,7.8
49,9,Daggett,1990,352,346,6,1.7
49,11,Davis,1990,86686,83250,3436,4.0
49,13,Duchesne,1990,4994,4590,404,8.1
49,15,Emery,1990,4169,3828,341,8.2
49,17,Garfield,1990,2062,1870,192,9.3
49,19,Grand,1990,3315,3073,242,7.3
49,21,Iron,1990,9145,8683,462,5.1
49,23,Juab,1990,2691,2563,128,4.8
49,25,Kane,1990,2530,2377,153,6.0
49,27,Millard,1990,4630,4420,210,4.5
49,29,Morgan,1990,2505,2376,129,5.1
49,31,Piute,1990,468,434,34,7.3
49,33,Rich,1990,716,701,15,2.1
49,35,Salt Lake,1990,369642,355680,13962,3.8
49,37,San Juan,1990,4123,3758,365,8.9
49,39,Sanpete,1990,6404,5715,689,10.8
49,41,Sevier,1990,6314,5963,351,5.6
49,43,Summit,1990,8012,7520,492,6.1
49,45,Tooele,1990,12325,11666,659,5.3
49,47,Uintah,1990,8853,8326,527,6.0
49,49,Utah,1990,116732,111588,5144,4.4
49,51,Wasatch,1990,4540,4249,291,6.4
49,53,Washington,1990,19229,18478,751,3.9
49,55,Wayne,1990,940,859,81,8.6
49,57,Weber,1990,77576,73647,3929,5.1
50,1,Addison,1990,18462,17724,738,4.0
50,3,Bennington,1990,18864,17889,975,5.2
50,5,Caledonia,1990,14344,13524,820,5.7
50,7,Chittenden,1990,77742,74820,2922,3.8
50,9,Essex,1990,2805,2584,221,7.9
50,11,Franklin,1990,21039,19874,1165,5.5
50,13,Grand Isle,1990,2830,2646,184,6.5
50,15,Lamoille,1990,10653,9978,675,6.3
50,17,Orange,1990,14221,13564,657,4.6
50,19,Orleans,1990,11948,11087,861,7.2
50,21,Rutland,1990,32836,31348,1488,4.5
50,23,Washington,1990,29891,28381,1510,5.1
50,25,Windham,1990,21921,20929,992,4.5
50,27,Windsor,1990,29431,28199,1232,4.2
51,1,Accomack,1990,15025,14206,819,5.5
51,3,Albemarle,1990,34946,34206,740,2.1
51,5,Alleghany,1990,8545,7875,670,7.8
51,7,Amelia,1990,4301,4149,152,3.5
51,9,Amherst,1990,14335,13606,729,5.1
51,11,Appomattox,1990,6230,5905,325,5.2
51,13,Arlington,1990,108269,106142,2127,2.0
51,15,Augusta,1990,29044,27880,1164,4.0
51,17,Bath,1990,2620,2305,315,12.0
51,19,Bedford,1990,27638,26449,1189,4.3
51,21,Bland,1990,3223,3034,189,5.9
51,23,Botetourt,1990,13694,13211,483,3.5
51,25,Brunswick,1990,7101,6429,672,9.5
51,27,Buchanan,1990,11345,10080,1265,11.2
51,29,Buckingham,1990,5524,5226,298,5.4
51,31,Campbell,1990,25868,24510,1358,5.2
51,33,Caroline,1990,9889,9158,731,7.4
51,35,Carroll,1990,13553,12531,1022,7.5
51,36,Charles City,1990,3386,3208,178,5.3
51,37,Charlotte,1990,5703,5131,572,10.0
51,41,Chesterfield,1990,119293,115538,3755,3.1
51,43,Clarke,1990,6406,6219,187,2.9
51,45,Craig,1990,2201,2066,135,6.1
51,47,Culpeper,1990,14279,13758,521,3.6
51,49,Cumberland,1990,3854,3679,175,4.5
51,51,Dickenson,1990,6205,5168,1037,16.7
51,53,Dinwiddie,1990,10470,9942,528,5.0
51,57,Essex,1990,4348,4055,293,6.7
51,59,Fairfax,1990,482803,473379,9424,2.0
51,61,Fauquier,1990,26492,25816,676,2.6
51,63,Floyd,1990,6155,5653,502,8.2
51,65,Fluvanna,1990,6360,6182,178,2.8
51,67,Franklin,1990,21160,19941,1219,5.8
51,69,Frederick,1990,25944,24544,1400,5.4
51,71,Giles,1990,8388,7659,729,8.7
51,73,Gloucester,1990,15282,14746,536,3.5
51,75,Goochland,1990,7380,7151,229,3.1
51,77,Grayson,1990,8579,7774,805,9.4
51,79,Greene,1990,5631,5469,162,2.9
51,81,Greensville,1990,4439,4181,258,5.8
51,83,Halifax,1990,18118,16727,1391,7.7
51,85,Hanover,1990,36167,35155,1012,2.8
51,87,Henrico,1990,125816,122101,3715,3.0
51,89,Henry,1990,32124,29670,2454,7.6
51,91,Highland,1990,1346,1289,57,4.2
51,93,Isle of Wight,1990,12976,12306,670,5.2
51,95,James City,1990,18923,18357,566,3.0
51,97,King and Queen,1990,3100,2955,145,4.7
51,99,King George,1990,6953,6692,261,3.8
51,101,King William,1990,5798,5619,179,3.1
51,103,Lancaster,1990,5013,4455,558,11.1
51,105,Lee,1990,9065,8209,856,9.4
51,107,Loudoun,1990,52289,51435,854,1.6
51,109,Louisa,1990,10359,9791,568,5.5
51,111,Lunenburg,1990,5516,5089,427,7.7
51,113,Madison,1990,5741,5582,159,2.8
51,115,Mathews,1990,4166,4032,134,3.2
51,117,Mecklenburg,1990,14312,13492,820,5.7
51,119,Middlesex,1990,4053,3920,133,3.3
51,121,Montgomery,1990,37182,34409,2773,7.5
51,125,Nelson,1990,6047,5790,257,4.3
51,127,New Kent,1990,5638,5450,188,3.3
51,131,Northampton,1990,5671,5366,305,5.4
51,133,Northumberland,1990,4899,4405,494,10.1
51,135,Nottoway,1990,6569,6282,287,4.4
51,137,Orange,1990,10775,10209,566,5.3
51,139,Page,1990,11226,9743,1483,13.2
51,141,Patrick,1990,9394,8959,435,4.6
51,143,Pittsylvania,1990,30215,27763,2452,8.1
51,145,Powhatan,1990,7515,7280,235,3.1
51,147,Prince Edward,1990,7699,7076,623,8.1
51,149,Prince George,1990,11902,11450,452,3.8
51,153,Prince William,1990,117318,114608,2710,2.3
51,155,Pulaski,1990,18199,15746,2453,13.5
51,157,Rappahannock,1990,3592,3386,206,5.7
51,159,Richmond,1990,3479,3240,239,6.9
51,161,Roanoke,1990,44920,43618,1302,2.9
51,163,Rockbridge,1990,9457,8915,542,5.7
51,165,Rockingham,1990,32189,30570,1619,5.0
51,167,Russell,1990,11872,10517,1355,11.4
51,169,Scott,1990,9659,8893,766,7.9
51,171,Shenandoah,1990,16525,15745,780,4.7
51,173,Smyth,1990,16350,14748,1602,9.8
51,175,Southampton,1990,7765,7377,388,5.0
51,177,Spotsylvania,1990,31344,30138,1206,3.8
51,179,Stafford,1990,32168,31143,1025,3.2
51,181,Surry,1990,3119,2918,201,6.4
51,183,Sussex,1990,4812,4536,276,5.7
51,185,Tazewell,1990,18799,17051,1748,9.3
51,187,Warren,1990,14033,13014,1019,7.3
51,191,Washington,1990,23726,21807,1919,8.1
51,193,Westmoreland,1990,7316,6706,610,8.3
51,195,Wise,1990,15475,13798,1677,10.8
51,197,Wythe,1990,13347,12068,1279,9.6
51,199,York,1990,20589,19877,712,3.5
51,510,Alexandria city,1990,73485,71456,2029,2.8
51,520,Bristol city,1990,8850,8152,698,7.9
51,530,Buena Vista city,1990,3393,3088,305,9.0
51,540,Charlottesville city,1990,20563,20044,519,2.5
51,550,Chesapeake city,1990,79696,76324,3372,4.2
51,570,Colonial Heights city,1990,8558,8206,352,4.1
51,580,Covington city,1990,3239,2917,322,9.9
51,590,Danville city,1990,25985,23577,2408,9.3
51,595,Emporia city,1990,2428,2270,158,6.5
51,600,Fairfax city,1990,12197,12003,194,1.6
51,610,Falls Church city,1990,5842,5750,92,1.6
51,620,Franklin city,1990,3454,3298,156,4.5
51,630,Fredericksburg city,1990,10336,9845,491,4.8
51,640,Galax city,1990,3498,3208,290,8.3
51,650,Hampton city,1990,64566,61162,3404,5.3
51,660,Harrisonburg city,1990,15980,15002,978,6.1
51,670,Hopewell city,1990,11460,10758,702,6.1
51,678,Lexington city,1990,2886,2657,229,7.9
51,680,Lynchburg city,1990,31985,30154,1831,5.7
51,683,Manassas city,1990,16425,16033,392,2.4
51,685,Manassas Park city,1990,3823,3744,79,2.1
51,690,Martinsville city,1990,8220,7440,780,9.5
51,700,Newport News city,1990,80573,76434,4139,5.1
51,710,Norfolk city,1990,97930,93336,4594,4.7
51,720,Norton city,1990,1631,1475,156,9.6
51,730,Petersburg city,1990,18130,16838,1292,7.1
51,735,Poquoson city,1990,5848,5622,226,3.9
51,740,Portsmouth city,1990,46855,43781,3074,6.6
51,750,Radford city,1990,7183,6348,835,11.6
51,760,Richmond city,1990,103613,97788,5825,5.6
51,770,Roanoke city,1990,48672,46432,2240,4.6
51,775,Salem city,1990,12735,12328,407,3.2
51,790,Staunton city,1990,11778,11272,506,4.3
51,800,Suffolk city,1990,25037,23479,1558,6.2
51,810,Virginia Beach city,1990,190902,183467,7435,3.9
51,820,Waynesboro city,1990,9074,8690,384,4.2
51,830,Williamsburg city,1990,5794,5280,514,8.9
51,840,Winchester city,1990,12523,11742,781,6.2
53,1,Adams,1990,7763,6941,822,10.6
53,3,Asotin,1990,9435,8947,488,5.2
53,5,Benton,1990,61236,57439,3797,6.2
53,7,Chelan,1990,31693,28959,2734,8.6
53,9,Clallam,1990,23166,21539,1627,7.0
53,11,Clark,1990,128425,122398,6027,4.7
53,13,Columbia,1990,1489,1302,187,12.6
53,15,Cowlitz,1990,38180,35548,2632,6.9
53,17,Douglas,1990,16006,14762,1244,7.8
53,19,Ferry,1990,2815,2483,332,11.8
53,21,Franklin,1990,19122,17137,1985,10.4
53,23,Garfield,1990,1066,1033,33,3.1
53,25,Grant,1990,27271,24877,2394,8.8
53,27,Grays Harbor,1990,27496,24871,2625,9.5
53,29,Island,1990,23025,22239,786,3.4
53,31,Jefferson,1990,8409,7984,425,5.1
53,33,King,1990,856290,824999,31291,3.7
53,35,Kitsap,1990,84777,81309,3468,4.1
53,37,Kittitas,1990,12693,11696,997,7.9
53,39,Klickitat,1990,7943,6997,946,11.9
53,41,Lewis,1990,26435,24289,2146,8.1
53,43,Lincoln,1990,4177,4018,159,3.8
53,45,Mason,1990,15939,15008,931,5.8
53,47,Okanogan,1990,19008,17178,1830,9.6
53,49,Pacific,1990,7540,6921,619,8.2
53,51,Pend Oreille,1990,3484,2986,498,14.3
53,53,Pierce,1990,277290,264100,13190,4.8
53,55,San Juan,1990,5108,4961,147,2.9
53,57,Skagit,1990,39476,36761,2715,6.9
53,59,Skamania,1990,3937,3535,402,10.2
53,61,Snohomish,1990,249511,239104,10407,4.2
53,63,Spokane,1990,173319,163599,9720,5.6
53,65,Stevens,1990,13425,12291,1134,8.4
53,67,Thurston,1990,81088,77097,3991,4.9
53,69,Wahkiakum,1990,1533,1440,93,6.1
53,71,Walla Walla,1990,23819,22199,1620,6.8
53,73,Whatcom,1990,68019,64459,3560,5.2
53,75,Whitman,1990,17524,17248,276,1.6
53,77,Yakima,1990,103120,91815,11305,11.0
54,1,Barbour,1990,6084,5303,781,12.8
54,3,Berkeley,1990,29877,27933,1944,6.5
54,5,Boone,1990,8569,7749,820,9.6
54,7,Braxton,1990,5042,4354,688,13.6
54,9,Brooke,1990,12084,11308,776,6.4
54,11,Cabell,1990,43397,40489,2908,6.7
54,13,Calhoun,1990,3072,2547,525,17.1
54,15,Clay,1990,2971,2480,491,16.5
54,17,Doddridge,1990,2744,2534,210,7.7
54,19,Fayette,1990,17028,15085,1943,11.4
54,21,Gilmer,1990,2827,2512,315,11.1
54,23,Grant,1990,5438,5051,387,7.1
54,25,Greenbrier,1990,15686,13769,1917,12.2
54,27,Hampshire,1990,7532,6821,711,9.4
54,29,Hancock,1990,15941,15019,922,5.8
54,31,Hardy,1990,5455,5139,316,5.8
54,33,Harrison,1990,30178,27516,2662,8.8
54,35,Jackson,1990,11461,10382,1079,9.4
54,37,Jefferson,1990,18971,17881,1090,5.7
54,39,Kanawha,1990,97479,91289,6190,6.4
54,41,Lewis,1990,7204,6399,805,11.2
54,43,Lincoln,1990,7065,6047,1018,14.4
54,45,Logan,1990,14543,12865,1678,11.5
54,47,McDowell,1990,8924,7731,1193,13.4
54,49,Marion,1990,24104,21915,2189,9.1
54,51,Marshall,1990,16209,14977,1232,7.6
54,53,Mason,1990,10123,9194,929,9.2
54,55,Mercer,1990,28806,26418,2388,8.3
54,57,Mineral,1990,11884,11068,816,6.9
54,59,Mingo,1990,9937,8841,1096,11.0
54,61,Monongalia,1990,37046,34593,2453,6.6
54,63,Monroe,1990,5163,4673,490,9.5
54,65,Morgan,1990,5758,5480,278,4.8
54,67,Nicholas,1990,10409,9033,1376,13.2
54,69,Ohio,1990,24467,23136,1331,5.4
54,71,Pendleton,1990,3698,3481,217,5.9
54,73,Pleasants,1990,3258,2922,336,10.3
54,75,Pocahontas,1990,4240,3668,572,13.5
54,77,Preston,1990,12286,11030,1256,10.2
54,79,Putnam,1990,20262,18812,1450,7.2
54,81,Raleigh,1990,29461,26810,2651,9.0
54,83,Randolph,1990,12360,10548,1812,14.7
54,85,Ritchie,1990,4504,3857,647,14.4
54,87,Roane,1990,5985,5051,934,15.6
54,89,Summers,1990,4720,4254,466,9.9
54,91,Taylor,1990,6193,5564,629,10.2
54,93,Tucker,1990,3548,3109,439,12.4
54,95,Tyler,1990,4200,3775,425,10.1
54,97,Upshur,1990,9917,8832,1085,10.9
54,99,Wayne,1990,16674,15253,1421,8.5
54,101,Webster,1990,3447,2778,669,19.4
54,103,Wetzel,1990,7848,6968,880,11.2
54,105,Wirt,1990,2378,1955,423,17.8
54,107,Wood,1990,42352,39326,3026,7.1
54,109,Wyoming,1990,8667,7600,1067,12.3
55,1,Adams,1990,6141,5808,333,5.4
55,3,Ashland,1990,7575,6975,600,7.9
55,5,Barron,1990,20862,19601,1261,6.0
55,7,Bayfield,1990,6660,6152,508,7.6
55,9,Brown,1990,106471,102381,4090,3.8
55,11,Buffalo,1990,7156,6758,398,5.6
55,13,Burnett,1990,5825,5458,367,6.3
55,15,Calumet,1990,21499,20082,1417,6.6
55,17,Chippewa,1990,26188,24708,1480,5.7
55,19,Clark,1990,15554,14617,937,6.0
55,21,Columbia,1990,24957,23565,1392,5.6
55,23,Crawford,1990,8019,7588,431,5.4
55,25,Dane,1990,218668,214263,4405,2.0
55,27,Dodge,1990,39433,37633,1800,4.6
55,29,Door,1990,14836,13851,985,6.6
55,31,Douglas,1990,19448,18337,1111,5.7
55,33,Dunn,1990,18260,17545,715,3.9
55,35,Eau Claire,1990,44329,42104,2225,5.0
55,37,Florence,1990,2171,2090,81,3.7
55,39,Fond du Lac,1990,48851,46342,2509,5.1
55,41,Forest,1990,3546,3308,238,6.7
55,43,Grant,1990,25279,24103,1176,4.7
55,45,Green,1990,17858,17169,689,3.9
55,47,Green Lake,1990,9466,8880,586,6.2
55,49,Iowa,1990,11849,11384,465,3.9
55,51,Iron,1990,2805,2633,172,6.1
55,53,Jackson,1990,8131,7630,501,6.2
55,55,Jefferson,1990,37732,36270,1462,3.9
55,57,Juneau,1990,10539,9810,729,6.9
55,59,Kenosha,1990,66526,62476,4050,6.1
55,61,Kewaunee,1990,10063,9603,460,4.6
55,63,La Crosse,1990,53385,51310,2075,3.9
55,65,Lafayette,1990,8412,8096,316,3.8
55,67,Langlade,1990,9069,8603,466,5.1
55,69,Lincoln,1990,13703,12966,737,5.4
55,71,Manitowoc,1990,41694,39677,2017,4.8
55,73,Marathon,1990,62306,59716,2590,4.2
55,75,Marinette,1990,19260,17896,1364,7.1
55,77,Marquette,1990,6018,5620,398,6.6
55,78,Menominee,1990,1166,1059,107,9.2
55,79,Milwaukee,1990,477120,454999,22121,4.6
55,81,Monroe,1990,18190,17269,921,5.1
55,83,Oconto,1990,14521,13376,1145,7.9
55,85,Oneida,1990,16041,15322,719,4.5
55,87,Outagamie,1990,84566,81848,2718,3.2
55,89,Ozaukee,1990,41336,40032,1304,3.2
55,91,Pepin,1990,3416,3254,162,4.7
55,93,Pierce,1990,18209,17545,664,3.6
55,95,Polk,1990,17218,16206,1012,5.9
55,97,Portage,1990,32557,31354,1203,3.7
55,99,Price,1990,7442,7050,392,5.3
55,101,Racine,1990,90178,86019,4159,4.6
55,103,Richland,1990,8703,8349,354,4.1
55,105,Rock,1990,72499,68536,3963,5.5
55,107,Rusk,1990,6996,6429,567,8.1
55,109,St. Croix,1990,27292,26322,970,3.6
55,111,Sauk,1990,26277,24879,1398,5.3
55,113,Sawyer,1990,6388,5873,515,8.1
55,115,Shawano,1990,18380,17459,921,5.0
55,117,Sheboygan,1990,55941,53629,2312,4.1
55,119,Taylor,1990,9964,9309,655,6.6
55,121,Trempealeau,1990,13419,12563,856,6.4
55,123,Vernon,1990,12630,12048,582,4.6
55,125,Vilas,1990,8282,7820,462,5.6
55,127,Walworth,1990,41875,40732,1143,2.7
55,129,Washburn,1990,6315,5868,447,7.1
55,131,Washington,1990,53772,51734,2038,3.8
55,133,Waukesha,1990,174346,168445,5901,3.4
55,135,Waupaca,1990,22992,21888,1104,4.8
55,137,Waushara,1990,9074,8523,551,6.1
55,139,Winnebago,1990,83881,81007,2874,3.4
55,141,Wood,1990,37539,35971,1568,4.2
56,1,Albany,1990,16793,15938,855,5.1
56,3,Big Horn,1990,4891,4610,281,5.7
56,5,Campbell,1990,16488,15712,776,4.7
56,7,Carbon,1990,8866,8424,442,5.0
56,9,Converse,1990,5757,5448,309,5.4
56,11,Crook,1990,2692,2611,81,3.0
56,13,Fremont,1990,15794,14655,1139,7.2
56,15,Goshen,1990,5979,5717,262,4.4
56,17,Hot Springs,1990,2422,2333,89,3.7
56,19,Johnson,1990,3433,3274,159,4.6
56,21,Laramie,1990,36888,35126,1762,4.8
56,23,Lincoln,1990,5803,5451,352,6.1
56,25,Natrona,1990,32034,30165,1869,5.8
56,27,Niobrara,1990,1188,1145,43,3.6
56,29,Park,1990,13125,12535,590,4.5
56,31,Platte,1990,3885,3696,189,4.9
56,33,Sheridan,1990,12173,11525,648,5.3
56,35,Sublette,1990,2680,2610,70,2.6
56,37,Sweetwater,1990,20452,19416,1036,5.1
56,39,Teton,1990,8267,8110,157,1.9
56,41,Uinta,1990,9944,9315,629,6.3
56,43,Washakie,1990,4267,4076,191,4.5
56,45,Weston,1990,3342,3200,142,4.2
72,1,Adjuntas Municipio,1990,4823,4025,798,16.5
72,3,Aguada Municipio,1990,12874,10319,2555,19.8
72,5,Aguadilla Municipio,1990,18207,14804,3403,18.7
72,7,Aguas Buenas Municipio,1990,7493,6164,1329,17.7
72,9,Aibonito Municipio,1990,8738,7711,1027,11.8
72,11,Anasco Municipio,1990,9221,7447,1774,19.2
72,13,Arecibo Municipio,1990,28961,24384,4577,15.8
72,15,Arroyo Municipio,1990,4918,3857,1061,21.6
72,17,Barceloneta Municipio,1990,6124,4977,1147,18.7
72,19,Barranquitas Municipio,1990,6151,5392,759,12.3
72,21,Bayamon Municipio,1990,78069,70569,7500,9.6
72,23,Cabo Rojo Municipio,1990,13090,10758,2332,17.8
72,25,Caguas Municipio,1990,49786,42806,6980,14.0
72,27,Camuy Municipio,1990,8976,7549,1427,15.9
72,29,Canovanas Municipio,1990,11870,10034,1836,15.5
72,31,Carolina Municipio,1990,69275,63525,5750,8.3
72,33,Catano Municipio,1990,10004,8967,1037,10.4
72,35,Cayey Municipio,1990,14341,11789,2552,17.8
72,37,Ceiba Municipio,1990,5126,4274,852,16.6
72,39,Ciales Municipio,1990,4694,3839,855,18.2
72,41,Cidra Municipio,1990,10888,9238,1650,15.2
72,43,Coamo Municipio,1990,9033,7427,1606,17.8
72,45,Comerio Municipio,1990,5585,4415,1170,20.9
72,47,Corozal Municipio,1990,8634,7539,1095,12.7
72,49,Culebra Municipio,1990,727,683,44,6.1
72,51,Dorado Municipio,1990,9483,8349,1134,12.0
72,53,Fajardo Municipio,1990,12327,10181,2146,17.4
72,54,Florida Municipio,1990,2583,2039,544,21.1
72,55,Guanica Municipio,1990,4497,3487,1010,22.5
72,57,Guayama Municipio,1990,10609,8280,2329,22.0
72,59,Guayanilla Municipio,1990,6148,4798,1350,22.0
72,61,Guaynabo Municipio,1990,34663,32604,2059,5.9
72,63,Gurabo Municipio,1990,9304,7844,1460,15.7
72,65,Hatillo Municipio,1990,9828,8193,1635,16.6
72,67,Hormigueros Municipio,1990,5990,5093,897,15.0
72,69,Humacao Municipio,1990,18137,14993,3144,17.3
72,71,Isabela Municipio,1990,12165,10192,1973,16.2
72,73,Jayuya Municipio,1990,3345,2930,415,12.4
72,75,Juana Diaz Municipio,1990,12136,9641,2495,20.6
72,77,Juncos Municipio,1990,8928,7454,1474,16.5
72,79,Lajas Municipio,1990,7333,5922,1411,19.2
72,81,Lares Municipio,1990,7037,5749,1288,18.3
72,83,Las Marias Municipio,1990,3257,2733,524,16.1
72,85,Las Piedras Municipio,1990,8759,7306,1453,16.6
72,87,Loiza Municipio,1990,8117,7096,1021,12.6
72,89,Luquillo Municipio,1990,6028,4810,1218,20.2
72,91,Manati Municipio,1990,12058,9923,2135,17.7
72,93,Maricao Municipio,1990,1960,1673,287,14.6
72,95,Maunabo Municipio,1990,2646,2080,566,21.4
72,97,Mayaguez Municipio,1990,33887,28291,5596,16.5
72,99,Moca Municipio,1990,10949,8491,2458,22.4
72,101,Morovis Municipio,1990,7203,5987,1216,16.9
72,103,Naguabo Municipio,1990,6287,5062,1225,19.5
72,105,Naranjito Municipio,1990,6629,5562,1067,16.1
72,107,Orocovis Municipio,1990,5168,4285,883,17.1
72,109,Patillas Municipio,1990,5337,4028,1309,24.5
72,111,Penuelas Municipio,1990,6362,4957,1405,22.1
72,113,Ponce Municipio,1990,56338,47054,9284,16.5
72,115,Quebradillas Municipio,1990,6692,5541,1151,17.2
72,117,Rincon Municipio,1990,4945,4051,894,18.1
72,119,Rio Grande Municipio,1990,15011,12724,2287,15.2
72,121,Sabana Grande Municipio,1990,7684,6341,1343,17.5
72,123,Salinas Municipio,1990,8071,5777,2294,28.4
72,125,San German Municipio,1990,12042,9751,2291,19.0
72,127,San Juan Municipio,1990,152473,139713,12760,8.4
72,129,San Lorenzo Municipio,1990,10628,8744,1884,17.7
72,131,San Sebastian Municipio,1990,12128,8993,3135,25.8
72,133,Santa Isabel Municipio,1990,4852,3429,1423,29.3
72,135,Toa Alta Municipio,1990,14419,12894,1525,10.6
72,137,Toa Baja Municipio,1990,31211,28713,2498,8.0
72,139,Trujillo Alto Municipio,1990,22306,20762,1544,6.9
72,141,Utuado Municipio,1990,8043,6732,1311,16.3
72,143,Vega Alta Municipio,1990,10334,8992,1342,13.0
72,145,Vega Baja Municipio,1990,16876,14176,2700,16.0
72,147,Vieques Municipio,1990,2477,2163,314,12.7
72,149,Villalba Municipio,1990,5870,4518,1352,23.0
72,151,Yabucoa Municipio,1990,10532,8218,2314,22.0
72,153,Yauco Municipio,1990,12633,10004,2629,20.8
1,1,Autauga,1991,16958,15811,1147,6.8
1,3,Baldwin,1991,49521,46797,2724,5.5
1,5,Barbour,1991,11649,10632,1017,8.7
1,7,Bibb,1991,7529,6641,888,11.8
1,9,Blount,1991,19166,18060,1106,5.8
1,11,Bullock,1991,4551,3697,854,18.8
1,13,Butler,1991,8723,7665,1058,12.1
1,15,Calhoun,1991,52215,48233,3982,7.6
1,17,Chambers,1991,17570,15822,1748,9.9
1,19,Cherokee,1991,9626,8805,821,8.5
1,21,Chilton,1991,15245,13733,1512,9.9
1,23,Choctaw,1991,6714,6009,705,10.5
1,25,Clarke,1991,12100,10954,1146,9.5
1,27,Clay,1991,6503,5873,630,9.7
1,29,Cleburne,1991,6711,6225,486,7.2
1,31,Coffee,1991,19109,17871,1238,6.5
1,33,Colbert,1991,24945,22716,2229,8.9
1,35,Conecuh,1991,5833,5199,634,10.9
1,37,Coosa,1991,5012,4676,336,6.7
1,39,Covington,1991,16805,15196,1609,9.6
1,41,Crenshaw,1991,6117,5598,519,8.5
1,43,Cullman,1991,33108,30628,2480,7.5
1,45,Dale,1991,20663,19329,1334,6.5
1,47,Dallas,1991,19699,17151,2548,12.9
1,49,DeKalb,1991,27586,25425,2161,7.8
1,51,Elmore,1991,22761,21247,1514,6.7
1,53,Escambia,1991,15247,13854,1393,9.1
1,55,Etowah,1991,46457,41576,4881,10.5
1,57,Fayette,1991,8488,7590,898,10.6
1,59,Franklin,1991,14222,12882,1340,9.4
1,61,Geneva,1991,11408,10827,581,5.1
1,63,Greene,1991,3795,3362,433,11.4
1,65,Hale,1991,6121,5559,562,9.2
1,67,Henry,1991,6657,6119,538,8.1
1,69,Houston,1991,41242,39109,2133,5.2
1,71,Jackson,1991,24326,21739,2587,10.6
1,73,Jefferson,1991,311796,294636,17160,5.5
1,75,Lamar,1991,7834,7052,782,10.0
1,77,Lauderdale,1991,38679,35775,2904,7.5
1,79,Lawrence,1991,15393,13889,1504,9.8
1,81,Lee,1991,43057,40503,2554,5.9
1,83,Limestone,1991,26980,24756,2224,8.2
1,85,Lowndes,1991,4466,3732,734,16.4
1,87,Macon,1991,8926,8099,827,9.3
1,89,Madison,1991,128844,121516,7328,5.7
1,91,Marengo,1991,10184,9399,785,7.7
1,93,Marion,1991,13904,12374,1530,11.0
1,95,Marshall,1991,35043,31624,3419,9.8
1,97,Mobile,1991,176654,164217,12437,7.0
1,99,Monroe,1991,10829,9707,1122,10.4
1,101,Montgomery,1991,99954,93906,6048,6.1
1,103,Morgan,1991,50871,47219,3652,7.2
1,105,Perry,1991,4659,4037,622,13.4
1,107,Pickens,1991,8790,7923,867,9.9
1,109,Pike,1991,12332,11354,978,7.9
1,111,Randolph,1991,9341,8429,912,9.8
1,113,Russell,1991,21908,20049,1859,8.5
1,115,St. Clair,1991,24014,22545,1469,6.1
1,117,Shelby,1991,54887,52727,2160,3.9
1,119,Sumter,1991,5923,5279,644,10.9
1,121,Talladega,1991,33730,30582,3148,9.3
1,123,Tallapoosa,1991,19266,18073,1193,6.2
1,125,Tuscaloosa,1991,70497,66796,3701,5.2
1,127,Walker,1991,30106,26572,3534,11.7
1,129,Washington,1991,6373,5517,856,13.4
1,131,Wilcox,1991,3988,3366,622,15.6
1,133,Winston,1991,10448,9133,1315,12.6
2,13,Aleutians East Borough,1991,1436,1419,17,1.2
2,16,Aleutians West Census Area,1991,3763,3728,35,0.9
2,20,Anchorage Borough/municipality,1991,123216,115148,8068,6.5
2,50,Bethel Census Area,1991,4617,4230,387,8.4
2,60,Bristol Bay Borough,1991,533,505,28,5.3
2,68,Denali Borough,1991,1012,888,124,12.3
2,70,Dillingham Census Area,1991,1373,1280,93,6.8
2,90,Fairbanks North Star Borough,1991,36755,33189,3566,9.7
2,100,Haines Borough,1991,1160,992,168,14.5
2,110,Juneau Borough/city,1991,15402,14454,948,6.2
2,122,Kenai Peninsula Borough,1991,19668,17095,2573,13.1
2,130,Ketchikan Gateway Borough,1991,7472,6784,688,9.2
2,150,Kodiak Island Borough,1991,6719,6191,528,7.9
2,158,Kusilvak Census Area,1991,1556,1363,193,12.4
2,164,Lake and Peninsula Borough,1991,498,463,35,7.0
2,170,Matanuska-Susitna Borough,1991,19961,17576,2385,11.9
2,180,Nome Census Area,1991,3271,2915,356,10.9
2,185,North Slope Borough,1991,2925,2797,128,4.4
2,188,Northwest Arctic Borough,1991,2169,1828,341,15.7
2,201,Prince of Wales-Outer Ketchikan Census Area,1991,2970,2570,400,13.5
2,220,Sitka Borough/city,1991,4477,4219,258,5.8
2,232,Skagway-Hoonah-Angoon Census Area,1991,2443,2192,251,10.3
2,240,Southeast Fairbanks Census Area,1991,2156,1866,290,13.5
2,261,Valdez-Cordova Census Area,1991,5098,4617,481,9.4
2,280,Wrangell-Petersburg Census Area,1991,3569,3214,355,9.9
2,290,Yukon-Koyukuk Census Area,1991,1989,1668,321,16.1
4,1,Apache,1991,17569,15252,2317,13.2
4,3,Cochise,1991,37023,34256,2767,7.5
4,5,Coconino,1991,49381,45735,3646,7.4
4,7,Gila,1991,16502,15216,1286,7.8
4,9,Graham,1991,9325,8672,653,7.0
4,11,Greenlee,1991,3928,3678,250,6.4
4,12,La Paz,1991,5318,4853,465,8.7
4,13,Maricopa,1991,1119128,1062582,56546,5.1
4,15,Mohave,1991,45951,42927,3024,6.6
4,17,Navajo,1991,26232,23178,3054,11.6
4,19,Pima,1991,322349,308547,13802,4.3
4,21,Pinal,1991,45369,42282,3087,6.8
4,23,Santa Cruz,1991,13038,11229,1809,13.9
4,25,Yavapai,1991,47429,44965,2464,5.2
4,27,Yuma,1991,49733,39343,10390,20.9
5,1,Arkansas,1991,10219,9610,609,6.0
5,3,Ashley,1991,11055,10258,797,7.2
5,5,Baxter,1991,11961,11274,687,5.7
5,7,Benton,1991,50316,48599,1717,3.4
5,9,Boone,1991,13714,12888,826,6.0
5,11,Bradley,1991,5109,4493,616,12.1
5,13,Calhoun,1991,2474,2216,258,10.4
5,15,Carroll,1991,10439,9831,608,5.8
5,17,Chicot,1991,6035,5409,626,10.4
5,19,Clark,1991,10293,9644,649,6.3
5,21,Clay,1991,8211,7502,709,8.6
5,23,Cleburne,1991,8788,8081,707,8.0
5,25,Cleveland,1991,3665,3378,287,7.8
5,27,Columbia,1991,11761,10900,861,7.3
5,29,Conway,1991,9165,8571,594,6.5
5,31,Craighead,1991,37055,34389,2666,7.2
5,33,Crawford,1991,21236,19330,1906,9.0
5,35,Crittenden,1991,22366,20342,2024,9.0
5,37,Cross,1991,8592,7909,683,7.9
5,39,Dallas,1991,4087,3702,385,9.4
5,41,Desha,1991,6984,6271,713,10.2
5,43,Drew,1991,8668,7860,808,9.3
5,45,Faulkner,1991,32490,30225,2265,7.0
5,47,Franklin,1991,7244,6698,546,7.5
5,49,Fulton,1991,4121,3882,239,5.8
5,51,Garland,1991,32346,29847,2499,7.7
5,53,Grant,1991,7004,6521,483,6.9
5,55,Greene,1991,15712,14630,1082,6.9
5,57,Hempstead,1991,10242,9345,897,8.8
5,59,Hot Spring,1991,11409,10249,1160,10.2
5,61,Howard,1991,6537,6089,448,6.9
5,63,Independence,1991,15929,14701,1228,7.7
5,65,Izard,1991,4557,4303,254,5.6
5,67,Jackson,1991,8263,7219,1044,12.6
5,69,Jefferson,1991,37977,33746,4231,11.1
5,71,Johnson,1991,8302,7628,674,8.1
5,73,Lafayette,1991,3644,3293,351,9.6
5,75,Lawrence,1991,7559,6835,724,9.6
5,77,Lee,1991,4683,4056,627,13.4
5,79,Lincoln,1991,4859,4432,427,8.8
5,81,Little River,1991,6680,6069,611,9.1
5,83,Logan,1991,9567,8763,804,8.4
5,85,Lonoke,1991,19718,18584,1134,5.8
5,87,Madison,1991,6761,6439,322,4.8
5,89,Marion,1991,4905,4597,308,6.3
5,91,Miller,1991,17018,15632,1386,8.1
5,93,Mississippi,1991,25939,23368,2571,9.9
5,95,Monroe,1991,4428,3984,444,10.0
5,97,Montgomery,1991,3564,3382,182,5.1
5,99,Nevada,1991,4518,4103,415,9.2
5,101,Newton,1991,2948,2689,259,8.8
5,103,Ouachita,1991,13510,11829,1681,12.4
5,105,Perry,1991,3682,3358,324,8.8
5,107,Phillips,1991,10681,9588,1093,10.2
5,109,Pike,1991,4545,4147,398,8.8
5,111,Poinsett,1991,10857,9865,992,9.1
5,113,Polk,1991,7686,7217,469,6.1
5,115,Pope,1991,24323,22842,1481,6.1
5,117,Prairie,1991,4374,3967,407,9.3
5,119,Pulaski,1991,186893,176026,10867,5.8
5,121,Randolph,1991,7261,6482,779,10.7
5,123,St. Francis,1991,11497,10094,1403,12.2
5,125,Saline,1991,34289,32171,2118,6.2
5,127,Scott,1991,4811,4568,243,5.1
5,129,Searcy,1991,3014,2773,241,8.0
5,131,Sebastian,1991,52439,48560,3879,7.4
5,133,Sevier,1991,6828,6426,402,5.9
5,135,Sharp,1991,5162,4759,403,7.8
5,137,Stone,1991,4472,4181,291,6.5
5,139,Union,1991,20710,19126,1584,7.6
5,141,Van Buren,1991,5635,5074,561,10.0
5,143,Washington,1991,62662,60227,2435,3.9
5,145,White,1991,26878,24310,2568,9.6
5,147,Woodruff,1991,4045,3437,608,15.0
5,149,Yell,1991,8742,8289,453,5.2
6,1,Alameda,1991,673297,636311,36986,5.5
6,3,Alpine,1991,357,309,48,13.4
6,5,Amador,1991,12010,11166,844,7.0
6,7,Butte,1991,79500,71646,7854,9.9
6,9,Calaveras,1991,13999,12685,1314,9.4
6,11,Colusa,1991,8118,6646,1472,18.1
6,13,Contra Costa,1991,435451,411394,24057,5.5
6,15,Del Norte,1991,9797,8590,1207,12.3
6,17,El Dorado,1991,65686,61257,4429,6.7
6,19,Fresno,1991,337883,292124,45759,13.5
6,21,Glenn,1991,11117,9352,1765,15.9
6,23,Humboldt,1991,56826,51795,5031,8.9
6,25,Imperial,1991,49121,36219,12902,26.3
6,27,Inyo,1991,7186,6479,707,9.8
6,29,Kern,1991,265426,232733,32693,12.3
6,31,Kings,1991,38735,33772,4963,12.8
6,33,Lake,1991,20965,18715,2250,10.7
6,35,Lassen,1991,10266,9188,1078,10.5
6,37,Los Angeles,1991,4449188,4092542,356646,8.0
6,39,Madera,1991,44372,37662,6710,15.1
6,41,Marin,1991,130871,125816,5055,3.9
6,43,Mariposa,1991,6964,6460,504,7.2
6,45,Mendocino,1991,38882,34717,4165,10.7
6,47,Merced,1991,77505,65296,12209,15.8
6,49,Modoc,1991,3893,3404,489,12.6
6,51,Mono,1991,5471,4807,664,12.1
6,53,Monterey,1991,171758,152131,19627,11.4
6,55,Napa,1991,55328,52093,3235,5.8
6,57,Nevada,1991,38466,35943,2523,6.6
6,59,Orange,1991,1321757,1251290,70467,5.3
6,61,Placer,1991,91300,85326,5974,6.5
6,63,Plumas,1991,9680,8604,1076,11.1
6,65,Riverside,1991,551422,495159,56263,10.2
6,67,Sacramento,1991,528527,493047,35480,6.7
6,69,San Benito,1991,21297,17842,3455,16.2
6,71,San Bernardino,1991,646035,592075,53960,8.4
6,73,San Diego,1991,1209812,1132952,76860,6.4
6,75,San Francisco/city,1991,405926,383963,21963,5.4
6,77,San Joaquin,1991,232005,203851,28154,12.1
6,79,San Luis Obispo,1991,96383,90498,5885,6.1
6,81,San Mateo,1991,367383,352624,14759,4.0
6,83,Santa Barbara,1991,195300,183570,11730,6.0
6,85,Santa Clara,1991,843630,794898,48732,5.8
6,87,Santa Cruz,1991,137542,125221,12321,9.0
6,89,Shasta,1991,68390,60854,7536,11.0
6,91,Sierra,1991,1652,1472,180,10.9
6,93,Siskiyou,1991,19174,16628,2546,13.3
6,95,Solano,1991,166839,156278,10561,6.3
6,97,Sonoma,1991,212341,200395,11946,5.6
6,99,Stanislaus,1991,183861,156477,27384,14.9
6,101,Sutter,1991,34649,28714,5935,17.1
6,103,Tehama,1991,21237,18767,2470,11.6
6,105,Trinity,1991,5143,4391,752,14.6
6,107,Tulare,1991,153350,125262,28088,18.3
6,109,Tuolumne,1991,20059,18303,1756,8.8
6,111,Ventura,1991,367417,339345,28072,7.6
6,113,Yolo,1991,77236,71102,6134,7.9
6,115,Yuba,1991,22700,19521,3179,14.0
8,1,Adams,1991,142694,135109,7585,5.3
8,3,Alamosa,1991,6825,6339,486,7.1
8,5,Arapahoe,1991,231656,222500,9156,4.0
8,7,Archuleta,1991,2750,2540,210,7.6
8,9,Baca,1991,2028,1960,68,3.4
8,11,Bent,1991,2054,1961,93,4.5
8,13,Boulder,1991,128615,122635,5980,4.6
8,14,Broomfield/city,1991,14645,14136,509,3.5
8,15,Chaffee,1991,6100,5736,364,6.0
8,17,Cheyenne,1991,1214,1189,25,2.1
8,19,Clear Creek,1991,4538,4345,193,4.3
8,21,Conejos,1991,3078,2757,321,10.4
8,23,Costilla,1991,1620,1407,213,13.1
8,25,Crowley,1991,1173,1111,62,5.3
8,27,Custer,1991,1003,953,50,5.0
8,29,Delta,1991,8650,7764,886,10.2
8,31,Denver/city,1991,254169,239655,14514,5.7
8,33,Dolores,1991,719,632,87,12.1
8,35,Douglas,1991,38173,37010,1163,3.0
8,37,Eagle,1991,13346,12697,649,4.9
8,39,Elbert,1991,5852,5561,291,5.0
8,41,El Paso,1991,193691,180211,13480,7.0
8,43,Fremont,1991,13095,12181,914,7.0
8,45,Garfield,1991,17237,16010,1227,7.1
8,47,Gilpin,1991,2764,2677,87,3.1
8,49,Grand,1991,4509,4336,173,3.8
8,51,Gunnison,1991,5963,5508,455,7.6
8,53,Hinsdale,1991,424,415,9,2.1
8,55,Huerfano,1991,2533,2332,201,7.9
8,57,Jackson,1991,908,857,51,5.6
8,59,Jefferson,1991,258557,248358,10199,3.9
8,61,Kiowa,1991,796,763,33,4.1
8,63,Kit Carson,1991,3242,3170,72,2.2
8,65,Lake,1991,2891,2685,206,7.1
8,67,La Plata,1991,18386,17231,1155,6.3
8,69,Larimer,1991,107336,102140,5196,4.8
8,71,Las Animas,1991,5470,5081,389,7.1
8,73,Lincoln,1991,2456,2377,79,3.2
8,75,Logan,1991,8494,8033,461,5.4
8,77,Mesa,1991,46660,43464,3196,6.8
8,79,Mineral,1991,319,305,14,4.4
8,81,Moffat,1991,6013,5593,420,7.0
8,83,Montezuma,1991,9437,8641,796,8.4
8,85,Montrose,1991,12054,11112,942,7.8
8,87,Morgan,1991,10982,10477,505,4.6
8,89,Otero,1991,8515,7934,581,6.8
8,91,Ouray,1991,1259,1165,94,7.5
8,93,Park,1991,4726,4522,204,4.3
8,95,Phillips,1991,1733,1697,36,2.1
8,97,Pitkin,1991,7691,7126,565,7.3
8,99,Prowers,1991,5947,5591,356,6.0
8,101,Pueblo,1991,52626,48471,4155,7.9
8,103,Rio Blanco,1991,3314,3145,169,5.1
8,105,Rio Grande,1991,5077,4558,519,10.2
8,107,Routt,1991,8583,8148,435,5.1
8,109,Saguache,1991,2296,2053,243,10.6
8,111,San Juan,1991,438,341,97,22.1
8,113,San Miguel,1991,2759,2577,182,6.6
8,115,Sedgwick,1991,1242,1200,42,3.4
8,117,Summit,1991,8538,8159,379,4.4
8,119,Teller,1991,8409,8008,401,4.8
8,121,Washington,1991,2136,2073,63,2.9
8,123,Weld,1991,68563,64965,3598,5.2
8,125,Yuma,1991,3993,3886,107,2.7
9,1,Fairfield,1991,463039,436187,26852,5.8
9,3,Hartford,1991,471955,439250,32705,6.9
9,5,Litchfield,1991,104311,97658,6653,6.4
9,7,Middlesex,1991,84411,79608,4803,5.7
9,9,New Haven,1991,442225,411421,30804,7.0
9,11,New London,1991,131326,122624,8702,6.6
9,13,Tolland,1991,75074,70795,4279,5.7
9,15,Windham,1991,56282,51346,4936,8.8
10,1,Kent,1991,61823,58119,3704,6.0
10,3,New Castle,1991,237741,222984,14757,6.2
10,5,Sussex,1991,62513,59613,2900,4.6
11,1,District of Colu,1991,319995,295423,24572,7.7
12,1,Alachua,1991,95149,90757,4392,4.6
12,3,Baker,1991,8443,7574,869,10.3
12,5,Bay,1991,61791,56543,5248,8.5
12,7,Bradford,1991,9624,9071,553,5.7
12,9,Brevard,1991,208673,193006,15667,7.5
12,11,Broward,1991,675667,620037,55630,8.2
12,13,Calhoun,1991,4665,4255,410,8.8
12,15,Charlotte,1991,42881,39886,2995,7.0
12,17,Citrus,1991,33685,30276,3409,10.1
12,19,Clay,1991,54969,52039,2930,5.3
12,21,Collier,1991,75369,69112,6257,8.3
12,23,Columbia,1991,20788,18659,2129,10.2
12,27,DeSoto,1991,10154,9371,783,7.7
12,29,Dixie,1991,3880,3423,457,11.8
12,31,Duval,1991,355163,331387,23776,6.7
12,33,Escambia,1991,122041,114543,7498,6.1
12,35,Flagler,1991,12531,11415,1116,8.9
12,37,Franklin,1991,4167,3939,228,5.5
12,39,Gadsden,1991,18507,17228,1279,6.9
12,41,Gilchrist,1991,4053,3724,329,8.1
12,43,Glades,1991,3285,2958,327,10.0
12,45,Gulf,1991,5332,4967,365,6.8
12,47,Hamilton,1991,4125,3742,383,9.3
12,49,Hardee,1991,9642,8533,1109,11.5
12,51,Hendry,1991,14169,12231,1938,13.7
12,53,Hernando,1991,37341,33866,3475,9.3
12,55,Highlands,1991,26607,24162,2445,9.2
12,57,Hillsborough,1991,454195,424298,29897,6.6
12,59,Holmes,1991,6478,6033,445,6.9
12,61,Indian River,1991,40447,35186,5261,13.0
12,63,Jackson,1991,19438,18074,1364,7.0
12,65,Jefferson,1991,5525,5228,297,5.4
12,67,Lafayette,1991,2276,2115,161,7.1
12,69,Lake,1991,66356,60634,5722,8.6
12,71,Lee,1991,157578,147443,10135,6.4
12,73,Leon,1991,115213,110755,4458,3.9
12,75,Levy,1991,10750,9994,756,7.0
12,77,Liberty,1991,2286,2151,135,5.9
12,79,Madison,1991,7002,6395,607,8.7
12,81,Manatee,1991,98509,93068,5441,5.5
12,83,Marion,1991,85557,78216,7341,8.6
12,85,Martin,1991,45416,40641,4775,10.5
12,86,Miami-Dade,1991,983384,902523,80861,8.2
12,87,Monroe,1991,41123,39440,1683,4.1
12,89,Nassau,1991,23115,21493,1622,7.0
12,91,Okaloosa,1991,66672,62344,4328,6.5
12,93,Okeechobee,1991,14415,13001,1414,9.8
12,95,Orange,1991,393445,364981,28464,7.2
12,97,Osceola,1991,60841,56828,4013,6.6
12,99,Palm Beach,1991,439873,398146,41727,9.5
12,101,Pasco,1991,109512,100617,8895,8.1
12,103,Pinellas,1991,420384,393158,27226,6.5
12,105,Polk,1991,199134,178563,20571,10.3
12,107,Putnam,1991,27669,25554,2115,7.6
12,109,St. Johns,1991,45139,42350,2789,6.2
12,111,St. Lucie,1991,71654,61365,10289,14.4
12,113,Santa Rosa,1991,40260,37978,2282,5.7
12,115,Sarasota,1991,127601,121161,6440,5.0
12,117,Seminole,1991,171554,159808,11746,6.8
12,119,Sumter,1991,12238,11126,1112,9.1
12,121,Suwannee,1991,12059,10914,1145,9.5
12,123,Taylor,1991,8153,6847,1306,16.0
12,125,Union,1991,3807,3592,215,5.6
12,127,Volusia,1991,169998,158105,11893,7.0
12,129,Wakulla,1991,8244,7835,409,5.0
12,131,Walton,1991,13311,12356,955,7.2
12,133,Washington,1991,7684,7160,524,6.8
13,1,Appling,1991,7656,7011,645,8.4
13,3,Atkinson,1991,2526,2367,159,6.3
13,5,Bacon,1991,4430,4144,286,6.5
13,7,Baker,1991,1652,1547,105,6.4
13,9,Baldwin,1991,16818,16156,662,3.9
13,11,Banks,1991,5913,5603,310,5.2
13,13,Barrow,1991,15262,14309,953,6.2
13,15,Bartow,1991,30097,28026,2071,6.9
13,17,Ben Hill,1991,7174,6763,411,5.7
13,19,Berrien,1991,6666,6292,374,5.6
13,21,Bibb,1991,68886,65680,3206,4.7
13,23,Bleckley,1991,4849,4628,221,4.6
13,25,Brantley,1991,4674,4320,354,7.6
13,27,Brooks,1991,6455,6232,223,3.5
13,29,Bryan,1991,7406,7061,345,4.7
13,31,Bulloch,1991,20232,19347,885,4.4
13,33,Burke,1991,8579,7569,1010,11.8
13,35,Butts,1991,6859,6355,504,7.3
13,37,Calhoun,1991,2114,1968,146,6.9
13,39,Camden,1991,13765,13232,533,3.9
13,43,Candler,1991,3523,3370,153,4.3
13,45,Carroll,1991,36581,34448,2133,5.8
13,47,Catoosa,1991,21873,20826,1047,4.8
13,49,Charlton,1991,3884,3717,167,4.3
13,51,Chatham,1991,100732,96153,4579,4.5
13,53,Chattahoochee,1991,2003,1846,157,7.8
13,55,Chattooga,1991,10685,9889,796,7.4
13,57,Cherokee,1991,53127,51067,2060,3.9
13,59,Clarke,1991,42868,41137,1731,4.0
13,61,Clay,1991,1401,1344,57,4.1
13,63,Clayton,1991,103192,97068,6124,5.9
13,65,Clinch,1991,2864,2733,131,4.6
13,67,Cobb,1991,269838,258254,11584,4.3
13,69,Coffee,1991,14687,13897,790,5.4
13,71,Colquitt,1991,16417,15547,870,5.3
13,73,Columbia,1991,35613,34327,1286,3.6
13,75,Cook,1991,6163,5711,452,7.3
13,77,Coweta,1991,28458,26839,1619,5.7
13,79,Crawford,1991,4063,3763,300,7.4
13,81,Crisp,1991,8762,8182,580,6.6
13,83,Dade,1991,6339,5983,356,5.6
13,85,Dawson,1991,5970,5688,282,4.7
13,87,Decatur,1991,11165,10397,768,6.9
13,89,DeKalb,1991,316025,300707,15318,4.8
13,91,Dodge,1991,8201,7736,465,5.7
13,93,Dooly,1991,3990,3697,293,7.3
13,95,Dougherty,1991,42591,39643,2948,6.9
13,97,Douglas,1991,40018,38074,1944,4.9
13,99,Early,1991,5313,4938,375,7.1
13,101,Echols,1991,1012,975,37,3.7
13,103,Effingham,1991,12684,12021,663,5.2
13,105,Elbert,1991,8840,8212,628,7.1
13,107,Emanuel,1991,8912,8029,883,9.9
13,109,Evans,1991,3975,3782,193,4.9
13,111,Fannin,1991,7248,6715,533,7.4
13,113,Fayette,1991,34686,33335,1351,3.9
13,115,Floyd,1991,42594,40060,2534,5.9
13,117,Forsyth,1991,25643,24462,1181,4.6
13,119,Franklin,1991,8172,7633,539,6.6
13,121,Fulton,1991,337707,319027,18680,5.5
13,123,Gilmer,1991,6591,6104,487,7.4
13,125,Glascock,1991,1218,1147,71,5.8
13,127,Glynn,1991,30964,29664,1300,4.2
13,129,Gordon,1991,18582,17222,1360,7.3
13,131,Grady,1991,9330,8814,516,5.5
13,133,Greene,1991,5253,4838,415,7.9
13,135,Gwinnett,1991,220458,211658,8800,4.0
13,137,Habersham,1991,14188,13473,715,5.0
13,139,Hall,1991,53557,50864,2693,5.0
13,141,Hancock,1991,3693,3330,363,9.8
13,143,Haralson,1991,9866,8880,986,10.0
13,145,Harris,1991,8738,8306,432,4.9
13,147,Hart,1991,9495,8940,555,5.8
13,149,Heard,1991,4030,3728,302,7.5
13,151,Henry,1991,33831,32200,1631,4.8
13,153,Houston,1991,43018,41311,1707,4.0
13,155,Irwin,1991,3766,3582,184,4.9
13,157,Jackson,1991,15403,14435,968,6.3
13,159,Jasper,1991,3869,3546,323,8.3
13,161,Jeff Davis,1991,5852,5423,429,7.3
13,163,Jefferson,1991,7657,7123,534,7.0
13,165,Jenkins,1991,3676,3474,202,5.5
13,167,Johnson,1991,3715,3510,205,5.5
13,169,Jones,1991,10580,10123,457,4.3
13,171,Lamar,1991,6046,5698,348,5.8
13,173,Lanier,1991,2571,2463,108,4.2
13,175,Laurens,1991,18863,17942,921,4.9
13,177,Lee,1991,8068,7686,382,4.7
13,179,Liberty,1991,14157,13460,697,4.9
13,181,Lincoln,1991,3619,3453,166,4.6
13,183,Long,1991,2417,2337,80,3.3
13,185,Lowndes,1991,34341,32938,1403,4.1
13,187,Lumpkin,1991,7494,7106,388,5.2
13,189,McDuffie,1991,9527,8922,605,6.4
13,191,McIntosh,1991,3546,3325,221,6.2
13,193,Macon,1991,5578,5014,564,10.1
13,195,Madison,1991,11308,10703,605,5.4
13,197,Marion,1991,2133,1981,152,7.1
13,199,Meriwether,1991,9486,8818,668,7.0
13,201,Miller,1991,2766,2592,174,6.3
13,205,Mitchell,1991,9001,8264,737,8.2
13,207,Monroe,1991,7791,7277,514,6.6
13,209,Montgomery,1991,3376,3165,211,6.3
13,211,Morgan,1991,5999,5606,393,6.6
13,213,Murray,1991,14829,13702,1127,7.6
13,215,Muscogee,1991,76423,72499,3924,5.1
13,217,Newton,1991,20929,19706,1223,5.8
13,219,Oconee,1991,9681,9357,324,3.3
13,221,Oglethorpe,1991,5196,4900,296,5.7
13,223,Paulding,1991,23174,21949,1225,5.3
13,225,Peach,1991,9432,8853,579,6.1
13,227,Pickens,1991,7590,7070,520,6.9
13,229,Pierce,1991,6442,6049,393,6.1
13,231,Pike,1991,5239,4976,263,5.0
13,233,Polk,1991,16102,14553,1549,9.6
13,235,Pulaski,1991,3729,3573,156,4.2
13,237,Putnam,1991,7005,6665,340,4.9
13,239,Quitman,1991,904,852,52,5.8
13,241,Rabun,1991,5740,5355,385,6.7
13,243,Randolph,1991,2982,2760,222,7.4
13,245,Richmond,1991,85677,80721,4956,5.8
13,247,Rockdale,1991,30818,29509,1309,4.2
13,249,Schley,1991,1370,1263,107,7.8
13,251,Screven,1991,6395,5820,575,9.0
13,253,Seminole,1991,4136,3862,274,6.6
13,255,Spalding,1991,26827,25139,1688,6.3
13,257,Stephens,1991,11852,11186,666,5.6
13,259,Stewart,1991,2120,1944,176,8.3
13,261,Sumter,1991,13585,12639,946,7.0
13,263,Talbot,1991,2731,2567,164,6.0
13,265,Taliaferro,1991,789,748,41,5.2
13,267,Tattnall,1991,6922,6646,276,4.0
13,269,Taylor,1991,3172,2925,247,7.8
13,271,Telfair,1991,4576,4315,261,5.7
13,273,Terrell,1991,4632,4334,298,6.4
13,275,Thomas,1991,18111,17266,845,4.7
13,277,Tift,1991,17711,16692,1019,5.8
13,279,Toombs,1991,10936,10217,719,6.6
13,281,Towns,1991,2630,2489,141,5.4
13,283,Treutlen,1991,2679,2489,190,7.1
13,285,Troup,1991,25609,23557,2052,8.0
13,287,Turner,1991,3614,3415,199,5.5
13,289,Twiggs,1991,3934,3714,220,5.6
13,291,Union,1991,5566,5314,252,4.5
13,293,Upson,1991,12420,11753,667,5.4
13,295,Walker,1991,29022,27147,1875,6.5
13,297,Walton,1991,19484,18437,1047,5.4
13,299,Ware,1991,14796,13923,873,5.9
13,301,Warren,1991,2466,2188,278,11.3
13,303,Washington,1991,8422,7980,442,5.2
13,305,Wayne,1991,10952,10247,705,6.4
13,307,Webster,1991,1036,964,72,6.9
13,309,Wheeler,1991,1994,1879,115,5.8
13,311,White,1991,7157,6775,382,5.3
13,313,Whitfield,1991,39774,37423,2351,5.9
13,315,Wilcox,1991,2861,2715,146,5.1
13,317,Wilkes,1991,4866,4614,252,5.2
13,319,Wilkinson,1991,4598,4399,199,4.3
13,321,Worth,1991,9100,8667,433,4.8
15,1,Hawaii,1991,62796,59952,2844,4.5
15,3,Honolulu/city,1991,413353,404854,8499,2.1
15,7,Kauai,1991,28142,26977,1165,4.1
15,9,Maui,1991,60562,57283,3279,5.4
16,1,Ada,1991,115546,110602,4944,4.3
16,3,Adams,1991,1594,1360,234,14.7
16,5,Bannock,1991,31812,29577,2235,7.0
16,7,Bear Lake,1991,2417,2293,124,5.1
16,9,Benewah,1991,3617,3161,456,12.6
16,11,Bingham,1991,19092,18023,1069,5.6
16,13,Blaine,1991,8349,7832,517,6.2
16,15,Boise,1991,1820,1686,134,7.4
16,17,Bonner,1991,12635,11274,1361,10.8
16,19,Bonneville,1991,40760,39067,1693,4.2
16,21,Boundary,1991,3514,3150,364,10.4
16,23,Butte,1991,1470,1382,88,6.0
16,25,Camas,1991,436,414,22,5.0
16,27,Canyon,1991,44361,41156,3205,7.2
16,29,Caribou,1991,3051,2867,184,6.0
16,31,Cassia,1991,8655,8095,560,6.5
16,33,Clark,1991,592,576,16,2.7
16,35,Clearwater,1991,4065,3419,646,15.9
16,37,Custer,1991,1983,1851,132,6.7
16,39,Elmore,1991,7867,7422,445,5.7
16,41,Franklin,1991,3846,3712,134,3.5
16,43,Fremont,1991,5056,4626,430,8.5
16,45,Gem,1991,5221,4764,457,8.8
16,47,Gooding,1991,5334,5095,239,4.5
16,49,Idaho,1991,6266,5522,744,11.9
16,51,Jefferson,1991,8412,7945,467,5.6
16,53,Jerome,1991,7164,6755,409,5.7
16,55,Kootenai,1991,36332,33393,2939,8.1
16,57,Latah,1991,13758,13146,612,4.4
16,59,Lemhi,1991,3249,2878,371,11.4
16,61,Lewis,1991,1496,1388,108,7.2
16,63,Lincoln,1991,1975,1856,119,6.0
16,65,Madison,1991,8685,8298,387,4.5
16,67,Minidoka,1991,9280,8662,618,6.7
16,69,Nez Perce,1991,19850,18887,963,4.9
16,71,Oneida,1991,1429,1377,52,3.6
16,73,Owyhee,1991,4011,3777,234,5.8
16,75,Payette,1991,8710,8049,661,7.6
16,77,Power,1991,3344,3107,237,7.1
16,79,Shoshone,1991,6679,5515,1164,17.4
16,81,Teton,1991,1926,1854,72,3.7
16,83,Twin Falls,1991,26295,24765,1530,5.8
16,85,Valley,1991,3340,2983,357,10.7
16,87,Washington,1991,4350,3758,592,13.6
17,1,Adams,1991,33703,31819,1884,5.6
17,3,Alexander,1991,4315,3769,546,12.7
17,5,Bond,1991,7570,6939,631,8.3
17,7,Boone,1991,18107,16321,1786,9.9
17,9,Brown,1991,2421,2283,138,5.7
17,11,Bureau,1991,18179,16949,1230,6.8
17,13,Calhoun,1991,2705,2450,255,9.4
17,15,Carroll,1991,8350,7774,576,6.9
17,17,Cass,1991,6916,6374,542,7.8
17,19,Champaign,1991,94970,91598,3372,3.6
17,21,Christian,1991,17577,16367,1210,6.9
17,23,Clark,1991,8883,8252,631,7.1
17,25,Clay,1991,6931,6336,595,8.6
17,27,Clinton,1991,16665,15483,1182,7.1
17,29,Coles,1991,26327,24897,1430,5.4
17,31,Cook,1991,2586567,2372995,213572,8.3
17,33,Crawford,1991,8947,8096,851,9.5
17,35,Cumberland,1991,5328,4876,452,8.5
17,37,DeKalb,1991,42754,39952,2802,6.6
17,39,De Witt,1991,8787,8170,617,7.0
17,41,Douglas,1991,10790,10214,576,5.3
17,43,DuPage,1991,458328,434506,23822,5.2
17,45,Edgar,1991,9645,8903,742,7.7
17,47,Edwards,1991,3714,3368,346,9.3
17,49,Effingham,1991,16900,15600,1300,7.7
17,51,Fayette,1991,9893,9053,840,8.5
17,53,Ford,1991,6899,6494,405,5.9
17,55,Franklin,1991,16890,14773,2117,12.5
17,57,Fulton,1991,14763,13330,1433,9.7
17,59,Gallatin,1991,3009,2743,266,8.8
17,61,Greene,1991,7212,6731,481,6.7
17,63,Grundy,1991,17088,15266,1822,10.7
17,65,Hamilton,1991,3642,3224,418,11.5
17,67,Hancock,1991,11325,10705,620,5.5
17,69,Hardin,1991,1970,1833,137,7.0
17,71,Henderson,1991,4601,4307,294,6.4
17,73,Henry,1991,26487,24626,1861,7.0
17,75,Iroquois,1991,16601,15774,827,5.0
17,77,Jackson,1991,29611,27658,1953,6.6
17,79,Jasper,1991,4870,4533,337,6.9
17,81,Jefferson,1991,17788,15796,1992,11.2
17,83,Jersey,1991,10190,9482,708,6.9
17,85,Jo Daviess,1991,11107,10482,625,5.6
17,87,Johnson,1991,4288,3799,489,11.4
17,89,Kane,1991,175954,162248,13706,7.8
17,91,Kankakee,1991,50079,46320,3759,7.5
17,93,Kendall,1991,22217,20881,1336,6.0
17,95,Knox,1991,29125,27166,1959,6.7
17,97,Lake,1991,287620,273819,13801,4.8
17,99,LaSalle,1991,52861,48291,4570,8.6
17,101,Lawrence,1991,7479,6778,701,9.4
17,103,Lee,1991,16782,15677,1105,6.6
17,105,Livingston,1991,19756,18910,846,4.3
17,107,Logan,1991,14102,13259,843,6.0
17,109,McDonough,1991,18047,17367,680,3.8
17,111,McHenry,1991,105956,98675,7281,6.9
17,113,McLean,1991,75620,72807,2813,3.7
17,115,Macon,1991,61108,56097,5011,8.2
17,117,Macoupin,1991,22896,21160,1736,7.6
17,119,Madison,1991,126400,117306,9094,7.2
17,121,Marion,1991,19928,17764,2164,10.9
17,123,Marshall,1991,6576,6193,383,5.8
17,125,Mason,1991,8013,7222,791,9.9
17,127,Massac,1991,6735,6256,479,7.1
17,129,Menard,1991,6193,5905,288,4.7
17,131,Mercer,1991,8675,8052,623,7.2
17,133,Monroe,1991,12131,11449,682,5.6
17,135,Montgomery,1991,14143,13032,1111,7.9
17,137,Morgan,1991,19211,18309,902,4.7
17,139,Moultrie,1991,7184,6718,466,6.5
17,141,Ogle,1991,25623,23965,1658,6.5
17,143,Peoria,1991,92224,86510,5714,6.2
17,145,Perry,1991,8931,7585,1346,15.1
17,147,Piatt,1991,8331,7859,472,5.7
17,149,Pike,1991,8501,7928,573,6.7
17,151,Pope,1991,1709,1524,185,10.8
17,153,Pulaski,1991,3003,2664,339,11.3
17,155,Putnam,1991,3008,2776,232,7.7
17,157,Randolph,1991,15895,14694,1201,7.6
17,159,Richland,1991,8535,7983,552,6.5
17,161,Rock Island,1991,75229,70516,4713,6.3
17,163,St. Clair,1991,117349,108220,9129,7.8
17,165,Saline,1991,11049,9954,1095,9.9
17,167,Sangamon,1991,105127,100878,4249,4.0
17,169,Schuyler,1991,3676,3413,263,7.2
17,171,Scott,1991,2876,2682,194,6.7
17,173,Shelby,1991,10971,10093,878,8.0
17,175,Stark,1991,2695,2472,223,8.3
17,177,Stephenson,1991,25483,23822,1661,6.5
17,179,Tazewell,1991,65357,61379,3978,6.1
17,181,Union,1991,8218,7330,888,10.8
17,183,Vermilion,1991,41615,37891,3724,8.9
17,185,Wabash,1991,6105,5268,837,13.7
17,187,Warren,1991,9916,9348,568,5.7
17,189,Washington,1991,7672,7064,608,7.9
17,191,Wayne,1991,8315,7573,742,8.9
17,193,White,1991,7482,6825,657,8.8
17,195,Whiteside,1991,31393,29223,2170,6.9
17,197,Will,1991,188777,174311,14466,7.7
17,199,Williamson,1991,26702,24181,2521,9.4
17,201,Winnebago,1991,142280,132125,10155,7.1
17,203,Woodford,1991,17093,16486,607,3.6
18,1,Adams,1991,15156,14097,1059,7.0
18,3,Allen,1991,161097,151923,9174,5.7
18,5,Bartholomew,1991,33533,31649,1884,5.6
18,7,Benton,1991,4655,4483,172,3.7
18,9,Blackford,1991,6464,5701,763,11.8
18,11,Boone,1991,20457,19843,614,3.0
18,13,Brown,1991,7167,6854,313,4.4
18,15,Carroll,1991,9973,9559,414,4.2
18,17,Cass,1991,18702,17475,1227,6.6
18,19,Clark,1991,45307,42850,2457,5.4
18,21,Clay,1991,11507,10756,751,6.5
18,23,Clinton,1991,14565,13903,662,4.5
18,25,Crawford,1991,4409,3965,444,10.1
18,27,Daviess,1991,12401,11839,562,4.5
18,29,Dearborn,1991,19529,17937,1592,8.2
18,31,Decatur,1991,11988,11498,490,4.1
18,33,DeKalb,1991,19199,17881,1318,6.9
18,35,Delaware,1991,58738,55026,3712,6.3
18,37,Dubois,1991,20359,19669,690,3.4
18,39,Elkhart,1991,82442,76979,5463,6.6
18,41,Fayette,1991,12532,10987,1545,12.3
18,43,Floyd,1991,32627,31193,1434,4.4
18,45,Fountain,1991,8312,7668,644,7.7
18,47,Franklin,1991,9697,8921,776,8.0
18,49,Fulton,1991,9334,8772,562,6.0
18,51,Gibson,1991,15716,14780,936,6.0
18,53,Grant,1991,35657,32627,3030,8.5
18,55,Greene,1991,14093,12959,1134,8.0
18,57,Hamilton,1991,63004,61515,1489,2.4
18,59,Hancock,1991,24516,23527,989,4.0
18,61,Harrison,1991,14949,14204,745,5.0
18,63,Hendricks,1991,40683,39557,1126,2.8
18,65,Henry,1991,23074,21178,1896,8.2
18,67,Howard,1991,39937,36793,3144,7.9
18,69,Huntington,1991,19072,17623,1449,7.6
18,71,Jackson,1991,19020,17620,1400,7.4
18,73,Jasper,1991,11873,11101,772,6.5
18,75,Jay,1991,10598,9656,942,8.9
18,77,Jefferson,1991,14502,13328,1174,8.1
18,79,Jennings,1991,11577,10780,797,6.9
18,81,Johnson,1991,49075,47405,1670,3.4
18,83,Knox,1991,18499,17210,1289,7.0
18,85,Kosciusko,1991,34172,32535,1637,4.8
18,87,LaGrange,1991,13970,12971,999,7.2
18,89,Lake,1991,222394,207380,15014,6.8
18,91,LaPorte,1991,51662,48862,2800,5.4
18,93,Lawrence,1991,21113,19299,1814,8.6
18,95,Madison,1991,63437,59305,4132,6.5
18,97,Marion,1991,423260,404811,18449,4.4
18,99,Marshall,1991,22285,21048,1237,5.6
18,101,Martin,1991,4930,4580,350,7.1
18,103,Miami,1991,15832,14546,1286,8.1
18,105,Monroe,1991,54211,52448,1763,3.3
18,107,Montgomery,1991,17501,16834,667,3.8
18,109,Morgan,1991,29431,27967,1464,5.0
18,111,Newton,1991,6393,6097,296,4.6
18,113,Noble,1991,19487,17759,1728,8.9
18,115,Ohio,1991,2546,2369,177,7.0
18,117,Orange,1991,8312,7423,889,10.7
18,119,Owen,1991,8187,7732,455,5.6
18,121,Parke,1991,7063,6660,403,5.7
18,123,Perry,1991,8455,7673,782,9.2
18,125,Pike,1991,5779,5430,349,6.0
18,127,Porter,1991,66833,64014,2819,4.2
18,129,Posey,1991,12729,12109,620,4.9
18,131,Pulaski,1991,5853,5488,365,6.2
18,133,Putnam,1991,14233,13489,744,5.2
18,135,Randolph,1991,12100,10743,1357,11.2
18,137,Ripley,1991,12193,11253,940,7.7
18,139,Rush,1991,8800,8215,585,6.6
18,141,St. Joseph,1991,123924,116586,7338,5.9
18,143,Scott,1991,9518,8793,725,7.6
18,145,Shelby,1991,21274,20033,1241,5.8
18,147,Spencer,1991,9434,8784,650,6.9
18,149,Starke,1991,10068,9335,733,7.3
18,151,Steuben,1991,14786,13803,983,6.6
18,153,Sullivan,1991,8740,8017,723,8.3
18,155,Switzerland,1991,3950,3641,309,7.8
18,157,Tippecanoe,1991,65263,63575,1688,2.6
18,159,Tipton,1991,8163,7642,521,6.4
18,161,Union,1991,3406,3102,304,8.9
18,163,Vanderburgh,1991,83997,79271,4726,5.6
18,165,Vermillion,1991,7550,7037,513,6.8
18,167,Vigo,1991,49886,47285,2601,5.2
18,169,Wabash,1991,18138,16596,1542,8.5
18,171,Warren,1991,3751,3536,215,5.7
18,173,Warrick,1991,23625,22563,1062,4.5
18,175,Washington,1991,10707,9844,863,8.1
18,177,Wayne,1991,35098,31403,3695,10.5
18,179,Wells,1991,13517,12838,679,5.0
18,181,White,1991,12024,11328,696,5.8
18,183,Whitley,1991,14711,13774,937,6.4
19,1,Adair,1991,4013,3888,125,3.1
19,3,Adams,1991,2415,2301,114,4.7
19,5,Allamakee,1991,7249,6852,397,5.5
19,7,Appanoose,1991,6606,6174,432,6.5
19,9,Audubon,1991,3737,3627,110,2.9
19,11,Benton,1991,11080,10502,578,5.2
19,13,Black Hawk,1991,63995,60003,3992,6.2
19,15,Boone,1991,12831,12198,633,4.9
19,17,Bremer,1991,11869,11303,566,4.8
19,19,Buchanan,1991,9845,9258,587,6.0
19,21,Buena Vista,1991,10499,10242,257,2.4
19,23,Butler,1991,7564,7086,478,6.3
19,25,Calhoun,1991,5042,4882,160,3.2
19,27,Carroll,1991,10986,10570,416,3.8
19,29,Cass,1991,7513,7102,411,5.5
19,31,Cedar,1991,9217,8939,278,3.0
19,33,Cerro Gordo,1991,25823,24380,1443,5.6
19,35,Cherokee,1991,6880,6679,201,2.9
19,37,Chickasaw,1991,7106,6621,485,6.8
19,39,Clarke,1991,4359,4064,295,6.8
19,41,Clay,1991,8851,8550,301,3.4
19,43,Clayton,1991,9199,8647,552,6.0
19,45,Clinton,1991,26161,24559,1602,6.1
19,47,Crawford,1991,8432,8051,381,4.5
19,49,Dallas,1991,16410,15850,560,3.4
19,51,Davis,1991,4012,3766,246,6.1
19,53,Decatur,1991,3850,3598,252,6.5
19,55,Delaware,1991,8970,8487,483,5.4
19,57,Des Moines,1991,22454,21116,1338,6.0
19,59,Dickinson,1991,8280,7982,298,3.6
19,61,Dubuque,1991,47293,44387,2906,6.1
19,63,Emmet,1991,5690,5354,336,5.9
19,65,Fayette,1991,10402,9851,551,5.3
19,67,Floyd,1991,8624,8046,578,6.7
19,69,Franklin,1991,5689,5447,242,4.3
19,71,Fremont,1991,3714,3531,183,4.9
19,73,Greene,1991,4989,4746,243,4.9
19,75,Grundy,1991,5824,5624,200,3.4
19,77,Guthrie,1991,5654,5404,250,4.4
19,79,Hamilton,1991,8481,8124,357,4.2
19,81,Hancock,1991,5992,5648,344,5.7
19,83,Hardin,1991,9438,8903,535,5.7
19,85,Harrison,1991,7225,6842,383,5.3
19,87,Henry,1991,10169,9720,449,4.4
19,89,Howard,1991,4690,4502,188,4.0
19,91,Humboldt,1991,4998,4798,200,4.0
19,93,Ida,1991,3767,3629,138,3.7
19,95,Iowa,1991,8387,8176,211,2.5
19,97,Jackson,1991,10277,9593,684,6.7
19,99,Jasper,1991,17956,17150,806,4.5
19,101,Jefferson,1991,8589,8191,398,4.6
19,103,Johnson,1991,58429,56667,1762,3.0
19,105,Jones,1991,9330,8851,479,5.1
19,107,Keokuk,1991,5256,4985,271,5.2
19,109,Kossuth,1991,8907,8415,492,5.5
19,111,Lee,1991,19488,18005,1483,7.6
19,113,Linn,1991,96786,91988,4798,5.0
19,115,Louisa,1991,6093,5776,317,5.2
19,117,Lucas,1991,4290,4049,241,5.6
19,119,Lyon,1991,5651,5519,132,2.3
19,121,Madison,1991,6377,6018,359,5.6
19,123,Mahaska,1991,10585,10098,487,4.6
19,125,Marion,1991,15895,15271,624,3.9
19,127,Marshall,1991,20153,19413,740,3.7
19,129,Mills,1991,6555,6324,231,3.5
19,131,Mitchell,1991,5170,4943,227,4.4
19,133,Monona,1991,4445,4252,193,4.3
19,135,Monroe,1991,3910,3678,232,5.9
19,137,Montgomery,1991,5990,5737,253,4.2
19,139,Muscatine,1991,20913,19731,1182,5.7
19,141,O'Brien,1991,7423,7243,180,2.4
19,143,Osceola,1991,3581,3465,116,3.2
19,145,Page,1991,8167,7681,486,6.0
19,147,Palo Alto,1991,4912,4724,188,3.8
19,149,Plymouth,1991,12346,11941,405,3.3
19,151,Pocahontas,1991,4307,4176,131,3.0
19,153,Polk,1991,193286,186341,6945,3.6
19,155,Pottawattamie,1991,43868,41888,1980,4.5
19,157,Poweshiek,1991,9795,9351,444,4.5
19,159,Ringgold,1991,2609,2501,108,4.1
19,161,Sac,1991,5903,5677,226,3.8
19,163,Scott,1991,80615,76621,3994,5.0
19,165,Shelby,1991,6658,6304,354,5.3
19,167,Sioux,1991,15449,15010,439,2.8
19,169,Story,1991,41924,40269,1655,3.9
19,171,Tama,1991,8162,7738,424,5.2
19,173,Taylor,1991,3278,3134,144,4.4
19,175,Union,1991,6052,5686,366,6.0
19,177,Van Buren,1991,3721,3521,200,5.4
19,179,Wapello,1991,17403,16103,1300,7.5
19,181,Warren,1991,20749,20098,651,3.1
19,183,Washington,1991,10684,10321,363,3.4
19,185,Wayne,1991,3138,3021,117,3.7
19,187,Webster,1991,19533,18522,1011,5.2
19,189,Winnebago,1991,5975,5613,362,6.1
19,191,Winneshiek,1991,11432,10818,614,5.4
19,193,Woodbury,1991,51366,48879,2487,4.8
19,195,Worth,1991,4012,3784,228,5.7
19,197,Wright,1991,7180,6888,292,4.1
20,1,Allen,1991,6658,6263,395,5.9
20,3,Anderson,1991,3907,3637,270,6.9
20,5,Atchison,1991,8293,7758,535,6.5
20,7,Barber,1991,2799,2719,80,2.9
20,9,Barton,1991,15310,14751,559,3.7
20,11,Bourbon,1991,6654,6261,393,5.9
20,13,Brown,1991,4933,4678,255,5.2
20,15,Butler,1991,26631,25691,940,3.5
20,17,Chase,1991,1430,1339,91,6.4
20,19,Chautauqua,1991,1791,1704,87,4.9
20,21,Cherokee,1991,9675,8964,711,7.3
20,23,Cheyenne,1991,1522,1504,18,1.2
20,25,Clark,1991,1271,1246,25,2.0
20,27,Clay,1991,4410,4244,166,3.8
20,29,Cloud,1991,5281,5127,154,2.9
20,31,Coffey,1991,4118,3899,219,5.3
20,33,Comanche,1991,1087,1075,12,1.1
20,35,Cowley,1991,17973,17078,895,5.0
20,37,Crawford,1991,16002,15108,894,5.6
20,39,Decatur,1991,1957,1924,33,1.7
20,41,Dickinson,1991,9612,9232,380,4.0
20,43,Doniphan,1991,3708,3409,299,8.1
20,45,Douglas,1991,45935,43850,2085,4.5
20,47,Edwards,1991,1839,1787,52,2.8
20,49,Elk,1991,1429,1361,68,4.8
20,51,Ellis,1991,14706,14217,489,3.3
20,53,Ellsworth,1991,2900,2821,79,2.7
20,55,Finney,1991,18106,17588,518,2.9
20,57,Ford,1991,14357,13958,399,2.8
20,59,Franklin,1991,11367,10712,655,5.8
20,61,Geary,1991,10828,9870,958,8.8
20,63,Gove,1991,1474,1454,20,1.4
20,65,Graham,1991,1732,1696,36,2.1
20,67,Grant,1991,3714,3609,105,2.8
20,69,Gray,1991,2658,2598,60,2.3
20,71,Greeley,1991,883,869,14,1.6
20,73,Greenwood,1991,3496,3337,159,4.5
20,75,Hamilton,1991,1239,1222,17,1.4
20,77,Harper,1991,3215,3132,83,2.6
20,79,Harvey,1991,16206,15659,547,3.4
20,81,Haskell,1991,2003,1964,39,1.9
20,83,Hodgeman,1991,954,942,12,1.3
20,85,Jackson,1991,5648,5293,355,6.3
20,87,Jefferson,1991,8570,8114,456,5.3
20,89,Jewell,1991,2044,2005,39,1.9
20,91,Johnson,1991,214283,207156,7127,3.3
20,93,Kearny,1991,2035,1995,40,2.0
20,95,Kingman,1991,3987,3820,167,4.2
20,97,Kiowa,1991,1746,1709,37,2.1
20,99,Labette,1991,11766,11052,714,6.1
20,101,Lane,1991,1110,1095,15,1.4
20,103,Leavenworth,1991,25932,24589,1343,5.2
20,105,Lincoln,1991,1811,1749,62,3.4
20,107,Linn,1991,3322,3001,321,9.7
20,109,Logan,1991,1574,1527,47,3.0
20,111,Lyon,1991,18851,18024,827,4.4
20,113,McPherson,1991,14439,13956,483,3.3
20,115,Marion,1991,6598,6419,179,2.7
20,117,Marshall,1991,5310,5136,174,3.3
20,119,Meade,1991,2124,2077,47,2.2
20,121,Miami,1991,12273,11562,711,5.8
20,123,Mitchell,1991,3525,3407,118,3.3
20,125,Montgomery,1991,17843,16690,1153,6.5
20,127,Morris,1991,2936,2811,125,4.3
20,129,Morton,1991,1665,1629,36,2.2
20,131,Nemaha,1991,5250,5148,102,1.9
20,133,Neosho,1991,8676,8247,429,4.9
20,135,Ness,1991,1960,1934,26,1.3
20,137,Norton,1991,2866,2809,57,2.0
20,139,Osage,1991,7523,6998,525,7.0
20,141,Osborne,1991,2520,2464,56,2.2
20,143,Ottawa,1991,2782,2694,88,3.2
20,145,Pawnee,1991,3690,3597,93,2.5
20,147,Phillips,1991,3086,3012,74,2.4
20,149,Pottawatomie,1991,8738,8276,462,5.3
20,151,Pratt,1991,4868,4733,135,2.8
20,153,Rawlins,1991,1599,1553,46,2.9
20,155,Reno,1991,31525,29921,1604,5.1
20,157,Republic,1991,3252,3203,49,1.5
20,159,Rice,1991,5015,4838,177,3.5
20,161,Riley,1991,28280,26831,1449,5.1
20,163,Rooks,1991,2805,2747,58,2.1
20,165,Rush,1991,1849,1796,53,2.9
20,167,Russell,1991,3769,3654,115,3.1
20,169,Saline,1991,27957,26891,1066,3.8
20,171,Scott,1991,2728,2671,57,2.1
20,173,Sedgwick,1991,218910,209715,9195,4.2
20,175,Seward,1991,9947,9592,355,3.6
20,177,Shawnee,1991,87030,82760,4270,4.9
20,179,Sheridan,1991,1508,1483,25,1.7
20,181,Sherman,1991,3582,3492,90,2.5
20,183,Smith,1991,2403,2356,47,2.0
20,185,Stafford,1991,2445,2381,64,2.6
20,187,Stanton,1991,1134,1105,29,2.6
20,189,Stevens,1991,2506,2453,53,2.1
20,191,Sumner,1991,12446,11838,608,4.9
20,193,Thomas,1991,4255,4160,95,2.2
20,195,Trego,1991,1811,1779,32,1.8
20,197,Wabaunsee,1991,3318,3161,157,4.7
20,199,Wallace,1991,849,825,24,2.8
20,201,Washington,1991,3547,3432,115,3.2
20,203,Wichita,1991,1275,1252,23,1.8
20,205,Wilson,1991,4575,4263,312,6.8
20,207,Woodson,1991,1747,1676,71,4.1
20,209,Wyandotte,1991,78081,71377,6704,8.6
21,1,Adair,1991,7598,6910,688,9.1
21,3,Allen,1991,7106,6471,635,8.9
21,5,Anderson,1991,8352,7919,433,5.2
21,7,Ballard,1991,3769,3435,334,8.9
21,9,Barren,1991,16984,15492,1492,8.8
21,11,Bath,1991,4610,3921,689,14.9
21,13,Bell,1991,10654,9272,1382,13.0
21,15,Boone,1991,32802,31142,1660,5.1
21,17,Bourbon,1991,9416,8971,445,4.7
21,19,Boyd,1991,22854,20698,2156,9.4
21,21,Boyle,1991,12487,11565,922,7.4
21,23,Bracken,1991,3551,3217,334,9.4
21,25,Breathitt,1991,5187,4180,1007,19.4
21,27,Breckinridge,1991,7064,6452,612,8.7
21,29,Bullitt,1991,25690,24357,1333,5.2
21,31,Butler,1991,5416,4863,553,10.2
21,33,Caldwell,1991,6106,5564,542,8.9
21,35,Calloway,1991,15472,14625,847,5.5
21,37,Campbell,1991,42972,40722,2250,5.2
21,39,Carlisle,1991,2611,2350,261,10.0
21,41,Carroll,1991,4081,3824,257,6.3
21,43,Carter,1991,10766,9045,1721,16.0
21,45,Casey,1991,6659,6081,578,8.7
21,47,Christian,1991,23356,21453,1903,8.1
21,49,Clark,1991,14595,13560,1035,7.1
21,51,Clay,1991,6657,6014,643,9.7
21,53,Clinton,1991,4441,4103,338,7.6
21,55,Crittenden,1991,3790,3351,439,11.6
21,57,Cumberland,1991,3015,2802,213,7.1
21,59,Daviess,1991,44556,41382,3174,7.1
21,61,Edmonson,1991,4438,3956,482,10.9
21,63,Elliott,1991,2448,2033,415,17.0
21,65,Estill,1991,5660,4982,678,12.0
21,67,Fayette,1991,126331,121637,4694,3.7
21,69,Fleming,1991,6185,5748,437,7.1
21,71,Floyd,1991,14921,13228,1693,11.3
21,73,Franklin,1991,24363,23327,1036,4.3
21,75,Fulton,1991,3610,3236,374,10.4
21,77,Gallatin,1991,2750,2539,211,7.7
21,79,Garrard,1991,5704,5296,408,7.2
21,81,Grant,1991,7875,7332,543,6.9
21,83,Graves,1991,15946,14278,1668,10.5
21,85,Grayson,1991,9855,9000,855,8.7
21,87,Green,1991,5214,4820,394,7.6
21,89,Greenup,1991,16051,14572,1479,9.2
21,91,Hancock,1991,3625,3217,408,11.3
21,93,Hardin,1991,34421,32032,2389,6.9
21,95,Harlan,1991,11251,9479,1772,15.7
21,97,Harrison,1991,7615,7121,494,6.5
21,99,Hart,1991,7113,6450,663,9.3
21,101,Henderson,1991,22353,20762,1591,7.1
21,103,Henry,1991,7079,6753,326,4.6
21,105,Hickman,1991,2589,2360,229,8.8
21,107,Hopkins,1991,20883,19152,1731,8.3
21,109,Jackson,1991,4478,4014,464,10.4
21,111,Jefferson,1991,349137,328035,21102,6.0
21,113,Jessamine,1991,16708,16000,708,4.2
21,115,Johnson,1991,9275,8315,960,10.4
21,117,Kenton,1991,75335,71597,3738,5.0
21,119,Knott,1991,5492,4794,698,12.7
21,121,Knox,1991,10047,9148,899,8.9
21,123,Larue,1991,5614,5265,349,6.2
21,125,Laurel,1991,18777,17297,1480,7.9
21,127,Lawrence,1991,4685,4006,679,14.5
21,129,Lee,1991,2466,2213,253,10.3
21,131,Leslie,1991,4323,3710,613,14.2
21,133,Letcher,1991,9046,7532,1514,16.7
21,135,Lewis,1991,6045,5192,853,14.1
21,137,Lincoln,1991,9067,8345,722,8.0
21,139,Livingston,1991,4618,4150,468,10.1
21,141,Logan,1991,11780,10892,888,7.5
21,143,Lyon,1991,2770,2504,266,9.6
21,145,McCracken,1991,31356,29431,1925,6.1
21,147,McCreary,1991,5423,4663,760,14.0
21,149,McLean,1991,4376,3841,535,12.2
21,151,Madison,1991,29798,28189,1609,5.4
21,153,Magoffin,1991,4455,3651,804,18.0
21,155,Marion,1991,8018,7406,612,7.6
21,157,Marshall,1991,12907,11730,1177,9.1
21,159,Martin,1991,3550,3191,359,10.1
21,161,Mason,1991,8055,7514,541,6.7
21,163,Meade,1991,8987,8320,667,7.4
21,165,Menifee,1991,2248,1869,379,16.9
21,167,Mercer,1991,9608,9007,601,6.3
21,169,Metcalfe,1991,4447,4101,346,7.8
21,171,Monroe,1991,5106,4705,401,7.9
21,173,Montgomery,1991,10052,8624,1428,14.2
21,175,Morgan,1991,4282,3685,597,13.9
21,177,Muhlenberg,1991,12438,10906,1532,12.3
21,179,Nelson,1991,15545,14460,1085,7.0
21,181,Nicholas,1991,3514,3293,221,6.3
21,183,Ohio,1991,8932,7884,1048,11.7
21,185,Oldham,1991,17918,17290,628,3.5
21,187,Owen,1991,4207,4018,189,4.5
21,189,Owsley,1991,1435,1317,118,8.2
21,191,Pendleton,1991,5883,5459,424,7.2
21,193,Perry,1991,10910,9490,1420,13.0
21,195,Pike,1991,26659,23834,2825,10.6
21,197,Powell,1991,5408,4727,681,12.6
21,199,Pulaski,1991,23227,21084,2143,9.2
21,201,Robertson,1991,927,858,69,7.4
21,203,Rockcastle,1991,6416,5763,653,10.2
21,205,Rowan,1991,9284,8482,802,8.6
21,207,Russell,1991,6932,5743,1189,17.2
21,209,Scott,1991,12973,12362,611,4.7
21,211,Shelby,1991,13631,13083,548,4.0
21,213,Simpson,1991,7718,7150,568,7.4
21,215,Spencer,1991,3733,3572,161,4.3
21,217,Taylor,1991,10892,10252,640,5.9
21,219,Todd,1991,4819,4429,390,8.1
21,221,Trigg,1991,5317,4974,343,6.5
21,223,Trimble,1991,2814,2650,164,5.8
21,225,Union,1991,7307,6656,651,8.9
21,227,Warren,1991,42969,39982,2987,7.0
21,229,Washington,1991,4912,4582,330,6.7
21,231,Wayne,1991,7162,6449,713,10.0
21,233,Webster,1991,5959,5424,535,9.0
21,235,Whitley,1991,12671,11515,1156,9.1
21,237,Wolfe,1991,2804,2448,356,12.7
21,239,Woodford,1991,11353,10919,434,3.8
22,1,Acadia Parish,1991,22202,20634,1568,7.1
22,3,Allen Parish,1991,7915,6926,989,12.5
22,5,Ascension Parish,1991,27695,25766,1929,7.0
22,7,Assumption Parish,1991,9506,8784,722,7.6
22,9,Avoyelles Parish,1991,14354,12501,1853,12.9
22,11,Beauregard Parish,1991,11372,10543,829,7.3
22,13,Bienville Parish,1991,6169,5621,548,8.9
22,15,Bossier Parish,1991,40389,37800,2589,6.4
22,17,Caddo Parish,1991,113484,105613,7871,6.9
22,19,Calcasieu Parish,1991,82024,76035,5989,7.3
22,21,Caldwell Parish,1991,4000,3554,446,11.2
22,23,Cameron Parish,1991,3945,3741,204,5.2
22,25,Catahoula Parish,1991,4543,4053,490,10.8
22,27,Claiborne Parish,1991,6099,5639,460,7.5
22,29,Concordia Parish,1991,8611,7282,1329,15.4
22,31,De Soto Parish,1991,9865,8719,1146,11.6
22,33,East Baton Rouge Parish,1991,198357,187800,10557,5.3
22,35,East Carroll Parish,1991,3427,2835,592,17.3
22,37,East Feliciana Parish,1991,7512,7000,512,6.8
22,39,Evangeline Parish,1991,12404,11344,1060,8.5
22,41,Franklin Parish,1991,9614,8561,1053,11.0
22,43,Grant Parish,1991,6851,6250,601,8.8
22,45,Iberia Parish,1991,29941,28187,1754,5.9
22,47,Iberville Parish,1991,13169,11910,1259,9.6
22,49,Jackson Parish,1991,6516,6171,345,5.3
22,51,Jefferson Parish,1991,233370,217847,15523,6.7
22,53,Jefferson Davis Parish,1991,12681,11608,1073,8.5
22,55,Lafayette Parish,1991,85404,81351,4053,4.7
22,57,Lafourche Parish,1991,37099,35363,1736,4.7
22,59,LaSalle Parish,1991,5884,5419,465,7.9
22,61,Lincoln Parish,1991,18324,17447,877,4.8
22,63,Livingston Parish,1991,34422,31538,2884,8.4
22,65,Madison Parish,1991,4721,4072,649,13.7
22,67,Morehouse Parish,1991,12773,11536,1237,9.7
22,69,Natchitoches Parish,1991,15438,14109,1329,8.6
22,71,Orleans Parish,1991,207774,191262,16512,7.9
22,73,Ouachita Parish,1991,66811,62810,4001,6.0
22,75,Plaquemines Parish,1991,10287,9566,721,7.0
22,77,Pointe Coupee Parish,1991,9167,8139,1028,11.2
22,79,Rapides Parish,1991,56214,52457,3757,6.7
22,81,Red River Parish,1991,3781,3304,477,12.6
22,83,Richland Parish,1991,8464,7508,956,11.3
22,85,Sabine Parish,1991,8736,8145,591,6.8
22,87,St. Bernard Parish,1991,31542,28929,2613,8.3
22,89,St. Charles Parish,1991,20407,18921,1486,7.3
22,91,St. Helena Parish,1991,3717,3448,269,7.2
22,93,St. James Parish,1991,8803,8043,760,8.6
22,95,St. John the Baptist Parish,1991,18731,16809,1922,10.3
22,97,St. Landry Parish,1991,30534,27630,2904,9.5
22,99,St. Martin Parish,1991,19396,18085,1311,6.8
22,101,St. Mary Parish,1991,25394,23433,1961,7.7
22,103,St. Tammany Parish,1991,71648,66695,4953,6.9
22,105,Tangipahoa Parish,1991,36143,32495,3648,10.1
22,107,Tensas Parish,1991,2743,2500,243,8.9
22,109,Terrebonne Parish,1991,41483,39252,2231,5.4
22,111,Union Parish,1991,8704,8040,664,7.6
22,113,Vermilion Parish,1991,19924,18391,1533,7.7
22,115,Vernon Parish,1991,16050,14972,1078,6.7
22,117,Washington Parish,1991,15991,14304,1687,10.5
22,119,Webster Parish,1991,17740,16089,1651,9.3
22,121,West Baton Rouge Parish,1991,9331,8674,657,7.0
22,123,West Carroll Parish,1991,5344,4435,909,17.0
22,125,West Feliciana Parish,1991,4007,3745,262,6.5
22,127,Winn Parish,1991,6012,5619,393,6.5
23,1,Androscoggin,1991,56736,51410,5326,9.4
23,3,Aroostook,1991,40940,36956,3984,9.7
23,5,Cumberland,1991,132224,124125,8099,6.1
23,7,Franklin,1991,14887,13572,1315,8.8
23,9,Hancock,1991,25412,23594,1818,7.2
23,11,Kennebec,1991,61056,56689,4367,7.2
23,13,Knox,1991,18539,17285,1254,6.8
23,15,Lincoln,1991,15701,14818,883,5.6
23,17,Oxford,1991,25550,23055,2495,9.8
23,19,Penobscot,1991,74956,68882,6074,8.1
23,21,Piscataquis,1991,8824,7976,848,9.6
23,23,Sagadahoc,1991,16434,15511,923,5.6
23,25,Somerset,1991,25628,22957,2671,10.4
23,27,Waldo,1991,16684,15069,1615,9.7
23,29,Washington,1991,16386,14709,1677,10.2
23,31,York,1991,90491,84071,6420,7.1
24,1,Allegany,1991,32926,28974,3952,12.0
24,3,Anne Arundel,1991,231744,220336,11408,4.9
24,5,Baltimore,1991,381526,358192,23334,6.1
24,9,Calvert,1991,29537,27771,1766,6.0
24,11,Caroline,1991,14100,13100,1000,7.1
24,13,Carroll,1991,69627,65782,3845,5.5
24,15,Cecil,1991,36545,32345,4200,11.5
24,17,Charles,1991,55243,52841,2402,4.3
24,19,Dorchester,1991,15772,14273,1499,9.5
24,21,Frederick,1991,86275,81543,4732,5.5
24,23,Garrett,1991,13499,11849,1650,12.2
24,25,Harford,1991,99834,93857,5977,6.0
24,27,Howard,1991,114694,110505,4189,3.7
24,29,Kent,1991,9495,8831,664,7.0
24,31,Montgomery,1991,442429,428258,14171,3.2
24,33,Prince George's,1991,431026,410201,20825,4.8
24,35,Queen Anne's,1991,18259,17281,978,5.4
24,37,St. Mary's,1991,40034,37860,2174,5.4
24,39,Somerset,1991,11051,9646,1405,12.7
24,41,Talbot,1991,16520,15771,749,4.5
24,43,Washington,1991,62914,57486,5428,8.6
24,45,Wicomico,1991,44592,41254,3338,7.5
24,47,Worcester,1991,22301,20156,2145,9.6
24,510,Baltimore city,1991,336276,302743,33533,10.0
25,1,Barnstable,1991,97293,87280,10013,10.3
25,3,Berkshire,1991,69383,61826,7557,10.9
25,5,Bristol,1991,264424,231253,33171,12.5
25,7,Dukes,1991,7821,7259,562,7.2
25,9,Essex,1991,347379,316089,31290,9.0
25,11,Franklin,1991,37543,34588,2955,7.9
25,13,Hampden,1991,220810,199289,21521,9.7
25,15,Hampshire,1991,78373,72799,5574,7.1
25,17,Middlesex,1991,786378,729979,56399,7.2
25,19,Nantucket/town,1991,4836,4568,268,5.5
25,21,Norfolk,1991,340450,315653,24797,7.3
25,23,Plymouth,1991,228096,205135,22961,10.1
25,25,Suffolk,1991,340108,310672,29436,8.7
25,27,Worcester,1991,361413,326115,35298,9.8
26,1,Alcona,1991,3925,3359,566,14.4
26,3,Alger,1991,3888,3475,413,10.6
26,5,Allegan,1991,45260,42089,3171,7.0
26,7,Alpena,1991,14404,12652,1752,12.2
26,9,Antrim,1991,8858,7752,1106,12.5
26,11,Arenac,1991,6126,5501,625,10.2
26,13,Baraga,1991,3246,2798,448,13.8
26,15,Barry,1991,25401,23431,1970,7.8
26,17,Bay,1991,53260,48627,4633,8.7
26,19,Benzie,1991,6128,5302,826,13.5
26,21,Berrien,1991,79781,72861,6920,8.7
26,23,Branch,1991,19247,17809,1438,7.5
26,25,Calhoun,1991,63796,58970,4826,7.6
26,27,Cass,1991,24088,21885,2203,9.1
26,29,Charlevoix,1991,11630,10431,1199,10.3
26,31,Cheboygan,1991,10408,8866,1542,14.8
26,33,Chippewa,1991,14828,13090,1738,11.7
26,35,Clare,1991,9448,8294,1154,12.2
26,37,Clinton,1991,31367,28984,2383,7.6
26,39,Crawford,1991,5575,5096,479,8.6
26,41,Delta,1991,17313,15246,2067,11.9
26,43,Dickinson,1991,12740,11563,1177,9.2
26,45,Eaton,1991,51232,47583,3649,7.1
26,47,Emmet,1991,14570,12869,1701,11.7
26,49,Genesee,1991,199063,175092,23971,12.0
26,51,Gladwin,1991,8140,7136,1004,12.3
26,53,Gogebic,1991,7437,6794,643,8.6
26,55,Grand Traverse,1991,36355,33461,2894,8.0
26,57,Gratiot,1991,18309,16323,1986,10.8
26,59,Hillsdale,1991,20317,18199,2118,10.4
26,61,Houghton,1991,14593,13354,1239,8.5
26,63,Huron,1991,15812,13855,1957,12.4
26,65,Ingham,1991,147824,137425,10399,7.0
26,67,Ionia,1991,26673,23707,2966,11.1
26,69,Iosco,1991,11232,10133,1099,9.8
26,71,Iron,1991,5289,4724,565,10.7
26,73,Isabella,1991,25445,23590,1855,7.3
26,75,Jackson,1991,69979,63758,6221,8.9
26,77,Kalamazoo,1991,117986,110919,7067,6.0
26,79,Kalkaska,1991,6332,5576,756,11.9
26,81,Kent,1991,268309,248679,19630,7.3
26,83,Keweenaw,1991,620,508,112,18.1
26,85,Lake,1991,2788,2421,367,13.2
26,87,Lapeer,1991,38437,33412,5025,13.1
26,89,Leelanau,1991,8858,8177,681,7.7
26,91,Lenawee,1991,44255,40061,4194,9.5
26,93,Livingston,1991,63638,58991,4647,7.3
26,95,Luce,1991,2434,2111,323,13.3
26,97,Mackinac,1991,6330,5377,953,15.1
26,99,Macomb,1991,395418,357190,38228,9.7
26,101,Manistee,1991,9365,8200,1165,12.4
26,103,Marquette,1991,32169,29597,2572,8.0
26,105,Mason,1991,12625,11323,1302,10.3
26,107,Mecosta,1991,16429,14946,1483,9.0
26,109,Menominee,1991,12044,11032,1012,8.4
26,111,Midland,1991,37754,35390,2364,6.3
26,113,Missaukee,1991,5381,4785,596,11.1
26,115,Monroe,1991,66778,59971,6807,10.2
26,117,Montcalm,1991,22712,19584,3128,13.8
26,119,Montmorency,1991,3178,2615,563,17.7
26,121,Muskegon,1991,73215,65435,7780,10.6
26,123,Newaygo,1991,17821,15731,2090,11.7
26,125,Oakland,1991,604297,558581,45716,7.6
26,127,Oceana,1991,11137,9782,1355,12.2
26,129,Ogemaw,1991,7182,6382,800,11.1
26,131,Ontonagon,1991,3918,3660,258,6.6
26,133,Osceola,1991,8930,7839,1091,12.2
26,135,Oscoda,1991,2989,2691,298,10.0
26,137,Otsego,1991,9681,8817,864,8.9
26,139,Ottawa,1991,104462,98002,6460,6.2
26,141,Presque Isle,1991,6178,5264,914,14.8
26,143,Roscommon,1991,6963,6237,726,10.4
26,145,Saginaw,1991,96570,88514,8056,8.3
26,147,St. Clair,1991,73297,64667,8630,11.8
26,149,St. Joseph,1991,28712,25702,3010,10.5
26,151,Sanilac,1991,18293,15854,2439,13.3
26,153,Schoolcraft,1991,3750,3230,520,13.9
26,155,Shiawassee,1991,34251,29982,4269,12.5
26,157,Tuscola,1991,25633,22582,3051,11.9
26,159,Van Buren,1991,33726,30368,3358,10.0
26,161,Washtenaw,1991,156651,147663,8988,5.7
26,163,Wayne,1991,940119,835559,104560,11.1
26,165,Wexford,1991,12312,10737,1575,12.8
27,1,Aitkin,1991,5312,4718,594,11.2
27,3,Anoka,1991,148881,141521,7360,4.9
27,5,Becker,1991,12770,11798,972,7.6
27,7,Beltrami,1991,16278,14999,1279,7.9
27,9,Benton,1991,17593,16531,1062,6.0
27,11,Big Stone,1991,2872,2728,144,5.0
27,13,Blue Earth,1991,30357,29220,1137,3.7
27,15,Brown,1991,14330,13699,631,4.4
27,17,Carlton,1991,13778,12665,1113,8.1
27,19,Carver,1991,29201,28041,1160,4.0
27,21,Cass,1991,9540,8635,905,9.5
27,23,Chippewa,1991,6341,5985,356,5.6
27,25,Chisago,1991,15965,14827,1138,7.1
27,27,Clay,1991,27415,26141,1274,4.6
27,29,Clearwater,1991,3677,3039,638,17.4
27,31,Cook,1991,2399,2237,162,6.8
27,33,Cottonwood,1991,5807,5452,355,6.1
27,35,Crow Wing,1991,22199,20605,1594,7.2
27,37,Dakota,1991,171379,164249,7130,4.2
27,39,Dodge,1991,8032,7543,489,6.1
27,41,Douglas,1991,14507,13722,785,5.4
27,43,Faribault,1991,8196,7690,506,6.2
27,45,Fillmore,1991,10150,9601,549,5.4
27,47,Freeborn,1991,16973,15987,986,5.8
27,49,Goodhue,1991,21936,21058,878,4.0
27,51,Grant,1991,2844,2661,183,6.4
27,53,Hennepin,1991,617190,590522,26668,4.3
27,55,Houston,1991,9983,9561,422,4.2
27,57,Hubbard,1991,6894,6276,618,9.0
27,59,Isanti,1991,13501,12553,948,7.0
27,61,Itasca,1991,18538,16670,1868,10.1
27,63,Jackson,1991,5444,5184,260,4.8
27,65,Kanabec,1991,6715,6033,682,10.2
27,67,Kandiyohi,1991,19468,18503,965,5.0
27,69,Kittson,1991,2546,2347,199,7.8
27,71,Koochiching,1991,6790,5929,861,12.7
27,73,Lac qui Parle,1991,3949,3809,140,3.5
27,75,Lake,1991,5297,4835,462,8.7
27,77,Lake of the Woods,1991,2162,2085,77,3.6
27,79,Le Sueur,1991,12378,11565,813,6.6
27,81,Lincoln,1991,3159,3033,126,4.0
27,83,Lyon,1991,13572,13058,514,3.8
27,85,McLeod,1991,18485,17653,832,4.5
27,87,Mahnomen,1991,1898,1681,217,11.4
27,89,Marshall,1991,4836,4177,659,13.6
27,91,Martin,1991,11832,11094,738,6.2
27,93,Meeker,1991,10163,9272,891,8.8
27,95,Mille Lacs,1991,9019,8210,809,9.0
27,97,Morrison,1991,13974,12589,1385,9.9
27,99,Mower,1991,18068,17385,683,3.8
27,101,Murray,1991,4414,4207,207,4.7
27,103,Nicollet,1991,16064,15503,561,3.5
27,105,Nobles,1991,9859,9518,341,3.5
27,107,Norman,1991,3527,3283,244,6.9
27,109,Olmsted,1991,63914,62110,1804,2.8
27,111,Otter Tail,1991,24735,23147,1588,6.4
27,113,Pennington,1991,6942,6210,732,10.5
27,115,Pine,1991,9392,8328,1064,11.3
27,117,Pipestone,1991,4837,4604,233,4.8
27,119,Polk,1991,15575,14634,941,6.0
27,121,Pope,1991,4883,4603,280,5.7
27,123,Ramsey,1991,271001,259158,11843,4.4
27,125,Red Lake,1991,2065,1758,307,14.9
27,127,Redwood,1991,9345,9079,266,2.8
27,129,Renville,1991,8292,7830,462,5.6
27,131,Rice,1991,27911,26446,1465,5.2
27,133,Rock,1991,4743,4615,128,2.7
27,135,Roseau,1991,8353,7771,582,7.0
27,137,St. Louis,1991,96811,90083,6728,6.9
27,139,Scott,1991,34614,32874,1740,5.0
27,141,Sherburne,1991,23360,21962,1398,6.0
27,143,Sibley,1991,6840,6459,381,5.6
27,145,Stearns,1991,67857,64023,3834,5.7
27,147,Steele,1991,16864,16050,814,4.8
27,149,Stevens,1991,5120,4896,224,4.4
27,151,Swift,1991,4686,4418,268,5.7
27,153,Todd,1991,10266,9413,853,8.3
27,155,Traverse,1991,1814,1723,91,5.0
27,157,Wabasha,1991,10437,9900,537,5.1
27,159,Wadena,1991,5828,5396,432,7.4
27,161,Waseca,1991,9313,8881,432,4.6
27,163,Washington,1991,85870,82234,3636,4.2
27,165,Watonwan,1991,5752,5479,273,4.7
27,167,Wilkin,1991,3573,3393,180,5.0
27,169,Winona,1991,26685,25117,1568,5.9
27,171,Wright,1991,38457,36063,2394,6.2
27,173,Yellow Medicine,1991,5381,5123,258,4.8
28,1,Adams,1991,15059,13508,1551,10.3
28,3,Alcorn,1991,15644,14016,1628,10.4
28,5,Amite,1991,5040,4702,338,6.7
28,7,Attala,1991,8009,7014,995,12.4
28,9,Benton,1991,3181,2815,366,11.5
28,11,Bolivar,1991,17386,15885,1501,8.6
28,13,Calhoun,1991,7015,6483,532,7.6
28,15,Carroll,1991,4079,3680,399,9.8
28,17,Chickasaw,1991,9313,8206,1107,11.9
28,19,Choctaw,1991,3572,3161,411,11.5
28,21,Claiborne,1991,3763,3063,700,18.6
28,23,Clarke,1991,8271,7660,611,7.4
28,25,Clay,1991,9810,8802,1008,10.3
28,27,Coahoma,1991,11808,10469,1339,11.3
28,29,Copiah,1991,11293,10024,1269,11.2
28,31,Covington,1991,7546,6739,807,10.7
28,33,DeSoto,1991,38041,35734,2307,6.1
28,35,Forrest,1991,31206,29110,2096,6.7
28,37,Franklin,1991,3180,2825,355,11.2
28,39,George,1991,7280,6388,892,12.3
28,41,Greene,1991,4581,4052,529,11.5
28,43,Grenada,1991,9819,8904,915,9.3
28,45,Hancock,1991,13040,12153,887,6.8
28,47,Harrison,1991,72639,67702,4937,6.8
28,49,Hinds,1991,127284,119478,7806,6.1
28,51,Holmes,1991,6875,5948,927,13.5
28,53,Humphreys,1991,5297,4796,501,9.5
28,55,Issaquena,1991,863,747,116,13.4
28,57,Itawamba,1991,10608,9617,991,9.3
28,59,Jackson,1991,56184,52384,3800,6.8
28,61,Jasper,1991,7084,6357,727,10.3
28,63,Jefferson,1991,2810,2012,798,28.4
28,65,Jefferson Davis,1991,5486,4594,892,16.3
28,67,Jones,1991,27990,25776,2214,7.9
28,69,Kemper,1991,4279,3859,420,9.8
28,71,Lafayette,1991,15327,14582,745,4.9
28,73,Lamar,1991,14330,13606,724,5.1
28,75,Lauderdale,1991,35124,32394,2730,7.8
28,77,Lawrence,1991,5302,4749,553,10.4
28,79,Leake,1991,8359,7620,739,8.8
28,81,Lee,1991,35343,32602,2741,7.8
28,83,Leflore,1991,15507,13575,1932,12.5
28,85,Lincoln,1991,13124,11747,1377,10.5
28,87,Lowndes,1991,27729,25408,2321,8.4
28,89,Madison,1991,27528,25774,1754,6.4
28,91,Marion,1991,10090,9050,1040,10.3
28,93,Marshall,1991,13609,11884,1725,12.7
28,95,Monroe,1991,17277,15617,1660,9.6
28,97,Montgomery,1991,5469,4885,584,10.7
28,99,Neshoba,1991,12233,11320,913,7.5
28,101,Newton,1991,9082,8552,530,5.8
28,103,Noxubee,1991,4665,4119,546,11.7
28,105,Oktibbeha,1991,18114,17071,1043,5.8
28,107,Panola,1991,13495,12006,1489,11.0
28,109,Pearl River,1991,16753,15337,1416,8.5
28,111,Perry,1991,4131,3588,543,13.1
28,113,Pike,1991,15289,13797,1492,9.8
28,115,Pontotoc,1991,11649,10840,809,6.9
28,117,Prentiss,1991,11787,10518,1269,10.8
28,119,Quitman,1991,4081,3563,518,12.7
28,121,Rankin,1991,47194,45138,2056,4.4
28,123,Scott,1991,12329,11562,767,6.2
28,125,Sharkey,1991,3020,2613,407,13.5
28,127,Simpson,1991,10251,9559,692,6.8
28,129,Smith,1991,6365,5922,443,7.0
28,131,Stone,1991,4945,4546,399,8.1
28,133,Sunflower,1991,12269,10917,1352,11.0
28,135,Tallahatchie,1991,6041,5280,761,12.6
28,137,Tate,1991,10372,9363,1009,9.7
28,139,Tippah,1991,9550,8408,1142,12.0
28,141,Tishomingo,1991,9931,8906,1025,10.3
28,143,Tunica,1991,2954,2519,435,14.7
28,145,Union,1991,11364,10492,872,7.7
28,147,Walthall,1991,5538,5057,481,8.7
28,149,Warren,1991,22589,20769,1820,8.1
28,151,Washington,1991,28638,25415,3223,11.3
28,153,Wayne,1991,8970,7815,1155,12.9
28,155,Webster,1991,4335,3877,458,10.6
28,157,Wilkinson,1991,3512,3025,487,13.9
28,159,Winston,1991,8439,7352,1087,12.9
28,161,Yalobusha,1991,5161,4605,556,10.8
28,163,Yazoo,1991,9401,8598,803,8.5
29,1,Adair,1991,12924,12378,546,4.2
29,3,Andrew,1991,7603,7102,501,6.6
29,5,Atchison,1991,3258,3149,109,3.3
29,7,Audrain,1991,11428,10781,647,5.7
29,9,Barry,1991,13122,12356,766,5.8
29,11,Barton,1991,5795,5592,203,3.5
29,13,Bates,1991,7014,6516,498,7.1
29,15,Benton,1991,5636,5106,530,9.4
29,17,Bollinger,1991,4756,4233,523,11.0
29,19,Boone,1991,69096,67031,2065,3.0
29,21,Buchanan,1991,41395,37925,3470,8.4
29,23,Butler,1991,17344,15795,1549,8.9
29,25,Caldwell,1991,3577,3294,283,7.9
29,27,Callaway,1991,17606,16711,895,5.1
29,29,Camden,1991,13250,11990,1260,9.5
29,31,Cape Girardeau,1991,32601,30769,1832,5.6
29,33,Carroll,1991,4967,4600,367,7.4
29,35,Carter,1991,2267,2010,257,11.3
29,37,Cass,1991,35100,33028,2072,5.9
29,39,Cedar,1991,5173,4839,334,6.5
29,41,Chariton,1991,4466,4080,386,8.6
29,43,Christian,1991,18322,17290,1032,5.6
29,45,Clark,1991,3686,3449,237,6.4
29,47,Clay,1991,89977,85277,4700,5.2
29,49,Clinton,1991,8182,7757,425,5.2
29,51,Cole,1991,34542,33166,1376,4.0
29,53,Cooper,1991,7893,7538,355,4.5
29,55,Crawford,1991,9142,8096,1046,11.4
29,57,Dade,1991,3023,2833,190,6.3
29,59,Dallas,1991,5686,5166,520,9.1
29,61,Daviess,1991,3321,3075,246,7.4
29,63,DeKalb,1991,3714,3455,259,7.0
29,65,Dent,1991,5706,5186,520,9.1
29,67,Douglas,1991,5246,4845,401,7.6
29,69,Dunklin,1991,12747,11522,1225,9.6
29,71,Franklin,1991,43170,39035,4135,9.6
29,73,Gasconade,1991,7168,6689,479,6.7
29,75,Gentry,1991,3220,3109,111,3.4
29,77,Greene,1991,111500,105963,5537,5.0
29,79,Grundy,1991,4811,4565,246,5.1
29,81,Harrison,1991,4003,3814,189,4.7
29,83,Henry,1991,9212,8459,753,8.2
29,85,Hickory,1991,2600,2365,235,9.0
29,87,Holt,1991,2674,2537,137,5.1
29,89,Howard,1991,4625,4417,208,4.5
29,91,Howell,1991,14863,13797,1066,7.2
29,93,Iron,1991,4090,3550,540,13.2
29,95,Jackson,1991,338969,317634,21335,6.3
29,97,Jasper,1991,45918,43383,2535,5.5
29,99,Jefferson,1991,93395,85680,7715,8.3
29,101,Johnson,1991,20883,19746,1137,5.4
29,103,Knox,1991,1910,1817,93,4.9
29,105,Laclede,1991,12797,11283,1514,11.8
29,107,Lafayette,1991,15198,14255,943,6.2
29,109,Lawrence,1991,14663,13838,825,5.6
29,111,Lewis,1991,4865,4491,374,7.7
29,113,Lincoln,1991,14893,13752,1141,7.7
29,115,Linn,1991,6543,6010,533,8.1
29,117,Livingston,1991,6693,6377,316,4.7
29,119,McDonald,1991,6904,6459,445,6.4
29,121,Macon,1991,7225,6712,513,7.1
29,123,Madison,1991,4708,4106,602,12.8
29,125,Maries,1991,4083,3801,282,6.9
29,127,Marion,1991,14048,13131,917,6.5
29,129,Mercer,1991,1513,1440,73,4.8
29,131,Miller,1991,10204,9100,1104,10.8
29,133,Mississippi,1991,6083,5455,628,10.3
29,135,Moniteau,1991,6414,6032,382,6.0
29,137,Monroe,1991,4133,3864,269,6.5
29,139,Montgomery,1991,5447,5054,393,7.2
29,141,Morgan,1991,7206,6645,561,7.8
29,143,New Madrid,1991,8472,7639,833,9.8
29,145,Newton,1991,23269,21724,1545,6.6
29,147,Nodaway,1991,11940,11551,389,3.3
29,149,Oregon,1991,3877,3613,264,6.8
29,151,Osage,1991,6556,6240,316,4.8
29,153,Ozark,1991,3596,3348,248,6.9
29,155,Pemiscot,1991,8226,7340,886,10.8
29,157,Perry,1991,9241,8721,520,5.6
29,159,Pettis,1991,18129,16777,1352,7.5
29,161,Phelps,1991,17339,16247,1092,6.3
29,163,Pike,1991,7112,6566,546,7.7
29,165,Platte,1991,35449,33886,1563,4.4
29,167,Polk,1991,10119,9421,698,6.9
29,169,Pulaski,1991,12928,11847,1081,8.4
29,171,Putnam,1991,2004,1934,70,3.5
29,173,Ralls,1991,4486,4240,246,5.5
29,175,Randolph,1991,10344,9461,883,8.5
29,177,Ray,1991,10369,9554,815,7.9
29,179,Reynolds,1991,2820,2574,246,8.7
29,181,Ripley,1991,4349,3928,421,9.7
29,183,St. Charles,1991,125465,118034,7431,5.9
29,185,St. Clair,1991,3553,3297,256,7.2
29,186,Ste. Genevieve,1991,7945,7363,582,7.3
29,187,St. Francois,1991,20646,18315,2331,11.3
29,189,St. Louis,1991,547412,518712,28700,5.2
29,195,Saline,1991,11139,10357,782,7.0
29,197,Schuyler,1991,2107,1991,116,5.5
29,199,Scotland,1991,2207,2137,70,3.2
29,201,Scott,1991,18672,17091,1581,8.5
29,203,Shannon,1991,3555,3199,356,10.0
29,205,Shelby,1991,3155,3004,151,4.8
29,207,Stoddard,1991,13374,12067,1307,9.8
29,209,Stone,1991,9720,8723,997,10.3
29,211,Sullivan,1991,2817,2717,100,3.5
29,213,Taney,1991,15599,13953,1646,10.6
29,215,Texas,1991,9484,8559,925,9.8
29,217,Vernon,1991,8710,8240,470,5.4
29,219,Warren,1991,10232,9439,793,7.8
29,221,Washington,1991,8249,6997,1252,15.2
29,223,Wayne,1991,4319,3660,659,15.3
29,225,Webster,1991,11224,10415,809,7.2
29,227,Worth,1991,991,930,61,6.2
29,229,Wright,1991,7326,6512,814,11.1
29,510,St. Louis city,1991,178750,162217,16533,9.2
30,1,Beaverhead,1991,4360,4082,278,6.4
30,3,Big Horn,1991,4660,4140,520,11.2
30,5,Blaine,1991,2813,2571,242,8.6
30,7,Broadwater,1991,1720,1637,83,4.8
30,9,Carbon,1991,3765,3521,244,6.5
30,11,Carter,1991,872,853,19,2.2
30,13,Cascade,1991,35992,33843,2149,6.0
30,15,Chouteau,1991,2606,2519,87,3.3
30,17,Custer,1991,5802,5493,309,5.3
30,19,Daniels,1991,1090,1060,30,2.8
30,21,Dawson,1991,4728,4538,190,4.0
30,23,Deer Lodge,1991,4014,3581,433,10.8
30,25,Fallon,1991,1531,1477,54,3.5
30,27,Fergus,1991,5778,5352,426,7.4
30,29,Flathead,1991,30737,27976,2761,9.0
30,31,Gallatin,1991,29754,28179,1575,5.3
30,33,Garfield,1991,883,869,14,1.6
30,35,Glacier,1991,5356,4758,598,11.2
30,37,Golden Valley,1991,457,410,47,10.3
30,39,Granite,1991,1203,1095,108,9.0
30,41,Hill,1991,8287,7742,545,6.6
30,43,Jefferson,1991,4120,3874,246,6.0
30,45,Judith Basin,1991,1118,1072,46,4.1
30,47,Lake,1991,9562,8704,858,9.0
30,49,Lewis and Clark,1991,25491,24072,1419,5.6
30,51,Liberty,1991,917,899,18,2.0
30,53,Lincoln,1991,8299,6954,1345,16.2
30,55,McCone,1991,1129,1087,42,3.7
30,57,Madison,1991,3303,3151,152,4.6
30,59,Meagher,1991,902,859,43,4.8
30,61,Mineral,1991,1766,1578,188,10.6
30,63,Missoula,1991,42996,39795,3201,7.4
30,65,Musselshell,1991,1764,1629,135,7.7
30,67,Park,1991,8022,7509,513,6.4
30,69,Petroleum,1991,286,271,15,5.2
30,71,Phillips,1991,2450,2334,116,4.7
30,73,Pondera,1991,2884,2776,108,3.7
30,75,Powder River,1991,1178,1145,33,2.8
30,77,Powell,1991,2645,2474,171,6.5
30,79,Prairie,1991,654,629,25,3.8
30,81,Ravalli,1991,12129,10843,1286,10.6
30,83,Richland,1991,5294,4912,382,7.2
30,85,Roosevelt,1991,4408,3932,476,10.8
30,87,Rosebud,1991,5132,4757,375,7.3
30,89,Sanders,1991,3663,3109,554,15.1
30,91,Sheridan,1991,1994,1946,48,2.4
30,93,Silver Bow,1991,15894,14624,1270,8.0
30,95,Stillwater,1991,3175,2907,268,8.4
30,97,Sweet Grass,1991,1529,1469,60,3.9
30,99,Teton,1991,2911,2793,118,4.1
30,101,Toole,1991,2580,2472,108,4.2
30,103,Treasure,1991,483,465,18,3.7
30,105,Valley,1991,4173,3954,219,5.2
30,107,Wheatland,1991,1115,1054,61,5.5
30,109,Wibaux,1991,518,485,33,6.4
30,111,Yellowstone,1991,61972,58668,3304,5.3
31,1,Adams,1991,15200,14888,312,2.1
31,3,Antelope,1991,3388,3316,72,2.1
31,5,Arthur,1991,222,217,5,2.3
31,7,Banner,1991,410,403,7,1.7
31,9,Blaine,1991,384,370,14,3.6
31,11,Boone,1991,3028,2989,39,1.3
31,13,Box Butte,1991,6216,5982,234,3.8
31,15,Boyd,1991,1217,1199,18,1.5
31,17,Brown,1991,1709,1664,45,2.6
31,19,Buffalo,1991,21162,20575,587,2.8
31,21,Burt,1991,3582,3454,128,3.6
31,23,Butler,1991,4051,3928,123,3.0
31,25,Cass,1991,10706,10338,368,3.4
31,27,Cedar,1991,4942,4847,95,1.9
31,29,Chase,1991,1973,1936,37,1.9
31,31,Cherry,1991,3267,3220,47,1.4
31,33,Cheyenne,1991,5048,4955,93,1.8
31,35,Clay,1991,3299,3238,61,1.8
31,37,Colfax,1991,4541,4454,87,1.9
31,39,Cuming,1991,5127,5052,75,1.5
31,41,Custer,1991,5825,5711,114,2.0
31,43,Dakota,1991,8922,8597,325,3.6
31,45,Dawes,1991,4182,4036,146,3.5
31,47,Dawson,1991,12217,11885,332,2.7
31,49,Deuel,1991,1059,1036,23,2.2
31,51,Dixon,1991,3127,3054,73,2.3
31,53,Dodge,1991,17885,17309,576,3.2
31,55,Douglas,1991,228505,221579,6926,3.0
31,57,Dundy,1991,1282,1267,15,1.2
31,59,Fillmore,1991,3390,3327,63,1.9
31,61,Franklin,1991,1721,1695,26,1.5
31,63,Frontier,1991,1502,1478,24,1.6
31,65,Furnas,1991,2514,2479,35,1.4
31,67,Gage,1991,11825,11593,232,2.0
31,69,Garden,1991,1156,1137,19,1.6
31,71,Garfield,1991,1076,1043,33,3.1
31,73,Gosper,1991,1212,1195,17,1.4
31,75,Grant,1991,392,384,8,2.0
31,77,Greeley,1991,1527,1492,35,2.3
31,79,Hall,1991,28073,27338,735,2.6
31,81,Hamilton,1991,4834,4750,84,1.7
31,83,Harlan,1991,1770,1744,26,1.5
31,85,Hayes,1991,502,493,9,1.8
31,87,Hitchcock,1991,1648,1612,36,2.2
31,89,Holt,1991,6119,6000,119,1.9
31,91,Hooker,1991,368,361,7,1.9
31,93,Howard,1991,3117,3040,77,2.5
31,95,Jefferson,1991,4257,4174,83,1.9
31,97,Johnson,1991,2335,2282,53,2.3
31,99,Kearney,1991,3233,3173,60,1.9
31,101,Keith,1991,4531,4400,131,2.9
31,103,Keya Paha,1991,504,494,10,2.0
31,105,Kimball,1991,2060,2026,34,1.7
31,107,Knox,1991,4385,4253,132,3.0
31,109,Lancaster,1991,126410,123395,3015,2.4
31,111,Lincoln,1991,17007,16505,502,3.0
31,113,Logan,1991,432,424,8,1.9
31,115,Loup,1991,464,456,8,1.7
31,117,McPherson,1991,304,299,5,1.6
31,119,Madison,1991,17406,16994,412,2.4
31,121,Merrick,1991,4338,4243,95,2.2
31,123,Morrill,1991,2751,2661,90,3.3
31,125,Nance,1991,2046,2001,45,2.2
31,127,Nemaha,1991,3581,3421,160,4.5
31,129,Nuckolls,1991,2548,2509,39,1.5
31,131,Otoe,1991,7229,7006,223,3.1
31,133,Pawnee,1991,1591,1558,33,2.1
31,135,Perkins,1991,1415,1386,29,2.0
31,137,Phelps,1991,5183,5111,72,1.4
31,139,Pierce,1991,3685,3599,86,2.3
31,141,Platte,1991,15900,15507,393,2.5
31,143,Polk,1991,2646,2598,48,1.8
31,145,Red Willow,1991,5760,5644,116,2.0
31,147,Richardson,1991,4635,4423,212,4.6
31,149,Rock,1991,993,966,27,2.7
31,151,Saline,1991,6596,6497,99,1.5
31,153,Sarpy,1991,50012,48797,1215,2.4
31,155,Saunders,1991,9717,9450,267,2.7
31,157,Scotts Bluff,1991,18101,17353,748,4.1
31,159,Seward,1991,8850,8639,211,2.4
31,161,Sheridan,1991,3114,3045,69,2.2
31,163,Sherman,1991,1612,1556,56,3.5
31,165,Sioux,1991,793,784,9,1.1
31,167,Stanton,1991,3100,3035,65,2.1
31,169,Thayer,1991,3220,3173,47,1.5
31,171,Thomas,1991,423,405,18,4.3
31,173,Thurston,1991,2566,2350,216,8.4
31,175,Valley,1991,2819,2762,57,2.0
31,177,Washington,1991,9159,8908,251,2.7
31,179,Wayne,1991,5274,5132,142,2.7
31,181,Webster,1991,1803,1772,31,1.7
31,183,Wheeler,1991,444,437,7,1.6
31,185,York,1991,8314,8175,139,1.7
32,1,Churchill,1991,7840,7310,530,6.8
32,3,Clark,1991,441583,414776,26807,6.1
32,5,Douglas,1991,15510,14626,884,5.7
32,7,Elko,1991,18247,17360,887,4.9
32,9,Esmeralda,1991,698,669,29,4.2
32,11,Eureka,1991,874,835,39,4.5
32,13,Humboldt,1991,7490,7128,362,4.8
32,15,Lander,1991,3044,2866,178,5.8
32,17,Lincoln,1991,1499,1377,122,8.1
32,19,Lyon,1991,9683,8970,713,7.4
32,21,Mineral,1991,2973,2809,164,5.5
32,23,Nye,1991,9340,8949,391,4.2
32,27,Pershing,1991,2057,1969,88,4.3
32,29,Storey,1991,1430,1387,43,3.0
32,31,Washoe,1991,152898,144777,8121,5.3
32,33,White Pine,1991,3842,3487,355,9.2
32,510,Carson City,1991,21042,19527,1515,7.2
33,1,Belknap,1991,26736,24715,2021,7.6
33,3,Carroll,1991,19072,17906,1166,6.1
33,5,Cheshire,1991,38681,36544,2137,5.5
33,7,Coos,1991,17656,16272,1384,7.8
33,9,Grafton,1991,40975,38286,2689,6.6
33,11,Hillsborough,1991,191553,178876,12677,6.6
33,13,Merrimack,1991,66181,62030,4151,6.3
33,15,Rockingham,1991,140167,129814,10353,7.4
33,17,Strafford,1991,58592,54544,4048,6.9
33,19,Sullivan,1991,20114,18643,1471,7.3
34,1,Atlantic,1991,124033,113009,11024,8.9
34,3,Bergen,1991,441705,417745,23960,5.4
34,5,Burlington,1991,210415,197184,13231,6.3
34,7,Camden,1991,260446,240106,20340,7.8
34,9,Cape May,1991,45111,40446,4665,10.3
34,11,Cumberland,1991,66818,60021,6797,10.2
34,13,Essex,1991,381057,349626,31431,8.2
34,15,Gloucester,1991,124138,114706,9432,7.6
34,17,Hudson,1991,286917,261683,25234,8.8
34,19,Hunterdon,1991,60162,57856,2306,3.8
34,21,Mercer,1991,173258,163363,9895,5.7
34,23,Middlesex,1991,377164,355070,22094,5.9
34,25,Monmouth,1991,290099,272972,17127,5.9
34,27,Morris,1991,239360,227579,11781,4.9
34,29,Ocean,1991,193688,180244,13444,6.9
34,31,Passaic,1991,235101,215673,19428,8.3
34,33,Salem,1991,32098,29770,2328,7.3
34,35,Somerset,1991,142252,136564,5688,4.0
34,37,Sussex,1991,70420,66097,4323,6.1
34,39,Union,1991,261496,243052,18444,7.1
34,41,Warren,1991,47737,44791,2946,6.2
35,1,Bernalillo,1991,253439,238808,14631,5.8
35,3,Catron,1991,1174,1013,161,13.7
35,5,Chaves,1991,25333,22676,2657,10.5
35,6,Cibola,1991,9211,7930,1281,13.9
35,7,Colfax,1991,5968,5395,573,9.6
35,9,Curry,1991,18373,17314,1059,5.8
35,11,De Baca,1991,921,851,70,7.6
35,13,Dona Ana,1991,59887,54930,4957,8.3
35,15,Eddy,1991,22495,20968,1527,6.8
35,17,Grant,1991,11272,10345,927,8.2
35,19,Guadalupe,1991,1787,1589,198,11.1
35,21,Harding,1991,461,433,28,6.1
35,23,Hidalgo,1991,2671,2537,134,5.0
35,25,Lea,1991,24051,22938,1113,4.6
35,27,Lincoln,1991,6145,5702,443,7.2
35,28,Los Alamos,1991,10834,10673,161,1.5
35,29,Luna,1991,8073,6853,1220,15.1
35,31,McKinley,1991,22771,20618,2153,9.5
35,33,Mora,1991,1553,1158,395,25.4
35,35,Otero,1991,19948,18236,1712,8.6
35,37,Quay,1991,4903,4576,327,6.7
35,39,Rio Arriba,1991,15790,13449,2341,14.8
35,41,Roosevelt,1991,7284,6861,423,5.8
35,43,Sandoval,1991,30369,28542,1827,6.0
35,45,San Juan,1991,41757,37672,4085,9.8
35,47,San Miguel,1991,10862,9607,1255,11.6
35,49,Santa Fe,1991,56973,54836,2137,3.8
35,51,Sierra,1991,3398,3196,202,5.9
35,53,Socorro,1991,6615,6110,505,7.6
35,55,Taos,1991,11889,9928,1961,16.5
35,57,Torrance,1991,4488,4122,366,8.2
35,59,Union,1991,1836,1757,79,4.3
35,61,Valencia,1991,20124,18755,1369,6.8
36,1,Albany,1991,157769,150295,7474,4.7
36,3,Allegany,1991,22987,21125,1862,8.1
36,5,Bronx,1991,453343,405331,48012,10.6
36,7,Broome,1991,104900,98751,6149,5.9
36,9,Cattaraugus,1991,39755,36162,3593,9.0
36,11,Cayuga,1991,39191,35933,3258,8.3
36,13,Chautauqua,1991,69014,63708,5306,7.7
36,15,Chemung,1991,43296,40414,2882,6.7
36,17,Chenango,1991,24850,23144,1706,6.9
36,19,Clinton,1991,40249,37053,3196,7.9
36,21,Columbia,1991,31299,29578,1721,5.5
36,23,Cortland,1991,24875,23015,1860,7.5
36,25,Delaware,1991,21467,20029,1438,6.7
36,27,Dutchess,1991,130406,123644,6762,5.2
36,29,Erie,1991,477074,443915,33159,7.0
36,31,Essex,1991,18274,16226,2048,11.2
36,33,Franklin,1991,21232,18783,2449,11.5
36,35,Fulton,1991,27047,24194,2853,10.5
36,37,Genesee,1991,32227,29682,2545,7.9
36,39,Greene,1991,21392,19737,1655,7.7
36,41,Hamilton,1991,2907,2602,305,10.5
36,43,Herkimer,1991,30331,27669,2662,8.8
36,45,Jefferson,1991,46608,41469,5139,11.0
36,47,Kings,1991,942106,850603,91503,9.7
36,49,Lewis,1991,13094,11884,1210,9.2
36,51,Livingston,1991,32913,30788,2125,6.5
36,53,Madison,1991,35667,33033,2634,7.4
36,55,Monroe,1991,380002,363275,16727,4.4
36,57,Montgomery,1991,24693,22288,2405,9.7
36,59,Nassau,1991,686726,647582,39144,5.7
36,61,New York,1991,766502,706927,59575,7.8
36,63,Niagara,1991,109310,100979,8331,7.6
36,65,Oneida,1991,114108,106564,7544,6.6
36,67,Onondaga,1991,243475,229024,14451,5.9
36,69,Ontario,1991,51725,48866,2859,5.5
36,71,Orange,1991,153593,144264,9329,6.1
36,73,Orleans,1991,19953,18489,1464,7.3
36,75,Oswego,1991,58244,52389,5855,10.1
36,77,Otsego,1991,30875,29043,1832,5.9
36,79,Putnam,1991,48499,45924,2575,5.3
36,81,Queens,1991,940996,864171,76825,8.2
36,83,Rensselaer,1991,82102,77043,5059,6.2
36,85,Richmond,1991,180464,165906,14558,8.1
36,87,Rockland,1991,142438,134405,8033,5.6
36,89,St. Lawrence,1991,51606,46540,5066,9.8
36,91,Saratoga,1991,97883,92531,5352,5.5
36,93,Schenectady,1991,75726,71248,4478,5.9
36,95,Schoharie,1991,15447,14334,1113,7.2
36,97,Schuyler,1991,9189,8481,708,7.7
36,99,Seneca,1991,16500,15485,1015,6.2
36,101,Steuben,1991,47963,44448,3515,7.3
36,103,Suffolk,1991,700102,651565,48537,6.9
36,105,Sullivan,1991,33261,30576,2685,8.1
36,107,Tioga,1991,26431,24874,1557,5.9
36,109,Tompkins,1991,48407,46328,2079,4.3
36,111,Ulster,1991,84843,79796,5047,5.9
36,113,Warren,1991,31609,28856,2753,8.7
36,115,Washington,1991,28994,26843,2151,7.4
36,117,Wayne,1991,47207,44149,3058,6.5
36,119,Westchester,1991,460724,435827,24897,5.4
36,121,Wyoming,1991,20091,18427,1664,8.3
36,123,Yates,1991,11527,10750,777,6.7
37,1,Alamance,1991,62256,58550,3706,6.0
37,3,Alexander,1991,16390,15293,1097,6.7
37,5,Alleghany,1991,4973,4721,252,5.1
37,7,Anson,1991,12155,11096,1059,8.7
37,9,Ashe,1991,11627,10687,940,8.1
37,11,Avery,1991,7331,6684,647,8.8
37,13,Beaufort,1991,20468,18957,1511,7.4
37,15,Bertie,1991,9125,8585,540,5.9
37,17,Bladen,1991,13718,12187,1531,11.2
37,19,Brunswick,1991,25904,23670,2234,8.6
37,21,Buncombe,1991,94647,90039,4608,4.9
37,23,Burke,1991,42225,39620,2605,6.2
37,25,Cabarrus,1991,55615,52806,2809,5.1
37,27,Caldwell,1991,40942,38077,2865,7.0
37,29,Camden,1991,2755,2632,123,4.5
37,31,Carteret,1991,26395,24869,1526,5.8
37,33,Caswell,1991,11081,10425,656,5.9
37,35,Catawba,1991,72643,67648,4995,6.9
37,37,Chatham,1991,22815,21599,1216,5.3
37,39,Cherokee,1991,9270,8276,994,10.7
37,41,Chowan,1991,6256,5900,356,5.7
37,43,Clay,1991,3216,2956,260,8.1
37,45,Cleveland,1991,46514,43076,3438,7.4
37,47,Columbus,1991,23953,22018,1935,8.1
37,49,Craven,1991,34334,32364,1970,5.7
37,51,Cumberland,1991,107317,100855,6462,6.0
37,53,Currituck,1991,7239,6914,325,4.5
37,55,Dare,1991,14624,13652,972,6.6
37,57,Davidson,1991,73864,69481,4383,5.9
37,59,Davie,1991,15666,14862,804,5.1
37,61,Duplin,1991,20642,18830,1812,8.8
37,63,Durham,1991,103442,99806,3636,3.5
37,65,Edgecombe,1991,28785,26556,2229,7.7
37,67,Forsyth,1991,144663,138081,6582,4.5
37,69,Franklin,1991,19547,18176,1371,7.0
37,71,Gaston,1991,96135,89664,6471,6.7
37,73,Gates,1991,4139,3990,149,3.6
37,75,Graham,1991,3666,2943,723,19.7
37,77,Granville,1991,19545,18396,1149,5.9
37,79,Greene,1991,7698,7277,421,5.5
37,81,Guilford,1991,202982,192302,10680,5.3
37,83,Halifax,1991,24344,22237,2107,8.7
37,85,Harnett,1991,31588,29662,1926,6.1
37,87,Haywood,1991,23954,22485,1469,6.1
37,89,Henderson,1991,32771,31317,1454,4.4
37,91,Hertford,1991,10191,9285,906,8.9
37,93,Hoke,1991,9768,9108,660,6.8
37,95,Hyde,1991,2764,2541,223,8.1
37,97,Iredell,1991,53806,50309,3497,6.5
37,99,Jackson,1991,13696,12742,954,7.0
37,101,Johnston,1991,46164,43416,2748,6.0
37,103,Jones,1991,4456,4202,254,5.7
37,105,Lee,1991,22107,20564,1543,7.0
37,107,Lenoir,1991,28806,26975,1831,6.4
37,109,Lincoln,1991,28366,26547,1819,6.4
37,111,McDowell,1991,19277,17685,1592,8.3
37,113,Macon,1991,11603,10955,648,5.6
37,115,Madison,1991,8527,7933,594,7.0
37,117,Martin,1991,13049,12285,764,5.9
37,119,Mecklenburg,1991,301740,287839,13901,4.6
37,121,Mitchell,1991,7388,6665,723,9.8
37,123,Montgomery,1991,12072,10935,1137,9.4
37,125,Moore,1991,28185,26531,1654,5.9
37,127,Nash,1991,43080,40240,2840,6.6
37,129,New Hanover,1991,68618,64414,4204,6.1
37,131,Northampton,1991,8753,8122,631,7.2
37,133,Onslow,1991,41988,39724,2264,5.4
37,135,Orange,1991,54697,53142,1555,2.8
37,137,Pamlico,1991,5119,4868,251,4.9
37,139,Pasquotank,1991,13201,12458,743,5.6
37,141,Pender,1991,14307,13149,1158,8.1
37,143,Perquimans,1991,4357,4113,244,5.6
37,145,Person,1991,16500,14948,1552,9.4
37,147,Pitt,1991,58256,54713,3543,6.1
37,149,Polk,1991,7362,7137,225,3.1
37,151,Randolph,1991,64005,60928,3077,4.8
37,153,Richmond,1991,22251,20144,2107,9.5
37,155,Robeson,1991,51307,46575,4732,9.2
37,157,Rockingham,1991,46936,43263,3673,7.8
37,159,Rowan,1991,58410,55142,3268,5.6
37,161,Rutherford,1991,30852,28522,2330,7.6
37,163,Sampson,1991,23143,21384,1759,7.6
37,165,Scotland,1991,16925,15087,1838,10.9
37,167,Stanly,1991,28678,26706,1972,6.9
37,169,Stokes,1991,20379,19397,982,4.8
37,171,Surry,1991,34511,32291,2220,6.4
37,173,Swain,1991,6181,5237,944,15.3
37,175,Transylvania,1991,11911,11302,609,5.1
37,177,Tyrrell,1991,1873,1656,217,11.6
37,179,Union,1991,47151,44736,2415,5.1
37,181,Vance,1991,20524,18499,2025,9.9
37,183,Wake,1991,261700,253306,8394,3.2
37,185,Warren,1991,7771,6836,935,12.0
37,187,Washington,1991,6516,6102,414,6.4
37,189,Watauga,1991,20117,19220,897,4.5
37,191,Wayne,1991,49417,45836,3581,7.2
37,193,Wilkes,1991,32299,30461,1838,5.7
37,195,Wilson,1991,35334,31524,3810,10.8
37,197,Yadkin,1991,16383,15590,793,4.8
37,199,Yancey,1991,6575,5994,581,8.8
38,1,Adams,1991,1613,1574,39,2.4
38,3,Barnes,1991,5709,5495,214,3.7
38,5,Benson,1991,2684,2468,216,8.0
38,7,Billings,1991,654,625,29,4.4
38,9,Bottineau,1991,3507,3360,147,4.2
38,11,Bowman,1991,1926,1872,54,2.8
38,13,Burke,1991,1226,1177,49,4.0
38,15,Burleigh,1991,34636,33233,1403,4.1
38,17,Cass,1991,60747,58830,1917,3.2
38,19,Cavalier,1991,2561,2445,116,4.5
38,21,Dickey,1991,2924,2831,93,3.2
38,23,Divide,1991,1181,1158,23,1.9
38,25,Dunn,1991,1904,1842,62,3.3
38,27,Eddy,1991,1397,1282,115,8.2
38,29,Emmons,1991,1976,1895,81,4.1
38,31,Foster,1991,1926,1846,80,4.2
38,33,Golden Valley,1991,1026,982,44,4.3
38,35,Grand Forks,1991,33975,32698,1277,3.8
38,37,Grant,1991,1573,1529,44,2.8
38,39,Griggs,1991,1511,1472,39,2.6
38,41,Hettinger,1991,1503,1450,53,3.5
38,43,Kidder,1991,1500,1413,87,5.8
38,45,LaMoure,1991,2263,2208,55,2.4
38,47,Logan,1991,1266,1226,40,3.2
38,49,McHenry,1991,2709,2554,155,5.7
38,51,McIntosh,1991,1824,1797,27,1.5
38,53,McKenzie,1991,2889,2780,109,3.8
38,55,McLean,1991,4665,4384,281,6.0
38,57,Mercer,1991,5047,4669,378,7.5
38,59,Morton,1991,12427,11766,661,5.3
38,61,Mountrail,1991,3060,2843,217,7.1
38,63,Nelson,1991,1769,1700,69,3.9
38,65,Oliver,1991,1201,1139,62,5.2
38,67,Pembina,1991,4681,4306,375,8.0
38,69,Pierce,1991,2282,2207,75,3.3
38,71,Ramsey,1991,6195,5975,220,3.6
38,73,Ransom,1991,2635,2573,62,2.4
38,75,Renville,1991,1343,1303,40,3.0
38,77,Richland,1991,8371,7981,390,4.7
38,79,Rolette,1991,4466,3799,667,14.9
38,81,Sargent,1991,2204,2138,66,3.0
38,83,Sheridan,1991,753,726,27,3.6
38,85,Sioux,1991,1289,1014,275,21.3
38,87,Slope,1991,454,437,17,3.7
38,89,Stark,1991,11922,11343,579,4.9
38,91,Steele,1991,1026,1007,19,1.9
38,93,Stutsman,1991,11147,10727,420,3.8
38,95,Towner,1991,1559,1511,48,3.1
38,97,Traill,1991,3832,3672,160,4.2
38,99,Walsh,1991,6604,6311,293,4.4
38,101,Ward,1991,25961,24823,1138,4.4
38,103,Wells,1991,2565,2393,172,6.7
38,105,Williams,1991,10360,9907,453,4.4
39,1,Adams,1991,10126,8863,1263,12.5
39,3,Allen,1991,52463,48254,4209,8.0
39,5,Ashland,1991,24789,23089,1700,6.9
39,7,Ashtabula,1991,45507,41368,4139,9.1
39,9,Athens,1991,24559,23026,1533,6.2
39,11,Auglaize,1991,23424,21984,1440,6.1
39,13,Belmont,1991,30215,28114,2101,7.0
39,15,Brown,1991,17062,15701,1361,8.0
39,17,Butler,1991,151846,142836,9010,5.9
39,19,Carroll,1991,12461,11516,945,7.6
39,21,Champaign,1991,18988,17632,1356,7.1
39,23,Clark,1991,70610,65892,4718,6.7
39,25,Clermont,1991,81614,76886,4728,5.8
39,27,Clinton,1991,19224,18034,1190,6.2
39,29,Columbiana,1991,49489,46028,3461,7.0
39,31,Coshocton,1991,16498,15263,1235,7.5
39,33,Crawford,1991,22511,20119,2392,10.6
39,35,Cuyahoga,1991,670753,629901,40852,6.1
39,37,Darke,1991,27436,25615,1821,6.6
39,39,Defiance,1991,20719,18948,1771,8.5
39,41,Delaware,1991,37411,36010,1401,3.7
39,43,Erie,1991,41951,38859,3092,7.4
39,45,Fairfield,1991,54106,51040,3066,5.7
39,47,Fayette,1991,13219,12296,923,7.0
39,49,Franklin,1991,536218,515732,20486,3.8
39,51,Fulton,1991,20781,18882,1899,9.1
39,53,Gallia,1991,13158,11970,1188,9.0
39,55,Geauga,1991,42305,40403,1902,4.5
39,57,Greene,1991,67893,64420,3473,5.1
39,59,Guernsey,1991,18215,16402,1813,10.0
39,61,Hamilton,1991,439051,418228,20823,4.7
39,63,Hancock,1991,36036,34067,1969,5.5
39,65,Hardin,1991,14324,12878,1446,10.1
39,67,Harrison,1991,6486,5876,610,9.4
39,69,Henry,1991,15962,14807,1155,7.2
39,71,Highland,1991,16178,14611,1567,9.7
39,73,Hocking,1991,11704,10545,1159,9.9
39,75,Holmes,1991,14820,14092,728,4.9
39,77,Huron,1991,29521,26066,3455,11.7
39,79,Jackson,1991,12861,11769,1092,8.5
39,81,Jefferson,1991,32190,29834,2356,7.3
39,83,Knox,1991,24378,22858,1520,6.2
39,85,Lake,1991,117573,110603,6970,5.9
39,87,Lawrence,1991,25189,23130,2059,8.2
39,89,Licking,1991,65809,62032,3777,5.7
39,91,Logan,1991,21787,20342,1445,6.6
39,93,Lorain,1991,135743,123702,12041,8.9
39,95,Lucas,1991,226120,204576,21544,9.5
39,97,Madison,1991,18131,17242,889,4.9
39,99,Mahoning,1991,117522,109227,8295,7.1
39,101,Marion,1991,30475,27978,2497,8.2
39,103,Medina,1991,65727,61995,3732,5.7
39,105,Meigs,1991,8650,7828,822,9.5
39,107,Mercer,1991,19985,18837,1148,5.7
39,109,Miami,1991,49028,45945,3083,6.3
39,111,Monroe,1991,6139,5540,599,9.8
39,113,Montgomery,1991,286309,269772,16537,5.8
39,115,Morgan,1991,5807,5223,584,10.1
39,117,Morrow,1991,13444,12371,1073,8.0
39,119,Muskingum,1991,39365,35355,4010,10.2
39,121,Noble,1991,5058,4582,476,9.4
39,123,Ottawa,1991,21501,19405,2096,9.7
39,125,Paulding,1991,9840,8991,849,8.6
39,127,Perry,1991,14340,12342,1998,13.9
39,129,Pickaway,1991,21666,20474,1192,5.5
39,131,Pike,1991,9675,8558,1117,11.5
39,133,Portage,1991,76178,71666,4512,5.9
39,135,Preble,1991,19679,18240,1439,7.3
39,137,Putnam,1991,17098,15805,1293,7.6
39,139,Richland,1991,61383,54958,6425,10.5
39,141,Ross,1991,30500,27854,2646,8.7
39,143,Sandusky,1991,32142,29250,2892,9.0
39,145,Scioto,1991,30031,26965,3066,10.2
39,147,Seneca,1991,30330,27574,2756,9.1
39,149,Shelby,1991,25543,23760,1783,7.0
39,151,Stark,1991,185364,172100,13264,7.2
39,153,Summit,1991,261136,245287,15849,6.1
39,155,Trumbull,1991,110694,101877,8817,8.0
39,157,Tuscarawas,1991,41112,37782,3330,8.1
39,159,Union,1991,16024,15210,814,5.1
39,161,Van Wert,1991,15876,14709,1167,7.4
39,163,Vinton,1991,4198,3710,488,11.6
39,165,Warren,1991,60866,57857,3009,4.9
39,167,Washington,1991,30353,28286,2067,6.8
39,169,Wayne,1991,52063,49028,3035,5.8
39,171,Williams,1991,20229,18416,1813,9.0
39,173,Wood,1991,59938,55795,4143,6.9
39,175,Wyandot,1991,11365,10217,1148,10.1
40,1,Adair,1991,9211,8658,553,6.0
40,3,Alfalfa,1991,2698,2635,63,2.3
40,5,Atoka,1991,4832,4455,377,7.8
40,7,Beaver,1991,3018,2923,95,3.1
40,9,Beckham,1991,8730,8145,585,6.7
40,11,Blaine,1991,4986,4703,283,5.7
40,13,Bryan,1991,13335,12395,940,7.0
40,15,Caddo,1991,12015,11100,915,7.6
40,17,Canadian,1991,39368,37685,1683,4.3
40,19,Carter,1991,19776,18431,1345,6.8
40,21,Cherokee,1991,15832,14549,1283,8.1
40,23,Choctaw,1991,6019,5365,654,10.9
40,25,Cimarron,1991,1805,1764,41,2.3
40,27,Cleveland,1991,94343,90661,3682,3.9
40,29,Coal,1991,2466,2146,320,13.0
40,31,Comanche,1991,41771,39050,2721,6.5
40,33,Cotton,1991,2415,2152,263,10.9
40,35,Craig,1991,6425,6078,347,5.4
40,37,Creek,1991,29701,27805,1896,6.4
40,39,Custer,1991,13480,12620,860,6.4
40,41,Delaware,1991,12748,11917,831,6.5
40,43,Dewey,1991,2422,2328,94,3.9
40,45,Ellis,1991,2025,1926,99,4.9
40,47,Garfield,1991,26711,25621,1090,4.1
40,49,Garvin,1991,11760,10943,817,6.9
40,51,Grady,1991,18588,17271,1317,7.1
40,53,Grant,1991,2552,2477,75,2.9
40,55,Greer,1991,2295,2193,102,4.4
40,57,Harmon,1991,1375,1306,69,5.0
40,59,Harper,1991,2022,1958,64,3.2
40,61,Haskell,1991,4397,3663,734,16.7
40,63,Hughes,1991,5339,4715,624,11.7
40,65,Jackson,1991,10263,9560,703,6.8
40,67,Jefferson,1991,2836,2665,171,6.0
40,69,Johnston,1991,3897,3599,298,7.6
40,71,Kay,1991,23584,22355,1229,5.2
40,73,Kingfisher,1991,6509,6293,216,3.3
40,75,Kiowa,1991,4766,4562,204,4.3
40,77,Latimer,1991,4343,3736,607,14.0
40,79,Le Flore,1991,17754,15404,2350,13.2
40,81,Lincoln,1991,13563,12750,813,6.0
40,83,Logan,1991,13371,12755,616,4.6
40,85,Love,1991,3708,3504,204,5.5
40,87,McClain,1991,11107,10574,533,4.8
40,89,McCurtain,1991,14270,12644,1626,11.4
40,91,McIntosh,1991,6603,6009,594,9.0
40,93,Major,1991,3704,3589,115,3.1
40,95,Marshall,1991,4511,4265,246,5.5
40,97,Mayes,1991,14732,13361,1371,9.3
40,99,Murray,1991,5615,5102,513,9.1
40,101,Muskogee,1991,29413,27042,2371,8.1
40,103,Noble,1991,5388,5167,221,4.1
40,105,Nowata,1991,4323,4019,304,7.0
40,107,Okfuskee,1991,4326,3964,362,8.4
40,109,Oklahoma,1991,304584,288265,16319,5.4
40,111,Okmulgee,1991,15156,13704,1452,9.6
40,113,Osage,1991,18876,18006,870,4.6
40,115,Ottawa,1991,13086,11951,1135,8.7
40,117,Pawnee,1991,6708,6140,568,8.5
40,119,Payne,1991,30190,28836,1354,4.5
40,121,Pittsburg,1991,18358,16487,1871,10.2
40,123,Pontotoc,1991,15859,14648,1211,7.6
40,125,Pottawatomie,1991,26348,24556,1792,6.8
40,127,Pushmataha,1991,4316,3874,442,10.2
40,129,Roger Mills,1991,1978,1883,95,4.8
40,131,Rogers,1991,29200,27102,2098,7.2
40,133,Seminole,1991,10433,9388,1045,10.0
40,135,Sequoyah,1991,15526,14055,1471,9.5
40,137,Stephens,1991,19351,18120,1231,6.4
40,139,Texas,1991,8378,8067,311,3.7
40,141,Tillman,1991,4291,3968,323,7.5
40,143,Tulsa,1991,271432,257968,13464,5.0
40,145,Wagoner,1991,24491,23202,1289,5.3
40,147,Washington,1991,22443,21652,791,3.5
40,149,Washita,1991,5179,4900,279,5.4
40,151,Woods,1991,4339,4225,114,2.6
40,153,Woodward,1991,8936,8451,485,5.4
41,1,Baker,1991,7043,6492,551,7.8
41,3,Benton,1991,36199,34696,1503,4.2
41,5,Clackamas,1991,160637,153797,6840,4.3
41,7,Clatsop,1991,16304,15112,1192,7.3
41,9,Columbia,1991,18816,17536,1280,6.8
41,11,Coos,1991,26982,24545,2437,9.0
41,13,Crook,1991,6945,6381,564,8.1
41,15,Curry,1991,8244,7678,566,6.9
41,17,Deschutes,1991,43073,40223,2850,6.6
41,19,Douglas,1991,43239,38755,4484,10.4
41,21,Gilliam,1991,1085,1050,35,3.2
41,23,Grant,1991,4304,3865,439,10.2
41,25,Harney,1991,3741,3439,302,8.1
41,27,Hood River,1991,9545,8670,875,9.2
41,29,Jackson,1991,74729,68906,5823,7.8
41,31,Jefferson,1991,6532,6063,469,7.2
41,33,Josephine,1991,26294,24093,2201,8.4
41,35,Klamath,1991,26767,24273,2494,9.3
41,37,Lake,1991,3719,3415,304,8.2
41,39,Lane,1991,145908,135985,9923,6.8
41,41,Lincoln,1991,19616,18449,1167,5.9
41,43,Linn,1991,44563,40832,3731,8.4
41,45,Malheur,1991,14356,13406,950,6.6
41,47,Marion,1991,118658,111795,6863,5.8
41,49,Morrow,1991,3507,3168,339,9.7
41,51,Multnomah,1991,326589,308474,18115,5.5
41,53,Polk,1991,25170,23787,1383,5.5
41,55,Sherman,1991,999,931,68,6.8
41,57,Tillamook,1991,9835,9228,607,6.2
41,59,Umatilla,1991,30311,27743,2568,8.5
41,61,Union,1991,11744,10903,841,7.2
41,63,Wallowa,1991,3649,3337,312,8.6
41,65,Wasco,1991,11375,10522,853,7.5
41,67,Washington,1991,191794,183116,8678,4.5
41,69,Wheeler,1991,526,457,69,13.1
41,71,Yamhill,1991,33184,31364,1820,5.5
42,1,Adams,1991,41551,39424,2127,5.1
42,3,Allegheny,1991,649757,615481,34276,5.3
42,5,Armstrong,1991,30604,27553,3051,10.0
42,7,Beaver,1991,83715,77768,5947,7.1
42,9,Bedford,1991,22015,19703,2312,10.5
42,11,Berks,1991,175310,164164,11146,6.4
42,13,Blair,1991,61147,55501,5646,9.2
42,15,Bradford,1991,27672,25654,2018,7.3
42,17,Bucks,1991,303594,282464,21130,7.0
42,19,Butler,1991,76416,71337,5079,6.6
42,21,Cambria,1991,67949,61809,6140,9.0
42,23,Cameron,1991,2514,2288,226,9.0
42,25,Carbon,1991,26953,24379,2574,9.5
42,27,Centre,1991,60978,58312,2666,4.4
42,29,Chester,1991,207580,197889,9691,4.7
42,31,Clarion,1991,18149,16530,1619,8.9
42,33,Clearfield,1991,35700,31494,4206,11.8
42,35,Clinton,1991,17310,15385,1925,11.1
42,37,Columbia,1991,31835,29048,2787,8.8
42,39,Crawford,1991,40306,36576,3730,9.3
42,41,Cumberland,1991,110783,106071,4712,4.3
42,43,Dauphin,1991,131017,124296,6721,5.1
42,45,Delaware,1991,277514,261402,16112,5.8
42,47,Elk,1991,16751,15192,1559,9.3
42,49,Erie,1991,135747,126030,9717,7.2
42,51,Fayette,1991,55833,50319,5514,9.9
42,53,Forest,1991,2028,1794,234,11.5
42,55,Franklin,1991,62180,58357,3823,6.1
42,57,Fulton,1991,6556,5996,560,8.5
42,59,Greene,1991,15583,13913,1670,10.7
42,61,Huntingdon,1991,19598,17175,2423,12.4
42,63,Indiana,1991,38844,35210,3634,9.4
42,65,Jefferson,1991,20730,18809,1921,9.3
42,67,Juniata,1991,10492,9467,1025,9.8
42,69,Lackawanna,1991,105938,97188,8750,8.3
42,71,Lancaster,1991,225023,214697,10326,4.6
42,73,Lawrence,1991,41271,37483,3788,9.2
42,75,Lebanon,1991,62153,58681,3472,5.6
42,77,Lehigh,1991,154263,144496,9767,6.3
42,79,Luzerne,1991,157704,143440,14264,9.0
42,81,Lycoming,1991,57391,52662,4729,8.2
42,83,McKean,1991,20797,19136,1661,8.0
42,85,Mercer,1991,55090,51076,4014,7.3
42,87,Mifflin,1991,22772,20686,2086,9.2
42,89,Monroe,1991,48731,44028,4703,9.7
42,91,Montgomery,1991,375320,355121,20199,5.4
42,93,Montour,1991,8658,8184,474,5.5
42,95,Northampton,1991,126132,118190,7942,6.3
42,97,Northumberland,1991,45262,40766,4496,9.9
42,99,Perry,1991,22322,20917,1405,6.3
42,101,Philadelphia/city,1991,691313,630908,60405,8.7
42,103,Pike,1991,14800,13602,1198,8.1
42,105,Potter,1991,7836,7157,679,8.7
42,107,Schuylkill,1991,69486,62673,6813,9.8
42,109,Snyder,1991,18326,16969,1357,7.4
42,111,Somerset,1991,35847,32635,3212,9.0
42,113,Sullivan,1991,2593,2268,325,12.5
42,115,Susquehanna,1991,18183,16630,1553,8.5
42,117,Tioga,1991,18761,17236,1525,8.1
42,119,Union,1991,16703,15435,1268,7.6
42,121,Venango,1991,25440,23354,2086,8.2
42,123,Warren,1991,22567,21092,1475,6.5
42,125,Washington,1991,91923,85480,6443,7.0
42,127,Wayne,1991,19515,17568,1947,10.0
42,129,Westmoreland,1991,174086,162070,12016,6.9
42,131,Wyoming,1991,13991,12812,1179,8.4
42,133,York,1991,187400,177198,10202,5.4
44,1,Bristol,1991,26428,24243,2185,8.3
44,3,Kent,1991,89484,82022,7462,8.3
44,5,Newport,1991,42881,39399,3482,8.1
44,7,Providence,1991,306852,279415,27437,8.9
44,9,Washington,1991,59713,56037,3676,6.2
45,1,Abbeville,1991,11837,10883,954,8.1
45,3,Aiken,1991,62325,58812,3513,5.6
45,5,Allendale,1991,4817,4307,510,10.6
45,7,Anderson,1991,76366,71733,4633,6.1
45,9,Bamberg,1991,7693,6847,846,11.0
45,11,Barnwell,1991,10086,8701,1385,13.7
45,13,Beaufort,1991,36946,35449,1497,4.1
45,15,Berkeley,1991,57664,55318,2346,4.1
45,17,Calhoun,1991,6153,5718,435,7.1
45,19,Charleston,1991,145764,139582,6182,4.2
45,21,Cherokee,1991,23137,21684,1453,6.3
45,23,Chester,1991,16029,13964,2065,12.9
45,25,Chesterfield,1991,19138,17926,1212,6.3
45,27,Clarendon,1991,11773,10480,1293,11.0
45,29,Colleton,1991,15481,13914,1567,10.1
45,31,Darlington,1991,30679,28374,2305,7.5
45,33,Dillon,1991,13159,11707,1452,11.0
45,35,Dorchester,1991,40241,38614,1627,4.0
45,37,Edgefield,1991,9058,8598,460,5.1
45,39,Fairfield,1991,10767,9487,1280,11.9
45,41,Florence,1991,57945,54505,3440,5.9
45,43,Georgetown,1991,21998,19957,2041,9.3
45,45,Greenville,1991,174433,165824,8609,4.9
45,47,Greenwood,1991,30426,28325,2101,6.9
45,49,Hampton,1991,7646,7012,634,8.3
45,51,Horry,1991,77385,71802,5583,7.2
45,53,Jasper,1991,6639,6340,299,4.5
45,55,Kershaw,1991,23184,21295,1889,8.1
45,57,Lancaster,1991,29077,26690,2387,8.2
45,59,Laurens,1991,29375,27674,1701,5.8
45,61,Lee,1991,8023,7429,594,7.4
45,63,Lexington,1991,98029,94068,3961,4.0
45,65,McCormick,1991,3704,3269,435,11.7
45,67,Marion,1991,16773,14659,2114,12.6
45,69,Marlboro,1991,12910,11493,1417,11.0
45,71,Newberry,1991,16947,16074,873,5.2
45,73,Oconee,1991,29199,26903,2296,7.9
45,75,Orangeburg,1991,39683,36069,3614,9.1
45,77,Pickens,1991,50359,47620,2739,5.4
45,79,Richland,1991,148704,142017,6687,4.5
45,81,Saluda,1991,8328,7913,415,5.0
45,83,Spartanburg,1991,120766,114410,6356,5.3
45,85,Sumter,1991,41906,38097,3809,9.1
45,87,Union,1991,15362,13947,1415,9.2
45,89,Williamsburg,1991,15907,14327,1580,9.9
45,91,York,1991,73307,69382,3925,5.4
46,3,Aurora,1991,1328,1288,40,3.0
46,5,Beadle,1991,8908,8528,380,4.3
46,7,Bennett,1991,1180,1123,57,4.8
46,9,Bon Homme,1991,3132,3043,89,2.8
46,11,Brookings,1991,14289,13863,426,3.0
46,13,Brown,1991,19539,18929,610,3.1
46,15,Brule,1991,2723,2642,81,3.0
46,17,Buffalo,1991,590,536,54,9.2
46,19,Butte,1991,3631,3496,135,3.7
46,21,Campbell,1991,941,898,43,4.6
46,23,Charles Mix,1991,3929,3769,160,4.1
46,25,Clark,1991,1927,1854,73,3.8
46,27,Clay,1991,6824,6636,188,2.8
46,29,Codington,1991,12177,11694,483,4.0
46,31,Corson,1991,1538,1209,329,21.4
46,33,Custer,1991,3587,3442,145,4.0
46,35,Davison,1991,8903,8684,219,2.5
46,37,Day,1991,3042,2882,160,5.3
46,39,Deuel,1991,2135,2061,74,3.5
46,41,Dewey,1991,2112,1834,278,13.2
46,43,Douglas,1991,1568,1527,41,2.6
46,45,Edmunds,1991,2075,2031,44,2.1
46,47,Fall River,1991,3194,3038,156,4.9
46,49,Faulk,1991,1247,1220,27,2.2
46,51,Grant,1991,4218,4017,201,4.8
46,53,Gregory,1991,2446,2389,57,2.3
46,55,Haakon,1991,1168,1127,41,3.5
46,57,Hamlin,1991,2185,2101,84,3.8
46,59,Hand,1991,2055,1992,63,3.1
46,61,Hanson,1991,1524,1490,34,2.2
46,63,Harding,1991,806,784,22,2.7
46,65,Hughes,1991,8580,8339,241,2.8
46,67,Hutchinson,1991,4013,3918,95,2.4
46,69,Hyde,1991,805,785,20,2.5
46,71,Jackson,1991,1204,1155,49,4.1
46,73,Jerauld,1991,1068,1039,29,2.7
46,75,Jones,1991,763,730,33,4.3
46,77,Kingsbury,1991,2734,2666,68,2.5
46,79,Lake,1991,5589,5403,186,3.3
46,81,Lawrence,1991,12193,11798,395,3.2
46,83,Lincoln,1991,8564,8382,182,2.1
46,85,Lyman,1991,1910,1803,107,5.6
46,87,McCook,1991,2730,2644,86,3.2
46,89,McPherson,1991,1464,1429,35,2.4
46,91,Marshall,1991,2184,2119,65,3.0
46,93,Meade,1991,10476,10055,421,4.0
46,95,Mellette,1991,767,723,44,5.7
46,97,Miner,1991,1527,1493,34,2.2
46,99,Minnehaha,1991,73422,71607,1815,2.5
46,101,Moody,1991,3542,3355,187,5.3
46,102,Oglala Lakota,1991,2301,1931,370,16.1
46,103,Pennington,1991,41088,39577,1511,3.7
46,105,Perkins,1991,2102,2051,51,2.4
46,107,Potter,1991,1500,1457,43,2.9
46,109,Roberts,1991,4596,4331,265,5.8
46,111,Sanborn,1991,1264,1222,42,3.3
46,115,Spink,1991,3551,3441,110,3.1
46,117,Stanley,1991,1436,1384,52,3.6
46,119,Sully,1991,898,873,25,2.8
46,121,Todd,1991,2411,2175,236,9.8
46,123,Tripp,1991,3333,3231,102,3.1
46,125,Turner,1991,4069,3961,108,2.7
46,127,Union,1991,3518,3272,246,7.0
46,129,Walworth,1991,2971,2881,90,3.0
46,135,Yankton,1991,9931,9671,260,2.6
46,137,Ziebach,1991,759,700,59,7.8
47,1,Anderson,1991,33273,31614,1659,5.0
47,3,Bedford,1991,15259,13962,1297,8.5
47,5,Benton,1991,7131,6462,669,9.4
47,7,Bledsoe,1991,3670,3283,387,10.5
47,9,Blount,1991,43010,40445,2565,6.0
47,11,Bradley,1991,38768,35956,2812,7.3
47,13,Campbell,1991,13789,11499,2290,16.6
47,15,Cannon,1991,5583,5240,343,6.1
47,17,Carroll,1991,12943,11891,1052,8.1
47,19,Carter,1991,24455,22867,1588,6.5
47,21,Cheatham,1991,14298,13594,704,4.9
47,23,Chester,1991,5851,5482,369,6.3
47,25,Claiborne,1991,10355,9431,924,8.9
47,27,Clay,1991,3475,3243,232,6.7
47,29,Cocke,1991,14206,12354,1852,13.0
47,31,Coffee,1991,19202,17851,1351,7.0
47,33,Crockett,1991,6737,6316,421,6.2
47,35,Cumberland,1991,15893,14458,1435,9.0
47,37,Davidson,1991,273492,260641,12851,4.7
47,39,Decatur,1991,4805,4216,589,12.3
47,41,DeKalb,1991,7607,7064,543,7.1
47,43,Dickson,1991,17256,16099,1157,6.7
47,45,Dyer,1991,16682,15335,1347,8.1
47,47,Fayette,1991,11267,10526,741,6.6
47,49,Fentress,1991,6656,6031,625,9.4
47,51,Franklin,1991,16046,15063,983,6.1
47,53,Gibson,1991,21946,20038,1908,8.7
47,55,Giles,1991,13030,12084,946,7.3
47,57,Grainger,1991,8224,7469,755,9.2
47,59,Greene,1991,27377,24098,3279,12.0
47,61,Grundy,1991,5428,4789,639,11.8
47,63,Hamblen,1991,26336,23851,2485,9.4
47,65,Hamilton,1991,142324,133982,8342,5.9
47,67,Hancock,1991,2249,2074,175,7.8
47,69,Hardeman,1991,9605,8820,785,8.2
47,71,Hardin,1991,10888,9865,1023,9.4
47,73,Hawkins,1991,21064,19830,1234,5.9
47,75,Haywood,1991,8221,7318,903,11.0
47,77,Henderson,1991,11060,9961,1099,9.9
47,79,Henry,1991,12191,11308,883,7.2
47,81,Hickman,1991,7980,7269,711,8.9
47,83,Houston,1991,3158,2819,339,10.7
47,85,Humphreys,1991,6854,6064,790,11.5
47,87,Jackson,1991,4084,3743,341,8.3
47,89,Jefferson,1991,16957,15378,1579,9.3
47,91,Johnson,1991,6676,6190,486,7.3
47,93,Knox,1991,176304,168539,7765,4.4
47,95,Lake,1991,2566,2367,199,7.8
47,97,Lauderdale,1991,9401,8424,977,10.4
47,99,Lawrence,1991,18219,16575,1644,9.0
47,101,Lewis,1991,4323,3948,375,8.7
47,103,Lincoln,1991,14147,12832,1315,9.3
47,105,Loudon,1991,16545,15404,1141,6.9
47,107,McMinn,1991,20398,18362,2036,10.0
47,109,McNairy,1991,10664,9717,947,8.9
47,111,Macon,1991,8567,7828,739,8.6
47,113,Madison,1991,39631,37357,2274,5.7
47,115,Marion,1991,11613,10613,1000,8.6
47,117,Marshall,1991,10842,9935,907,8.4
47,119,Maury,1991,30848,27894,2954,9.6
47,121,Meigs,1991,3903,3410,493,12.6
47,123,Monroe,1991,13976,12052,1924,13.8
47,125,Montgomery,1991,41322,38599,2723,6.6
47,127,Moore,1991,2602,2447,155,6.0
47,129,Morgan,1991,6970,6370,600,8.6
47,131,Obion,1991,14500,13020,1480,10.2
47,133,Overton,1991,8581,7715,866,10.1
47,135,Perry,1991,2976,2665,311,10.5
47,137,Pickett,1991,1940,1838,102,5.3
47,139,Polk,1991,6449,5750,699,10.8
47,141,Putnam,1991,26209,24091,2118,8.1
47,143,Rhea,1991,11079,9805,1274,11.5
47,145,Roane,1991,20215,18590,1625,8.0
47,147,Robertson,1991,21745,20127,1618,7.4
47,149,Rutherford,1991,65962,62648,3314,5.0
47,151,Scott,1991,7723,6644,1079,14.0
47,153,Sequatchie,1991,4544,4217,327,7.2
47,155,Sevier,1991,28182,25617,2565,9.1
47,157,Shelby,1991,397120,375561,21559,5.4
47,159,Smith,1991,7010,6491,519,7.4
47,161,Stewart,1991,5029,4634,395,7.9
47,163,Sullivan,1991,70104,66757,3347,4.8
47,165,Sumner,1991,55227,51590,3637,6.6
47,167,Tipton,1991,17106,15934,1172,6.9
47,169,Trousdale,1991,2838,2530,308,10.9
47,171,Unicoi,1991,7823,6928,895,11.4
47,173,Union,1991,6478,6056,422,6.5
47,175,Van Buren,1991,2235,2018,217,9.7
47,177,Warren,1991,17236,15723,1513,8.8
47,179,Washington,1991,46863,44320,2543,5.4
47,181,Wayne,1991,6967,6330,637,9.1
47,183,Weakley,1991,16187,15147,1040,6.4
47,185,White,1991,9530,8599,931,9.8
47,187,Williamson,1991,43975,42481,1494,3.4
47,189,Wilson,1991,36497,34391,2106,5.8
48,1,Anderson,1991,18296,17087,1209,6.6
48,3,Andrews,1991,6350,6065,285,4.5
48,5,Angelina,1991,32592,30191,2401,7.4
48,7,Aransas,1991,7664,7377,287,3.7
48,9,Archer,1991,3750,3602,148,3.9
48,11,Armstrong,1991,1047,1012,35,3.3
48,13,Atascosa,1991,13739,12751,988,7.2
48,15,Austin,1991,9640,9301,339,3.5
48,17,Bailey,1991,3796,3614,182,4.8
48,19,Bandera,1991,6121,5989,132,2.2
48,21,Bastrop,1991,18680,17879,801,4.3
48,23,Baylor,1991,1899,1777,122,6.4
48,25,Bee,1991,9313,8623,690,7.4
48,27,Bell,1991,76160,70986,5174,6.8
48,29,Bexar,1991,567428,528278,39150,6.9
48,31,Blanco,1991,2932,2846,86,2.9
48,33,Borden,1991,395,375,20,5.1
48,35,Bosque,1991,5903,5403,500,8.5
48,37,Bowie,1991,38155,34842,3313,8.7
48,39,Brazoria,1991,102715,97712,5003,4.9
48,41,Brazos,1991,62300,60132,2168,3.5
48,43,Brewster,1991,4074,3940,134,3.3
48,45,Briscoe,1991,925,902,23,2.5
48,47,Brooks,1991,2929,2630,299,10.2
48,49,Brown,1991,15570,14284,1286,8.3
48,51,Burleson,1991,6550,6251,299,4.6
48,53,Burnet,1991,9539,9023,516,5.4
48,55,Caldwell,1991,11837,11210,627,5.3
48,57,Calhoun,1991,8961,8390,571,6.4
48,59,Callahan,1991,5511,5238,273,5.0
48,61,Cameron,1991,109397,92909,16488,15.1
48,63,Camp,1991,4830,4359,471,9.8
48,65,Carson,1991,3138,3004,134,4.3
48,67,Cass,1991,14636,13076,1560,10.7
48,69,Castro,1991,4181,3966,215,5.1
48,71,Chambers,1991,9902,9440,462,4.7
48,73,Cherokee,1991,18890,17610,1280,6.8
48,75,Childress,1991,2701,2550,151,5.6
48,77,Clay,1991,4720,4523,197,4.2
48,79,Cochran,1991,1987,1897,90,4.5
48,81,Coke,1991,1360,1328,32,2.4
48,83,Coleman,1991,3664,3393,271,7.4
48,85,Collin,1991,166476,158340,8136,4.9
48,87,Collingsworth,1991,1817,1734,83,4.6
48,89,Colorado,1991,8110,7867,243,3.0
48,91,Comal,1991,26427,24887,1540,5.8
48,93,Comanche,1991,5993,5707,286,4.8
48,95,Concho,1991,1444,1408,36,2.5
48,97,Cooke,1991,15130,14228,902,6.0
48,99,Coryell,1991,17088,15869,1219,7.1
48,101,Cottle,1991,940,896,44,4.7
48,103,Crane,1991,2333,2232,101,4.3
48,105,Crockett,1991,1842,1740,102,5.5
48,107,Crosby,1991,3310,3154,156,4.7
48,109,Culberson,1991,1578,1464,114,7.2
48,111,Dallam,1991,2664,2584,80,3.0
48,113,Dallas,1991,1081031,1011136,69895,6.5
48,115,Dawson,1991,5800,5413,387,6.7
48,117,Deaf Smith,1991,9014,8394,620,6.9
48,119,Delta,1991,2047,1907,140,6.8
48,121,Denton,1991,172931,164493,8438,4.9
48,123,DeWitt,1991,7717,7383,334,4.3
48,125,Dickens,1991,1052,999,53,5.0
48,127,Dimmit,1991,4176,3583,593,14.2
48,129,Donley,1991,1558,1486,72,4.6
48,131,Duval,1991,4314,3840,474,11.0
48,133,Eastland,1991,7979,7382,597,7.5
48,135,Ector,1991,57901,54277,3624,6.3
48,137,Edwards,1991,955,887,68,7.1
48,139,Ellis,1991,44236,41251,2985,6.7
48,141,El Paso,1991,263275,231466,31809,12.1
48,143,Erath,1991,14284,13608,676,4.7
48,145,Falls,1991,7227,6849,378,5.2
48,147,Fannin,1991,11195,10276,919,8.2
48,149,Fayette,1991,10040,9805,235,2.3
48,151,Fisher,1991,1998,1879,119,6.0
48,153,Floyd,1991,3913,3684,229,5.9
48,155,Foard,1991,917,904,13,1.4
48,157,Fort Bend,1991,128319,123532,4787,3.7
48,159,Franklin,1991,3550,3290,260,7.3
48,161,Freestone,1991,7098,6675,423,6.0
48,163,Frio,1991,7240,6627,613,8.5
48,165,Gaines,1991,6796,6561,235,3.5
48,167,Galveston,1991,116023,107366,8657,7.5
48,169,Garza,1991,2271,2177,94,4.1
48,171,Gillespie,1991,8791,8623,168,1.9
48,173,Glasscock,1991,690,677,13,1.9
48,175,Goliad,1991,2669,2536,133,5.0
48,177,Gonzales,1991,7946,7628,318,4.0
48,179,Gray,1991,11048,10484,564,5.1
48,181,Grayson,1991,46326,42957,3369,7.3
48,183,Gregg,1991,54840,49806,5034,9.2
48,185,Grimes,1991,8082,7709,373,4.6
48,187,Guadalupe,1991,32380,30970,1410,4.4
48,189,Hale,1991,17179,16261,918,5.3
48,191,Hall,1991,1953,1831,122,6.2
48,193,Hamilton,1991,3461,3337,124,3.6
48,195,Hansford,1991,2827,2720,107,3.8
48,197,Hardeman,1991,2109,2019,90,4.3
48,199,Hardin,1991,20453,19093,1360,6.6
48,201,Harris,1991,1581879,1489353,92526,5.8
48,203,Harrison,1991,25948,23692,2256,8.7
48,205,Hartley,1991,1825,1782,43,2.4
48,207,Haskell,1991,2871,2775,96,3.3
48,209,Hays,1991,34461,32927,1534,4.5
48,211,Hemphill,1991,1858,1793,65,3.5
48,213,Henderson,1991,25839,23199,2640,10.2
48,215,Hidalgo,1991,166284,129810,36474,21.9
48,217,Hill,1991,12244,11406,838,6.8
48,219,Hockley,1991,11290,10777,513,4.5
48,221,Hood,1991,13320,12480,840,6.3
48,223,Hopkins,1991,14285,13172,1113,7.8
48,225,Houston,1991,8397,7968,429,5.1
48,227,Howard,1991,13582,12944,638,4.7
48,229,Hudspeth,1991,1134,1106,28,2.5
48,231,Hunt,1991,32034,29585,2449,7.6
48,233,Hutchinson,1991,11263,10614,649,5.8
48,235,Irion,1991,870,837,33,3.8
48,237,Jack,1991,3217,3058,159,4.9
48,239,Jackson,1991,5744,5529,215,3.7
48,241,Jasper,1991,12988,11627,1361,10.5
48,243,Jeff Davis,1991,1029,987,42,4.1
48,245,Jefferson,1991,118310,110139,8171,6.9
48,247,Jim Hogg,1991,2067,1873,194,9.4
48,249,Jim Wells,1991,15361,13829,1532,10.0
48,251,Johnson,1991,49416,46367,3049,6.2
48,253,Jones,1991,8163,7809,354,4.3
48,255,Karnes,1991,5054,4792,262,5.2
48,257,Kaufman,1991,25557,23984,1573,6.2
48,259,Kendall,1991,7861,7653,208,2.6
48,261,Kenedy,1991,211,206,5,2.4
48,263,Kent,1991,486,468,18,3.7
48,265,Kerr,1991,15762,15182,580,3.7
48,267,Kimble,1991,2099,2048,51,2.4
48,269,King,1991,170,164,6,3.5
48,271,Kinney,1991,1122,1047,75,6.7
48,273,Kleberg,1991,12394,11523,871,7.0
48,275,Knox,1991,2229,2155,74,3.3
48,277,Lamar,1991,20475,18881,1594,7.8
48,279,Lamb,1991,6372,6026,346,5.4
48,281,Lampasas,1991,6189,5786,403,6.5
48,283,La Salle,1991,2377,2185,192,8.1
48,285,Lavaca,1991,8647,8435,212,2.5
48,287,Lee,1991,6307,6035,272,4.3
48,289,Leon,1991,5007,4644,363,7.2
48,291,Liberty,1991,23741,21633,2108,8.9
48,293,Limestone,1991,9129,8673,456,5.0
48,295,Lipscomb,1991,1425,1366,59,4.1
48,297,Live Oak,1991,4263,4084,179,4.2
48,299,Llano,1991,4314,4167,147,3.4
48,301,Loving,1991,54,53,1,1.9
48,303,Lubbock,1991,113180,106846,6334,5.6
48,305,Lynn,1991,3013,2909,104,3.5
48,307,McCulloch,1991,3519,3215,304,8.6
48,309,McLennan,1991,93471,86826,6645,7.1
48,311,McMullen,1991,323,316,7,2.2
48,313,Madison,1991,3988,3812,176,4.4
48,315,Marion,1991,3713,3351,362,9.7
48,317,Martin,1991,1887,1848,39,2.1
48,319,Mason,1991,1524,1479,45,3.0
48,321,Matagorda,1991,17624,15639,1985,11.3
48,323,Maverick,1991,16359,10712,5647,34.5
48,325,Medina,1991,11947,11271,676,5.7
48,327,Menard,1991,954,922,32,3.4
48,329,Midland,1991,56135,53424,2711,4.8
48,331,Milam,1991,9872,9363,509,5.2
48,333,Mills,1991,2052,1989,63,3.1
48,335,Mitchell,1991,3235,2969,266,8.2
48,337,Montague,1991,7742,7288,454,5.9
48,339,Montgomery,1991,97842,92562,5280,5.4
48,341,Moore,1991,8565,8230,335,3.9
48,343,Morris,1991,6064,5303,761,12.5
48,345,Motley,1991,765,741,24,3.1
48,347,Nacogdoches,1991,26331,24726,1605,6.1
48,349,Navarro,1991,18673,17123,1550,8.3
48,351,Newton,1991,5094,4561,533,10.5
48,353,Nolan,1991,7675,7104,571,7.4
48,355,Nueces,1991,138240,126809,11431,8.3
48,357,Ochiltree,1991,4401,4218,183,4.2
48,359,Oldham,1991,1134,1070,64,5.6
48,361,Orange,1991,40585,36863,3722,9.2
48,363,Palo Pinto,1991,11496,10505,991,8.6
48,365,Panola,1991,8136,7329,807,9.9
48,367,Parker,1991,33388,31111,2277,6.8
48,369,Parmer,1991,4248,4096,152,3.6
48,371,Pecos,1991,6556,5994,562,8.6
48,373,Polk,1991,12028,11153,875,7.3
48,375,Potter,1991,47468,44658,2810,5.9
48,377,Presidio,1991,2805,2202,603,21.5
48,379,Rains,1991,3216,3007,209,6.5
48,381,Randall,1991,50677,48806,1871,3.7
48,383,Reagan,1991,1979,1906,73,3.7
48,385,Real,1991,1040,978,62,6.0
48,387,Red River,1991,5749,5209,540,9.4
48,389,Reeves,1991,6737,6033,704,10.4
48,391,Refugio,1991,3323,3186,137,4.1
48,393,Roberts,1991,539,528,11,2.0
48,395,Robertson,1991,6325,5852,473,7.5
48,397,Rockwall,1991,15200,14489,711,4.7
48,399,Runnels,1991,5289,5098,191,3.6
48,401,Rusk,1991,21542,19917,1625,7.5
48,403,Sabine,1991,3372,3071,301,8.9
48,405,San Augustine,1991,3278,3071,207,6.3
48,407,San Jacinto,1991,6603,6256,347,5.3
48,409,San Patricio,1991,25634,23168,2466,9.6
48,411,San Saba,1991,2082,1941,141,6.8
48,413,Schleicher,1991,1286,1218,68,5.3
48,415,Scurry,1991,8158,7749,409,5.0
48,417,Shackelford,1991,1503,1459,44,2.9
48,419,Shelby,1991,9029,8223,806,8.9
48,421,Sherman,1991,1419,1375,44,3.1
48,423,Smith,1991,77204,71939,5265,6.8
48,425,Somervell,1991,3295,3100,195,5.9
48,427,Starr,1991,19565,11831,7734,39.5
48,429,Stephens,1991,3694,3544,150,4.1
48,431,Sterling,1991,671,655,16,2.4
48,433,Stonewall,1991,837,797,40,4.8
48,435,Sutton,1991,2204,2063,141,6.4
48,437,Swisher,1991,3688,3559,129,3.5
48,439,Tarrant,1991,675993,628709,47284,7.0
48,441,Taylor,1991,55683,52639,3044,5.5
48,443,Terrell,1991,620,601,19,3.1
48,445,Terry,1991,6138,5836,302,4.9
48,447,Throckmorton,1991,926,909,17,1.8
48,449,Titus,1991,11810,10794,1016,8.6
48,451,Tom Green,1991,47021,44663,2358,5.0
48,453,Travis,1991,343841,327617,16224,4.7
48,455,Trinity,1991,4571,4309,262,5.7
48,457,Tyler,1991,6739,6227,512,7.6
48,459,Upshur,1991,14625,13508,1117,7.6
48,461,Upton,1991,1924,1869,55,2.9
48,463,Uvalde,1991,10595,9377,1218,11.5
48,465,Val Verde,1991,15926,13736,2190,13.8
48,467,Van Zandt,1991,17466,16266,1200,6.9
48,469,Victoria,1991,38690,36939,1751,4.5
48,471,Walker,1991,19859,19163,696,3.5
48,473,Waller,1991,10940,10390,550,5.0
48,475,Ward,1991,5300,4999,301,5.7
48,477,Washington,1991,13120,12760,360,2.7
48,479,Webb,1991,58375,51799,6576,11.3
48,481,Wharton,1991,18566,17638,928,5.0
48,483,Wheeler,1991,2672,2555,117,4.4
48,485,Wichita,1991,56586,52567,4019,7.1
48,487,Wilbarger,1991,7190,6772,418,5.8
48,489,Willacy,1991,7103,5811,1292,18.2
48,491,Williamson,1991,81386,78518,2868,3.5
48,493,Wilson,1991,10612,10154,458,4.3
48,495,Winkler,1991,3481,3271,210,6.0
48,497,Wise,1991,16389,15399,990,6.0
48,499,Wood,1991,13168,12299,869,6.6
48,501,Yoakum,1991,4134,3984,150,3.6
48,503,Young,1991,8743,8242,501,5.7
48,505,Zapata,1991,3203,2748,455,14.2
48,507,Zavala,1991,4700,3683,1017,21.6
49,1,Beaver,1991,1998,1912,86,4.3
49,3,Box Elder,1991,16137,15488,649,4.0
49,5,Cache,1991,34345,33155,1190,3.5
49,7,Carbon,1991,8672,7961,711,8.2
49,9,Daggett,1991,391,379,12,3.1
49,11,Davis,1991,89715,85838,3877,4.3
49,13,Duchesne,1991,5160,4759,401,7.8
49,15,Emery,1991,4024,3639,385,9.6
49,17,Garfield,1991,2136,1892,244,11.4
49,19,Grand,1991,3527,3281,246,7.0
49,21,Iron,1991,9518,9024,494,5.2
49,23,Juab,1991,2984,2824,160,5.4
49,25,Kane,1991,2651,2448,203,7.7
49,27,Millard,1991,4674,4431,243,5.2
49,29,Morgan,1991,2582,2447,135,5.2
49,31,Piute,1991,502,452,50,10.0
49,33,Rich,1991,746,726,20,2.7
49,35,Salt Lake,1991,381474,364971,16503,4.3
49,37,San Juan,1991,4141,3695,446,10.8
49,39,Sanpete,1991,6755,6027,728,10.8
49,41,Sevier,1991,6517,6032,485,7.4
49,43,Summit,1991,8466,7869,597,7.1
49,45,Tooele,1991,12065,11403,662,5.5
49,47,Uintah,1991,9342,8782,560,6.0
49,49,Utah,1991,123188,117712,5476,4.4
49,51,Wasatch,1991,4597,4235,362,7.9
49,53,Washington,1991,21050,20088,962,4.6
49,55,Wayne,1991,962,871,91,9.5
49,57,Weber,1991,79393,75143,4250,5.4
50,1,Addison,1991,18463,17371,1092,5.9
50,3,Bennington,1991,18359,17421,938,5.1
50,5,Caledonia,1991,14485,13479,1006,6.9
50,7,Chittenden,1991,77470,74022,3448,4.5
50,9,Essex,1991,2791,2543,248,8.9
50,11,Franklin,1991,21295,19835,1460,6.9
50,13,Grand Isle,1991,2897,2679,218,7.5
50,15,Lamoille,1991,10326,9482,844,8.2
50,17,Orange,1991,14310,13464,846,5.9
50,19,Orleans,1991,12036,10861,1175,9.8
50,21,Rutland,1991,32310,30297,2013,6.2
50,23,Washington,1991,30160,28202,1958,6.5
50,25,Windham,1991,22280,20999,1281,5.7
50,27,Windsor,1991,29497,27854,1643,5.6
51,1,Accomack,1991,15395,14323,1072,7.0
51,3,Albemarle,1991,35134,33960,1174,3.3
51,5,Alleghany,1991,8907,8027,880,9.9
51,7,Amelia,1991,4547,4254,293,6.4
51,9,Amherst,1991,14745,13867,878,6.0
51,11,Appomattox,1991,6456,6009,447,6.9
51,13,Arlington,1991,108617,104885,3732,3.4
51,15,Augusta,1991,29696,28004,1692,5.7
51,17,Bath,1991,2738,2423,315,11.5
51,19,Bedford,1991,29186,27629,1557,5.3
51,21,Bland,1991,3595,3366,229,6.4
51,23,Botetourt,1991,14341,13537,804,5.6
51,25,Brunswick,1991,7419,6446,973,13.1
51,27,Buchanan,1991,11799,10045,1754,14.9
51,29,Buckingham,1991,5800,5350,450,7.8
51,31,Campbell,1991,26645,25082,1563,5.9
51,33,Caroline,1991,10186,9096,1090,10.7
51,35,Carroll,1991,14105,12812,1293,9.2
51,36,Charles City,1991,3481,3182,299,8.6
51,37,Charlotte,1991,5596,5201,395,7.1
51,41,Chesterfield,1991,125165,119713,5452,4.4
51,43,Clarke,1991,6435,6090,345,5.4
51,45,Craig,1991,2384,2204,180,7.6
51,47,Culpeper,1991,14907,13878,1029,6.9
51,49,Cumberland,1991,4063,3802,261,6.4
51,51,Dickenson,1991,6311,5264,1047,16.6
51,53,Dinwiddie,1991,10744,9987,757,7.0
51,57,Essex,1991,4645,4258,387,8.3
51,59,Fairfax,1991,491856,476571,15285,3.1
51,61,Fauquier,1991,27124,25852,1272,4.7
51,63,Floyd,1991,6398,5727,671,10.5
51,65,Fluvanna,1991,6752,6403,349,5.2
51,67,Franklin,1991,21578,19748,1830,8.5
51,69,Frederick,1991,27180,25151,2029,7.5
51,71,Giles,1991,8532,7652,880,10.3
51,73,Gloucester,1991,15828,15138,690,4.4
51,75,Goochland,1991,7703,7315,388,5.0
51,77,Grayson,1991,8603,7813,790,9.2
51,79,Greene,1991,6081,5618,463,7.6
51,81,Greensville,1991,5192,4770,422,8.1
51,83,Halifax,1991,18560,16968,1592,8.6
51,85,Hanover,1991,37608,35983,1625,4.3
51,87,Henrico,1991,129009,123592,5417,4.2
51,89,Henry,1991,32092,28812,3280,10.2
51,91,Highland,1991,1380,1307,73,5.3
51,93,Isle of Wight,1991,13481,12671,810,6.0
51,95,James City,1991,19894,19236,658,3.3
51,97,King and Queen,1991,3342,3151,191,5.7
51,99,King George,1991,7252,6795,457,6.3
51,101,King William,1991,6396,6083,313,4.9
51,103,Lancaster,1991,5181,4571,610,11.8
51,105,Lee,1991,9647,8652,995,10.3
51,107,Loudoun,1991,54340,52497,1843,3.4
51,109,Louisa,1991,10446,9515,931,8.9
51,111,Lunenburg,1991,5485,4458,1027,18.7
51,113,Madison,1991,6278,5975,303,4.8
51,115,Mathews,1991,4256,4094,162,3.8
51,117,Mecklenburg,1991,14863,13506,1357,9.1
51,119,Middlesex,1991,4185,4025,160,3.8
51,121,Montgomery,1991,37205,34480,2725,7.3
51,125,Nelson,1991,6151,5753,398,6.5
51,127,New Kent,1991,5839,5546,293,5.0
51,131,Northampton,1991,5899,5362,537,9.1
51,133,Northumberland,1991,5136,4598,538,10.5
51,135,Nottoway,1991,6695,6223,472,7.1
51,137,Orange,1991,11013,10096,917,8.3
51,139,Page,1991,11475,10031,1444,12.6
51,141,Patrick,1991,9468,8777,691,7.3
51,143,Pittsylvania,1991,30498,27587,2911,9.5
51,145,Powhatan,1991,7958,7587,371,4.7
51,147,Prince Edward,1991,8249,7392,857,10.4
51,149,Prince George,1991,11391,10835,556,4.9
51,153,Prince William,1991,120743,115992,4751,3.9
51,155,Pulaski,1991,17880,15668,2212,12.4
51,157,Rappahannock,1991,4123,3776,347,8.4
51,159,Richmond,1991,3625,3355,270,7.4
51,161,Roanoke,1991,46089,44259,1830,4.0
51,163,Rockbridge,1991,10144,9332,812,8.0
51,165,Rockingham,1991,33448,31512,1936,5.8
51,167,Russell,1991,12592,10974,1618,12.8
51,169,Scott,1991,9835,8972,863,8.8
51,171,Shenandoah,1991,17244,16190,1054,6.1
51,173,Smyth,1991,17097,15429,1668,9.8
51,175,Southampton,1991,7619,7216,403,5.3
51,177,Spotsylvania,1991,32778,30871,1907,5.8
51,179,Stafford,1991,34423,32736,1687,4.9
51,181,Surry,1991,3229,2937,292,9.0
51,183,Sussex,1991,4883,4385,498,10.2
51,185,Tazewell,1991,19797,17474,2323,11.7
51,187,Warren,1991,14605,13211,1394,9.5
51,191,Washington,1991,24130,22419,1711,7.1
51,193,Westmoreland,1991,7659,6893,766,10.0
51,195,Wise,1991,16120,14003,2117,13.1
51,197,Wythe,1991,13901,12585,1316,9.5
51,199,York,1991,21984,21162,822,3.7
51,510,Alexandria city,1991,74965,71403,3562,4.8
51,520,Bristol city,1991,8702,8105,597,6.9
51,530,Buena Vista city,1991,3607,3225,382,10.6
51,540,Charlottesville city,1991,20432,19502,930,4.6
51,550,Chesapeake city,1991,84492,79970,4522,5.4
51,570,Colonial Heights city,1991,8675,8214,461,5.3
51,580,Covington city,1991,3408,2978,430,12.6
51,590,Danville city,1991,27002,23443,3559,13.2
51,595,Emporia city,1991,2655,2378,277,10.4
51,600,Fairfax city,1991,12253,11983,270,2.2
51,610,Falls Church city,1991,5841,5617,224,3.8
51,620,Franklin city,1991,3692,3475,217,5.9
51,630,Fredericksburg city,1991,10731,9879,852,7.9
51,640,Galax city,1991,3478,3205,273,7.8
51,650,Hampton city,1991,66584,62645,3939,5.9
51,660,Harrisonburg city,1991,16405,15553,852,5.2
51,670,Hopewell city,1991,11509,10493,1016,8.8
51,678,Lexington city,1991,2986,2785,201,6.7
51,680,Lynchburg city,1991,32288,30236,2052,6.4
51,683,Manassas city,1991,17131,16287,844,4.9
51,685,Manassas Park city,1991,3900,3737,163,4.2
51,690,Martinsville city,1991,8319,7221,1098,13.2
51,700,Newport News city,1991,82526,77708,4818,5.8
51,710,Norfolk city,1991,96289,90445,5844,6.1
51,720,Norton city,1991,1657,1494,163,9.8
51,730,Petersburg city,1991,18298,16449,1849,10.1
51,735,Poquoson city,1991,5887,5693,194,3.3
51,740,Portsmouth city,1991,47681,44137,3544,7.4
51,750,Radford city,1991,7059,6419,640,9.1
51,760,Richmond city,1991,104193,96257,7936,7.6
51,770,Roanoke city,1991,50163,46887,3276,6.5
51,775,Salem city,1991,13231,12527,704,5.3
51,790,Staunton city,1991,11627,11044,583,5.0
51,800,Suffolk city,1991,25470,23899,1571,6.2
51,810,Virginia Beach city,1991,198864,189551,9313,4.7
51,820,Waynesboro city,1991,9254,8558,696,7.5
51,830,Williamsburg city,1991,5896,5333,563,9.5
51,840,Winchester city,1991,12876,11695,1181,9.2
53,1,Adams,1991,8040,7046,994,12.4
53,3,Asotin,1991,9564,8978,586,6.1
53,5,Benton,1991,62577,58297,4280,6.8
53,7,Chelan,1991,31874,28556,3318,10.4
53,9,Clallam,1991,23102,21320,1782,7.7
53,11,Clark,1991,129023,121074,7949,6.2
53,13,Columbia,1991,1363,1181,182,13.4
53,15,Cowlitz,1991,38844,35713,3131,8.1
53,17,Douglas,1991,16427,15055,1372,8.4
53,19,Ferry,1991,2768,2424,344,12.4
53,21,Franklin,1991,19945,17604,2341,11.7
53,23,Garfield,1991,1037,1010,27,2.6
53,25,Grant,1991,28814,25919,2895,10.0
53,27,Grays Harbor,1991,27346,24175,3171,11.6
53,29,Island,1991,23068,22058,1010,4.4
53,31,Jefferson,1991,8270,7730,540,6.5
53,33,King,1991,864351,827148,37203,4.3
53,35,Kitsap,1991,86824,82519,4305,5.0
53,37,Kittitas,1991,12959,11721,1238,9.6
53,39,Klickitat,1991,7871,6859,1012,12.9
53,41,Lewis,1991,26359,23647,2712,10.3
53,43,Lincoln,1991,4135,3955,180,4.4
53,45,Mason,1991,15949,14703,1246,7.8
53,47,Okanogan,1991,20233,17993,2240,11.1
53,49,Pacific,1991,7814,7050,764,9.8
53,51,Pend Oreille,1991,3454,2974,480,13.9
53,53,Pierce,1991,279408,262195,17213,6.2
53,55,San Juan,1991,5369,5180,189,3.5
53,57,Skagit,1991,40902,37496,3406,8.3
53,59,Skamania,1991,4024,3524,500,12.4
53,61,Snohomish,1991,256269,243587,12682,4.9
53,63,Spokane,1991,177274,166458,10816,6.1
53,65,Stevens,1991,14000,12673,1327,9.5
53,67,Thurston,1991,83293,78440,4853,5.8
53,69,Wahkiakum,1991,1524,1438,86,5.6
53,71,Walla Walla,1991,23778,21923,1855,7.8
53,73,Whatcom,1991,70058,65480,4578,6.5
53,75,Whitman,1991,17506,17195,311,1.8
53,77,Yakima,1991,103315,90425,12890,12.5
54,1,Barbour,1991,6292,5175,1117,17.8
54,3,Berkeley,1991,30724,27713,3011,9.8
54,5,Boone,1991,8924,7745,1179,13.2
54,7,Braxton,1991,5149,4048,1101,21.4
54,9,Brooke,1991,12044,10913,1131,9.4
54,11,Cabell,1991,43816,39815,4001,9.1
54,13,Calhoun,1991,3065,2431,634,20.7
54,15,Clay,1991,3081,2487,594,19.3
54,17,Doddridge,1991,2781,2580,201,7.2
54,19,Fayette,1991,17326,14946,2380,13.7
54,21,Gilmer,1991,2852,2505,347,12.2
54,23,Grant,1991,5445,4914,531,9.8
54,25,Greenbrier,1991,15626,13425,2201,14.1
54,27,Hampshire,1991,7732,6766,966,12.5
54,29,Hancock,1991,15981,14587,1394,8.7
54,31,Hardy,1991,5393,4931,462,8.6
54,33,Harrison,1991,31027,27791,3236,10.4
54,35,Jackson,1991,13070,11793,1277,9.8
54,37,Jefferson,1991,19448,17532,1916,9.9
54,39,Kanawha,1991,98899,91220,7679,7.8
54,41,Lewis,1991,7467,6503,964,12.9
54,43,Lincoln,1991,7140,5954,1186,16.6
54,45,Logan,1991,14698,12814,1884,12.8
54,47,McDowell,1991,9026,7396,1630,18.1
54,49,Marion,1991,24155,21558,2597,10.8
54,51,Marshall,1991,16510,14795,1715,10.4
54,53,Mason,1991,10084,8695,1389,13.8
54,55,Mercer,1991,28533,25918,2615,9.2
54,57,Mineral,1991,11848,10843,1005,8.5
54,59,Mingo,1991,10262,8880,1382,13.5
54,61,Monongalia,1991,37155,34514,2641,7.1
54,63,Monroe,1991,5160,4540,620,12.0
54,65,Morgan,1991,5882,5392,490,8.3
54,67,Nicholas,1991,10644,8984,1660,15.6
54,69,Ohio,1991,24482,22786,1696,6.9
54,71,Pendleton,1991,3673,3421,252,6.9
54,73,Pleasants,1991,3181,2740,441,13.9
54,75,Pocahontas,1991,4182,3484,698,16.7
54,77,Preston,1991,12326,10923,1403,11.4
54,79,Putnam,1991,21200,19357,1843,8.7
54,81,Raleigh,1991,30404,27045,3359,11.0
54,83,Randolph,1991,12607,10766,1841,14.6
54,85,Ritchie,1991,4502,3855,647,14.4
54,87,Roane,1991,6018,5014,1004,16.7
54,89,Summers,1991,4827,4286,541,11.2
54,91,Taylor,1991,6388,5609,779,12.2
54,93,Tucker,1991,3638,3164,474,13.0
54,95,Tyler,1991,4140,3723,417,10.1
54,97,Upshur,1991,10230,8667,1563,15.3
54,99,Wayne,1991,16972,15082,1890,11.1
54,101,Webster,1991,3372,2730,642,19.0
54,103,Wetzel,1991,7888,6866,1022,13.0
54,105,Wirt,1991,2019,1599,420,20.8
54,107,Wood,1991,42874,39102,3772,8.8
54,109,Wyoming,1991,8416,7343,1073,12.7
55,1,Adams,1991,6414,6012,402,6.3
55,3,Ashland,1991,7559,6863,696,9.2
55,5,Barron,1991,21611,20162,1449,6.7
55,7,Bayfield,1991,6653,6095,558,8.4
55,9,Brown,1991,109042,103876,5166,4.7
55,11,Buffalo,1991,7114,6629,485,6.8
55,13,Burnett,1991,5990,5536,454,7.6
55,15,Calumet,1991,21794,20330,1464,6.7
55,17,Chippewa,1991,26329,24721,1608,6.1
55,19,Clark,1991,15637,14348,1289,8.2
55,21,Columbia,1991,25440,23949,1491,5.9
55,23,Crawford,1991,8432,7895,537,6.4
55,25,Dane,1991,220960,215701,5259,2.4
55,27,Dodge,1991,39714,37430,2284,5.8
55,29,Door,1991,14606,13482,1124,7.7
55,31,Douglas,1991,20146,18730,1416,7.0
55,33,Dunn,1991,19056,18008,1048,5.5
55,35,Eau Claire,1991,44601,42095,2506,5.6
55,37,Florence,1991,1447,1269,178,12.3
55,39,Fond du Lac,1991,52089,49544,2545,4.9
55,41,Forest,1991,3657,3321,336,9.2
55,43,Grant,1991,27171,25732,1439,5.3
55,45,Green,1991,17387,16389,998,5.7
55,47,Green Lake,1991,10187,9502,685,6.7
55,49,Iowa,1991,12696,12116,580,4.6
55,51,Iron,1991,2860,2635,225,7.9
55,53,Jackson,1991,8409,7710,699,8.3
55,55,Jefferson,1991,38089,36007,2082,5.5
55,57,Juneau,1991,10689,9883,806,7.5
55,59,Kenosha,1991,68765,64626,4139,6.0
55,61,Kewaunee,1991,9899,9248,651,6.6
55,63,La Crosse,1991,53871,51592,2279,4.2
55,65,Lafayette,1991,8308,7903,405,4.9
55,67,Langlade,1991,8846,8303,543,6.1
55,69,Lincoln,1991,13885,12869,1016,7.3
55,71,Manitowoc,1991,42253,39915,2338,5.5
55,73,Marathon,1991,63701,60304,3397,5.3
55,75,Marinette,1991,19549,17788,1761,9.0
55,77,Marquette,1991,6158,5709,449,7.3
55,78,Menominee,1991,1509,1382,127,8.4
55,79,Milwaukee,1991,470899,445569,25330,5.4
55,81,Monroe,1991,18499,17258,1241,6.7
55,83,Oconto,1991,14417,12921,1496,10.4
55,85,Oneida,1991,16456,15635,821,5.0
55,87,Outagamie,1991,85557,82382,3175,3.7
55,89,Ozaukee,1991,41592,39984,1608,3.9
55,91,Pepin,1991,3414,3159,255,7.5
55,93,Pierce,1991,18318,17353,965,5.3
55,95,Polk,1991,17514,16184,1330,7.6
55,97,Portage,1991,34885,33466,1419,4.1
55,99,Price,1991,7318,6769,549,7.5
55,101,Racine,1991,90351,84423,5928,6.6
55,103,Richland,1991,8263,7704,559,6.8
55,105,Rock,1991,74286,65123,9163,12.3
55,107,Rusk,1991,6724,6014,710,10.6
55,109,St. Croix,1991,27750,26198,1552,5.6
55,111,Sauk,1991,26453,24754,1699,6.4
55,113,Sawyer,1991,6810,6275,535,7.9
55,115,Shawano,1991,18382,17106,1276,6.9
55,117,Sheboygan,1991,55803,52683,3120,5.6
55,119,Taylor,1991,9996,9138,858,8.6
55,121,Trempealeau,1991,13322,12271,1051,7.9
55,123,Vernon,1991,12453,11656,797,6.4
55,125,Vilas,1991,8498,7991,507,6.0
55,127,Walworth,1991,45085,43433,1652,3.7
55,129,Washburn,1991,6751,6229,522,7.7
55,131,Washington,1991,54880,52212,2668,4.9
55,133,Waukesha,1991,176235,168980,7255,4.1
55,135,Waupaca,1991,23629,22372,1257,5.3
55,137,Waushara,1991,9128,8461,667,7.3
55,139,Winnebago,1991,85287,82155,3132,3.7
55,141,Wood,1991,38115,36383,1732,4.5
56,1,Albany,1991,16342,15798,544,3.3
56,3,Big Horn,1991,4768,4488,280,5.9
56,5,Campbell,1991,16720,15940,780,4.7
56,7,Carbon,1991,8697,8221,476,5.5
56,9,Converse,1991,5804,5519,285,4.9
56,11,Crook,1991,2703,2627,76,2.8
56,13,Fremont,1991,15705,14660,1045,6.7
56,15,Goshen,1991,5959,5738,221,3.7
56,17,Hot Springs,1991,2444,2338,106,4.3
56,19,Johnson,1991,3375,3206,169,5.0
56,21,Laramie,1991,36366,34934,1432,3.9
56,23,Lincoln,1991,6050,5629,421,7.0
56,25,Natrona,1991,31724,29823,1901,6.0
56,27,Niobrara,1991,1176,1130,46,3.9
56,29,Park,1991,13186,12632,554,4.2
56,31,Platte,1991,3832,3646,186,4.9
56,33,Sheridan,1991,12176,11471,705,5.8
56,35,Sublette,1991,2736,2663,73,2.7
56,37,Sweetwater,1991,20776,19583,1193,5.7
56,39,Teton,1991,8591,8392,199,2.3
56,41,Uinta,1991,10121,9420,701,6.9
56,43,Washakie,1991,4303,4113,190,4.4
56,45,Weston,1991,3211,3068,143,4.5
72,1,Adjuntas Municipio,1991,5021,4214,807,16.1
72,3,Aguada Municipio,1991,13508,10630,2878,21.3
72,5,Aguadilla Municipio,1991,19220,15250,3970,20.7
72,7,Aguas Buenas Municipio,1991,7745,6191,1554,20.1
72,9,Aibonito Municipio,1991,9308,8206,1102,11.8
72,11,Anasco Municipio,1991,9606,7577,2029,21.1
72,13,Arecibo Municipio,1991,30014,24616,5398,18.0
72,15,Arroyo Municipio,1991,4961,3769,1192,24.0
72,17,Barceloneta Municipio,1991,6531,4998,1533,23.5
72,19,Barranquitas Municipio,1991,6506,5608,898,13.8
72,21,Bayamon Municipio,1991,80162,70864,9298,11.6
72,23,Cabo Rojo Municipio,1991,13188,10946,2242,17.0
72,25,Caguas Municipio,1991,51778,44004,7774,15.0
72,27,Camuy Municipio,1991,9316,7622,1694,18.2
72,29,Canovanas Municipio,1991,12130,10076,2054,16.9
72,31,Carolina Municipio,1991,70921,63791,7130,10.1
72,33,Catano Municipio,1991,10323,9004,1319,12.8
72,35,Cayey Municipio,1991,15027,12119,2908,19.4
72,37,Ceiba Municipio,1991,5256,4292,964,18.3
72,39,Ciales Municipio,1991,4997,4026,971,19.4
72,41,Cidra Municipio,1991,11249,9497,1752,15.6
72,43,Coamo Municipio,1991,9286,7444,1842,19.8
72,45,Comerio Municipio,1991,5518,4433,1085,19.7
72,47,Corozal Municipio,1991,8913,7570,1343,15.1
72,49,Culebra Municipio,1991,737,713,24,3.3
72,51,Dorado Municipio,1991,9768,8384,1384,14.2
72,53,Fajardo Municipio,1991,12695,10224,2471,19.5
72,54,Florida Municipio,1991,2717,2048,669,24.6
72,55,Guanica Municipio,1991,4923,3745,1178,23.9
72,57,Guayama Municipio,1991,10585,8090,2495,23.6
72,59,Guayanilla Municipio,1991,6287,4787,1500,23.9
72,61,Guaynabo Municipio,1991,35186,32740,2446,7.0
72,63,Gurabo Municipio,1991,9771,8063,1708,17.5
72,65,Hatillo Municipio,1991,10035,8271,1764,17.6
72,67,Hormigueros Municipio,1991,6262,5182,1080,17.2
72,69,Humacao Municipio,1991,18836,15056,3780,20.1
72,71,Isabela Municipio,1991,12570,10192,2378,18.9
72,73,Jayuya Municipio,1991,3670,3164,506,13.8
72,75,Juana Diaz Municipio,1991,12507,9620,2887,23.1
72,77,Juncos Municipio,1991,9230,7485,1745,18.9
72,79,Lajas Municipio,1991,7632,6180,1452,19.0
72,81,Lares Municipio,1991,7522,5959,1563,20.8
72,83,Las Marias Municipio,1991,3529,3022,507,14.4
72,85,Las Piedras Municipio,1991,9104,7336,1768,19.4
72,87,Loiza Municipio,1991,8204,7125,1079,13.2
72,89,Luquillo Municipio,1991,6220,4831,1389,22.3
72,91,Manati Municipio,1991,12544,9964,2580,20.6
72,93,Maricao Municipio,1991,1963,1707,256,13.0
72,95,Maunabo Municipio,1991,2936,2183,753,25.6
72,97,Mayaguez Municipio,1991,34916,28786,6130,17.6
72,99,Moca Municipio,1991,11522,8747,2775,24.1
72,101,Morovis Municipio,1991,7317,6013,1304,17.8
72,103,Naguabo Municipio,1991,6276,5083,1193,19.0
72,105,Naranjito Municipio,1991,6777,5586,1191,17.6
72,107,Orocovis Municipio,1991,5407,4512,895,16.6
72,109,Patillas Municipio,1991,5367,3935,1432,26.7
72,111,Penuelas Municipio,1991,6444,4946,1498,23.2
72,113,Ponce Municipio,1991,57786,46950,10836,18.8
72,115,Quebradillas Municipio,1991,6914,5658,1256,18.2
72,117,Rincon Municipio,1991,5240,4346,894,17.1
72,119,Rio Grande Municipio,1991,15272,12777,2495,16.3
72,121,Sabana Grande Municipio,1991,7841,6452,1389,17.7
72,123,Salinas Municipio,1991,7934,5645,2289,28.9
72,125,San German Municipio,1991,12314,9922,2392,19.4
72,127,San Juan Municipio,1991,157638,140297,17341,11.0
72,129,San Lorenzo Municipio,1991,11157,8988,2169,19.4
72,131,San Sebastian Municipio,1991,12473,8954,3519,28.2
72,133,Santa Isabel Municipio,1991,5187,3755,1432,27.6
72,135,Toa Alta Municipio,1991,14959,12948,2011,13.4
72,137,Toa Baja Municipio,1991,31826,28833,2993,9.4
72,139,Trujillo Alto Municipio,1991,22975,20848,2127,9.3
72,141,Utuado Municipio,1991,8499,6862,1637,19.3
72,143,Vega Alta Municipio,1991,10869,9029,1840,16.9
72,145,Vega Baja Municipio,1991,17476,14235,3241,18.5
72,147,Vieques Municipio,1991,2588,2183,405,15.6
72,149,Villalba Municipio,1991,5986,4507,1479,24.7
72,151,Yabucoa Municipio,1991,10995,8252,2743,24.9
72,153,Yauco Municipio,1991,12762,9982,2780,21.8
1,1,Autauga,1992,17629,16482,1147,6.5
1,3,Baldwin,1992,52129,48869,3260,6.3
1,5,Barbour,1992,11592,10347,1245,10.7
1,7,Bibb,1992,7976,7094,882,11.1
1,9,Blount,1992,19522,18315,1207,6.2
1,11,Bullock,1992,4295,3654,641,14.9
1,13,Butler,1992,8904,7823,1081,12.1
1,15,Calhoun,1992,53138,48427,4711,8.9
1,17,Chambers,1992,17222,15857,1365,7.9
1,19,Cherokee,1992,9553,8876,677,7.1
1,21,Chilton,1992,15660,14088,1572,10.0
1,23,Choctaw,1992,6979,6180,799,11.4
1,25,Clarke,1992,12846,11181,1665,13.0
1,27,Clay,1992,6459,6018,441,6.8
1,29,Cleburne,1992,7088,6625,463,6.5
1,31,Coffee,1992,19833,18644,1189,6.0
1,33,Colbert,1992,25177,22976,2201,8.7
1,35,Conecuh,1992,6083,5279,804,13.2
1,37,Coosa,1992,5035,4740,295,5.9
1,39,Covington,1992,16880,15082,1798,10.7
1,41,Crenshaw,1992,6190,5645,545,8.8
1,43,Cullman,1992,34457,32014,2443,7.1
1,45,Dale,1992,20776,19336,1440,6.9
1,47,Dallas,1992,20221,17445,2776,13.7
1,49,DeKalb,1992,28230,26250,1980,7.0
1,51,Elmore,1992,23802,22276,1526,6.4
1,53,Escambia,1992,15767,13874,1893,12.0
1,55,Etowah,1992,46500,42419,4081,8.8
1,57,Fayette,1992,8630,7874,756,8.8
1,59,Franklin,1992,14912,13709,1203,8.1
1,61,Geneva,1992,11954,11360,594,5.0
1,63,Greene,1992,3797,3282,515,13.6
1,65,Hale,1992,6414,5756,658,10.3
1,67,Henry,1992,6751,6224,527,7.8
1,69,Houston,1992,41871,39553,2318,5.5
1,71,Jackson,1992,24912,22238,2674,10.7
1,73,Jefferson,1992,315818,296757,19061,6.0
1,75,Lamar,1992,7754,7017,737,9.5
1,77,Lauderdale,1992,39309,36567,2742,7.0
1,79,Lawrence,1992,15207,13648,1559,10.3
1,81,Lee,1992,43903,41454,2449,5.6
1,83,Limestone,1992,27282,25373,1909,7.0
1,85,Lowndes,1992,4444,3665,779,17.5
1,87,Macon,1992,8872,8018,854,9.6
1,89,Madison,1992,131139,124578,6561,5.0
1,91,Marengo,1992,10704,9619,1085,10.1
1,93,Marion,1992,14140,12871,1269,9.0
1,95,Marshall,1992,35738,32687,3051,8.5
1,97,Mobile,1992,182095,167184,14911,8.2
1,99,Monroe,1992,10656,8650,2006,18.8
1,101,Montgomery,1992,102582,96166,6416,6.3
1,103,Morgan,1992,50859,46960,3899,7.7
1,105,Perry,1992,4898,4227,671,13.7
1,107,Pickens,1992,9034,8052,982,10.9
1,109,Pike,1992,12407,11462,945,7.6
1,111,Randolph,1992,9644,8905,739,7.7
1,113,Russell,1992,21748,20014,1734,8.0
1,115,St. Clair,1992,25038,23328,1710,6.8
1,117,Shelby,1992,57335,54980,2355,4.1
1,119,Sumter,1992,6113,5341,772,12.6
1,121,Talladega,1992,34723,31271,3452,9.9
1,123,Tallapoosa,1992,19404,18414,990,5.1
1,125,Tuscaloosa,1992,70490,66335,4155,5.9
1,127,Walker,1992,30404,26668,3736,12.3
1,129,Washington,1992,6415,5331,1084,16.9
1,131,Wilcox,1992,4069,3342,727,17.9
1,133,Winston,1992,10908,9885,1023,9.4
2,13,Aleutians East Borough,1992,1587,1564,23,1.4
2,16,Aleutians West Census Area,1992,3891,3849,42,1.1
2,20,Anchorage Borough/municipality,1992,127412,118410,9002,7.1
2,50,Bethel Census Area,1992,5140,4694,446,8.7
2,60,Bristol Bay Borough,1992,614,580,34,5.5
2,68,Denali Borough,1992,1045,945,100,9.6
2,70,Dillingham Census Area,1992,1567,1440,127,8.1
2,90,Fairbanks North Star Borough,1992,38792,35131,3661,9.4
2,100,Haines Borough,1992,1114,981,133,11.9
2,110,Juneau Borough/city,1992,16058,14962,1096,6.8
2,122,Kenai Peninsula Borough,1992,20116,17128,2988,14.9
2,130,Ketchikan Gateway Borough,1992,7633,6932,701,9.2
2,150,Kodiak Island Borough,1992,6899,6189,710,10.3
2,158,Kusilvak Census Area,1992,1707,1524,183,10.7
2,164,Lake and Peninsula Borough,1992,566,516,50,8.8
2,170,Matanuska-Susitna Borough,1992,21064,18323,2741,13.0
2,180,Nome Census Area,1992,3148,2757,391,12.4
2,185,North Slope Borough,1992,2843,2723,120,4.2
2,188,Northwest Arctic Borough,1992,2168,1729,439,20.2
2,201,Prince of Wales-Outer Ketchikan Census Area,1992,2975,2611,364,12.2
2,220,Sitka Borough/city,1992,4615,4346,269,5.8
2,232,Skagway-Hoonah-Angoon Census Area,1992,2495,2233,262,10.5
2,240,Southeast Fairbanks Census Area,1992,2214,1931,283,12.8
2,261,Valdez-Cordova Census Area,1992,5071,4557,514,10.1
2,280,Wrangell-Petersburg Census Area,1992,3627,3276,351,9.7
2,290,Yukon-Koyukuk Census Area,1992,2064,1699,365,17.7
4,1,Apache,1992,18745,15694,3051,16.3
4,3,Cochise,1992,39113,35382,3731,9.5
4,5,Coconino,1992,52681,47760,4921,9.3
4,7,Gila,1992,16901,15021,1880,11.1
4,9,Graham,1992,9854,8852,1002,10.2
4,11,Greenlee,1992,3937,3538,399,10.1
4,12,La Paz,1992,5464,4699,765,14.0
4,13,Maricopa,1992,1147507,1073199,74308,6.5
4,15,Mohave,1992,48627,44010,4617,9.5
4,17,Navajo,1992,28247,23908,4339,15.4
4,19,Pima,1992,337433,319022,18411,5.5
4,21,Pinal,1992,46806,42712,4094,8.7
4,23,Santa Cruz,1992,13664,11277,2387,17.5
4,25,Yavapai,1992,51634,47934,3700,7.2
4,27,Yuma,1992,54829,40251,14578,26.6
5,1,Arkansas,1992,10382,9693,689,6.6
5,3,Ashley,1992,11180,10362,818,7.3
5,5,Baxter,1992,12538,11897,641,5.1
5,7,Benton,1992,52370,50661,1709,3.3
5,9,Boone,1992,14103,13348,755,5.4
5,11,Bradley,1992,5035,4526,509,10.1
5,13,Calhoun,1992,2422,2179,243,10.0
5,15,Carroll,1992,11114,10488,626,5.6
5,17,Chicot,1992,6343,5659,684,10.8
5,19,Clark,1992,10452,9965,487,4.7
5,21,Clay,1992,8184,7515,669,8.2
5,23,Cleburne,1992,8827,7914,913,10.3
5,25,Cleveland,1992,3902,3635,267,6.8
5,27,Columbia,1992,11869,10992,877,7.4
5,29,Conway,1992,9554,8758,796,8.3
5,31,Craighead,1992,38070,35730,2340,6.1
5,33,Crawford,1992,21603,19839,1764,8.2
5,35,Crittenden,1992,21910,20232,1678,7.7
5,37,Cross,1992,8864,8085,779,8.8
5,39,Dallas,1992,3986,3667,319,8.0
5,41,Desha,1992,7025,6245,780,11.1
5,43,Drew,1992,9065,8366,699,7.7
5,45,Faulkner,1992,34341,31794,2547,7.4
5,47,Franklin,1992,7359,6870,489,6.6
5,49,Fulton,1992,4275,4039,236,5.5
5,51,Garland,1992,33635,30841,2794,8.3
5,53,Grant,1992,7148,6641,507,7.1
5,55,Greene,1992,15976,14906,1070,6.7
5,57,Hempstead,1992,10654,9901,753,7.1
5,59,Hot Spring,1992,11631,10499,1132,9.7
5,61,Howard,1992,6600,6173,427,6.5
5,63,Independence,1992,16167,15097,1070,6.6
5,65,Izard,1992,4244,3863,381,9.0
5,67,Jackson,1992,8370,7331,1039,12.4
5,69,Jefferson,1992,38175,33987,4188,11.0
5,71,Johnson,1992,8513,7993,520,6.1
5,73,Lafayette,1992,3595,3283,312,8.7
5,75,Lawrence,1992,7692,7047,645,8.4
5,77,Lee,1992,4736,4131,605,12.8
5,79,Lincoln,1992,5071,4580,491,9.7
5,81,Little River,1992,5672,5131,541,9.5
5,83,Logan,1992,9795,9135,660,6.7
5,85,Lonoke,1992,20403,19314,1089,5.3
5,87,Madison,1992,6842,6532,310,4.5
5,89,Marion,1992,5115,4855,260,5.1
5,91,Miller,1992,17139,15852,1287,7.5
5,93,Mississippi,1992,26907,24114,2793,10.4
5,95,Monroe,1992,4429,3923,506,11.4
5,97,Montgomery,1992,3657,3483,174,4.8
5,99,Nevada,1992,4588,4283,305,6.6
5,101,Newton,1992,2866,2691,175,6.1
5,103,Ouachita,1992,13129,11639,1490,11.3
5,105,Perry,1992,3670,3295,375,10.2
5,107,Phillips,1992,10919,9744,1175,10.8
5,109,Pike,1992,4581,4216,365,8.0
5,111,Poinsett,1992,10919,10075,844,7.7
5,113,Polk,1992,7750,7283,467,6.0
5,115,Pope,1992,25195,23714,1481,5.9
5,117,Prairie,1992,3989,3461,528,13.2
5,119,Pulaski,1992,190119,179452,10667,5.6
5,121,Randolph,1992,7298,6546,752,10.3
5,123,St. Francis,1992,11713,10344,1369,11.7
5,125,Saline,1992,35401,33325,2076,5.9
5,127,Scott,1992,4887,4691,196,4.0
5,129,Searcy,1992,3031,2793,238,7.9
5,131,Sebastian,1992,53279,49508,3771,7.1
5,133,Sevier,1992,7001,6585,416,5.9
5,135,Sharp,1992,5464,5043,421,7.7
5,137,Stone,1992,4605,4300,305,6.6
5,139,Union,1992,21124,19596,1528,7.2
5,141,Van Buren,1992,5840,5274,566,9.7
5,143,Washington,1992,64376,62013,2363,3.7
5,145,White,1992,27735,25262,2473,8.9
5,147,Woodruff,1992,4023,3454,569,14.1
5,149,Yell,1992,9025,8564,461,5.1
6,1,Alameda,1992,676844,632143,44701,6.6
6,3,Alpine,1992,348,290,58,16.7
6,5,Amador,1992,12709,11534,1175,9.2
6,7,Butte,1992,81972,72224,9748,11.9
6,9,Calaveras,1992,15026,13213,1813,12.1
6,11,Colusa,1992,8227,6444,1783,21.7
6,13,Contra Costa,1992,441907,412696,29211,6.6
6,15,Del Norte,1992,9845,8316,1529,15.5
6,17,El Dorado,1992,67225,61475,5750,8.6
6,19,Fresno,1992,352686,297613,55073,15.6
6,21,Glenn,1992,11403,9231,2172,19.0
6,23,Humboldt,1992,58905,52985,5920,10.1
6,25,Imperial,1992,53964,37279,16685,30.9
6,27,Inyo,1992,7165,6336,829,11.6
6,29,Kern,1992,272956,229852,43104,15.8
6,31,Kings,1992,40602,34392,6210,15.3
6,33,Lake,1992,22340,19454,2886,12.9
6,35,Lassen,1992,10768,9530,1238,11.5
6,37,Los Angeles,1992,4445526,4007915,437611,9.8
6,39,Madera,1992,46882,39013,7869,16.8
6,41,Marin,1992,130413,123790,6623,5.1
6,43,Mariposa,1992,7159,6529,630,8.8
6,45,Mendocino,1992,39779,34868,4911,12.3
6,47,Merced,1992,83022,68534,14488,17.5
6,49,Modoc,1992,4011,3495,516,12.9
6,51,Mono,1992,5819,5199,620,10.7
6,53,Monterey,1992,177080,155007,22073,12.5
6,55,Napa,1992,57503,53346,4157,7.2
6,57,Nevada,1992,39576,36209,3367,8.5
6,59,Orange,1992,1330284,1240988,89296,6.7
6,61,Placer,1992,93422,85481,7941,8.5
6,63,Plumas,1992,9678,8319,1359,14.0
6,65,Riverside,1992,576055,507395,68660,11.9
6,67,Sacramento,1992,528783,484762,44021,8.3
6,69,San Benito,1992,21908,18092,3816,17.4
6,71,San Bernardino,1992,668462,603899,64563,9.7
6,73,San Diego,1992,1213104,1124640,88464,7.3
6,75,San Francisco/city,1992,404677,376862,27815,6.9
6,77,San Joaquin,1992,239447,205455,33992,14.2
6,79,San Luis Obispo,1992,99563,92075,7488,7.5
6,81,San Mateo,1992,367975,349111,18864,5.1
6,83,Santa Barbara,1992,192980,178564,14416,7.5
6,85,Santa Clara,1992,846404,788105,58299,6.9
6,87,Santa Cruz,1992,138967,125421,13546,9.7
6,89,Shasta,1992,72893,63305,9588,13.2
6,91,Sierra,1992,1709,1518,191,11.2
6,93,Siskiyou,1992,19404,16343,3061,15.8
6,95,Solano,1992,173088,160250,12838,7.4
6,97,Sonoma,1992,217125,201720,15405,7.1
6,99,Stanislaus,1992,191813,160063,31750,16.6
6,101,Sutter,1992,34132,27400,6732,19.7
6,103,Tehama,1992,23024,20050,2974,12.9
6,105,Trinity,1992,5268,4377,891,16.9
6,107,Tulare,1992,154174,127100,27074,17.6
6,109,Tuolumne,1992,20753,18399,2354,11.3
6,111,Ventura,1992,372915,339280,33635,9.0
6,113,Yolo,1992,81833,75034,6799,8.3
6,115,Yuba,1992,22368,18468,3900,17.4
8,1,Adams,1992,145853,137205,8648,5.9
8,3,Alamosa,1992,6972,6394,578,8.3
8,5,Arapahoe,1992,237815,226517,11298,4.8
8,7,Archuleta,1992,2821,2583,238,8.4
8,9,Baca,1992,2051,1979,72,3.5
8,11,Bent,1992,2066,1945,121,5.9
8,13,Boulder,1992,132688,125936,6752,5.1
8,14,Broomfield/city,1992,15034,14455,579,3.9
8,15,Chaffee,1992,6151,5720,431,7.0
8,17,Cheyenne,1992,1242,1196,46,3.7
8,19,Clear Creek,1992,4629,4377,252,5.4
8,21,Conejos,1992,3138,2743,395,12.6
8,23,Costilla,1992,1605,1439,166,10.3
8,25,Crowley,1992,1159,1086,73,6.3
8,27,Custer,1992,1143,1065,78,6.8
8,29,Delta,1992,8760,7949,811,9.3
8,31,Denver/city,1992,258938,241458,17480,6.8
8,33,Dolores,1992,725,605,120,16.6
8,35,Douglas,1992,41568,39946,1622,3.9
8,37,Eagle,1992,14092,13134,958,6.8
8,39,Elbert,1992,6246,5891,355,5.7
8,41,El Paso,1992,199616,185099,14517,7.3
8,43,Fremont,1992,14314,13041,1273,8.9
8,45,Garfield,1992,17182,15628,1554,9.0
8,47,Gilpin,1992,2817,2676,141,5.0
8,49,Grand,1992,4683,4399,284,6.1
8,51,Gunnison,1992,6413,5896,517,8.1
8,53,Hinsdale,1992,467,435,32,6.9
8,55,Huerfano,1992,2632,2367,265,10.1
8,57,Jackson,1992,967,904,63,6.5
8,59,Jefferson,1992,261635,249271,12364,4.7
8,61,Kiowa,1992,816,778,38,4.7
8,63,Kit Carson,1992,3262,3114,148,4.5
8,65,Lake,1992,2970,2659,311,10.5
8,67,La Plata,1992,19258,17920,1338,6.9
8,69,Larimer,1992,109813,104076,5737,5.2
8,71,Las Animas,1992,5535,4939,596,10.8
8,73,Lincoln,1992,2522,2414,108,4.3
8,75,Logan,1992,8416,7949,467,5.5
8,77,Mesa,1992,48111,44271,3840,8.0
8,79,Mineral,1992,356,330,26,7.3
8,81,Moffat,1992,6191,5657,534,8.6
8,83,Montezuma,1992,9959,8964,995,10.0
8,85,Montrose,1992,12485,11464,1021,8.2
8,87,Morgan,1992,11274,10685,589,5.2
8,89,Otero,1992,8368,7734,634,7.6
8,91,Ouray,1992,1316,1213,103,7.8
8,93,Park,1992,4946,4603,343,6.9
8,95,Phillips,1992,1729,1667,62,3.6
8,97,Pitkin,1992,7936,7232,704,8.9
8,99,Prowers,1992,5948,5569,379,6.4
8,101,Pueblo,1992,53165,48120,5045,9.5
8,103,Rio Blanco,1992,3512,3288,224,6.4
8,105,Rio Grande,1992,5072,4441,631,12.4
8,107,Routt,1992,8884,8260,624,7.0
8,109,Saguache,1992,2365,2037,328,13.9
8,111,San Juan,1992,369,238,131,35.5
8,113,San Miguel,1992,3183,2954,229,7.2
8,115,Sedgwick,1992,1198,1149,49,4.1
8,117,Summit,1992,9065,8545,520,5.7
8,119,Teller,1992,8818,8183,635,7.2
8,121,Washington,1992,2164,2081,83,3.8
8,123,Weld,1992,69327,65226,4101,5.9
8,125,Yuma,1992,3887,3742,145,3.7
9,1,Fairfield,1992,462095,431613,30482,6.6
9,3,Hartford,1992,463663,427496,36167,7.8
9,5,Litchfield,1992,105864,98389,7475,7.1
9,7,Middlesex,1992,83726,78338,5388,6.4
9,9,New Haven,1992,440562,405912,34650,7.9
9,11,New London,1992,131949,122780,9169,6.9
9,13,Tolland,1992,74215,69465,4750,6.4
9,15,Windham,1992,56709,51629,5080,9.0
10,1,Kent,1992,64651,61065,3586,5.5
10,3,New Castle,1992,237619,224805,12814,5.4
10,5,Sussex,1992,64719,61887,2832,4.4
11,1,District of Colu,1992,317069,289912,27157,8.6
12,1,Alachua,1992,96154,91391,4763,5.0
12,3,Baker,1992,8801,7813,988,11.2
12,5,Bay,1992,63511,57382,6129,9.7
12,7,Bradford,1992,9708,9038,670,6.9
12,9,Brevard,1992,210783,193314,17469,8.3
12,11,Broward,1992,691923,630093,61830,8.9
12,13,Calhoun,1992,4635,4222,413,8.9
12,15,Charlotte,1992,44445,41006,3439,7.7
12,17,Citrus,1992,33773,30392,3381,10.0
12,19,Clay,1992,56472,53175,3297,5.8
12,21,Collier,1992,76932,69277,7655,10.0
12,23,Columbia,1992,21147,18909,2238,10.6
12,27,DeSoto,1992,10108,9048,1060,10.5
12,29,Dixie,1992,3831,3426,405,10.6
12,31,Duval,1992,358363,332525,25838,7.2
12,33,Escambia,1992,122875,115640,7235,5.9
12,35,Flagler,1992,12975,11946,1029,7.9
12,37,Franklin,1992,4392,4109,283,6.4
12,39,Gadsden,1992,18672,17282,1390,7.4
12,41,Gilchrist,1992,4086,3789,297,7.3
12,43,Glades,1992,3449,3031,418,12.1
12,45,Gulf,1992,5509,5028,481,8.7
12,47,Hamilton,1992,4128,3572,556,13.5
12,49,Hardee,1992,9769,8256,1513,15.5
12,51,Hendry,1992,15475,12905,2570,16.6
12,53,Hernando,1992,38582,34851,3731,9.7
12,55,Highlands,1992,27121,24174,2947,10.9
12,57,Hillsborough,1992,465423,430487,34936,7.5
12,59,Holmes,1992,6423,5879,544,8.5
12,61,Indian River,1992,40155,34603,5552,13.8
12,63,Jackson,1992,19816,18376,1440,7.3
12,65,Jefferson,1992,5673,5343,330,5.8
12,67,Lafayette,1992,2306,2161,145,6.3
12,69,Lake,1992,68906,62654,6252,9.1
12,71,Lee,1992,161791,149163,12628,7.8
12,73,Leon,1992,117462,112687,4775,4.1
12,75,Levy,1992,10996,10112,884,8.0
12,77,Liberty,1992,2355,2240,115,4.9
12,79,Madison,1992,6854,6295,559,8.2
12,81,Manatee,1992,102810,96281,6529,6.4
12,83,Marion,1992,87215,79369,7846,9.0
12,85,Martin,1992,45229,40038,5191,11.5
12,86,Miami-Dade,1992,986854,899456,87398,8.9
12,87,Monroe,1992,41344,39323,2021,4.9
12,89,Nassau,1992,23716,21887,1829,7.7
12,91,Okaloosa,1992,68936,64472,4464,6.5
12,93,Okeechobee,1992,14698,12928,1770,12.0
12,95,Orange,1992,405549,373886,31663,7.8
12,97,Osceola,1992,64024,58769,5255,8.2
12,99,Palm Beach,1992,446896,398332,48564,10.9
12,101,Pasco,1992,111421,101479,9942,8.9
12,103,Pinellas,1992,423487,394104,29383,6.9
12,105,Polk,1992,198658,175952,22706,11.4
12,107,Putnam,1992,29059,26414,2645,9.1
12,109,St. Johns,1992,46041,43041,3000,6.5
12,111,St. Lucie,1992,73698,61464,12234,16.6
12,113,Santa Rosa,1992,42265,39906,2359,5.6
12,115,Sarasota,1992,132270,124677,7593,5.7
12,117,Seminole,1992,178295,165054,13241,7.4
12,119,Sumter,1992,12233,11176,1057,8.6
12,121,Suwannee,1992,12545,11267,1278,10.2
12,123,Taylor,1992,7963,6895,1068,13.4
12,125,Union,1992,3806,3584,222,5.8
12,127,Volusia,1992,171827,158026,13801,8.0
12,129,Wakulla,1992,8546,8096,450,5.3
12,131,Walton,1992,13463,12711,752,5.6
12,133,Washington,1992,7864,7233,631,8.0
13,1,Appling,1992,7982,7018,964,12.1
13,3,Atkinson,1992,2714,2472,242,8.9
13,5,Bacon,1992,4568,4185,383,8.4
13,7,Baker,1992,1489,1221,268,18.0
13,9,Baldwin,1992,17113,16165,948,5.5
13,11,Banks,1992,5963,5612,351,5.9
13,13,Barrow,1992,15881,14679,1202,7.6
13,15,Bartow,1992,30972,28539,2433,7.9
13,17,Ben Hill,1992,7563,7064,499,6.6
13,19,Berrien,1992,6638,6153,485,7.3
13,21,Bibb,1992,69915,65468,4447,6.4
13,23,Bleckley,1992,5086,4830,256,5.0
13,25,Brantley,1992,4744,4258,486,10.2
13,27,Brooks,1992,6545,6241,304,4.6
13,29,Bryan,1992,8008,7578,430,5.4
13,31,Bulloch,1992,20809,19854,955,4.6
13,33,Burke,1992,8564,7280,1284,15.0
13,35,Butts,1992,6885,6256,629,9.1
13,37,Calhoun,1992,2180,1909,271,12.4
13,39,Camden,1992,14496,13701,795,5.5
13,43,Candler,1992,3635,3414,221,6.1
13,45,Carroll,1992,37250,34692,2558,6.9
13,47,Catoosa,1992,22608,21316,1292,5.7
13,49,Charlton,1992,3824,3583,241,6.3
13,51,Chatham,1992,104322,97667,6655,6.4
13,53,Chattahoochee,1992,2146,1933,213,9.9
13,55,Chattooga,1992,11515,10592,923,8.0
13,57,Cherokee,1992,56297,53505,2792,5.0
13,59,Clarke,1992,42608,40648,1960,4.6
13,61,Clay,1992,1520,1412,108,7.1
13,63,Clayton,1992,105450,98167,7283,6.9
13,65,Clinch,1992,3157,2965,192,6.1
13,67,Cobb,1992,279420,264491,14929,5.3
13,69,Coffee,1992,15058,13990,1068,7.1
13,71,Colquitt,1992,16758,15674,1084,6.5
13,73,Columbia,1992,36076,34354,1722,4.8
13,75,Cook,1992,6628,6162,466,7.0
13,77,Coweta,1992,30263,28182,2081,6.9
13,79,Crawford,1992,4724,4358,366,7.7
13,81,Crisp,1992,9101,8297,804,8.8
13,83,Dade,1992,6428,6020,408,6.3
13,85,Dawson,1992,6344,5978,366,5.8
13,87,Decatur,1992,11179,10079,1100,9.8
13,89,DeKalb,1992,322859,302649,20210,6.3
13,91,Dodge,1992,8636,8024,612,7.1
13,93,Dooly,1992,4142,3810,332,8.0
13,95,Dougherty,1992,43694,39410,4284,9.8
13,97,Douglas,1992,41225,38830,2395,5.8
13,99,Early,1992,5448,4871,577,10.6
13,101,Echols,1992,1016,963,53,5.2
13,103,Effingham,1992,13248,12452,796,6.0
13,105,Elbert,1992,9036,7954,1082,12.0
13,107,Emanuel,1992,8751,7768,983,11.2
13,109,Evans,1992,4078,3794,284,7.0
13,111,Fannin,1992,7888,7260,628,8.0
13,113,Fayette,1992,36271,34819,1452,4.0
13,115,Floyd,1992,43762,40794,2968,6.8
13,117,Forsyth,1992,27198,25774,1424,5.2
13,119,Franklin,1992,8546,7781,765,9.0
13,121,Fulton,1992,346026,321702,24324,7.0
13,123,Gilmer,1992,6644,6024,620,9.3
13,125,Glascock,1992,1243,1172,71,5.7
13,127,Glynn,1992,31846,30232,1614,5.1
13,129,Gordon,1992,19482,17958,1524,7.8
13,131,Grady,1992,9854,9111,743,7.5
13,133,Greene,1992,5250,4740,510,9.7
13,135,Gwinnett,1992,232628,221001,11627,5.0
13,137,Habersham,1992,14428,13707,721,5.0
13,139,Hall,1992,56289,53070,3219,5.7
13,141,Hancock,1992,3607,3189,418,11.6
13,143,Haralson,1992,9654,8483,1171,12.1
13,145,Harris,1992,8706,8212,494,5.7
13,147,Hart,1992,9524,8697,827,8.7
13,149,Heard,1992,4142,3775,367,8.9
13,151,Henry,1992,35881,34043,1838,5.1
13,153,Houston,1992,44418,41913,2505,5.6
13,155,Irwin,1992,3942,3719,223,5.7
13,157,Jackson,1992,15755,14632,1123,7.1
13,159,Jasper,1992,3847,3519,328,8.5
13,161,Jeff Davis,1992,5901,5388,513,8.7
13,163,Jefferson,1992,7753,7118,635,8.2
13,165,Jenkins,1992,3909,3676,233,6.0
13,167,Johnson,1992,3731,3464,267,7.2
13,169,Jones,1992,10743,10209,534,5.0
13,171,Lamar,1992,6243,5830,413,6.6
13,173,Lanier,1992,2645,2506,139,5.3
13,175,Laurens,1992,19991,18877,1114,5.6
13,177,Lee,1992,8419,7859,560,6.7
13,179,Liberty,1992,14575,13395,1180,8.1
13,181,Lincoln,1992,3735,3496,239,6.4
13,183,Long,1992,2518,2425,93,3.7
13,185,Lowndes,1992,35579,33494,2085,5.9
13,187,Lumpkin,1992,7746,7353,393,5.1
13,189,McDuffie,1992,9476,8791,685,7.2
13,191,McIntosh,1992,3513,3259,254,7.2
13,193,Macon,1992,6021,5219,802,13.3
13,195,Madison,1992,11472,10742,730,6.4
13,197,Marion,1992,2418,2235,183,7.6
13,199,Meriwether,1992,9439,8434,1005,10.6
13,201,Miller,1992,2914,2626,288,9.9
13,205,Mitchell,1992,9314,8274,1040,11.2
13,207,Monroe,1992,7813,7257,556,7.1
13,209,Montgomery,1992,3491,3170,321,9.2
13,211,Morgan,1992,6088,5633,455,7.5
13,213,Murray,1992,16210,15028,1182,7.3
13,215,Muscogee,1992,78103,72713,5390,6.9
13,217,Newton,1992,21642,20093,1549,7.2
13,219,Oconee,1992,9794,9412,382,3.9
13,221,Oglethorpe,1992,4995,4640,355,7.1
13,223,Paulding,1992,24587,23114,1473,6.0
13,225,Peach,1992,9836,9015,821,8.3
13,227,Pickens,1992,7710,7137,573,7.4
13,229,Pierce,1992,7011,6494,517,7.4
13,231,Pike,1992,5460,5147,313,5.7
13,233,Polk,1992,15781,13917,1864,11.8
13,235,Pulaski,1992,4060,3836,224,5.5
13,237,Putnam,1992,7275,6924,351,4.8
13,239,Quitman,1992,949,862,87,9.2
13,241,Rabun,1992,5765,5223,542,9.4
13,243,Randolph,1992,3129,2854,275,8.8
13,245,Richmond,1992,87878,80704,7174,8.2
13,247,Rockdale,1992,32032,30370,1662,5.2
13,249,Schley,1992,1449,1321,128,8.8
13,251,Screven,1992,6678,6071,607,9.1
13,253,Seminole,1992,4471,4011,460,10.3
13,255,Spalding,1992,27133,25306,1827,6.7
13,257,Stephens,1992,12430,11558,872,7.0
13,259,Stewart,1992,2190,1995,195,8.9
13,261,Sumter,1992,14007,12685,1322,9.4
13,263,Talbot,1992,2655,2421,234,8.8
13,265,Taliaferro,1992,724,665,59,8.1
13,267,Tattnall,1992,6958,6500,458,6.6
13,269,Taylor,1992,3410,3133,277,8.1
13,271,Telfair,1992,4941,4468,473,9.6
13,273,Terrell,1992,4822,4386,436,9.0
13,275,Thomas,1992,18422,17139,1283,7.0
13,277,Tift,1992,18058,16772,1286,7.1
13,279,Toombs,1992,11306,10261,1045,9.2
13,281,Towns,1992,2645,2465,180,6.8
13,283,Treutlen,1992,2768,2442,326,11.8
13,285,Troup,1992,26207,23679,2528,9.6
13,287,Turner,1992,3884,3563,321,8.3
13,289,Twiggs,1992,3927,3668,259,6.6
13,291,Union,1992,6004,5620,384,6.4
13,293,Upson,1992,12818,12136,682,5.3
13,295,Walker,1992,29768,27379,2389,8.0
13,297,Walton,1992,20163,18695,1468,7.3
13,299,Ware,1992,14969,13881,1088,7.3
13,301,Warren,1992,2633,2387,246,9.3
13,303,Washington,1992,8886,8419,467,5.3
13,305,Wayne,1992,11234,10120,1114,9.9
13,307,Webster,1992,1111,1029,82,7.4
13,309,Wheeler,1992,2000,1826,174,8.7
13,311,White,1992,7926,7502,424,5.3
13,313,Whitfield,1992,41991,39476,2515,6.0
13,315,Wilcox,1992,2972,2758,214,7.2
13,317,Wilkes,1992,5195,4918,277,5.3
13,319,Wilkinson,1992,4567,4320,247,5.4
13,321,Worth,1992,9289,8583,706,7.6
15,1,Hawaii,1992,64305,59581,4724,7.3
15,3,Honolulu/city,1992,418831,407458,11373,2.7
15,7,Kauai,1992,28944,26208,2736,9.5
15,9,Maui,1992,64864,59767,5097,7.9
16,1,Ada,1992,121928,116705,5223,4.3
16,3,Adams,1992,1663,1431,232,14.0
16,5,Bannock,1992,31462,29099,2363,7.5
16,7,Bear Lake,1992,2596,2457,139,5.4
16,9,Benewah,1992,3739,3309,430,11.5
16,11,Bingham,1992,19712,18484,1228,6.2
16,13,Blaine,1992,8708,8059,649,7.5
16,15,Boise,1992,1858,1715,143,7.7
16,17,Bonner,1992,13494,12114,1380,10.2
16,19,Bonneville,1992,41975,39941,2034,4.8
16,21,Boundary,1992,3725,3365,360,9.7
16,23,Butte,1992,1526,1415,111,7.3
16,25,Camas,1992,462,435,27,5.8
16,27,Canyon,1992,46317,43192,3125,6.7
16,29,Caribou,1992,3321,3100,221,6.7
16,31,Cassia,1992,8990,8255,735,8.2
16,33,Clark,1992,636,607,29,4.6
16,35,Clearwater,1992,4050,3423,627,15.5
16,37,Custer,1992,1992,1800,192,9.6
16,39,Elmore,1992,7926,7370,556,7.0
16,41,Franklin,1992,4078,3933,145,3.6
16,43,Fremont,1992,5200,4757,443,8.5
16,45,Gem,1992,5402,4958,444,8.2
16,47,Gooding,1992,5483,5203,280,5.1
16,49,Idaho,1992,6433,5671,762,11.8
16,51,Jefferson,1992,8667,8140,527,6.1
16,53,Jerome,1992,7364,6879,485,6.6
16,55,Kootenai,1992,39445,36301,3144,8.0
16,57,Latah,1992,14046,13516,530,3.8
16,59,Lemhi,1992,3345,2986,359,10.7
16,61,Lewis,1992,1511,1413,98,6.5
16,63,Lincoln,1992,1961,1831,130,6.6
16,65,Madison,1992,8750,8493,257,2.9
16,67,Minidoka,1992,9674,8833,841,8.7
16,69,Nez Perce,1992,20664,19738,926,4.5
16,71,Oneida,1992,1417,1347,70,4.9
16,73,Owyhee,1992,4164,3924,240,5.8
16,75,Payette,1992,8900,7999,901,10.1
16,77,Power,1992,3340,3092,248,7.4
16,79,Shoshone,1992,6607,5539,1068,16.2
16,81,Teton,1992,2112,2027,85,4.0
16,83,Twin Falls,1992,27244,25315,1929,7.1
16,85,Valley,1992,3695,3314,381,10.3
16,87,Washington,1992,4074,3655,419,10.3
17,1,Adams,1992,34647,32304,2343,6.8
17,3,Alexander,1992,4196,3712,484,11.5
17,5,Bond,1992,7558,6930,628,8.3
17,7,Boone,1992,18750,16766,1984,10.6
17,9,Brown,1992,2488,2335,153,6.1
17,11,Bureau,1992,18388,17192,1196,6.5
17,13,Calhoun,1992,2723,2462,261,9.6
17,15,Carroll,1992,8490,7944,546,6.4
17,17,Cass,1992,7178,6603,575,8.0
17,19,Champaign,1992,95448,91709,3739,3.9
17,21,Christian,1992,18414,16980,1434,7.8
17,23,Clark,1992,9348,8691,657,7.0
17,25,Clay,1992,7010,6398,612,8.7
17,27,Clinton,1992,16704,15592,1112,6.7
17,29,Coles,1992,26754,25157,1597,6.0
17,31,Cook,1992,2623572,2391395,232177,8.8
17,33,Crawford,1992,10012,9234,778,7.8
17,35,Cumberland,1992,5370,4926,444,8.3
17,37,DeKalb,1992,43326,40445,2881,6.6
17,39,De Witt,1992,8970,8331,639,7.1
17,41,Douglas,1992,10531,9797,734,7.0
17,43,DuPage,1992,470682,443557,27125,5.8
17,45,Edgar,1992,9035,8249,786,8.7
17,47,Edwards,1992,3689,3415,274,7.4
17,49,Effingham,1992,17301,15758,1543,8.9
17,51,Fayette,1992,10185,9259,926,9.1
17,53,Ford,1992,7086,6687,399,5.6
17,55,Franklin,1992,16871,14661,2210,13.1
17,57,Fulton,1992,14843,13251,1592,10.7
17,59,Gallatin,1992,3057,2687,370,12.1
17,61,Greene,1992,7011,6544,467,6.7
17,63,Grundy,1992,17666,15569,2097,11.9
17,65,Hamilton,1992,3660,3216,444,12.1
17,67,Hancock,1992,10939,10205,734,6.7
17,69,Hardin,1992,1986,1822,164,8.3
17,71,Henderson,1992,4741,4452,289,6.1
17,73,Henry,1992,26632,24756,1876,7.0
17,75,Iroquois,1992,16945,15952,993,5.9
17,77,Jackson,1992,29884,27675,2209,7.4
17,79,Jasper,1992,4947,4595,352,7.1
17,81,Jefferson,1992,17792,15805,1987,11.2
17,83,Jersey,1992,10303,9583,720,7.0
17,85,Jo Daviess,1992,11895,11277,618,5.2
17,87,Johnson,1992,4337,3842,495,11.4
17,89,Kane,1992,181703,166484,15219,8.4
17,91,Kankakee,1992,50005,45850,4155,8.3
17,93,Kendall,1992,22866,21401,1465,6.4
17,95,Knox,1992,29803,27801,2002,6.7
17,97,Lake,1992,292071,276695,15376,5.3
17,99,LaSalle,1992,54477,49155,5322,9.8
17,101,Lawrence,1992,7212,6543,669,9.3
17,103,Lee,1992,16851,15795,1056,6.3
17,105,Livingston,1992,20006,19020,986,4.9
17,107,Logan,1992,13840,12897,943,6.8
17,109,McDonough,1992,18381,17729,652,3.5
17,111,McHenry,1992,110717,102726,7991,7.2
17,113,McLean,1992,77702,74667,3035,3.9
17,115,Macon,1992,61698,56326,5372,8.7
17,117,Macoupin,1992,23498,21628,1870,8.0
17,119,Madison,1992,127216,117850,9366,7.4
17,121,Marion,1992,20781,18687,2094,10.1
17,123,Marshall,1992,6989,6567,422,6.0
17,125,Mason,1992,7850,7002,848,10.8
17,127,Massac,1992,7000,6398,602,8.6
17,129,Menard,1992,6162,5863,299,4.9
17,131,Mercer,1992,8599,7861,738,8.6
17,133,Monroe,1992,12507,11690,817,6.5
17,135,Montgomery,1992,15019,13749,1270,8.5
17,137,Morgan,1992,18790,17704,1086,5.8
17,139,Moultrie,1992,7595,7086,509,6.7
17,141,Ogle,1992,25871,24146,1725,6.7
17,143,Peoria,1992,93097,86655,6442,6.9
17,145,Perry,1992,8520,7158,1362,16.0
17,147,Piatt,1992,8812,8219,593,6.7
17,149,Pike,1992,8680,8018,662,7.6
17,151,Pope,1992,1673,1479,194,11.6
17,153,Pulaski,1992,2987,2627,360,12.1
17,155,Putnam,1992,3043,2808,235,7.7
17,157,Randolph,1992,15730,14139,1591,10.1
17,159,Richland,1992,9157,8630,527,5.8
17,161,Rock Island,1992,76483,70943,5540,7.2
17,163,St. Clair,1992,118071,108353,9718,8.2
17,165,Saline,1992,11114,9799,1315,11.8
17,167,Sangamon,1992,104769,99656,5113,4.9
17,169,Schuyler,1992,3852,3574,278,7.2
17,171,Scott,1992,2855,2635,220,7.7
17,173,Shelby,1992,11046,10169,877,7.9
17,175,Stark,1992,3056,2809,247,8.1
17,177,Stephenson,1992,26349,24418,1931,7.3
17,179,Tazewell,1992,66507,61941,4566,6.9
17,181,Union,1992,8333,7368,965,11.6
17,183,Vermilion,1992,41981,37787,4194,10.0
17,185,Wabash,1992,6050,5342,708,11.7
17,187,Warren,1992,10119,9567,552,5.5
17,189,Washington,1992,7523,7028,495,6.6
17,191,Wayne,1992,8332,7587,745,8.9
17,193,White,1992,7862,7191,671,8.5
17,195,Whiteside,1992,31720,29791,1929,6.1
17,197,Will,1992,195858,178746,17112,8.7
17,199,Williamson,1992,27258,24364,2894,10.6
17,201,Winnebago,1992,144170,132727,11443,7.9
17,203,Woodford,1992,17293,16552,741,4.3
18,1,Adams,1992,15359,14315,1044,6.8
18,3,Allen,1992,164063,154407,9656,5.9
18,5,Bartholomew,1992,34735,33016,1719,4.9
18,7,Benton,1992,4793,4567,226,4.7
18,9,Blackford,1992,6225,5520,705,11.3
18,11,Boone,1992,20971,20191,780,3.7
18,13,Brown,1992,7463,7207,256,3.4
18,15,Carroll,1992,10680,10199,481,4.5
18,17,Cass,1992,18892,17618,1274,6.7
18,19,Clark,1992,46799,44104,2695,5.8
18,21,Clay,1992,11807,10991,816,6.9
18,23,Clinton,1992,14699,14061,638,4.3
18,25,Crawford,1992,4485,4003,482,10.7
18,27,Daviess,1992,12746,12081,665,5.2
18,29,Dearborn,1992,20124,18491,1633,8.1
18,31,Decatur,1992,12906,12325,581,4.5
18,33,DeKalb,1992,19629,18421,1208,6.2
18,35,Delaware,1992,61792,57582,4210,6.8
18,37,Dubois,1992,20764,20049,715,3.4
18,39,Elkhart,1992,84558,79974,4584,5.4
18,41,Fayette,1992,12603,10923,1680,13.3
18,43,Floyd,1992,33908,32255,1653,4.9
18,45,Fountain,1992,8468,7719,749,8.8
18,47,Franklin,1992,9818,8996,822,8.4
18,49,Fulton,1992,9492,8890,602,6.3
18,51,Gibson,1992,16379,15232,1147,7.0
18,53,Grant,1992,35906,32762,3144,8.8
18,55,Greene,1992,14818,13457,1361,9.2
18,57,Hamilton,1992,65905,64271,1634,2.5
18,59,Hancock,1992,25009,24012,997,4.0
18,61,Harrison,1992,15370,14600,770,5.0
18,63,Hendricks,1992,41803,40567,1236,3.0
18,65,Henry,1992,23809,21507,2302,9.7
18,67,Howard,1992,40741,38025,2716,6.7
18,69,Huntington,1992,18948,17821,1127,5.9
18,71,Jackson,1992,19642,18379,1263,6.4
18,73,Jasper,1992,12177,11289,888,7.3
18,75,Jay,1992,11057,10052,1005,9.1
18,77,Jefferson,1992,14666,13707,959,6.5
18,79,Jennings,1992,12010,11333,677,5.6
18,81,Johnson,1992,50123,48264,1859,3.7
18,83,Knox,1992,18684,17749,935,5.0
18,85,Kosciusko,1992,34983,33301,1682,4.8
18,87,LaGrange,1992,14236,13416,820,5.8
18,89,Lake,1992,224358,206257,18101,8.1
18,91,LaPorte,1992,52512,49128,3384,6.4
18,93,Lawrence,1992,21773,19694,2079,9.5
18,95,Madison,1992,63841,59259,4582,7.2
18,97,Marion,1992,429968,407330,22638,5.3
18,99,Marshall,1992,23046,21805,1241,5.4
18,101,Martin,1992,5023,4678,345,6.9
18,103,Miami,1992,16026,14814,1212,7.6
18,105,Monroe,1992,55189,53018,2171,3.9
18,107,Montgomery,1992,18560,17962,598,3.2
18,109,Morgan,1992,30259,28604,1655,5.5
18,111,Newton,1992,6646,6260,386,5.8
18,113,Noble,1992,20978,19606,1372,6.5
18,115,Ohio,1992,2550,2357,193,7.6
18,117,Orange,1992,8789,7723,1066,12.1
18,119,Owen,1992,8977,8380,597,6.7
18,121,Parke,1992,7307,6811,496,6.8
18,123,Perry,1992,8834,8050,784,8.9
18,125,Pike,1992,5982,5525,457,7.6
18,127,Porter,1992,68078,64518,3560,5.2
18,129,Posey,1992,12769,12149,620,4.9
18,131,Pulaski,1992,5925,5476,449,7.6
18,133,Putnam,1992,15034,14366,668,4.4
18,135,Randolph,1992,11959,10432,1527,12.8
18,137,Ripley,1992,12349,11422,927,7.5
18,139,Rush,1992,9032,8384,648,7.2
18,141,St. Joseph,1992,125190,117093,8097,6.5
18,143,Scott,1992,9645,9046,599,6.2
18,145,Shelby,1992,21330,20213,1117,5.2
18,147,Spencer,1992,9552,8783,769,8.1
18,149,Starke,1992,10335,9467,868,8.4
18,151,Steuben,1992,15542,14691,851,5.5
18,153,Sullivan,1992,8968,8141,827,9.2
18,155,Switzerland,1992,3938,3580,358,9.1
18,157,Tippecanoe,1992,66127,63909,2218,3.4
18,159,Tipton,1992,8374,7857,517,6.2
18,161,Union,1992,3500,3195,305,8.7
18,163,Vanderburgh,1992,85018,79572,5446,6.4
18,165,Vermillion,1992,7721,7090,631,8.2
18,167,Vigo,1992,51184,48002,3182,6.2
18,169,Wabash,1992,17882,16488,1394,7.8
18,171,Warren,1992,3794,3548,246,6.5
18,173,Warrick,1992,24180,22879,1301,5.4
18,175,Washington,1992,10744,9791,953,8.9
18,177,Wayne,1992,36095,31919,4176,11.6
18,179,Wells,1992,13710,13015,695,5.1
18,181,White,1992,12841,12044,797,6.2
18,183,Whitley,1992,14957,14115,842,5.6
19,1,Adair,1992,4224,4086,138,3.3
19,3,Adams,1992,2432,2341,91,3.7
19,5,Allamakee,1992,7471,7050,421,5.6
19,7,Appanoose,1992,6762,6363,399,5.9
19,9,Audubon,1992,3857,3750,107,2.8
19,11,Benton,1992,11433,10904,529,4.6
19,13,Black Hawk,1992,66721,62670,4051,6.1
19,15,Boone,1992,13147,12606,541,4.1
19,17,Bremer,1992,12394,11850,544,4.4
19,19,Buchanan,1992,10107,9490,617,6.1
19,21,Buena Vista,1992,10897,10623,274,2.5
19,23,Butler,1992,7950,7443,507,6.4
19,25,Calhoun,1992,5237,5061,176,3.4
19,27,Carroll,1992,11677,11331,346,3.0
19,29,Cass,1992,7787,7402,385,4.9
19,31,Cedar,1992,9386,9051,335,3.6
19,33,Cerro Gordo,1992,25724,24235,1489,5.8
19,35,Cherokee,1992,7022,6809,213,3.0
19,37,Chickasaw,1992,7325,6851,474,6.5
19,39,Clarke,1992,4252,3968,284,6.7
19,41,Clay,1992,9154,8876,278,3.0
19,43,Clayton,1992,9701,9135,566,5.8
19,45,Clinton,1992,27244,25702,1542,5.7
19,47,Crawford,1992,8742,8390,352,4.0
19,49,Dallas,1992,17227,16628,599,3.5
19,51,Davis,1992,4136,3924,212,5.1
19,53,Decatur,1992,3921,3642,279,7.1
19,55,Delaware,1992,9145,8656,489,5.3
19,57,Des Moines,1992,23246,21863,1383,5.9
19,59,Dickinson,1992,8942,8643,299,3.3
19,61,Dubuque,1992,48777,46253,2524,5.2
19,63,Emmet,1992,5818,5509,309,5.3
19,65,Fayette,1992,10745,10180,565,5.3
19,67,Floyd,1992,8824,8246,578,6.6
19,69,Franklin,1992,5891,5647,244,4.1
19,71,Fremont,1992,3852,3642,210,5.5
19,73,Greene,1992,5288,5074,214,4.0
19,75,Grundy,1992,6087,5870,217,3.6
19,77,Guthrie,1992,5691,5457,234,4.1
19,79,Hamilton,1992,8835,8420,415,4.7
19,81,Hancock,1992,5973,5652,321,5.4
19,83,Hardin,1992,9569,9091,478,5.0
19,85,Harrison,1992,7493,7084,409,5.5
19,87,Henry,1992,10625,10160,465,4.4
19,89,Howard,1992,4936,4733,203,4.1
19,91,Humboldt,1992,5191,5023,168,3.2
19,93,Ida,1992,3886,3783,103,2.7
19,95,Iowa,1992,9102,8884,218,2.4
19,97,Jackson,1992,10698,10034,664,6.2
19,99,Jasper,1992,18158,17469,689,3.8
19,101,Jefferson,1992,9080,8612,468,5.2
19,103,Johnson,1992,60845,58956,1889,3.1
19,105,Jones,1992,9651,9107,544,5.6
19,107,Keokuk,1992,5272,4965,307,5.8
19,109,Kossuth,1992,9042,8619,423,4.7
19,111,Lee,1992,19736,18207,1529,7.7
19,113,Linn,1992,100838,96769,4069,4.0
19,115,Louisa,1992,6417,6062,355,5.5
19,117,Lucas,1992,4465,4177,288,6.5
19,119,Lyon,1992,5961,5813,148,2.5
19,121,Madison,1992,6535,6199,336,5.1
19,123,Mahaska,1992,10919,10493,426,3.9
19,125,Marion,1992,16547,15982,565,3.4
19,127,Marshall,1992,20428,19637,791,3.9
19,129,Mills,1992,6664,6396,268,4.0
19,131,Mitchell,1992,5345,5144,201,3.8
19,133,Monona,1992,4863,4654,209,4.3
19,135,Monroe,1992,3978,3770,208,5.2
19,137,Montgomery,1992,6047,5761,286,4.7
19,139,Muscatine,1992,21659,20499,1160,5.4
19,141,O'Brien,1992,7717,7498,219,2.8
19,143,Osceola,1992,3739,3615,124,3.3
19,145,Page,1992,8638,8169,469,5.4
19,147,Palo Alto,1992,5278,5119,159,3.0
19,149,Plymouth,1992,12722,12277,445,3.5
19,151,Pocahontas,1992,4374,4224,150,3.4
19,153,Polk,1992,202021,194898,7123,3.5
19,155,Pottawattamie,1992,45373,43212,2161,4.8
19,157,Poweshiek,1992,10260,9815,445,4.3
19,159,Ringgold,1992,2725,2621,104,3.8
19,161,Sac,1992,6126,5945,181,3.0
19,163,Scott,1992,84064,79467,4597,5.5
19,165,Shelby,1992,6779,6421,358,5.3
19,167,Sioux,1992,16279,15830,449,2.8
19,169,Story,1992,43435,41860,1575,3.6
19,171,Tama,1992,8238,7800,438,5.3
19,173,Taylor,1992,3250,3106,144,4.4
19,175,Union,1992,6375,6104,271,4.3
19,177,Van Buren,1992,3872,3677,195,5.0
19,179,Wapello,1992,18039,16849,1190,6.6
19,181,Warren,1992,21720,21043,677,3.1
19,183,Washington,1992,11060,10677,383,3.5
19,185,Wayne,1992,3341,3167,174,5.2
19,187,Webster,1992,20043,18920,1123,5.6
19,189,Winnebago,1992,6433,6199,234,3.6
19,191,Winneshiek,1992,11866,11200,666,5.6
19,193,Woodbury,1992,53301,51125,2176,4.1
19,195,Worth,1992,3975,3782,193,4.9
19,197,Wright,1992,7274,6950,324,4.5
20,1,Allen,1992,6647,6299,348,5.2
20,3,Anderson,1992,3881,3617,264,6.8
20,5,Atchison,1992,8338,7781,557,6.7
20,7,Barber,1992,2773,2695,78,2.8
20,9,Barton,1992,15433,14787,646,4.2
20,11,Bourbon,1992,6814,6421,393,5.8
20,13,Brown,1992,4873,4605,268,5.5
20,15,Butler,1992,27716,26549,1167,4.2
20,17,Chase,1992,1430,1361,69,4.8
20,19,Chautauqua,1992,1771,1648,123,6.9
20,21,Cherokee,1992,9926,9117,809,8.2
20,23,Cheyenne,1992,1512,1486,26,1.7
20,25,Clark,1992,1272,1252,20,1.6
20,27,Clay,1992,4677,4505,172,3.7
20,29,Cloud,1992,5334,5181,153,2.9
20,31,Coffey,1992,4220,3943,277,6.6
20,33,Comanche,1992,1062,1051,11,1.0
20,35,Cowley,1992,18148,17155,993,5.5
20,37,Crawford,1992,16663,15748,915,5.5
20,39,Decatur,1992,1971,1926,45,2.3
20,41,Dickinson,1992,9939,9574,365,3.7
20,43,Doniphan,1992,3768,3526,242,6.4
20,45,Douglas,1992,47824,45742,2082,4.4
20,47,Edwards,1992,1805,1747,58,3.2
20,49,Elk,1992,1500,1428,72,4.8
20,51,Ellis,1992,15206,14639,567,3.7
20,53,Ellsworth,1992,2929,2816,113,3.9
20,55,Finney,1992,18801,18125,676,3.6
20,57,Ford,1992,14277,13810,467,3.3
20,59,Franklin,1992,11685,11010,675,5.8
20,61,Geary,1992,11775,10970,805,6.8
20,63,Gove,1992,1474,1445,29,2.0
20,65,Graham,1992,1705,1661,44,2.6
20,67,Grant,1992,3759,3651,108,2.9
20,69,Gray,1992,2650,2581,69,2.6
20,71,Greeley,1992,865,838,27,3.1
20,73,Greenwood,1992,3566,3375,191,5.4
20,75,Hamilton,1992,1236,1213,23,1.9
20,77,Harper,1992,3150,3034,116,3.7
20,79,Harvey,1992,16446,15759,687,4.2
20,81,Haskell,1992,1955,1911,44,2.3
20,83,Hodgeman,1992,945,928,17,1.8
20,85,Jackson,1992,5937,5596,341,5.7
20,87,Jefferson,1992,8861,8429,432,4.9
20,89,Jewell,1992,2114,2075,39,1.8
20,91,Johnson,1992,220640,213560,7080,3.2
20,93,Kearny,1992,2096,2036,60,2.9
20,95,Kingman,1992,3988,3811,177,4.4
20,97,Kiowa,1992,1727,1683,44,2.5
20,99,Labette,1992,11342,10329,1013,8.9
20,101,Lane,1992,1099,1084,15,1.4
20,103,Leavenworth,1992,26363,24957,1406,5.3
20,105,Lincoln,1992,1849,1786,63,3.4
20,107,Linn,1992,3363,3023,340,10.1
20,109,Logan,1992,1602,1539,63,3.9
20,111,Lyon,1992,19217,18361,856,4.5
20,113,McPherson,1992,14748,14304,444,3.0
20,115,Marion,1992,6633,6429,204,3.1
20,117,Marshall,1992,5506,5371,135,2.5
20,119,Meade,1992,2130,2080,50,2.3
20,121,Miami,1992,12422,11747,675,5.4
20,123,Mitchell,1992,3600,3483,117,3.3
20,125,Montgomery,1992,17890,16700,1190,6.7
20,127,Morris,1992,2988,2847,141,4.7
20,129,Morton,1992,1655,1598,57,3.4
20,131,Nemaha,1992,5399,5273,126,2.3
20,133,Neosho,1992,8743,8303,440,5.0
20,135,Ness,1992,1979,1928,51,2.6
20,137,Norton,1992,2862,2810,52,1.8
20,139,Osage,1992,7761,7231,530,6.8
20,141,Osborne,1992,2532,2475,57,2.3
20,143,Ottawa,1992,2823,2729,94,3.3
20,145,Pawnee,1992,3909,3791,118,3.0
20,147,Phillips,1992,3176,3101,75,2.4
20,149,Pottawatomie,1992,8857,8479,378,4.3
20,151,Pratt,1992,4938,4788,150,3.0
20,153,Rawlins,1992,1622,1592,30,1.8
20,155,Reno,1992,31441,29882,1559,5.0
20,157,Republic,1992,3332,3283,49,1.5
20,159,Rice,1992,5025,4791,234,4.7
20,161,Riley,1992,28898,27642,1256,4.3
20,163,Rooks,1992,2867,2774,93,3.2
20,165,Rush,1992,1895,1838,57,3.0
20,167,Russell,1992,3867,3740,127,3.3
20,169,Saline,1992,28729,27671,1058,3.7
20,171,Scott,1992,2717,2646,71,2.6
20,173,Sedgwick,1992,223830,213655,10175,4.5
20,175,Seward,1992,9931,9496,435,4.4
20,177,Shawnee,1992,87951,83824,4127,4.7
20,179,Sheridan,1992,1476,1449,27,1.8
20,181,Sherman,1992,3696,3594,102,2.8
20,183,Smith,1992,2451,2403,48,2.0
20,185,Stafford,1992,2423,2356,67,2.8
20,187,Stanton,1992,1068,1043,25,2.3
20,189,Stevens,1992,2492,2415,77,3.1
20,191,Sumner,1992,12558,11854,704,5.6
20,193,Thomas,1992,4385,4276,109,2.5
20,195,Trego,1992,1840,1800,40,2.2
20,197,Wabaunsee,1992,3363,3197,166,4.9
20,199,Wallace,1992,819,801,18,2.2
20,201,Washington,1992,3611,3491,120,3.3
20,203,Wichita,1992,1260,1234,26,2.1
20,205,Wilson,1992,4732,4450,282,6.0
20,207,Woodson,1992,1839,1747,92,5.0
20,209,Wyandotte,1992,77887,71122,6765,8.7
21,1,Adair,1992,7580,7040,540,7.1
21,3,Allen,1992,7157,6657,500,7.0
21,5,Anderson,1992,8391,8046,345,4.1
21,7,Ballard,1992,3850,3468,382,9.9
21,9,Barren,1992,16942,15835,1107,6.5
21,11,Bath,1992,4564,4043,521,11.4
21,13,Bell,1992,10312,9078,1234,12.0
21,15,Boone,1992,33922,31970,1952,5.8
21,17,Bourbon,1992,9396,8962,434,4.6
21,19,Boyd,1992,23027,20783,2244,9.7
21,21,Boyle,1992,12881,12087,794,6.2
21,23,Bracken,1992,3587,3285,302,8.4
21,25,Breathitt,1992,5023,4310,713,14.2
21,27,Breckinridge,1992,7308,6712,596,8.2
21,29,Bullitt,1992,26540,25409,1131,4.3
21,31,Butler,1992,5488,5033,455,8.3
21,33,Caldwell,1992,6250,5497,753,12.0
21,35,Calloway,1992,15916,15039,877,5.5
21,37,Campbell,1992,43319,40555,2764,6.4
21,39,Carlisle,1992,2595,2378,217,8.4
21,41,Carroll,1992,4493,4279,214,4.8
21,43,Carter,1992,10902,9208,1694,15.5
21,45,Casey,1992,6981,6512,469,6.7
21,47,Christian,1992,22540,21222,1318,5.8
21,49,Clark,1992,14550,13680,870,6.0
21,51,Clay,1992,6852,6154,698,10.2
21,53,Clinton,1992,4467,3986,481,10.8
21,55,Crittenden,1992,3848,3489,359,9.3
21,57,Cumberland,1992,2967,2618,349,11.8
21,59,Daviess,1992,44974,41680,3294,7.3
21,61,Edmonson,1992,4576,4015,561,12.3
21,63,Elliott,1992,2409,1997,412,17.1
21,65,Estill,1992,5749,5197,552,9.6
21,67,Fayette,1992,127983,123262,4721,3.7
21,69,Fleming,1992,6098,5676,422,6.9
21,71,Floyd,1992,15040,13391,1649,11.0
21,73,Franklin,1992,24209,23270,939,3.9
21,75,Fulton,1992,3665,3344,321,8.8
21,77,Gallatin,1992,2768,2581,187,6.8
21,79,Garrard,1992,6046,5639,407,6.7
21,81,Grant,1992,8190,7508,682,8.3
21,83,Graves,1992,15691,14563,1128,7.2
21,85,Grayson,1992,10018,9190,828,8.3
21,87,Green,1992,5239,4952,287,5.5
21,89,Greenup,1992,16479,14831,1648,10.0
21,91,Hancock,1992,3404,3040,364,10.7
21,93,Hardin,1992,34432,31984,2448,7.1
21,95,Harlan,1992,11020,9283,1737,15.8
21,97,Harrison,1992,7574,7088,486,6.4
21,99,Hart,1992,7192,6694,498,6.9
21,101,Henderson,1992,22297,20737,1560,7.0
21,103,Henry,1992,7070,6760,310,4.4
21,105,Hickman,1992,2527,2371,156,6.2
21,107,Hopkins,1992,20861,18808,2053,9.8
21,109,Jackson,1992,4542,4072,470,10.3
21,111,Jefferson,1992,351513,331878,19635,5.6
21,113,Jessamine,1992,17077,16394,683,4.0
21,115,Johnson,1992,9464,8663,801,8.5
21,117,Kenton,1992,75350,70898,4452,5.9
21,119,Knott,1992,5798,5074,724,12.5
21,121,Knox,1992,10294,9326,968,9.4
21,123,Larue,1992,5789,5456,333,5.8
21,125,Laurel,1992,19433,17822,1611,8.3
21,127,Lawrence,1992,4828,4179,649,13.4
21,129,Lee,1992,2375,2109,266,11.2
21,131,Leslie,1992,4340,3923,417,9.6
21,133,Letcher,1992,8672,7175,1497,17.3
21,135,Lewis,1992,5706,4842,864,15.1
21,137,Lincoln,1992,9376,8745,631,6.7
21,139,Livingston,1992,4661,4219,442,9.5
21,141,Logan,1992,12302,11626,676,5.5
21,143,Lyon,1992,2888,2655,233,8.1
21,145,McCracken,1992,31628,30002,1626,5.1
21,147,McCreary,1992,5621,4905,716,12.7
21,149,McLean,1992,4269,3700,569,13.3
21,151,Madison,1992,29915,28618,1297,4.3
21,153,Magoffin,1992,4349,3647,702,16.1
21,155,Marion,1992,8397,7802,595,7.1
21,157,Marshall,1992,13109,11999,1110,8.5
21,159,Martin,1992,3680,3294,386,10.5
21,161,Mason,1992,8303,7731,572,6.9
21,163,Meade,1992,9222,8623,599,6.5
21,165,Menifee,1992,2207,1915,292,13.2
21,167,Mercer,1992,9981,9202,779,7.8
21,169,Metcalfe,1992,4498,4178,320,7.1
21,171,Monroe,1992,4924,4670,254,5.2
21,173,Montgomery,1992,9686,8809,877,9.1
21,175,Morgan,1992,4385,3830,555,12.7
21,177,Muhlenberg,1992,11867,10395,1472,12.4
21,179,Nelson,1992,15667,14404,1263,8.1
21,181,Nicholas,1992,3536,3331,205,5.8
21,183,Ohio,1992,9088,8032,1056,11.6
21,185,Oldham,1992,18617,18054,563,3.0
21,187,Owen,1992,4446,4248,198,4.5
21,189,Owsley,1992,1528,1401,127,8.3
21,191,Pendleton,1992,5963,5506,457,7.7
21,193,Perry,1992,11277,10033,1244,11.0
21,195,Pike,1992,26801,23608,3193,11.9
21,197,Powell,1992,5780,5228,552,9.6
21,199,Pulaski,1992,23141,21176,1965,8.5
21,201,Robertson,1992,941,874,67,7.1
21,203,Rockcastle,1992,5807,5255,552,9.5
21,205,Rowan,1992,8964,8279,685,7.6
21,207,Russell,1992,6811,6028,783,11.5
21,209,Scott,1992,13279,12717,562,4.2
21,211,Shelby,1992,14391,13958,433,3.0
21,213,Simpson,1992,7914,7359,555,7.0
21,215,Spencer,1992,3829,3714,115,3.0
21,217,Taylor,1992,11204,10655,549,4.9
21,219,Todd,1992,5164,4898,266,5.2
21,221,Trigg,1992,5459,5139,320,5.9
21,223,Trimble,1992,2856,2709,147,5.1
21,225,Union,1992,7205,6583,622,8.6
21,227,Warren,1992,44216,41725,2491,5.6
21,229,Washington,1992,5169,4917,252,4.9
21,231,Wayne,1992,7216,6558,658,9.1
21,233,Webster,1992,5960,5269,691,11.6
21,235,Whitley,1992,13058,11823,1235,9.5
21,237,Wolfe,1992,2974,2676,298,10.0
21,239,Woodford,1992,11457,11104,353,3.1
22,1,Acadia Parish,1992,22193,20235,1958,8.8
22,3,Allen Parish,1992,8184,7292,892,10.9
22,5,Ascension Parish,1992,28490,26658,1832,6.4
22,7,Assumption Parish,1992,9049,8151,898,9.9
22,9,Avoyelles Parish,1992,14599,12886,1713,11.7
22,11,Beauregard Parish,1992,12176,11114,1062,8.7
22,13,Bienville Parish,1992,6459,5973,486,7.5
22,15,Bossier Parish,1992,40921,38435,2486,6.1
22,17,Caddo Parish,1992,114539,107365,7174,6.3
22,19,Calcasieu Parish,1992,82525,76164,6361,7.7
22,21,Caldwell Parish,1992,4050,3667,383,9.5
22,23,Cameron Parish,1992,3825,3536,289,7.6
22,25,Catahoula Parish,1992,4902,4365,537,11.0
22,27,Claiborne Parish,1992,6112,5590,522,8.5
22,29,Concordia Parish,1992,8634,7538,1096,12.7
22,31,De Soto Parish,1992,10230,9131,1099,10.7
22,33,East Baton Rouge Parish,1992,202500,193053,9447,4.7
22,35,East Carroll Parish,1992,3622,3078,544,15.0
22,37,East Feliciana Parish,1992,7483,7009,474,6.3
22,39,Evangeline Parish,1992,12446,11273,1173,9.4
22,41,Franklin Parish,1992,10522,9384,1138,10.8
22,43,Grant Parish,1992,6996,6333,663,9.5
22,45,Iberia Parish,1992,30229,27409,2820,9.3
22,47,Iberville Parish,1992,13567,12268,1299,9.6
22,49,Jackson Parish,1992,6468,6110,358,5.5
22,51,Jefferson Parish,1992,232850,213654,19196,8.2
22,53,Jefferson Davis Parish,1992,12496,11196,1300,10.4
22,55,Lafayette Parish,1992,86000,80879,5121,6.0
22,57,Lafourche Parish,1992,36481,34237,2244,6.2
22,59,LaSalle Parish,1992,6270,5790,480,7.7
22,61,Lincoln Parish,1992,19010,18513,497,2.6
22,63,Livingston Parish,1992,35102,32593,2509,7.1
22,65,Madison Parish,1992,4967,4366,601,12.1
22,67,Morehouse Parish,1992,13243,12049,1194,9.0
22,69,Natchitoches Parish,1992,15980,14725,1255,7.9
22,71,Orleans Parish,1992,205178,185469,19709,9.6
22,73,Ouachita Parish,1992,67054,63342,3712,5.5
22,75,Plaquemines Parish,1992,10523,9398,1125,10.7
22,77,Pointe Coupee Parish,1992,9203,8333,870,9.5
22,79,Rapides Parish,1992,56361,52785,3576,6.3
22,81,Red River Parish,1992,3774,3381,393,10.4
22,83,Richland Parish,1992,8718,7744,974,11.2
22,85,Sabine Parish,1992,9272,8584,688,7.4
22,87,St. Bernard Parish,1992,31365,28181,3184,10.2
22,89,St. Charles Parish,1992,20823,18721,2102,10.1
22,91,St. Helena Parish,1992,3862,3601,261,6.8
22,93,St. James Parish,1992,8803,7962,841,9.6
22,95,St. John the Baptist Parish,1992,18636,16569,2067,11.1
22,97,St. Landry Parish,1992,30298,27222,3076,10.2
22,99,St. Martin Parish,1992,19442,17871,1571,8.1
22,101,St. Mary Parish,1992,24760,21679,3081,12.4
22,103,St. Tammany Parish,1992,73384,67195,6189,8.4
22,105,Tangipahoa Parish,1992,37989,34604,3385,8.9
22,107,Tensas Parish,1992,2999,2762,237,7.9
22,109,Terrebonne Parish,1992,41747,38355,3392,8.1
22,111,Union Parish,1992,9660,9011,649,6.7
22,113,Vermilion Parish,1992,21337,19246,2091,9.8
22,115,Vernon Parish,1992,16706,15468,1238,7.4
22,117,Washington Parish,1992,16447,14762,1685,10.2
22,119,Webster Parish,1992,18079,16314,1765,9.8
22,121,West Baton Rouge Parish,1992,9455,8854,601,6.4
22,123,West Carroll Parish,1992,5488,4626,862,15.7
22,125,West Feliciana Parish,1992,4155,3919,236,5.7
22,127,Winn Parish,1992,6093,5770,323,5.3
23,1,Androscoggin,1992,56425,51552,4873,8.6
23,3,Aroostook,1992,40987,36741,4246,10.4
23,5,Cumberland,1992,132293,124933,7360,5.6
23,7,Franklin,1992,14968,13743,1225,8.2
23,9,Hancock,1992,25645,23696,1949,7.6
23,11,Kennebec,1992,61086,56686,4400,7.2
23,13,Knox,1992,18527,17345,1182,6.4
23,15,Lincoln,1992,16175,15219,956,5.9
23,17,Oxford,1992,25754,23511,2243,8.7
23,19,Penobscot,1992,75074,69694,5380,7.2
23,21,Piscataquis,1992,8719,7937,782,9.0
23,23,Sagadahoc,1992,16253,15369,884,5.4
23,25,Somerset,1992,26257,23648,2609,9.9
23,27,Waldo,1992,16864,15375,1489,8.8
23,29,Washington,1992,16555,14893,1662,10.0
23,31,York,1992,89864,83801,6063,6.7
24,1,Allegany,1992,33141,28803,4338,13.1
24,3,Anne Arundel,1992,235314,222256,13058,5.5
24,5,Baltimore,1992,385311,358705,26606,6.9
24,9,Calvert,1992,30864,29118,1746,5.7
24,11,Caroline,1992,14833,13628,1205,8.1
24,13,Carroll,1992,71027,66946,4081,5.7
24,15,Cecil,1992,36483,32696,3787,10.4
24,17,Charles,1992,56862,53781,3081,5.4
24,19,Dorchester,1992,15105,13237,1868,12.4
24,21,Frederick,1992,88928,84112,4816,5.4
24,23,Garrett,1992,13617,11826,1791,13.2
24,25,Harford,1992,103474,96256,7218,7.0
24,27,Howard,1992,117681,112829,4852,4.1
24,29,Kent,1992,9686,8922,764,7.9
24,31,Montgomery,1992,451063,434982,16081,3.6
24,33,Prince George's,1992,438299,414009,24290,5.5
24,35,Queen Anne's,1992,18603,17401,1202,6.5
24,37,St. Mary's,1992,39551,36981,2570,6.5
24,39,Somerset,1992,11134,9815,1319,11.8
24,41,Talbot,1992,17021,16155,866,5.1
24,43,Washington,1992,64078,58277,5801,9.1
24,45,Wicomico,1992,46027,42058,3969,8.6
24,47,Worcester,1992,23189,20573,2616,11.3
24,510,Baltimore city,1992,334141,298251,35890,10.7
25,1,Barnstable,1992,97763,87283,10480,10.7
25,3,Berkshire,1992,68650,61353,7297,10.6
25,5,Bristol,1992,265125,233248,31877,12.0
25,7,Dukes,1992,7522,6928,594,7.9
25,9,Essex,1992,349778,317617,32161,9.2
25,11,Franklin,1992,37014,34040,2974,8.0
25,13,Hampden,1992,220104,199347,20757,9.4
25,15,Hampshire,1992,79016,73636,5380,6.8
25,17,Middlesex,1992,787750,729034,58716,7.5
25,19,Nantucket/town,1992,4965,4730,235,4.7
25,21,Norfolk,1992,342359,317227,25132,7.3
25,23,Plymouth,1992,228405,205411,22994,10.1
25,25,Suffolk,1992,333854,305386,28468,8.5
25,27,Worcester,1992,362267,329328,32939,9.1
26,1,Alcona,1992,4116,3458,658,16.0
26,3,Alger,1992,3939,3495,444,11.3
26,5,Allegan,1992,46011,42811,3200,7.0
26,7,Alpena,1992,14779,12737,2042,13.8
26,9,Antrim,1992,8950,7805,1145,12.8
26,11,Arenac,1992,6189,5492,697,11.3
26,13,Baraga,1992,3234,2749,485,15.0
26,15,Barry,1992,25296,23319,1977,7.8
26,17,Bay,1992,54124,49081,5043,9.3
26,19,Benzie,1992,6290,5547,743,11.8
26,21,Berrien,1992,80212,73168,7044,8.8
26,23,Branch,1992,19181,17404,1777,9.3
26,25,Calhoun,1992,64098,59384,4714,7.4
26,27,Cass,1992,24142,22314,1828,7.6
26,29,Charlevoix,1992,11959,10368,1591,13.3
26,31,Cheboygan,1992,10699,9226,1473,13.8
26,33,Chippewa,1992,15605,13638,1967,12.6
26,35,Clare,1992,9812,8523,1289,13.1
26,37,Clinton,1992,31131,29386,1745,5.6
26,39,Crawford,1992,5588,5043,545,9.8
26,41,Delta,1992,17552,15144,2408,13.7
26,43,Dickinson,1992,12906,11655,1251,9.7
26,45,Eaton,1992,51062,48302,2760,5.4
26,47,Emmet,1992,14974,13048,1926,12.9
26,49,Genesee,1992,197619,173841,23778,12.0
26,51,Gladwin,1992,8190,7069,1121,13.7
26,53,Gogebic,1992,7797,7031,766,9.8
26,55,Grand Traverse,1992,38358,35245,3113,8.1
26,57,Gratiot,1992,18125,16403,1722,9.5
26,59,Hillsdale,1992,20881,19111,1770,8.5
26,61,Houghton,1992,15115,13643,1472,9.7
26,63,Huron,1992,15697,13759,1938,12.3
26,65,Ingham,1992,146730,138084,8646,5.9
26,67,Ionia,1992,26056,23592,2464,9.5
26,69,Iosco,1992,11433,10151,1282,11.2
26,71,Iron,1992,5382,4767,615,11.4
26,73,Isabella,1992,25486,23607,1879,7.4
26,75,Jackson,1992,71004,64191,6813,9.6
26,77,Kalamazoo,1992,118284,111756,6528,5.5
26,79,Kalkaska,1992,6557,5784,773,11.8
26,81,Kent,1992,271916,251544,20372,7.5
26,83,Keweenaw,1992,636,529,107,16.8
26,85,Lake,1992,3057,2633,424,13.9
26,87,Lapeer,1992,39254,34492,4762,12.1
26,89,Leelanau,1992,9416,8690,726,7.7
26,91,Lenawee,1992,44891,41351,3540,7.9
26,93,Livingston,1992,67533,63290,4243,6.3
26,95,Luce,1992,2365,1989,376,15.9
26,97,Mackinac,1992,6412,5384,1028,16.0
26,99,Macomb,1992,403247,366921,36326,9.0
26,101,Manistee,1992,9709,8347,1362,14.0
26,103,Marquette,1992,32913,30189,2724,8.3
26,105,Mason,1992,13402,11758,1644,12.3
26,107,Mecosta,1992,16268,14883,1385,8.5
26,109,Menominee,1992,12478,11424,1054,8.4
26,111,Midland,1992,38906,36120,2786,7.2
26,113,Missaukee,1992,5521,4982,539,9.8
26,115,Monroe,1992,66092,59831,6261,9.5
26,117,Montcalm,1992,23289,20363,2926,12.6
26,119,Montmorency,1992,3525,2853,672,19.1
26,121,Muskegon,1992,74329,66165,8164,11.0
26,123,Newaygo,1992,18456,16229,2227,12.1
26,125,Oakland,1992,620905,573767,47138,7.6
26,127,Oceana,1992,11479,9852,1627,14.2
26,129,Ogemaw,1992,7464,6538,926,12.4
26,131,Ontonagon,1992,4002,3594,408,10.2
26,133,Osceola,1992,9439,8469,970,10.3
26,135,Oscoda,1992,3153,2840,313,9.9
26,137,Otsego,1992,10235,9279,956,9.3
26,139,Ottawa,1992,106852,100307,6545,6.1
26,141,Presque Isle,1992,6240,5216,1024,16.4
26,143,Roscommon,1992,7403,6545,858,11.6
26,145,Saginaw,1992,97322,89087,8235,8.5
26,147,St. Clair,1992,74545,66115,8430,11.3
26,149,St. Joseph,1992,29525,26827,2698,9.1
26,151,Sanilac,1992,18691,16305,2386,12.8
26,153,Schoolcraft,1992,3894,3310,584,15.0
26,155,Shiawassee,1992,34782,30739,4043,11.6
26,157,Tuscola,1992,26244,23351,2893,11.0
26,159,Van Buren,1992,34098,30833,3265,9.6
26,161,Washtenaw,1992,160557,152567,7990,5.0
26,163,Wayne,1992,953580,849423,104157,10.9
26,165,Wexford,1992,12798,11071,1727,13.5
27,1,Aitkin,1992,5351,4722,629,11.8
27,3,Anoka,1992,152712,145519,7193,4.7
27,5,Becker,1992,12658,11255,1403,11.1
27,7,Beltrami,1992,16573,15281,1292,7.8
27,9,Benton,1992,17971,16992,979,5.4
27,11,Big Stone,1992,2820,2679,141,5.0
27,13,Blue Earth,1992,30817,29699,1118,3.6
27,15,Brown,1992,14216,13510,706,5.0
27,17,Carlton,1992,14452,13220,1232,8.5
27,19,Carver,1992,30279,29114,1165,3.8
27,21,Cass,1992,9828,8850,978,10.0
27,23,Chippewa,1992,6141,5736,405,6.6
27,25,Chisago,1992,16446,15340,1106,6.7
27,27,Clay,1992,27824,26736,1088,3.9
27,29,Clearwater,1992,3700,3042,658,17.8
27,31,Cook,1992,2667,2499,168,6.3
27,33,Cottonwood,1992,5886,5447,439,7.5
27,35,Crow Wing,1992,22765,21010,1755,7.7
27,37,Dakota,1992,177196,170142,7054,4.0
27,39,Dodge,1992,8350,7866,484,5.8
27,41,Douglas,1992,14632,13785,847,5.8
27,43,Faribault,1992,8122,7658,464,5.7
27,45,Fillmore,1992,10050,9508,542,5.4
27,47,Freeborn,1992,17102,16366,736,4.3
27,49,Goodhue,1992,22998,22115,883,3.8
27,51,Grant,1992,2808,2624,184,6.6
27,53,Hennepin,1992,620359,593899,26460,4.3
27,55,Houston,1992,10160,9763,397,3.9
27,57,Hubbard,1992,7045,6386,659,9.4
27,59,Isanti,1992,13635,12734,901,6.6
27,61,Itasca,1992,19005,16841,2164,11.4
27,63,Jackson,1992,5337,5060,277,5.2
27,65,Kanabec,1992,6759,6087,672,9.9
27,67,Kandiyohi,1992,19294,18335,959,5.0
27,69,Kittson,1992,2507,2311,196,7.8
27,71,Koochiching,1992,6688,6000,688,10.3
27,73,Lac qui Parle,1992,3905,3728,177,4.5
27,75,Lake,1992,5546,5009,537,9.7
27,77,Lake of the Woods,1992,2220,2099,121,5.5
27,79,Le Sueur,1992,12664,11898,766,6.0
27,81,Lincoln,1992,3045,2917,128,4.2
27,83,Lyon,1992,14041,13536,505,3.6
27,85,McLeod,1992,18914,17946,968,5.1
27,87,Mahnomen,1992,2644,2417,227,8.6
27,89,Marshall,1992,4758,4130,628,13.2
27,91,Martin,1992,11644,10971,673,5.8
27,93,Meeker,1992,9613,8792,821,8.5
27,95,Mille Lacs,1992,9966,9191,775,7.8
27,97,Morrison,1992,14239,12917,1322,9.3
27,99,Mower,1992,18260,17602,658,3.6
27,101,Murray,1992,4489,4226,263,5.9
27,103,Nicollet,1992,16543,15995,548,3.3
27,105,Nobles,1992,9952,9564,388,3.9
27,107,Norman,1992,3473,3216,257,7.4
27,109,Olmsted,1992,64272,62426,1846,2.9
27,111,Otter Tail,1992,25047,23344,1703,6.8
27,113,Pennington,1992,6954,6303,651,9.4
27,115,Pine,1992,10511,9450,1061,10.1
27,117,Pipestone,1992,4848,4622,226,4.7
27,119,Polk,1992,15875,14925,950,6.0
27,121,Pope,1992,5152,4868,284,5.5
27,123,Ramsey,1992,272125,260428,11697,4.3
27,125,Red Lake,1992,2063,1732,331,16.0
27,127,Redwood,1992,9562,9215,347,3.6
27,129,Renville,1992,8039,7509,530,6.6
27,131,Rice,1992,27957,26411,1546,5.5
27,133,Rock,1992,4662,4527,135,2.9
27,135,Roseau,1992,8116,7751,365,4.5
27,137,St. Louis,1992,98337,90963,7374,7.5
27,139,Scott,1992,35772,34119,1653,4.6
27,141,Sherburne,1992,24380,23001,1379,5.7
27,143,Sibley,1992,6729,6293,436,6.5
27,145,Stearns,1992,68587,65170,3417,5.0
27,147,Steele,1992,16967,16184,783,4.6
27,149,Stevens,1992,5119,4907,212,4.1
27,151,Swift,1992,4749,4444,305,6.4
27,153,Todd,1992,10183,9350,833,8.2
27,155,Traverse,1992,1761,1668,93,5.3
27,157,Wabasha,1992,10884,10371,513,4.7
27,159,Wadena,1992,5810,5404,406,7.0
27,161,Waseca,1992,9158,8701,457,5.0
27,163,Washington,1992,89265,85649,3616,4.1
27,165,Watonwan,1992,5847,5583,264,4.5
27,167,Wilkin,1992,3598,3459,139,3.9
27,169,Winona,1992,26526,25221,1305,4.9
27,171,Wright,1992,39344,37036,2308,5.9
27,173,Yellow Medicine,1992,5481,5186,295,5.4
28,1,Adams,1992,14698,13526,1172,8.0
28,3,Alcorn,1992,15577,14189,1388,8.9
28,5,Amite,1992,5057,4705,352,7.0
28,7,Attala,1992,7706,6806,900,11.7
28,9,Benton,1992,3129,2857,272,8.7
28,11,Bolivar,1992,17833,16250,1583,8.9
28,13,Calhoun,1992,7269,6805,464,6.4
28,15,Carroll,1992,4101,3819,282,6.9
28,17,Chickasaw,1992,9073,8183,890,9.8
28,19,Choctaw,1992,3413,3005,408,12.0
28,21,Claiborne,1992,4026,3417,609,15.1
28,23,Clarke,1992,8188,7499,689,8.4
28,25,Clay,1992,9786,8777,1009,10.3
28,27,Coahoma,1992,11826,10529,1297,11.0
28,29,Copiah,1992,11225,10065,1160,10.3
28,31,Covington,1992,7394,6767,627,8.5
28,33,DeSoto,1992,38633,36397,2236,5.8
28,35,Forrest,1992,31206,28943,2263,7.3
28,37,Franklin,1992,3202,2931,271,8.5
28,39,George,1992,7565,6516,1049,13.9
28,41,Greene,1992,4566,4017,549,12.0
28,43,Grenada,1992,9923,9086,837,8.4
28,45,Hancock,1992,13619,12607,1012,7.4
28,47,Harrison,1992,75375,69909,5466,7.3
28,49,Hinds,1992,126578,118867,7711,6.1
28,51,Holmes,1992,6899,6040,859,12.5
28,53,Humphreys,1992,5335,4864,471,8.8
28,55,Issaquena,1992,883,769,114,12.9
28,57,Itawamba,1992,10609,9959,650,6.1
28,59,Jackson,1992,58533,54468,4065,6.9
28,61,Jasper,1992,7434,6543,891,12.0
28,63,Jefferson,1992,2470,1955,515,20.9
28,65,Jefferson Davis,1992,5173,4389,784,15.2
28,67,Jones,1992,28303,26183,2120,7.5
28,69,Kemper,1992,4174,3717,457,10.9
28,71,Lafayette,1992,15422,14511,911,5.9
28,73,Lamar,1992,14401,13539,862,6.0
28,75,Lauderdale,1992,34297,31844,2453,7.2
28,77,Lawrence,1992,5507,4954,553,10.0
28,79,Leake,1992,8360,7716,644,7.7
28,81,Lee,1992,36475,34229,2246,6.2
28,83,Leflore,1992,15572,14042,1530,9.8
28,85,Lincoln,1992,13092,11788,1304,10.0
28,87,Lowndes,1992,26785,24668,2117,7.9
28,89,Madison,1992,28287,26789,1498,5.3
28,91,Marion,1992,10272,9107,1165,11.3
28,93,Marshall,1992,13597,12028,1569,11.5
28,95,Monroe,1992,16693,15267,1426,8.5
28,97,Montgomery,1992,5346,4947,399,7.5
28,99,Neshoba,1992,12622,11866,756,6.0
28,101,Newton,1992,9085,8389,696,7.7
28,103,Noxubee,1992,4467,3984,483,10.8
28,105,Oktibbeha,1992,18783,17403,1380,7.3
28,107,Panola,1992,13481,11895,1586,11.8
28,109,Pearl River,1992,17249,15753,1496,8.7
28,111,Perry,1992,4305,3772,533,12.4
28,113,Pike,1992,15322,13850,1472,9.6
28,115,Pontotoc,1992,12213,11385,828,6.8
28,117,Prentiss,1992,11710,10849,861,7.4
28,119,Quitman,1992,4275,3757,518,12.1
28,121,Rankin,1992,48216,46199,2017,4.2
28,123,Scott,1992,12617,11994,623,4.9
28,125,Sharkey,1992,3117,2721,396,12.7
28,127,Simpson,1992,10510,9909,601,5.7
28,129,Smith,1992,6260,5845,415,6.6
28,131,Stone,1992,5103,4577,526,10.3
28,133,Sunflower,1992,12355,10963,1392,11.3
28,135,Tallahatchie,1992,5874,5228,646,11.0
28,137,Tate,1992,10351,9413,938,9.1
28,139,Tippah,1992,9343,8588,755,8.1
28,141,Tishomingo,1992,10383,9554,829,8.0
28,143,Tunica,1992,3020,2618,402,13.3
28,145,Union,1992,11605,10917,688,5.9
28,147,Walthall,1992,5602,5047,555,9.9
28,149,Warren,1992,22750,20806,1944,8.5
28,151,Washington,1992,27739,24376,3363,12.1
28,153,Wayne,1992,8908,7881,1027,11.5
28,155,Webster,1992,4478,4075,403,9.0
28,157,Wilkinson,1992,3374,2968,406,12.0
28,159,Winston,1992,8062,6804,1258,15.6
28,161,Yalobusha,1992,5078,4573,505,9.9
28,163,Yazoo,1992,9483,8657,826,8.7
29,1,Adair,1992,13456,13088,368,2.7
29,3,Andrew,1992,7511,7076,435,5.8
29,5,Atchison,1992,2945,2807,138,4.7
29,7,Audrain,1992,11506,10826,680,5.9
29,9,Barry,1992,13324,12495,829,6.2
29,11,Barton,1992,6085,5871,214,3.5
29,13,Bates,1992,7299,6790,509,7.0
29,15,Benton,1992,5615,5058,557,9.9
29,17,Bollinger,1992,4689,4264,425,9.1
29,19,Boone,1992,70586,68718,1868,2.6
29,21,Buchanan,1992,40883,37745,3138,7.7
29,23,Butler,1992,17541,16088,1453,8.3
29,25,Caldwell,1992,3602,3323,279,7.7
29,27,Callaway,1992,17793,16883,910,5.1
29,29,Camden,1992,13562,12367,1195,8.8
29,31,Cape Girardeau,1992,33165,31299,1866,5.6
29,33,Carroll,1992,4976,4628,348,7.0
29,35,Carter,1992,2273,2045,228,10.0
29,37,Cass,1992,35688,33714,1974,5.5
29,39,Cedar,1992,5178,4859,319,6.2
29,41,Chariton,1992,4153,3834,319,7.7
29,43,Christian,1992,19125,18209,916,4.8
29,45,Clark,1992,3606,3389,217,6.0
29,47,Clay,1992,90010,86236,3774,4.2
29,49,Clinton,1992,8297,7841,456,5.5
29,51,Cole,1992,34814,33550,1264,3.6
29,53,Cooper,1992,8290,7837,453,5.5
29,55,Crawford,1992,9700,8683,1017,10.5
29,57,Dade,1992,3160,2959,201,6.4
29,59,Dallas,1992,5764,5244,520,9.0
29,61,Daviess,1992,3255,2998,257,7.9
29,63,DeKalb,1992,3678,3433,245,6.7
29,65,Dent,1992,5976,5432,544,9.1
29,67,Douglas,1992,5311,4916,395,7.4
29,69,Dunklin,1992,13284,11936,1348,10.1
29,71,Franklin,1992,42778,39255,3523,8.2
29,73,Gasconade,1992,7149,6454,695,9.7
29,75,Gentry,1992,3237,3114,123,3.8
29,77,Greene,1992,114454,108885,5569,4.9
29,79,Grundy,1992,4916,4680,236,4.8
29,81,Harrison,1992,4046,3873,173,4.3
29,83,Henry,1992,9363,8559,804,8.6
29,85,Hickory,1992,2658,2426,232,8.7
29,87,Holt,1992,2844,2700,144,5.1
29,89,Howard,1992,4694,4476,218,4.6
29,91,Howell,1992,15308,14237,1071,7.0
29,93,Iron,1992,4159,3618,541,13.0
29,95,Jackson,1992,337428,317098,20330,6.0
29,97,Jasper,1992,47305,44711,2594,5.5
29,99,Jefferson,1992,92749,86264,6485,7.0
29,101,Johnson,1992,20764,19854,910,4.4
29,103,Knox,1992,1942,1845,97,5.0
29,105,Laclede,1992,12928,11729,1199,9.3
29,107,Lafayette,1992,15055,14228,827,5.5
29,109,Lawrence,1992,14738,13788,950,6.4
29,111,Lewis,1992,4824,4529,295,6.1
29,113,Lincoln,1992,15008,13857,1151,7.7
29,115,Linn,1992,6632,6029,603,9.1
29,117,Livingston,1992,6838,6552,286,4.2
29,119,McDonald,1992,6895,6381,514,7.5
29,121,Macon,1992,7409,6922,487,6.6
29,123,Madison,1992,4620,3846,774,16.8
29,125,Maries,1992,4149,3775,374,9.0
29,127,Marion,1992,14402,13565,837,5.8
29,129,Mercer,1992,1707,1634,73,4.3
29,131,Miller,1992,10388,9339,1049,10.1
29,133,Mississippi,1992,6134,5373,761,12.4
29,135,Moniteau,1992,6544,6077,467,7.1
29,137,Monroe,1992,4300,4066,234,5.4
29,139,Montgomery,1992,5524,5146,378,6.8
29,141,Morgan,1992,7432,6788,644,8.7
29,143,New Madrid,1992,8475,7662,813,9.6
29,145,Newton,1992,24116,22411,1705,7.1
29,147,Nodaway,1992,11954,11683,271,2.3
29,149,Oregon,1992,3971,3671,300,7.6
29,151,Osage,1992,6569,6277,292,4.4
29,153,Ozark,1992,3681,3439,242,6.6
29,155,Pemiscot,1992,7906,6994,912,11.5
29,157,Perry,1992,9496,9042,454,4.8
29,159,Pettis,1992,18469,16997,1472,8.0
29,161,Phelps,1992,17387,16353,1034,5.9
29,163,Pike,1992,7121,6588,533,7.5
29,165,Platte,1992,36217,34862,1355,3.7
29,167,Polk,1992,10302,9664,638,6.2
29,169,Pulaski,1992,12983,11703,1280,9.9
29,171,Putnam,1992,1983,1907,76,3.8
29,173,Ralls,1992,4607,4374,233,5.1
29,175,Randolph,1992,10220,9473,747,7.3
29,177,Ray,1992,10069,9469,600,6.0
29,179,Reynolds,1992,2885,2621,264,9.2
29,181,Ripley,1992,4454,4018,436,9.8
29,183,St. Charles,1992,126990,120311,6679,5.3
29,185,St. Clair,1992,3579,3297,282,7.9
29,186,Ste. Genevieve,1992,8225,7698,527,6.4
29,187,St. Francois,1992,20643,18484,2159,10.5
29,189,St. Louis,1992,542001,515934,26067,4.8
29,195,Saline,1992,10750,9931,819,7.6
29,197,Schuyler,1992,2198,2103,95,4.3
29,199,Scotland,1992,2303,2221,82,3.6
29,201,Scott,1992,18683,17213,1470,7.9
29,203,Shannon,1992,3660,3326,334,9.1
29,205,Shelby,1992,3212,3049,163,5.1
29,207,Stoddard,1992,13044,11612,1432,11.0
29,209,Stone,1992,11423,10341,1082,9.5
29,211,Sullivan,1992,2815,2710,105,3.7
29,213,Taney,1992,18742,16936,1806,9.6
29,215,Texas,1992,9162,8180,982,10.7
29,217,Vernon,1992,8337,7874,463,5.6
29,219,Warren,1992,10365,9602,763,7.4
29,221,Washington,1992,8185,7058,1127,13.8
29,223,Wayne,1992,4148,3489,659,15.9
29,225,Webster,1992,11418,10695,723,6.3
29,227,Worth,1992,966,918,48,5.0
29,229,Wright,1992,7512,6890,622,8.3
29,510,St. Louis city,1992,173795,158223,15572,9.0
30,1,Beaverhead,1992,4481,4216,265,5.9
30,3,Big Horn,1992,5122,4380,742,14.5
30,5,Blaine,1992,2843,2621,222,7.8
30,7,Broadwater,1992,1828,1738,90,4.9
30,9,Carbon,1992,3911,3707,204,5.2
30,11,Carter,1992,939,924,15,1.6
30,13,Cascade,1992,36634,34367,2267,6.2
30,15,Chouteau,1992,2645,2575,70,2.6
30,17,Custer,1992,6009,5693,316,5.3
30,19,Daniels,1992,1119,1094,25,2.2
30,21,Dawson,1992,4777,4590,187,3.9
30,23,Deer Lodge,1992,4149,3700,449,10.8
30,25,Fallon,1992,1546,1496,50,3.2
30,27,Fergus,1992,5837,5468,369,6.3
30,29,Flathead,1992,32388,29758,2630,8.1
30,31,Gallatin,1992,31794,30117,1677,5.3
30,33,Garfield,1992,929,912,17,1.8
30,35,Glacier,1992,5570,4802,768,13.8
30,37,Golden Valley,1992,487,446,41,8.4
30,39,Granite,1992,1292,1187,105,8.1
30,41,Hill,1992,8513,7965,548,6.4
30,43,Jefferson,1992,4198,3977,221,5.3
30,45,Judith Basin,1992,1149,1096,53,4.6
30,47,Lake,1992,10141,9245,896,8.8
30,49,Lewis and Clark,1992,26346,24912,1434,5.4
30,51,Liberty,1992,1014,990,24,2.4
30,53,Lincoln,1992,8068,6924,1144,14.2
30,55,McCone,1992,1228,1188,40,3.3
30,57,Madison,1992,3360,3200,160,4.8
30,59,Meagher,1992,930,882,48,5.2
30,61,Mineral,1992,1720,1541,179,10.4
30,63,Missoula,1992,45470,42511,2959,6.5
30,65,Musselshell,1992,1805,1673,132,7.3
30,67,Park,1992,8333,7837,496,6.0
30,69,Petroleum,1992,313,294,19,6.1
30,71,Phillips,1992,2450,2318,132,5.4
30,73,Pondera,1992,3004,2860,144,4.8
30,75,Powder River,1992,1218,1183,35,2.9
30,77,Powell,1992,2624,2442,182,6.9
30,79,Prairie,1992,700,672,28,4.0
30,81,Ravalli,1992,13144,11954,1190,9.1
30,83,Richland,1992,5427,5027,400,7.4
30,85,Roosevelt,1992,4420,3889,531,12.0
30,87,Rosebud,1992,4902,4499,403,8.2
30,89,Sanders,1992,3760,3276,484,12.9
30,91,Sheridan,1992,2147,2093,54,2.5
30,93,Silver Bow,1992,16531,15231,1300,7.9
30,95,Stillwater,1992,3264,3059,205,6.3
30,97,Sweet Grass,1992,1614,1566,48,3.0
30,99,Teton,1992,2896,2803,93,3.2
30,101,Toole,1992,2749,2648,101,3.7
30,103,Treasure,1992,542,509,33,6.1
30,105,Valley,1992,4261,4032,229,5.4
30,107,Wheatland,1992,1184,1142,42,3.5
30,109,Wibaux,1992,538,508,30,5.6
30,111,Yellowstone,1992,64811,61268,3543,5.5
31,1,Adams,1992,15475,15188,287,1.9
31,3,Antelope,1992,3329,3245,84,2.5
31,5,Arthur,1992,225,220,5,2.2
31,7,Banner,1992,421,414,7,1.7
31,9,Blaine,1992,366,352,14,3.8
31,11,Boone,1992,3003,2941,62,2.1
31,13,Box Butte,1992,6215,6007,208,3.3
31,15,Boyd,1992,1219,1197,22,1.8
31,17,Brown,1992,1767,1713,54,3.1
31,19,Buffalo,1992,22227,21612,615,2.8
31,21,Burt,1992,3519,3375,144,4.1
31,23,Butler,1992,4068,3949,119,2.9
31,25,Cass,1992,10883,10514,369,3.4
31,27,Cedar,1992,4975,4888,87,1.7
31,29,Chase,1992,1927,1888,39,2.0
31,31,Cherry,1992,3261,3198,63,1.9
31,33,Cheyenne,1992,4845,4746,99,2.0
31,35,Clay,1992,3433,3363,70,2.0
31,37,Colfax,1992,4658,4590,68,1.5
31,39,Cuming,1992,5079,4968,111,2.2
31,41,Custer,1992,5749,5599,150,2.6
31,43,Dakota,1992,9097,8810,287,3.2
31,45,Dawes,1992,4287,4145,142,3.3
31,47,Dawson,1992,12693,12252,441,3.5
31,49,Deuel,1992,1090,1061,29,2.7
31,51,Dixon,1992,3069,2992,77,2.5
31,53,Dodge,1992,17981,17390,591,3.3
31,55,Douglas,1992,230205,222734,7471,3.2
31,57,Dundy,1992,1243,1224,19,1.5
31,59,Fillmore,1992,3382,3317,65,1.9
31,61,Franklin,1992,1717,1676,41,2.4
31,63,Frontier,1992,1504,1472,32,2.1
31,65,Furnas,1992,2541,2501,40,1.6
31,67,Gage,1992,11708,11437,271,2.3
31,69,Garden,1992,1119,1099,20,1.8
31,71,Garfield,1992,1060,1023,37,3.5
31,73,Gosper,1992,1216,1191,25,2.1
31,75,Grant,1992,387,382,5,1.3
31,77,Greeley,1992,1512,1461,51,3.4
31,79,Hall,1992,28774,28000,774,2.7
31,81,Hamilton,1992,4946,4859,87,1.8
31,83,Harlan,1992,1798,1754,44,2.4
31,85,Hayes,1992,539,528,11,2.0
31,87,Hitchcock,1992,1635,1597,38,2.3
31,89,Holt,1992,6069,5914,155,2.6
31,91,Hooker,1992,375,366,9,2.4
31,93,Howard,1992,3235,3152,83,2.6
31,95,Jefferson,1992,4307,4207,100,2.3
31,97,Johnson,1992,2358,2294,64,2.7
31,99,Kearney,1992,3376,3314,62,1.8
31,101,Keith,1992,4392,4271,121,2.8
31,103,Keya Paha,1992,497,485,12,2.4
31,105,Kimball,1992,2103,2049,54,2.6
31,107,Knox,1992,4427,4294,133,3.0
31,109,Lancaster,1992,128782,125481,3301,2.6
31,111,Lincoln,1992,17448,16891,557,3.2
31,113,Logan,1992,436,428,8,1.8
31,115,Loup,1992,459,449,10,2.2
31,117,McPherson,1992,299,293,6,2.0
31,119,Madison,1992,17580,17130,450,2.6
31,121,Merrick,1992,4470,4378,92,2.1
31,123,Morrill,1992,2760,2642,118,4.3
31,125,Nance,1992,2024,1977,47,2.3
31,127,Nemaha,1992,3526,3354,172,4.9
31,129,Nuckolls,1992,2485,2441,44,1.8
31,131,Otoe,1992,7363,7101,262,3.6
31,133,Pawnee,1992,1499,1466,33,2.2
31,135,Perkins,1992,1456,1421,35,2.4
31,137,Phelps,1992,5230,5158,72,1.4
31,139,Pierce,1992,3642,3567,75,2.1
31,141,Platte,1992,16149,15758,391,2.4
31,143,Polk,1992,2611,2566,45,1.7
31,145,Red Willow,1992,5878,5722,156,2.7
31,147,Richardson,1992,4694,4501,193,4.1
31,149,Rock,1992,1001,977,24,2.4
31,151,Saline,1992,6767,6659,108,1.6
31,153,Sarpy,1992,50614,49219,1395,2.8
31,155,Saunders,1992,10197,9911,286,2.8
31,157,Scotts Bluff,1992,18501,17693,808,4.4
31,159,Seward,1992,8883,8654,229,2.6
31,161,Sheridan,1992,3025,2954,71,2.3
31,163,Sherman,1992,1629,1581,48,2.9
31,165,Sioux,1992,808,797,11,1.4
31,167,Stanton,1992,3069,2991,78,2.5
31,169,Thayer,1992,3204,3139,65,2.0
31,171,Thomas,1992,407,391,16,3.9
31,173,Thurston,1992,2585,2381,204,7.9
31,175,Valley,1992,2768,2708,60,2.2
31,177,Washington,1992,9221,8997,224,2.4
31,179,Wayne,1992,5533,5377,156,2.8
31,181,Webster,1992,1840,1808,32,1.7
31,183,Wheeler,1992,447,438,9,2.0
31,185,York,1992,7870,7751,119,1.5
32,1,Churchill,1992,8284,7623,661,8.0
32,3,Clark,1992,459435,428101,31334,6.8
32,5,Douglas,1992,16007,14934,1073,6.7
32,7,Elko,1992,19428,18274,1154,5.9
32,9,Esmeralda,1992,745,684,61,8.2
32,11,Eureka,1992,860,810,50,5.8
32,13,Humboldt,1992,7792,7339,453,5.8
32,15,Lander,1992,3191,2933,258,8.1
32,17,Lincoln,1992,1502,1355,147,9.8
32,19,Lyon,1992,10055,9074,981,9.8
32,21,Mineral,1992,3241,3066,175,5.4
32,23,Nye,1992,9781,9204,577,5.9
32,27,Pershing,1992,2166,2028,138,6.4
32,29,Storey,1992,1377,1318,59,4.3
32,31,Washoe,1992,159718,149527,10191,6.4
32,33,White Pine,1992,3718,3346,372,10.0
32,510,Carson City,1992,21592,19575,2017,9.3
33,1,Belknap,1992,26505,24425,2080,7.8
33,3,Carroll,1992,18934,17761,1173,6.2
33,5,Cheshire,1992,38504,36250,2254,5.9
33,7,Coos,1992,17682,15842,1840,10.4
33,9,Grafton,1992,40385,38059,2326,5.8
33,11,Hillsborough,1992,191203,177187,14016,7.3
33,13,Merrimack,1992,66585,62481,4104,6.2
33,15,Rockingham,1992,141495,129666,11829,8.4
33,17,Strafford,1992,57149,53076,4073,7.1
33,19,Sullivan,1992,19576,18233,1343,6.9
34,1,Atlantic,1992,123603,110766,12837,10.4
34,3,Bergen,1992,432911,401362,31549,7.3
34,5,Burlington,1992,207954,191654,16300,7.8
34,7,Camden,1992,257872,233889,23983,9.3
34,9,Cape May,1992,45689,39629,6060,13.3
34,11,Cumberland,1992,66190,58088,8102,12.2
34,13,Essex,1992,387331,348273,39058,10.1
34,15,Gloucester,1992,123328,112408,10920,8.9
34,17,Hudson,1992,282613,250730,31883,11.3
34,19,Hunterdon,1992,60865,57767,3098,5.1
34,21,Mercer,1992,172045,160621,11424,6.6
34,23,Middlesex,1992,378328,349423,28905,7.6
34,25,Monmouth,1992,289494,267925,21569,7.5
34,27,Morris,1992,244505,229060,15445,6.3
34,29,Ocean,1992,192356,176283,16073,8.4
34,31,Passaic,1992,231031,206449,24582,10.6
34,33,Salem,1992,31614,28918,2696,8.5
34,35,Somerset,1992,143214,135750,7464,5.2
34,37,Sussex,1992,72672,66846,5826,8.0
34,39,Union,1992,265852,242484,23368,8.8
34,41,Warren,1992,48968,45123,3845,7.9
35,1,Bernalillo,1992,257850,244537,13313,5.2
35,3,Catron,1992,1169,1036,133,11.4
35,5,Chaves,1992,25052,22096,2956,11.8
35,6,Cibola,1992,9384,8113,1271,13.5
35,7,Colfax,1992,6144,5545,599,9.7
35,9,Curry,1992,19174,18047,1127,5.9
35,11,De Baca,1992,904,842,62,6.9
35,13,Dona Ana,1992,61009,56020,4989,8.2
35,15,Eddy,1992,22995,21187,1808,7.9
35,17,Grant,1992,11163,9901,1262,11.3
35,19,Guadalupe,1992,1765,1547,218,12.4
35,21,Harding,1992,456,432,24,5.3
35,23,Hidalgo,1992,2728,2569,159,5.8
35,25,Lea,1992,24499,22877,1622,6.6
35,27,Lincoln,1992,6396,5935,461,7.2
35,28,Los Alamos,1992,10831,10669,162,1.5
35,29,Luna,1992,8772,7308,1464,16.7
35,31,McKinley,1992,23413,21485,1928,8.2
35,33,Mora,1992,1550,1177,373,24.1
35,35,Otero,1992,19975,18192,1783,8.9
35,37,Quay,1992,4798,4498,300,6.3
35,39,Rio Arriba,1992,15389,13014,2375,15.4
35,41,Roosevelt,1992,7305,6924,381,5.2
35,43,Sandoval,1992,31544,29805,1739,5.5
35,45,San Juan,1992,43428,38308,5120,11.8
35,47,San Miguel,1992,11040,9784,1256,11.4
35,49,Santa Fe,1992,58931,56498,2433,4.1
35,51,Sierra,1992,3475,3277,198,5.7
35,53,Socorro,1992,6828,6241,587,8.6
35,55,Taos,1992,12112,9872,2240,18.5
35,57,Torrance,1992,4686,4202,484,10.3
35,59,Union,1992,1839,1754,85,4.6
35,61,Valencia,1992,20680,19458,1222,5.9
36,1,Albany,1992,156345,148416,7929,5.1
36,3,Allegany,1992,23019,20780,2239,9.7
36,5,Bronx,1992,458221,397984,60237,13.1
36,7,Broome,1992,104278,97150,7128,6.8
36,9,Cattaraugus,1992,39397,35417,3980,10.1
36,11,Cayuga,1992,38522,35405,3117,8.1
36,13,Chautauqua,1992,67950,62260,5690,8.4
36,15,Chemung,1992,43191,40202,2989,6.9
36,17,Chenango,1992,25012,23046,1966,7.9
36,19,Clinton,1992,40390,36760,3630,9.0
36,21,Columbia,1992,31355,29526,1829,5.8
36,23,Cortland,1992,24941,22880,2061,8.3
36,25,Delaware,1992,21133,19463,1670,7.9
36,27,Dutchess,1992,125779,117244,8535,6.8
36,29,Erie,1992,475214,440103,35111,7.4
36,31,Essex,1992,18662,16338,2324,12.5
36,33,Franklin,1992,21319,19063,2256,10.6
36,35,Fulton,1992,26923,24193,2730,10.1
36,37,Genesee,1992,32047,29447,2600,8.1
36,39,Greene,1992,21566,19621,1945,9.0
36,41,Hamilton,1992,2854,2513,341,11.9
36,43,Herkimer,1992,30227,27539,2688,8.9
36,45,Jefferson,1992,46561,40862,5699,12.2
36,47,Kings,1992,952128,836491,115637,12.1
36,49,Lewis,1992,12718,11299,1419,11.2
36,51,Livingston,1992,33156,30903,2253,6.8
36,53,Madison,1992,35747,32946,2801,7.8
36,55,Monroe,1992,380034,361210,18824,5.0
36,57,Montgomery,1992,24584,22112,2472,10.1
36,59,Nassau,1992,680170,631475,48695,7.2
36,61,New York,1992,771320,698552,72768,9.4
36,63,Niagara,1992,109231,99961,9270,8.5
36,65,Oneida,1992,113864,105822,8042,7.1
36,67,Onondaga,1992,242330,226380,15950,6.6
36,69,Ontario,1992,52017,48773,3244,6.2
36,71,Orange,1992,154455,144305,10150,6.6
36,73,Orleans,1992,20554,18774,1780,8.7
36,75,Oswego,1992,58142,52034,6108,10.5
36,77,Otsego,1992,31150,28951,2199,7.1
36,79,Putnam,1992,48374,45412,2962,6.1
36,81,Queens,1992,953966,852964,101002,10.6
36,83,Rensselaer,1992,81860,76559,5301,6.5
36,85,Richmond,1992,184206,165957,18249,9.9
36,87,Rockland,1992,141705,132446,9259,6.5
36,89,St. Lawrence,1992,51649,46492,5157,10.0
36,91,Saratoga,1992,99007,93109,5898,6.0
36,93,Schenectady,1992,75408,70594,4814,6.4
36,95,Schoharie,1992,15668,14335,1333,8.5
36,97,Schuyler,1992,9096,8302,794,8.7
36,99,Seneca,1992,16782,15667,1115,6.6
36,101,Steuben,1992,48605,44642,3963,8.2
36,103,Suffolk,1992,694417,636836,57581,8.3
36,105,Sullivan,1992,33593,30500,3093,9.2
36,107,Tioga,1992,26407,24628,1779,6.7
36,109,Tompkins,1992,48174,45887,2287,4.7
36,111,Ulster,1992,83879,78204,5675,6.8
36,113,Warren,1992,31861,28787,3074,9.6
36,115,Washington,1992,29067,26692,2375,8.2
36,117,Wayne,1992,47505,43986,3519,7.4
36,119,Westchester,1992,452390,423882,28508,6.3
36,121,Wyoming,1992,20225,18424,1801,8.9
36,123,Yates,1992,11598,10751,847,7.3
37,1,Alamance,1992,62628,59197,3431,5.5
37,3,Alexander,1992,16374,15650,724,4.4
37,5,Alleghany,1992,5075,4725,350,6.9
37,7,Anson,1992,12450,10660,1790,14.4
37,9,Ashe,1992,11632,10533,1099,9.4
37,11,Avery,1992,7363,6625,738,10.0
37,13,Beaufort,1992,20735,18860,1875,9.0
37,15,Bertie,1992,9285,8611,674,7.3
37,17,Bladen,1992,14405,12667,1738,12.1
37,19,Brunswick,1992,27246,24160,3086,11.3
37,21,Buncombe,1992,96709,91322,5387,5.6
37,23,Burke,1992,43213,40671,2542,5.9
37,25,Cabarrus,1992,57146,53663,3483,6.1
37,27,Caldwell,1992,41031,38899,2132,5.2
37,29,Camden,1992,2840,2687,153,5.4
37,31,Carteret,1992,27324,25577,1747,6.4
37,33,Caswell,1992,11160,10530,630,5.6
37,35,Catawba,1992,73930,69305,4625,6.3
37,37,Chatham,1992,22973,22057,916,4.0
37,39,Cherokee,1992,9221,8142,1079,11.7
37,41,Chowan,1992,6597,6161,436,6.6
37,43,Clay,1992,3183,2916,267,8.4
37,45,Cleveland,1992,46277,42739,3538,7.6
37,47,Columbus,1992,25076,22480,2596,10.4
37,49,Craven,1992,35444,33108,2336,6.6
37,51,Cumberland,1992,109539,102959,6580,6.0
37,53,Currituck,1992,7211,6946,265,3.7
37,55,Dare,1992,14981,13772,1209,8.1
37,57,Davidson,1992,75049,70112,4937,6.6
37,59,Davie,1992,15601,14929,672,4.3
37,61,Duplin,1992,21131,19111,2020,9.6
37,63,Durham,1992,105956,101536,4420,4.2
37,65,Edgecombe,1992,28505,26026,2479,8.7
37,67,Forsyth,1992,146606,138887,7719,5.3
37,69,Franklin,1992,19950,18565,1385,6.9
37,71,Gaston,1992,96587,89668,6919,7.2
37,73,Gates,1992,4287,4086,201,4.7
37,75,Graham,1992,4117,3375,742,18.0
37,77,Granville,1992,20866,19618,1248,6.0
37,79,Greene,1992,7777,7368,409,5.3
37,81,Guilford,1992,205584,194287,11297,5.5
37,83,Halifax,1992,25169,22901,2268,9.0
37,85,Harnett,1992,31864,29827,2037,6.4
37,87,Haywood,1992,24290,22648,1642,6.8
37,89,Henderson,1992,33111,31419,1692,5.1
37,91,Hertford,1992,10533,9494,1039,9.9
37,93,Hoke,1992,10063,9201,862,8.6
37,95,Hyde,1992,2896,2594,302,10.4
37,97,Iredell,1992,54685,51682,3003,5.5
37,99,Jackson,1992,14278,13225,1053,7.4
37,101,Johnston,1992,47264,44738,2526,5.3
37,103,Jones,1992,4535,4251,284,6.3
37,105,Lee,1992,23557,21924,1633,6.9
37,107,Lenoir,1992,29444,27320,2124,7.2
37,109,Lincoln,1992,28681,27009,1672,5.8
37,111,McDowell,1992,19451,17882,1569,8.1
37,113,Macon,1992,11922,11099,823,6.9
37,115,Madison,1992,8546,8008,538,6.3
37,117,Martin,1992,13570,12567,1003,7.4
37,119,Mecklenburg,1992,307028,290846,16182,5.3
37,121,Mitchell,1992,7201,6469,732,10.2
37,123,Montgomery,1992,12408,11153,1255,10.1
37,125,Moore,1992,28635,26553,2082,7.3
37,127,Nash,1992,43626,40291,3335,7.6
37,129,New Hanover,1992,70359,64985,5374,7.6
37,131,Northampton,1992,9033,8298,735,8.1
37,133,Onslow,1992,41740,39625,2115,5.1
37,135,Orange,1992,56088,54451,1637,2.9
37,137,Pamlico,1992,5273,4960,313,5.9
37,139,Pasquotank,1992,13568,12764,804,5.9
37,141,Pender,1992,15303,13882,1421,9.3
37,143,Perquimans,1992,4398,4128,270,6.1
37,145,Person,1992,16457,14780,1677,10.2
37,147,Pitt,1992,58228,54421,3807,6.5
37,149,Polk,1992,7361,7075,286,3.9
37,151,Randolph,1992,64636,61737,2899,4.5
37,153,Richmond,1992,21948,19930,2018,9.2
37,155,Robeson,1992,53970,48189,5781,10.7
37,157,Rockingham,1992,47440,43712,3728,7.9
37,159,Rowan,1992,58888,55551,3337,5.7
37,161,Rutherford,1992,30713,28712,2001,6.5
37,163,Sampson,1992,23790,22118,1672,7.0
37,165,Scotland,1992,17255,15298,1957,11.3
37,167,Stanly,1992,28407,26580,1827,6.4
37,169,Stokes,1992,20733,19835,898,4.3
37,171,Surry,1992,35337,33202,2135,6.0
37,173,Swain,1992,6379,5210,1169,18.3
37,175,Transylvania,1992,11988,11312,676,5.6
37,177,Tyrrell,1992,1962,1662,300,15.3
37,179,Union,1992,48302,45622,2680,5.5
37,181,Vance,1992,20647,18619,2028,9.8
37,183,Wake,1992,272509,262657,9852,3.6
37,185,Warren,1992,7655,6867,788,10.3
37,187,Washington,1992,6217,5693,524,8.4
37,189,Watauga,1992,20803,20037,766,3.7
37,191,Wayne,1992,47763,44275,3488,7.3
37,193,Wilkes,1992,32814,31112,1702,5.2
37,195,Wilson,1992,36494,32482,4012,11.0
37,197,Yadkin,1992,16576,15800,776,4.7
37,199,Yancey,1992,6639,5987,652,9.8
38,1,Adams,1992,1538,1504,34,2.2
38,3,Barnes,1992,5469,5269,200,3.7
38,5,Benson,1992,2755,2386,369,13.4
38,7,Billings,1992,573,542,31,5.4
38,9,Bottineau,1992,3377,3232,145,4.3
38,11,Bowman,1992,1821,1739,82,4.5
38,13,Burke,1992,1102,1057,45,4.1
38,15,Burleigh,1992,35557,34141,1416,4.0
38,17,Cass,1992,61859,59973,1886,3.0
38,19,Cavalier,1992,2533,2430,103,4.1
38,21,Dickey,1992,2780,2700,80,2.9
38,23,Divide,1992,1144,1125,19,1.7
38,25,Dunn,1992,1856,1783,73,3.9
38,27,Eddy,1992,1243,1110,133,10.7
38,29,Emmons,1992,2085,1982,103,4.9
38,31,Foster,1992,1915,1828,87,4.5
38,33,Golden Valley,1992,887,847,40,4.5
38,35,Grand Forks,1992,34350,33185,1165,3.4
38,37,Grant,1992,1519,1467,52,3.4
38,39,Griggs,1992,1445,1394,51,3.5
38,41,Hettinger,1992,1389,1329,60,4.3
38,43,Kidder,1992,1459,1370,89,6.1
38,45,LaMoure,1992,2297,2241,56,2.4
38,47,Logan,1992,1187,1159,28,2.4
38,49,McHenry,1992,2712,2548,164,6.0
38,51,McIntosh,1992,1727,1692,35,2.0
38,53,McKenzie,1992,2895,2764,131,4.5
38,55,McLean,1992,4551,4232,319,7.0
38,57,Mercer,1992,4883,4448,435,8.9
38,59,Morton,1992,12585,11886,699,5.6
38,61,Mountrail,1992,2998,2739,259,8.6
38,63,Nelson,1992,1697,1630,67,3.9
38,65,Oliver,1992,1124,1063,61,5.4
38,67,Pembina,1992,4803,4422,381,7.9
38,69,Pierce,1992,2254,2178,76,3.4
38,71,Ramsey,1992,6335,6068,267,4.2
38,73,Ransom,1992,2601,2519,82,3.2
38,75,Renville,1992,1335,1292,43,3.2
38,77,Richland,1992,8404,8075,329,3.9
38,79,Rolette,1992,4735,4013,722,15.2
38,81,Sargent,1992,2118,2045,73,3.4
38,83,Sheridan,1992,710,677,33,4.6
38,85,Sioux,1992,1375,1049,326,23.7
38,87,Slope,1992,428,409,19,4.4
38,89,Stark,1992,11884,11229,655,5.5
38,91,Steele,1992,1029,1005,24,2.3
38,93,Stutsman,1992,10977,10532,445,4.1
38,95,Towner,1992,1544,1499,45,2.9
38,97,Traill,1992,3781,3629,152,4.0
38,99,Walsh,1992,6422,6096,326,5.1
38,101,Ward,1992,26596,25346,1250,4.7
38,103,Wells,1992,2480,2287,193,7.8
38,105,Williams,1992,10110,9545,565,5.6
39,1,Adams,1992,10587,9008,1579,14.9
39,3,Allen,1992,52023,47669,4354,8.4
39,5,Ashland,1992,25538,23762,1776,7.0
39,7,Ashtabula,1992,45861,41127,4734,10.3
39,9,Athens,1992,24903,23118,1785,7.2
39,11,Auglaize,1992,23596,21970,1626,6.9
39,13,Belmont,1992,30380,27808,2572,8.5
39,15,Brown,1992,17483,15904,1579,9.0
39,17,Butler,1992,155170,144617,10553,6.8
39,19,Carroll,1992,12793,11519,1274,10.0
39,21,Champaign,1992,19431,18041,1390,7.2
39,23,Clark,1992,70522,65063,5459,7.7
39,25,Clermont,1992,83505,77941,5564,6.7
39,27,Clinton,1992,19485,18025,1460,7.5
39,29,Columbiana,1992,51029,46114,4915,9.6
39,31,Coshocton,1992,16438,15051,1387,8.4
39,33,Crawford,1992,22641,20159,2482,11.0
39,35,Cuyahoga,1992,681114,631352,49762,7.3
39,37,Darke,1992,27814,25598,2216,8.0
39,39,Defiance,1992,19248,17788,1460,7.6
39,41,Delaware,1992,38745,36820,1925,5.0
39,43,Erie,1992,43039,39521,3518,8.2
39,45,Fairfield,1992,55857,52436,3421,6.1
39,47,Fayette,1992,13699,12563,1136,8.3
39,49,Franklin,1992,547587,521651,25936,4.7
39,51,Fulton,1992,21234,19240,1994,9.4
39,53,Gallia,1992,13467,12075,1392,10.3
39,55,Geauga,1992,43510,40980,2530,5.8
39,57,Greene,1992,67912,63991,3921,5.8
39,59,Guernsey,1992,19430,16450,2980,15.3
39,61,Hamilton,1992,441331,415967,25364,5.7
39,63,Hancock,1992,37828,35479,2349,6.2
39,65,Hardin,1992,14475,13098,1377,9.5
39,67,Harrison,1992,6934,6253,681,9.8
39,69,Henry,1992,16238,14879,1359,8.4
39,71,Highland,1992,16996,15389,1607,9.5
39,73,Hocking,1992,11839,10613,1226,10.4
39,75,Holmes,1992,15314,14563,751,4.9
39,77,Huron,1992,29976,26037,3939,13.1
39,79,Jackson,1992,13348,12100,1248,9.3
39,81,Jefferson,1992,32354,29347,3007,9.3
39,83,Knox,1992,24836,23162,1674,6.7
39,85,Lake,1992,120629,111839,8790,7.3
39,87,Lawrence,1992,25644,23638,2006,7.8
39,89,Licking,1992,66701,62590,4111,6.2
39,91,Logan,1992,22318,20671,1647,7.4
39,93,Lorain,1992,137259,125117,12142,8.8
39,95,Lucas,1992,224368,204718,19650,8.8
39,97,Madison,1992,18749,17676,1073,5.7
39,99,Mahoning,1992,120209,108724,11485,9.6
39,101,Marion,1992,31660,28983,2677,8.5
39,103,Medina,1992,68100,63558,4542,6.7
39,105,Meigs,1992,8797,7685,1112,12.6
39,107,Mercer,1992,20240,18503,1737,8.6
39,109,Miami,1992,49108,45734,3374,6.9
39,111,Monroe,1992,6301,5532,769,12.2
39,113,Montgomery,1992,285494,266812,18682,6.5
39,115,Morgan,1992,5734,4981,753,13.1
39,117,Morrow,1992,13414,12216,1198,8.9
39,119,Muskingum,1992,40679,36478,4201,10.3
39,121,Noble,1992,5198,4596,602,11.6
39,123,Ottawa,1992,21301,18766,2535,11.9
39,125,Paulding,1992,9027,8385,642,7.1
39,127,Perry,1992,14354,12454,1900,13.2
39,129,Pickaway,1992,22397,21024,1373,6.1
39,131,Pike,1992,10097,8897,1200,11.9
39,133,Portage,1992,78447,72854,5593,7.1
39,135,Preble,1992,19896,18271,1625,8.2
39,137,Putnam,1992,17606,16297,1309,7.4
39,139,Richland,1992,61041,55361,5680,9.3
39,141,Ross,1992,31579,28623,2956,9.4
39,143,Sandusky,1992,31867,28766,3101,9.7
39,145,Scioto,1992,31651,27930,3721,11.8
39,147,Seneca,1992,29926,27120,2806,9.4
39,149,Shelby,1992,26343,24123,2220,8.4
39,151,Stark,1992,186701,171677,15024,8.0
39,153,Summit,1992,266253,247420,18833,7.1
39,155,Trumbull,1992,113160,101496,11664,10.3
39,157,Tuscarawas,1992,43276,39298,3978,9.2
39,159,Union,1992,16150,15087,1063,6.6
39,161,Van Wert,1992,16203,15139,1064,6.6
39,163,Vinton,1992,3978,3441,537,13.5
39,165,Warren,1992,62529,58627,3902,6.2
39,167,Washington,1992,31450,28851,2599,8.3
39,169,Wayne,1992,52128,48704,3424,6.6
39,171,Williams,1992,20948,19236,1712,8.2
39,173,Wood,1992,60294,56297,3997,6.6
39,175,Wyandot,1992,11417,10327,1090,9.5
40,1,Adair,1992,9571,9045,526,5.5
40,3,Alfalfa,1992,2699,2640,59,2.2
40,5,Atoka,1992,4770,4449,321,6.7
40,7,Beaver,1992,2931,2829,102,3.5
40,9,Beckham,1992,8857,8218,639,7.2
40,11,Blaine,1992,4857,4558,299,6.2
40,13,Bryan,1992,13434,12620,814,6.1
40,15,Caddo,1992,12125,11339,786,6.5
40,17,Canadian,1992,39708,38027,1681,4.2
40,19,Carter,1992,19850,18593,1257,6.3
40,21,Cherokee,1992,16125,14992,1133,7.0
40,23,Choctaw,1992,5936,5176,760,12.8
40,25,Cimarron,1992,1868,1827,41,2.2
40,27,Cleveland,1992,95137,91669,3468,3.6
40,29,Coal,1992,2462,2190,272,11.0
40,31,Comanche,1992,43075,40650,2425,5.6
40,33,Cotton,1992,2302,2174,128,5.6
40,35,Craig,1992,6608,6256,352,5.3
40,37,Creek,1992,29736,27849,1887,6.3
40,39,Custer,1992,13676,12992,684,5.0
40,41,Delaware,1992,13167,12382,785,6.0
40,43,Dewey,1992,2453,2358,95,3.9
40,45,Ellis,1992,1915,1801,114,6.0
40,47,Garfield,1992,26683,25706,977,3.7
40,49,Garvin,1992,11326,10424,902,8.0
40,51,Grady,1992,19078,17896,1182,6.2
40,53,Grant,1992,2544,2481,63,2.5
40,55,Greer,1992,2284,2217,67,2.9
40,57,Harmon,1992,1425,1362,63,4.4
40,59,Harper,1992,2065,2012,53,2.6
40,61,Haskell,1992,4359,3703,656,15.0
40,63,Hughes,1992,5476,4781,695,12.7
40,65,Jackson,1992,10221,9694,527,5.2
40,67,Jefferson,1992,3126,2921,205,6.6
40,69,Johnston,1992,4227,3982,245,5.8
40,71,Kay,1992,24012,22590,1422,5.9
40,73,Kingfisher,1992,6510,6221,289,4.4
40,75,Kiowa,1992,4849,4669,180,3.7
40,77,Latimer,1992,4126,3528,598,14.5
40,79,Le Flore,1992,17814,15990,1824,10.2
40,81,Lincoln,1992,14221,13404,817,5.7
40,83,Logan,1992,13348,12785,563,4.2
40,85,Love,1992,3750,3555,195,5.2
40,87,McClain,1992,11174,10655,519,4.6
40,89,McCurtain,1992,14777,13540,1237,8.4
40,91,McIntosh,1992,6646,6090,556,8.4
40,93,Major,1992,3777,3635,142,3.8
40,95,Marshall,1992,4922,4627,295,6.0
40,97,Mayes,1992,14532,13228,1304,9.0
40,99,Murray,1992,5749,5137,612,10.6
40,101,Muskogee,1992,29323,27172,2151,7.3
40,103,Noble,1992,5232,5016,216,4.1
40,105,Nowata,1992,4240,3952,288,6.8
40,107,Okfuskee,1992,4582,4190,392,8.6
40,109,Oklahoma,1992,306731,289355,17376,5.7
40,111,Okmulgee,1992,14834,13283,1551,10.5
40,113,Osage,1992,18946,18036,910,4.8
40,115,Ottawa,1992,13008,11956,1052,8.1
40,117,Pawnee,1992,6836,6201,635,9.3
40,119,Payne,1992,32911,31957,954,2.9
40,121,Pittsburg,1992,18049,15994,2055,11.4
40,123,Pontotoc,1992,15918,14782,1136,7.1
40,125,Pottawatomie,1992,26208,24615,1593,6.1
40,127,Pushmataha,1992,4596,4198,398,8.7
40,129,Roger Mills,1992,2011,1929,82,4.1
40,131,Rogers,1992,29403,27466,1937,6.6
40,133,Seminole,1992,10822,9771,1051,9.7
40,135,Sequoyah,1992,15627,14374,1253,8.0
40,137,Stephens,1992,18861,17501,1360,7.2
40,139,Texas,1992,8603,8306,297,3.5
40,141,Tillman,1992,4336,4052,284,6.5
40,143,Tulsa,1992,273243,258776,14467,5.3
40,145,Wagoner,1992,24734,23324,1410,5.7
40,147,Washington,1992,22680,21218,1462,6.4
40,149,Washita,1992,5268,5034,234,4.4
40,151,Woods,1992,4413,4322,91,2.1
40,153,Woodward,1992,8883,8311,572,6.4
41,1,Baker,1992,7236,6549,687,9.5
41,3,Benton,1992,36559,35082,1477,4.0
41,5,Clackamas,1992,165055,156038,9017,5.5
41,7,Clatsop,1992,16775,15368,1407,8.4
41,9,Columbia,1992,19617,17801,1816,9.3
41,11,Coos,1992,27439,24493,2946,10.7
41,13,Crook,1992,7366,6750,616,8.4
41,15,Curry,1992,8144,7417,727,8.9
41,17,Deschutes,1992,44741,41104,3637,8.1
41,19,Douglas,1992,42802,37755,5047,11.8
41,21,Gilliam,1992,1123,1078,45,4.0
41,23,Grant,1992,4434,3965,469,10.6
41,25,Harney,1992,3689,3330,359,9.7
41,27,Hood River,1992,9628,8645,983,10.2
41,29,Jackson,1992,77272,70952,6320,8.2
41,31,Jefferson,1992,7287,6681,606,8.3
41,33,Josephine,1992,27375,24691,2684,9.8
41,35,Klamath,1992,28116,25289,2827,10.1
41,37,Lake,1992,3787,3460,327,8.6
41,39,Lane,1992,147439,136741,10698,7.3
41,41,Lincoln,1992,20588,19130,1458,7.1
41,43,Linn,1992,45224,40882,4342,9.6
41,45,Malheur,1992,14635,13416,1219,8.3
41,47,Marion,1992,122728,114328,8400,6.8
41,49,Morrow,1992,3828,3430,398,10.4
41,51,Multnomah,1992,337249,313614,23635,7.0
41,53,Polk,1992,25936,24416,1520,5.9
41,55,Sherman,1992,1005,919,86,8.6
41,57,Tillamook,1992,10214,9521,693,6.8
41,59,Umatilla,1992,31038,28280,2758,8.9
41,61,Union,1992,12101,11111,990,8.2
41,63,Wallowa,1992,3692,3324,368,10.0
41,65,Wasco,1992,11595,10559,1036,8.9
41,67,Washington,1992,197726,186194,11532,5.8
41,69,Wheeler,1992,526,476,50,9.5
41,71,Yamhill,1992,34188,31868,2320,6.8
42,1,Adams,1992,42618,40142,2476,5.8
42,3,Allegheny,1992,660461,619849,40612,6.1
42,5,Armstrong,1992,31872,28451,3421,10.7
42,7,Beaver,1992,85372,78794,6578,7.7
42,9,Bedford,1992,23274,20769,2505,10.8
42,11,Berks,1992,178421,166686,11735,6.6
42,13,Blair,1992,62040,56532,5508,8.9
42,15,Bradford,1992,27704,25554,2150,7.8
42,17,Bucks,1992,304765,282628,22137,7.3
42,19,Butler,1992,78188,72814,5374,6.9
42,21,Cambria,1992,69591,62045,7546,10.8
42,23,Cameron,1992,2496,2247,249,10.0
42,25,Carbon,1992,27067,24196,2871,10.6
42,27,Centre,1992,62315,59524,2791,4.5
42,29,Chester,1992,209677,198660,11017,5.3
42,31,Clarion,1992,18548,16853,1695,9.1
42,33,Clearfield,1992,36008,32162,3846,10.7
42,35,Clinton,1992,17627,15913,1714,9.7
42,37,Columbia,1992,32248,29285,2963,9.2
42,39,Crawford,1992,39838,36158,3680,9.2
42,41,Cumberland,1992,112275,107436,4839,4.3
42,43,Dauphin,1992,132413,125468,6945,5.2
42,45,Delaware,1992,278325,259142,19183,6.9
42,47,Elk,1992,16830,15621,1209,7.2
42,49,Erie,1992,138721,128187,10534,7.6
42,51,Fayette,1992,56737,50811,5926,10.4
42,53,Forest,1992,2038,1781,257,12.6
42,55,Franklin,1992,62291,58628,3663,5.9
42,57,Fulton,1992,6529,6020,509,7.8
42,59,Greene,1992,15598,13759,1839,11.8
42,61,Huntingdon,1992,19836,17253,2583,13.0
42,63,Indiana,1992,38233,34058,4175,10.9
42,65,Jefferson,1992,21324,19162,2162,10.1
42,67,Juniata,1992,10385,9119,1266,12.2
42,69,Lackawanna,1992,106903,97501,9402,8.8
42,71,Lancaster,1992,228085,217374,10711,4.7
42,73,Lawrence,1992,41378,37123,4255,10.3
42,75,Lebanon,1992,62511,59217,3294,5.3
42,77,Lehigh,1992,153979,143328,10651,6.9
42,79,Luzerne,1992,160942,144531,16411,10.2
42,81,Lycoming,1992,57979,53066,4913,8.5
42,83,McKean,1992,21264,19366,1898,8.9
42,85,Mercer,1992,56373,51315,5058,9.0
42,87,Mifflin,1992,22676,20335,2341,10.3
42,89,Monroe,1992,48784,43530,5254,10.8
42,91,Montgomery,1992,377835,354558,23277,6.2
42,93,Montour,1992,8901,8386,515,5.8
42,95,Northampton,1992,126732,117442,9290,7.3
42,97,Northumberland,1992,45548,41261,4287,9.4
42,99,Perry,1992,22546,21141,1405,6.2
42,101,Philadelphia/city,1992,683079,619908,63171,9.2
42,103,Pike,1992,15494,14210,1284,8.3
42,105,Potter,1992,7941,7149,792,10.0
42,107,Schuylkill,1992,70626,63886,6740,9.5
42,109,Snyder,1992,18725,17386,1339,7.2
42,111,Somerset,1992,36394,32843,3551,9.8
42,113,Sullivan,1992,2568,2292,276,10.7
42,115,Susquehanna,1992,18768,16994,1774,9.5
42,117,Tioga,1992,18629,17216,1413,7.6
42,119,Union,1992,16907,15754,1153,6.8
42,121,Venango,1992,25386,23035,2351,9.3
42,123,Warren,1992,22641,20894,1747,7.7
42,125,Washington,1992,93573,86604,6969,7.4
42,127,Wayne,1992,19291,17278,2013,10.4
42,129,Westmoreland,1992,177747,164369,13378,7.5
42,131,Wyoming,1992,14637,13144,1493,10.2
42,133,York,1992,189733,177943,11790,6.2
44,1,Bristol,1992,26840,24354,2486,9.3
44,3,Kent,1992,90733,82621,8112,8.9
44,5,Newport,1992,43009,39310,3699,8.6
44,7,Providence,1992,308617,279309,29308,9.5
44,9,Washington,1992,61138,57017,4121,6.7
45,1,Abbeville,1992,12041,11129,912,7.6
45,3,Aiken,1992,62720,58583,4137,6.6
45,5,Allendale,1992,4903,4328,575,11.7
45,7,Anderson,1992,77135,72637,4498,5.8
45,9,Bamberg,1992,7670,6890,780,10.2
45,11,Barnwell,1992,10369,9055,1314,12.7
45,13,Beaufort,1992,38251,36489,1762,4.6
45,15,Berkeley,1992,59271,55945,3326,5.6
45,17,Calhoun,1992,6253,5805,448,7.2
45,19,Charleston,1992,147617,138674,8943,6.1
45,21,Cherokee,1992,23407,21928,1479,6.3
45,23,Chester,1992,16195,14274,1921,11.9
45,25,Chesterfield,1992,19872,18613,1259,6.3
45,27,Clarendon,1992,11925,10482,1443,12.1
45,29,Colleton,1992,15844,14108,1736,11.0
45,31,Darlington,1992,31989,28933,3056,9.6
45,33,Dillon,1992,13029,11645,1384,10.6
45,35,Dorchester,1992,40921,38801,2120,5.2
45,37,Edgefield,1992,9004,8433,571,6.3
45,39,Fairfield,1992,10920,9806,1114,10.2
45,41,Florence,1992,59547,55175,4372,7.3
45,43,Georgetown,1992,22312,20019,2293,10.3
45,45,Greenville,1992,176989,167353,9636,5.4
45,47,Greenwood,1992,31246,29095,2151,6.9
45,49,Hampton,1992,7870,7147,723,9.2
45,51,Horry,1992,81384,74830,6554,8.1
45,53,Jasper,1992,6721,6377,344,5.1
45,55,Kershaw,1992,23798,21598,2200,9.2
45,57,Lancaster,1992,29224,26513,2711,9.3
45,59,Laurens,1992,30090,28268,1822,6.1
45,61,Lee,1992,8298,7513,785,9.5
45,63,Lexington,1992,100078,95604,4474,4.5
45,65,McCormick,1992,3728,3372,356,9.5
45,67,Marion,1992,16783,14663,2120,12.6
45,69,Marlboro,1992,12659,11362,1297,10.2
45,71,Newberry,1992,17531,16155,1376,7.8
45,73,Oconee,1992,29301,26849,2452,8.4
45,75,Orangeburg,1992,40301,36460,3841,9.5
45,77,Pickens,1992,51251,48537,2714,5.3
45,79,Richland,1992,149856,142009,7847,5.2
45,81,Saluda,1992,8535,8016,519,6.1
45,83,Spartanburg,1992,121798,115619,6179,5.1
45,85,Sumter,1992,42841,39350,3491,8.1
45,87,Union,1992,15998,14627,1371,8.6
45,89,Williamsburg,1992,16543,14906,1637,9.9
45,91,York,1992,75662,70829,4833,6.4
46,3,Aurora,1992,1386,1339,47,3.4
46,5,Beadle,1992,9187,8900,287,3.1
46,7,Bennett,1992,1161,1099,62,5.3
46,9,Bon Homme,1992,3080,2998,82,2.7
46,11,Brookings,1992,14123,13854,269,1.9
46,13,Brown,1992,19524,18997,527,2.7
46,15,Brule,1992,2784,2690,94,3.4
46,17,Buffalo,1992,605,546,59,9.8
46,19,Butte,1992,3643,3468,175,4.8
46,21,Campbell,1992,933,909,24,2.6
46,23,Charles Mix,1992,4467,4286,181,4.1
46,25,Clark,1992,1948,1855,93,4.8
46,27,Clay,1992,6750,6666,84,1.2
46,29,Codington,1992,12747,12263,484,3.8
46,31,Corson,1992,1784,1354,430,24.1
46,33,Custer,1992,3701,3571,130,3.5
46,35,Davison,1992,9099,8818,281,3.1
46,37,Day,1992,3106,2966,140,4.5
46,39,Deuel,1992,2251,2155,96,4.3
46,41,Dewey,1992,2137,1865,272,12.7
46,43,Douglas,1992,1554,1515,39,2.5
46,45,Edmunds,1992,2094,2051,43,2.1
46,47,Fall River,1992,3378,3246,132,3.9
46,49,Faulk,1992,1241,1217,24,1.9
46,51,Grant,1992,4260,3994,266,6.2
46,53,Gregory,1992,2486,2405,81,3.3
46,55,Haakon,1992,1168,1123,45,3.9
46,57,Hamlin,1992,2287,2188,99,4.3
46,59,Hand,1992,2097,2029,68,3.2
46,61,Hanson,1992,1530,1493,37,2.4
46,63,Harding,1992,867,826,41,4.7
46,65,Hughes,1992,9098,8851,247,2.7
46,67,Hutchinson,1992,3973,3863,110,2.8
46,69,Hyde,1992,822,804,18,2.2
46,71,Jackson,1992,1192,1141,51,4.3
46,73,Jerauld,1992,1062,1037,25,2.4
46,75,Jones,1992,750,717,33,4.4
46,77,Kingsbury,1992,2732,2604,128,4.7
46,79,Lake,1992,5598,5430,168,3.0
46,81,Lawrence,1992,12062,11683,379,3.1
46,83,Lincoln,1992,8452,8253,199,2.4
46,85,Lyman,1992,2055,1976,79,3.8
46,87,McCook,1992,2772,2666,106,3.8
46,89,McPherson,1992,1496,1464,32,2.1
46,91,Marshall,1992,2195,2122,73,3.3
46,93,Meade,1992,10377,9965,412,4.0
46,95,Mellette,1992,810,761,49,6.0
46,97,Miner,1992,1445,1374,71,4.9
46,99,Minnehaha,1992,72417,70587,1830,2.5
46,101,Moody,1992,3438,3235,203,5.9
46,102,Oglala Lakota,1992,2590,2193,397,15.3
46,103,Pennington,1992,42340,40891,1449,3.4
46,105,Perkins,1992,2080,2026,54,2.6
46,107,Potter,1992,1586,1517,69,4.4
46,109,Roberts,1992,4889,4613,276,5.6
46,111,Sanborn,1992,1297,1261,36,2.8
46,115,Spink,1992,3484,3375,109,3.1
46,117,Stanley,1992,1500,1444,56,3.7
46,119,Sully,1992,911,880,31,3.4
46,121,Todd,1992,2532,2307,225,8.9
46,123,Tripp,1992,3353,3251,102,3.0
46,125,Turner,1992,3729,3613,116,3.1
46,127,Union,1992,6238,5965,273,4.4
46,129,Walworth,1992,2994,2902,92,3.1
46,135,Yankton,1992,10496,10286,210,2.0
46,137,Ziebach,1992,791,741,50,6.3
47,1,Anderson,1992,34820,32935,1885,5.4
47,3,Bedford,1992,15763,14601,1162,7.4
47,5,Benton,1992,7113,6526,587,8.3
47,7,Bledsoe,1992,3463,3170,293,8.5
47,9,Blount,1992,45056,42413,2643,5.9
47,11,Bradley,1992,38432,35825,2607,6.8
47,13,Campbell,1992,15236,13100,2136,14.0
47,15,Cannon,1992,5479,5170,309,5.6
47,17,Carroll,1992,13586,12562,1024,7.5
47,19,Carter,1992,24996,23319,1677,6.7
47,21,Cheatham,1992,14692,13972,720,4.9
47,23,Chester,1992,5820,5491,329,5.7
47,25,Claiborne,1992,11698,10955,743,6.4
47,27,Clay,1992,3578,3312,266,7.4
47,29,Cocke,1992,14919,12960,1959,13.1
47,31,Coffee,1992,19607,18423,1184,6.0
47,33,Crockett,1992,7100,6648,452,6.4
47,35,Cumberland,1992,16568,15077,1491,9.0
47,37,Davidson,1992,276639,263329,13310,4.8
47,39,Decatur,1992,4834,4311,523,10.8
47,41,DeKalb,1992,7640,7073,567,7.4
47,43,Dickson,1992,17501,16399,1102,6.3
47,45,Dyer,1992,16854,15432,1422,8.4
47,47,Fayette,1992,11469,10509,960,8.4
47,49,Fentress,1992,7004,6282,722,10.3
47,51,Franklin,1992,16420,15414,1006,6.1
47,53,Gibson,1992,22066,20274,1792,8.1
47,55,Giles,1992,13160,12218,942,7.2
47,57,Grainger,1992,8555,7905,650,7.6
47,59,Greene,1992,28349,24980,3369,11.9
47,61,Grundy,1992,4996,4341,655,13.1
47,63,Hamblen,1992,27380,25240,2140,7.8
47,65,Hamilton,1992,142536,134623,7913,5.6
47,67,Hancock,1992,2356,2170,186,7.9
47,69,Hardeman,1992,9482,8664,818,8.6
47,71,Hardin,1992,10775,9605,1170,10.9
47,73,Hawkins,1992,21723,20420,1303,6.0
47,75,Haywood,1992,8766,7676,1090,12.4
47,77,Henderson,1992,11407,10471,936,8.2
47,79,Henry,1992,13310,12330,980,7.4
47,81,Hickman,1992,8041,7387,654,8.1
47,83,Houston,1992,3258,2816,442,13.6
47,85,Humphreys,1992,6638,5756,882,13.3
47,87,Jackson,1992,4124,3786,338,8.2
47,89,Jefferson,1992,18019,16420,1599,8.9
47,91,Johnson,1992,7152,6544,608,8.5
47,93,Knox,1992,183912,175550,8362,4.5
47,95,Lake,1992,2710,2522,188,6.9
47,97,Lauderdale,1992,9439,8518,921,9.8
47,99,Lawrence,1992,19717,18182,1535,7.8
47,101,Lewis,1992,4579,4241,338,7.4
47,103,Lincoln,1992,14428,13572,856,5.9
47,105,Loudon,1992,17232,16257,975,5.7
47,107,McMinn,1992,20279,18385,1894,9.3
47,109,McNairy,1992,11201,10253,948,8.5
47,111,Macon,1992,8669,8139,530,6.1
47,113,Madison,1992,40219,37764,2455,6.1
47,115,Marion,1992,11698,10680,1018,8.7
47,117,Marshall,1992,11675,10979,696,6.0
47,119,Maury,1992,31207,28590,2617,8.4
47,121,Meigs,1992,3942,3414,528,13.4
47,123,Monroe,1992,13891,12352,1539,11.1
47,125,Montgomery,1992,42129,39514,2615,6.2
47,127,Moore,1992,2659,2536,123,4.6
47,129,Morgan,1992,6945,6249,696,10.0
47,131,Obion,1992,14340,12971,1369,9.5
47,133,Overton,1992,8641,7886,755,8.7
47,135,Perry,1992,2909,2636,273,9.4
47,137,Pickett,1992,2039,1886,153,7.5
47,139,Polk,1992,6340,5706,634,10.0
47,141,Putnam,1992,27003,25132,1871,6.9
47,143,Rhea,1992,10508,9431,1077,10.2
47,145,Roane,1992,20572,18821,1751,8.5
47,147,Robertson,1992,22044,20621,1423,6.5
47,149,Rutherford,1992,68309,65030,3279,4.8
47,151,Scott,1992,7735,6511,1224,15.8
47,153,Sequatchie,1992,4471,4040,431,9.6
47,155,Sevier,1992,29796,26988,2808,9.4
47,157,Shelby,1992,398231,375127,23104,5.8
47,159,Smith,1992,7821,7371,450,5.8
47,161,Stewart,1992,4111,3695,416,10.1
47,163,Sullivan,1992,72176,68517,3659,5.1
47,165,Sumner,1992,56340,52777,3563,6.3
47,167,Tipton,1992,17279,16040,1239,7.2
47,169,Trousdale,1992,2730,2494,236,8.6
47,171,Unicoi,1992,7966,7134,832,10.4
47,173,Union,1992,6542,6236,306,4.7
47,175,Van Buren,1992,2305,2103,202,8.8
47,177,Warren,1992,17890,16410,1480,8.3
47,179,Washington,1992,48060,45461,2599,5.4
47,181,Wayne,1992,7462,6876,586,7.9
47,183,Weakley,1992,17697,16906,791,4.5
47,185,White,1992,9983,8979,1004,10.1
47,187,Williamson,1992,45975,44240,1735,3.8
47,189,Wilson,1992,37047,35116,1931,5.2
48,1,Anderson,1992,18579,17153,1426,7.7
48,3,Andrews,1992,6339,5825,514,8.1
48,5,Angelina,1992,33640,31067,2573,7.6
48,7,Aransas,1992,7859,7380,479,6.1
48,9,Archer,1992,3759,3613,146,3.9
48,11,Armstrong,1992,1072,1029,43,4.0
48,13,Atascosa,1992,14280,13076,1204,8.4
48,15,Austin,1992,9671,9258,413,4.3
48,17,Bailey,1992,3804,3556,248,6.5
48,19,Bandera,1992,6371,6161,210,3.3
48,21,Bastrop,1992,19696,18813,883,4.5
48,23,Baylor,1992,1852,1779,73,3.9
48,25,Bee,1992,9474,8430,1044,11.0
48,27,Bell,1992,79610,74030,5580,7.0
48,29,Bexar,1992,587944,550014,37930,6.5
48,31,Blanco,1992,2983,2865,118,4.0
48,33,Borden,1992,381,364,17,4.5
48,35,Bosque,1992,6052,5704,348,5.8
48,37,Bowie,1992,39480,35732,3748,9.5
48,39,Brazoria,1992,102853,95468,7385,7.2
48,41,Brazos,1992,64157,62282,1875,2.9
48,43,Brewster,1992,4230,4136,94,2.2
48,45,Briscoe,1992,977,937,40,4.1
48,47,Brooks,1992,3054,2662,392,12.8
48,49,Brown,1992,15578,14155,1423,9.1
48,51,Burleson,1992,6992,6612,380,5.4
48,53,Burnet,1992,9675,9029,646,6.7
48,55,Caldwell,1992,12196,11647,549,4.5
48,57,Calhoun,1992,9999,9191,808,8.1
48,59,Callahan,1992,5523,5229,294,5.3
48,61,Cameron,1992,113739,96987,16752,14.7
48,63,Camp,1992,4960,4355,605,12.2
48,65,Carson,1992,3392,3214,178,5.2
48,67,Cass,1992,14453,12609,1844,12.8
48,69,Castro,1992,4074,3800,274,6.7
48,71,Chambers,1992,9993,9375,618,6.2
48,73,Cherokee,1992,18898,17504,1394,7.4
48,75,Childress,1992,3050,2835,215,7.0
48,77,Clay,1992,4714,4483,231,4.9
48,79,Cochran,1992,1894,1745,149,7.9
48,81,Coke,1992,1412,1354,58,4.1
48,83,Coleman,1992,3668,3374,294,8.0
48,85,Collin,1992,173407,164331,9076,5.2
48,87,Collingsworth,1992,1779,1693,86,4.8
48,89,Colorado,1992,8375,7984,391,4.7
48,91,Comal,1992,27881,26375,1506,5.4
48,93,Comanche,1992,6297,5978,319,5.1
48,95,Concho,1992,1459,1411,48,3.3
48,97,Cooke,1992,15471,14495,976,6.3
48,99,Coryell,1992,18299,17159,1140,6.2
48,101,Cottle,1992,919,851,68,7.4
48,103,Crane,1992,2268,2091,177,7.8
48,105,Crockett,1992,1944,1793,151,7.8
48,107,Crosby,1992,3293,3029,264,8.0
48,109,Culberson,1992,1538,1423,115,7.5
48,111,Dallam,1992,2862,2760,102,3.6
48,113,Dallas,1992,1095888,1014557,81331,7.4
48,115,Dawson,1992,5899,5474,425,7.2
48,117,Deaf Smith,1992,9166,8369,797,8.7
48,119,Delta,1992,2099,1953,146,7.0
48,121,Denton,1992,178341,169145,9196,5.2
48,123,DeWitt,1992,8082,7595,487,6.0
48,125,Dickens,1992,1036,973,63,6.1
48,127,Dimmit,1992,4153,3321,832,20.0
48,129,Donley,1992,1570,1497,73,4.6
48,131,Duval,1992,4490,3833,657,14.6
48,133,Eastland,1992,7850,7302,548,7.0
48,135,Ector,1992,59966,54113,5853,9.8
48,137,Edwards,1992,913,850,63,6.9
48,139,Ellis,1992,45045,41756,3289,7.3
48,141,El Paso,1992,272951,240990,31961,11.7
48,143,Erath,1992,14251,13627,624,4.4
48,145,Falls,1992,7205,6835,370,5.1
48,147,Fannin,1992,11322,10322,1000,8.8
48,149,Fayette,1992,10276,9966,310,3.0
48,151,Fisher,1992,2025,1877,148,7.3
48,153,Floyd,1992,3772,3496,276,7.3
48,155,Foard,1992,963,952,11,1.1
48,157,Fort Bend,1992,134877,128602,6275,4.7
48,159,Franklin,1992,3606,3279,327,9.1
48,161,Freestone,1992,7482,6978,504,6.7
48,163,Frio,1992,7624,6517,1107,14.5
48,165,Gaines,1992,6796,6427,369,5.4
48,167,Galveston,1992,121618,110715,10903,9.0
48,169,Garza,1992,2526,2389,137,5.4
48,171,Gillespie,1992,9087,8860,227,2.5
48,173,Glasscock,1992,614,594,20,3.3
48,175,Goliad,1992,2745,2584,161,5.9
48,177,Gonzales,1992,7851,7423,428,5.5
48,179,Gray,1992,11016,10308,708,6.4
48,181,Grayson,1992,46021,42322,3699,8.0
48,183,Gregg,1992,56394,50628,5766,10.2
48,185,Grimes,1992,7936,7457,479,6.0
48,187,Guadalupe,1992,33474,32059,1415,4.2
48,189,Hale,1992,17244,16137,1107,6.4
48,191,Hall,1992,2011,1853,158,7.9
48,193,Hamilton,1992,3597,3470,127,3.5
48,195,Hansford,1992,2652,2556,96,3.6
48,197,Hardeman,1992,2101,1995,106,5.0
48,199,Hardin,1992,21120,19507,1613,7.6
48,201,Harris,1992,1617325,1497952,119373,7.4
48,203,Harrison,1992,26556,23894,2662,10.0
48,205,Hartley,1992,1966,1919,47,2.4
48,207,Haskell,1992,2967,2839,128,4.3
48,209,Hays,1992,35942,34558,1384,3.9
48,211,Hemphill,1992,1897,1800,97,5.1
48,213,Henderson,1992,25636,23387,2249,8.8
48,215,Hidalgo,1992,172589,133829,38760,22.5
48,217,Hill,1992,12969,11765,1204,9.3
48,219,Hockley,1992,11551,10848,703,6.1
48,221,Hood,1992,13927,12755,1172,8.4
48,223,Hopkins,1992,14998,13758,1240,8.3
48,225,Houston,1992,8522,8049,473,5.6
48,227,Howard,1992,14172,13228,944,6.7
48,229,Hudspeth,1992,1226,1188,38,3.1
48,231,Hunt,1992,32723,29847,2876,8.8
48,233,Hutchinson,1992,11132,10232,900,8.1
48,235,Irion,1992,948,908,40,4.2
48,237,Jack,1992,3226,3043,183,5.7
48,239,Jackson,1992,5849,5524,325,5.6
48,241,Jasper,1992,13823,12176,1647,11.9
48,243,Jeff Davis,1992,1007,962,45,4.5
48,245,Jefferson,1992,121294,110564,10730,8.8
48,247,Jim Hogg,1992,2071,1805,266,12.8
48,249,Jim Wells,1992,15909,13846,2063,13.0
48,251,Johnson,1992,49920,46893,3027,6.1
48,253,Jones,1992,8068,7592,476,5.9
48,255,Karnes,1992,5107,4751,356,7.0
48,257,Kaufman,1992,25693,24121,1572,6.1
48,259,Kendall,1992,8265,8065,200,2.4
48,261,Kenedy,1992,218,216,2,0.9
48,263,Kent,1992,472,453,19,4.0
48,265,Kerr,1992,16189,15498,691,4.3
48,267,Kimble,1992,2203,2135,68,3.1
48,269,King,1992,137,133,4,2.9
48,271,Kinney,1992,1181,1066,115,9.7
48,273,Kleberg,1992,13097,12074,1023,7.8
48,275,Knox,1992,2465,2364,101,4.1
48,277,Lamar,1992,21151,19253,1898,9.0
48,279,Lamb,1992,6543,6068,475,7.3
48,281,Lampasas,1992,6347,5903,444,7.0
48,283,La Salle,1992,2505,2253,252,10.1
48,285,Lavaca,1992,8772,8533,239,2.7
48,287,Lee,1992,6880,6605,275,4.0
48,289,Leon,1992,5260,4814,446,8.5
48,291,Liberty,1992,24341,21723,2618,10.8
48,293,Limestone,1992,9276,8745,531,5.7
48,295,Lipscomb,1992,1402,1337,65,4.6
48,297,Live Oak,1992,4859,4605,254,5.2
48,299,Llano,1992,4293,4092,201,4.7
48,301,Loving,1992,79,75,4,5.1
48,303,Lubbock,1992,115771,109109,6662,5.8
48,305,Lynn,1992,2870,2734,136,4.7
48,307,McCulloch,1992,3495,3212,283,8.1
48,309,McLennan,1992,94553,88212,6341,6.7
48,311,McMullen,1992,335,329,6,1.8
48,313,Madison,1992,4076,3934,142,3.5
48,315,Marion,1992,3885,3375,510,13.1
48,317,Martin,1992,1847,1795,52,2.8
48,319,Mason,1992,1576,1514,62,3.9
48,321,Matagorda,1992,18066,15285,2781,15.4
48,323,Maverick,1992,17037,11188,5849,34.3
48,325,Medina,1992,12188,11423,765,6.3
48,327,Menard,1992,1010,962,48,4.8
48,329,Midland,1992,57821,53647,4174,7.2
48,331,Milam,1992,10346,9790,556,5.4
48,333,Mills,1992,2113,2043,70,3.3
48,335,Mitchell,1992,3291,2948,343,10.4
48,337,Montague,1992,7847,7277,570,7.3
48,339,Montgomery,1992,102466,95882,6584,6.4
48,341,Moore,1992,8593,8259,334,3.9
48,343,Morris,1992,6005,5179,826,13.8
48,345,Motley,1992,799,763,36,4.5
48,347,Nacogdoches,1992,26287,24681,1606,6.1
48,349,Navarro,1992,19183,17715,1468,7.7
48,351,Newton,1992,5398,4749,649,12.0
48,353,Nolan,1992,7857,7198,659,8.4
48,355,Nueces,1992,143094,129193,13901,9.7
48,357,Ochiltree,1992,4428,4122,306,6.9
48,359,Oldham,1992,1156,1083,73,6.3
48,361,Orange,1992,42079,37219,4860,11.5
48,363,Palo Pinto,1992,11863,10712,1151,9.7
48,365,Panola,1992,8085,7150,935,11.6
48,367,Parker,1992,33724,31521,2203,6.5
48,369,Parmer,1992,4322,4122,200,4.6
48,371,Pecos,1992,6678,5986,692,10.4
48,373,Polk,1992,13058,11905,1153,8.8
48,375,Potter,1992,48941,45835,3106,6.3
48,377,Presidio,1992,3201,2198,1003,31.3
48,379,Rains,1992,3134,2920,214,6.8
48,381,Randall,1992,52230,50339,1891,3.6
48,383,Reagan,1992,1985,1875,110,5.5
48,385,Real,1992,1089,998,91,8.4
48,387,Red River,1992,5954,5421,533,9.0
48,389,Reeves,1992,6918,5882,1036,15.0
48,391,Refugio,1992,3315,3125,190,5.7
48,393,Roberts,1992,560,531,29,5.2
48,395,Robertson,1992,6714,6223,491,7.3
48,397,Rockwall,1992,16142,15329,813,5.0
48,399,Runnels,1992,5315,5068,247,4.6
48,401,Rusk,1992,21559,19851,1708,7.9
48,403,Sabine,1992,3508,3115,393,11.2
48,405,San Augustine,1992,3441,3208,233,6.8
48,407,San Jacinto,1992,7170,6712,458,6.4
48,409,San Patricio,1992,27010,23737,3273,12.1
48,411,San Saba,1992,2168,2020,148,6.8
48,413,Schleicher,1992,1330,1221,109,8.2
48,415,Scurry,1992,8159,7487,672,8.2
48,417,Shackelford,1992,1480,1421,59,4.0
48,419,Shelby,1992,9376,8553,823,8.8
48,421,Sherman,1992,1378,1339,39,2.8
48,423,Smith,1992,79061,73443,5618,7.1
48,425,Somervell,1992,3649,3395,254,7.0
48,427,Starr,1992,19206,12663,6543,34.1
48,429,Stephens,1992,3760,3543,217,5.8
48,431,Sterling,1992,738,721,17,2.3
48,433,Stonewall,1992,906,764,142,15.7
48,435,Sutton,1992,2150,1978,172,8.0
48,437,Swisher,1992,4039,3816,223,5.5
48,439,Tarrant,1992,681959,632973,48986,7.2
48,441,Taylor,1992,57448,54277,3171,5.5
48,443,Terrell,1992,635,596,39,6.1
48,445,Terry,1992,6075,5554,521,8.6
48,447,Throckmorton,1992,926,906,20,2.2
48,449,Titus,1992,11953,10786,1167,9.8
48,451,Tom Green,1992,48660,46144,2516,5.2
48,453,Travis,1992,362455,346161,16294,4.5
48,455,Trinity,1992,4834,4558,276,5.7
48,457,Tyler,1992,6831,6199,632,9.3
48,459,Upshur,1992,14984,13755,1229,8.2
48,461,Upton,1992,1931,1811,120,6.2
48,463,Uvalde,1992,10314,8824,1490,14.4
48,465,Val Verde,1992,17194,14680,2514,14.6
48,467,Van Zandt,1992,17781,16539,1242,7.0
48,469,Victoria,1992,39939,37512,2427,6.1
48,471,Walker,1992,20590,19903,687,3.3
48,473,Waller,1992,10967,10399,568,5.2
48,475,Ward,1992,4989,4479,510,10.2
48,477,Washington,1992,13370,12967,403,3.0
48,479,Webb,1992,61543,54739,6804,11.1
48,481,Wharton,1992,19568,18248,1320,6.7
48,483,Wheeler,1992,2760,2587,173,6.3
48,485,Wichita,1992,56624,52824,3800,6.7
48,487,Wilbarger,1992,7317,6948,369,5.0
48,489,Willacy,1992,7531,5908,1623,21.6
48,491,Williamson,1992,87024,84273,2751,3.2
48,493,Wilson,1992,11069,10569,500,4.5
48,495,Winkler,1992,3563,3195,368,10.3
48,497,Wise,1992,17405,16308,1097,6.3
48,499,Wood,1992,13888,12935,953,6.9
48,501,Yoakum,1992,3957,3674,283,7.2
48,503,Young,1992,8842,8150,692,7.8
48,505,Zapata,1992,3473,2850,623,17.9
48,507,Zavala,1992,4810,3553,1257,26.1
49,1,Beaver,1992,2026,1925,101,5.0
49,3,Box Elder,1992,15999,15159,840,5.3
49,5,Cache,1992,36063,34742,1321,3.7
49,7,Carbon,1992,8931,8088,843,9.4
49,9,Daggett,1992,402,383,19,4.7
49,11,Davis,1992,93573,89489,4084,4.4
49,13,Duchesne,1992,5411,4938,473,8.7
49,15,Emery,1992,4461,4066,395,8.9
49,17,Garfield,1992,2255,1947,308,13.7
49,19,Grand,1992,4051,3751,300,7.4
49,21,Iron,1992,10104,9714,390,3.9
49,23,Juab,1992,3121,2891,230,7.4
49,25,Kane,1992,2845,2627,218,7.7
49,27,Millard,1992,4654,4368,286,6.1
49,29,Morgan,1992,2911,2758,153,5.3
49,31,Piute,1992,462,429,33,7.1
49,33,Rich,1992,755,727,28,3.7
49,35,Salt Lake,1992,396365,378789,17576,4.4
49,37,San Juan,1992,4428,3982,446,10.1
49,39,Sanpete,1992,6806,6172,634,9.3
49,41,Sevier,1992,6637,6171,466,7.0
49,43,Summit,1992,9241,8615,626,6.8
49,45,Tooele,1992,12565,11787,778,6.2
49,47,Uintah,1992,9702,8977,725,7.5
49,49,Utah,1992,127273,121957,5316,4.2
49,51,Wasatch,1992,4799,4434,365,7.6
49,53,Washington,1992,22768,21788,980,4.3
49,55,Wayne,1992,1048,963,85,8.1
49,57,Weber,1992,82728,77790,4938,6.0
50,1,Addison,1992,18650,17346,1304,7.0
50,3,Bennington,1992,18804,17666,1138,6.1
50,5,Caledonia,1992,15140,14077,1063,7.0
50,7,Chittenden,1992,79507,75961,3546,4.5
50,9,Essex,1992,2891,2647,244,8.4
50,11,Franklin,1992,21795,20330,1465,6.7
50,13,Grand Isle,1992,2986,2742,244,8.2
50,15,Lamoille,1992,10889,9963,926,8.5
50,17,Orange,1992,14227,13470,757,5.3
50,19,Orleans,1992,12276,11039,1237,10.1
50,21,Rutland,1992,32623,30141,2482,7.6
50,23,Washington,1992,29920,27832,2088,7.0
50,25,Windham,1992,22652,21406,1246,5.5
50,27,Windsor,1992,29287,27599,1688,5.8
51,1,Accomack,1992,15604,14173,1431,9.2
51,3,Albemarle,1992,36088,34730,1358,3.8
51,5,Alleghany,1992,7948,7208,740,9.3
51,7,Amelia,1992,4521,4151,370,8.2
51,9,Amherst,1992,14743,13806,937,6.4
51,11,Appomattox,1992,6743,6134,609,9.0
51,13,Arlington,1992,109084,104398,4686,4.3
51,15,Augusta,1992,30157,28386,1771,5.9
51,17,Bath,1992,2870,2549,321,11.2
51,19,Bedford,1992,29978,28338,1640,5.5
51,21,Bland,1992,3655,3424,231,6.3
51,23,Botetourt,1992,14665,13855,810,5.5
51,25,Brunswick,1992,7501,6737,764,10.2
51,27,Buchanan,1992,11498,9675,1823,15.9
51,29,Buckingham,1992,5712,5313,399,7.0
51,31,Campbell,1992,26865,25065,1800,6.7
51,33,Caroline,1992,10670,9452,1218,11.4
51,35,Carroll,1992,14546,13378,1168,8.0
51,36,Charles City,1992,3538,3197,341,9.6
51,37,Charlotte,1992,5979,5345,634,10.6
51,41,Chesterfield,1992,129212,122897,6315,4.9
51,43,Clarke,1992,6351,6028,323,5.1
51,45,Craig,1992,3357,3195,162,4.8
51,47,Culpeper,1992,14980,13943,1037,6.9
51,49,Cumberland,1992,4272,3968,304,7.1
51,51,Dickenson,1992,6388,5276,1112,17.4
51,53,Dinwiddie,1992,11196,10336,860,7.7
51,57,Essex,1992,4716,4353,363,7.7
51,59,Fairfax,1992,497995,479685,18310,3.7
51,61,Fauquier,1992,27447,26080,1367,5.0
51,63,Floyd,1992,6464,5883,581,9.0
51,65,Fluvanna,1992,7111,6731,380,5.3
51,67,Franklin,1992,21635,20367,1268,5.9
51,69,Frederick,1992,28479,26388,2091,7.3
51,71,Giles,1992,8456,7744,712,8.4
51,73,Gloucester,1992,16001,15244,757,4.7
51,75,Goochland,1992,7925,7461,464,5.9
51,77,Grayson,1992,8774,8156,618,7.0
51,79,Greene,1992,6281,5887,394,6.3
51,81,Greensville,1992,5365,4990,375,7.0
51,83,Halifax,1992,18951,17383,1568,8.3
51,85,Hanover,1992,38395,36594,1801,4.7
51,87,Henrico,1992,131731,124891,6840,5.2
51,89,Henry,1992,31265,29122,2143,6.9
51,91,Highland,1992,1320,1261,59,4.5
51,93,Isle of Wight,1992,13744,12753,991,7.2
51,95,James City,1992,20383,19742,641,3.1
51,97,King and Queen,1992,3327,3100,227,6.8
51,99,King George,1992,7486,6891,595,7.9
51,101,King William,1992,6508,6177,331,5.1
51,103,Lancaster,1992,5418,4603,815,15.0
51,105,Lee,1992,10017,8582,1435,14.3
51,107,Loudoun,1992,56583,54308,2275,4.0
51,109,Louisa,1992,10854,9715,1139,10.5
51,111,Lunenburg,1992,5191,4565,626,12.1
51,113,Madison,1992,6584,6259,325,4.9
51,115,Mathews,1992,4254,4067,187,4.4
51,117,Mecklenburg,1992,14938,13600,1338,9.0
51,119,Middlesex,1992,4267,4057,210,4.9
51,121,Montgomery,1992,36705,34747,1958,5.3
51,125,Nelson,1992,6863,6355,508,7.4
51,127,New Kent,1992,5892,5568,324,5.5
51,131,Northampton,1992,5784,5256,528,9.1
51,133,Northumberland,1992,5413,4697,716,13.2
51,135,Nottoway,1992,6616,6182,434,6.6
51,137,Orange,1992,10865,9989,876,8.1
51,139,Page,1992,11813,10550,1263,10.7
51,141,Patrick,1992,9330,8887,443,4.7
51,143,Pittsylvania,1992,30767,28374,2393,7.8
51,145,Powhatan,1992,8236,7866,370,4.5
51,147,Prince Edward,1992,8662,7780,882,10.2
51,149,Prince George,1992,11949,11207,742,6.2
51,153,Prince William,1992,123863,118167,5696,4.6
51,155,Pulaski,1992,17432,15750,1682,9.6
51,157,Rappahannock,1992,4139,3829,310,7.5
51,159,Richmond,1992,3783,3419,364,9.6
51,161,Roanoke,1992,47097,45211,1886,4.0
51,163,Rockbridge,1992,10017,9074,943,9.4
51,165,Rockingham,1992,35111,33328,1783,5.1
51,167,Russell,1992,12610,11032,1578,12.5
51,169,Scott,1992,10160,9289,871,8.6
51,171,Shenandoah,1992,17637,16542,1095,6.2
51,173,Smyth,1992,18196,15831,2365,13.0
51,175,Southampton,1992,7833,7320,513,6.5
51,177,Spotsylvania,1992,34549,32484,2065,6.0
51,179,Stafford,1992,35900,34034,1866,5.2
51,181,Surry,1992,3230,2814,416,12.9
51,183,Sussex,1992,5012,4470,542,10.8
51,185,Tazewell,1992,20876,18070,2806,13.4
51,187,Warren,1992,14977,13406,1571,10.5
51,191,Washington,1992,25462,23490,1972,7.7
51,193,Westmoreland,1992,7905,6952,953,12.1
51,195,Wise,1992,16488,13978,2510,15.2
51,197,Wythe,1992,14184,12747,1437,10.1
51,199,York,1992,23003,22084,919,4.0
51,510,Alexandria city,1992,76996,72265,4731,6.1
51,520,Bristol city,1992,8736,8074,662,7.6
51,530,Buena Vista city,1992,3373,3000,373,11.1
51,540,Charlottesville city,1992,20057,19117,940,4.7
51,550,Chesapeake city,1992,87296,82527,4769,5.5
51,570,Colonial Heights city,1992,8917,8277,640,7.2
51,580,Covington city,1992,3062,2632,430,14.0
51,590,Danville city,1992,26964,24030,2934,10.9
51,595,Emporia city,1992,2574,2322,252,9.8
51,600,Fairfax city,1992,12480,12208,272,2.2
51,610,Falls Church city,1992,5829,5522,307,5.3
51,620,Franklin city,1992,3749,3526,223,5.9
51,630,Fredericksburg city,1992,10543,9617,926,8.8
51,640,Galax city,1992,3491,3270,221,6.3
51,650,Hampton city,1992,67089,62458,4631,6.9
51,660,Harrisonburg city,1992,16868,16277,591,3.5
51,670,Hopewell city,1992,11348,10163,1185,10.4
51,678,Lexington city,1992,2812,2662,150,5.3
51,680,Lynchburg city,1992,32350,30264,2086,6.4
51,683,Manassas city,1992,17754,16730,1024,5.8
51,685,Manassas Park city,1992,3864,3718,146,3.8
51,690,Martinsville city,1992,7831,7188,643,8.2
51,700,Newport News city,1992,85059,79330,5729,6.7
51,710,Norfolk city,1992,96974,90123,6851,7.1
51,720,Norton city,1992,1685,1539,146,8.7
51,730,Petersburg city,1992,17674,15591,2083,11.8
51,735,Poquoson city,1992,5762,5558,204,3.5
51,740,Portsmouth city,1992,47869,43917,3952,8.3
51,750,Radford city,1992,7112,6641,471,6.6
51,760,Richmond city,1992,103168,93905,9263,9.0
51,770,Roanoke city,1992,50778,47252,3526,6.9
51,775,Salem city,1992,13240,12579,661,5.0
51,790,Staunton city,1992,11483,10837,646,5.6
51,800,Suffolk city,1992,25756,23805,1951,7.6
51,810,Virginia Beach city,1992,204113,193652,10461,5.1
51,820,Waynesboro city,1992,9161,8382,779,8.5
51,830,Williamsburg city,1992,5937,5186,751,12.6
51,840,Winchester city,1992,12842,11621,1221,9.5
53,1,Adams,1992,8115,6935,1180,14.5
53,3,Asotin,1992,9991,9445,546,5.5
53,5,Benton,1992,65199,60310,4889,7.5
53,7,Chelan,1992,32474,28751,3723,11.5
53,9,Clallam,1992,23385,21306,2079,8.9
53,11,Clark,1992,132033,122743,9290,7.0
53,13,Columbia,1992,1422,1212,210,14.8
53,15,Cowlitz,1992,38215,34101,4114,10.8
53,17,Douglas,1992,16859,15359,1500,8.9
53,19,Ferry,1992,2859,2441,418,14.6
53,21,Franklin,1992,20652,18249,2403,11.6
53,23,Garfield,1992,1055,1019,36,3.4
53,25,Grant,1992,30101,26692,3409,11.3
53,27,Grays Harbor,1992,28119,24623,3496,12.4
53,29,Island,1992,24156,22707,1449,6.0
53,31,Jefferson,1992,8640,7856,784,9.1
53,33,King,1992,895264,847584,47680,5.3
53,35,Kitsap,1992,88513,83083,5430,6.1
53,37,Kittitas,1992,13636,11879,1757,12.9
53,39,Klickitat,1992,8123,6979,1144,14.1
53,41,Lewis,1992,27536,24445,3091,11.2
53,43,Lincoln,1992,4282,4054,228,5.3
53,45,Mason,1992,16046,14663,1383,8.6
53,47,Okanogan,1992,21014,18531,2483,11.8
53,49,Pacific,1992,7881,7019,862,10.9
53,51,Pend Oreille,1992,3680,3143,537,14.6
53,53,Pierce,1992,288047,266187,21860,7.6
53,55,San Juan,1992,5392,5057,335,6.2
53,57,Skagit,1992,42336,37935,4401,10.4
53,59,Skamania,1992,3808,3106,702,18.4
53,61,Snohomish,1992,269513,253818,15695,5.8
53,63,Spokane,1992,181129,168624,12505,6.9
53,65,Stevens,1992,14751,13064,1687,11.4
53,67,Thurston,1992,86225,80412,5813,6.7
53,69,Wahkiakum,1992,1562,1450,112,7.2
53,71,Walla Walla,1992,24576,22578,1998,8.1
53,73,Whatcom,1992,73352,67642,5710,7.8
53,75,Whitman,1992,17365,16951,414,2.4
53,77,Yakima,1992,109157,94174,14983,13.7
54,1,Barbour,1992,6270,5198,1072,17.1
54,3,Berkeley,1992,30972,28032,2940,9.5
54,5,Boone,1992,9317,7882,1435,15.4
54,7,Braxton,1992,5170,4111,1059,20.5
54,9,Brooke,1992,12014,10616,1398,11.6
54,11,Cabell,1992,44035,39816,4219,9.6
54,13,Calhoun,1992,3127,2496,631,20.2
54,15,Clay,1992,3147,2548,599,19.0
54,17,Doddridge,1992,2883,2596,287,10.0
54,19,Fayette,1992,17456,14916,2540,14.6
54,21,Gilmer,1992,2840,2478,362,12.7
54,23,Grant,1992,5347,4800,547,10.2
54,25,Greenbrier,1992,15230,13368,1862,12.2
54,27,Hampshire,1992,7684,6867,817,10.6
54,29,Hancock,1992,15918,14209,1709,10.7
54,31,Hardy,1992,5640,5261,379,6.7
54,33,Harrison,1992,31600,28091,3509,11.1
54,35,Jackson,1992,12937,11340,1597,12.3
54,37,Jefferson,1992,19588,17711,1877,9.6
54,39,Kanawha,1992,100321,91680,8641,8.6
54,41,Lewis,1992,7410,6425,985,13.3
54,43,Lincoln,1992,7350,6165,1185,16.1
54,45,Logan,1992,14923,12871,2052,13.8
54,47,McDowell,1992,8827,7422,1405,15.9
54,49,Marion,1992,24959,21282,3677,14.7
54,51,Marshall,1992,16497,14517,1980,12.0
54,53,Mason,1992,10232,8573,1659,16.2
54,55,Mercer,1992,28364,25490,2874,10.1
54,57,Mineral,1992,11661,10530,1131,9.7
54,59,Mingo,1992,10644,9304,1340,12.6
54,61,Monongalia,1992,38264,35233,3031,7.9
54,63,Monroe,1992,4979,4521,458,9.2
54,65,Morgan,1992,5900,5436,464,7.9
54,67,Nicholas,1992,10637,8989,1648,15.5
54,69,Ohio,1992,24377,22327,2050,8.4
54,71,Pendleton,1992,3661,3483,178,4.9
54,73,Pleasants,1992,3361,2938,423,12.6
54,75,Pocahontas,1992,4153,3564,589,14.2
54,77,Preston,1992,12701,11118,1583,12.5
54,79,Putnam,1992,21921,19897,2024,9.2
54,81,Raleigh,1992,30790,26961,3829,12.4
54,83,Randolph,1992,12642,11015,1627,12.9
54,85,Ritchie,1992,4506,3855,651,14.4
54,87,Roane,1992,6136,5089,1047,17.1
54,89,Summers,1992,4641,4002,639,13.8
54,91,Taylor,1992,6374,5624,750,11.8
54,93,Tucker,1992,3646,3149,497,13.6
54,95,Tyler,1992,4088,3659,429,10.5
54,97,Upshur,1992,9870,8559,1311,13.3
54,99,Wayne,1992,17018,15142,1876,11.0
54,101,Webster,1992,3330,2692,638,19.2
54,103,Wetzel,1992,7775,6707,1068,13.7
54,105,Wirt,1992,2077,1745,332,16.0
54,107,Wood,1992,43475,39332,4143,9.5
54,109,Wyoming,1992,8814,7415,1399,15.9
55,1,Adams,1992,6865,6408,457,6.7
55,3,Ashland,1992,7799,7157,642,8.2
55,5,Barron,1992,21954,20505,1449,6.6
55,7,Bayfield,1992,6868,6349,519,7.6
55,9,Brown,1992,114323,109430,4893,4.3
55,11,Buffalo,1992,7245,6815,430,5.9
55,13,Burnett,1992,6027,5601,426,7.1
55,15,Calumet,1992,22411,21212,1199,5.4
55,17,Chippewa,1992,26927,25220,1707,6.3
55,19,Clark,1992,15485,14255,1230,7.9
55,21,Columbia,1992,26108,24545,1563,6.0
55,23,Crawford,1992,8736,8186,550,6.3
55,25,Dane,1992,230975,226018,4957,2.1
55,27,Dodge,1992,40724,38403,2321,5.7
55,29,Door,1992,14771,13635,1136,7.7
55,31,Douglas,1992,20986,19358,1628,7.8
55,33,Dunn,1992,18919,17856,1063,5.6
55,35,Eau Claire,1992,45571,42939,2632,5.8
55,37,Florence,1992,1526,1357,169,11.1
55,39,Fond du Lac,1992,52351,50054,2297,4.4
55,41,Forest,1992,4259,3942,317,7.4
55,43,Grant,1992,25325,23956,1369,5.4
55,45,Green,1992,18262,17447,815,4.5
55,47,Green Lake,1992,10159,9588,571,5.6
55,49,Iowa,1992,12668,12101,567,4.5
55,51,Iron,1992,3192,2919,273,8.6
55,53,Jackson,1992,8692,8059,633,7.3
55,55,Jefferson,1992,38122,36190,1932,5.1
55,57,Juneau,1992,10781,9936,845,7.8
55,59,Kenosha,1992,71304,67029,4275,6.0
55,61,Kewaunee,1992,10459,9782,677,6.5
55,63,La Crosse,1992,55597,53167,2430,4.4
55,65,Lafayette,1992,8424,7990,434,5.2
55,67,Langlade,1992,9264,8626,638,6.9
55,69,Lincoln,1992,14532,13599,933,6.4
55,71,Manitowoc,1992,41750,39381,2369,5.7
55,73,Marathon,1992,65492,61941,3551,5.4
55,75,Marinette,1992,19769,18144,1625,8.2
55,77,Marquette,1992,6343,5901,442,7.0
55,78,Menominee,1992,1753,1577,176,10.0
55,79,Milwaukee,1992,476423,452104,24319,5.1
55,81,Monroe,1992,18860,17570,1290,6.8
55,83,Oconto,1992,14311,13087,1224,8.6
55,85,Oneida,1992,17391,16532,859,4.9
55,87,Outagamie,1992,89206,85947,3259,3.7
55,89,Ozaukee,1992,43174,41530,1644,3.8
55,91,Pepin,1992,3383,3164,219,6.5
55,93,Pierce,1992,18928,17855,1073,5.7
55,95,Polk,1992,18206,16789,1417,7.8
55,97,Portage,1992,36597,34909,1688,4.6
55,99,Price,1992,7618,7145,473,6.2
55,101,Racine,1992,91710,85241,6469,7.1
55,103,Richland,1992,8297,7746,551,6.6
55,105,Rock,1992,75098,69068,6030,8.0
55,107,Rusk,1992,6871,6177,694,10.1
55,109,St. Croix,1992,28758,27147,1611,5.6
55,111,Sauk,1992,27504,25918,1586,5.8
55,113,Sawyer,1992,7470,6830,640,8.6
55,115,Shawano,1992,17939,16779,1160,6.5
55,117,Sheboygan,1992,56522,54106,2416,4.3
55,119,Taylor,1992,10053,9297,756,7.5
55,121,Trempealeau,1992,13554,12409,1145,8.4
55,123,Vernon,1992,12628,11851,777,6.2
55,125,Vilas,1992,8930,8477,453,5.1
55,127,Walworth,1992,45471,43716,1755,3.9
55,129,Washburn,1992,6807,6274,533,7.8
55,131,Washington,1992,57553,54793,2760,4.8
55,133,Waukesha,1992,183124,175699,7425,4.1
55,135,Waupaca,1992,24382,23192,1190,4.9
55,137,Waushara,1992,9312,8664,648,7.0
55,139,Winnebago,1992,88742,85766,2976,3.4
55,141,Wood,1992,38958,36800,2158,5.5
56,1,Albany,1992,16015,15568,447,2.8
56,3,Big Horn,1992,4828,4512,316,6.5
56,5,Campbell,1992,16766,15849,917,5.5
56,7,Carbon,1992,8327,7854,473,5.7
56,9,Converse,1992,6005,5667,338,5.6
56,11,Crook,1992,2759,2673,86,3.1
56,13,Fremont,1992,16111,14929,1182,7.3
56,15,Goshen,1992,6061,5790,271,4.5
56,17,Hot Springs,1992,2448,2317,131,5.4
56,19,Johnson,1992,3299,3114,185,5.6
56,21,Laramie,1992,37204,35688,1516,4.1
56,23,Lincoln,1992,6327,5837,490,7.7
56,25,Natrona,1992,31232,29016,2216,7.1
56,27,Niobrara,1992,1156,1102,54,4.7
56,29,Park,1992,13357,12805,552,4.1
56,31,Platte,1992,3921,3705,216,5.5
56,33,Sheridan,1992,12545,11842,703,5.6
56,35,Sublette,1992,2788,2699,89,3.2
56,37,Sweetwater,1992,21136,19862,1274,6.0
56,39,Teton,1992,9001,8752,249,2.8
56,41,Uinta,1992,10258,9425,833,8.1
56,43,Washakie,1992,4456,4200,256,5.7
56,45,Weston,1992,3216,3037,179,5.6
72,1,Adjuntas Municipio,1992,5323,4406,917,17.2
72,3,Aguada Municipio,1992,14615,11340,3275,22.4
72,5,Aguadilla Municipio,1992,20895,16269,4626,22.1
72,7,Aguas Buenas Municipio,1992,7732,6208,1524,19.7
72,9,Aibonito Municipio,1992,9572,8128,1444,15.1
72,11,Anasco Municipio,1992,9984,7801,2183,21.9
72,13,Arecibo Municipio,1992,29010,23337,5673,19.6
72,15,Arroyo Municipio,1992,4873,3815,1058,21.7
72,17,Barceloneta Municipio,1992,6498,5012,1486,22.9
72,19,Barranquitas Municipio,1992,6873,5889,984,14.3
72,21,Bayamon Municipio,1992,80796,71066,9730,12.0
72,23,Cabo Rojo Municipio,1992,13785,11269,2516,18.3
72,25,Caguas Municipio,1992,52845,45075,7770,14.7
72,27,Camuy Municipio,1992,9049,7225,1824,20.2
72,29,Canovanas Municipio,1992,12383,10104,2279,18.4
72,31,Carolina Municipio,1992,71968,63972,7996,11.1
72,33,Catano Municipio,1992,10434,9030,1404,13.5
72,35,Cayey Municipio,1992,15308,12414,2894,18.9
72,37,Ceiba Municipio,1992,5238,4304,934,17.8
72,39,Ciales Municipio,1992,5249,4117,1132,21.6
72,41,Cidra Municipio,1992,11583,9728,1855,16.0
72,43,Coamo Municipio,1992,8860,6898,1962,22.1
72,45,Comerio Municipio,1992,5511,4446,1065,19.3
72,47,Corozal Municipio,1992,9097,7592,1505,16.5
72,49,Culebra Municipio,1992,773,728,45,5.8
72,51,Dorado Municipio,1992,9924,8408,1516,15.3
72,53,Fajardo Municipio,1992,12916,10253,2663,20.6
72,54,Florida Municipio,1992,2727,2053,674,24.7
72,55,Guanica Municipio,1992,5621,4096,1525,27.1
72,57,Guayama Municipio,1992,10664,8190,2474,23.2
72,59,Guayanilla Municipio,1992,6569,4865,1704,25.9
72,61,Guaynabo Municipio,1992,35738,32833,2905,8.1
72,63,Gurabo Municipio,1992,9995,8259,1736,17.4
72,65,Hatillo Municipio,1992,9880,7841,2039,20.6
72,67,Hormigueros Municipio,1992,6449,5335,1114,17.3
72,69,Humacao Municipio,1992,18596,15099,3497,18.8
72,71,Isabela Municipio,1992,12155,9338,2817,23.2
72,73,Jayuya Municipio,1992,3880,3287,593,15.3
72,75,Juana Diaz Municipio,1992,12612,9775,2837,22.5
72,77,Juncos Municipio,1992,9303,7506,1797,19.3
72,79,Lajas Municipio,1992,8938,7171,1767,19.8
72,81,Lares Municipio,1992,7587,5911,1676,22.1
72,83,Las Marias Municipio,1992,3937,3381,556,14.1
72,85,Las Piedras Municipio,1992,8901,7357,1544,17.3
72,87,Loiza Municipio,1992,8406,7146,1260,15.0
72,89,Luquillo Municipio,1992,6582,4844,1738,26.4
72,91,Manati Municipio,1992,12689,9993,2696,21.2
72,93,Maricao Municipio,1992,2219,1899,320,14.4
72,95,Maunabo Municipio,1992,3009,2221,788,26.2
72,97,Mayaguez Municipio,1992,35505,29636,5869,16.5
72,99,Moca Municipio,1992,11839,9331,2508,21.2
72,101,Morovis Municipio,1992,7650,6030,1620,21.2
72,103,Naguabo Municipio,1992,6489,5097,1392,21.5
72,105,Naranjito Municipio,1992,6923,5601,1322,19.1
72,107,Orocovis Municipio,1992,5793,4536,1257,21.7
72,109,Patillas Municipio,1992,5511,3984,1527,27.7
72,111,Penuelas Municipio,1992,6717,5026,1691,25.2
72,113,Ponce Municipio,1992,58761,47707,11054,18.8
72,115,Quebradillas Municipio,1992,8803,7581,1222,13.9
72,117,Rincon Municipio,1992,5550,4688,862,15.5
72,119,Rio Grande Municipio,1992,15787,12813,2974,18.8
72,121,Sabana Grande Municipio,1992,8045,6642,1403,17.4
72,123,Salinas Municipio,1992,7993,5715,2278,28.5
72,125,San German Municipio,1992,12778,10215,2563,20.1
72,127,San Juan Municipio,1992,158895,140696,18199,11.5
72,129,San Lorenzo Municipio,1992,11605,9207,2398,20.7
72,131,San Sebastian Municipio,1992,12006,8481,3525,29.4
72,133,Santa Isabel Municipio,1992,5475,3632,1843,33.7
72,135,Toa Alta Municipio,1992,15313,12984,2329,15.2
72,137,Toa Baja Municipio,1992,32073,28915,3158,9.8
72,139,Trujillo Alto Municipio,1992,23241,20908,2333,10.0
72,141,Utuado Municipio,1992,8404,6844,1560,18.6
72,143,Vega Alta Municipio,1992,10796,9055,1741,16.1
72,145,Vega Baja Municipio,1992,17593,14276,3317,18.9
72,147,Vieques Municipio,1992,2784,2129,655,23.5
72,149,Villalba Municipio,1992,6294,4580,1714,27.2
72,151,Yabucoa Municipio,1992,11105,8276,2829,25.5
72,153,Yauco Municipio,1992,12932,10143,2789,21.6
1,1,Autauga,1993,18170,17098,1072,5.9
1,3,Baldwin,1993,54891,51633,3258,5.9
1,5,Barbour,1993,11953,10763,1190,10.0
1,7,Bibb,1993,7700,6817,883,11.5
1,9,Blount,1993,19862,18823,1039,5.2
1,11,Bullock,1993,4155,3547,608,14.6
1,13,Butler,1993,9177,8189,988,10.8
1,15,Calhoun,1993,52616,48089,4527,8.6
1,17,Chambers,1993,17400,15750,1650,9.5
1,19,Cherokee,1993,9652,9054,598,6.2
1,21,Chilton,1993,16277,14848,1429,8.8
1,23,Choctaw,1993,7219,6202,1017,14.1
1,25,Clarke,1993,12947,11420,1527,11.8
1,27,Clay,1993,6724,6033,691,10.3
1,29,Cleburne,1993,6967,6507,460,6.6
1,31,Coffee,1993,20795,19547,1248,6.0
1,33,Colbert,1993,25564,23458,2106,8.2
1,35,Conecuh,1993,6290,5653,637,10.1
1,37,Coosa,1993,5124,4811,313,6.1
1,39,Covington,1993,16884,15337,1547,9.2
1,41,Crenshaw,1993,5937,5470,467,7.9
1,43,Cullman,1993,35198,32943,2255,6.4
1,45,Dale,1993,20872,19025,1847,8.8
1,47,Dallas,1993,20318,17319,2999,14.8
1,49,DeKalb,1993,29378,27426,1952,6.6
1,51,Elmore,1993,24657,23169,1488,6.0
1,53,Escambia,1993,16099,14509,1590,9.9
1,55,Etowah,1993,47378,43763,3615,7.6
1,57,Fayette,1993,8718,7922,796,9.1
1,59,Franklin,1993,15240,14112,1128,7.4
1,61,Geneva,1993,12092,11375,717,5.9
1,63,Greene,1993,3713,3166,547,14.7
1,65,Hale,1993,6946,6270,676,9.7
1,67,Henry,1993,6527,5891,636,9.7
1,69,Houston,1993,42253,39362,2891,6.8
1,71,Jackson,1993,25762,23289,2473,9.6
1,73,Jefferson,1993,317054,299295,17759,5.6
1,75,Lamar,1993,7825,7087,738,9.4
1,77,Lauderdale,1993,40407,37542,2865,7.1
1,79,Lawrence,1993,15338,13851,1487,9.7
1,81,Lee,1993,44267,41692,2575,5.8
1,83,Limestone,1993,27208,25622,1586,5.8
1,85,Lowndes,1993,4256,3460,796,18.7
1,87,Macon,1993,8589,7753,836,9.7
1,89,Madison,1993,134088,126767,7321,5.5
1,91,Marengo,1993,10718,9564,1154,10.8
1,93,Marion,1993,14402,13088,1314,9.1
1,95,Marshall,1993,37539,34662,2877,7.7
1,97,Mobile,1993,187148,171841,15307,8.2
1,99,Monroe,1993,10162,8701,1461,14.4
1,101,Montgomery,1993,104151,98181,5970,5.7
1,103,Morgan,1993,51584,47951,3633,7.0
1,105,Perry,1993,4828,4114,714,14.8
1,107,Pickens,1993,9130,8091,1039,11.4
1,109,Pike,1993,12929,12048,881,6.8
1,111,Randolph,1993,9673,8783,890,9.2
1,113,Russell,1993,22452,20770,1682,7.5
1,115,St. Clair,1993,25786,24200,1586,6.2
1,117,Shelby,1993,60445,58365,2080,3.4
1,119,Sumter,1993,6140,5372,768,12.5
1,121,Talladega,1993,34360,31422,2938,8.6
1,123,Tallapoosa,1993,19835,18467,1368,6.9
1,125,Tuscaloosa,1993,72453,68695,3758,5.2
1,127,Walker,1993,29794,26624,3170,10.6
1,129,Washington,1993,6668,5524,1144,17.2
1,131,Wilcox,1993,4007,3307,700,17.5
1,133,Winston,1993,11837,10952,885,7.5
2,13,Aleutians East Borough,1993,1482,1452,30,2.0
2,16,Aleutians West Census Area,1993,3985,3936,49,1.2
2,20,Anchorage Borough/municipality,1993,131813,123923,7890,6.0
2,50,Bethel Census Area,1993,5028,4673,355,7.1
2,60,Bristol Bay Borough,1993,633,595,38,6.0
2,68,Denali Borough,1993,1022,927,95,9.3
2,70,Dillingham Census Area,1993,1544,1427,117,7.6
2,90,Fairbanks North Star Borough,1993,39553,36215,3338,8.4
2,100,Haines Borough,1993,1093,992,101,9.2
2,110,Juneau Borough/city,1993,16156,15160,996,6.2
2,122,Kenai Peninsula Borough,1993,20454,17801,2653,13.0
2,130,Ketchikan Gateway Borough,1993,7647,6977,670,8.8
2,150,Kodiak Island Borough,1993,7178,6462,716,10.0
2,158,Kusilvak Census Area,1993,1702,1521,181,10.6
2,164,Lake and Peninsula Borough,1993,533,493,40,7.5
2,170,Matanuska-Susitna Borough,1993,22403,19943,2460,11.0
2,180,Nome Census Area,1993,3258,2870,388,11.9
2,185,North Slope Borough,1993,2984,2846,138,4.6
2,188,Northwest Arctic Borough,1993,2176,1805,371,17.0
2,201,Prince of Wales-Outer Ketchikan Census Area,1993,3053,2754,299,9.8
2,220,Sitka Borough/city,1993,4717,4427,290,6.1
2,232,Skagway-Hoonah-Angoon Census Area,1993,2516,2277,239,9.5
2,240,Southeast Fairbanks Census Area,1993,2311,2014,297,12.9
2,261,Valdez-Cordova Census Area,1993,5208,4718,490,9.4
2,280,Wrangell-Petersburg Census Area,1993,3642,3324,318,8.7
2,290,Yukon-Koyukuk Census Area,1993,2005,1701,304,15.2
4,1,Apache,1993,18259,15110,3149,17.2
4,3,Cochise,1993,40701,36792,3909,9.6
4,5,Coconino,1993,53847,49118,4729,8.8
4,7,Gila,1993,17709,16037,1672,9.4
4,9,Graham,1993,10449,9416,1033,9.9
4,11,Greenlee,1993,3978,3548,430,10.8
4,12,La Paz,1993,5365,4521,844,15.7
4,13,Maricopa,1993,1184151,1124576,59575,5.0
4,15,Mohave,1993,52313,47336,4977,9.5
4,17,Navajo,1993,29794,25709,4085,13.7
4,19,Pima,1993,348764,334529,14235,4.1
4,21,Pinal,1993,47789,44665,3124,6.5
4,23,Santa Cruz,1993,14628,12129,2499,17.1
4,25,Yavapai,1993,55997,52955,3042,5.4
4,27,Yuma,1993,57386,41387,15999,27.9
5,1,Arkansas,1993,10505,9905,600,5.7
5,3,Ashley,1993,10897,10140,757,6.9
5,5,Baxter,1993,13153,12520,633,4.8
5,7,Benton,1993,55305,53830,1475,2.7
5,9,Boone,1993,14372,13772,600,4.2
5,11,Bradley,1993,4920,4482,438,8.9
5,13,Calhoun,1993,2397,2171,226,9.4
5,15,Carroll,1993,11856,11250,606,5.1
5,17,Chicot,1993,6287,5718,569,9.1
5,19,Clark,1993,11131,10645,486,4.4
5,21,Clay,1993,8291,7554,737,8.9
5,23,Cleburne,1993,8830,8178,652,7.4
5,25,Cleveland,1993,3764,3532,232,6.2
5,27,Columbia,1993,11771,10876,895,7.6
5,29,Conway,1993,9216,8564,652,7.1
5,31,Craighead,1993,37933,36049,1884,5.0
5,33,Crawford,1993,22079,20614,1465,6.6
5,35,Crittenden,1993,21856,20328,1528,7.0
5,37,Cross,1993,8890,8062,828,9.3
5,39,Dallas,1993,3894,3610,284,7.3
5,41,Desha,1993,7107,6501,606,8.5
5,43,Drew,1993,9350,8728,622,6.7
5,45,Faulkner,1993,35058,33076,1982,5.7
5,47,Franklin,1993,7794,7352,442,5.7
5,49,Fulton,1993,4475,4203,272,6.1
5,51,Garland,1993,34524,31954,2570,7.4
5,53,Grant,1993,7060,6691,369,5.2
5,55,Greene,1993,16173,15163,1010,6.2
5,57,Hempstead,1993,10828,10010,818,7.6
5,59,Hot Spring,1993,11817,10886,931,7.9
5,61,Howard,1993,6766,6336,430,6.4
5,63,Independence,1993,16307,15353,954,5.9
5,65,Izard,1993,4162,3796,366,8.8
5,67,Jackson,1993,8342,7391,951,11.4
5,69,Jefferson,1993,37391,33877,3514,9.4
5,71,Johnson,1993,9384,8880,504,5.4
5,73,Lafayette,1993,3611,3326,285,7.9
5,75,Lawrence,1993,7917,7349,568,7.2
5,77,Lee,1993,4679,4164,515,11.0
5,79,Lincoln,1993,5140,4764,376,7.3
5,81,Little River,1993,5686,5232,454,8.0
5,83,Logan,1993,10045,9556,489,4.9
5,85,Lonoke,1993,21180,20179,1001,4.7
5,87,Madison,1993,6817,6584,233,3.4
5,89,Marion,1993,5315,5132,183,3.4
5,91,Miller,1993,17075,15875,1200,7.0
5,93,Mississippi,1993,26947,24145,2802,10.4
5,95,Monroe,1993,4384,4044,340,7.8
5,97,Montgomery,1993,3793,3637,156,4.1
5,99,Nevada,1993,4572,4297,275,6.0
5,101,Newton,1993,2946,2774,172,5.8
5,103,Ouachita,1993,12864,11358,1506,11.7
5,105,Perry,1993,3534,3218,316,8.9
5,107,Phillips,1993,10998,9780,1218,11.1
5,109,Pike,1993,4630,4338,292,6.3
5,111,Poinsett,1993,11010,9999,1011,9.2
5,113,Polk,1993,8087,7720,367,4.5
5,115,Pope,1993,25450,24167,1283,5.0
5,117,Prairie,1993,3903,3505,398,10.2
5,119,Pulaski,1993,189596,180516,9080,4.8
5,121,Randolph,1993,7690,7058,632,8.2
5,123,St. Francis,1993,11973,10388,1585,13.2
5,125,Saline,1993,35947,34357,1590,4.4
5,127,Scott,1993,5027,4839,188,3.7
5,129,Searcy,1993,2973,2813,160,5.4
5,131,Sebastian,1993,54101,50825,3276,6.1
5,133,Sevier,1993,7048,6714,334,4.7
5,135,Sharp,1993,5610,5203,407,7.3
5,137,Stone,1993,4847,4554,293,6.0
5,139,Union,1993,21099,19579,1520,7.2
5,141,Van Buren,1993,5910,5420,490,8.3
5,143,Washington,1993,66955,64930,2025,3.0
5,145,White,1993,27998,25833,2165,7.7
5,147,Woodruff,1993,4020,3592,428,10.6
5,149,Yell,1993,9147,8723,424,4.6
6,1,Alameda,1993,677590,632236,45354,6.7
6,3,Alpine,1993,360,313,47,13.1
6,5,Amador,1993,12821,11625,1196,9.3
6,7,Butte,1993,82492,72595,9897,12.0
6,9,Calaveras,1993,14945,13129,1816,12.2
6,11,Colusa,1993,8478,6635,1843,21.7
6,13,Contra Costa,1993,442129,412757,29372,6.6
6,15,Del Norte,1993,9753,8366,1387,14.2
6,17,El Dorado,1993,67433,61549,5884,8.7
6,19,Fresno,1993,361695,305602,56093,15.5
6,21,Glenn,1993,11357,9382,1975,17.4
6,23,Humboldt,1993,59584,53665,5919,9.9
6,25,Imperial,1993,55298,39035,16263,29.4
6,27,Inyo,1993,7107,6313,794,11.2
6,29,Kern,1993,273345,230068,43277,15.8
6,31,Kings,1993,40934,34672,6262,15.3
6,33,Lake,1993,22877,19813,3064,13.4
6,35,Lassen,1993,10933,9572,1361,12.4
6,37,Los Angeles,1993,4347927,3913235,434692,10.0
6,39,Madera,1993,47870,40060,7810,16.3
6,41,Marin,1993,130684,123949,6735,5.2
6,43,Mariposa,1993,7240,6510,730,10.1
6,45,Mendocino,1993,40353,35793,4560,11.3
6,47,Merced,1993,83243,68772,14471,17.4
6,49,Modoc,1993,3928,3392,536,13.6
6,51,Mono,1993,5975,5412,563,9.4
6,53,Monterey,1993,176744,153635,23109,13.1
6,55,Napa,1993,57973,53384,4589,7.9
6,57,Nevada,1993,40205,36801,3404,8.5
6,59,Orange,1993,1326902,1236273,90629,6.8
6,61,Placer,1993,93149,85584,7565,8.1
6,63,Plumas,1993,9680,8212,1468,15.2
6,65,Riverside,1993,582050,511391,70659,12.1
6,67,Sacramento,1993,529619,485342,44277,8.4
6,69,San Benito,1993,22256,18674,3582,16.1
6,71,San Bernardino,1993,675880,608655,67225,9.9
6,73,San Diego,1993,1218067,1122528,95539,7.8
6,75,San Francisco/city,1993,406129,377344,28785,7.1
6,77,San Joaquin,1993,241861,207589,34272,14.2
6,79,San Luis Obispo,1993,101239,92946,8293,8.2
6,81,San Mateo,1993,368361,349558,18803,5.1
6,83,Santa Barbara,1993,192907,177938,14969,7.8
6,85,Santa Clara,1993,846876,787983,58893,7.0
6,87,Santa Cruz,1993,140344,125640,14704,10.5
6,89,Shasta,1993,73175,63919,9256,12.6
6,91,Sierra,1993,1807,1607,200,11.1
6,93,Siskiyou,1993,19309,16304,3005,15.6
6,95,Solano,1993,174705,160362,14343,8.2
6,97,Sonoma,1993,220068,205456,14612,6.6
6,99,Stanislaus,1993,194155,161404,32751,16.9
6,101,Sutter,1993,34687,28150,6537,18.8
6,103,Tehama,1993,23310,20234,3076,13.2
6,105,Trinity,1993,5184,4315,869,16.8
6,107,Tulare,1993,157673,128987,28686,18.2
6,109,Tuolumne,1993,20617,18155,2462,11.9
6,111,Ventura,1993,375302,341278,34024,9.1
6,113,Yolo,1993,82692,76030,6662,8.1
6,115,Yuba,1993,23003,18973,4030,17.5
8,1,Adams,1993,150745,142597,8148,5.4
8,3,Alamosa,1993,7214,6694,520,7.2
8,5,Arapahoe,1993,247447,236918,10529,4.3
8,7,Archuleta,1993,3016,2784,232,7.7
8,9,Baca,1993,2085,2029,56,2.7
8,11,Bent,1993,2179,2089,90,4.1
8,13,Boulder,1993,139832,133330,6502,4.6
8,14,Broomfield/city,1993,15772,15218,554,3.5
8,15,Chaffee,1993,6398,6011,387,6.0
8,17,Cheyenne,1993,1143,1104,39,3.4
8,19,Clear Creek,1993,4961,4602,359,7.2
8,21,Conejos,1993,3224,2907,317,9.8
8,23,Costilla,1993,1731,1535,196,11.3
8,25,Crowley,1993,1185,1116,69,5.8
8,27,Custer,1993,1275,1203,72,5.6
8,29,Delta,1993,9208,8547,661,7.2
8,31,Denver/city,1993,266668,250276,16392,6.1
8,33,Dolores,1993,718,621,97,13.5
8,35,Douglas,1993,46163,44604,1559,3.4
8,37,Eagle,1993,14879,14085,794,5.3
8,39,Elbert,1993,6975,6626,349,5.0
8,41,El Paso,1993,208845,195715,13130,6.3
8,43,Fremont,1993,15195,13978,1217,8.0
8,45,Garfield,1993,18208,17030,1178,6.5
8,47,Gilpin,1993,3276,3143,133,4.1
8,49,Grand,1993,4932,4676,256,5.2
8,51,Gunnison,1993,6930,6490,440,6.3
8,53,Hinsdale,1993,524,501,23,4.4
8,55,Huerfano,1993,2848,2599,249,8.7
8,57,Jackson,1993,1102,1029,73,6.6
8,59,Jefferson,1993,272310,260612,11698,4.3
8,61,Kiowa,1993,829,813,16,1.9
8,63,Kit Carson,1993,3268,3145,123,3.8
8,65,Lake,1993,3022,2680,342,11.3
8,67,La Plata,1993,20416,19194,1222,6.0
8,69,Larimer,1993,116349,111053,5296,4.6
8,71,Las Animas,1993,5748,5281,467,8.1
8,73,Lincoln,1993,2496,2393,103,4.1
8,75,Logan,1993,8546,8197,349,4.1
8,77,Mesa,1993,49836,46303,3533,7.1
8,79,Mineral,1993,379,354,25,6.6
8,81,Moffat,1993,6243,5776,467,7.5
8,83,Montezuma,1993,10661,9834,827,7.8
8,85,Montrose,1993,12929,12157,772,6.0
8,87,Morgan,1993,11798,11334,464,3.9
8,89,Otero,1993,8380,7861,519,6.2
8,91,Ouray,1993,1390,1323,67,4.8
8,93,Park,1993,5608,5277,331,5.9
8,95,Phillips,1993,1793,1754,39,2.2
8,97,Pitkin,1993,8567,8013,554,6.5
8,99,Prowers,1993,6018,5715,303,5.0
8,101,Pueblo,1993,53719,49204,4515,8.4
8,103,Rio Blanco,1993,3454,3281,173,5.0
8,105,Rio Grande,1993,4947,4514,433,8.8
8,107,Routt,1993,9503,8962,541,5.7
8,109,Saguache,1993,2357,2083,274,11.6
8,111,San Juan,1993,330,260,70,21.2
8,113,San Miguel,1993,3649,3475,174,4.8
8,115,Sedgwick,1993,1206,1155,51,4.2
8,117,Summit,1993,9584,9179,405,4.2
8,119,Teller,1993,9996,9228,768,7.7
8,121,Washington,1993,2182,2110,72,3.3
8,123,Weld,1993,73139,69265,3874,5.3
8,125,Yuma,1993,3972,3847,125,3.1
9,1,Fairfield,1993,456825,431226,25599,5.6
9,3,Hartford,1993,455390,422850,32540,7.1
9,5,Litchfield,1993,104086,97598,6488,6.2
9,7,Middlesex,1993,83951,78791,5160,6.1
9,9,New Haven,1993,432210,402447,29763,6.9
9,11,New London,1993,132744,124615,8129,6.1
9,13,Tolland,1993,73428,69092,4336,5.9
9,15,Windham,1993,55917,51628,4289,7.7
10,1,Kent,1993,66653,62965,3688,5.5
10,3,New Castle,1993,243128,231699,11429,4.7
10,5,Sussex,1993,66073,62768,3305,5.0
11,1,District of Colu,1993,314324,287993,26331,8.4
12,1,Alachua,1993,99649,95643,4006,4.0
12,3,Baker,1993,8709,7910,799,9.2
12,5,Bay,1993,65440,59116,6324,9.7
12,7,Bradford,1993,9662,9049,613,6.3
12,9,Brevard,1993,212950,196053,16897,7.9
12,11,Broward,1993,713533,661707,51826,7.3
12,13,Calhoun,1993,4461,4154,307,6.9
12,15,Charlotte,1993,45009,41992,3017,6.7
12,17,Citrus,1993,34502,31359,3143,9.1
12,19,Clay,1993,58664,55681,2983,5.1
12,21,Collier,1993,80616,73607,7009,8.7
12,23,Columbia,1993,22085,19980,2105,9.5
12,27,DeSoto,1993,10195,9123,1072,10.5
12,29,Dixie,1993,3960,3608,352,8.9
12,31,Duval,1993,362075,341124,20951,5.8
12,33,Escambia,1993,123137,116684,6453,5.2
12,35,Flagler,1993,13915,13066,849,6.1
12,37,Franklin,1993,4448,4282,166,3.7
12,39,Gadsden,1993,18954,17708,1246,6.6
12,41,Gilchrist,1993,4218,3953,265,6.3
12,43,Glades,1993,3493,3078,415,11.9
12,45,Gulf,1993,5852,5416,436,7.5
12,47,Hamilton,1993,3789,3168,621,16.4
12,49,Hardee,1993,10451,8782,1669,16.0
12,51,Hendry,1993,15759,13294,2465,15.6
12,53,Hernando,1993,40169,37081,3088,7.7
12,55,Highlands,1993,27421,24501,2920,10.6
12,57,Hillsborough,1993,481260,449042,32218,6.7
12,59,Holmes,1993,6586,6105,481,7.3
12,61,Indian River,1993,40196,35489,4707,11.7
12,63,Jackson,1993,19920,18595,1325,6.7
12,65,Jefferson,1993,5613,5341,272,4.8
12,67,Lafayette,1993,2353,2209,144,6.1
12,69,Lake,1993,71374,66368,5006,7.0
12,71,Lee,1993,165395,155440,9955,6.0
12,73,Leon,1993,121374,116823,4551,3.7
12,75,Levy,1993,11550,10762,788,6.8
12,77,Liberty,1993,2293,2199,94,4.1
12,79,Madison,1993,6984,6493,491,7.0
12,81,Manatee,1993,98907,93424,5483,5.5
12,83,Marion,1993,90973,83455,7518,8.3
12,85,Martin,1993,46165,41450,4715,10.2
12,86,Miami-Dade,1993,987569,902369,85200,8.6
12,87,Monroe,1993,43292,41684,1608,3.7
12,89,Nassau,1993,24564,23028,1536,6.3
12,91,Okaloosa,1993,71929,67349,4580,6.4
12,93,Okeechobee,1993,15342,13733,1609,10.5
12,95,Orange,1993,418002,390840,27162,6.5
12,97,Osceola,1993,66726,62282,4444,6.7
12,99,Palm Beach,1993,456296,413275,43021,9.4
12,101,Pasco,1993,115646,106551,9095,7.9
12,103,Pinellas,1993,434524,406975,27549,6.3
12,105,Polk,1993,200866,180490,20376,10.1
12,107,Putnam,1993,30085,27676,2409,8.0
12,109,St. Johns,1993,48997,45984,3013,6.1
12,111,St. Lucie,1993,73973,63813,10160,13.7
12,113,Santa Rosa,1993,44334,42222,2112,4.8
12,115,Sarasota,1993,126972,120247,6725,5.3
12,117,Seminole,1993,184238,173119,11119,6.0
12,119,Sumter,1993,12241,11339,902,7.4
12,121,Suwannee,1993,12689,11467,1222,9.6
12,123,Taylor,1993,7867,6611,1256,16.0
12,125,Union,1993,4010,3803,207,5.2
12,127,Volusia,1993,176897,164539,12358,7.0
12,129,Wakulla,1993,8890,8478,412,4.6
12,131,Walton,1993,14222,13419,803,5.6
12,133,Washington,1993,7962,7317,645,8.1
13,1,Appling,1993,8289,7404,885,10.7
13,3,Atkinson,1993,2857,2628,229,8.0
13,5,Bacon,1993,4535,4196,339,7.5
13,7,Baker,1993,1344,1147,197,14.7
13,9,Baldwin,1993,17164,16404,760,4.4
13,11,Banks,1993,5838,5532,306,5.2
13,13,Barrow,1993,16469,15405,1064,6.5
13,15,Bartow,1993,31337,29223,2114,6.7
13,17,Ben Hill,1993,8000,7432,568,7.1
13,19,Berrien,1993,6450,5954,496,7.7
13,21,Bibb,1993,70341,66219,4122,5.9
13,23,Bleckley,1993,4984,4751,233,4.7
13,25,Brantley,1993,5048,4618,430,8.5
13,27,Brooks,1993,6610,6317,293,4.4
13,29,Bryan,1993,8426,8044,382,4.5
13,31,Bulloch,1993,20683,19966,717,3.5
13,33,Burke,1993,8552,7545,1007,11.8
13,35,Butts,1993,7162,6706,456,6.4
13,37,Calhoun,1993,2089,1799,290,13.9
13,39,Camden,1993,15161,14528,633,4.2
13,43,Candler,1993,3766,3599,167,4.4
13,45,Carroll,1993,37909,35700,2209,5.8
13,47,Catoosa,1993,23248,22189,1059,4.6
13,49,Charlton,1993,3913,3695,218,5.6
13,51,Chatham,1993,103476,97320,6156,5.9
13,53,Chattahoochee,1993,2068,1894,174,8.4
13,55,Chattooga,1993,11871,11191,680,5.7
13,57,Cherokee,1993,57270,54946,2324,4.1
13,59,Clarke,1993,43108,41432,1676,3.9
13,61,Clay,1993,1474,1362,112,7.6
13,63,Clayton,1993,107679,101176,6503,6.0
13,65,Clinch,1993,3550,3413,137,3.9
13,67,Cobb,1993,291689,278483,13206,4.5
13,69,Coffee,1993,15558,14496,1062,6.8
13,71,Colquitt,1993,17093,16170,923,5.4
13,73,Columbia,1993,38209,36362,1847,4.8
13,75,Cook,1993,6940,6474,466,6.7
13,77,Coweta,1993,31829,30156,1673,5.3
13,79,Crawford,1993,4943,4614,329,6.7
13,81,Crisp,1993,9175,8547,628,6.8
13,83,Dade,1993,6549,6218,331,5.1
13,85,Dawson,1993,6801,6479,322,4.7
13,87,Decatur,1993,10972,10070,902,8.2
13,89,DeKalb,1993,329045,310604,18441,5.6
13,91,Dodge,1993,8873,8317,556,6.3
13,93,Dooly,1993,4315,4011,304,7.0
13,95,Dougherty,1993,43974,40018,3956,9.0
13,97,Douglas,1993,42445,40522,1923,4.5
13,99,Early,1993,5192,4700,492,9.5
13,101,Echols,1993,1023,948,75,7.3
13,103,Effingham,1993,13587,12958,629,4.6
13,105,Elbert,1993,8592,7791,801,9.3
13,107,Emanuel,1993,8600,7718,882,10.3
13,109,Evans,1993,4379,3991,388,8.9
13,111,Fannin,1993,7981,7382,599,7.5
13,113,Fayette,1993,38045,36827,1218,3.2
13,115,Floyd,1993,44693,41863,2830,6.3
13,117,Forsyth,1993,28669,27597,1072,3.7
13,119,Franklin,1993,8999,8435,564,6.3
13,121,Fulton,1993,354138,332059,22079,6.2
13,123,Gilmer,1993,6727,6223,504,7.5
13,125,Glascock,1993,1165,1094,71,6.1
13,127,Glynn,1993,32061,30672,1389,4.3
13,129,Gordon,1993,19930,18636,1294,6.5
13,131,Grady,1993,9784,9060,724,7.4
13,133,Greene,1993,5122,4576,546,10.7
13,135,Gwinnett,1993,246537,236434,10103,4.1
13,137,Habersham,1993,14486,13863,623,4.3
13,139,Hall,1993,59338,56734,2604,4.4
13,141,Hancock,1993,3919,3567,352,9.0
13,143,Haralson,1993,9236,8370,866,9.4
13,145,Harris,1993,9060,8655,405,4.5
13,147,Hart,1993,9169,8522,647,7.1
13,149,Heard,1993,4035,3740,295,7.3
13,151,Henry,1993,38835,37258,1577,4.1
13,153,Houston,1993,45120,42913,2207,4.9
13,155,Irwin,1993,4114,3873,241,5.9
13,157,Jackson,1993,16703,15860,843,5.0
13,159,Jasper,1993,3853,3558,295,7.7
13,161,Jeff Davis,1993,5661,5202,459,8.1
13,163,Jefferson,1993,7902,7315,587,7.4
13,165,Jenkins,1993,3927,3694,233,5.9
13,167,Johnson,1993,3929,3686,243,6.2
13,169,Jones,1993,10810,10286,524,4.8
13,171,Lamar,1993,6839,6497,342,5.0
13,173,Lanier,1993,2713,2573,140,5.2
13,175,Laurens,1993,20277,19248,1029,5.1
13,177,Lee,1993,8901,8392,509,5.7
13,179,Liberty,1993,15174,13795,1379,9.1
13,181,Lincoln,1993,3863,3628,235,6.1
13,183,Long,1993,2712,2574,138,5.1
13,185,Lowndes,1993,36326,34397,1929,5.3
13,187,Lumpkin,1993,7757,7410,347,4.5
13,189,McDuffie,1993,9495,8864,631,6.6
13,191,McIntosh,1993,3465,3226,239,6.9
13,193,Macon,1993,5742,4984,758,13.2
13,195,Madison,1993,11700,11176,524,4.5
13,197,Marion,1993,3298,3081,217,6.6
13,199,Meriwether,1993,9308,8497,811,8.7
13,201,Miller,1993,2953,2728,225,7.6
13,205,Mitchell,1993,9510,8529,981,10.3
13,207,Monroe,1993,7793,7323,470,6.0
13,209,Montgomery,1993,3406,3143,263,7.7
13,211,Morgan,1993,6298,5889,409,6.5
13,213,Murray,1993,16459,15642,817,5.0
13,215,Muscogee,1993,78392,73366,5026,6.4
13,217,Newton,1993,22449,21146,1303,5.8
13,219,Oconee,1993,10150,9864,286,2.8
13,221,Oglethorpe,1993,5070,4732,338,6.7
13,223,Paulding,1993,26704,25495,1209,4.5
13,225,Peach,1993,9904,9157,747,7.5
13,227,Pickens,1993,7969,7463,506,6.3
13,229,Pierce,1993,6813,6305,508,7.5
13,231,Pike,1993,5078,4739,339,6.7
13,233,Polk,1993,15704,14000,1704,10.9
13,235,Pulaski,1993,4039,3838,201,5.0
13,237,Putnam,1993,7435,7122,313,4.2
13,239,Quitman,1993,1023,948,75,7.3
13,241,Rabun,1993,6137,5636,501,8.2
13,243,Randolph,1993,3190,2926,264,8.3
13,245,Richmond,1993,85278,78685,6593,7.7
13,247,Rockdale,1993,33071,31641,1430,4.3
13,249,Schley,1993,1498,1393,105,7.0
13,251,Screven,1993,6608,6145,463,7.0
13,253,Seminole,1993,4373,4038,335,7.7
13,255,Spalding,1993,27578,25919,1659,6.0
13,257,Stephens,1993,12524,11755,769,6.1
13,259,Stewart,1993,2378,2215,163,6.9
13,261,Sumter,1993,14117,13048,1069,7.6
13,263,Talbot,1993,2499,2302,197,7.9
13,265,Taliaferro,1993,705,657,48,6.8
13,267,Tattnall,1993,6824,6336,488,7.2
13,269,Taylor,1993,3391,3058,333,9.8
13,271,Telfair,1993,4918,4513,405,8.2
13,273,Terrell,1993,4660,4233,427,9.2
13,275,Thomas,1993,18978,17950,1028,5.4
13,277,Tift,1993,18928,17554,1374,7.3
13,279,Toombs,1993,11082,10132,950,8.6
13,281,Towns,1993,2776,2558,218,7.9
13,283,Treutlen,1993,2626,2391,235,8.9
13,285,Troup,1993,26039,23934,2105,8.1
13,287,Turner,1993,3973,3680,293,7.4
13,289,Twiggs,1993,3903,3673,230,5.9
13,291,Union,1993,6100,5734,366,6.0
13,293,Upson,1993,12950,12222,728,5.6
13,295,Walker,1993,29677,27957,1720,5.8
13,297,Walton,1993,21123,19844,1279,6.1
13,299,Ware,1993,15186,14194,992,6.5
13,301,Warren,1993,2497,2296,201,8.0
13,303,Washington,1993,9010,8615,395,4.4
13,305,Wayne,1993,11241,10184,1057,9.4
13,307,Webster,1993,1127,1072,55,4.9
13,309,Wheeler,1993,2049,1918,131,6.4
13,311,White,1993,8165,7822,343,4.2
13,313,Whitfield,1993,43276,41376,1900,4.4
13,315,Wilcox,1993,3036,2848,188,6.2
13,317,Wilkes,1993,5364,5049,315,5.9
13,319,Wilkinson,1993,4577,4331,246,5.4
13,321,Worth,1993,9323,8705,618,6.6
15,1,Hawaii,1993,64894,59963,4931,7.6
15,3,Honolulu/city,1993,423482,410185,13297,3.1
15,7,Kauai,1993,28182,24530,3652,13.0
15,9,Maui,1993,65565,62057,3508,5.4
16,1,Ada,1993,129140,124080,5060,3.9
16,3,Adams,1993,1687,1447,240,14.2
16,5,Bannock,1993,35400,33172,2228,6.3
16,7,Bear Lake,1993,2737,2579,158,5.8
16,9,Benewah,1993,3924,3508,416,10.6
16,11,Bingham,1993,20309,19160,1149,5.7
16,13,Blaine,1993,8851,8338,513,5.8
16,15,Boise,1993,2175,2021,154,7.1
16,17,Bonner,1993,14520,13117,1403,9.7
16,19,Bonneville,1993,43107,41259,1848,4.3
16,21,Boundary,1993,3976,3614,362,9.1
16,23,Butte,1993,1564,1468,96,6.1
16,25,Camas,1993,397,378,19,4.8
16,27,Canyon,1993,48844,45676,3168,6.5
16,29,Caribou,1993,3279,3050,229,7.0
16,31,Cassia,1993,8612,7884,728,8.5
16,33,Clark,1993,431,407,24,5.6
16,35,Clearwater,1993,4105,3471,634,15.4
16,37,Custer,1993,1704,1449,255,15.0
16,39,Elmore,1993,7712,7167,545,7.1
16,41,Franklin,1993,3967,3832,135,3.4
16,43,Fremont,1993,4461,4065,396,8.9
16,45,Gem,1993,5348,4939,409,7.6
16,47,Gooding,1993,5415,5131,284,5.2
16,49,Idaho,1993,6524,5692,832,12.8
16,51,Jefferson,1993,8947,8472,475,5.3
16,53,Jerome,1993,7276,6810,466,6.4
16,55,Kootenai,1993,43365,39949,3416,7.9
16,57,Latah,1993,15398,14879,519,3.4
16,59,Lemhi,1993,3515,3143,372,10.6
16,61,Lewis,1993,1585,1453,132,8.3
16,63,Lincoln,1993,1681,1581,100,5.9
16,65,Madison,1993,8888,8617,271,3.0
16,67,Minidoka,1993,9237,8415,822,8.9
16,69,Nez Perce,1993,21587,20761,826,3.8
16,71,Oneida,1993,1358,1311,47,3.5
16,73,Owyhee,1993,3442,3253,189,5.5
16,75,Payette,1993,9597,8788,809,8.4
16,77,Power,1993,3737,3538,199,5.3
16,79,Shoshone,1993,6768,5818,950,14.0
16,81,Teton,1993,1998,1917,81,4.1
16,83,Twin Falls,1993,26453,24727,1726,6.5
16,85,Valley,1993,3898,3468,430,11.0
16,87,Washington,1993,4380,3994,386,8.8
17,1,Adams,1993,35700,33575,2125,6.0
17,3,Alexander,1993,4184,3667,517,12.4
17,5,Bond,1993,7557,7019,538,7.1
17,7,Boone,1993,19340,17150,2190,11.3
17,9,Brown,1993,2544,2410,134,5.3
17,11,Bureau,1993,18875,17675,1200,6.4
17,13,Calhoun,1993,2859,2473,386,13.5
17,15,Carroll,1993,8834,8242,592,6.7
17,17,Cass,1993,7375,6915,460,6.2
17,19,Champaign,1993,94415,90335,4080,4.3
17,21,Christian,1993,18430,17166,1264,6.9
17,23,Clark,1993,9601,9081,520,5.4
17,25,Clay,1993,6663,6109,554,8.3
17,27,Clinton,1993,16725,15642,1083,6.5
17,29,Coles,1993,26836,25492,1344,5.0
17,31,Cook,1993,2639033,2412054,226979,8.6
17,33,Crawford,1993,10654,9973,681,6.4
17,35,Cumberland,1993,5358,5027,331,6.2
17,37,DeKalb,1993,43864,41208,2656,6.1
17,39,De Witt,1993,9571,8979,592,6.2
17,41,Douglas,1993,10731,10077,654,6.1
17,43,DuPage,1993,481739,454936,26803,5.6
17,45,Edgar,1993,8970,8280,690,7.7
17,47,Edwards,1993,3742,3517,225,6.0
17,49,Effingham,1993,17137,16063,1074,6.3
17,51,Fayette,1993,10321,9513,808,7.8
17,53,Ford,1993,7003,6524,479,6.8
17,55,Franklin,1993,16819,14671,2148,12.8
17,57,Fulton,1993,15158,13742,1416,9.3
17,59,Gallatin,1993,3037,2632,405,13.3
17,61,Greene,1993,7099,6669,430,6.1
17,63,Grundy,1993,17953,15926,2027,11.3
17,65,Hamilton,1993,3756,3343,413,11.0
17,67,Hancock,1993,11395,10712,683,6.0
17,69,Hardin,1993,1980,1790,190,9.6
17,71,Henderson,1993,4919,4624,295,6.0
17,73,Henry,1993,26015,24472,1543,5.9
17,75,Iroquois,1993,17487,16617,870,5.0
17,77,Jackson,1993,29727,27780,1947,6.5
17,79,Jasper,1993,4983,4673,310,6.2
17,81,Jefferson,1993,18135,16438,1697,9.4
17,83,Jersey,1993,10429,9621,808,7.7
17,85,Jo Daviess,1993,12968,12388,580,4.5
17,87,Johnson,1993,4408,3888,520,11.8
17,89,Kane,1993,185385,171584,13801,7.4
17,91,Kankakee,1993,50404,46682,3722,7.4
17,93,Kendall,1993,23480,22162,1318,5.6
17,95,Knox,1993,29595,27786,1809,6.1
17,97,Lake,1993,296451,281234,15217,5.1
17,99,LaSalle,1993,55788,50552,5236,9.4
17,101,Lawrence,1993,7255,6717,538,7.4
17,103,Lee,1993,17221,16193,1028,6.0
17,105,Livingston,1993,20234,19341,893,4.4
17,107,Logan,1993,13642,12883,759,5.6
17,109,McDonough,1993,18629,18038,591,3.2
17,111,McHenry,1993,115415,107820,7595,6.6
17,113,McLean,1993,77160,74368,2792,3.6
17,115,Macon,1993,60872,55621,5251,8.6
17,117,Macoupin,1993,23571,21742,1829,7.8
17,119,Madison,1993,126501,117853,8648,6.8
17,121,Marion,1993,21269,19126,2143,10.1
17,123,Marshall,1993,6635,6267,368,5.5
17,125,Mason,1993,8254,7492,762,9.2
17,127,Massac,1993,7730,7222,508,6.6
17,129,Menard,1993,6133,5840,293,4.8
17,131,Mercer,1993,8849,8173,676,7.6
17,133,Monroe,1993,12503,11866,637,5.1
17,135,Montgomery,1993,14555,13244,1311,9.0
17,137,Morgan,1993,18921,18004,917,4.8
17,139,Moultrie,1993,7933,7451,482,6.1
17,141,Ogle,1993,26178,24362,1816,6.9
17,143,Peoria,1993,92541,86791,5750,6.2
17,145,Perry,1993,8299,7017,1282,15.4
17,147,Piatt,1993,8656,8090,566,6.5
17,149,Pike,1993,8903,8266,637,7.2
17,151,Pope,1993,1689,1482,207,12.3
17,153,Pulaski,1993,2979,2594,385,12.9
17,155,Putnam,1993,3096,2864,232,7.5
17,157,Randolph,1993,15151,13642,1509,10.0
17,159,Richland,1993,9908,9465,443,4.5
17,161,Rock Island,1993,75248,70373,4875,6.5
17,163,St. Clair,1993,117585,109023,8562,7.3
17,165,Saline,1993,11256,9632,1624,14.4
17,167,Sangamon,1993,102609,97876,4733,4.6
17,169,Schuyler,1993,3700,3462,238,6.4
17,171,Scott,1993,2848,2662,186,6.5
17,173,Shelby,1993,11006,10283,723,6.6
17,175,Stark,1993,2850,2647,203,7.1
17,177,Stephenson,1993,26347,24738,1609,6.1
17,179,Tazewell,1993,66274,62203,4071,6.1
17,181,Union,1993,8557,7372,1185,13.8
17,183,Vermilion,1993,41960,37870,4090,9.7
17,185,Wabash,1993,6165,5614,551,8.9
17,187,Warren,1993,10120,9487,633,6.3
17,189,Washington,1993,7921,7433,488,6.2
17,191,Wayne,1993,8231,7547,684,8.3
17,193,White,1993,7570,6836,734,9.7
17,195,Whiteside,1993,31143,29284,1859,6.0
17,197,Will,1993,201440,185652,15788,7.8
17,199,Williamson,1993,27583,24475,3108,11.3
17,201,Winnebago,1993,144120,133112,11008,7.6
17,203,Woodford,1993,17373,16725,648,3.7
18,1,Adams,1993,15554,14809,745,4.8
18,3,Allen,1993,167842,159634,8208,4.9
18,5,Bartholomew,1993,36845,35453,1392,3.8
18,7,Benton,1993,5102,4849,253,5.0
18,9,Blackford,1993,6122,5523,599,9.8
18,11,Boone,1993,21727,21089,638,2.9
18,13,Brown,1993,7988,7774,214,2.7
18,15,Carroll,1993,11030,10568,462,4.2
18,17,Cass,1993,18900,17583,1317,7.0
18,19,Clark,1993,47913,45583,2330,4.9
18,21,Clay,1993,12271,11592,679,5.5
18,23,Clinton,1993,15208,14570,638,4.2
18,25,Crawford,1993,4716,4219,497,10.5
18,27,Daviess,1993,13129,12496,633,4.8
18,29,Dearborn,1993,20633,19251,1382,6.7
18,31,Decatur,1993,14066,13559,507,3.6
18,33,DeKalb,1993,20095,19150,945,4.7
18,35,Delaware,1993,62611,58865,3746,6.0
18,37,Dubois,1993,21407,20772,635,3.0
18,39,Elkhart,1993,88486,85294,3192,3.6
18,41,Fayette,1993,12763,11653,1110,8.7
18,43,Floyd,1993,34931,33559,1372,3.9
18,45,Fountain,1993,8607,7973,634,7.4
18,47,Franklin,1993,10011,9346,665,6.6
18,49,Fulton,1993,9905,9365,540,5.5
18,51,Gibson,1993,16494,15319,1175,7.1
18,53,Grant,1993,35860,33182,2678,7.5
18,55,Greene,1993,15270,13995,1275,8.3
18,57,Hamilton,1993,71062,69517,1545,2.2
18,59,Hancock,1993,25911,25039,872,3.4
18,61,Harrison,1993,15939,15271,668,4.2
18,63,Hendricks,1993,43929,42894,1035,2.4
18,65,Henry,1993,24287,22441,1846,7.6
18,67,Howard,1993,42434,40020,2414,5.7
18,69,Huntington,1993,19448,18547,901,4.6
18,71,Jackson,1993,20193,19150,1043,5.2
18,73,Jasper,1993,13024,12178,846,6.5
18,75,Jay,1993,11158,10328,830,7.4
18,77,Jefferson,1993,14620,13832,788,5.4
18,79,Jennings,1993,12847,12308,539,4.2
18,81,Johnson,1993,52773,51134,1639,3.1
18,83,Knox,1993,19773,18908,865,4.4
18,85,Kosciusko,1993,35544,34004,1540,4.3
18,87,LaGrange,1993,15069,14429,640,4.2
18,89,Lake,1993,226828,210296,16532,7.3
18,91,LaPorte,1993,53892,50736,3156,5.9
18,93,Lawrence,1993,22755,21048,1707,7.5
18,95,Madison,1993,64770,61011,3759,5.8
18,97,Marion,1993,438772,419550,19222,4.4
18,99,Marshall,1993,24429,23381,1048,4.3
18,101,Martin,1993,5097,4806,291,5.7
18,103,Miami,1993,16154,15171,983,6.1
18,105,Monroe,1993,57845,55679,2166,3.7
18,107,Montgomery,1993,19561,18961,600,3.1
18,109,Morgan,1993,31112,29808,1304,4.2
18,111,Newton,1993,6767,6401,366,5.4
18,113,Noble,1993,22012,21002,1010,4.6
18,115,Ohio,1993,2607,2465,142,5.4
18,117,Orange,1993,9196,8360,836,9.1
18,119,Owen,1993,9803,9258,545,5.6
18,121,Parke,1993,7640,7159,481,6.3
18,123,Perry,1993,9193,8448,745,8.1
18,125,Pike,1993,6071,5714,357,5.9
18,127,Porter,1993,70126,66605,3521,5.0
18,129,Posey,1993,13366,12840,526,3.9
18,131,Pulaski,1993,6022,5625,397,6.6
18,133,Putnam,1993,15781,15204,577,3.7
18,135,Randolph,1993,12041,10816,1225,10.2
18,137,Ripley,1993,12813,12026,787,6.1
18,139,Rush,1993,9473,8941,532,5.6
18,141,St. Joseph,1993,128404,121900,6504,5.1
18,143,Scott,1993,10042,9450,592,5.9
18,145,Shelby,1993,22113,21068,1045,4.7
18,147,Spencer,1993,10370,9706,664,6.4
18,149,Starke,1993,10670,9948,722,6.8
18,151,Steuben,1993,16099,15387,712,4.4
18,153,Sullivan,1993,9747,8918,829,8.5
18,155,Switzerland,1993,3964,3745,219,5.5
18,157,Tippecanoe,1993,68562,66483,2079,3.0
18,159,Tipton,1993,8732,8325,407,4.7
18,161,Union,1993,3685,3462,223,6.1
18,163,Vanderburgh,1993,88647,83945,4702,5.3
18,165,Vermillion,1993,8042,7391,651,8.1
18,167,Vigo,1993,53063,49679,3384,6.4
18,169,Wabash,1993,17920,16984,936,5.2
18,171,Warren,1993,3875,3669,206,5.3
18,173,Warrick,1993,25836,24584,1252,4.8
18,175,Washington,1993,11187,10406,781,7.0
18,177,Wayne,1993,37295,33989,3306,8.9
18,179,Wells,1993,13970,13414,556,4.0
18,181,White,1993,14495,13711,784,5.4
18,183,Whitley,1993,15315,14691,624,4.1
19,1,Adair,1993,4134,3994,140,3.4
19,3,Adams,1993,2360,2279,81,3.4
19,5,Allamakee,1993,7465,7104,361,4.8
19,7,Appanoose,1993,6778,6414,364,5.4
19,9,Audubon,1993,3641,3553,88,2.4
19,11,Benton,1993,11639,11168,471,4.0
19,13,Black Hawk,1993,69039,65174,3865,5.6
19,15,Boone,1993,13419,12924,495,3.7
19,17,Bremer,1993,12630,12118,512,4.1
19,19,Buchanan,1993,10358,9767,591,5.7
19,21,Buena Vista,1993,11056,10751,305,2.8
19,23,Butler,1993,7912,7468,444,5.6
19,25,Calhoun,1993,5252,5062,190,3.6
19,27,Carroll,1993,12089,11706,383,3.2
19,29,Cass,1993,7772,7374,398,5.1
19,31,Cedar,1993,9640,9323,317,3.3
19,33,Cerro Gordo,1993,25917,24547,1370,5.3
19,35,Cherokee,1993,7026,6824,202,2.9
19,37,Chickasaw,1993,7461,7003,458,6.1
19,39,Clarke,1993,4082,3735,347,8.5
19,41,Clay,1993,9379,9106,273,2.9
19,43,Clayton,1993,9650,9099,551,5.7
19,45,Clinton,1993,27325,25950,1375,5.0
19,47,Crawford,1993,8856,8462,394,4.4
19,49,Dallas,1993,17778,17240,538,3.0
19,51,Davis,1993,4272,4080,192,4.5
19,53,Decatur,1993,3943,3641,302,7.7
19,55,Delaware,1993,9062,8546,516,5.7
19,57,Des Moines,1993,23658,22350,1308,5.5
19,59,Dickinson,1993,9470,9146,324,3.4
19,61,Dubuque,1993,49765,47658,2107,4.2
19,63,Emmet,1993,5740,5481,259,4.5
19,65,Fayette,1993,10762,10239,523,4.9
19,67,Floyd,1993,8696,8072,624,7.2
19,69,Franklin,1993,5855,5639,216,3.7
19,71,Fremont,1993,3923,3724,199,5.1
19,73,Greene,1993,5277,5062,215,4.1
19,75,Grundy,1993,6091,5897,194,3.2
19,77,Guthrie,1993,5869,5627,242,4.1
19,79,Hamilton,1993,8497,8187,310,3.6
19,81,Hancock,1993,5887,5653,234,4.0
19,83,Hardin,1993,9558,9166,392,4.1
19,85,Harrison,1993,7591,7222,369,4.9
19,87,Henry,1993,10795,10407,388,3.6
19,89,Howard,1993,4871,4682,189,3.9
19,91,Humboldt,1993,5238,5059,179,3.4
19,93,Ida,1993,4065,3962,103,2.5
19,95,Iowa,1993,9364,9140,224,2.4
19,97,Jackson,1993,10892,10330,562,5.2
19,99,Jasper,1993,18108,17415,693,3.8
19,101,Jefferson,1993,9540,9119,421,4.4
19,103,Johnson,1993,63636,61880,1756,2.8
19,105,Jones,1993,9418,8954,464,4.9
19,107,Keokuk,1993,5143,4879,264,5.1
19,109,Kossuth,1993,8787,8454,333,3.8
19,111,Lee,1993,19625,18166,1459,7.4
19,113,Linn,1993,104449,100793,3656,3.5
19,115,Louisa,1993,6539,6205,334,5.1
19,117,Lucas,1993,4396,4112,284,6.5
19,119,Lyon,1993,5909,5741,168,2.8
19,121,Madison,1993,7021,6701,320,4.6
19,123,Mahaska,1993,11094,10652,442,4.0
19,125,Marion,1993,17079,16465,614,3.6
19,127,Marshall,1993,20716,19856,860,4.2
19,129,Mills,1993,6526,6299,227,3.5
19,131,Mitchell,1993,5484,5272,212,3.9
19,133,Monona,1993,5154,4946,208,4.0
19,135,Monroe,1993,4094,3884,210,5.1
19,137,Montgomery,1993,6131,5874,257,4.2
19,139,Muscatine,1993,21818,20909,909,4.2
19,141,O'Brien,1993,7912,7705,207,2.6
19,143,Osceola,1993,3632,3519,113,3.1
19,145,Page,1993,8951,8597,354,4.0
19,147,Palo Alto,1993,5288,5105,183,3.5
19,149,Plymouth,1993,12876,12512,364,2.8
19,151,Pocahontas,1993,4241,4120,121,2.9
19,153,Polk,1993,208136,200683,7453,3.6
19,155,Pottawattamie,1993,46622,44665,1957,4.2
19,157,Poweshiek,1993,10340,9828,512,5.0
19,159,Ringgold,1993,2676,2576,100,3.7
19,161,Sac,1993,6024,5823,201,3.3
19,163,Scott,1993,85266,81134,4132,4.8
19,165,Shelby,1993,6812,6502,310,4.6
19,167,Sioux,1993,16825,16379,446,2.7
19,169,Story,1993,44778,43371,1407,3.1
19,171,Tama,1993,9085,8668,417,4.6
19,173,Taylor,1993,3223,3088,135,4.2
19,175,Union,1993,6452,6149,303,4.7
19,177,Van Buren,1993,4021,3845,176,4.4
19,179,Wapello,1993,18502,17421,1081,5.8
19,181,Warren,1993,22477,21766,711,3.2
19,183,Washington,1993,11126,10751,375,3.4
19,185,Wayne,1993,3286,3106,180,5.5
19,187,Webster,1993,20224,19216,1008,5.0
19,189,Winnebago,1993,6680,6459,221,3.3
19,191,Winneshiek,1993,11887,11224,663,5.6
19,193,Woodbury,1993,54905,53156,1749,3.2
19,195,Worth,1993,4080,3891,189,4.6
19,197,Wright,1993,7004,6716,288,4.1
20,1,Allen,1993,6781,6399,382,5.6
20,3,Anderson,1993,3915,3615,300,7.7
20,5,Atchison,1993,8310,7673,637,7.7
20,7,Barber,1993,2815,2727,88,3.1
20,9,Barton,1993,15299,14580,719,4.7
20,11,Bourbon,1993,6812,6311,501,7.4
20,13,Brown,1993,4859,4575,284,5.8
20,15,Butler,1993,28668,27035,1633,5.7
20,17,Chase,1993,1423,1350,73,5.1
20,19,Chautauqua,1993,1760,1667,93,5.3
20,21,Cherokee,1993,9735,8984,751,7.7
20,23,Cheyenne,1993,1514,1481,33,2.2
20,25,Clark,1993,1285,1257,28,2.2
20,27,Clay,1993,4635,4475,160,3.5
20,29,Cloud,1993,5402,5243,159,2.9
20,31,Coffey,1993,4414,4178,236,5.3
20,33,Comanche,1993,1073,1053,20,1.9
20,35,Cowley,1993,18554,17543,1011,5.4
20,37,Crawford,1993,17104,16038,1066,6.2
20,39,Decatur,1993,1920,1868,52,2.7
20,41,Dickinson,1993,9822,9387,435,4.4
20,43,Doniphan,1993,3975,3670,305,7.7
20,45,Douglas,1993,48699,46338,2361,4.8
20,47,Edwards,1993,1831,1770,61,3.3
20,49,Elk,1993,1447,1358,89,6.2
20,51,Ellis,1993,15353,14772,581,3.8
20,53,Ellsworth,1993,2900,2791,109,3.8
20,55,Finney,1993,18738,18007,731,3.9
20,57,Ford,1993,14501,14023,478,3.3
20,59,Franklin,1993,12057,11320,737,6.1
20,61,Geary,1993,11341,10473,868,7.7
20,63,Gove,1993,1511,1480,31,2.1
20,65,Graham,1993,1698,1652,46,2.7
20,67,Grant,1993,3859,3743,116,3.0
20,69,Gray,1993,2619,2555,64,2.4
20,71,Greeley,1993,846,815,31,3.7
20,73,Greenwood,1993,3518,3299,219,6.2
20,75,Hamilton,1993,1229,1197,32,2.6
20,77,Harper,1993,3085,2962,123,4.0
20,79,Harvey,1993,16528,15905,623,3.8
20,81,Haskell,1993,1995,1940,55,2.8
20,83,Hodgeman,1993,993,974,19,1.9
20,85,Jackson,1993,6184,5791,393,6.4
20,87,Jefferson,1993,9107,8631,476,5.2
20,89,Jewell,1993,2120,2081,39,1.8
20,91,Johnson,1993,228092,220709,7383,3.2
20,93,Kearny,1993,2090,2019,71,3.4
20,95,Kingman,1993,4034,3797,237,5.9
20,97,Kiowa,1993,1698,1655,43,2.5
20,99,Labette,1993,10997,10132,865,7.9
20,101,Lane,1993,1104,1087,17,1.5
20,103,Leavenworth,1993,27015,25491,1524,5.6
20,105,Lincoln,1993,1854,1782,72,3.9
20,107,Linn,1993,3345,2998,347,10.4
20,109,Logan,1993,1585,1534,51,3.2
20,111,Lyon,1993,19140,18259,881,4.6
20,113,McPherson,1993,15211,14764,447,2.9
20,115,Marion,1993,6581,6380,201,3.1
20,117,Marshall,1993,5633,5489,144,2.6
20,119,Meade,1993,2087,2041,46,2.2
20,121,Miami,1993,12581,11907,674,5.4
20,123,Mitchell,1993,3592,3483,109,3.0
20,125,Montgomery,1993,17881,16789,1092,6.1
20,127,Morris,1993,3103,2964,139,4.5
20,129,Morton,1993,1669,1616,53,3.2
20,131,Nemaha,1993,5423,5282,141,2.6
20,133,Neosho,1993,8681,8228,453,5.2
20,135,Ness,1993,1954,1908,46,2.4
20,137,Norton,1993,2869,2822,47,1.6
20,139,Osage,1993,7785,7257,528,6.8
20,141,Osborne,1993,2549,2474,75,2.9
20,143,Ottawa,1993,2793,2701,92,3.3
20,145,Pawnee,1993,3897,3768,129,3.3
20,147,Phillips,1993,3207,3126,81,2.5
20,149,Pottawatomie,1993,9067,8703,364,4.0
20,151,Pratt,1993,5033,4849,184,3.7
20,153,Rawlins,1993,1646,1620,26,1.6
20,155,Reno,1993,31808,30322,1486,4.7
20,157,Republic,1993,3341,3275,66,2.0
20,159,Rice,1993,4996,4752,244,4.9
20,161,Riley,1993,28901,27672,1229,4.3
20,163,Rooks,1993,2857,2750,107,3.7
20,165,Rush,1993,1849,1799,50,2.7
20,167,Russell,1993,3836,3678,158,4.1
20,169,Saline,1993,28709,27540,1169,4.1
20,171,Scott,1993,2696,2617,79,2.9
20,173,Sedgwick,1993,226992,213708,13284,5.9
20,175,Seward,1993,9888,9446,442,4.5
20,177,Shawnee,1993,89481,85135,4346,4.9
20,179,Sheridan,1993,1465,1428,37,2.5
20,181,Sherman,1993,3866,3728,138,3.6
20,183,Smith,1993,2451,2393,58,2.4
20,185,Stafford,1993,2447,2353,94,3.8
20,187,Stanton,1993,1051,1023,28,2.7
20,189,Stevens,1993,2447,2377,70,2.9
20,191,Sumner,1993,12840,11940,900,7.0
20,193,Thomas,1993,4404,4264,140,3.2
20,195,Trego,1993,1852,1810,42,2.3
20,197,Wabaunsee,1993,3405,3236,169,5.0
20,199,Wallace,1993,827,809,18,2.2
20,201,Washington,1993,3600,3474,126,3.5
20,203,Wichita,1993,1292,1256,36,2.8
20,205,Wilson,1993,4784,4517,267,5.6
20,207,Woodson,1993,1926,1818,108,5.6
20,209,Wyandotte,1993,77989,70964,7025,9.0
21,1,Adair,1993,7853,7356,497,6.3
21,3,Allen,1993,7989,7617,372,4.7
21,5,Anderson,1993,8605,8243,362,4.2
21,7,Ballard,1993,3840,3506,334,8.7
21,9,Barren,1993,17124,16208,916,5.3
21,11,Bath,1993,4505,3969,536,11.9
21,13,Bell,1993,10358,9263,1095,10.6
21,15,Boone,1993,34976,33147,1829,5.2
21,17,Bourbon,1993,9571,9109,462,4.8
21,19,Boyd,1993,23104,20507,2597,11.2
21,21,Boyle,1993,13102,12441,661,5.0
21,23,Bracken,1993,3678,3353,325,8.8
21,25,Breathitt,1993,5073,4575,498,9.8
21,27,Breckinridge,1993,7421,6926,495,6.7
21,29,Bullitt,1993,27560,26609,951,3.5
21,31,Butler,1993,5353,4999,354,6.6
21,33,Caldwell,1993,6695,6166,529,7.9
21,35,Calloway,1993,16168,15275,893,5.5
21,37,Campbell,1993,43233,40897,2336,5.4
21,39,Carlisle,1993,2583,2407,176,6.8
21,41,Carroll,1993,4661,4394,267,5.7
21,43,Carter,1993,11043,9271,1772,16.0
21,45,Casey,1993,6834,6307,527,7.7
21,47,Christian,1993,22816,21567,1249,5.5
21,49,Clark,1993,14835,14054,781,5.3
21,51,Clay,1993,7064,6397,667,9.4
21,53,Clinton,1993,4479,4126,353,7.9
21,55,Crittenden,1993,4103,3810,293,7.1
21,57,Cumberland,1993,2938,2700,238,8.1
21,59,Daviess,1993,45976,43110,2866,6.2
21,61,Edmonson,1993,4509,4019,490,10.9
21,63,Elliott,1993,2401,2041,360,15.0
21,65,Estill,1993,5803,5312,491,8.5
21,67,Fayette,1993,131693,127214,4479,3.4
21,69,Fleming,1993,6488,5993,495,7.6
21,71,Floyd,1993,14698,13271,1427,9.7
21,73,Franklin,1993,23981,23194,787,3.3
21,75,Fulton,1993,3714,3471,243,6.5
21,77,Gallatin,1993,2810,2643,167,5.9
21,79,Garrard,1993,6189,5821,368,5.9
21,81,Grant,1993,8282,7728,554,6.7
21,83,Graves,1993,15945,14765,1180,7.4
21,85,Grayson,1993,10158,9314,844,8.3
21,87,Green,1993,5275,5034,241,4.6
21,89,Greenup,1993,16504,14710,1794,10.9
21,91,Hancock,1993,3467,3142,325,9.4
21,93,Hardin,1993,34928,32571,2357,6.7
21,95,Harlan,1993,10254,9014,1240,12.1
21,97,Harrison,1993,7566,7089,477,6.3
21,99,Hart,1993,7288,6848,440,6.0
21,101,Henderson,1993,22830,21584,1246,5.5
21,103,Henry,1993,7477,7177,300,4.0
21,105,Hickman,1993,2511,2363,148,5.9
21,107,Hopkins,1993,20703,19034,1669,8.1
21,109,Jackson,1993,4385,3980,405,9.2
21,111,Jefferson,1993,352126,334670,17456,5.0
21,113,Jessamine,1993,17716,17084,632,3.6
21,115,Johnson,1993,9800,9083,717,7.3
21,117,Kenton,1993,75188,71433,3755,5.0
21,119,Knott,1993,5896,5212,684,11.6
21,121,Knox,1993,10394,9487,907,8.7
21,123,Larue,1993,5601,5349,252,4.5
21,125,Laurel,1993,20038,18605,1433,7.2
21,127,Lawrence,1993,4801,4239,562,11.7
21,129,Lee,1993,2410,2154,256,10.6
21,131,Leslie,1993,4430,4047,383,8.6
21,133,Letcher,1993,8288,7118,1170,14.1
21,135,Lewis,1993,5748,4921,827,14.4
21,137,Lincoln,1993,9702,9108,594,6.1
21,139,Livingston,1993,4604,4238,366,7.9
21,141,Logan,1993,12887,12249,638,5.0
21,143,Lyon,1993,2949,2759,190,6.4
21,145,McCracken,1993,31791,30356,1435,4.5
21,147,McCreary,1993,6061,5404,657,10.8
21,149,McLean,1993,4410,3828,582,13.2
21,151,Madison,1993,31183,29838,1345,4.3
21,153,Magoffin,1993,4332,3667,665,15.4
21,155,Marion,1993,8409,7729,680,8.1
21,157,Marshall,1993,13283,12248,1035,7.8
21,159,Martin,1993,3589,3198,391,10.9
21,161,Mason,1993,8540,7825,715,8.4
21,163,Meade,1993,9281,8746,535,5.8
21,165,Menifee,1993,2219,1901,318,14.3
21,167,Mercer,1993,10378,9739,639,6.2
21,169,Metcalfe,1993,4560,4310,250,5.5
21,171,Monroe,1993,5230,5010,220,4.2
21,173,Montgomery,1993,9698,8682,1016,10.5
21,175,Morgan,1993,4454,3947,507,11.4
21,177,Muhlenberg,1993,11697,10416,1281,11.0
21,179,Nelson,1993,15777,14774,1003,6.4
21,181,Nicholas,1993,3581,3278,303,8.5
21,183,Ohio,1993,9135,8207,928,10.2
21,185,Oldham,1993,19507,19048,459,2.4
21,187,Owen,1993,4600,4409,191,4.2
21,189,Owsley,1993,1477,1399,78,5.3
21,191,Pendleton,1993,5939,5601,338,5.7
21,193,Perry,1993,11454,10322,1132,9.9
21,195,Pike,1993,27008,23843,3165,11.7
21,197,Powell,1993,6033,5468,565,9.4
21,199,Pulaski,1993,23463,21618,1845,7.9
21,201,Robertson,1993,947,886,61,6.4
21,203,Rockcastle,1993,5647,5170,477,8.4
21,205,Rowan,1993,9108,8479,629,6.9
21,207,Russell,1993,6765,6111,654,9.7
21,209,Scott,1993,13824,13322,502,3.6
21,211,Shelby,1993,14854,14442,412,2.8
21,213,Simpson,1993,8158,7567,591,7.2
21,215,Spencer,1993,4106,3970,136,3.3
21,217,Taylor,1993,11445,11009,436,3.8
21,219,Todd,1993,5323,5099,224,4.2
21,221,Trigg,1993,5503,5170,333,6.1
21,223,Trimble,1993,2930,2796,134,4.6
21,225,Union,1993,6948,6336,612,8.8
21,227,Warren,1993,44403,42296,2107,4.7
21,229,Washington,1993,5667,5466,201,3.5
21,231,Wayne,1993,7663,7093,570,7.4
21,233,Webster,1993,5837,5325,512,8.8
21,235,Whitley,1993,13316,12268,1048,7.9
21,237,Wolfe,1993,3071,2736,335,10.9
21,239,Woodford,1993,11732,11346,386,3.3
22,1,Acadia Parish,1993,21747,20084,1663,7.6
22,3,Allen Parish,1993,8409,7552,857,10.2
22,5,Ascension Parish,1993,28304,26300,2004,7.1
22,7,Assumption Parish,1993,9129,8231,898,9.8
22,9,Avoyelles Parish,1993,14588,13118,1470,10.1
22,11,Beauregard Parish,1993,12566,11581,985,7.8
22,13,Bienville Parish,1993,6232,5811,421,6.8
22,15,Bossier Parish,1993,40913,38485,2428,5.9
22,17,Caddo Parish,1993,112628,105918,6710,6.0
22,19,Calcasieu Parish,1993,79785,74231,5554,7.0
22,21,Caldwell Parish,1993,4301,3957,344,8.0
22,23,Cameron Parish,1993,3639,3410,229,6.3
22,25,Catahoula Parish,1993,5002,4579,423,8.5
22,27,Claiborne Parish,1993,5734,5375,359,6.3
22,29,Concordia Parish,1993,8384,7489,895,10.7
22,31,De Soto Parish,1993,10120,9217,903,8.9
22,33,East Baton Rouge Parish,1993,198036,187995,10041,5.1
22,35,East Carroll Parish,1993,3456,2968,488,14.1
22,37,East Feliciana Parish,1993,7672,7148,524,6.8
22,39,Evangeline Parish,1993,12070,11177,893,7.4
22,41,Franklin Parish,1993,10197,9301,896,8.8
22,43,Grant Parish,1993,6912,6413,499,7.2
22,45,Iberia Parish,1993,29339,27227,2112,7.2
22,47,Iberville Parish,1993,13141,11856,1285,9.8
22,49,Jackson Parish,1993,6236,5921,315,5.1
22,51,Jefferson Parish,1993,232414,213861,18553,8.0
22,53,Jefferson Davis Parish,1993,11708,10729,979,8.4
22,55,Lafayette Parish,1993,85061,81033,4028,4.7
22,57,Lafourche Parish,1993,36516,34363,2153,5.9
22,59,LaSalle Parish,1993,6075,5625,450,7.4
22,61,Lincoln Parish,1993,18366,17890,476,2.6
22,63,Livingston Parish,1993,35326,32437,2889,8.2
22,65,Madison Parish,1993,4986,4378,608,12.2
22,67,Morehouse Parish,1993,12943,11775,1168,9.0
22,69,Natchitoches Parish,1993,16001,14912,1089,6.8
22,71,Orleans Parish,1993,204841,184842,19999,9.8
22,73,Ouachita Parish,1993,65506,61834,3672,5.6
22,75,Plaquemines Parish,1993,10280,9276,1004,9.8
22,77,Pointe Coupee Parish,1993,9753,8873,880,9.0
22,79,Rapides Parish,1993,56127,52868,3259,5.8
22,81,Red River Parish,1993,3748,3423,325,8.7
22,83,Richland Parish,1993,8426,7620,806,9.6
22,85,Sabine Parish,1993,9039,8474,565,6.3
22,87,St. Bernard Parish,1993,31351,28293,3058,9.8
22,89,St. Charles Parish,1993,21397,19094,2303,10.8
22,91,St. Helena Parish,1993,3903,3628,275,7.0
22,93,St. James Parish,1993,8787,7813,974,11.1
22,95,St. John the Baptist Parish,1993,19275,16747,2528,13.1
22,97,St. Landry Parish,1993,29762,27070,2692,9.0
22,99,St. Martin Parish,1993,18990,17748,1242,6.5
22,101,St. Mary Parish,1993,23753,21639,2114,8.9
22,103,St. Tammany Parish,1993,76094,69769,6325,8.3
22,105,Tangipahoa Parish,1993,38765,35148,3617,9.3
22,107,Tensas Parish,1993,3074,2828,246,8.0
22,109,Terrebonne Parish,1993,40877,38461,2416,5.9
22,111,Union Parish,1993,10633,10054,579,5.4
22,113,Vermilion Parish,1993,21303,19764,1539,7.2
22,115,Vernon Parish,1993,17044,15833,1211,7.1
22,117,Washington Parish,1993,16245,14872,1373,8.5
22,119,Webster Parish,1993,17730,16118,1612,9.1
22,121,West Baton Rouge Parish,1993,9357,8664,693,7.4
22,123,West Carroll Parish,1993,5378,4639,739,13.7
22,125,West Feliciana Parish,1993,3652,3385,267,7.3
22,127,Winn Parish,1993,6239,5995,244,3.9
23,1,Androscoggin,1993,56286,52122,4164,7.4
23,3,Aroostook,1993,39487,35482,4005,10.1
23,5,Cumberland,1993,129262,122674,6588,5.1
23,7,Franklin,1993,14935,13911,1024,6.9
23,9,Hancock,1993,25442,23605,1837,7.2
23,11,Kennebec,1993,59435,55449,3986,6.7
23,13,Knox,1993,18719,17739,980,5.2
23,15,Lincoln,1993,16289,15360,929,5.7
23,17,Oxford,1993,25511,23353,2158,8.5
23,19,Penobscot,1993,73917,69061,4856,6.6
23,21,Piscataquis,1993,8462,7740,722,8.5
23,23,Sagadahoc,1993,15831,15046,785,5.0
23,25,Somerset,1993,25396,23028,2368,9.3
23,27,Waldo,1993,17053,15651,1402,8.2
23,29,Washington,1993,16335,14497,1838,11.3
23,31,York,1993,87775,82546,5229,6.0
24,1,Allegany,1993,32704,29035,3669,11.2
24,3,Anne Arundel,1993,240180,227547,12633,5.3
24,5,Baltimore,1993,387665,362560,25105,6.5
24,9,Calvert,1993,31386,29964,1422,4.5
24,11,Caroline,1993,15126,13984,1142,7.5
24,13,Carroll,1993,72416,68704,3712,5.1
24,15,Cecil,1993,37079,34016,3063,8.3
24,17,Charles,1993,56207,53753,2454,4.4
24,19,Dorchester,1993,15591,14023,1568,10.1
24,21,Frederick,1993,89824,85804,4020,4.5
24,23,Garrett,1993,13886,12167,1719,12.4
24,25,Harford,1993,104292,97918,6374,6.1
24,27,Howard,1993,122255,117693,4562,3.7
24,29,Kent,1993,9769,9094,675,6.9
24,31,Montgomery,1993,449439,434310,15129,3.4
24,33,Prince George's,1993,431688,409261,22427,5.2
24,35,Queen Anne's,1993,18818,17796,1022,5.4
24,37,St. Mary's,1993,40677,38422,2255,5.5
24,39,Somerset,1993,11419,10091,1328,11.6
24,41,Talbot,1993,17202,16514,688,4.0
24,43,Washington,1993,65368,59947,5421,8.3
24,45,Wicomico,1993,46427,43328,3099,6.7
24,47,Worcester,1993,23089,20626,2463,10.7
24,510,Baltimore city,1993,329126,295937,33189,10.1
25,1,Barnstable,1993,100428,90964,9464,9.4
25,3,Berkshire,1993,68253,62442,5811,8.5
25,5,Bristol,1993,267098,239401,27697,10.4
25,7,Dukes,1993,7798,7218,580,7.4
25,9,Essex,1993,349776,323438,26338,7.5
25,11,Franklin,1993,36705,34366,2339,6.4
25,13,Hampden,1993,218328,199000,19328,8.9
25,15,Hampshire,1993,78910,74547,4363,5.5
25,17,Middlesex,1993,784567,737162,47405,6.0
25,19,Nantucket/town,1993,5327,5121,206,3.9
25,21,Norfolk,1993,343436,323041,20395,5.9
25,23,Plymouth,1993,230864,212217,18647,8.1
25,25,Suffolk,1993,331785,308178,23607,7.1
25,27,Worcester,1993,364361,338346,26015,7.1
26,1,Alcona,1993,4459,3841,618,13.9
26,3,Alger,1993,4012,3606,406,10.1
26,5,Allegan,1993,48065,45317,2748,5.7
26,7,Alpena,1993,14914,12991,1923,12.9
26,9,Antrim,1993,9217,8251,966,10.5
26,11,Arenac,1993,6436,5756,680,10.6
26,13,Baraga,1993,3523,3110,413,11.7
26,15,Barry,1993,26481,24803,1678,6.3
26,17,Bay,1993,54163,50005,4158,7.7
26,19,Benzie,1993,6608,5923,685,10.4
26,21,Berrien,1993,81981,75621,6360,7.8
26,23,Branch,1993,19104,17566,1538,8.1
26,25,Calhoun,1993,65563,61292,4271,6.5
26,27,Cass,1993,24785,23320,1465,5.9
26,29,Charlevoix,1993,12360,10954,1406,11.4
26,31,Cheboygan,1993,10857,9584,1273,11.7
26,33,Chippewa,1993,16565,14719,1846,11.1
26,35,Clare,1993,10115,9031,1084,10.7
26,37,Clinton,1993,31778,30002,1776,5.6
26,39,Crawford,1993,5535,4964,571,10.3
26,41,Delta,1993,17829,15784,2045,11.5
26,43,Dickinson,1993,13169,12116,1053,8.0
26,45,Eaton,1993,51875,49066,2809,5.4
26,47,Emmet,1993,15243,13487,1756,11.5
26,49,Genesee,1993,198537,178046,20491,10.3
26,51,Gladwin,1993,8414,7472,942,11.2
26,53,Gogebic,1993,8161,7376,785,9.6
26,55,Grand Traverse,1993,39892,37381,2511,6.3
26,57,Gratiot,1993,19331,17766,1565,8.1
26,59,Hillsdale,1993,21603,20118,1485,6.9
26,61,Houghton,1993,15754,14400,1354,8.6
26,63,Huron,1993,16534,14829,1705,10.3
26,65,Ingham,1993,146679,138544,8135,5.5
26,67,Ionia,1993,26596,24222,2374,8.9
26,69,Iosco,1993,10768,9375,1393,12.9
26,71,Iron,1993,5538,4933,605,10.9
26,73,Isabella,1993,26129,24613,1516,5.8
26,75,Jackson,1993,73061,67158,5903,8.1
26,77,Kalamazoo,1993,121222,115642,5580,4.6
26,79,Kalkaska,1993,6947,6141,806,11.6
26,81,Kent,1993,280319,264239,16080,5.7
26,83,Keweenaw,1993,690,584,106,15.4
26,85,Lake,1993,3248,2803,445,13.7
26,87,Lapeer,1993,39384,35764,3620,9.2
26,89,Leelanau,1993,9944,9303,641,6.4
26,91,Lenawee,1993,44724,42091,2633,5.9
26,93,Livingston,1993,67835,64848,2987,4.4
26,95,Luce,1993,2373,2006,367,15.5
26,97,Mackinac,1993,6655,5829,826,12.4
26,99,Macomb,1993,404552,377105,27447,6.8
26,101,Manistee,1993,9906,8635,1271,12.8
26,103,Marquette,1993,33223,30723,2500,7.5
26,105,Mason,1993,13955,12454,1501,10.8
26,107,Mecosta,1993,17131,15884,1247,7.3
26,109,Menominee,1993,12728,11750,978,7.7
26,111,Midland,1993,39960,37083,2877,7.2
26,113,Missaukee,1993,5816,5305,511,8.8
26,115,Monroe,1993,66757,61391,5366,8.0
26,117,Montcalm,1993,24253,21804,2449,10.1
26,119,Montmorency,1993,3523,2954,569,16.2
26,121,Muskegon,1993,76074,69364,6710,8.8
26,123,Newaygo,1993,19593,17581,2012,10.3
26,125,Oakland,1993,626502,588614,37888,6.0
26,127,Oceana,1993,11972,10418,1554,13.0
26,129,Ogemaw,1993,7830,6984,846,10.8
26,131,Ontonagon,1993,3916,3569,347,8.9
26,133,Osceola,1993,10257,9272,985,9.6
26,135,Oscoda,1993,3394,3061,333,9.8
26,137,Otsego,1993,10966,10121,845,7.7
26,139,Ottawa,1993,112009,106629,5380,4.8
26,141,Presque Isle,1993,6367,5309,1058,16.6
26,143,Roscommon,1993,7787,6978,809,10.4
26,145,Saginaw,1993,97945,90621,7324,7.5
26,147,St. Clair,1993,74052,67727,6325,8.5
26,149,St. Joseph,1993,30682,28781,1901,6.2
26,151,Sanilac,1993,19879,17856,2023,10.2
26,153,Schoolcraft,1993,3939,3404,535,13.6
26,155,Shiawassee,1993,35235,31807,3428,9.7
26,157,Tuscola,1993,26561,24059,2502,9.4
26,159,Van Buren,1993,34913,32073,2840,8.1
26,161,Washtenaw,1993,161167,154390,6777,4.2
26,163,Wayne,1993,942084,863995,78089,8.3
26,165,Wexford,1993,13274,11818,1456,11.0
27,1,Aitkin,1993,5581,4928,653,11.7
27,3,Anoka,1993,156491,149348,7143,4.6
27,5,Becker,1993,12858,11485,1373,10.7
27,7,Beltrami,1993,17090,15831,1259,7.4
27,9,Benton,1993,18548,17548,1000,5.4
27,11,Big Stone,1993,2849,2680,169,5.9
27,13,Blue Earth,1993,31088,30032,1056,3.4
27,15,Brown,1993,14542,13861,681,4.7
27,17,Carlton,1993,15026,13833,1193,7.9
27,19,Carver,1993,31647,30566,1081,3.4
27,21,Cass,1993,10420,9407,1013,9.7
27,23,Chippewa,1993,6468,6120,348,5.4
27,25,Chisago,1993,17235,16118,1117,6.5
27,27,Clay,1993,28236,27156,1080,3.8
27,29,Clearwater,1993,3972,3262,710,17.9
27,31,Cook,1993,2734,2585,149,5.4
27,33,Cottonwood,1993,6169,5813,356,5.8
27,35,Crow Wing,1993,24140,22304,1836,7.6
27,37,Dakota,1993,182765,176303,6462,3.5
27,39,Dodge,1993,8636,8101,535,6.2
27,41,Douglas,1993,15191,14341,850,5.6
27,43,Faribault,1993,8155,7636,519,6.4
27,45,Fillmore,1993,10244,9663,581,5.7
27,47,Freeborn,1993,17435,16496,939,5.4
27,49,Goodhue,1993,23509,22502,1007,4.3
27,51,Grant,1993,2998,2820,178,5.9
27,53,Hennepin,1993,626139,600868,25271,4.0
27,55,Houston,1993,10475,10005,470,4.5
27,57,Hubbard,1993,7222,6579,643,8.9
27,59,Isanti,1993,14133,13219,914,6.5
27,61,Itasca,1993,19666,17326,2340,11.9
27,63,Jackson,1993,5618,5347,271,4.8
27,65,Kanabec,1993,7074,6335,739,10.4
27,67,Kandiyohi,1993,19688,18811,877,4.5
27,69,Kittson,1993,2520,2347,173,6.9
27,71,Koochiching,1993,6600,5846,754,11.4
27,73,Lac qui Parle,1993,3939,3776,163,4.1
27,75,Lake,1993,5500,5077,423,7.7
27,77,Lake of the Woods,1993,2184,2093,91,4.2
27,79,Le Sueur,1993,12987,12245,742,5.7
27,81,Lincoln,1993,3170,3021,149,4.7
27,83,Lyon,1993,14733,14233,500,3.4
27,85,McLeod,1993,19522,18557,965,4.9
27,87,Mahnomen,1993,2782,2525,257,9.2
27,89,Marshall,1993,4841,4247,594,12.3
27,91,Martin,1993,11636,10783,853,7.3
27,93,Meeker,1993,9590,8833,757,7.9
27,95,Mille Lacs,1993,9917,9129,788,7.9
27,97,Morrison,1993,14793,13436,1357,9.2
27,99,Mower,1993,18513,17825,688,3.7
27,101,Murray,1993,4526,4273,253,5.6
27,103,Nicollet,1993,17264,16711,553,3.2
27,105,Nobles,1993,10267,9868,399,3.9
27,107,Norman,1993,3589,3350,239,6.7
27,109,Olmsted,1993,65394,63391,2003,3.1
27,111,Otter Tail,1993,25627,23806,1821,7.1
27,113,Pennington,1993,7193,6630,563,7.8
27,115,Pine,1993,11340,10284,1056,9.3
27,117,Pipestone,1993,4984,4723,261,5.2
27,119,Polk,1993,16366,15456,910,5.6
27,121,Pope,1993,5203,4904,299,5.7
27,123,Ramsey,1993,272111,261392,10719,3.9
27,125,Red Lake,1993,2069,1794,275,13.3
27,127,Redwood,1993,8448,8079,369,4.4
27,129,Renville,1993,9239,8661,578,6.3
27,131,Rice,1993,27891,26475,1416,5.1
27,133,Rock,1993,4764,4634,130,2.7
27,135,Roseau,1993,8205,7790,415,5.1
27,137,St. Louis,1993,98442,91230,7212,7.3
27,139,Scott,1993,37400,35817,1583,4.2
27,141,Sherburne,1993,25780,24349,1431,5.6
27,143,Sibley,1993,6806,6321,485,7.1
27,145,Stearns,1993,70288,66957,3331,4.7
27,147,Steele,1993,17505,16808,697,4.0
27,149,Stevens,1993,5255,5044,211,4.0
27,151,Swift,1993,5002,4736,266,5.3
27,153,Todd,1993,10537,9750,787,7.5
27,155,Traverse,1993,1787,1696,91,5.1
27,157,Wabasha,1993,11004,10514,490,4.5
27,159,Wadena,1993,5914,5545,369,6.2
27,161,Waseca,1993,8958,8459,499,5.6
27,163,Washington,1993,94061,90592,3469,3.7
27,165,Watonwan,1993,5885,5649,236,4.0
27,167,Wilkin,1993,3501,3366,135,3.9
27,169,Winona,1993,27824,26554,1270,4.6
27,171,Wright,1993,40545,38282,2263,5.6
27,173,Yellow Medicine,1993,5887,5597,290,4.9
28,1,Adams,1993,14902,13776,1126,7.6
28,3,Alcorn,1993,15569,14446,1123,7.2
28,5,Amite,1993,5183,4805,378,7.3
28,7,Attala,1993,7732,6870,862,11.1
28,9,Benton,1993,3105,2899,206,6.6
28,11,Bolivar,1993,18403,16548,1855,10.1
28,13,Calhoun,1993,7282,6934,348,4.8
28,15,Carroll,1993,4241,3989,252,5.9
28,17,Chickasaw,1993,8972,8225,747,8.3
28,19,Choctaw,1993,3394,3067,327,9.6
28,21,Claiborne,1993,3888,3440,448,11.5
28,23,Clarke,1993,8138,7672,466,5.7
28,25,Clay,1993,9366,8463,903,9.6
28,27,Coahoma,1993,11954,10597,1357,11.4
28,29,Copiah,1993,11187,10290,897,8.0
28,31,Covington,1993,7739,7203,536,6.9
28,33,DeSoto,1993,39604,37646,1958,4.9
28,35,Forrest,1993,31235,29387,1848,5.9
28,37,Franklin,1993,3280,3047,233,7.1
28,39,George,1993,7769,6785,984,12.7
28,41,Greene,1993,4447,3929,518,11.6
28,43,Grenada,1993,9988,9204,784,7.8
28,45,Hancock,1993,14969,14021,948,6.3
28,47,Harrison,1993,79454,75200,4254,5.4
28,49,Hinds,1993,126670,119640,7030,5.5
28,51,Holmes,1993,7114,6326,788,11.1
28,53,Humphreys,1993,5295,4716,579,10.9
28,55,Issaquena,1993,880,761,119,13.5
28,57,Itawamba,1993,10767,10254,513,4.8
28,59,Jackson,1993,62786,59063,3723,5.9
28,61,Jasper,1993,7277,6758,519,7.1
28,63,Jefferson,1993,2430,1998,432,17.8
28,65,Jefferson Davis,1993,4986,4461,525,10.5
28,67,Jones,1993,28897,27216,1681,5.8
28,69,Kemper,1993,4172,3822,350,8.4
28,71,Lafayette,1993,15121,14730,391,2.6
28,73,Lamar,1993,14687,14071,616,4.2
28,75,Lauderdale,1993,34594,32584,2010,5.8
28,77,Lawrence,1993,5272,4798,474,9.0
28,79,Leake,1993,8370,7765,605,7.2
28,81,Lee,1993,37569,35814,1755,4.7
28,83,Leflore,1993,15925,14327,1598,10.0
28,85,Lincoln,1993,12879,11693,1186,9.2
28,87,Lowndes,1993,26813,25154,1659,6.2
28,89,Madison,1993,29835,28452,1383,4.6
28,91,Marion,1993,10246,9214,1032,10.1
28,93,Marshall,1993,13770,12459,1311,9.5
28,95,Monroe,1993,16875,15724,1151,6.8
28,97,Montgomery,1993,5404,4993,411,7.6
28,99,Neshoba,1993,12940,12292,648,5.0
28,101,Newton,1993,8709,8178,531,6.1
28,103,Noxubee,1993,4493,4069,424,9.4
28,105,Oktibbeha,1993,18313,17663,650,3.5
28,107,Panola,1993,13212,11903,1309,9.9
28,109,Pearl River,1993,17782,16508,1274,7.2
28,111,Perry,1993,4457,4009,448,10.1
28,113,Pike,1993,15663,14342,1321,8.4
28,115,Pontotoc,1993,12347,11742,605,4.9
28,117,Prentiss,1993,11757,11156,601,5.1
28,119,Quitman,1993,3954,3481,473,12.0
28,121,Rankin,1993,49362,47655,1707,3.5
28,123,Scott,1993,13235,12662,573,4.3
28,125,Sharkey,1993,3251,2842,409,12.6
28,127,Simpson,1993,10883,10357,526,4.8
28,129,Smith,1993,6388,6088,300,4.7
28,131,Stone,1993,5058,4651,407,8.0
28,133,Sunflower,1993,12186,10736,1450,11.9
28,135,Tallahatchie,1993,5880,5238,642,10.9
28,137,Tate,1993,10425,9672,753,7.2
28,139,Tippah,1993,9547,8978,569,6.0
28,141,Tishomingo,1993,10521,9881,640,6.1
28,143,Tunica,1993,3442,3100,342,9.9
28,145,Union,1993,11816,11209,607,5.1
28,147,Walthall,1993,5722,5286,436,7.6
28,149,Warren,1993,23596,21677,1919,8.1
28,151,Washington,1993,27911,24858,3053,10.9
28,153,Wayne,1993,8813,7990,823,9.3
28,155,Webster,1993,4494,4239,255,5.7
28,157,Wilkinson,1993,3439,3050,389,11.3
28,159,Winston,1993,7920,6988,932,11.8
28,161,Yalobusha,1993,5057,4712,345,6.8
28,163,Yazoo,1993,9749,8919,830,8.5
29,1,Adair,1993,13746,13217,529,3.8
29,3,Andrew,1993,7522,7010,512,6.8
29,5,Atchison,1993,2849,2724,125,4.4
29,7,Audrain,1993,11891,11225,666,5.6
29,9,Barry,1993,13587,12642,945,7.0
29,11,Barton,1993,6263,6014,249,4.0
29,13,Bates,1993,7340,6764,576,7.8
29,15,Benton,1993,5633,5055,578,10.3
29,17,Bollinger,1993,4798,4364,434,9.0
29,19,Boone,1993,72110,69905,2205,3.1
29,21,Buchanan,1993,41000,37337,3663,8.9
29,23,Butler,1993,18183,16577,1606,8.8
29,25,Caldwell,1993,3645,3339,306,8.4
29,27,Callaway,1993,18206,17206,1000,5.5
29,29,Camden,1993,14286,12894,1392,9.7
29,31,Cape Girardeau,1993,33790,31798,1992,5.9
29,33,Carroll,1993,5073,4614,459,9.0
29,35,Carter,1993,2443,2150,293,12.0
29,37,Cass,1993,36705,34944,1761,4.8
29,39,Cedar,1993,5225,4909,316,6.0
29,41,Chariton,1993,4036,3662,374,9.3
29,43,Christian,1993,20762,19587,1175,5.7
29,45,Clark,1993,3414,3211,203,5.9
29,47,Clay,1993,92090,88397,3693,4.0
29,49,Clinton,1993,8405,7985,420,5.0
29,51,Cole,1993,35356,33807,1549,4.4
29,53,Cooper,1993,8138,7589,549,6.7
29,55,Crawford,1993,9917,8855,1062,10.7
29,57,Dade,1993,3055,2842,213,7.0
29,59,Dallas,1993,5932,5381,551,9.3
29,61,Daviess,1993,3307,3022,285,8.6
29,63,DeKalb,1993,3843,3581,262,6.8
29,65,Dent,1993,6184,5632,552,8.9
29,67,Douglas,1993,5544,5176,368,6.6
29,69,Dunklin,1993,13474,12074,1400,10.4
29,71,Franklin,1993,42778,39926,2852,6.7
29,73,Gasconade,1993,7286,6482,804,11.0
29,75,Gentry,1993,3309,3162,147,4.4
29,77,Greene,1993,118438,112176,6262,5.3
29,79,Grundy,1993,5055,4735,320,6.3
29,81,Harrison,1993,4134,3924,210,5.1
29,83,Henry,1993,9551,8734,817,8.6
29,85,Hickory,1993,2717,2485,232,8.5
29,87,Holt,1993,2842,2679,163,5.7
29,89,Howard,1993,4744,4482,262,5.5
29,91,Howell,1993,16190,14973,1217,7.5
29,93,Iron,1993,4298,3728,570,13.3
29,95,Jackson,1993,339403,320005,19398,5.7
29,97,Jasper,1993,48691,45889,2802,5.8
29,99,Jefferson,1993,93777,88038,5739,6.1
29,101,Johnson,1993,21397,20526,871,4.1
29,103,Knox,1993,1854,1746,108,5.8
29,105,Laclede,1993,13516,12343,1173,8.7
29,107,Lafayette,1993,15377,14551,826,5.4
29,109,Lawrence,1993,14849,13859,990,6.7
29,111,Lewis,1993,5053,4760,293,5.8
29,113,Lincoln,1993,15638,14331,1307,8.4
29,115,Linn,1993,6900,6138,762,11.0
29,117,Livingston,1993,6993,6605,388,5.5
29,119,McDonald,1993,6977,6483,494,7.1
29,121,Macon,1993,7618,6776,842,11.1
29,123,Madison,1993,4823,4199,624,12.9
29,125,Maries,1993,4100,3792,308,7.5
29,127,Marion,1993,14649,13649,1000,6.8
29,129,Mercer,1993,1846,1766,80,4.3
29,131,Miller,1993,10632,9491,1141,10.7
29,133,Mississippi,1993,6075,5389,686,11.3
29,135,Moniteau,1993,6549,6102,447,6.8
29,137,Monroe,1993,4077,3773,304,7.5
29,139,Montgomery,1993,5620,5204,416,7.4
29,141,Morgan,1993,7491,6790,701,9.4
29,143,New Madrid,1993,8522,7673,849,10.0
29,145,Newton,1993,24498,22952,1546,6.3
29,147,Nodaway,1993,11543,11194,349,3.0
29,149,Oregon,1993,4139,3837,302,7.3
29,151,Osage,1993,6624,6315,309,4.7
29,153,Ozark,1993,3875,3603,272,7.0
29,155,Pemiscot,1993,8031,6845,1186,14.8
29,157,Perry,1993,9718,9101,617,6.3
29,159,Pettis,1993,19138,17454,1684,8.8
29,161,Phelps,1993,17712,16536,1176,6.6
29,163,Pike,1993,7135,6489,646,9.1
29,165,Platte,1993,37664,36342,1322,3.5
29,167,Polk,1993,10551,9921,630,6.0
29,169,Pulaski,1993,12682,11305,1377,10.9
29,171,Putnam,1993,2035,1956,79,3.9
29,173,Ralls,1993,4783,4495,288,6.0
29,175,Randolph,1993,10484,9525,959,9.1
29,177,Ray,1993,10392,9752,640,6.2
29,179,Reynolds,1993,3082,2796,286,9.3
29,181,Ripley,1993,4764,4218,546,11.5
29,183,St. Charles,1993,131645,125032,6613,5.0
29,185,St. Clair,1993,3712,3444,268,7.2
29,186,Ste. Genevieve,1993,8425,7757,668,7.9
29,187,St. Francois,1993,21390,18758,2632,12.3
29,189,St. Louis,1993,543854,519312,24542,4.5
29,195,Saline,1993,11212,10474,738,6.6
29,197,Schuyler,1993,2289,2133,156,6.8
29,199,Scotland,1993,2293,2196,97,4.2
29,201,Scott,1993,19037,17517,1520,8.0
29,203,Shannon,1993,3787,3437,350,9.2
29,205,Shelby,1993,3223,3009,214,6.6
29,207,Stoddard,1993,13239,11788,1451,11.0
29,209,Stone,1993,12845,11423,1422,11.1
29,211,Sullivan,1993,2706,2562,144,5.3
29,213,Taney,1993,24145,21964,2181,9.0
29,215,Texas,1993,9933,8346,1587,16.0
29,217,Vernon,1993,8449,7999,450,5.3
29,219,Warren,1993,10655,9921,734,6.9
29,221,Washington,1993,8393,7159,1234,14.7
29,223,Wayne,1993,4120,3233,887,21.5
29,225,Webster,1993,11946,11218,728,6.1
29,227,Worth,1993,966,908,58,6.0
29,229,Wright,1993,7831,7144,687,8.8
29,510,St. Louis city,1993,170160,155364,14796,8.7
30,1,Beaverhead,1993,4640,4390,250,5.4
30,3,Big Horn,1993,5024,4390,634,12.6
30,5,Blaine,1993,2802,2558,244,8.7
30,7,Broadwater,1993,1792,1714,78,4.4
30,9,Carbon,1993,3880,3655,225,5.8
30,11,Carter,1993,875,852,23,2.6
30,13,Cascade,1993,35865,33618,2247,6.3
30,15,Chouteau,1993,2522,2468,54,2.1
30,17,Custer,1993,6100,5785,315,5.2
30,19,Daniels,1993,1130,1109,21,1.9
30,21,Dawson,1993,4847,4667,180,3.7
30,23,Deer Lodge,1993,4175,3776,399,9.6
30,25,Fallon,1993,1519,1457,62,4.1
30,27,Fergus,1993,5736,5415,321,5.6
30,29,Flathead,1993,34418,31943,2475,7.2
30,31,Gallatin,1993,33159,31658,1501,4.5
30,33,Garfield,1993,879,865,14,1.6
30,35,Glacier,1993,5425,4800,625,11.5
30,37,Golden Valley,1993,475,453,22,4.6
30,39,Granite,1993,1313,1211,102,7.8
30,41,Hill,1993,8658,8118,540,6.2
30,43,Jefferson,1993,4330,4124,206,4.8
30,45,Judith Basin,1993,1045,1008,37,3.5
30,47,Lake,1993,10122,9325,797,7.9
30,49,Lewis and Clark,1993,26806,25440,1366,5.1
30,51,Liberty,1993,995,970,25,2.5
30,53,Lincoln,1993,8159,6887,1272,15.6
30,55,McCone,1993,1121,1085,36,3.2
30,57,Madison,1993,3341,3215,126,3.8
30,59,Meagher,1993,916,862,54,5.9
30,61,Mineral,1993,1642,1487,155,9.4
30,63,Missoula,1993,46693,43989,2704,5.8
30,65,Musselshell,1993,1799,1690,109,6.1
30,67,Park,1993,9487,9089,398,4.2
30,69,Petroleum,1993,303,286,17,5.6
30,71,Phillips,1993,2416,2322,94,3.9
30,73,Pondera,1993,2950,2851,99,3.4
30,75,Powder River,1993,1165,1137,28,2.4
30,77,Powell,1993,2544,2314,230,9.0
30,79,Prairie,1993,655,628,27,4.1
30,81,Ravalli,1993,13886,12691,1195,8.6
30,83,Richland,1993,5375,4991,384,7.1
30,85,Roosevelt,1993,4308,3918,390,9.1
30,87,Rosebud,1993,4745,4374,371,7.8
30,89,Sanders,1993,3844,3367,477,12.4
30,91,Sheridan,1993,2107,2071,36,1.7
30,93,Silver Bow,1993,16777,15634,1143,6.8
30,95,Stillwater,1993,3362,3225,137,4.1
30,97,Sweet Grass,1993,1652,1607,45,2.7
30,99,Teton,1993,2791,2726,65,2.3
30,101,Toole,1993,2803,2698,105,3.7
30,103,Treasure,1993,459,441,18,3.9
30,105,Valley,1993,4188,3996,192,4.6
30,107,Wheatland,1993,1150,1101,49,4.3
30,109,Wibaux,1993,557,537,20,3.6
30,111,Yellowstone,1993,65555,62364,3191,4.9
31,1,Adams,1993,15459,15184,275,1.8
31,3,Antelope,1993,3265,3171,94,2.9
31,5,Arthur,1993,222,219,3,1.4
31,7,Banner,1993,423,418,5,1.2
31,9,Blaine,1993,342,327,15,4.4
31,11,Boone,1993,2918,2865,53,1.8
31,13,Box Butte,1993,6252,6046,206,3.3
31,15,Boyd,1993,1197,1158,39,3.3
31,17,Brown,1993,1789,1727,62,3.5
31,19,Buffalo,1993,22812,22242,570,2.5
31,21,Burt,1993,3629,3486,143,3.9
31,23,Butler,1993,4029,3904,125,3.1
31,25,Cass,1993,11086,10720,366,3.3
31,27,Cedar,1993,4894,4792,102,2.1
31,29,Chase,1993,1906,1860,46,2.4
31,31,Cherry,1993,3291,3224,67,2.0
31,33,Cheyenne,1993,5063,4948,115,2.3
31,35,Clay,1993,3416,3345,71,2.1
31,37,Colfax,1993,4703,4612,91,1.9
31,39,Cuming,1993,5144,5041,103,2.0
31,41,Custer,1993,5784,5642,142,2.5
31,43,Dakota,1993,9422,9189,233,2.5
31,45,Dawes,1993,4510,4351,159,3.5
31,47,Dawson,1993,13057,12653,404,3.1
31,49,Deuel,1993,1106,1085,21,1.9
31,51,Dixon,1993,2985,2890,95,3.2
31,53,Dodge,1993,17865,17267,598,3.3
31,55,Douglas,1993,235522,228147,7375,3.1
31,57,Dundy,1993,1255,1236,19,1.5
31,59,Fillmore,1993,3281,3205,76,2.3
31,61,Franklin,1993,1626,1589,37,2.3
31,63,Frontier,1993,1535,1506,29,1.9
31,65,Furnas,1993,2573,2522,51,2.0
31,67,Gage,1993,12046,11776,270,2.2
31,69,Garden,1993,1085,1066,19,1.8
31,71,Garfield,1993,1074,1045,29,2.7
31,73,Gosper,1993,1236,1211,25,2.0
31,75,Grant,1993,386,382,4,1.0
31,77,Greeley,1993,1457,1414,43,3.0
31,79,Hall,1993,29621,28931,690,2.3
31,81,Hamilton,1993,5101,5015,86,1.7
31,83,Harlan,1993,1763,1724,39,2.2
31,85,Hayes,1993,504,489,15,3.0
31,87,Hitchcock,1993,1653,1613,40,2.4
31,89,Holt,1993,6389,6210,179,2.8
31,91,Hooker,1993,410,401,9,2.2
31,93,Howard,1993,3305,3226,79,2.4
31,95,Jefferson,1993,4377,4267,110,2.5
31,97,Johnson,1993,2400,2333,67,2.8
31,99,Kearney,1993,3413,3355,58,1.7
31,101,Keith,1993,4368,4234,134,3.1
31,103,Keya Paha,1993,498,481,17,3.4
31,105,Kimball,1993,2125,2071,54,2.5
31,107,Knox,1993,4502,4366,136,3.0
31,109,Lancaster,1993,131009,127835,3174,2.4
31,111,Lincoln,1993,17358,16687,671,3.9
31,113,Logan,1993,447,440,7,1.6
31,115,Loup,1993,425,415,10,2.4
31,117,McPherson,1993,300,296,4,1.3
31,119,Madison,1993,18773,18252,521,2.8
31,121,Merrick,1993,4554,4469,85,1.9
31,123,Morrill,1993,2744,2619,125,4.6
31,125,Nance,1993,1962,1906,56,2.9
31,127,Nemaha,1993,3897,3737,160,4.1
31,129,Nuckolls,1993,2478,2426,52,2.1
31,131,Otoe,1993,7405,7161,244,3.3
31,133,Pawnee,1993,1504,1462,42,2.8
31,135,Perkins,1993,1417,1383,34,2.4
31,137,Phelps,1993,5182,5116,66,1.3
31,139,Pierce,1993,3865,3774,91,2.4
31,141,Platte,1993,16911,16510,401,2.4
31,143,Polk,1993,2545,2490,55,2.2
31,145,Red Willow,1993,5998,5846,152,2.5
31,147,Richardson,1993,4789,4610,179,3.7
31,149,Rock,1993,970,937,33,3.4
31,151,Saline,1993,6864,6756,108,1.6
31,153,Sarpy,1993,51308,49896,1412,2.8
31,155,Saunders,1993,10428,10156,272,2.6
31,157,Scotts Bluff,1993,18629,17807,822,4.4
31,159,Seward,1993,8967,8764,203,2.3
31,161,Sheridan,1993,2989,2923,66,2.2
31,163,Sherman,1993,1537,1493,44,2.9
31,165,Sioux,1993,821,808,13,1.6
31,167,Stanton,1993,3208,3126,82,2.6
31,169,Thayer,1993,3214,3147,67,2.1
31,171,Thomas,1993,417,393,24,5.8
31,173,Thurston,1993,2582,2391,191,7.4
31,175,Valley,1993,2732,2667,65,2.4
31,177,Washington,1993,9569,9339,230,2.4
31,179,Wayne,1993,5636,5476,160,2.8
31,181,Webster,1993,1825,1788,37,2.0
31,183,Wheeler,1993,434,422,12,2.8
31,185,York,1993,8116,7970,146,1.8
32,1,Churchill,1993,8615,7875,740,8.6
32,3,Clark,1993,488727,455022,33705,6.9
32,5,Douglas,1993,16662,15455,1207,7.2
32,7,Elko,1993,20269,18952,1317,6.5
32,9,Esmeralda,1993,762,683,79,10.4
32,11,Eureka,1993,811,752,59,7.3
32,13,Humboldt,1993,8147,7701,446,5.5
32,15,Lander,1993,3096,2742,354,11.4
32,17,Lincoln,1993,1448,1278,170,11.7
32,19,Lyon,1993,10555,9481,1074,10.2
32,21,Mineral,1993,3117,2843,274,8.8
32,23,Nye,1993,10519,9777,742,7.1
32,27,Pershing,1993,2105,1976,129,6.1
32,29,Storey,1993,1427,1351,76,5.3
32,31,Washoe,1993,165198,155332,9866,6.0
32,33,White Pine,1993,3614,3164,450,12.5
32,510,Carson City,1993,22281,20026,2255,10.1
33,1,Belknap,1993,26671,24947,1724,6.5
33,3,Carroll,1993,19036,18041,995,5.2
33,5,Cheshire,1993,38611,36741,1870,4.8
33,7,Coos,1993,17437,15854,1583,9.1
33,9,Grafton,1993,40299,38304,1995,5.0
33,11,Hillsborough,1993,190904,178884,12020,6.3
33,13,Merrimack,1993,66826,63802,3024,4.5
33,15,Rockingham,1993,143133,132737,10396,7.3
33,17,Strafford,1993,57625,54389,3236,5.6
33,19,Sullivan,1993,19769,18739,1030,5.2
34,1,Atlantic,1993,122533,110609,11924,9.7
34,3,Bergen,1993,430460,400579,29881,6.9
34,5,Burlington,1993,203432,190599,12833,6.3
34,7,Camden,1993,251302,232111,19191,7.6
34,9,Cape May,1993,45438,39290,6148,13.5
34,11,Cumberland,1993,64069,56554,7515,11.7
34,13,Essex,1993,377782,341992,35790,9.5
34,15,Gloucester,1993,121571,112473,9098,7.5
34,17,Hudson,1993,280512,251362,29150,10.4
34,19,Hunterdon,1993,61529,58724,2805,4.6
34,21,Mercer,1993,170091,159915,10176,6.0
34,23,Middlesex,1993,377632,351149,26483,7.0
34,25,Monmouth,1993,292837,273928,18909,6.5
34,27,Morris,1993,242494,228227,14267,5.9
34,29,Ocean,1993,195618,181483,14135,7.2
34,31,Passaic,1993,230441,206579,23862,10.4
34,33,Salem,1993,30922,28661,2261,7.3
34,35,Somerset,1993,145962,138619,7343,5.0
34,37,Sussex,1993,72130,66773,5357,7.4
34,39,Union,1993,261134,239382,21752,8.3
34,41,Warren,1993,48296,44802,3494,7.2
35,1,Bernalillo,1993,269257,251643,17614,6.5
35,3,Catron,1993,1182,1050,132,11.2
35,5,Chaves,1993,24564,22745,1819,7.4
35,6,Cibola,1993,8889,7767,1122,12.6
35,7,Colfax,1993,6322,5816,506,8.0
35,9,Curry,1993,19085,17906,1179,6.2
35,11,De Baca,1993,935,879,56,6.0
35,13,Dona Ana,1993,61892,56900,4992,8.1
35,15,Eddy,1993,23324,21220,2104,9.0
35,17,Grant,1993,11490,10470,1020,8.9
35,19,Guadalupe,1993,1817,1591,226,12.4
35,21,Harding,1993,458,435,23,5.0
35,23,Hidalgo,1993,2852,2674,178,6.2
35,25,Lea,1993,24485,23065,1420,5.8
35,27,Lincoln,1993,6556,6162,394,6.0
35,28,Los Alamos,1993,11040,10905,135,1.2
35,29,Luna,1993,8983,7549,1434,16.0
35,31,McKinley,1993,24329,22579,1750,7.2
35,33,Mora,1993,1604,1269,335,20.9
35,35,Otero,1993,19291,17719,1572,8.1
35,37,Quay,1993,4891,4593,298,6.1
35,39,Rio Arriba,1993,16127,14040,2087,12.9
35,41,Roosevelt,1993,6769,6431,338,5.0
35,43,Sandoval,1993,33677,31750,1927,5.7
35,45,San Juan,1993,43387,38950,4437,10.2
35,47,San Miguel,1993,11564,10498,1066,9.2
35,49,Santa Fe,1993,60989,58727,2262,3.7
35,51,Sierra,1993,3613,3434,179,5.0
35,53,Socorro,1993,6376,5773,603,9.5
35,55,Taos,1993,12119,10277,1842,15.2
35,57,Torrance,1993,4570,4171,399,8.7
35,59,Union,1993,1874,1805,69,3.7
35,61,Valencia,1993,22259,20833,1426,6.4
36,1,Albany,1993,156784,150098,6686,4.3
36,3,Allegany,1993,22849,20863,1986,8.7
36,5,Bronx,1993,453967,398787,55180,12.2
36,7,Broome,1993,103585,96379,7206,7.0
36,9,Cattaraugus,1993,38827,35370,3457,8.9
36,11,Cayuga,1993,38163,35478,2685,7.0
36,13,Chautauqua,1993,68464,63699,4765,7.0
36,15,Chemung,1993,42902,40447,2455,5.7
36,17,Chenango,1993,25177,23110,2067,8.2
36,19,Clinton,1993,40775,37616,3159,7.7
36,21,Columbia,1993,32797,31093,1704,5.2
36,23,Cortland,1993,24691,22706,1985,8.0
36,25,Delaware,1993,21011,19568,1443,6.9
36,27,Dutchess,1993,123221,112575,10646,8.6
36,29,Erie,1993,471737,440342,31395,6.7
36,31,Essex,1993,18040,16111,1929,10.7
36,33,Franklin,1993,21467,19604,1863,8.7
36,35,Fulton,1993,27094,24940,2154,8.0
36,37,Genesee,1993,32099,29960,2139,6.7
36,39,Greene,1993,21480,19644,1836,8.5
36,41,Hamilton,1993,2807,2489,318,11.3
36,43,Herkimer,1993,30360,28003,2357,7.8
36,45,Jefferson,1993,45032,39971,5061,11.2
36,47,Kings,1993,945326,836462,108864,11.5
36,49,Lewis,1993,12545,11261,1284,10.2
36,51,Livingston,1993,33446,31525,1921,5.7
36,53,Madison,1993,35479,33043,2436,6.9
36,55,Monroe,1993,384975,367181,17794,4.6
36,57,Montgomery,1993,24261,22407,1854,7.6
36,59,Nassau,1993,677578,637312,40266,5.9
36,61,New York,1993,772856,703328,69528,9.0
36,63,Niagara,1993,108654,100397,8257,7.6
36,65,Oneida,1993,113573,106496,7077,6.2
36,67,Onondaga,1993,241334,227026,14308,5.9
36,69,Ontario,1993,52562,49753,2809,5.3
36,71,Orange,1993,156423,146959,9464,6.1
36,73,Orleans,1993,21271,19672,1599,7.5
36,75,Oswego,1993,58046,52592,5454,9.4
36,77,Otsego,1993,31108,29174,1934,6.2
36,79,Putnam,1993,48616,45993,2623,5.4
36,81,Queens,1993,948385,856751,91634,9.7
36,83,Rensselaer,1993,82199,77873,4326,5.3
36,85,Richmond,1993,185463,168117,17346,9.4
36,87,Rockland,1993,144402,135387,9015,6.2
36,89,St. Lawrence,1993,51023,46413,4610,9.0
36,91,Saratoga,1993,100496,95439,5057,5.0
36,93,Schenectady,1993,75306,71390,3916,5.2
36,95,Schoharie,1993,15625,14550,1075,6.9
36,97,Schuyler,1993,8903,8228,675,7.6
36,99,Seneca,1993,16119,15082,1037,6.4
36,101,Steuben,1993,48543,45284,3259,6.7
36,103,Suffolk,1993,695848,644796,51052,7.3
36,105,Sullivan,1993,33562,30792,2770,8.3
36,107,Tioga,1993,26385,24674,1711,6.5
36,109,Tompkins,1993,48773,46775,1998,4.1
36,111,Ulster,1993,83276,77087,6189,7.4
36,113,Warren,1993,31946,29269,2677,8.4
36,115,Washington,1993,28942,26975,1967,6.8
36,117,Wayne,1993,48069,45100,2969,6.2
36,119,Westchester,1993,444635,419763,24872,5.6
36,121,Wyoming,1993,20952,19251,1701,8.1
36,123,Yates,1993,11851,11180,671,5.7
37,1,Alamance,1993,62842,60015,2827,4.5
37,3,Alexander,1993,16510,15982,528,3.2
37,5,Alleghany,1993,4894,4642,252,5.1
37,7,Anson,1993,11742,10666,1076,9.2
37,9,Ashe,1993,11716,10858,858,7.3
37,11,Avery,1993,7281,6668,613,8.4
37,13,Beaufort,1993,19862,18476,1386,7.0
37,15,Bertie,1993,8953,8364,589,6.6
37,17,Bladen,1993,15340,13976,1364,8.9
37,19,Brunswick,1993,28033,24953,3080,11.0
37,21,Buncombe,1993,98143,93965,4178,4.3
37,23,Burke,1993,43077,41083,1994,4.6
37,25,Cabarrus,1993,57659,55127,2532,4.4
37,27,Caldwell,1993,40931,39282,1649,4.0
37,29,Camden,1993,2843,2714,129,4.5
37,31,Carteret,1993,27327,25508,1819,6.7
37,33,Caswell,1993,10929,10412,517,4.7
37,35,Catawba,1993,73122,70039,3083,4.2
37,37,Chatham,1993,22976,22371,605,2.6
37,39,Cherokee,1993,9298,8343,955,10.3
37,41,Chowan,1993,6712,6359,353,5.3
37,43,Clay,1993,3305,3008,297,9.0
37,45,Cleveland,1993,45650,43157,2493,5.5
37,47,Columbus,1993,25132,22967,2165,8.6
37,49,Craven,1993,34180,32141,2039,6.0
37,51,Cumberland,1993,111413,105288,6125,5.5
37,53,Currituck,1993,7440,7144,296,4.0
37,55,Dare,1993,15036,13917,1119,7.4
37,57,Davidson,1993,74770,71635,3135,4.2
37,59,Davie,1993,15890,15240,650,4.1
37,61,Duplin,1993,20932,19267,1665,8.0
37,63,Durham,1993,106412,102643,3769,3.5
37,65,Edgecombe,1993,27697,25686,2011,7.3
37,67,Forsyth,1993,147490,141250,6240,4.2
37,69,Franklin,1993,20075,19074,1001,5.0
37,71,Gaston,1993,96319,91208,5111,5.3
37,73,Gates,1993,4265,4115,150,3.5
37,75,Graham,1993,4272,3668,604,14.1
37,77,Granville,1993,21074,20064,1010,4.8
37,79,Greene,1993,7768,7404,364,4.7
37,81,Guilford,1993,206946,197759,9187,4.4
37,83,Halifax,1993,24936,22938,1998,8.0
37,85,Harnett,1993,32043,30478,1565,4.9
37,87,Haywood,1993,23642,22144,1498,6.3
37,89,Henderson,1993,33324,31918,1406,4.2
37,91,Hertford,1993,10492,9480,1012,9.6
37,93,Hoke,1993,10344,9499,845,8.2
37,95,Hyde,1993,2846,2555,291,10.2
37,97,Iredell,1993,54776,52709,2067,3.8
37,99,Jackson,1993,14463,13477,986,6.8
37,101,Johnston,1993,47675,45850,1825,3.8
37,103,Jones,1993,4471,4249,222,5.0
37,105,Lee,1993,24104,22887,1217,5.0
37,107,Lenoir,1993,29018,27018,2000,6.9
37,109,Lincoln,1993,29374,28105,1269,4.3
37,111,McDowell,1993,19349,18179,1170,6.0
37,113,Macon,1993,12150,11323,827,6.8
37,115,Madison,1993,8547,8119,428,5.0
37,117,Martin,1993,12978,12068,910,7.0
37,119,Mecklenburg,1993,315437,301303,14134,4.5
37,121,Mitchell,1993,6835,6288,547,8.0
37,123,Montgomery,1993,11827,10870,957,8.1
37,125,Moore,1993,28610,26839,1771,6.2
37,127,Nash,1993,43557,40831,2726,6.3
37,129,New Hanover,1993,71642,66426,5216,7.3
37,131,Northampton,1993,8742,8172,570,6.5
37,133,Onslow,1993,42456,40397,2059,4.8
37,135,Orange,1993,57509,56187,1322,2.3
37,137,Pamlico,1993,5146,4930,216,4.2
37,139,Pasquotank,1993,13833,13062,771,5.6
37,141,Pender,1993,13681,12483,1198,8.8
37,143,Perquimans,1993,4398,4179,219,5.0
37,145,Person,1993,16279,15003,1276,7.8
37,147,Pitt,1993,58965,55884,3081,5.2
37,149,Polk,1993,7291,7061,230,3.2
37,151,Randolph,1993,64615,62635,1980,3.1
37,153,Richmond,1993,21346,19458,1888,8.8
37,155,Robeson,1993,54683,50137,4546,8.3
37,157,Rockingham,1993,46983,44222,2761,5.9
37,159,Rowan,1993,59391,56941,2450,4.1
37,161,Rutherford,1993,30695,28925,1770,5.8
37,163,Sampson,1993,23511,21832,1679,7.1
37,165,Scotland,1993,17466,15858,1608,9.2
37,167,Stanly,1993,27897,26434,1463,5.2
37,169,Stokes,1993,20783,20090,693,3.3
37,171,Surry,1993,35276,33800,1476,4.2
37,173,Swain,1993,6137,5177,960,15.6
37,175,Transylvania,1993,11493,10923,570,5.0
37,177,Tyrrell,1993,1898,1660,238,12.5
37,179,Union,1993,49725,47634,2091,4.2
37,181,Vance,1993,19922,18160,1762,8.8
37,183,Wake,1993,280866,272023,8843,3.1
37,185,Warren,1993,7301,6700,601,8.2
37,187,Washington,1993,6093,5555,538,8.8
37,189,Watauga,1993,21113,20496,617,2.9
37,191,Wayne,1993,46853,44274,2579,5.5
37,193,Wilkes,1993,32077,30942,1135,3.5
37,195,Wilson,1993,36702,32836,3866,10.5
37,197,Yadkin,1993,16685,16094,591,3.5
37,199,Yancey,1993,6316,5818,498,7.9
38,1,Adams,1993,1489,1455,34,2.3
38,3,Barnes,1993,5536,5343,193,3.5
38,5,Benson,1993,2608,2253,355,13.6
38,7,Billings,1993,544,525,19,3.5
38,9,Bottineau,1993,3319,3183,136,4.1
38,11,Bowman,1993,1813,1743,70,3.9
38,13,Burke,1993,1092,1049,43,3.9
38,15,Burleigh,1993,36346,34957,1389,3.8
38,17,Cass,1993,63054,61375,1679,2.7
38,19,Cavalier,1993,2586,2456,130,5.0
38,21,Dickey,1993,2791,2719,72,2.6
38,23,Divide,1993,1162,1139,23,2.0
38,25,Dunn,1993,1879,1809,70,3.7
38,27,Eddy,1993,1244,1139,105,8.4
38,29,Emmons,1993,2084,1996,88,4.2
38,31,Foster,1993,1939,1862,77,4.0
38,33,Golden Valley,1993,916,876,40,4.4
38,35,Grand Forks,1993,35460,34318,1142,3.2
38,37,Grant,1993,1500,1449,51,3.4
38,39,Griggs,1993,1527,1484,43,2.8
38,41,Hettinger,1993,1358,1310,48,3.5
38,43,Kidder,1993,1437,1363,74,5.1
38,45,LaMoure,1993,2310,2249,61,2.6
38,47,Logan,1993,1198,1175,23,1.9
38,49,McHenry,1993,2743,2578,165,6.0
38,51,McIntosh,1993,1702,1663,39,2.3
38,53,McKenzie,1993,2786,2704,82,2.9
38,55,McLean,1993,4509,4240,269,6.0
38,57,Mercer,1993,4871,4454,417,8.6
38,59,Morton,1993,12857,12198,659,5.1
38,61,Mountrail,1993,3266,3010,256,7.8
38,63,Nelson,1993,1708,1644,64,3.7
38,65,Oliver,1993,1124,1081,43,3.8
38,67,Pembina,1993,4769,4361,408,8.6
38,69,Pierce,1993,2257,2190,67,3.0
38,71,Ramsey,1993,6437,6179,258,4.0
38,73,Ransom,1993,2621,2527,94,3.6
38,75,Renville,1993,1347,1314,33,2.4
38,77,Richland,1993,8332,8002,330,4.0
38,79,Rolette,1993,5093,4316,777,15.3
38,81,Sargent,1993,2131,2073,58,2.7
38,83,Sheridan,1993,698,674,24,3.4
38,85,Sioux,1993,1380,1132,248,18.0
38,87,Slope,1993,394,377,17,4.3
38,89,Stark,1993,11939,11432,507,4.2
38,91,Steele,1993,1015,998,17,1.7
38,93,Stutsman,1993,11058,10621,437,4.0
38,95,Towner,1993,1635,1597,38,2.3
38,97,Traill,1993,3797,3645,152,4.0
38,99,Walsh,1993,6420,6029,391,6.1
38,101,Ward,1993,27019,25745,1274,4.7
38,103,Wells,1993,2512,2343,169,6.7
38,105,Williams,1993,10128,9657,471,4.7
39,1,Adams,1993,11255,9527,1728,15.4
39,3,Allen,1993,51685,47466,4219,8.2
39,5,Ashland,1993,25479,23597,1882,7.4
39,7,Ashtabula,1993,45213,41199,4014,8.9
39,9,Athens,1993,24887,23282,1605,6.4
39,11,Auglaize,1993,23940,22134,1806,7.5
39,13,Belmont,1993,30890,28054,2836,9.2
39,15,Brown,1993,17856,16182,1674,9.4
39,17,Butler,1993,157511,146638,10873,6.9
39,19,Carroll,1993,12551,11590,961,7.7
39,21,Champaign,1993,19358,17652,1706,8.8
39,23,Clark,1993,69127,64807,4320,6.2
39,25,Clermont,1993,84753,79313,5440,6.4
39,27,Clinton,1993,20108,18747,1361,6.8
39,29,Columbiana,1993,50760,46356,4404,8.7
39,31,Coshocton,1993,16352,15197,1155,7.1
39,33,Crawford,1993,22490,20600,1890,8.4
39,35,Cuyahoga,1993,682136,637621,44515,6.5
39,37,Darke,1993,28334,26565,1769,6.2
39,39,Defiance,1993,20257,18861,1396,6.9
39,41,Delaware,1993,40042,38031,2011,5.0
39,43,Erie,1993,42443,39582,2861,6.7
39,45,Fairfield,1993,57133,53739,3394,5.9
39,47,Fayette,1993,14180,13229,951,6.7
39,49,Franklin,1993,552035,526134,25901,4.7
39,51,Fulton,1993,21320,19809,1511,7.1
39,53,Gallia,1993,13515,12261,1254,9.3
39,55,Geauga,1993,43087,40972,2115,4.9
39,57,Greene,1993,67126,63818,3308,4.9
39,59,Guernsey,1993,18461,16191,2270,12.3
39,61,Hamilton,1993,439265,414109,25156,5.7
39,63,Hancock,1993,38392,36514,1878,4.9
39,65,Hardin,1993,14683,13556,1127,7.7
39,67,Harrison,1993,7434,6783,651,8.8
39,69,Henry,1993,16509,15167,1342,8.1
39,71,Highland,1993,16853,15461,1392,8.3
39,73,Hocking,1993,12121,10842,1279,10.6
39,75,Holmes,1993,15941,15350,591,3.7
39,77,Huron,1993,29288,25939,3349,11.4
39,79,Jackson,1993,13750,12493,1257,9.1
39,81,Jefferson,1993,31958,28834,3124,9.8
39,83,Knox,1993,25656,24097,1559,6.1
39,85,Lake,1993,121698,113750,7948,6.5
39,87,Lawrence,1993,25752,23560,2192,8.5
39,89,Licking,1993,67171,63299,3872,5.8
39,91,Logan,1993,22799,21122,1677,7.4
39,93,Lorain,1993,135948,127422,8526,6.3
39,95,Lucas,1993,224673,208501,16172,7.2
39,97,Madison,1993,19252,17919,1333,6.9
39,99,Mahoning,1993,118960,108555,10405,8.7
39,101,Marion,1993,31388,28996,2392,7.6
39,103,Medina,1993,69274,65559,3715,5.4
39,105,Meigs,1993,8493,7490,1003,11.8
39,107,Mercer,1993,20184,18650,1534,7.6
39,109,Miami,1993,49062,45994,3068,6.3
39,111,Monroe,1993,6339,5583,756,11.9
39,113,Montgomery,1993,281399,265571,15828,5.6
39,115,Morgan,1993,5491,4786,705,12.8
39,117,Morrow,1993,13848,12835,1013,7.3
39,119,Muskingum,1993,41393,37599,3794,9.2
39,121,Noble,1993,5056,4567,489,9.7
39,123,Ottawa,1993,20979,18943,2036,9.7
39,125,Paulding,1993,9549,8911,638,6.7
39,127,Perry,1993,14325,12600,1725,12.0
39,129,Pickaway,1993,22551,21268,1283,5.7
39,131,Pike,1993,10704,9263,1441,13.5
39,133,Portage,1993,78773,74038,4735,6.0
39,135,Preble,1993,20449,19114,1335,6.5
39,137,Putnam,1993,18469,17235,1234,6.7
39,139,Richland,1993,61979,56749,5230,8.4
39,141,Ross,1993,32256,29592,2664,8.3
39,143,Sandusky,1993,31173,28846,2327,7.5
39,145,Scioto,1993,31631,28104,3527,11.2
39,147,Seneca,1993,29992,27551,2441,8.1
39,149,Shelby,1993,25628,23684,1944,7.6
39,151,Stark,1993,184772,171234,13538,7.3
39,153,Summit,1993,267147,250422,16725,6.3
39,155,Trumbull,1993,111354,101502,9852,8.8
39,157,Tuscarawas,1993,43126,39934,3192,7.4
39,159,Union,1993,15568,14712,856,5.5
39,161,Van Wert,1993,16166,15248,918,5.7
39,163,Vinton,1993,4037,3477,560,13.9
39,165,Warren,1993,64120,60147,3973,6.2
39,167,Washington,1993,31834,29139,2695,8.5
39,169,Wayne,1993,53633,50979,2654,4.9
39,171,Williams,1993,21473,20210,1263,5.9
39,173,Wood,1993,61239,57998,3241,5.3
39,175,Wyandot,1993,11612,10695,917,7.9
40,1,Adair,1993,9892,9391,501,5.1
40,3,Alfalfa,1993,2687,2636,51,1.9
40,5,Atoka,1993,4879,4577,302,6.2
40,7,Beaver,1993,2915,2826,89,3.1
40,9,Beckham,1993,9141,8640,501,5.5
40,11,Blaine,1993,5044,4820,224,4.4
40,13,Bryan,1993,13665,12978,687,5.0
40,15,Caddo,1993,12107,11284,823,6.8
40,17,Canadian,1993,40015,38581,1434,3.6
40,19,Carter,1993,20605,19401,1204,5.8
40,21,Cherokee,1993,16168,15066,1102,6.8
40,23,Choctaw,1993,5896,5165,731,12.4
40,25,Cimarron,1993,1779,1747,32,1.8
40,27,Cleveland,1993,96206,93080,3126,3.2
40,29,Coal,1993,2552,2301,251,9.8
40,31,Comanche,1993,42601,40146,2455,5.8
40,33,Cotton,1993,2333,2203,130,5.6
40,35,Craig,1993,6427,6106,321,5.0
40,37,Creek,1993,29778,27861,1917,6.4
40,39,Custer,1993,13294,12755,539,4.1
40,41,Delaware,1993,14215,13550,665,4.7
40,43,Dewey,1993,2377,2294,83,3.5
40,45,Ellis,1993,1885,1817,68,3.6
40,47,Garfield,1993,27188,26201,987,3.6
40,49,Garvin,1993,11284,10517,767,6.8
40,51,Grady,1993,19534,18469,1065,5.5
40,53,Grant,1993,2487,2435,52,2.1
40,55,Greer,1993,2393,2312,81,3.4
40,57,Harmon,1993,1358,1301,57,4.2
40,59,Harper,1993,2023,1970,53,2.6
40,61,Haskell,1993,4296,3573,723,16.8
40,63,Hughes,1993,5616,4972,644,11.5
40,65,Jackson,1993,10704,10231,473,4.4
40,67,Jefferson,1993,3221,3017,204,6.3
40,69,Johnston,1993,4521,4269,252,5.6
40,71,Kay,1993,23778,21897,1881,7.9
40,73,Kingfisher,1993,6612,6330,282,4.3
40,75,Kiowa,1993,4901,4692,209,4.3
40,77,Latimer,1993,4098,3449,649,15.8
40,79,Le Flore,1993,18458,16855,1603,8.7
40,81,Lincoln,1993,14877,14144,733,4.9
40,83,Logan,1993,13475,12913,562,4.2
40,85,Love,1993,3935,3674,261,6.6
40,87,McClain,1993,11294,10851,443,3.9
40,89,McCurtain,1993,14632,13429,1203,8.2
40,91,McIntosh,1993,6994,6318,676,9.7
40,93,Major,1993,3745,3616,129,3.4
40,95,Marshall,1993,4998,4699,299,6.0
40,97,Mayes,1993,14590,13449,1141,7.8
40,99,Murray,1993,5619,5127,492,8.8
40,101,Muskogee,1993,29770,27524,2246,7.5
40,103,Noble,1993,5306,5090,216,4.1
40,105,Nowata,1993,3991,3720,271,6.8
40,107,Okfuskee,1993,4490,4090,400,8.9
40,109,Oklahoma,1993,306134,290565,15569,5.1
40,111,Okmulgee,1993,15005,13461,1544,10.3
40,113,Osage,1993,19076,18096,980,5.1
40,115,Ottawa,1993,13373,12448,925,6.9
40,117,Pawnee,1993,6846,6164,682,10.0
40,119,Payne,1993,33320,32415,905,2.7
40,121,Pittsburg,1993,18303,16394,1909,10.4
40,123,Pontotoc,1993,16201,15211,990,6.1
40,125,Pottawatomie,1993,26199,24805,1394,5.3
40,127,Pushmataha,1993,4904,4525,379,7.7
40,129,Roger Mills,1993,2110,2035,75,3.6
40,131,Rogers,1993,30060,28041,2019,6.7
40,133,Seminole,1993,10899,10004,895,8.2
40,135,Sequoyah,1993,15952,14674,1278,8.0
40,137,Stephens,1993,18415,17322,1093,5.9
40,139,Texas,1993,8705,8455,250,2.9
40,141,Tillman,1993,4184,3918,266,6.4
40,143,Tulsa,1993,273644,257969,15675,5.7
40,145,Wagoner,1993,24978,23690,1288,5.2
40,147,Washington,1993,21054,19690,1364,6.5
40,149,Washita,1993,5138,4933,205,4.0
40,151,Woods,1993,4323,4216,107,2.5
40,153,Woodward,1993,9026,8544,482,5.3
41,1,Baker,1993,7349,6673,676,9.2
41,3,Benton,1993,37720,36498,1222,3.2
41,5,Clackamas,1993,170593,161785,8808,5.2
41,7,Clatsop,1993,17447,16009,1438,8.2
41,9,Columbia,1993,20279,18413,1866,9.2
41,11,Coos,1993,28094,25165,2929,10.4
41,13,Crook,1993,7720,6995,725,9.4
41,15,Curry,1993,8184,7471,713,8.7
41,17,Deschutes,1993,47408,43447,3961,8.4
41,19,Douglas,1993,43085,38207,4878,11.3
41,21,Gilliam,1993,1134,1079,55,4.9
41,23,Grant,1993,4364,3858,506,11.6
41,25,Harney,1993,3800,3362,438,11.5
41,27,Hood River,1993,10243,9202,1041,10.2
41,29,Jackson,1993,79778,73183,6595,8.3
41,31,Jefferson,1993,7344,6716,628,8.6
41,33,Josephine,1993,28370,25423,2947,10.4
41,35,Klamath,1993,28551,25572,2979,10.4
41,37,Lake,1993,3856,3504,352,9.1
41,39,Lane,1993,151193,140127,11066,7.3
41,41,Lincoln,1993,20602,19091,1511,7.3
41,43,Linn,1993,46711,42437,4274,9.1
41,45,Malheur,1993,14914,13638,1276,8.6
41,47,Marion,1993,127980,118959,9021,7.0
41,49,Morrow,1993,4008,3605,403,10.1
41,51,Multnomah,1993,342887,321306,21581,6.3
41,53,Polk,1993,26922,25334,1588,5.9
41,55,Sherman,1993,945,850,95,10.1
41,57,Tillamook,1993,10278,9650,628,6.1
41,59,Umatilla,1993,31988,29222,2766,8.6
41,61,Union,1993,12350,11426,924,7.5
41,63,Wallowa,1993,3647,3281,366,10.0
41,65,Wasco,1993,11859,10800,1059,8.9
41,67,Washington,1993,204895,194514,10381,5.1
41,69,Wheeler,1993,535,473,62,11.6
41,71,Yamhill,1993,35077,33067,2010,5.7
42,1,Adams,1993,41843,39684,2159,5.2
42,3,Allegheny,1993,662604,621654,40950,6.2
42,5,Armstrong,1993,31941,28703,3238,10.1
42,7,Beaver,1993,85924,79542,6382,7.4
42,9,Bedford,1993,23649,21458,2191,9.3
42,11,Berks,1993,177651,167524,10127,5.7
42,13,Blair,1993,62975,58482,4493,7.1
42,15,Bradford,1993,27404,25542,1862,6.8
42,17,Bucks,1993,305014,285844,19170,6.3
42,19,Butler,1993,79909,74655,5254,6.6
42,21,Cambria,1993,69955,62147,7808,11.2
42,23,Cameron,1993,2520,2311,209,8.3
42,25,Carbon,1993,26601,24385,2216,8.3
42,27,Centre,1993,62956,60320,2636,4.2
42,29,Chester,1993,211072,201341,9731,4.6
42,31,Clarion,1993,18358,16897,1461,8.0
42,33,Clearfield,1993,36502,33052,3450,9.5
42,35,Clinton,1993,17443,15860,1583,9.1
42,37,Columbia,1993,32204,29610,2594,8.1
42,39,Crawford,1993,40082,37011,3071,7.7
42,41,Cumberland,1993,113127,109179,3948,3.5
42,43,Dauphin,1993,133522,127312,6210,4.7
42,45,Delaware,1993,276307,259256,17051,6.2
42,47,Elk,1993,17113,16211,902,5.3
42,49,Erie,1993,140234,130562,9672,6.9
42,51,Fayette,1993,56721,51297,5424,9.6
42,53,Forest,1993,2066,1834,232,11.2
42,55,Franklin,1993,62098,58778,3320,5.3
42,57,Fulton,1993,6420,5995,425,6.6
42,59,Greene,1993,15509,13690,1819,11.7
42,61,Huntingdon,1993,19654,17404,2250,11.4
42,63,Indiana,1993,37282,33223,4059,10.9
42,65,Jefferson,1993,21302,19685,1617,7.6
42,67,Juniata,1993,10178,9262,916,9.0
42,69,Lackawanna,1993,106932,97947,8985,8.4
42,71,Lancaster,1993,228421,219112,9309,4.1
42,73,Lawrence,1993,40878,36921,3957,9.7
42,75,Lebanon,1993,62831,59770,3061,4.9
42,77,Lehigh,1993,153380,143869,9511,6.2
42,79,Luzerne,1993,159780,145681,14099,8.8
42,81,Lycoming,1993,57501,52789,4712,8.2
42,83,McKean,1993,21179,19411,1768,8.3
42,85,Mercer,1993,55239,49444,5795,10.5
42,87,Mifflin,1993,22006,20333,1673,7.6
42,89,Monroe,1993,48922,44181,4741,9.7
42,91,Montgomery,1993,377610,357034,20576,5.4
42,93,Montour,1993,8947,8572,375,4.2
42,95,Northampton,1993,126163,118161,8002,6.3
42,97,Northumberland,1993,45684,41675,4009,8.8
42,99,Perry,1993,22603,21519,1084,4.8
42,101,Philadelphia/city,1993,677430,615038,62392,9.2
42,103,Pike,1993,16136,14918,1218,7.5
42,105,Potter,1993,8332,7615,717,8.6
42,107,Schuylkill,1993,69638,63622,6016,8.6
42,109,Snyder,1993,18715,17647,1068,5.7
42,111,Somerset,1993,36666,33093,3573,9.7
42,113,Sullivan,1993,2729,2543,186,6.8
42,115,Susquehanna,1993,19135,17454,1681,8.8
42,117,Tioga,1993,19153,17736,1417,7.4
42,119,Union,1993,17046,16111,935,5.5
42,121,Venango,1993,25525,23312,2213,8.7
42,123,Warren,1993,22408,20877,1531,6.8
42,125,Washington,1993,94855,87666,7189,7.6
42,127,Wayne,1993,18824,17001,1823,9.7
42,129,Westmoreland,1993,180024,166106,13918,7.7
42,131,Wyoming,1993,14803,13418,1385,9.4
42,133,York,1993,189578,179596,9982,5.3
44,1,Bristol,1993,26458,24472,1986,7.5
44,3,Kent,1993,89846,83351,6495,7.2
44,5,Newport,1993,41717,38412,3305,7.9
44,7,Providence,1993,303564,279561,24003,7.9
44,9,Washington,1993,61635,58065,3570,5.8
45,1,Abbeville,1993,12386,11244,1142,9.2
45,3,Aiken,1993,64592,59583,5009,7.8
45,5,Allendale,1993,4754,4164,590,12.4
45,7,Anderson,1993,78905,74511,4394,5.6
45,9,Bamberg,1993,7841,6881,960,12.2
45,11,Barnwell,1993,10754,9364,1390,12.9
45,13,Beaufort,1993,40051,38057,1994,5.0
45,15,Berkeley,1993,60269,56444,3825,6.3
45,17,Calhoun,1993,6214,5840,374,6.0
45,19,Charleston,1993,145312,135811,9501,6.5
45,21,Cherokee,1993,23741,22325,1416,6.0
45,23,Chester,1993,15898,13791,2107,13.3
45,25,Chesterfield,1993,20224,18600,1624,8.0
45,27,Clarendon,1993,12436,10697,1739,14.0
45,29,Colleton,1993,15880,14006,1874,11.8
45,31,Darlington,1993,32721,28711,4010,12.3
45,33,Dillon,1993,13727,12042,1685,12.3
45,35,Dorchester,1993,41641,39473,2168,5.2
45,37,Edgefield,1993,9159,8526,633,6.9
45,39,Fairfield,1993,11051,9855,1196,10.8
45,41,Florence,1993,61350,56057,5293,8.6
45,43,Georgetown,1993,23493,20442,3051,13.0
45,45,Greenville,1993,179767,170501,9266,5.2
45,47,Greenwood,1993,31898,29641,2257,7.1
45,49,Hampton,1993,8163,7342,821,10.1
45,51,Horry,1993,83000,75417,7583,9.1
45,53,Jasper,1993,6968,6485,483,6.9
45,55,Kershaw,1993,23761,21167,2594,10.9
45,57,Lancaster,1993,29917,27161,2756,9.2
45,59,Laurens,1993,30772,28848,1924,6.3
45,61,Lee,1993,8548,7538,1010,11.8
45,63,Lexington,1993,101003,96302,4701,4.7
45,65,McCormick,1993,3842,3469,373,9.7
45,67,Marion,1993,17132,14826,2306,13.5
45,69,Marlboro,1993,12622,10947,1675,13.3
45,71,Newberry,1993,17555,16261,1294,7.4
45,73,Oconee,1993,28562,26075,2487,8.7
45,75,Orangeburg,1993,40753,36570,4183,10.3
45,77,Pickens,1993,52261,49438,2823,5.4
45,79,Richland,1993,149682,140830,8852,5.9
45,81,Saluda,1993,8647,8039,608,7.0
45,83,Spartanburg,1993,123782,117448,6334,5.1
45,85,Sumter,1993,44712,40816,3896,8.7
45,87,Union,1993,16086,14616,1470,9.1
45,89,Williamsburg,1993,17408,14826,2582,14.8
45,91,York,1993,77411,72494,4917,6.4
46,3,Aurora,1993,1311,1261,50,3.8
46,5,Beadle,1993,9096,8833,263,2.9
46,7,Bennett,1993,1017,965,52,5.1
46,9,Bon Homme,1993,3003,2928,75,2.5
46,11,Brookings,1993,14421,14119,302,2.1
46,13,Brown,1993,19773,19290,483,2.4
46,15,Brule,1993,2747,2643,104,3.8
46,17,Buffalo,1993,737,684,53,7.2
46,19,Butte,1993,3541,3363,178,5.0
46,21,Campbell,1993,915,885,30,3.3
46,23,Charles Mix,1993,4485,4314,171,3.8
46,25,Clark,1993,1845,1758,87,4.7
46,27,Clay,1993,6686,6592,94,1.4
46,29,Codington,1993,13111,12586,525,4.0
46,31,Corson,1993,1736,1350,386,22.2
46,33,Custer,1993,3532,3363,169,4.8
46,35,Davison,1993,9267,8984,283,3.1
46,37,Day,1993,3015,2885,130,4.3
46,39,Deuel,1993,2208,2110,98,4.4
46,41,Dewey,1993,2115,1853,262,12.4
46,43,Douglas,1993,1467,1421,46,3.1
46,45,Edmunds,1993,2101,2065,36,1.7
46,47,Fall River,1993,3326,3198,128,3.8
46,49,Faulk,1993,1206,1175,31,2.6
46,51,Grant,1993,4060,3848,212,5.2
46,53,Gregory,1993,2525,2428,97,3.8
46,55,Haakon,1993,1169,1115,54,4.6
46,57,Hamlin,1993,2321,2222,99,4.3
46,59,Hand,1993,2132,2074,58,2.7
46,61,Hanson,1993,1542,1494,48,3.1
46,63,Harding,1993,780,746,34,4.4
46,65,Hughes,1993,9524,9255,269,2.8
46,67,Hutchinson,1993,3763,3670,93,2.5
46,69,Hyde,1993,766,742,24,3.1
46,71,Jackson,1993,1043,977,66,6.3
46,73,Jerauld,1993,1077,1037,40,3.7
46,75,Jones,1993,772,739,33,4.3
46,77,Kingsbury,1993,2597,2496,101,3.9
46,79,Lake,1993,5609,5403,206,3.7
46,81,Lawrence,1993,12053,11662,391,3.2
46,83,Lincoln,1993,9160,8970,190,2.1
46,85,Lyman,1993,2262,2154,108,4.8
46,87,McCook,1993,2546,2467,79,3.1
46,89,McPherson,1993,1402,1373,29,2.1
46,91,Marshall,1993,2250,2181,69,3.1
46,93,Meade,1993,11589,11137,452,3.9
46,95,Mellette,1993,792,736,56,7.1
46,97,Miner,1993,1373,1299,74,5.4
46,99,Minnehaha,1993,76993,75127,1866,2.4
46,101,Moody,1993,3324,3108,216,6.5
46,102,Oglala Lakota,1993,2886,2436,450,15.6
46,103,Pennington,1993,42976,41388,1588,3.7
46,105,Perkins,1993,2005,1951,54,2.7
46,107,Potter,1993,1479,1428,51,3.4
46,109,Roberts,1993,4721,4468,253,5.4
46,111,Sanborn,1993,1368,1320,48,3.5
46,115,Spink,1993,3406,3305,101,3.0
46,117,Stanley,1993,1592,1536,56,3.5
46,119,Sully,1993,914,890,24,2.6
46,121,Todd,1993,2480,2254,226,9.1
46,123,Tripp,1993,3331,3217,114,3.4
46,125,Turner,1993,3799,3662,137,3.6
46,127,Union,1993,6279,5992,287,4.6
46,129,Walworth,1993,2928,2826,102,3.5
46,135,Yankton,1993,10221,10004,217,2.1
46,137,Ziebach,1993,700,647,53,7.6
47,1,Anderson,1993,35544,33780,1764,5.0
47,3,Bedford,1993,16183,15207,976,6.0
47,5,Benton,1993,7133,6537,596,8.4
47,7,Bledsoe,1993,3476,3216,260,7.5
47,9,Blount,1993,47046,44314,2732,5.8
47,11,Bradley,1993,39251,36669,2582,6.6
47,13,Campbell,1993,14396,12776,1620,11.3
47,15,Cannon,1993,5234,4893,341,6.5
47,17,Carroll,1993,13608,12738,870,6.4
47,19,Carter,1993,25279,23636,1643,6.5
47,21,Cheatham,1993,15452,14912,540,3.5
47,23,Chester,1993,6519,6235,284,4.4
47,25,Claiborne,1993,11769,11053,716,6.1
47,27,Clay,1993,3535,3272,263,7.4
47,29,Cocke,1993,14968,13110,1858,12.4
47,31,Coffee,1993,20319,19106,1213,6.0
47,33,Crockett,1993,6923,6371,552,8.0
47,35,Cumberland,1993,16528,15081,1447,8.8
47,37,Davidson,1993,284198,272837,11361,4.0
47,39,Decatur,1993,5008,4630,378,7.5
47,41,DeKalb,1993,7685,7125,560,7.3
47,43,Dickson,1993,18067,17162,905,5.0
47,45,Dyer,1993,16758,15497,1261,7.5
47,47,Fayette,1993,11473,10636,837,7.3
47,49,Fentress,1993,7182,6442,740,10.3
47,51,Franklin,1993,16844,15883,961,5.7
47,53,Gibson,1993,22312,20702,1610,7.2
47,55,Giles,1993,13672,12999,673,4.9
47,57,Grainger,1993,8684,8010,674,7.8
47,59,Greene,1993,28252,25471,2781,9.8
47,61,Grundy,1993,4708,4154,554,11.8
47,63,Hamblen,1993,27491,25511,1980,7.2
47,65,Hamilton,1993,146107,139164,6943,4.8
47,67,Hancock,1993,2255,2029,226,10.0
47,69,Hardeman,1993,9462,8444,1018,10.8
47,71,Hardin,1993,11006,9674,1332,12.1
47,73,Hawkins,1993,22115,20839,1276,5.8
47,75,Haywood,1993,8498,7421,1077,12.7
47,77,Henderson,1993,11989,11180,809,6.7
47,79,Henry,1993,13719,12790,929,6.8
47,81,Hickman,1993,8083,7432,651,8.1
47,83,Houston,1993,3200,2806,394,12.3
47,85,Humphreys,1993,7136,6276,860,12.1
47,87,Jackson,1993,4195,3800,395,9.4
47,89,Jefferson,1993,18775,17084,1691,9.0
47,91,Johnson,1993,7203,6716,487,6.8
47,93,Knox,1993,189257,181767,7490,4.0
47,95,Lake,1993,2858,2698,160,5.6
47,97,Lauderdale,1993,9316,7915,1401,15.0
47,99,Lawrence,1993,20078,18782,1296,6.5
47,101,Lewis,1993,4639,4230,409,8.8
47,103,Lincoln,1993,14286,13314,972,6.8
47,105,Loudon,1993,17767,16930,837,4.7
47,107,McMinn,1993,20298,18707,1591,7.8
47,109,McNairy,1993,11232,10281,951,8.5
47,111,Macon,1993,8854,8408,446,5.0
47,113,Madison,1993,40757,38498,2259,5.5
47,115,Marion,1993,12077,11162,915,7.6
47,117,Marshall,1993,11904,11330,574,4.8
47,119,Maury,1993,33065,31203,1862,5.6
47,121,Meigs,1993,3979,3531,448,11.3
47,123,Monroe,1993,15217,13725,1492,9.8
47,125,Montgomery,1993,44944,42472,2472,5.5
47,127,Moore,1993,2735,2629,106,3.9
47,129,Morgan,1993,6124,5520,604,9.9
47,131,Obion,1993,14197,13170,1027,7.2
47,133,Overton,1993,8830,7944,886,10.0
47,135,Perry,1993,2965,2745,220,7.4
47,137,Pickett,1993,2024,1874,150,7.4
47,139,Polk,1993,6297,5784,513,8.1
47,141,Putnam,1993,27564,25732,1832,6.6
47,143,Rhea,1993,11070,9950,1120,10.1
47,145,Roane,1993,28154,26530,1624,5.8
47,147,Robertson,1993,23224,21750,1474,6.3
47,149,Rutherford,1993,73104,69989,3115,4.3
47,151,Scott,1993,7771,6596,1175,15.1
47,153,Sequatchie,1993,4756,4381,375,7.9
47,155,Sevier,1993,31226,28443,2783,8.9
47,157,Shelby,1993,401839,379568,22271,5.5
47,159,Smith,1993,8332,7931,401,4.8
47,161,Stewart,1993,4107,3717,390,9.5
47,163,Sullivan,1993,72881,69237,3644,5.0
47,165,Sumner,1993,58612,55657,2955,5.0
47,167,Tipton,1993,17970,16828,1142,6.4
47,169,Trousdale,1993,2933,2754,179,6.1
47,171,Unicoi,1993,7966,7175,791,9.9
47,173,Union,1993,6714,6438,276,4.1
47,175,Van Buren,1993,2446,2255,191,7.8
47,177,Warren,1993,18658,17303,1355,7.3
47,179,Washington,1993,49231,46386,2845,5.8
47,181,Wayne,1993,7511,6953,558,7.4
47,183,Weakley,1993,18101,17558,543,3.0
47,185,White,1993,9942,9102,840,8.4
47,187,Williamson,1993,48892,47465,1427,2.9
47,189,Wilson,1993,38578,36995,1583,4.1
48,1,Anderson,1993,18585,17416,1169,6.3
48,3,Andrews,1993,6047,5590,457,7.6
48,5,Angelina,1993,34306,31544,2762,8.1
48,7,Aransas,1993,8296,7805,491,5.9
48,9,Archer,1993,3866,3729,137,3.5
48,11,Armstrong,1993,1002,962,40,4.0
48,13,Atascosa,1993,14943,14008,935,6.3
48,15,Austin,1993,10191,9780,411,4.0
48,17,Bailey,1993,3882,3627,255,6.6
48,19,Bandera,1993,6438,6236,202,3.1
48,21,Bastrop,1993,20570,19838,732,3.6
48,23,Baylor,1993,1843,1769,74,4.0
48,25,Bee,1993,10118,8772,1346,13.3
48,27,Bell,1993,84196,79202,4994,5.9
48,29,Bexar,1993,602250,568432,33818,5.6
48,31,Blanco,1993,3120,3013,107,3.4
48,33,Borden,1993,402,390,12,3.0
48,35,Bosque,1993,6410,5990,420,6.6
48,37,Bowie,1993,39675,35967,3708,9.3
48,39,Brazoria,1993,104670,96590,8080,7.7
48,41,Brazos,1993,66516,64729,1787,2.7
48,43,Brewster,1993,4473,4365,108,2.4
48,45,Briscoe,1993,978,946,32,3.3
48,47,Brooks,1993,3346,2981,365,10.9
48,49,Brown,1993,15842,14536,1306,8.2
48,51,Burleson,1993,7184,6838,346,4.8
48,53,Burnet,1993,10257,9748,509,5.0
48,55,Caldwell,1993,12682,12177,505,4.0
48,57,Calhoun,1993,10224,9137,1087,10.6
48,59,Callahan,1993,5792,5491,301,5.2
48,61,Cameron,1993,117748,101798,15950,13.5
48,63,Camp,1993,4977,4474,503,10.1
48,65,Carson,1993,3583,3447,136,3.8
48,67,Cass,1993,14413,12862,1551,10.8
48,69,Castro,1993,4249,3946,303,7.1
48,71,Chambers,1993,10319,9490,829,8.0
48,73,Cherokee,1993,18813,17499,1314,7.0
48,75,Childress,1993,3077,2923,154,5.0
48,77,Clay,1993,4725,4513,212,4.5
48,79,Cochran,1993,1883,1697,186,9.9
48,81,Coke,1993,1408,1359,49,3.5
48,83,Coleman,1993,3783,3555,228,6.0
48,85,Collin,1993,182469,174781,7688,4.2
48,87,Collingsworth,1993,1796,1694,102,5.7
48,89,Colorado,1993,8440,8106,334,4.0
48,91,Comal,1993,29286,27791,1495,5.1
48,93,Comanche,1993,6397,6092,305,4.8
48,95,Concho,1993,1443,1398,45,3.1
48,97,Cooke,1993,15241,14204,1037,6.8
48,99,Coryell,1993,19228,18217,1011,5.3
48,101,Cottle,1993,902,829,73,8.1
48,103,Crane,1993,2220,2063,157,7.1
48,105,Crockett,1993,1903,1808,95,5.0
48,107,Crosby,1993,3341,3095,246,7.4
48,109,Culberson,1993,1407,1308,99,7.0
48,111,Dallam,1993,3085,2995,90,2.9
48,113,Dallas,1993,1100640,1028104,72536,6.6
48,115,Dawson,1993,6084,5630,454,7.5
48,117,Deaf Smith,1993,9274,8540,734,7.9
48,119,Delta,1993,2203,2084,119,5.4
48,121,Denton,1993,184147,176472,7675,4.2
48,123,DeWitt,1993,8045,7606,439,5.5
48,125,Dickens,1993,1022,957,65,6.4
48,127,Dimmit,1993,3728,3018,710,19.0
48,129,Donley,1993,1531,1475,56,3.7
48,131,Duval,1993,4579,3963,616,13.5
48,133,Eastland,1993,7954,7518,436,5.5
48,135,Ector,1993,59952,54401,5551,9.3
48,137,Edwards,1993,951,879,72,7.6
48,139,Ellis,1993,45819,42771,3048,6.7
48,141,El Paso,1993,278727,248582,30145,10.8
48,143,Erath,1993,15053,14356,697,4.6
48,145,Falls,1993,7369,6970,399,5.4
48,147,Fannin,1993,11147,10298,849,7.6
48,149,Fayette,1993,10118,9821,297,2.9
48,151,Fisher,1993,2021,1888,133,6.6
48,153,Floyd,1993,3588,3346,242,6.7
48,155,Foard,1993,1058,1037,21,2.0
48,157,Fort Bend,1993,140983,134150,6833,4.8
48,159,Franklin,1993,3725,3427,298,8.0
48,161,Freestone,1993,7496,6911,585,7.8
48,163,Frio,1993,6962,6131,831,11.9
48,165,Gaines,1993,6870,6512,358,5.2
48,167,Galveston,1993,124915,114137,10778,8.6
48,169,Garza,1993,2400,2254,146,6.1
48,171,Gillespie,1993,9377,9171,206,2.2
48,173,Glasscock,1993,600,583,17,2.8
48,175,Goliad,1993,2752,2585,167,6.1
48,177,Gonzales,1993,7626,7257,369,4.8
48,179,Gray,1993,11241,10628,613,5.5
48,181,Grayson,1993,46197,42764,3433,7.4
48,183,Gregg,1993,56620,51051,5569,9.8
48,185,Grimes,1993,8117,7692,425,5.2
48,187,Guadalupe,1993,34608,33355,1253,3.6
48,189,Hale,1993,16999,16030,969,5.7
48,191,Hall,1993,1911,1781,130,6.8
48,193,Hamilton,1993,3784,3620,164,4.3
48,195,Hansford,1993,2543,2457,86,3.4
48,197,Hardeman,1993,2064,1955,109,5.3
48,199,Hardin,1993,21763,19609,2154,9.9
48,201,Harris,1993,1636018,1511310,124708,7.6
48,203,Harrison,1993,26933,24193,2740,10.2
48,205,Hartley,1993,2100,2054,46,2.2
48,207,Haskell,1993,2945,2797,148,5.0
48,209,Hays,1993,38036,36796,1240,3.3
48,211,Hemphill,1993,1875,1780,95,5.1
48,213,Henderson,1993,25819,23890,1929,7.5
48,215,Hidalgo,1993,176427,139892,36535,20.7
48,217,Hill,1993,13036,12091,945,7.2
48,219,Hockley,1993,11836,11242,594,5.0
48,221,Hood,1993,14539,12769,1770,12.2
48,223,Hopkins,1993,15560,14465,1095,7.0
48,225,Houston,1993,8386,7916,470,5.6
48,227,Howard,1993,14005,13263,742,5.3
48,229,Hudspeth,1993,1378,1332,46,3.3
48,231,Hunt,1993,32846,30264,2582,7.9
48,233,Hutchinson,1993,10643,9708,935,8.8
48,235,Irion,1993,943,911,32,3.4
48,237,Jack,1993,3342,3201,141,4.2
48,239,Jackson,1993,6913,6600,313,4.5
48,241,Jasper,1993,14720,12649,2071,14.1
48,243,Jeff Davis,1993,1029,980,49,4.8
48,245,Jefferson,1993,120956,108326,12630,10.4
48,247,Jim Hogg,1993,1924,1747,177,9.2
48,249,Jim Wells,1993,16173,14586,1587,9.8
48,251,Johnson,1993,50995,47993,3002,5.9
48,253,Jones,1993,9001,8639,362,4.0
48,255,Karnes,1993,5067,4732,335,6.6
48,257,Kaufman,1993,26617,24973,1644,6.2
48,259,Kendall,1993,8954,8745,209,2.3
48,261,Kenedy,1993,228,222,6,2.6
48,263,Kent,1993,432,413,19,4.4
48,265,Kerr,1993,16619,15978,641,3.9
48,267,Kimble,1993,2279,2209,70,3.1
48,269,King,1993,156,149,7,4.5
48,271,Kinney,1993,1175,1074,101,8.6
48,273,Kleberg,1993,13489,12589,900,6.7
48,275,Knox,1993,2383,2297,86,3.6
48,277,Lamar,1993,21889,20162,1727,7.9
48,279,Lamb,1993,6745,6311,434,6.4
48,281,Lampasas,1993,6619,6246,373,5.6
48,283,La Salle,1993,2646,2418,228,8.6
48,285,Lavaca,1993,8888,8668,220,2.5
48,287,Lee,1993,7124,6878,246,3.5
48,289,Leon,1993,5406,4925,481,8.9
48,291,Liberty,1993,25029,22187,2842,11.4
48,293,Limestone,1993,9330,8808,522,5.6
48,295,Lipscomb,1993,1378,1343,35,2.5
48,297,Live Oak,1993,5261,5016,245,4.7
48,299,Llano,1993,4501,4324,177,3.9
48,301,Loving,1993,58,57,1,1.7
48,303,Lubbock,1993,116728,111235,5493,4.7
48,305,Lynn,1993,2925,2814,111,3.8
48,307,McCulloch,1993,3721,3470,251,6.7
48,309,McLennan,1993,95174,89705,5469,5.7
48,311,McMullen,1993,312,299,13,4.2
48,313,Madison,1993,4026,3824,202,5.0
48,315,Marion,1993,3972,3510,462,11.6
48,317,Martin,1993,1968,1913,55,2.8
48,319,Mason,1993,1599,1543,56,3.5
48,321,Matagorda,1993,17879,15206,2673,15.0
48,323,Maverick,1993,17286,12119,5167,29.9
48,325,Medina,1993,13189,12529,660,5.0
48,327,Menard,1993,1022,985,37,3.6
48,329,Midland,1993,58321,54407,3914,6.7
48,331,Milam,1993,10244,9564,680,6.6
48,333,Mills,1993,2109,2033,76,3.6
48,335,Mitchell,1993,3208,2986,222,6.9
48,337,Montague,1993,7713,7209,504,6.5
48,339,Montgomery,1993,106216,99931,6285,5.9
48,341,Moore,1993,8755,8427,328,3.7
48,343,Morris,1993,5912,5279,633,10.7
48,345,Motley,1993,791,760,31,3.9
48,347,Nacogdoches,1993,26494,25199,1295,4.9
48,349,Navarro,1993,19325,17807,1518,7.9
48,351,Newton,1993,5708,4948,760,13.3
48,353,Nolan,1993,7751,7142,609,7.9
48,355,Nueces,1993,143339,130487,12852,9.0
48,357,Ochiltree,1993,4483,4298,185,4.1
48,359,Oldham,1993,1163,1093,70,6.0
48,361,Orange,1993,43158,36729,6429,14.9
48,363,Palo Pinto,1993,12068,10892,1176,9.7
48,365,Panola,1993,8277,7434,843,10.2
48,367,Parker,1993,34497,32449,2048,5.9
48,369,Parmer,1993,4409,4213,196,4.4
48,371,Pecos,1993,6637,6126,511,7.7
48,373,Polk,1993,13469,12303,1166,8.7
48,375,Potter,1993,49730,46925,2805,5.6
48,377,Presidio,1993,3405,2261,1144,33.6
48,379,Rains,1993,3120,2936,184,5.9
48,381,Randall,1993,53435,51689,1746,3.3
48,383,Reagan,1993,1970,1859,111,5.6
48,385,Real,1993,1147,1069,78,6.8
48,387,Red River,1993,5933,5467,466,7.9
48,389,Reeves,1993,7020,6007,1013,14.4
48,391,Refugio,1993,3280,3081,199,6.1
48,393,Roberts,1993,551,533,18,3.3
48,395,Robertson,1993,6735,6297,438,6.5
48,397,Rockwall,1993,16683,16013,670,4.0
48,399,Runnels,1993,5365,5101,264,4.9
48,401,Rusk,1993,20971,19274,1697,8.1
48,403,Sabine,1993,3606,3190,416,11.5
48,405,San Augustine,1993,3145,2926,219,7.0
48,407,San Jacinto,1993,7486,7099,387,5.2
48,409,San Patricio,1993,27342,24765,2577,9.4
48,411,San Saba,1993,2237,2137,100,4.5
48,413,Schleicher,1993,1329,1245,84,6.3
48,415,Scurry,1993,7866,7367,499,6.3
48,417,Shackelford,1993,1533,1470,63,4.1
48,419,Shelby,1993,9714,8920,794,8.2
48,421,Sherman,1993,1403,1363,40,2.9
48,423,Smith,1993,80663,74899,5764,7.1
48,425,Somervell,1993,2584,2130,454,17.6
48,427,Starr,1993,20188,14106,6082,30.1
48,429,Stephens,1993,3940,3660,280,7.1
48,431,Sterling,1993,761,730,31,4.1
48,433,Stonewall,1993,814,753,61,7.5
48,435,Sutton,1993,2130,2028,102,4.8
48,437,Swisher,1993,4104,3914,190,4.6
48,439,Tarrant,1993,688741,644774,43967,6.4
48,441,Taylor,1993,57778,54537,3241,5.6
48,443,Terrell,1993,593,555,38,6.4
48,445,Terry,1993,6050,5622,428,7.1
48,447,Throckmorton,1993,914,894,20,2.2
48,449,Titus,1993,11763,10689,1074,9.1
48,451,Tom Green,1993,49114,46563,2551,5.2
48,453,Travis,1993,380637,365668,14969,3.9
48,455,Trinity,1993,4874,4563,311,6.4
48,457,Tyler,1993,7058,6294,764,10.8
48,459,Upshur,1993,15116,14015,1101,7.3
48,461,Upton,1993,1909,1802,107,5.6
48,463,Uvalde,1993,10377,9095,1282,12.4
48,465,Val Verde,1993,17450,15235,2215,12.7
48,467,Van Zandt,1993,18196,17053,1143,6.3
48,469,Victoria,1993,40709,38428,2281,5.6
48,471,Walker,1993,20726,20059,667,3.2
48,473,Waller,1993,11140,10605,535,4.8
48,475,Ward,1993,4781,4332,449,9.4
48,477,Washington,1993,13578,13157,421,3.1
48,479,Webb,1993,64564,57733,6831,10.6
48,481,Wharton,1993,19404,17982,1422,7.3
48,483,Wheeler,1993,2669,2548,121,4.5
48,485,Wichita,1993,57857,54518,3339,5.8
48,487,Wilbarger,1993,7261,6992,269,3.7
48,489,Willacy,1993,7385,5689,1696,23.0
48,491,Williamson,1993,93991,91527,2464,2.6
48,493,Wilson,1993,11497,11095,402,3.5
48,495,Winkler,1993,3355,3039,316,9.4
48,497,Wise,1993,17926,16992,934,5.2
48,499,Wood,1993,14232,13322,910,6.4
48,501,Yoakum,1993,3837,3571,266,6.9
48,503,Young,1993,8904,8270,634,7.1
48,505,Zapata,1993,3620,3016,604,16.7
48,507,Zavala,1993,4723,3575,1148,24.3
49,1,Beaver,1993,2126,2026,100,4.7
49,3,Box Elder,1993,17418,16509,909,5.2
49,5,Cache,1993,38586,37396,1190,3.1
49,7,Carbon,1993,8992,8333,659,7.3
49,9,Daggett,1993,396,381,15,3.8
49,11,Davis,1993,99845,96187,3658,3.7
49,13,Duchesne,1993,5733,5242,491,8.6
49,15,Emery,1993,4122,3787,335,8.1
49,17,Garfield,1993,2342,2113,229,9.8
49,19,Grand,1993,4640,4344,296,6.4
49,21,Iron,1993,11136,10715,421,3.8
49,23,Juab,1993,3256,3057,199,6.1
49,25,Kane,1993,2514,2341,173,6.9
49,27,Millard,1993,4695,4444,251,5.3
49,29,Morgan,1993,2959,2798,161,5.4
49,31,Piute,1993,468,441,27,5.8
49,33,Rich,1993,789,765,24,3.0
49,35,Salt Lake,1993,419359,404435,14924,3.6
49,37,San Juan,1993,5070,4707,363,7.2
49,39,Sanpete,1993,7141,6688,453,6.3
49,41,Sevier,1993,7098,6714,384,5.4
49,43,Summit,1993,10311,9790,521,5.1
49,45,Tooele,1993,12109,11444,665,5.5
49,47,Uintah,1993,9987,9260,727,7.3
49,49,Utah,1993,136204,131345,4859,3.6
49,51,Wasatch,1993,5064,4749,315,6.2
49,53,Washington,1993,26094,25147,947,3.6
49,55,Wayne,1993,1083,1003,80,7.4
49,57,Weber,1993,87465,82986,4479,5.1
50,1,Addison,1993,18413,17247,1166,6.3
50,3,Bennington,1993,18783,17876,907,4.8
50,5,Caledonia,1993,14812,13779,1033,7.0
50,7,Chittenden,1993,81152,78081,3071,3.8
50,9,Essex,1993,2864,2639,225,7.9
50,11,Franklin,1993,22130,20800,1330,6.0
50,13,Grand Isle,1993,3063,2824,239,7.8
50,15,Lamoille,1993,11042,10245,797,7.2
50,17,Orange,1993,14594,13987,607,4.2
50,19,Orleans,1993,12364,11285,1079,8.7
50,21,Rutland,1993,32348,30365,1983,6.1
50,23,Washington,1993,30502,28826,1676,5.5
50,25,Windham,1993,22864,21954,910,4.0
50,27,Windsor,1993,29438,28109,1329,4.5
51,1,Accomack,1993,15590,14219,1371,8.8
51,3,Albemarle,1993,35899,34908,991,2.8
51,5,Alleghany,1993,8642,8029,613,7.1
51,7,Amelia,1993,4492,4207,285,6.3
51,9,Amherst,1993,14689,14055,634,4.3
51,11,Appomattox,1993,6250,5798,452,7.2
51,13,Arlington,1993,109430,104531,4899,4.5
51,15,Augusta,1993,29688,28292,1396,4.7
51,17,Bath,1993,2827,2565,262,9.3
51,19,Bedford,1993,30533,29323,1210,4.0
51,21,Bland,1993,3400,3172,228,6.7
51,23,Botetourt,1993,14862,14225,637,4.3
51,25,Brunswick,1993,7419,6832,587,7.9
51,27,Buchanan,1993,10807,9174,1633,15.1
51,29,Buckingham,1993,5733,5406,327,5.7
51,31,Campbell,1993,26623,25460,1163,4.4
51,33,Caroline,1993,10474,9534,940,9.0
51,35,Carroll,1993,14059,13238,821,5.8
51,36,Charles City,1993,3583,3287,296,8.3
51,37,Charlotte,1993,5738,5215,523,9.1
51,41,Chesterfield,1993,129511,124094,5417,4.2
51,43,Clarke,1993,6255,6048,207,3.3
51,45,Craig,1993,2440,2289,151,6.2
51,47,Culpeper,1993,14661,14058,603,4.1
51,49,Cumberland,1993,4073,3857,216,5.3
51,51,Dickenson,1993,6263,5300,963,15.4
51,53,Dinwiddie,1993,10466,9772,694,6.6
51,57,Essex,1993,4744,4415,329,6.9
51,59,Fairfax,1993,502766,485851,16915,3.4
51,61,Fauquier,1993,26968,26065,903,3.3
51,63,Floyd,1993,6375,5893,482,7.6
51,65,Fluvanna,1993,7303,7039,264,3.6
51,67,Franklin,1993,22029,21097,932,4.2
51,69,Frederick,1993,27965,26515,1450,5.2
51,71,Giles,1993,8383,7725,658,7.8
51,73,Gloucester,1993,16288,15548,740,4.5
51,75,Goochland,1993,7978,7633,345,4.3
51,77,Grayson,1993,8356,7928,428,5.1
51,79,Greene,1993,6534,6270,264,4.0
51,81,Greensville,1993,5264,4928,336,6.4
51,83,Halifax,1993,18815,17504,1311,7.0
51,85,Hanover,1993,38796,37477,1319,3.4
51,87,Henrico,1993,130767,125570,5197,4.0
51,89,Henry,1993,30420,28689,1731,5.7
51,91,Highland,1993,1337,1273,64,4.8
51,93,Isle of Wight,1993,13708,12830,878,6.4
51,95,James City,1993,20364,19785,579,2.8
51,97,King and Queen,1993,3069,2844,225,7.3
51,99,King George,1993,7556,7140,416,5.5
51,101,King William,1993,6135,5866,269,4.4
51,103,Lancaster,1993,5312,4513,799,15.0
51,105,Lee,1993,10023,8914,1109,11.1
51,107,Loudoun,1993,59906,57905,2001,3.3
51,109,Louisa,1993,10661,9728,933,8.8
51,111,Lunenburg,1993,4990,4541,449,9.0
51,113,Madison,1993,6290,6069,221,3.5
51,115,Mathews,1993,4269,4090,179,4.2
51,117,Mecklenburg,1993,14840,13942,898,6.1
51,119,Middlesex,1993,4240,4038,202,4.8
51,121,Montgomery,1993,36901,34913,1988,5.4
51,125,Nelson,1993,6524,6200,324,5.0
51,127,New Kent,1993,5923,5635,288,4.9
51,131,Northampton,1993,5664,5242,422,7.5
51,133,Northumberland,1993,5353,4615,738,13.8
51,135,Nottoway,1993,6368,5952,416,6.5
51,137,Orange,1993,11010,10423,587,5.3
51,139,Page,1993,11634,10771,863,7.4
51,141,Patrick,1993,9106,8763,343,3.8
51,143,Pittsylvania,1993,30445,28714,1731,5.7
51,145,Powhatan,1993,8494,8189,305,3.6
51,147,Prince Edward,1993,8510,7780,730,8.6
51,149,Prince George,1993,11990,11467,523,4.4
51,153,Prince William,1993,125188,120770,4418,3.5
51,155,Pulaski,1993,17450,15746,1704,9.8
51,157,Rappahannock,1993,3999,3833,166,4.2
51,159,Richmond,1993,3738,3425,313,8.4
51,161,Roanoke,1993,47637,45772,1865,3.9
51,163,Rockbridge,1993,9749,9003,746,7.7
51,165,Rockingham,1993,35424,34157,1267,3.6
51,167,Russell,1993,13069,11669,1400,10.7
51,169,Scott,1993,10112,9292,820,8.1
51,171,Shenandoah,1993,17280,16578,702,4.1
51,173,Smyth,1993,17851,15746,2105,11.8
51,175,Southampton,1993,7469,7061,408,5.5
51,177,Spotsylvania,1993,34237,32681,1556,4.5
51,179,Stafford,1993,37307,36064,1243,3.3
51,181,Surry,1993,3060,2717,343,11.2
51,183,Sussex,1993,4945,4536,409,8.3
51,185,Tazewell,1993,20552,17872,2680,13.0
51,187,Warren,1993,14559,13572,987,6.8
51,191,Washington,1993,25287,23585,1702,6.7
51,193,Westmoreland,1993,7474,6642,832,11.1
51,195,Wise,1993,16206,14096,2110,13.0
51,197,Wythe,1993,14512,13306,1206,8.3
51,199,York,1993,24164,23269,895,3.7
51,510,Alexandria city,1993,75592,71063,4529,6.0
51,520,Bristol city,1993,8781,8214,567,6.5
51,530,Buena Vista city,1993,3432,3009,423,12.3
51,540,Charlottesville city,1993,20102,19452,650,3.2
51,550,Chesapeake city,1993,89510,85410,4100,4.6
51,570,Colonial Heights city,1993,8721,8248,473,5.4
51,580,Covington city,1993,3311,2977,334,10.1
51,590,Danville city,1993,26862,24602,2260,8.4
51,595,Emporia city,1993,2338,2140,198,8.5
51,600,Fairfax city,1993,12484,12191,293,2.3
51,610,Falls Church city,1993,5655,5411,244,4.3
51,620,Franklin city,1993,3819,3558,261,6.8
51,630,Fredericksburg city,1993,10927,10277,650,5.9
51,640,Galax city,1993,3330,3190,140,4.2
51,650,Hampton city,1993,66850,62625,4225,6.3
51,660,Harrisonburg city,1993,17478,16952,526,3.0
51,670,Hopewell city,1993,11287,10420,867,7.7
51,678,Lexington city,1993,2758,2622,136,4.9
51,680,Lynchburg city,1993,32120,30583,1537,4.8
51,683,Manassas city,1993,17937,17212,725,4.0
51,685,Manassas Park city,1993,3920,3831,89,2.3
51,690,Martinsville city,1993,7649,7075,574,7.5
51,700,Newport News city,1993,82756,77479,5277,6.4
51,710,Norfolk city,1993,91759,85581,6178,6.7
51,720,Norton city,1993,1623,1482,141,8.7
51,730,Petersburg city,1993,18316,16579,1737,9.5
51,735,Poquoson city,1993,5931,5742,189,3.2
51,740,Portsmouth city,1993,46873,43342,3531,7.5
51,750,Radford city,1993,6899,6443,456,6.6
51,760,Richmond city,1993,101159,94434,6725,6.6
51,770,Roanoke city,1993,50740,47793,2947,5.8
51,775,Salem city,1993,13294,12819,475,3.6
51,790,Staunton city,1993,11397,10882,515,4.5
51,800,Suffolk city,1993,25675,23946,1729,6.7
51,810,Virginia Beach city,1993,205032,195879,9153,4.5
51,820,Waynesboro city,1993,9008,8380,628,7.0
51,830,Williamsburg city,1993,5995,5357,638,10.6
51,840,Winchester city,1993,12946,12167,779,6.0
53,1,Adams,1993,8450,7135,1315,15.6
53,3,Asotin,1993,10285,9736,549,5.3
53,5,Benton,1993,68587,63726,4861,7.1
53,7,Chelan,1993,33126,29540,3586,10.8
53,9,Clallam,1993,23652,21265,2387,10.1
53,11,Clark,1993,136117,128139,7978,5.9
53,13,Columbia,1993,1529,1293,236,15.4
53,15,Cowlitz,1993,38676,34397,4279,11.1
53,17,Douglas,1993,17553,16079,1474,8.4
53,19,Ferry,1993,2839,2395,444,15.6
53,21,Franklin,1993,21840,19263,2577,11.8
53,23,Garfield,1993,1100,1030,70,6.4
53,25,Grant,1993,31388,27804,3584,11.4
53,27,Grays Harbor,1993,28177,23837,4340,15.4
53,29,Island,1993,24148,22831,1317,5.5
53,31,Jefferson,1993,9340,8556,784,8.4
53,33,King,1993,901812,852409,49403,5.5
53,35,Kitsap,1993,89263,83127,6136,6.9
53,37,Kittitas,1993,13805,12320,1485,10.8
53,39,Klickitat,1993,8251,7005,1246,15.1
53,41,Lewis,1993,27863,24755,3108,11.2
53,43,Lincoln,1993,4484,4202,282,6.3
53,45,Mason,1993,16806,15181,1625,9.7
53,47,Okanogan,1993,22011,19344,2667,12.1
53,49,Pacific,1993,8020,7043,977,12.2
53,51,Pend Oreille,1993,3835,3288,547,14.3
53,53,Pierce,1993,296637,273912,22725,7.7
53,55,San Juan,1993,5412,4994,418,7.7
53,57,Skagit,1993,43940,38944,4996,11.4
53,59,Skamania,1993,4121,3508,613,14.9
53,61,Snohomish,1993,275641,259105,16536,6.0
53,63,Spokane,1993,185375,174064,11311,6.1
53,65,Stevens,1993,15510,13901,1609,10.4
53,67,Thurston,1993,88505,82210,6295,7.1
53,69,Wahkiakum,1993,1657,1526,131,7.9
53,71,Walla Walla,1993,24928,23201,1727,6.9
53,73,Whatcom,1993,75010,69083,5927,7.9
53,75,Whitman,1993,17839,17416,423,2.4
53,77,Yakima,1993,112372,95966,16406,14.6
54,1,Barbour,1993,6285,5438,847,13.5
54,3,Berkeley,1993,30902,28512,2390,7.7
54,5,Boone,1993,8640,7135,1505,17.4
54,7,Braxton,1993,4914,4116,798,16.2
54,9,Brooke,1993,11596,10504,1092,9.4
54,11,Cabell,1993,42903,39420,3483,8.1
54,13,Calhoun,1993,3053,2476,577,18.9
54,15,Clay,1993,3177,2627,550,17.3
54,17,Doddridge,1993,2925,2632,293,10.0
54,19,Fayette,1993,17663,15252,2411,13.7
54,21,Gilmer,1993,2819,2525,294,10.4
54,23,Grant,1993,5043,4588,455,9.0
54,25,Greenbrier,1993,15421,13393,2028,13.2
54,27,Hampshire,1993,7678,7027,651,8.5
54,29,Hancock,1993,15291,13940,1351,8.8
54,31,Hardy,1993,6546,6242,304,4.6
54,33,Harrison,1993,31330,28200,3130,10.0
54,35,Jackson,1993,12034,10536,1498,12.4
54,37,Jefferson,1993,19149,18030,1119,5.8
54,39,Kanawha,1993,102041,94172,7869,7.7
54,41,Lewis,1993,7313,6398,915,12.5
54,43,Lincoln,1993,7108,6068,1040,14.6
54,45,Logan,1993,15098,12806,2292,15.2
54,47,McDowell,1993,8467,7267,1200,14.2
54,49,Marion,1993,24365,20592,3773,15.5
54,51,Marshall,1993,16611,14684,1927,11.6
54,53,Mason,1993,9731,8316,1415,14.5
54,55,Mercer,1993,28109,25742,2367,8.4
54,57,Mineral,1993,11356,10549,807,7.1
54,59,Mingo,1993,10616,9210,1406,13.2
54,61,Monongalia,1993,38991,35855,3136,8.0
54,63,Monroe,1993,5001,4574,427,8.5
54,65,Morgan,1993,5885,5512,373,6.3
54,67,Nicholas,1993,10559,8913,1646,15.6
54,69,Ohio,1993,24329,22445,1884,7.7
54,71,Pendleton,1993,3690,3526,164,4.4
54,73,Pleasants,1993,3255,2801,454,13.9
54,75,Pocahontas,1993,4154,3673,481,11.6
54,77,Preston,1993,12813,11342,1471,11.5
54,79,Putnam,1993,22774,21037,1737,7.6
54,81,Raleigh,1993,31301,27391,3910,12.5
54,83,Randolph,1993,12718,11280,1438,11.3
54,85,Ritchie,1993,4440,3755,685,15.4
54,87,Roane,1993,6029,5160,869,14.4
54,89,Summers,1993,4362,3886,476,10.9
54,91,Taylor,1993,6507,5634,873,13.4
54,93,Tucker,1993,3651,3152,499,13.7
54,95,Tyler,1993,4066,3672,394,9.7
54,97,Upshur,1993,9816,8695,1121,11.4
54,99,Wayne,1993,16728,15122,1606,9.6
54,101,Webster,1993,3218,2657,561,17.4
54,103,Wetzel,1993,7663,6650,1013,13.2
54,105,Wirt,1993,2037,1718,319,15.7
54,107,Wood,1993,43190,39533,3657,8.5
54,109,Wyoming,1993,8742,7220,1522,17.4
55,1,Adams,1993,7004,6628,376,5.4
55,3,Ashland,1993,7980,7364,616,7.7
55,5,Barron,1993,23160,21659,1501,6.5
55,7,Bayfield,1993,7124,6614,510,7.2
55,9,Brown,1993,117723,113051,4672,4.0
55,11,Buffalo,1993,7566,7221,345,4.6
55,13,Burnett,1993,6199,5802,397,6.4
55,15,Calumet,1993,23047,21982,1065,4.6
55,17,Chippewa,1993,27484,25834,1650,6.0
55,19,Clark,1993,15807,14734,1073,6.8
55,21,Columbia,1993,26365,24848,1517,5.8
55,23,Crawford,1993,8968,8500,468,5.2
55,25,Dane,1993,239876,235114,4762,2.0
55,27,Dodge,1993,42073,40247,1826,4.3
55,29,Door,1993,14559,13426,1133,7.8
55,31,Douglas,1993,21141,19718,1423,6.7
55,33,Dunn,1993,21120,20203,917,4.3
55,35,Eau Claire,1993,46227,43980,2247,4.9
55,37,Florence,1993,1559,1437,122,7.8
55,39,Fond du Lac,1993,52055,50148,1907,3.7
55,41,Forest,1993,4349,4056,293,6.7
55,43,Grant,1993,25676,24535,1141,4.4
55,45,Green,1993,18160,17517,643,3.5
55,47,Green Lake,1993,10207,9617,590,5.8
55,49,Iowa,1993,12809,12301,508,4.0
55,51,Iron,1993,3281,3011,270,8.2
55,53,Jackson,1993,8961,8405,556,6.2
55,55,Jefferson,1993,39190,37474,1716,4.4
55,57,Juneau,1993,11043,10286,757,6.9
55,59,Kenosha,1993,72019,68667,3352,4.7
55,61,Kewaunee,1993,10423,9914,509,4.9
55,63,La Crosse,1993,56941,54661,2280,4.0
55,65,Lafayette,1993,8376,8073,303,3.6
55,67,Langlade,1993,9445,8827,618,6.5
55,69,Lincoln,1993,14811,13973,838,5.7
55,71,Manitowoc,1993,41822,39824,1998,4.8
55,73,Marathon,1993,67014,63851,3163,4.7
55,75,Marinette,1993,19763,18357,1406,7.1
55,77,Marquette,1993,6517,6055,462,7.1
55,78,Menominee,1993,1892,1722,170,9.0
55,79,Milwaukee,1993,476731,454901,21830,4.6
55,81,Monroe,1993,19040,18008,1032,5.4
55,83,Oconto,1993,14550,13467,1083,7.4
55,85,Oneida,1993,18280,17423,857,4.7
55,87,Outagamie,1993,91187,88289,2898,3.2
55,89,Ozaukee,1993,43779,42579,1200,2.7
55,91,Pepin,1993,3489,3312,177,5.1
55,93,Pierce,1993,19065,18267,798,4.2
55,95,Polk,1993,18579,17496,1083,5.8
55,97,Portage,1993,36982,35249,1733,4.7
55,99,Price,1993,7603,7167,436,5.7
55,101,Racine,1993,91346,86247,5099,5.6
55,103,Richland,1993,8425,8042,383,4.5
55,105,Rock,1993,75205,70853,4352,5.8
55,107,Rusk,1993,7122,6394,728,10.2
55,109,St. Croix,1993,29218,27997,1221,4.2
55,111,Sauk,1993,28400,26929,1471,5.2
55,113,Sawyer,1993,7839,7282,557,7.1
55,115,Shawano,1993,18325,17365,960,5.2
55,117,Sheboygan,1993,57635,55874,1761,3.1
55,119,Taylor,1993,10304,9579,725,7.0
55,121,Trempealeau,1993,13650,12726,924,6.8
55,123,Vernon,1993,13005,12311,694,5.3
55,125,Vilas,1993,9375,8910,465,5.0
55,127,Walworth,1993,49007,47663,1344,2.7
55,129,Washburn,1993,7010,6519,491,7.0
55,131,Washington,1993,59147,57187,1960,3.3
55,133,Waukesha,1993,187628,181502,6126,3.3
55,135,Waupaca,1993,25707,24612,1095,4.3
55,137,Waushara,1993,9471,8827,644,6.8
55,139,Winnebago,1993,91518,88273,3245,3.5
55,141,Wood,1993,39380,37460,1920,4.9
56,1,Albany,1993,15351,14943,408,2.7
56,3,Big Horn,1993,4877,4579,298,6.1
56,5,Campbell,1993,17224,16322,902,5.2
56,7,Carbon,1993,8376,7882,494,5.9
56,9,Converse,1993,6138,5798,340,5.5
56,11,Crook,1993,2901,2794,107,3.7
56,13,Fremont,1993,16336,15188,1148,7.0
56,15,Goshen,1993,6084,5817,267,4.4
56,17,Hot Springs,1993,2515,2380,135,5.4
56,19,Johnson,1993,3347,3193,154,4.6
56,21,Laramie,1993,37993,36487,1506,4.0
56,23,Lincoln,1993,6187,5709,478,7.7
56,25,Natrona,1993,31860,29568,2292,7.2
56,27,Niobrara,1993,1137,1097,40,3.5
56,29,Park,1993,13719,13172,547,4.0
56,31,Platte,1993,3982,3774,208,5.2
56,33,Sheridan,1993,13183,12588,595,4.5
56,35,Sublette,1993,2848,2749,99,3.5
56,37,Sweetwater,1993,21271,19993,1278,6.0
56,39,Teton,1993,9556,9324,232,2.4
56,41,Uinta,1993,10721,9810,911,8.5
56,43,Washakie,1993,4529,4218,311,6.9
56,45,Weston,1993,3214,3053,161,5.0
72,1,Adjuntas Municipio,1993,5296,4335,961,18.1
72,3,Aguada Municipio,1993,14554,11383,3171,21.8
72,5,Aguadilla Municipio,1993,21978,17062,4916,22.4
72,7,Aguas Buenas Municipio,1993,8110,6367,1743,21.5
72,9,Aibonito Municipio,1993,9619,7943,1676,17.4
72,11,Anasco Municipio,1993,10291,8151,2140,20.8
72,13,Arecibo Municipio,1993,29770,24158,5612,18.9
72,15,Arroyo Municipio,1993,5191,3918,1273,24.5
72,17,Barceloneta Municipio,1993,6774,5209,1565,23.1
72,19,Barranquitas Municipio,1993,6943,5928,1015,14.6
72,21,Bayamon Municipio,1993,82013,72135,9878,12.0
72,23,Cabo Rojo Municipio,1993,14099,11671,2428,17.2
72,25,Caguas Municipio,1993,54967,46670,8297,15.1
72,27,Camuy Municipio,1993,9639,7852,1787,18.5
72,29,Canovanas Municipio,1993,13191,10798,2393,18.1
72,31,Carolina Municipio,1993,74689,66302,8387,11.2
72,33,Catano Municipio,1993,10198,8674,1524,14.9
72,35,Cayey Municipio,1993,15337,12436,2901,18.9
72,37,Ceiba Municipio,1993,5328,4364,964,18.1
72,39,Ciales Municipio,1993,5397,4080,1317,24.4
72,41,Cidra Municipio,1993,11833,9777,2056,17.4
72,43,Coamo Municipio,1993,8815,6722,2093,23.7
72,45,Comerio Municipio,1993,5162,4280,882,17.1
72,47,Corozal Municipio,1993,9257,7682,1575,17.0
72,49,Culebra Municipio,1993,797,725,72,9.0
72,51,Dorado Municipio,1993,10427,8732,1695,16.3
72,53,Fajardo Municipio,1993,12959,10234,2725,21.0
72,54,Florida Municipio,1993,2852,2112,740,25.9
72,55,Guanica Municipio,1993,5142,3555,1587,30.9
72,57,Guayama Municipio,1993,11095,8222,2873,25.9
72,59,Guayanilla Municipio,1993,6517,4881,1636,25.1
72,61,Guaynabo Municipio,1993,37515,34328,3187,8.5
72,63,Gurabo Municipio,1993,10625,8827,1798,16.9
72,65,Hatillo Municipio,1993,10424,8234,2190,21.0
72,67,Hormigueros Municipio,1993,6637,5516,1121,16.9
72,69,Humacao Municipio,1993,18736,15185,3551,19.0
72,71,Isabela Municipio,1993,13175,10214,2961,22.5
72,73,Jayuya Municipio,1993,3788,3038,750,19.8
72,75,Juana Diaz Municipio,1993,13111,10181,2930,22.3
72,77,Juncos Municipio,1993,10029,7851,2178,21.7
72,79,Lajas Municipio,1993,8942,6812,2130,23.8
72,81,Lares Municipio,1993,8031,6271,1760,21.9
72,83,Las Marias Municipio,1993,3187,2470,717,22.5
72,85,Las Piedras Municipio,1993,9371,7611,1760,18.8
72,87,Loiza Municipio,1993,8552,7284,1268,14.8
72,89,Luquillo Municipio,1993,6524,4992,1532,23.5
72,91,Manati Municipio,1993,12945,10099,2846,22.0
72,93,Maricao Municipio,1993,2128,1717,411,19.3
72,95,Maunabo Municipio,1993,3032,2132,900,29.7
72,97,Mayaguez Municipio,1993,35453,29734,5719,16.1
72,99,Moca Municipio,1993,11632,9194,2438,21.0
72,101,Morovis Municipio,1993,8082,6370,1712,21.2
72,103,Naguabo Municipio,1993,6600,5160,1440,21.8
72,105,Naranjito Municipio,1993,6873,5646,1227,17.9
72,107,Orocovis Municipio,1993,5791,4530,1261,21.8
72,109,Patillas Municipio,1993,5792,4144,1648,28.5
72,111,Penuelas Municipio,1993,6695,4906,1789,26.7
72,113,Ponce Municipio,1993,60284,48438,11846,19.7
72,115,Quebradillas Municipio,1993,7369,6190,1179,16.0
72,117,Rincon Municipio,1993,5448,4541,907,16.6
72,119,Rio Grande Municipio,1993,15990,12903,3087,19.3
72,121,Sabana Grande Municipio,1993,8635,6920,1715,19.9
72,123,Salinas Municipio,1993,8291,5962,2329,28.1
72,125,San German Municipio,1993,13496,10524,2972,22.0
72,127,San Juan Municipio,1993,160428,141391,19037,11.9
72,129,San Lorenzo Municipio,1993,12053,9351,2702,22.4
72,131,San Sebastian Municipio,1993,13247,9718,3529,26.6
72,133,Santa Isabel Municipio,1993,5401,3429,1972,36.5
72,135,Toa Alta Municipio,1993,15589,13518,2071,13.3
72,137,Toa Baja Municipio,1993,34324,30350,3974,11.6
72,139,Trujillo Alto Municipio,1993,25099,22737,2362,9.4
72,141,Utuado Municipio,1993,8284,6643,1641,19.8
72,143,Vega Alta Municipio,1993,11029,9242,1787,16.2
72,145,Vega Baja Municipio,1993,17431,14396,3035,17.4
72,147,Vieques Municipio,1993,2658,2099,559,21.0
72,149,Villalba Municipio,1993,6633,4711,1922,29.0
72,151,Yabucoa Municipio,1993,11136,8478,2658,23.9
72,153,Yauco Municipio,1993,13078,10090,2988,22.8
1,1,Autauga,1994,18885,17940,945,5.0
1,3,Baldwin,1994,58092,55275,2817,4.8
1,5,Barbour,1994,12144,11366,778,6.4
1,7,Bibb,1994,7748,7152,596,7.7
1,9,Blount,1994,20334,19480,854,4.2
1,11,Bullock,1994,4277,3663,614,14.4
1,13,Butler,1994,9565,8705,860,9.0
1,15,Calhoun,1994,52488,48389,4099,7.8
1,17,Chambers,1994,17053,15655,1398,8.2
1,19,Cherokee,1994,10006,9382,624,6.2
1,21,Chilton,1994,16979,15803,1176,6.9
1,23,Choctaw,1994,7079,6284,795,11.2
1,25,Clarke,1994,13417,12201,1216,9.1
1,27,Clay,1994,6536,6166,370,5.7
1,29,Cleburne,1994,7346,7027,319,4.3
1,31,Coffee,1994,21294,20254,1040,4.9
1,33,Colbert,1994,26085,24098,1987,7.6
1,35,Conecuh,1994,6559,5958,601,9.2
1,37,Coosa,1994,5316,5031,285,5.4
1,39,Covington,1994,17310,16272,1038,6.0
1,41,Crenshaw,1994,5937,5584,353,5.9
1,43,Cullman,1994,36605,34730,1875,5.1
1,45,Dale,1994,21021,19391,1630,7.8
1,47,Dallas,1994,20664,18182,2482,12.0
1,49,DeKalb,1994,30274,28597,1677,5.5
1,51,Elmore,1994,25359,24152,1207,4.8
1,53,Escambia,1994,16096,14813,1283,8.0
1,55,Etowah,1994,47985,44794,3191,6.6
1,57,Fayette,1994,8823,8253,570,6.5
1,59,Franklin,1994,15581,14530,1051,6.7
1,61,Geneva,1994,12816,12153,663,5.2
1,63,Greene,1994,3704,3188,516,13.9
1,65,Hale,1994,7216,6530,686,9.5
1,67,Henry,1994,6416,5933,483,7.5
1,69,Houston,1994,42266,39735,2531,6.0
1,71,Jackson,1994,25392,22981,2411,9.5
1,73,Jefferson,1994,321285,306669,14616,4.5
1,75,Lamar,1994,7547,7073,474,6.3
1,77,Lauderdale,1994,41420,38797,2623,6.3
1,79,Lawrence,1994,15148,13954,1194,7.9
1,81,Lee,1994,45389,43459,1930,4.3
1,83,Limestone,1994,27369,25806,1563,5.7
1,85,Lowndes,1994,4225,3578,647,15.3
1,87,Macon,1994,8484,7737,747,8.8
1,89,Madison,1994,134299,126790,7509,5.6
1,91,Marengo,1994,10916,9860,1056,9.7
1,93,Marion,1994,14842,13772,1070,7.2
1,95,Marshall,1994,38287,35621,2666,7.0
1,97,Mobile,1994,190859,176899,13960,7.3
1,99,Monroe,1994,10244,9018,1226,12.0
1,101,Montgomery,1994,105610,100264,5346,5.1
1,103,Morgan,1994,52386,48870,3516,6.7
1,105,Perry,1994,4929,4188,741,15.0
1,107,Pickens,1994,9035,8267,768,8.5
1,109,Pike,1994,13238,12479,759,5.7
1,111,Randolph,1994,9845,9165,680,6.9
1,113,Russell,1994,23393,21987,1406,6.0
1,115,St. Clair,1994,26567,25499,1068,4.0
1,117,Shelby,1994,64630,62770,1860,2.9
1,119,Sumter,1994,6227,5445,782,12.6
1,121,Talladega,1994,35015,32243,2772,7.9
1,123,Tallapoosa,1994,20172,18901,1271,6.3
1,125,Tuscaloosa,1994,74975,71440,3535,4.7
1,127,Walker,1994,29750,27108,2642,8.9
1,129,Washington,1994,6487,5619,868,13.4
1,131,Wilcox,1994,3969,3361,608,15.3
1,133,Winston,1994,12348,11610,738,6.0
2,13,Aleutians East Borough,1994,1494,1451,43,2.9
2,16,Aleutians West Census Area,1994,2893,2824,69,2.4
2,20,Anchorage Borough/municipality,1994,133408,126020,7388,5.5
2,50,Bethel Census Area,1994,5396,4999,397,7.4
2,60,Bristol Bay Borough,1994,478,448,30,6.3
2,68,Denali Borough,1994,1083,984,99,9.1
2,70,Dillingham Census Area,1994,1612,1497,115,7.1
2,90,Fairbanks North Star Borough,1994,40707,37408,3299,8.1
2,100,Haines Borough,1994,1158,1040,118,10.2
2,110,Juneau Borough/city,1994,16175,15219,956,5.9
2,122,Kenai Peninsula Borough,1994,21018,18396,2622,12.5
2,130,Ketchikan Gateway Borough,1994,7662,7036,626,8.2
2,150,Kodiak Island Borough,1994,7660,6760,900,11.7
2,158,Kusilvak Census Area,1994,1817,1624,193,10.6
2,164,Lake and Peninsula Borough,1994,558,524,34,6.1
2,170,Matanuska-Susitna Borough,1994,24830,22230,2600,10.5
2,180,Nome Census Area,1994,3442,3029,413,12.0
2,185,North Slope Borough,1994,3179,3057,122,3.8
2,188,Northwest Arctic Borough,1994,2262,1912,350,15.5
2,201,Prince of Wales-Outer Ketchikan Census Area,1994,3193,2820,373,11.7
2,220,Sitka Borough/city,1994,4807,4328,479,10.0
2,232,Skagway-Hoonah-Angoon Census Area,1994,2312,2111,201,8.7
2,240,Southeast Fairbanks Census Area,1994,2453,2136,317,12.9
2,261,Valdez-Cordova Census Area,1994,5286,4770,516,9.8
2,280,Wrangell-Petersburg Census Area,1994,3666,3335,331,9.0
2,282,Yakutat Borough/city,1994,300,260,40,13.3
2,290,Yukon-Koyukuk Census Area,1994,1935,1621,314,16.2
4,1,Apache,1994,19758,16216,3542,17.9
4,3,Cochise,1994,43388,38870,4518,10.4
4,5,Coconino,1994,58364,53111,5253,9.0
4,7,Gila,1994,18964,17363,1601,8.4
4,9,Graham,1994,10740,9710,1030,9.6
4,11,Greenlee,1994,4134,3749,385,9.3
4,12,La Paz,1994,6108,5277,831,13.6
4,13,Maricopa,1994,1283037,1224442,58595,4.6
4,15,Mohave,1994,57657,52774,4883,8.5
4,17,Navajo,1994,32405,27562,4843,14.9
4,19,Pima,1994,375558,361040,14518,3.9
4,21,Pinal,1994,51219,48346,2873,5.6
4,23,Santa Cruz,1994,15324,12115,3209,20.9
4,25,Yavapai,1994,61701,58452,3249,5.3
4,27,Yuma,1994,66965,45975,20990,31.3
5,1,Arkansas,1994,10585,9940,645,6.1
5,3,Ashley,1994,11284,10579,705,6.2
5,5,Baxter,1994,14002,13472,530,3.8
5,7,Benton,1994,59145,57741,1404,2.4
5,9,Boone,1994,14707,14015,692,4.7
5,11,Bradley,1994,4942,4477,465,9.4
5,13,Calhoun,1994,2393,2158,235,9.8
5,15,Carroll,1994,12216,11622,594,4.9
5,17,Chicot,1994,6500,5944,556,8.6
5,19,Clark,1994,11486,11086,400,3.5
5,21,Clay,1994,8370,7846,524,6.3
5,23,Cleburne,1994,9125,8581,544,6.0
5,25,Cleveland,1994,3984,3732,252,6.3
5,27,Columbia,1994,11862,10989,873,7.4
5,29,Conway,1994,9389,8872,517,5.5
5,31,Craighead,1994,38966,37505,1461,3.7
5,33,Crawford,1994,23055,21815,1240,5.4
5,35,Crittenden,1994,22107,20788,1319,6.0
5,37,Cross,1994,8967,8322,645,7.2
5,39,Dallas,1994,3948,3577,371,9.4
5,41,Desha,1994,7304,6669,635,8.7
5,43,Drew,1994,9960,9334,626,6.3
5,45,Faulkner,1994,36948,35083,1865,5.0
5,47,Franklin,1994,7985,7678,307,3.8
5,49,Fulton,1994,4460,4203,257,5.8
5,51,Garland,1994,35107,32924,2183,6.2
5,53,Grant,1994,7068,6685,383,5.4
5,55,Greene,1994,17321,16355,966,5.6
5,57,Hempstead,1994,11183,10377,806,7.2
5,59,Hot Spring,1994,11801,11118,683,5.8
5,61,Howard,1994,6934,6596,338,4.9
5,63,Independence,1994,16520,15607,913,5.5
5,65,Izard,1994,4054,3766,288,7.1
5,67,Jackson,1994,8182,7328,854,10.4
5,69,Jefferson,1994,37243,33899,3344,9.0
5,71,Johnson,1994,10089,9645,444,4.4
5,73,Lafayette,1994,3635,3374,261,7.2
5,75,Lawrence,1994,7904,7398,506,6.4
5,77,Lee,1994,4869,4435,434,8.9
5,79,Lincoln,1994,5324,4979,345,6.5
5,81,Little River,1994,5740,5294,446,7.8
5,83,Logan,1994,10273,9789,484,4.7
5,85,Lonoke,1994,22307,21469,838,3.8
5,87,Madison,1994,6778,6545,233,3.4
5,89,Marion,1994,5672,5488,184,3.2
5,91,Miller,1994,17202,15861,1341,7.8
5,93,Mississippi,1994,27206,24022,3184,11.7
5,95,Monroe,1994,4456,4142,314,7.0
5,97,Montgomery,1994,3835,3681,154,4.0
5,99,Nevada,1994,4794,4494,300,6.3
5,101,Newton,1994,2980,2785,195,6.5
5,103,Ouachita,1994,12852,11231,1621,12.6
5,105,Perry,1994,3630,3331,299,8.2
5,107,Phillips,1994,11030,9894,1136,10.3
5,109,Pike,1994,4834,4542,292,6.0
5,111,Poinsett,1994,11059,10295,764,6.9
5,113,Polk,1994,8437,8101,336,4.0
5,115,Pope,1994,26107,24906,1201,4.6
5,117,Prairie,1994,4187,3902,285,6.8
5,119,Pulaski,1994,192353,184229,8124,4.2
5,121,Randolph,1994,7803,7275,528,6.8
5,123,St. Francis,1994,12506,11195,1311,10.5
5,125,Saline,1994,37628,36287,1341,3.6
5,127,Scott,1994,4998,4834,164,3.3
5,129,Searcy,1994,2958,2794,164,5.5
5,131,Sebastian,1994,55447,52753,2694,4.9
5,133,Sevier,1994,6976,6662,314,4.5
5,135,Sharp,1994,5772,5373,399,6.9
5,137,Stone,1994,5039,4777,262,5.2
5,139,Union,1994,21378,19880,1498,7.0
5,141,Van Buren,1994,6101,5598,503,8.2
5,143,Washington,1994,70561,68731,1830,2.6
5,145,White,1994,29222,27427,1795,6.1
5,147,Woodruff,1994,4081,3765,316,7.7
5,149,Yell,1994,9212,8844,368,4.0
6,1,Alameda,1994,679944,637748,42196,6.2
6,3,Alpine,1994,446,400,46,10.3
6,5,Amador,1994,12742,11692,1050,8.2
6,7,Butte,1994,82911,74285,8626,10.4
6,9,Calaveras,1994,14647,12987,1660,11.3
6,11,Colusa,1994,8210,6634,1576,19.2
6,13,Contra Costa,1994,451868,423567,28301,6.3
6,15,Del Norte,1994,10043,8817,1226,12.2
6,17,El Dorado,1994,70475,65353,5122,7.3
6,19,Fresno,1994,356626,305186,51440,14.4
6,21,Glenn,1994,11531,9657,1874,16.3
6,23,Humboldt,1994,59886,54659,5227,8.7
6,25,Imperial,1994,57646,42342,15304,26.5
6,27,Inyo,1994,7180,6416,764,10.6
6,29,Kern,1994,265826,225307,40519,15.2
6,31,Kings,1994,40969,35091,5878,14.3
6,33,Lake,1994,22469,19641,2828,12.6
6,35,Lassen,1994,11184,9902,1282,11.5
6,37,Los Angeles,1994,4295542,3899679,395863,9.2
6,39,Madera,1994,48501,40990,7511,15.5
6,41,Marin,1994,129265,123224,6041,4.7
6,43,Mariposa,1994,7247,6548,699,9.6
6,45,Mendocino,1994,40472,36540,3932,9.7
6,47,Merced,1994,83719,70059,13660,16.3
6,49,Modoc,1994,4273,3757,516,12.1
6,51,Mono,1994,6163,5520,643,10.4
6,53,Monterey,1994,175018,153154,21864,12.5
6,55,Napa,1994,57792,53760,4032,7.0
6,57,Nevada,1994,40989,37896,3093,7.5
6,59,Orange,1994,1333330,1256115,77215,5.8
6,61,Placer,1994,98548,91941,6607,6.7
6,63,Plumas,1994,9995,8549,1446,14.5
6,65,Riverside,1994,597407,533406,64001,10.7
6,67,Sacramento,1994,532774,493828,38946,7.3
6,69,San Benito,1994,22328,19178,3150,14.1
6,71,San Bernardino,1994,670910,612190,58720,8.8
6,73,San Diego,1994,1226829,1139017,87812,7.2
6,75,San Francisco/city,1994,401966,375886,26080,6.5
6,77,San Joaquin,1994,240239,209125,31114,13.0
6,79,San Luis Obispo,1994,99813,92546,7267,7.3
6,81,San Mateo,1994,369650,352094,17556,4.7
6,83,Santa Barbara,1994,195288,181015,14273,7.3
6,85,Santa Clara,1994,851909,797685,54224,6.4
6,87,Santa Cruz,1994,140714,126823,13891,9.9
6,89,Shasta,1994,72574,63706,8868,12.2
6,91,Sierra,1994,1779,1597,182,10.2
6,93,Siskiyou,1994,19413,16669,2744,14.1
6,95,Solano,1994,175053,161537,13516,7.7
6,97,Sonoma,1994,223907,210641,13266,5.9
6,99,Stanislaus,1994,193635,162614,31021,16.0
6,101,Sutter,1994,34059,28328,5731,16.8
6,103,Tehama,1994,23904,21176,2728,11.4
6,105,Trinity,1994,5278,4484,794,15.0
6,107,Tulare,1994,161587,134881,26706,16.5
6,109,Tuolumne,1994,20998,18648,2350,11.2
6,111,Ventura,1994,380330,349961,30369,8.0
6,113,Yolo,1994,86590,80613,5977,6.9
6,115,Yuba,1994,21994,18469,3525,16.0
8,1,Adams,1994,158494,151709,6785,4.3
8,3,Alamosa,1994,7544,7109,435,5.8
8,5,Arapahoe,1994,260958,252068,8890,3.4
8,7,Archuleta,1994,3293,3129,164,5.0
8,9,Baca,1994,2054,2002,52,2.5
8,11,Bent,1994,2249,2181,68,3.0
8,13,Boulder,1994,148378,142824,5554,3.7
8,14,Broomfield/city,1994,16732,16264,468,2.8
8,15,Chaffee,1994,6808,6504,304,4.5
8,17,Cheyenne,1994,1132,1108,24,2.1
8,19,Clear Creek,1994,4916,4682,234,4.8
8,21,Conejos,1994,3454,3161,293,8.5
8,23,Costilla,1994,1541,1370,171,11.1
8,25,Crowley,1994,1255,1198,57,4.5
8,27,Custer,1994,1330,1277,53,4.0
8,29,Delta,1994,10018,9440,578,5.8
8,31,Denver/city,1994,273932,260400,13532,4.9
8,33,Dolores,1994,690,632,58,8.4
8,35,Douglas,1994,52266,50978,1288,2.5
8,37,Eagle,1994,16597,16005,592,3.6
8,39,Elbert,1994,7457,7131,326,4.4
8,41,El Paso,1994,224269,213529,10740,4.8
8,43,Fremont,1994,16068,15163,905,5.6
8,45,Garfield,1994,19795,19003,792,4.0
8,47,Gilpin,1994,3062,2983,79,2.6
8,49,Grand,1994,5111,4949,162,3.2
8,51,Gunnison,1994,7572,7145,427,5.6
8,53,Hinsdale,1994,562,545,17,3.0
8,55,Huerfano,1994,3033,2829,204,6.7
8,57,Jackson,1994,985,915,70,7.1
8,59,Jefferson,1994,285985,276462,9523,3.3
8,61,Kiowa,1994,852,838,14,1.6
8,63,Kit Carson,1994,3315,3221,94,2.8
8,65,Lake,1994,3080,2893,187,6.1
8,67,La Plata,1994,22213,21279,934,4.2
8,69,Larimer,1994,123216,118814,4402,3.6
8,71,Las Animas,1994,6151,5850,301,4.9
8,73,Lincoln,1994,2526,2463,63,2.5
8,75,Logan,1994,9229,8955,274,3.0
8,77,Mesa,1994,51769,48905,2864,5.5
8,79,Mineral,1994,378,344,34,9.0
8,81,Moffat,1994,6358,5981,377,5.9
8,83,Montezuma,1994,11010,10272,738,6.7
8,85,Montrose,1994,14142,13440,702,5.0
8,87,Morgan,1994,12465,11969,496,4.0
8,89,Otero,1994,8618,8137,481,5.6
8,91,Ouray,1994,1561,1497,64,4.1
8,93,Park,1994,6566,6293,273,4.2
8,95,Phillips,1994,1867,1836,31,1.7
8,97,Pitkin,1994,9031,8614,417,4.6
8,99,Prowers,1994,6227,5990,237,3.8
8,101,Pueblo,1994,55775,52572,3203,5.7
8,103,Rio Blanco,1994,3538,3385,153,4.3
8,105,Rio Grande,1994,5113,4705,408,8.0
8,107,Routt,1994,10010,9629,381,3.8
8,109,Saguache,1994,2477,2218,259,10.5
8,111,San Juan,1994,316,271,45,14.2
8,113,San Miguel,1994,4119,3976,143,3.5
8,115,Sedgwick,1994,1193,1146,47,3.9
8,117,Summit,1994,10750,10446,304,2.8
8,119,Teller,1994,11987,11405,582,4.9
8,121,Washington,1994,2195,2128,67,3.1
8,123,Weld,1994,76379,73035,3344,4.4
8,125,Yuma,1994,4117,4016,101,2.5
9,1,Fairfield,1994,448522,426887,21635,4.8
9,3,Hartford,1994,442797,415716,27081,6.1
9,5,Litchfield,1994,101605,96496,5109,5.0
9,7,Middlesex,1994,82728,78376,4352,5.3
9,9,New Haven,1994,421774,396386,25388,6.0
9,11,New London,1994,133228,126308,6920,5.2
9,13,Tolland,1994,72081,68556,3525,4.9
9,15,Windham,1994,55788,52054,3734,6.7
10,1,Kent,1994,69278,65777,3501,5.1
10,3,New Castle,1994,248171,236943,11228,4.5
10,5,Sussex,1994,66803,63439,3364,5.0
11,1,District of Colu,1994,309634,285026,24608,7.9
12,1,Alachua,1994,102438,99053,3385,3.3
12,3,Baker,1994,8816,8257,559,6.3
12,5,Bay,1994,65684,60168,5516,8.4
12,7,Bradford,1994,9498,9048,450,4.7
12,9,Brevard,1994,212959,197417,15542,7.3
12,11,Broward,1994,733204,685906,47298,6.5
12,13,Calhoun,1994,4596,4328,268,5.8
12,15,Charlotte,1994,45812,43264,2548,5.6
12,17,Citrus,1994,35714,32911,2803,7.8
12,19,Clay,1994,61694,59291,2403,3.9
12,21,Collier,1994,82723,76076,6647,8.0
12,23,Columbia,1994,22427,20634,1793,8.0
12,27,DeSoto,1994,10096,9313,783,7.8
12,29,Dixie,1994,3958,3653,305,7.7
12,31,Duval,1994,368925,350989,17936,4.9
12,33,Escambia,1994,124151,118374,5777,4.7
12,35,Flagler,1994,14428,13775,653,4.5
12,37,Franklin,1994,4597,4446,151,3.3
12,39,Gadsden,1994,19169,18116,1053,5.5
12,41,Gilchrist,1994,4143,3949,194,4.7
12,43,Glades,1994,3583,3210,373,10.4
12,45,Gulf,1994,5822,5470,352,6.0
12,47,Hamilton,1994,3624,3255,369,10.2
12,49,Hardee,1994,11081,9509,1572,14.2
12,51,Hendry,1994,16274,13607,2667,16.4
12,53,Hernando,1994,42872,39977,2895,6.8
12,55,Highlands,1994,28266,25530,2736,9.7
12,57,Hillsborough,1994,497456,471808,25648,5.2
12,59,Holmes,1994,6888,6462,426,6.2
12,61,Indian River,1994,41324,36823,4501,10.9
12,63,Jackson,1994,19660,18394,1266,6.4
12,65,Jefferson,1994,5409,5143,266,4.9
12,67,Lafayette,1994,2461,2353,108,4.4
12,69,Lake,1994,74646,69996,4650,6.2
12,71,Lee,1994,171671,163345,8326,4.8
12,73,Leon,1994,125061,120725,4336,3.5
12,75,Levy,1994,11906,11213,693,5.8
12,77,Liberty,1994,2367,2282,85,3.6
12,79,Madison,1994,7245,6864,381,5.3
12,81,Manatee,1994,101741,97157,4584,4.5
12,83,Marion,1994,91426,85013,6413,7.0
12,85,Martin,1994,46174,41926,4248,9.2
12,86,Miami-Dade,1994,1015656,930711,84945,8.4
12,87,Monroe,1994,43634,42300,1334,3.1
12,89,Nassau,1994,25692,24364,1328,5.2
12,91,Okaloosa,1994,75234,71369,3865,5.1
12,93,Okeechobee,1994,15345,13643,1702,11.1
12,95,Orange,1994,430131,405911,24220,5.6
12,97,Osceola,1994,69069,65118,3951,5.7
12,99,Palm Beach,1994,467793,427091,40702,8.7
12,101,Pasco,1994,120870,113322,7548,6.2
12,103,Pinellas,1994,447263,424988,22275,5.0
12,105,Polk,1994,200873,183605,17268,8.6
12,107,Putnam,1994,29546,27515,2031,6.9
12,109,St. Johns,1994,52088,49444,2644,5.1
12,111,St. Lucie,1994,75486,64849,10637,14.1
12,113,Santa Rosa,1994,46597,44633,1964,4.2
12,115,Sarasota,1994,130497,124997,5500,4.2
12,117,Seminole,1994,190485,180579,9906,5.2
12,119,Sumter,1994,12424,11585,839,6.8
12,121,Suwannee,1994,12908,12009,899,7.0
12,123,Taylor,1994,7612,6710,902,11.8
12,125,Union,1994,4016,3867,149,3.7
12,127,Volusia,1994,178035,167129,10906,6.1
12,129,Wakulla,1994,8977,8570,407,4.5
12,131,Walton,1994,14649,13918,731,5.0
12,133,Washington,1994,8169,7635,534,6.5
13,1,Appling,1994,8514,7822,692,8.1
13,3,Atkinson,1994,3004,2815,189,6.3
13,5,Bacon,1994,4495,4254,241,5.4
13,7,Baker,1994,1527,1359,168,11.0
13,9,Baldwin,1994,17119,16528,591,3.5
13,11,Banks,1994,5882,5641,241,4.1
13,13,Barrow,1994,17117,16249,868,5.1
13,15,Bartow,1994,32268,30494,1774,5.5
13,17,Ben Hill,1994,8235,7741,494,6.0
13,19,Berrien,1994,6444,6062,382,5.9
13,21,Bibb,1994,71853,67245,4608,6.4
13,23,Bleckley,1994,5385,5140,245,4.5
13,25,Brantley,1994,5155,4691,464,9.0
13,27,Brooks,1994,6610,6363,247,3.7
13,29,Bryan,1994,8953,8554,399,4.5
13,31,Bulloch,1994,21478,20807,671,3.1
13,33,Burke,1994,8602,7577,1025,11.9
13,35,Butts,1994,7285,6917,368,5.1
13,37,Calhoun,1994,1993,1743,250,12.5
13,39,Camden,1994,15289,14668,621,4.1
13,43,Candler,1994,3728,3501,227,6.1
13,45,Carroll,1994,38805,37007,1798,4.6
13,47,Catoosa,1994,23822,22815,1007,4.2
13,49,Charlton,1994,3882,3667,215,5.5
13,51,Chatham,1994,103861,97982,5879,5.7
13,53,Chattahoochee,1994,2035,1865,170,8.4
13,55,Chattooga,1994,11869,11266,603,5.1
13,57,Cherokee,1994,60868,58858,2010,3.3
13,59,Clarke,1994,44368,42757,1611,3.6
13,61,Clay,1994,1495,1404,91,6.1
13,63,Clayton,1994,110862,104809,6053,5.5
13,65,Clinch,1994,3815,3671,144,3.8
13,67,Cobb,1994,303291,291001,12290,4.1
13,69,Coffee,1994,16207,15424,783,4.8
13,71,Colquitt,1994,16987,16116,871,5.1
13,73,Columbia,1994,38997,37397,1600,4.1
13,75,Cook,1994,7115,6774,341,4.8
13,77,Coweta,1994,34060,32654,1406,4.1
13,79,Crawford,1994,5082,4814,268,5.3
13,81,Crisp,1994,9499,8961,538,5.7
13,83,Dade,1994,6756,6411,345,5.1
13,85,Dawson,1994,7194,6913,281,3.9
13,87,Decatur,1994,11423,10417,1006,8.8
13,89,DeKalb,1994,337554,319804,17750,5.3
13,91,Dodge,1994,9299,8831,468,5.0
13,93,Dooly,1994,4435,4112,323,7.3
13,95,Dougherty,1994,45578,41335,4243,9.3
13,97,Douglas,1994,44291,42572,1719,3.9
13,99,Early,1994,5093,4631,462,9.1
13,101,Echols,1994,990,937,53,5.4
13,103,Effingham,1994,14338,13689,649,4.5
13,105,Elbert,1994,8435,7795,640,7.6
13,107,Emanuel,1994,8541,7775,766,9.0
13,109,Evans,1994,4485,4082,403,9.0
13,111,Fannin,1994,8057,7599,458,5.7
13,113,Fayette,1994,40259,39141,1118,2.8
13,115,Floyd,1994,45772,43554,2218,4.8
13,117,Forsyth,1994,31362,30407,955,3.0
13,119,Franklin,1994,8934,8492,442,4.9
13,121,Fulton,1994,364905,344442,20463,5.6
13,123,Gilmer,1994,6898,6518,380,5.5
13,125,Glascock,1994,1006,952,54,5.4
13,127,Glynn,1994,32532,31169,1363,4.2
13,129,Gordon,1994,20570,19427,1143,5.6
13,131,Grady,1994,9785,9208,577,5.9
13,133,Greene,1994,5147,4710,437,8.5
13,135,Gwinnett,1994,262510,252951,9559,3.6
13,137,Habersham,1994,14426,13810,616,4.3
13,139,Hall,1994,63098,60792,2306,3.7
13,141,Hancock,1994,3934,3675,259,6.6
13,143,Haralson,1994,9391,8824,567,6.0
13,145,Harris,1994,9423,9061,362,3.8
13,147,Hart,1994,8728,8199,529,6.1
13,149,Heard,1994,3898,3637,261,6.7
13,151,Henry,1994,42545,40996,1549,3.6
13,153,Houston,1994,46613,44543,2070,4.4
13,155,Irwin,1994,4151,3958,193,4.6
13,157,Jackson,1994,18204,17435,769,4.2
13,159,Jasper,1994,4137,3950,187,4.5
13,161,Jeff Davis,1994,5725,5334,391,6.8
13,163,Jefferson,1994,7836,7286,550,7.0
13,165,Jenkins,1994,3903,3697,206,5.3
13,167,Johnson,1994,4088,3856,232,5.7
13,169,Jones,1994,10939,10500,439,4.0
13,171,Lamar,1994,7151,6852,299,4.2
13,173,Lanier,1994,2795,2695,100,3.6
13,175,Laurens,1994,20835,19910,925,4.4
13,177,Lee,1994,9445,8964,481,5.1
13,179,Liberty,1994,15680,14335,1345,8.6
13,181,Lincoln,1994,3668,3402,266,7.3
13,183,Long,1994,2836,2725,111,3.9
13,185,Lowndes,1994,37220,35618,1602,4.3
13,187,Lumpkin,1994,8091,7867,224,2.8
13,189,McDuffie,1994,9488,8851,637,6.7
13,191,McIntosh,1994,3419,3202,217,6.3
13,193,Macon,1994,5725,4919,806,14.1
13,195,Madison,1994,11879,11428,451,3.8
13,197,Marion,1994,3362,3164,198,5.9
13,199,Meriwether,1994,9201,8514,687,7.5
13,201,Miller,1994,2974,2727,247,8.3
13,205,Mitchell,1994,9974,9196,778,7.8
13,207,Monroe,1994,7814,7420,394,5.0
13,209,Montgomery,1994,3616,3334,282,7.8
13,211,Morgan,1994,6153,5841,312,5.1
13,213,Murray,1994,17566,16831,735,4.2
13,215,Muscogee,1994,78874,73990,4884,6.2
13,217,Newton,1994,23488,22436,1052,4.5
13,219,Oconee,1994,10713,10467,246,2.3
13,221,Oglethorpe,1994,4927,4637,290,5.9
13,223,Paulding,1994,29091,28080,1011,3.5
13,225,Peach,1994,10169,9430,739,7.3
13,227,Pickens,1994,8362,7962,400,4.8
13,229,Pierce,1994,6944,6462,482,6.9
13,231,Pike,1994,5249,4990,259,4.9
13,233,Polk,1994,15487,14192,1295,8.4
13,235,Pulaski,1994,4122,3929,193,4.7
13,237,Putnam,1994,7362,7123,239,3.2
13,239,Quitman,1994,1047,986,61,5.8
13,241,Rabun,1994,6595,6269,326,4.9
13,243,Randolph,1994,3155,2922,233,7.4
13,245,Richmond,1994,83757,77800,5957,7.1
13,247,Rockdale,1994,34180,32918,1262,3.7
13,249,Schley,1994,1520,1435,85,5.6
13,251,Screven,1994,6599,6175,424,6.4
13,253,Seminole,1994,4386,4079,307,7.0
13,255,Spalding,1994,27819,26418,1401,5.0
13,257,Stephens,1994,12464,11850,614,4.9
13,259,Stewart,1994,2365,2204,161,6.8
13,261,Sumter,1994,14253,13330,923,6.5
13,263,Talbot,1994,2593,2420,173,6.7
13,265,Taliaferro,1994,629,596,33,5.2
13,267,Tattnall,1994,6921,6465,456,6.6
13,269,Taylor,1994,3352,3079,273,8.1
13,271,Telfair,1994,4850,4382,468,9.6
13,273,Terrell,1994,4610,4099,511,11.1
13,275,Thomas,1994,19401,18570,831,4.3
13,277,Tift,1994,18934,17827,1107,5.8
13,279,Toombs,1994,11574,10684,890,7.7
13,281,Towns,1994,3021,2876,145,4.8
13,283,Treutlen,1994,2751,2519,232,8.4
13,285,Troup,1994,26077,24377,1700,6.5
13,287,Turner,1994,4018,3758,260,6.5
13,289,Twiggs,1994,4048,3766,282,7.0
13,291,Union,1994,6258,5998,260,4.2
13,293,Upson,1994,12796,12146,650,5.1
13,295,Walker,1994,29857,28228,1629,5.5
13,297,Walton,1994,22139,21208,931,4.2
13,299,Ware,1994,15516,14668,848,5.5
13,301,Warren,1994,2440,2260,180,7.4
13,303,Washington,1994,9237,8893,344,3.7
13,305,Wayne,1994,10971,10015,956,8.7
13,307,Webster,1994,1096,1035,61,5.6
13,309,Wheeler,1994,1955,1785,170,8.7
13,311,White,1994,8475,8126,349,4.1
13,313,Whitfield,1994,44326,42707,1619,3.7
13,315,Wilcox,1994,3106,2957,149,4.8
13,317,Wilkes,1994,5426,5162,264,4.9
13,319,Wilkinson,1994,4516,4317,199,4.4
13,321,Worth,1994,9246,8647,599,6.5
15,1,Hawaii,1994,65214,59123,6091,9.3
15,3,Honolulu/city,1994,423496,406701,16795,4.0
15,7,Kauai,1994,28455,24929,3526,12.4
15,9,Maui,1994,66054,62182,3872,5.9
16,1,Ada,1994,138759,134012,4747,3.4
16,3,Adams,1994,1812,1601,211,11.6
16,5,Bannock,1994,36741,34469,2272,6.2
16,7,Bear Lake,1994,2886,2714,172,6.0
16,9,Benewah,1994,4095,3687,408,10.0
16,11,Bingham,1994,20837,19612,1225,5.9
16,13,Blaine,1994,9664,9170,494,5.1
16,15,Boise,1994,2503,2353,150,6.0
16,17,Bonner,1994,15389,14077,1312,8.5
16,19,Bonneville,1994,43917,42030,1887,4.3
16,21,Boundary,1994,4164,3800,364,8.7
16,23,Butte,1994,1574,1496,78,5.0
16,25,Camas,1994,469,457,12,2.6
16,27,Canyon,1994,52247,49223,3024,5.8
16,29,Caribou,1994,3205,2969,236,7.4
16,31,Cassia,1994,9501,8750,751,7.9
16,33,Clark,1994,616,589,27,4.4
16,35,Clearwater,1994,4084,3489,595,14.6
16,37,Custer,1994,2379,2184,195,8.2
16,39,Elmore,1994,8215,7677,538,6.5
16,41,Franklin,1994,4303,4156,147,3.4
16,43,Fremont,1994,4599,4219,380,8.3
16,45,Gem,1994,5807,5426,381,6.6
16,47,Gooding,1994,6351,6081,270,4.3
16,49,Idaho,1994,6658,5905,753,11.3
16,51,Jefferson,1994,9316,8815,501,5.4
16,53,Jerome,1994,8506,8076,430,5.1
16,55,Kootenai,1994,46740,43258,3482,7.4
16,57,Latah,1994,15721,15276,445,2.8
16,59,Lemhi,1994,3879,3562,317,8.2
16,61,Lewis,1994,1635,1525,110,6.7
16,63,Lincoln,1994,2117,2018,99,4.7
16,65,Madison,1994,9434,9130,304,3.2
16,67,Minidoka,1994,10240,9353,887,8.7
16,69,Nez Perce,1994,22085,21328,757,3.4
16,71,Oneida,1994,1447,1395,52,3.6
16,73,Owyhee,1994,4522,4374,148,3.3
16,75,Payette,1994,9599,8798,801,8.3
16,77,Power,1994,3193,2965,228,7.1
16,79,Shoshone,1994,6737,5964,773,11.5
16,81,Teton,1994,2353,2266,87,3.7
16,83,Twin Falls,1994,31005,29480,1525,4.9
16,85,Valley,1994,4013,3667,346,8.6
16,87,Washington,1994,4284,3878,406,9.5
17,1,Adams,1994,35832,34506,1326,3.7
17,3,Alexander,1994,3939,3501,438,11.1
17,5,Bond,1994,7714,7285,429,5.6
17,7,Boone,1994,19273,18238,1035,5.4
17,9,Brown,1994,2711,2604,107,3.9
17,11,Bureau,1994,18708,17707,1001,5.4
17,13,Calhoun,1994,2876,2667,209,7.3
17,15,Carroll,1994,8811,8335,476,5.4
17,17,Cass,1994,7196,6826,370,5.1
17,19,Champaign,1994,93101,90057,3044,3.3
17,21,Christian,1994,19777,18582,1195,6.0
17,23,Clark,1994,9475,9043,432,4.6
17,25,Clay,1994,6676,6180,496,7.4
17,27,Clinton,1994,16773,15957,816,4.9
17,29,Coles,1994,27053,26076,977,3.6
17,31,Cook,1994,2648367,2472365,176002,6.6
17,33,Crawford,1994,9839,9087,752,7.6
17,35,Cumberland,1994,5429,5175,254,4.7
17,37,DeKalb,1994,44051,42123,1928,4.4
17,39,De Witt,1994,9318,8825,493,5.3
17,41,Douglas,1994,11237,10715,522,4.6
17,43,DuPage,1994,495899,474969,20930,4.2
17,45,Edgar,1994,9299,8745,554,6.0
17,47,Edwards,1994,3898,3671,227,5.8
17,49,Effingham,1994,17339,16545,794,4.6
17,51,Fayette,1994,10037,9385,652,6.5
17,53,Ford,1994,6969,6579,390,5.6
17,55,Franklin,1994,16606,14822,1784,10.7
17,57,Fulton,1994,14801,13738,1063,7.2
17,59,Gallatin,1994,3020,2614,406,13.4
17,61,Greene,1994,7040,6677,363,5.2
17,63,Grundy,1994,18107,16546,1561,8.6
17,65,Hamilton,1994,3578,3203,375,10.5
17,67,Hancock,1994,12086,11592,494,4.1
17,69,Hardin,1994,1916,1764,152,7.9
17,71,Henderson,1994,4783,4578,205,4.3
17,73,Henry,1994,25569,24365,1204,4.7
17,75,Iroquois,1994,17780,17074,706,4.0
17,77,Jackson,1994,29373,27782,1591,5.4
17,79,Jasper,1994,4921,4653,268,5.4
17,81,Jefferson,1994,17877,16473,1404,7.9
17,83,Jersey,1994,10097,9585,512,5.1
17,85,Jo Daviess,1994,13424,12962,462,3.4
17,87,Johnson,1994,4435,4017,418,9.4
17,89,Kane,1994,187126,176260,10866,5.8
17,91,Kankakee,1994,51591,48322,3269,6.3
17,93,Kendall,1994,24811,23600,1211,4.9
17,95,Knox,1994,29041,27624,1417,4.9
17,97,Lake,1994,299162,285578,13584,4.5
17,99,LaSalle,1994,55051,50843,4208,7.6
17,101,Lawrence,1994,7143,6585,558,7.8
17,103,Lee,1994,17369,16611,758,4.4
17,105,Livingston,1994,19642,19004,638,3.2
17,107,Logan,1994,13214,12662,552,4.2
17,109,McDonough,1994,18967,18496,471,2.5
17,111,McHenry,1994,121098,114986,6112,5.0
17,113,McLean,1994,78917,76822,2095,2.7
17,115,Macon,1994,60571,56189,4382,7.2
17,117,Macoupin,1994,22664,21264,1400,6.2
17,119,Madison,1994,125651,119166,6485,5.2
17,121,Marion,1994,20950,19320,1630,7.8
17,123,Marshall,1994,6531,6210,321,4.9
17,125,Mason,1994,8380,7804,576,6.9
17,127,Massac,1994,7560,7144,416,5.5
17,129,Menard,1994,6149,5908,241,3.9
17,131,Mercer,1994,8545,8018,527,6.2
17,133,Monroe,1994,12470,12060,410,3.3
17,135,Montgomery,1994,14461,13435,1026,7.1
17,137,Morgan,1994,18591,17816,775,4.2
17,139,Moultrie,1994,7976,7623,353,4.4
17,141,Ogle,1994,26629,25302,1327,5.0
17,143,Peoria,1994,92890,88648,4242,4.6
17,145,Perry,1994,7769,6816,953,12.3
17,147,Piatt,1994,8292,7838,454,5.5
17,149,Pike,1994,8763,8295,468,5.3
17,151,Pope,1994,1700,1524,176,10.4
17,153,Pulaski,1994,2797,2524,273,9.8
17,155,Putnam,1994,3097,2893,204,6.6
17,157,Randolph,1994,14586,13414,1172,8.0
17,159,Richland,1994,10011,9549,462,4.6
17,161,Rock Island,1994,73372,69683,3689,5.0
17,163,St. Clair,1994,116979,109734,7245,6.2
17,165,Saline,1994,11045,9616,1429,12.9
17,167,Sangamon,1994,101172,97149,4023,4.0
17,169,Schuyler,1994,3738,3536,202,5.4
17,171,Scott,1994,2761,2625,136,4.9
17,173,Shelby,1994,11022,10492,530,4.8
17,175,Stark,1994,2885,2736,149,5.2
17,177,Stephenson,1994,25806,24481,1325,5.1
17,179,Tazewell,1994,67052,64061,2991,4.5
17,181,Union,1994,8217,7399,818,10.0
17,183,Vermilion,1994,41318,38092,3226,7.8
17,185,Wabash,1994,6063,5581,482,7.9
17,187,Warren,1994,9977,9420,557,5.6
17,189,Washington,1994,7855,7481,374,4.8
17,191,Wayne,1994,8326,7726,600,7.2
17,193,White,1994,7423,6790,633,8.5
17,195,Whiteside,1994,31179,29902,1277,4.1
17,197,Will,1994,209596,196555,13041,6.2
17,199,Williamson,1994,27127,24609,2518,9.3
17,201,Winnebago,1994,144904,137384,7520,5.2
17,203,Woodford,1994,17744,17266,478,2.7
18,1,Adams,1994,16040,15453,587,3.7
18,3,Allen,1994,172143,164971,7172,4.2
18,5,Bartholomew,1994,38836,37567,1269,3.3
18,7,Benton,1994,5284,4991,293,5.5
18,9,Blackford,1994,6386,5954,432,6.8
18,11,Boone,1994,22753,22080,673,3.0
18,13,Brown,1994,8349,8127,222,2.7
18,15,Carroll,1994,11661,11195,466,4.0
18,17,Cass,1994,18805,17193,1612,8.6
18,19,Clark,1994,49875,47370,2505,5.0
18,21,Clay,1994,12647,11933,714,5.6
18,23,Clinton,1994,15570,15010,560,3.6
18,25,Crawford,1994,4782,4292,490,10.2
18,27,Daviess,1994,13281,12723,558,4.2
18,29,Dearborn,1994,21453,20154,1299,6.1
18,31,Decatur,1994,15169,14612,557,3.7
18,33,DeKalb,1994,20902,19993,909,4.3
18,35,Delaware,1994,65293,61780,3513,5.4
18,37,Dubois,1994,21947,21280,667,3.0
18,39,Elkhart,1994,93503,90712,2791,3.0
18,41,Fayette,1994,12816,11652,1164,9.1
18,43,Floyd,1994,36504,35007,1497,4.1
18,45,Fountain,1994,8805,8232,573,6.5
18,47,Franklin,1994,10467,9798,669,6.4
18,49,Fulton,1994,10120,9653,467,4.6
18,51,Gibson,1994,16346,15177,1169,7.2
18,53,Grant,1994,36931,34205,2726,7.4
18,55,Greene,1994,15558,14160,1398,9.0
18,57,Hamilton,1994,76763,75140,1623,2.1
18,59,Hancock,1994,27206,26355,851,3.1
18,61,Harrison,1994,16727,16031,696,4.2
18,63,Hendricks,1994,46344,45234,1110,2.4
18,65,Henry,1994,25227,23586,1641,6.5
18,67,Howard,1994,42925,40612,2313,5.4
18,69,Huntington,1994,20237,19226,1011,5.0
18,71,Jackson,1994,20872,20018,854,4.1
18,73,Jasper,1994,13935,13188,747,5.4
18,75,Jay,1994,11469,10830,639,5.6
18,77,Jefferson,1994,14943,14250,693,4.6
18,79,Jennings,1994,13607,13180,427,3.1
18,81,Johnson,1994,55479,53770,1709,3.1
18,83,Knox,1994,20381,19491,890,4.4
18,85,Kosciusko,1994,36503,35380,1123,3.1
18,87,LaGrange,1994,16470,15887,583,3.5
18,89,Lake,1994,228708,213301,15407,6.7
18,91,LaPorte,1994,54563,51938,2625,4.8
18,93,Lawrence,1994,23848,22167,1681,7.0
18,95,Madison,1994,66364,63066,3298,5.0
18,97,Marion,1994,451901,432113,19788,4.4
18,99,Marshall,1994,26101,25262,839,3.2
18,101,Martin,1994,5199,4930,269,5.2
18,103,Miami,1994,16558,15573,985,5.9
18,105,Monroe,1994,60701,58448,2253,3.7
18,107,Montgomery,1994,20577,20032,545,2.6
18,109,Morgan,1994,32765,31424,1341,4.1
18,111,Newton,1994,6770,6411,359,5.3
18,113,Noble,1994,23850,23040,810,3.4
18,115,Ohio,1994,2670,2507,163,6.1
18,117,Orange,1994,9587,8758,829,8.6
18,119,Owen,1994,9868,9286,582,5.9
18,121,Parke,1994,7905,7455,450,5.7
18,123,Perry,1994,9595,8774,821,8.6
18,125,Pike,1994,6202,5839,363,5.9
18,127,Porter,1994,71523,68270,3253,4.5
18,129,Posey,1994,13858,13307,551,4.0
18,131,Pulaski,1994,6200,5850,350,5.6
18,133,Putnam,1994,16964,16424,540,3.2
18,135,Randolph,1994,12261,11184,1077,8.8
18,137,Ripley,1994,13377,12689,688,5.1
18,139,Rush,1994,9780,9336,444,4.5
18,141,St. Joseph,1994,134478,128868,5610,4.2
18,143,Scott,1994,10345,9858,487,4.7
18,145,Shelby,1994,22806,21815,991,4.3
18,147,Spencer,1994,10870,10215,655,6.0
18,149,Starke,1994,11219,10602,617,5.5
18,151,Steuben,1994,16843,16232,611,3.6
18,153,Sullivan,1994,10253,9367,886,8.6
18,155,Switzerland,1994,4189,3968,221,5.3
18,157,Tippecanoe,1994,70201,67939,2262,3.2
18,159,Tipton,1994,8756,8381,375,4.3
18,161,Union,1994,3938,3716,222,5.6
18,163,Vanderburgh,1994,91361,86918,4443,4.9
18,165,Vermillion,1994,8260,7585,675,8.2
18,167,Vigo,1994,54054,50665,3389,6.3
18,169,Wabash,1994,18521,17757,764,4.1
18,171,Warren,1994,3977,3796,181,4.6
18,173,Warrick,1994,27169,25867,1302,4.8
18,175,Washington,1994,11443,10769,674,5.9
18,177,Wayne,1994,39292,36827,2465,6.3
18,179,Wells,1994,14417,13887,530,3.7
18,181,White,1994,16099,15286,813,5.1
18,183,Whitley,1994,15850,15279,571,3.6
19,1,Adair,1994,4357,4218,139,3.2
19,3,Adams,1994,2476,2396,80,3.2
19,5,Allamakee,1994,7721,7354,367,4.8
19,7,Appanoose,1994,6851,6481,370,5.4
19,9,Audubon,1994,3730,3629,101,2.7
19,11,Benton,1994,11818,11339,479,4.1
19,13,Black Hawk,1994,68452,65131,3321,4.9
19,15,Boone,1994,13791,13324,467,3.4
19,17,Bremer,1994,12518,12129,389,3.1
19,19,Buchanan,1994,10711,10201,510,4.8
19,21,Buena Vista,1994,11226,10923,303,2.7
19,23,Butler,1994,8302,7853,449,5.4
19,25,Calhoun,1994,5211,5030,181,3.5
19,27,Carroll,1994,12074,11690,384,3.2
19,29,Cass,1994,7813,7451,362,4.6
19,31,Cedar,1994,9721,9436,285,2.9
19,33,Cerro Gordo,1994,26124,24945,1179,4.5
19,35,Cherokee,1994,7120,6894,226,3.2
19,37,Chickasaw,1994,7642,7211,431,5.6
19,39,Clarke,1994,4015,3744,271,6.7
19,41,Clay,1994,9707,9419,288,3.0
19,43,Clayton,1994,9676,9111,565,5.8
19,45,Clinton,1994,27272,26039,1233,4.5
19,47,Crawford,1994,8899,8585,314,3.5
19,49,Dallas,1994,18196,17689,507,2.8
19,51,Davis,1994,4361,4176,185,4.2
19,53,Decatur,1994,4054,3825,229,5.6
19,55,Delaware,1994,9388,8883,505,5.4
19,57,Des Moines,1994,23725,22625,1100,4.6
19,59,Dickinson,1994,9596,9202,394,4.1
19,61,Dubuque,1994,50363,48508,1855,3.7
19,63,Emmet,1994,5681,5393,288,5.1
19,65,Fayette,1994,11563,11129,434,3.8
19,67,Floyd,1994,8519,7793,726,8.5
19,69,Franklin,1994,6104,5904,200,3.3
19,71,Fremont,1994,4013,3876,137,3.4
19,73,Greene,1994,5282,5063,219,4.1
19,75,Grundy,1994,6279,6091,188,3.0
19,77,Guthrie,1994,5854,5628,226,3.9
19,79,Hamilton,1994,8748,8478,270,3.1
19,81,Hancock,1994,6128,5935,193,3.1
19,83,Hardin,1994,9670,9363,307,3.2
19,85,Harrison,1994,7665,7313,352,4.6
19,87,Henry,1994,11131,10761,370,3.3
19,89,Howard,1994,5305,5118,187,3.5
19,91,Humboldt,1994,5410,5241,169,3.1
19,93,Ida,1994,4173,4071,102,2.4
19,95,Iowa,1994,9529,9336,193,2.0
19,97,Jackson,1994,11011,10454,557,5.1
19,99,Jasper,1994,18514,17913,601,3.2
19,101,Jefferson,1994,9796,9344,452,4.6
19,103,Johnson,1994,64931,63249,1682,2.6
19,105,Jones,1994,9624,9231,393,4.1
19,107,Keokuk,1994,5179,4951,228,4.4
19,109,Kossuth,1994,8996,8648,348,3.9
19,111,Lee,1994,19808,18725,1083,5.5
19,113,Linn,1994,106559,103325,3234,3.0
19,115,Louisa,1994,6500,6236,264,4.1
19,117,Lucas,1994,4403,4175,228,5.2
19,119,Lyon,1994,5906,5758,148,2.5
19,121,Madison,1994,7435,7119,316,4.3
19,123,Mahaska,1994,11354,11012,342,3.0
19,125,Marion,1994,17150,16593,557,3.2
19,127,Marshall,1994,21149,20537,612,2.9
19,129,Mills,1994,6632,6416,216,3.3
19,131,Mitchell,1994,5742,5514,228,4.0
19,133,Monona,1994,5231,5053,178,3.4
19,135,Monroe,1994,4203,4034,169,4.0
19,137,Montgomery,1994,6228,5989,239,3.8
19,139,Muscatine,1994,21589,20790,799,3.7
19,141,O'Brien,1994,8059,7852,207,2.6
19,143,Osceola,1994,3700,3582,118,3.2
19,145,Page,1994,9283,8943,340,3.7
19,147,Palo Alto,1994,5406,5223,183,3.4
19,149,Plymouth,1994,13058,12688,370,2.8
19,151,Pocahontas,1994,4343,4224,119,2.7
19,153,Polk,1994,210017,204073,5944,2.8
19,155,Pottawattamie,1994,46770,45093,1677,3.6
19,157,Poweshiek,1994,10460,10033,427,4.1
19,159,Ringgold,1994,2729,2627,102,3.7
19,161,Sac,1994,6160,5936,224,3.6
19,163,Scott,1994,84146,80745,3401,4.0
19,165,Shelby,1994,6917,6606,311,4.5
19,167,Sioux,1994,17305,16794,511,3.0
19,169,Story,1994,45830,44498,1332,2.9
19,171,Tama,1994,9534,9159,375,3.9
19,173,Taylor,1994,3316,3121,195,5.9
19,175,Union,1994,6342,6021,321,5.1
19,177,Van Buren,1994,4074,3907,167,4.1
19,179,Wapello,1994,18611,17687,924,5.0
19,181,Warren,1994,22749,22239,510,2.2
19,183,Washington,1994,11270,10933,337,3.0
19,185,Wayne,1994,3407,3283,124,3.6
19,187,Webster,1994,20367,19501,866,4.3
19,189,Winnebago,1994,6827,6651,176,2.6
19,191,Winneshiek,1994,12128,11515,613,5.1
19,193,Woodbury,1994,55203,53471,1732,3.1
19,195,Worth,1994,4094,3915,179,4.4
19,197,Wright,1994,7076,6826,250,3.5
20,1,Allen,1994,7153,6729,424,5.9
20,3,Anderson,1994,4050,3790,260,6.4
20,5,Atchison,1994,8600,7944,656,7.6
20,7,Barber,1994,2843,2744,99,3.5
20,9,Barton,1994,15479,14749,730,4.7
20,11,Bourbon,1994,6661,6236,425,6.4
20,13,Brown,1994,5003,4699,304,6.1
20,15,Butler,1994,29002,27424,1578,5.4
20,17,Chase,1994,1410,1328,82,5.8
20,19,Chautauqua,1994,1803,1697,106,5.9
20,21,Cherokee,1994,10102,9325,777,7.7
20,23,Cheyenne,1994,1590,1552,38,2.4
20,25,Clark,1994,1302,1275,27,2.1
20,27,Clay,1994,4613,4469,144,3.1
20,29,Cloud,1994,5333,5175,158,3.0
20,31,Coffey,1994,4243,3973,270,6.4
20,33,Comanche,1994,1127,1104,23,2.0
20,35,Cowley,1994,18170,17144,1026,5.6
20,37,Crawford,1994,17533,16596,937,5.3
20,39,Decatur,1994,1982,1935,47,2.4
20,41,Dickinson,1994,10046,9589,457,4.5
20,43,Doniphan,1994,4148,3840,308,7.4
20,45,Douglas,1994,49833,47477,2356,4.7
20,47,Edwards,1994,1878,1812,66,3.5
20,49,Elk,1994,1449,1353,96,6.6
20,51,Ellis,1994,16109,15560,549,3.4
20,53,Ellsworth,1994,2896,2792,104,3.6
20,55,Finney,1994,18451,17811,640,3.5
20,57,Ford,1994,15741,15122,619,3.9
20,59,Franklin,1994,12336,11561,775,6.3
20,61,Geary,1994,10922,10054,868,7.9
20,63,Gove,1994,1542,1513,29,1.9
20,65,Graham,1994,1728,1658,70,4.1
20,67,Grant,1994,3966,3832,134,3.4
20,69,Gray,1994,2703,2623,80,3.0
20,71,Greeley,1994,820,795,25,3.0
20,73,Greenwood,1994,3597,3374,223,6.2
20,75,Hamilton,1994,1291,1264,27,2.1
20,77,Harper,1994,3162,3033,129,4.1
20,79,Harvey,1994,16201,15501,700,4.3
20,81,Haskell,1994,2118,2066,52,2.5
20,83,Hodgeman,1994,1025,1001,24,2.3
20,85,Jackson,1994,6471,6107,364,5.6
20,87,Jefferson,1994,9489,9064,425,4.5
20,89,Jewell,1994,2123,2084,39,1.8
20,91,Johnson,1994,237008,229562,7446,3.1
20,93,Kearny,1994,2100,2041,59,2.8
20,95,Kingman,1994,4257,4005,252,5.9
20,97,Kiowa,1994,1891,1834,57,3.0
20,99,Labette,1994,10838,9969,869,8.0
20,101,Lane,1994,1269,1235,34,2.7
20,103,Leavenworth,1994,27623,26176,1447,5.2
20,105,Lincoln,1994,1794,1724,70,3.9
20,107,Linn,1994,3408,3060,348,10.2
20,109,Logan,1994,1593,1551,42,2.6
20,111,Lyon,1994,18934,18061,873,4.6
20,113,McPherson,1994,15519,15128,391,2.5
20,115,Marion,1994,6889,6708,181,2.6
20,117,Marshall,1994,5718,5574,144,2.5
20,119,Meade,1994,2151,2094,57,2.6
20,121,Miami,1994,12995,12370,625,4.8
20,123,Mitchell,1994,3643,3566,77,2.1
20,125,Montgomery,1994,18037,16974,1063,5.9
20,127,Morris,1994,3220,3086,134,4.2
20,129,Morton,1994,1645,1601,44,2.7
20,131,Nemaha,1994,5459,5310,149,2.7
20,133,Neosho,1994,9012,8574,438,4.9
20,135,Ness,1994,1753,1709,44,2.5
20,137,Norton,1994,2878,2832,46,1.6
20,139,Osage,1994,7812,7258,554,7.1
20,141,Osborne,1994,2614,2549,65,2.5
20,143,Ottawa,1994,2758,2678,80,2.9
20,145,Pawnee,1994,3851,3761,90,2.3
20,147,Phillips,1994,3256,3185,71,2.2
20,149,Pottawatomie,1994,8816,8477,339,3.8
20,151,Pratt,1994,5183,5006,177,3.4
20,153,Rawlins,1994,1688,1648,40,2.4
20,155,Reno,1994,32382,31023,1359,4.2
20,157,Republic,1994,3259,3164,95,2.9
20,159,Rice,1994,5031,4791,240,4.8
20,161,Riley,1994,28958,27722,1236,4.3
20,163,Rooks,1994,2773,2672,101,3.6
20,165,Rush,1994,1905,1839,66,3.5
20,167,Russell,1994,3837,3681,156,4.1
20,169,Saline,1994,28131,27153,978,3.5
20,171,Scott,1994,2793,2734,59,2.1
20,173,Sedgwick,1994,225925,212604,13321,5.9
20,175,Seward,1994,10420,9994,426,4.1
20,177,Shawnee,1994,90071,86005,4066,4.5
20,179,Sheridan,1994,1545,1511,34,2.2
20,181,Sherman,1994,3917,3802,115,2.9
20,183,Smith,1994,2529,2476,53,2.1
20,185,Stafford,1994,2373,2295,78,3.3
20,187,Stanton,1994,1113,1081,32,2.9
20,189,Stevens,1994,2422,2353,69,2.8
20,191,Sumner,1994,12891,12024,867,6.7
20,193,Thomas,1994,4722,4603,119,2.5
20,195,Trego,1994,2003,1970,33,1.6
20,197,Wabaunsee,1994,3389,3233,156,4.6
20,199,Wallace,1994,834,806,28,3.4
20,201,Washington,1994,3698,3553,145,3.9
20,203,Wichita,1994,1305,1273,32,2.5
20,205,Wilson,1994,4917,4659,258,5.2
20,207,Woodson,1994,1748,1634,114,6.5
20,209,Wyandotte,1994,77783,71160,6623,8.5
21,1,Adair,1994,7842,7414,428,5.5
21,3,Allen,1994,9264,8950,314,3.4
21,5,Anderson,1994,8889,8575,314,3.5
21,7,Ballard,1994,3880,3578,302,7.8
21,9,Barren,1994,17683,16966,717,4.1
21,11,Bath,1994,4774,4224,550,11.5
21,13,Bell,1994,10190,9265,925,9.1
21,15,Boone,1994,36400,34719,1681,4.6
21,17,Bourbon,1994,9478,9084,394,4.2
21,19,Boyd,1994,22457,20704,1753,7.8
21,21,Boyle,1994,13227,12544,683,5.2
21,23,Bracken,1994,3721,3483,238,6.4
21,25,Breathitt,1994,4979,4581,398,8.0
21,27,Breckinridge,1994,7462,7001,461,6.2
21,29,Bullitt,1994,28820,28057,763,2.6
21,31,Butler,1994,5410,5103,307,5.7
21,33,Caldwell,1994,7184,6839,345,4.8
21,35,Calloway,1994,16420,15613,807,4.9
21,37,Campbell,1994,43597,41588,2009,4.6
21,39,Carlisle,1994,2591,2428,163,6.3
21,41,Carroll,1994,4968,4753,215,4.3
21,43,Carter,1994,11179,9525,1654,14.8
21,45,Casey,1994,6804,6427,377,5.5
21,47,Christian,1994,24284,23159,1125,4.6
21,49,Clark,1994,14953,14170,783,5.2
21,51,Clay,1994,6991,6435,556,8.0
21,53,Clinton,1994,4410,4065,345,7.8
21,55,Crittenden,1994,4168,3922,246,5.9
21,57,Cumberland,1994,2930,2754,176,6.0
21,59,Daviess,1994,47729,45344,2385,5.0
21,61,Edmonson,1994,4416,4109,307,7.0
21,63,Elliott,1994,2457,2124,333,13.6
21,65,Estill,1994,5808,5351,457,7.9
21,67,Fayette,1994,133152,128813,4339,3.3
21,69,Fleming,1994,6422,6043,379,5.9
21,71,Floyd,1994,14406,13194,1212,8.4
21,73,Franklin,1994,24257,23515,742,3.1
21,75,Fulton,1994,3676,3490,186,5.1
21,77,Gallatin,1994,2957,2788,169,5.7
21,79,Garrard,1994,6290,5933,357,5.7
21,81,Grant,1994,8578,8083,495,5.8
21,83,Graves,1994,16372,15101,1271,7.8
21,85,Grayson,1994,10296,9610,686,6.7
21,87,Green,1994,5228,4999,229,4.4
21,89,Greenup,1994,16136,14924,1212,7.5
21,91,Hancock,1994,3449,3197,252,7.3
21,93,Hardin,1994,34909,32806,2103,6.0
21,95,Harlan,1994,10249,9047,1202,11.7
21,97,Harrison,1994,7652,7239,413,5.4
21,99,Hart,1994,7583,7249,334,4.4
21,101,Henderson,1994,23260,22066,1194,5.1
21,103,Henry,1994,7626,7402,224,2.9
21,105,Hickman,1994,2495,2330,165,6.6
21,107,Hopkins,1994,20614,19313,1301,6.3
21,109,Jackson,1994,4838,4392,446,9.2
21,111,Jefferson,1994,357031,341472,15559,4.4
21,113,Jessamine,1994,17951,17429,522,2.9
21,115,Johnson,1994,9959,9293,666,6.7
21,117,Kenton,1994,75731,72350,3381,4.5
21,119,Knott,1994,5787,5259,528,9.1
21,121,Knox,1994,10581,9772,809,7.6
21,123,Larue,1994,5669,5419,250,4.4
21,125,Laurel,1994,20535,19025,1510,7.4
21,127,Lawrence,1994,5036,4437,599,11.9
21,129,Lee,1994,2479,2249,230,9.3
21,131,Leslie,1994,4463,4044,419,9.4
21,133,Letcher,1994,8121,7100,1021,12.6
21,135,Lewis,1994,5531,4888,643,11.6
21,137,Lincoln,1994,9735,9175,560,5.8
21,139,Livingston,1994,4671,4323,348,7.5
21,141,Logan,1994,13357,12766,591,4.4
21,143,Lyon,1994,3042,2847,195,6.4
21,145,McCracken,1994,32530,30846,1684,5.2
21,147,McCreary,1994,6443,5936,507,7.9
21,149,McLean,1994,4208,3824,384,9.1
21,151,Madison,1994,31881,30430,1451,4.6
21,153,Magoffin,1994,4609,3979,630,13.7
21,155,Marion,1994,8350,7442,908,10.9
21,157,Marshall,1994,13467,12519,948,7.0
21,159,Martin,1994,3317,3047,270,8.1
21,161,Mason,1994,8539,8098,441,5.2
21,163,Meade,1994,9416,8924,492,5.2
21,165,Menifee,1994,2322,2011,311,13.4
21,167,Mercer,1994,10662,10194,468,4.4
21,169,Metcalfe,1994,4709,4496,213,4.5
21,171,Monroe,1994,5379,5141,238,4.4
21,173,Montgomery,1994,10256,9392,864,8.4
21,175,Morgan,1994,4467,3964,503,11.3
21,177,Muhlenberg,1994,11855,10731,1124,9.5
21,179,Nelson,1994,16246,15246,1000,6.2
21,181,Nicholas,1994,3504,3289,215,6.1
21,183,Ohio,1994,9146,8370,776,8.5
21,185,Oldham,1994,20732,20273,459,2.2
21,187,Owen,1994,4498,4296,202,4.5
21,189,Owsley,1994,1512,1444,68,4.5
21,191,Pendleton,1994,6113,5812,301,4.9
21,193,Perry,1994,11392,10391,1001,8.8
21,195,Pike,1994,27198,24646,2552,9.4
21,197,Powell,1994,6461,5927,534,8.3
21,199,Pulaski,1994,23813,22366,1447,6.1
21,201,Robertson,1994,981,932,49,5.0
21,203,Rockcastle,1994,5827,5386,441,7.6
21,205,Rowan,1994,9152,8477,675,7.4
21,207,Russell,1994,6626,6107,519,7.8
21,209,Scott,1994,14281,13804,477,3.3
21,211,Shelby,1994,15742,15400,342,2.2
21,213,Simpson,1994,8093,7557,536,6.6
21,215,Spencer,1994,4405,4282,123,2.8
21,217,Taylor,1994,11609,11123,486,4.2
21,219,Todd,1994,5526,5316,210,3.8
21,221,Trigg,1994,5646,5397,249,4.4
21,223,Trimble,1994,3031,2916,115,3.8
21,225,Union,1994,6679,6315,364,5.4
21,227,Warren,1994,44890,43289,1601,3.6
21,229,Washington,1994,5605,5402,203,3.6
21,231,Wayne,1994,7772,7301,471,6.1
21,233,Webster,1994,5725,5363,362,6.3
21,235,Whitley,1994,13474,12413,1061,7.9
21,237,Wolfe,1994,3121,2806,315,10.1
21,239,Woodford,1994,11944,11574,370,3.1
22,1,Acadia Parish,1994,21995,20400,1595,7.3
22,3,Allen Parish,1994,8377,7515,862,10.3
22,5,Ascension Parish,1994,29402,27162,2240,7.6
22,7,Assumption Parish,1994,9218,8395,823,8.9
22,9,Avoyelles Parish,1994,16108,14427,1681,10.4
22,11,Beauregard Parish,1994,12931,11836,1095,8.5
22,13,Bienville Parish,1994,6380,5869,511,8.0
22,15,Bossier Parish,1994,42395,39760,2635,6.2
22,17,Caddo Parish,1994,114765,107112,7653,6.7
22,19,Calcasieu Parish,1994,83139,77371,5768,6.9
22,21,Caldwell Parish,1994,4491,4098,393,8.8
22,23,Cameron Parish,1994,3606,3386,220,6.1
22,25,Catahoula Parish,1994,5592,5054,538,9.6
22,27,Claiborne Parish,1994,5988,5478,510,8.5
22,29,Concordia Parish,1994,8449,7490,959,11.4
22,31,De Soto Parish,1994,10264,9425,839,8.2
22,33,East Baton Rouge Parish,1994,200313,188892,11421,5.7
22,35,East Carroll Parish,1994,3507,2931,576,16.4
22,37,East Feliciana Parish,1994,7760,7162,598,7.7
22,39,Evangeline Parish,1994,12101,11204,897,7.4
22,41,Franklin Parish,1994,10563,9568,995,9.4
22,43,Grant Parish,1994,6581,5817,764,11.6
22,45,Iberia Parish,1994,29874,27614,2260,7.6
22,47,Iberville Parish,1994,13242,11750,1492,11.3
22,49,Jackson Parish,1994,6388,6015,373,5.8
22,51,Jefferson Parish,1994,236591,218609,17982,7.6
22,53,Jefferson Davis Parish,1994,11849,10885,964,8.1
22,55,Lafayette Parish,1994,87516,83314,4202,4.8
22,57,Lafourche Parish,1994,37554,35442,2112,5.6
22,59,LaSalle Parish,1994,5917,5443,474,8.0
22,61,Lincoln Parish,1994,18140,17624,516,2.8
22,63,Livingston Parish,1994,36569,33372,3197,8.7
22,65,Madison Parish,1994,5318,4702,616,11.6
22,67,Morehouse Parish,1994,12791,11311,1480,11.6
22,69,Natchitoches Parish,1994,16004,14894,1110,6.9
22,71,Orleans Parish,1994,207762,187708,20054,9.7
22,73,Ouachita Parish,1994,65552,61601,3951,6.0
22,75,Plaquemines Parish,1994,10508,9478,1030,9.8
22,77,Pointe Coupee Parish,1994,9897,8836,1061,10.7
22,79,Rapides Parish,1994,57074,53507,3567,6.2
22,81,Red River Parish,1994,3828,3481,347,9.1
22,83,Richland Parish,1994,8321,7388,933,11.2
22,85,Sabine Parish,1994,8992,8461,531,5.9
22,87,St. Bernard Parish,1994,31986,28994,2992,9.4
22,89,St. Charles Parish,1994,21829,19865,1964,9.0
22,91,St. Helena Parish,1994,3991,3696,295,7.4
22,93,St. James Parish,1994,8885,7907,978,11.0
22,95,St. John the Baptist Parish,1994,19344,17223,2121,11.0
22,97,St. Landry Parish,1994,30372,27427,2945,9.7
22,99,St. Martin Parish,1994,19820,18295,1525,7.7
22,101,St. Mary Parish,1994,24184,21976,2208,9.1
22,103,St. Tammany Parish,1994,80061,73969,6092,7.6
22,105,Tangipahoa Parish,1994,41384,37167,4217,10.2
22,107,Tensas Parish,1994,3142,2873,269,8.6
22,109,Terrebonne Parish,1994,42132,39778,2354,5.6
22,111,Union Parish,1994,10985,10370,615,5.6
22,113,Vermilion Parish,1994,22209,20750,1459,6.6
22,115,Vernon Parish,1994,17112,15623,1489,8.7
22,117,Washington Parish,1994,17150,15673,1477,8.6
22,119,Webster Parish,1994,18662,16535,2127,11.4
22,121,West Baton Rouge Parish,1994,9518,8713,805,8.5
22,123,West Carroll Parish,1994,5223,4232,991,19.0
22,125,West Feliciana Parish,1994,3926,3595,331,8.4
22,127,Winn Parish,1994,6383,6067,316,5.0
23,1,Androscoggin,1994,56203,52393,3810,6.8
23,3,Aroostook,1994,38645,34344,4301,11.1
23,5,Cumberland,1994,129468,123733,5735,4.4
23,7,Franklin,1994,14600,13571,1029,7.0
23,9,Hancock,1994,26220,24375,1845,7.0
23,11,Kennebec,1994,58747,54973,3774,6.4
23,13,Knox,1994,19259,18334,925,4.8
23,15,Lincoln,1994,16057,15241,816,5.1
23,17,Oxford,1994,25061,22888,2173,8.7
23,19,Penobscot,1994,73141,67993,5148,7.0
23,21,Piscataquis,1994,8452,7704,748,8.8
23,23,Sagadahoc,1994,15801,15112,689,4.4
23,25,Somerset,1994,25319,22874,2445,9.7
23,27,Waldo,1994,17092,15781,1311,7.7
23,29,Washington,1994,15984,14190,1794,11.2
23,31,York,1994,86981,82278,4703,5.4
24,1,Allegany,1994,32361,29201,3160,9.8
24,3,Anne Arundel,1994,242072,231672,10400,4.3
24,5,Baltimore,1994,385761,364327,21434,5.6
24,9,Calvert,1994,33041,31822,1219,3.7
24,11,Caroline,1994,15019,14280,739,4.9
24,13,Carroll,1994,73705,70537,3168,4.3
24,15,Cecil,1994,37359,34437,2922,7.8
24,17,Charles,1994,57746,55681,2065,3.6
24,19,Dorchester,1994,15234,13857,1377,9.0
24,21,Frederick,1994,94108,90347,3761,4.0
24,23,Garrett,1994,13696,12187,1509,11.0
24,25,Harford,1994,106532,100301,6231,5.8
24,27,Howard,1994,125754,121279,4475,3.6
24,29,Kent,1994,9900,9335,565,5.7
24,31,Montgomery,1994,460810,447202,13608,3.0
24,33,Prince George's,1994,441915,421674,20241,4.6
24,35,Queen Anne's,1994,18928,18020,908,4.8
24,37,St. Mary's,1994,40662,38712,1950,4.8
24,39,Somerset,1994,11768,10428,1340,11.4
24,41,Talbot,1994,17411,16811,600,3.4
24,43,Washington,1994,64961,60526,4435,6.8
24,45,Wicomico,1994,47140,44077,3063,6.5
24,47,Worcester,1994,23740,21488,2252,9.5
24,510,Baltimore city,1994,319617,290849,28768,9.0
25,1,Barnstable,1994,101469,92763,8706,8.6
25,3,Berkshire,1994,67202,62014,5188,7.7
25,5,Bristol,1994,267781,243611,24170,9.0
25,7,Dukes,1994,8361,7795,566,6.8
25,9,Essex,1994,351834,328805,23029,6.5
25,11,Franklin,1994,37137,35142,1995,5.4
25,13,Hampden,1994,215421,198375,17046,7.9
25,15,Hampshire,1994,79578,75652,3926,4.9
25,17,Middlesex,1994,786456,746104,40352,5.1
25,19,Nantucket/town,1994,5579,5426,153,2.7
25,21,Norfolk,1994,346336,328837,17499,5.1
25,23,Plymouth,1994,235707,220308,15399,6.5
25,25,Suffolk,1994,329799,309319,20480,6.2
25,27,Worcester,1994,364236,343091,21145,5.8
26,1,Alcona,1994,4847,4235,612,12.6
26,3,Alger,1994,4138,3752,386,9.3
26,5,Allegan,1994,50182,47962,2220,4.4
26,7,Alpena,1994,15478,13548,1930,12.5
26,9,Antrim,1994,9371,8438,933,10.0
26,11,Arenac,1994,6596,5822,774,11.7
26,13,Baraga,1994,3834,3434,400,10.4
26,15,Barry,1994,28175,26788,1387,4.9
26,17,Bay,1994,55367,51089,4278,7.7
26,19,Benzie,1994,6863,6247,616,9.0
26,21,Berrien,1994,83924,78574,5350,6.4
26,23,Branch,1994,19687,18593,1094,5.6
26,25,Calhoun,1994,67316,63433,3883,5.8
26,27,Cass,1994,25765,24533,1232,4.8
26,29,Charlevoix,1994,12605,11337,1268,10.1
26,31,Cheboygan,1994,11718,10296,1422,12.1
26,33,Chippewa,1994,17387,15428,1959,11.3
26,35,Clare,1994,10483,9292,1191,11.4
26,37,Clinton,1994,32667,31328,1339,4.1
26,39,Crawford,1994,5684,5100,584,10.3
26,41,Delta,1994,18188,16238,1950,10.7
26,43,Dickinson,1994,13563,12552,1011,7.5
26,45,Eaton,1994,53144,51130,2014,3.8
26,47,Emmet,1994,15816,13929,1887,11.9
26,49,Genesee,1994,205609,188056,17553,8.5
26,51,Gladwin,1994,8872,7932,940,10.6
26,53,Gogebic,1994,8379,7631,748,8.9
26,55,Grand Traverse,1994,41437,39060,2377,5.7
26,57,Gratiot,1994,19347,17852,1495,7.7
26,59,Hillsdale,1994,22238,20967,1271,5.7
26,61,Houghton,1994,16434,15116,1318,8.0
26,63,Huron,1994,17580,15968,1612,9.2
26,65,Ingham,1994,149112,142201,6911,4.6
26,67,Ionia,1994,27087,24959,2128,7.9
26,69,Iosco,1994,10946,9701,1245,11.4
26,71,Iron,1994,5606,4953,653,11.6
26,73,Isabella,1994,27652,26254,1398,5.1
26,75,Jackson,1994,74802,69749,5053,6.8
26,77,Kalamazoo,1994,123928,118814,5114,4.1
26,79,Kalkaska,1994,7128,6437,691,9.7
26,81,Kent,1994,290714,277471,13243,4.6
26,83,Keweenaw,1994,730,632,98,13.4
26,85,Lake,1994,3283,2862,421,12.8
26,87,Lapeer,1994,39297,36796,2501,6.4
26,89,Leelanau,1994,10340,9752,588,5.7
26,91,Lenawee,1994,45361,43039,2322,5.1
26,93,Livingston,1994,69694,67029,2665,3.8
26,95,Luce,1994,2466,2116,350,14.2
26,97,Mackinac,1994,7072,6187,885,12.5
26,99,Macomb,1994,407672,385118,22554,5.5
26,101,Manistee,1994,10223,8992,1231,12.0
26,103,Marquette,1994,33740,31174,2566,7.6
26,105,Mason,1994,14441,12919,1522,10.5
26,107,Mecosta,1994,17350,16186,1164,6.7
26,109,Menominee,1994,13060,12133,927,7.1
26,111,Midland,1994,40946,38399,2547,6.2
26,113,Missaukee,1994,6255,5754,501,8.0
26,115,Monroe,1994,67520,63538,3982,5.9
26,117,Montcalm,1994,25004,22619,2385,9.5
26,119,Montmorency,1994,3571,2954,617,17.3
26,121,Muskegon,1994,78432,72562,5870,7.5
26,123,Newaygo,1994,20336,18176,2160,10.6
26,125,Oakland,1994,629074,601474,27600,4.4
26,127,Oceana,1994,13300,11554,1746,13.1
26,129,Ogemaw,1994,8348,7401,947,11.3
26,131,Ontonagon,1994,3904,3607,297,7.6
26,133,Osceola,1994,10647,9723,924,8.7
26,135,Oscoda,1994,3604,3226,378,10.5
26,137,Otsego,1994,11840,11020,820,6.9
26,139,Ottawa,1994,118028,113481,4547,3.9
26,141,Presque Isle,1994,6491,5320,1171,18.0
26,143,Roscommon,1994,8034,7138,896,11.2
26,145,Saginaw,1994,99515,92899,6616,6.6
26,147,St. Clair,1994,74570,69129,5441,7.3
26,149,St. Joseph,1994,32446,30961,1485,4.6
26,151,Sanilac,1994,20563,18588,1975,9.6
26,153,Schoolcraft,1994,4119,3532,587,14.3
26,155,Shiawassee,1994,35574,32744,2830,8.0
26,157,Tuscola,1994,27667,25335,2332,8.4
26,159,Van Buren,1994,35937,33325,2612,7.3
26,161,Washtenaw,1994,162626,157156,5470,3.4
26,163,Wayne,1994,935256,873969,61287,6.6
26,165,Wexford,1994,14152,12743,1409,10.0
27,1,Aitkin,1994,5741,5143,598,10.4
27,3,Anoka,1994,163119,157471,5648,3.5
27,5,Becker,1994,12959,11932,1027,7.9
27,7,Beltrami,1994,18047,16855,1192,6.6
27,9,Benton,1994,18949,18126,823,4.3
27,11,Big Stone,1994,2826,2679,147,5.2
27,13,Blue Earth,1994,32471,31563,908,2.8
27,15,Brown,1994,14874,14299,575,3.9
27,17,Carlton,1994,15247,14061,1186,7.8
27,19,Carver,1994,33811,32882,929,2.7
27,21,Cass,1994,10727,9810,917,8.5
27,23,Chippewa,1994,6488,6117,371,5.7
27,25,Chisago,1994,18281,17351,930,5.1
27,27,Clay,1994,29762,28687,1075,3.6
27,29,Clearwater,1994,4017,3411,606,15.1
27,31,Cook,1994,2858,2697,161,5.6
27,33,Cottonwood,1994,6347,6008,339,5.3
27,35,Crow Wing,1994,25065,23396,1669,6.7
27,37,Dakota,1994,189122,183684,5438,2.9
27,39,Dodge,1994,9079,8551,528,5.8
27,41,Douglas,1994,15851,15197,654,4.1
27,43,Faribault,1994,8390,7978,412,4.9
27,45,Fillmore,1994,10231,9714,517,5.1
27,47,Freeborn,1994,16820,15693,1127,6.7
27,49,Goodhue,1994,23508,22545,963,4.1
27,51,Grant,1994,3050,2903,147,4.8
27,53,Hennepin,1994,640396,619978,20418,3.2
27,55,Houston,1994,10765,10436,329,3.1
27,57,Hubbard,1994,7549,6955,594,7.9
27,59,Isanti,1994,14387,13706,681,4.7
27,61,Itasca,1994,19982,17661,2321,11.6
27,63,Jackson,1994,5769,5482,287,5.0
27,65,Kanabec,1994,7214,6608,606,8.4
27,67,Kandiyohi,1994,20324,19515,809,4.0
27,69,Kittson,1994,2523,2366,157,6.2
27,71,Koochiching,1994,6477,5850,627,9.7
27,73,Lac qui Parle,1994,4008,3859,149,3.7
27,75,Lake,1994,5607,5263,344,6.1
27,77,Lake of the Woods,1994,2349,2248,101,4.3
27,79,Le Sueur,1994,13619,12988,631,4.6
27,81,Lincoln,1994,3205,3051,154,4.8
27,83,Lyon,1994,14745,14255,490,3.3
27,85,McLeod,1994,20072,19291,781,3.9
27,87,Mahnomen,1994,2591,2386,205,7.9
27,89,Marshall,1994,4868,4345,523,10.7
27,91,Martin,1994,11811,11242,569,4.8
27,93,Meeker,1994,9515,8904,611,6.4
27,95,Mille Lacs,1994,9671,8978,693,7.2
27,97,Morrison,1994,14996,13849,1147,7.6
27,99,Mower,1994,18713,17992,721,3.9
27,101,Murray,1994,4552,4317,235,5.2
27,103,Nicollet,1994,17986,17510,476,2.6
27,105,Nobles,1994,10166,9835,331,3.3
27,107,Norman,1994,3617,3412,205,5.7
27,109,Olmsted,1994,65157,62901,2256,3.5
27,111,Otter Tail,1994,26178,24741,1437,5.5
27,113,Pennington,1994,7546,7081,465,6.2
27,115,Pine,1994,11078,10090,988,8.9
27,117,Pipestone,1994,5044,4861,183,3.6
27,119,Polk,1994,17000,16048,952,5.6
27,121,Pope,1994,5304,5050,254,4.8
27,123,Ramsey,1994,276429,267447,8982,3.2
27,125,Red Lake,1994,2066,1830,236,11.4
27,127,Redwood,1994,9197,8910,287,3.1
27,129,Renville,1994,8449,7937,512,6.1
27,131,Rice,1994,28173,26849,1324,4.7
27,133,Rock,1994,5025,4887,138,2.7
27,135,Roseau,1994,8557,8235,322,3.8
27,137,St. Louis,1994,100237,93776,6461,6.4
27,139,Scott,1994,39595,38337,1258,3.2
27,141,Sherburne,1994,27272,26165,1107,4.1
27,143,Sibley,1994,6942,6552,390,5.6
27,145,Stearns,1994,72138,69188,2950,4.1
27,147,Steele,1994,18076,17413,663,3.7
27,149,Stevens,1994,5393,5191,202,3.7
27,151,Swift,1994,5183,4944,239,4.6
27,153,Todd,1994,10471,9755,716,6.8
27,155,Traverse,1994,1922,1843,79,4.1
27,157,Wabasha,1994,11881,11380,501,4.2
27,159,Wadena,1994,6134,5786,348,5.7
27,161,Waseca,1994,9011,8626,385,4.3
27,163,Washington,1994,100293,97466,2827,2.8
27,165,Watonwan,1994,5863,5661,202,3.4
27,167,Wilkin,1994,4066,3910,156,3.8
27,169,Winona,1994,28265,27246,1019,3.6
27,171,Wright,1994,42188,40401,1787,4.2
27,173,Yellow Medicine,1994,5500,5207,293,5.3
28,1,Adams,1994,15044,13863,1181,7.9
28,3,Alcorn,1994,15886,14546,1340,8.4
28,5,Amite,1994,5059,4749,310,6.1
28,7,Attala,1994,7911,7246,665,8.4
28,9,Benton,1994,3172,2950,222,7.0
28,11,Bolivar,1994,18481,16781,1700,9.2
28,13,Calhoun,1994,7235,6891,344,4.8
28,15,Carroll,1994,4412,4146,266,6.0
28,17,Chickasaw,1994,8836,8133,703,8.0
28,19,Choctaw,1994,3300,3043,257,7.8
28,21,Claiborne,1994,3759,3311,448,11.9
28,23,Clarke,1994,8302,7804,498,6.0
28,25,Clay,1994,8910,7933,977,11.0
28,27,Coahoma,1994,12521,11174,1347,10.8
28,29,Copiah,1994,11263,10425,838,7.4
28,31,Covington,1994,8600,8124,476,5.5
28,33,DeSoto,1994,41802,39823,1979,4.7
28,35,Forrest,1994,32255,30691,1564,4.8
28,37,Franklin,1994,3239,3007,232,7.2
28,39,George,1994,7926,6989,937,11.8
28,41,Greene,1994,4619,4090,529,11.5
28,43,Grenada,1994,10144,9464,680,6.7
28,45,Hancock,1994,16045,15047,998,6.2
28,47,Harrison,1994,82546,78251,4295,5.2
28,49,Hinds,1994,127624,121494,6130,4.8
28,51,Holmes,1994,7602,6763,839,11.0
28,53,Humphreys,1994,5355,4448,907,16.9
28,55,Issaquena,1994,849,723,126,14.8
28,57,Itawamba,1994,11143,10694,449,4.0
28,59,Jackson,1994,65387,61705,3682,5.6
28,61,Jasper,1994,7524,6995,529,7.0
28,63,Jefferson,1994,2525,2075,450,17.8
28,65,Jefferson Davis,1994,5283,4794,489,9.3
28,67,Jones,1994,29629,28221,1408,4.8
28,69,Kemper,1994,4216,3881,335,7.9
28,71,Lafayette,1994,15673,15332,341,2.2
28,73,Lamar,1994,15383,14776,607,3.9
28,75,Lauderdale,1994,34841,32932,1909,5.5
28,77,Lawrence,1994,5211,4781,430,8.3
28,79,Leake,1994,8608,8032,576,6.7
28,81,Lee,1994,38573,36926,1647,4.3
28,83,Leflore,1994,15997,14478,1519,9.5
28,85,Lincoln,1994,12955,11957,998,7.7
28,87,Lowndes,1994,27319,25624,1695,6.2
28,89,Madison,1994,31488,30183,1305,4.1
28,91,Marion,1994,10210,9315,895,8.8
28,93,Marshall,1994,13831,12631,1200,8.7
28,95,Monroe,1994,17066,16044,1022,6.0
28,97,Montgomery,1994,5503,5137,366,6.7
28,99,Neshoba,1994,12932,12241,691,5.3
28,101,Newton,1994,8726,8191,535,6.1
28,103,Noxubee,1994,4480,4100,380,8.5
28,105,Oktibbeha,1994,18311,17666,645,3.5
28,107,Panola,1994,13631,12398,1233,9.0
28,109,Pearl River,1994,17967,16795,1172,6.5
28,111,Perry,1994,4918,4518,400,8.1
28,113,Pike,1994,15647,14423,1224,7.8
28,115,Pontotoc,1994,12769,12261,508,4.0
28,117,Prentiss,1994,12243,11423,820,6.7
28,119,Quitman,1994,3752,3316,436,11.6
28,121,Rankin,1994,51409,49734,1675,3.3
28,123,Scott,1994,13185,12626,559,4.2
28,125,Sharkey,1994,3256,2714,542,16.6
28,127,Simpson,1994,10702,10200,502,4.7
28,129,Smith,1994,6280,5973,307,4.9
28,131,Stone,1994,5094,4684,410,8.0
28,133,Sunflower,1994,11856,10518,1338,11.3
28,135,Tallahatchie,1994,5714,4992,722,12.6
28,137,Tate,1994,10513,9864,649,6.2
28,139,Tippah,1994,9754,9167,587,6.0
28,141,Tishomingo,1994,9951,9073,878,8.8
28,143,Tunica,1994,4534,4082,452,10.0
28,145,Union,1994,12169,11511,658,5.4
28,147,Walthall,1994,5865,5466,399,6.8
28,149,Warren,1994,27341,25542,1799,6.6
28,151,Washington,1994,29766,26629,3137,10.5
28,153,Wayne,1994,8760,8056,704,8.0
28,155,Webster,1994,4536,4277,259,5.7
28,157,Wilkinson,1994,3554,3181,373,10.5
28,159,Winston,1994,7924,7211,713,9.0
28,161,Yalobusha,1994,5184,4855,329,6.3
28,163,Yazoo,1994,9973,9096,877,8.8
29,1,Adair,1994,14239,13783,456,3.2
29,3,Andrew,1994,7658,7136,522,6.8
29,5,Atchison,1994,2935,2851,84,2.9
29,7,Audrain,1994,12336,11830,506,4.1
29,9,Barry,1994,14166,13450,716,5.1
29,11,Barton,1994,6684,6479,205,3.1
29,13,Bates,1994,7270,6788,482,6.6
29,15,Benton,1994,5911,5433,478,8.1
29,17,Bollinger,1994,4891,4568,323,6.6
29,19,Boone,1994,73542,72001,1541,2.1
29,21,Buchanan,1994,41598,37448,4150,10.0
29,23,Butler,1994,18665,17284,1381,7.4
29,25,Caldwell,1994,3792,3554,238,6.3
29,27,Callaway,1994,18329,17618,711,3.9
29,29,Camden,1994,14889,13736,1153,7.7
29,31,Cape Girardeau,1994,34366,32893,1473,4.3
29,33,Carroll,1994,5170,4845,325,6.3
29,35,Carter,1994,2490,2262,228,9.2
29,37,Cass,1994,38706,36954,1752,4.5
29,39,Cedar,1994,5276,5026,250,4.7
29,41,Chariton,1994,4061,3787,274,6.7
29,43,Christian,1994,22177,21307,870,3.9
29,45,Clark,1994,3521,3395,126,3.6
29,47,Clay,1994,95377,91817,3560,3.7
29,49,Clinton,1994,8676,8255,421,4.9
29,51,Cole,1994,36523,35397,1126,3.1
29,53,Cooper,1994,8288,7952,336,4.1
29,55,Crawford,1994,9958,9191,767,7.7
29,57,Dade,1994,3154,2981,173,5.5
29,59,Dallas,1994,5974,5587,387,6.5
29,61,Daviess,1994,3488,3292,196,5.6
29,63,DeKalb,1994,3884,3668,216,5.6
29,65,Dent,1994,6351,5867,484,7.6
29,67,Douglas,1994,5828,5464,364,6.2
29,69,Dunklin,1994,13590,12396,1194,8.8
29,71,Franklin,1994,43620,41384,2236,5.1
29,73,Gasconade,1994,7299,6863,436,6.0
29,75,Gentry,1994,3558,3446,112,3.1
29,77,Greene,1994,121467,117344,4123,3.4
29,79,Grundy,1994,5085,4830,255,5.0
29,81,Harrison,1994,4241,4102,139,3.3
29,83,Henry,1994,9706,9006,700,7.2
29,85,Hickory,1994,2801,2614,187,6.7
29,87,Holt,1994,2894,2752,142,4.9
29,89,Howard,1994,4835,4650,185,3.8
29,91,Howell,1994,16791,15505,1286,7.7
29,93,Iron,1994,4313,3817,496,11.5
29,95,Jackson,1994,345803,327667,18136,5.2
29,97,Jasper,1994,49761,47305,2456,4.9
29,99,Jefferson,1994,96124,91248,4876,5.1
29,101,Johnson,1994,21768,21032,736,3.4
29,103,Knox,1994,1872,1789,83,4.4
29,105,Laclede,1994,13887,12979,908,6.5
29,107,Lafayette,1994,15783,15080,703,4.5
29,109,Lawrence,1994,15184,14333,851,5.6
29,111,Lewis,1994,5281,5055,226,4.3
29,113,Lincoln,1994,15843,14877,966,6.1
29,115,Linn,1994,6984,6327,657,9.4
29,117,Livingston,1994,7106,6757,349,4.9
29,119,McDonald,1994,7278,6895,383,5.3
29,121,Macon,1994,7649,7097,552,7.2
29,123,Madison,1994,4757,4301,456,9.6
29,125,Maries,1994,4075,3896,179,4.4
29,127,Marion,1994,14867,14141,726,4.9
29,129,Mercer,1994,2156,2095,61,2.8
29,131,Miller,1994,10912,10012,900,8.2
29,133,Mississippi,1994,6241,5533,708,11.3
29,135,Moniteau,1994,6690,6404,286,4.3
29,137,Monroe,1994,4038,3815,223,5.5
29,139,Montgomery,1994,5772,5444,328,5.7
29,141,Morgan,1994,7881,7331,550,7.0
29,143,New Madrid,1994,8560,7883,677,7.9
29,145,Newton,1994,24999,23648,1351,5.4
29,147,Nodaway,1994,11904,11665,239,2.0
29,149,Oregon,1994,4244,3983,261,6.1
29,151,Osage,1994,6792,6522,270,4.0
29,153,Ozark,1994,4012,3765,247,6.2
29,155,Pemiscot,1994,8023,6687,1336,16.7
29,157,Perry,1994,9803,9355,448,4.6
29,159,Pettis,1994,19280,18043,1237,6.4
29,161,Phelps,1994,17761,16966,795,4.5
29,163,Pike,1994,7248,6723,525,7.2
29,165,Platte,1994,39209,37983,1226,3.1
29,167,Polk,1994,10789,10315,474,4.4
29,169,Pulaski,1994,12118,11124,994,8.2
29,171,Putnam,1994,2112,2048,64,3.0
29,173,Ralls,1994,4945,4722,223,4.5
29,175,Randolph,1994,10345,9632,713,6.9
29,177,Ray,1994,10449,9890,559,5.3
29,179,Reynolds,1994,3211,3004,207,6.4
29,181,Ripley,1994,4905,4466,439,9.0
29,183,St. Charles,1994,136270,130958,5312,3.9
29,185,St. Clair,1994,3659,3415,244,6.7
29,186,Ste. Genevieve,1994,8675,8203,472,5.4
29,187,St. Francois,1994,21740,19522,2218,10.2
29,189,St. Louis,1994,553095,531747,21348,3.9
29,195,Saline,1994,11609,11054,555,4.8
29,197,Schuyler,1994,2330,2220,110,4.7
29,199,Scotland,1994,2271,2203,68,3.0
29,201,Scott,1994,19243,18037,1206,6.3
29,203,Shannon,1994,3857,3578,279,7.2
29,205,Shelby,1994,3421,3277,144,4.2
29,207,Stoddard,1994,13284,12136,1148,8.6
29,209,Stone,1994,13685,12378,1307,9.6
29,211,Sullivan,1994,3053,2924,129,4.2
29,213,Taney,1994,25178,23137,2041,8.1
29,215,Texas,1994,9656,8510,1146,11.9
29,217,Vernon,1994,8503,8147,356,4.2
29,219,Warren,1994,11002,10358,644,5.9
29,221,Washington,1994,8513,7432,1081,12.7
29,223,Wayne,1994,3905,2996,909,23.3
29,225,Webster,1994,12352,11860,492,4.0
29,227,Worth,1994,951,906,45,4.7
29,229,Wright,1994,7645,6703,942,12.3
29,510,St. Louis city,1994,168145,154834,13311,7.9
30,1,Beaverhead,1994,4724,4535,189,4.0
30,3,Big Horn,1994,5226,4520,706,13.5
30,5,Blaine,1994,2878,2658,220,7.6
30,7,Broadwater,1994,1856,1777,79,4.3
30,9,Carbon,1994,4032,3784,248,6.2
30,11,Carter,1994,919,894,25,2.7
30,13,Cascade,1994,36691,34728,1963,5.4
30,15,Chouteau,1994,2662,2575,87,3.3
30,17,Custer,1994,6222,5972,250,4.0
30,19,Daniels,1994,1181,1154,27,2.3
30,21,Dawson,1994,4974,4826,148,3.0
30,23,Deer Lodge,1994,4219,3873,346,8.2
30,25,Fallon,1994,1564,1515,49,3.1
30,27,Fergus,1994,5922,5619,303,5.1
30,29,Flathead,1994,35532,32946,2586,7.3
30,31,Gallatin,1994,33546,32717,829,2.5
30,33,Garfield,1994,941,907,34,3.6
30,35,Glacier,1994,5644,4931,713,12.6
30,37,Golden Valley,1994,506,472,34,6.7
30,39,Granite,1994,1338,1251,87,6.5
30,41,Hill,1994,8897,8385,512,5.8
30,43,Jefferson,1994,4514,4340,174,3.9
30,45,Judith Basin,1994,1098,1051,47,4.3
30,47,Lake,1994,10299,9537,762,7.4
30,49,Lewis and Clark,1994,27310,26087,1223,4.5
30,51,Liberty,1994,1037,1007,30,2.9
30,53,Lincoln,1994,8436,7084,1352,16.0
30,55,McCone,1994,1167,1135,32,2.7
30,57,Madison,1994,3497,3322,175,5.0
30,59,Meagher,1994,950,897,53,5.6
30,61,Mineral,1994,1705,1525,180,10.6
30,63,Missoula,1994,47275,44908,2367,5.0
30,65,Musselshell,1994,1883,1753,130,6.9
30,67,Park,1994,9838,9415,423,4.3
30,69,Petroleum,1994,312,299,13,4.2
30,71,Phillips,1994,2506,2417,89,3.6
30,73,Pondera,1994,3075,2962,113,3.7
30,75,Powder River,1994,1209,1183,26,2.2
30,77,Powell,1994,2570,2361,209,8.1
30,79,Prairie,1994,679,652,27,4.0
30,81,Ravalli,1994,14444,13541,903,6.3
30,83,Richland,1994,5508,5184,324,5.9
30,85,Roosevelt,1994,4477,4030,447,10.0
30,87,Rosebud,1994,4871,4501,370,7.6
30,89,Sanders,1994,3949,3469,480,12.2
30,91,Sheridan,1994,2185,2146,39,1.8
30,93,Silver Bow,1994,17129,16157,972,5.7
30,95,Stillwater,1994,3516,3350,166,4.7
30,97,Sweet Grass,1994,1717,1666,51,3.0
30,99,Teton,1994,2919,2833,86,2.9
30,101,Toole,1994,2907,2791,116,4.0
30,103,Treasure,1994,477,462,15,3.1
30,105,Valley,1994,4313,4139,174,4.0
30,107,Wheatland,1994,1200,1146,54,4.5
30,109,Wibaux,1994,591,556,35,5.9
30,111,Yellowstone,1994,67494,64567,2927,4.3
31,1,Adams,1994,15776,15530,246,1.6
31,3,Antelope,1994,3339,3217,122,3.7
31,5,Arthur,1994,227,222,5,2.2
31,7,Banner,1994,429,418,11,2.6
31,9,Blaine,1994,341,327,14,4.1
31,11,Boone,1994,2891,2840,51,1.8
31,13,Box Butte,1994,6233,5997,236,3.8
31,15,Boyd,1994,1227,1191,36,2.9
31,17,Brown,1994,1865,1801,64,3.4
31,19,Buffalo,1994,23742,23144,598,2.5
31,21,Burt,1994,3689,3551,138,3.7
31,23,Butler,1994,4205,4103,102,2.4
31,25,Cass,1994,11489,11159,330,2.9
31,27,Cedar,1994,5226,5115,111,2.1
31,29,Chase,1994,1948,1906,42,2.2
31,31,Cherry,1994,3413,3338,75,2.2
31,33,Cheyenne,1994,5190,5065,125,2.4
31,35,Clay,1994,3514,3451,63,1.8
31,37,Colfax,1994,4718,4637,81,1.7
31,39,Cuming,1994,5342,5224,118,2.2
31,41,Custer,1994,5814,5679,135,2.3
31,43,Dakota,1994,9683,9410,273,2.8
31,45,Dawes,1994,4561,4407,154,3.4
31,47,Dawson,1994,13144,12723,421,3.2
31,49,Deuel,1994,1047,1019,28,2.7
31,51,Dixon,1994,2853,2772,81,2.8
31,53,Dodge,1994,18536,17989,547,3.0
31,55,Douglas,1994,241394,234325,7069,2.9
31,57,Dundy,1994,1212,1183,29,2.4
31,59,Fillmore,1994,3313,3249,64,1.9
31,61,Franklin,1994,1730,1690,40,2.3
31,63,Frontier,1994,1582,1557,25,1.6
31,65,Furnas,1994,2658,2609,49,1.8
31,67,Gage,1994,11840,11547,293,2.5
31,69,Garden,1994,1146,1127,19,1.7
31,71,Garfield,1994,1102,1073,29,2.6
31,73,Gosper,1994,1227,1200,27,2.2
31,75,Grant,1994,400,394,6,1.5
31,77,Greeley,1994,1527,1477,50,3.3
31,79,Hall,1994,30306,29658,648,2.1
31,81,Hamilton,1994,5214,5140,74,1.4
31,83,Harlan,1994,1763,1736,27,1.5
31,85,Hayes,1994,527,513,14,2.7
31,87,Hitchcock,1994,1635,1587,48,2.9
31,89,Holt,1994,6604,6442,162,2.5
31,91,Hooker,1994,412,398,14,3.4
31,93,Howard,1994,3366,3282,84,2.5
31,95,Jefferson,1994,4357,4247,110,2.5
31,97,Johnson,1994,2377,2315,62,2.6
31,99,Kearney,1994,3534,3471,63,1.8
31,101,Keith,1994,4592,4457,135,2.9
31,103,Keya Paha,1994,524,509,15,2.9
31,105,Kimball,1994,2233,2178,55,2.5
31,107,Knox,1994,4654,4514,140,3.0
31,109,Lancaster,1994,133556,130625,2931,2.2
31,111,Lincoln,1994,17833,17189,644,3.6
31,113,Logan,1994,454,442,12,2.6
31,115,Loup,1994,464,456,8,1.7
31,117,McPherson,1994,317,309,8,2.5
31,119,Madison,1994,19352,18870,482,2.5
31,121,Merrick,1994,4613,4530,83,1.8
31,123,Morrill,1994,2843,2722,121,4.3
31,125,Nance,1994,1954,1909,45,2.3
31,127,Nemaha,1994,3797,3639,158,4.2
31,129,Nuckolls,1994,2518,2466,52,2.1
31,131,Otoe,1994,7606,7358,248,3.3
31,133,Pawnee,1994,1534,1494,40,2.6
31,135,Perkins,1994,1449,1415,34,2.3
31,137,Phelps,1994,5356,5275,81,1.5
31,139,Pierce,1994,3964,3883,81,2.0
31,141,Platte,1994,17621,17228,393,2.2
31,143,Polk,1994,2606,2552,54,2.1
31,145,Red Willow,1994,6006,5857,149,2.5
31,147,Richardson,1994,4701,4514,187,4.0
31,149,Rock,1994,980,940,40,4.1
31,151,Saline,1994,7154,7043,111,1.6
31,153,Sarpy,1994,53620,52296,1324,2.5
31,155,Saunders,1994,10500,10229,271,2.6
31,157,Scotts Bluff,1994,18538,17707,831,4.5
31,159,Seward,1994,9171,8964,207,2.3
31,161,Sheridan,1994,3050,2976,74,2.4
31,163,Sherman,1994,1602,1550,52,3.2
31,165,Sioux,1994,818,805,13,1.6
31,167,Stanton,1994,3301,3216,85,2.6
31,169,Thayer,1994,3261,3211,50,1.5
31,171,Thomas,1994,429,409,20,4.7
31,173,Thurston,1994,2775,2595,180,6.5
31,175,Valley,1994,2805,2737,68,2.4
31,177,Washington,1994,9854,9644,210,2.1
31,179,Wayne,1994,6022,5847,175,2.9
31,181,Webster,1994,1868,1831,37,2.0
31,183,Wheeler,1994,422,409,13,3.1
31,185,York,1994,8745,8615,130,1.5
32,1,Churchill,1994,8892,8155,737,8.3
32,3,Clark,1994,527872,494931,32941,6.2
32,5,Douglas,1994,16996,15721,1275,7.5
32,7,Elko,1994,20813,19515,1298,6.2
32,9,Esmeralda,1994,788,732,56,7.1
32,11,Eureka,1994,783,696,87,11.1
32,13,Humboldt,1994,8073,7630,443,5.5
32,15,Lander,1994,3069,2717,352,11.5
32,17,Lincoln,1994,1420,1254,166,11.7
32,19,Lyon,1994,10921,9861,1060,9.7
32,21,Mineral,1994,3015,2696,319,10.6
32,23,Nye,1994,11877,11197,680,5.7
32,27,Pershing,1994,2092,1940,152,7.3
32,29,Storey,1994,1473,1399,74,5.0
32,31,Washoe,1994,167983,159055,8928,5.3
32,33,White Pine,1994,3700,3316,384,10.4
32,510,Carson City,1994,22111,20333,1778,8.0
33,1,Belknap,1994,27639,26439,1200,4.3
33,3,Carroll,1994,19621,18860,761,3.9
33,5,Cheshire,1994,39059,37561,1498,3.8
33,7,Coos,1994,17172,16033,1139,6.6
33,9,Grafton,1994,41611,40365,1246,3.0
33,11,Hillsborough,1994,189196,180023,9173,4.8
33,13,Merrimack,1994,70197,67932,2265,3.2
33,15,Rockingham,1994,143872,135877,7995,5.6
33,17,Strafford,1994,56992,54814,2178,3.8
33,19,Sullivan,1994,20613,19905,708,3.4
34,1,Atlantic,1994,123208,112435,10773,8.7
34,3,Bergen,1994,432938,406022,26916,6.2
34,5,Burlington,1994,206419,195430,10989,5.3
34,7,Camden,1994,253250,236078,17172,6.8
34,9,Cape May,1994,45845,40027,5818,12.7
34,11,Cumberland,1994,64721,57920,6801,10.5
34,13,Essex,1994,374510,343510,31000,8.3
34,15,Gloucester,1994,124442,116046,8396,6.7
34,17,Hudson,1994,285389,258695,26694,9.4
34,19,Hunterdon,1994,62944,60583,2361,3.8
34,21,Mercer,1994,170531,161401,9130,5.4
34,23,Middlesex,1994,382207,360029,22178,5.8
34,25,Monmouth,1994,298161,280982,17179,5.8
34,27,Morris,1994,246714,234434,12280,5.0
34,29,Ocean,1994,199919,186755,13164,6.6
34,31,Passaic,1994,231445,209763,21682,9.4
34,33,Salem,1994,31073,28971,2102,6.8
34,35,Somerset,1994,150326,143793,6533,4.3
34,37,Sussex,1994,73028,68385,4643,6.4
34,39,Union,1994,261822,242964,18858,7.2
34,41,Warren,1994,48900,45801,3099,6.3
35,1,Bernalillo,1994,274958,262408,12550,4.6
35,3,Catron,1994,1287,1113,174,13.5
35,5,Chaves,1994,25756,23867,1889,7.3
35,6,Cibola,1994,10111,9061,1050,10.4
35,7,Colfax,1994,6563,6091,472,7.2
35,9,Curry,1994,19615,18502,1113,5.7
35,11,De Baca,1994,888,858,30,3.4
35,13,Dona Ana,1994,62738,57136,5602,8.9
35,15,Eddy,1994,23535,21392,2143,9.1
35,17,Grant,1994,11781,10886,895,7.6
35,19,Guadalupe,1994,1982,1751,231,11.7
35,21,Harding,1994,442,412,30,6.8
35,23,Hidalgo,1994,3274,3068,206,6.3
35,25,Lea,1994,24118,22380,1738,7.2
35,27,Lincoln,1994,7018,6603,415,5.9
35,28,Los Alamos,1994,10912,10774,138,1.3
35,29,Luna,1994,9545,7542,2003,21.0
35,31,McKinley,1994,24582,22460,2122,8.6
35,33,Mora,1994,1663,1339,324,19.5
35,35,Otero,1994,20018,18464,1554,7.8
35,37,Quay,1994,4922,4621,301,6.1
35,39,Rio Arriba,1994,16900,15030,1870,11.1
35,41,Roosevelt,1994,7629,7239,390,5.1
35,43,Sandoval,1994,35962,34254,1708,4.7
35,45,San Juan,1994,45432,40837,4595,10.1
35,47,San Miguel,1994,12152,11205,947,7.8
35,49,Santa Fe,1994,61965,59596,2369,3.8
35,51,Sierra,1994,3525,3334,191,5.4
35,53,Socorro,1994,6399,5866,533,8.3
35,55,Taos,1994,12581,10740,1841,14.6
35,57,Torrance,1994,5015,4680,335,6.7
35,59,Union,1994,1975,1887,88,4.5
35,61,Valencia,1994,23641,22496,1145,4.8
36,1,Albany,1994,157319,150871,6448,4.1
36,3,Allegany,1994,22820,20917,1903,8.3
36,5,Bronx,1994,447109,401813,45296,10.1
36,7,Broome,1994,101723,94948,6775,6.7
36,9,Cattaraugus,1994,39858,36572,3286,8.2
36,11,Cayuga,1994,37769,35411,2358,6.2
36,13,Chautauqua,1994,68246,63762,4484,6.6
36,15,Chemung,1994,43205,40935,2270,5.3
36,17,Chenango,1994,25031,23028,2003,8.0
36,19,Clinton,1994,41323,38159,3164,7.7
36,21,Columbia,1994,32924,31395,1529,4.6
36,23,Cortland,1994,24337,22465,1872,7.7
36,25,Delaware,1994,21018,19673,1345,6.4
36,27,Dutchess,1994,117747,109595,8152,6.9
36,29,Erie,1994,470199,442627,27572,5.9
36,31,Essex,1994,18106,16259,1847,10.2
36,33,Franklin,1994,21510,19630,1880,8.7
36,35,Fulton,1994,27517,25427,2090,7.6
36,37,Genesee,1994,32084,30027,2057,6.4
36,39,Greene,1994,21416,19660,1756,8.2
36,41,Hamilton,1994,2670,2372,298,11.2
36,43,Herkimer,1994,30652,28600,2052,6.7
36,45,Jefferson,1994,44375,39867,4508,10.2
36,47,Kings,1994,932007,840236,91771,9.8
36,49,Lewis,1994,12495,11344,1151,9.2
36,51,Livingston,1994,33918,31936,1982,5.8
36,53,Madison,1994,35167,33070,2097,6.0
36,55,Monroe,1994,384542,365858,18684,4.9
36,57,Montgomery,1994,24414,22564,1850,7.6
36,59,Nassau,1994,675366,641283,34083,5.0
36,61,New York,1994,776377,717487,58890,7.6
36,63,Niagara,1994,108768,101304,7464,6.9
36,65,Oneida,1994,113827,107837,5990,5.3
36,67,Onondaga,1994,237687,225610,12077,5.1
36,69,Ontario,1994,52715,49895,2820,5.3
36,71,Orange,1994,153907,145614,8293,5.4
36,73,Orleans,1994,20958,19482,1476,7.0
36,75,Oswego,1994,57458,52454,5004,8.7
36,77,Otsego,1994,30557,28685,1872,6.1
36,79,Putnam,1994,48569,46306,2263,4.7
36,81,Queens,1994,946236,868178,78058,8.2
36,83,Rensselaer,1994,82479,78121,4358,5.3
36,85,Richmond,1994,184966,170570,14396,7.8
36,87,Rockland,1994,142796,135187,7609,5.3
36,89,St. Lawrence,1994,51331,46521,4810,9.4
36,91,Saratoga,1994,102529,97618,4911,4.8
36,93,Schenectady,1994,75370,71685,3685,4.9
36,95,Schoharie,1994,15547,14588,959,6.2
36,97,Schuyler,1994,8637,8042,595,6.9
36,99,Seneca,1994,15561,14617,944,6.1
36,101,Steuben,1994,48574,45417,3157,6.5
36,103,Suffolk,1994,693050,650058,42992,6.2
36,105,Sullivan,1994,32723,30274,2449,7.5
36,107,Tioga,1994,26440,24643,1797,6.8
36,109,Tompkins,1994,48907,47055,1852,3.8
36,111,Ulster,1994,80729,75426,5303,6.6
36,113,Warren,1994,32653,30140,2513,7.7
36,115,Washington,1994,29638,27773,1865,6.3
36,117,Wayne,1994,48237,45317,2920,6.1
36,119,Westchester,1994,439586,418000,21586,4.9
36,121,Wyoming,1994,21647,19947,1700,7.9
36,123,Yates,1994,12402,11757,645,5.2
37,1,Alamance,1994,63388,61157,2231,3.5
37,3,Alexander,1994,16901,16391,510,3.0
37,5,Alleghany,1994,4904,4681,223,4.5
37,7,Anson,1994,11558,10345,1213,10.5
37,9,Ashe,1994,11534,10848,686,5.9
37,11,Avery,1994,7255,6758,497,6.9
37,13,Beaufort,1994,19701,18384,1317,6.7
37,15,Bertie,1994,9021,8423,598,6.6
37,17,Bladen,1994,16453,15169,1284,7.8
37,19,Brunswick,1994,28683,25655,3028,10.6
37,21,Buncombe,1994,99084,95265,3819,3.9
37,23,Burke,1994,43416,41845,1571,3.6
37,25,Cabarrus,1994,58935,56979,1956,3.3
37,27,Caldwell,1994,40897,39743,1154,2.8
37,29,Camden,1994,2906,2789,117,4.0
37,31,Carteret,1994,27356,25753,1603,5.9
37,33,Caswell,1994,11309,10888,421,3.7
37,35,Catawba,1994,74017,71361,2656,3.6
37,37,Chatham,1994,23448,22850,598,2.6
37,39,Cherokee,1994,9450,8667,783,8.3
37,41,Chowan,1994,6612,6272,340,5.1
37,43,Clay,1994,3344,3127,217,6.5
37,45,Cleveland,1994,45494,43441,2053,4.5
37,47,Columbus,1994,26460,24445,2015,7.6
37,49,Craven,1994,34403,32353,2050,6.0
37,51,Cumberland,1994,111308,105474,5834,5.2
37,53,Currituck,1994,7634,7380,254,3.3
37,55,Dare,1994,15362,14446,916,6.0
37,57,Davidson,1994,75400,72912,2488,3.3
37,59,Davie,1994,16069,15629,440,2.7
37,61,Duplin,1994,20818,19583,1235,5.9
37,63,Durham,1994,107550,104209,3341,3.1
37,65,Edgecombe,1994,27082,25120,1962,7.2
37,67,Forsyth,1994,150165,144435,5730,3.8
37,69,Franklin,1994,20359,19672,687,3.4
37,71,Gaston,1994,97163,92950,4213,4.3
37,73,Gates,1994,4577,4394,183,4.0
37,75,Graham,1994,4323,3733,590,13.6
37,77,Granville,1994,21443,20477,966,4.5
37,79,Greene,1994,8019,7582,437,5.4
37,81,Guilford,1994,209697,202277,7420,3.5
37,83,Halifax,1994,24321,22541,1780,7.3
37,85,Harnett,1994,32569,31408,1161,3.6
37,87,Haywood,1994,23588,22058,1530,6.5
37,89,Henderson,1994,35022,33852,1170,3.3
37,91,Hertford,1994,10117,9406,711,7.0
37,93,Hoke,1994,10771,10041,730,6.8
37,95,Hyde,1994,2809,2524,285,10.1
37,97,Iredell,1994,55860,54186,1674,3.0
37,99,Jackson,1994,14671,13831,840,5.7
37,101,Johnston,1994,48803,47347,1456,3.0
37,103,Jones,1994,4491,4269,222,4.9
37,105,Lee,1994,24970,23848,1122,4.5
37,107,Lenoir,1994,29057,27002,2055,7.1
37,109,Lincoln,1994,30349,29207,1142,3.8
37,111,McDowell,1994,19790,18780,1010,5.1
37,113,Macon,1994,12236,11630,606,5.0
37,115,Madison,1994,8607,8230,377,4.4
37,117,Martin,1994,12930,12108,822,6.4
37,119,Mecklenburg,1994,325183,313786,11397,3.5
37,121,Mitchell,1994,6669,6075,594,8.9
37,123,Montgomery,1994,11844,11063,781,6.6
37,125,Moore,1994,28539,27350,1189,4.2
37,127,Nash,1994,42938,40730,2208,5.1
37,129,New Hanover,1994,72957,67883,5074,7.0
37,131,Northampton,1994,8685,7991,694,8.0
37,133,Onslow,1994,42965,41073,1892,4.4
37,135,Orange,1994,59163,57984,1179,2.0
37,137,Pamlico,1994,5285,4982,303,5.7
37,139,Pasquotank,1994,13921,13184,737,5.3
37,141,Pender,1994,14355,13381,974,6.8
37,143,Perquimans,1994,4405,4204,201,4.6
37,145,Person,1994,16005,15006,999,6.2
37,147,Pitt,1994,60832,57996,2836,4.7
37,149,Polk,1994,7417,7201,216,2.9
37,151,Randolph,1994,65748,63846,1902,2.9
37,153,Richmond,1994,21510,19382,2128,9.9
37,155,Robeson,1994,54533,50346,4187,7.7
37,157,Rockingham,1994,47824,44995,2829,5.9
37,159,Rowan,1994,60765,58780,1985,3.3
37,161,Rutherford,1994,30713,29326,1387,4.5
37,163,Sampson,1994,23203,21914,1289,5.6
37,165,Scotland,1994,17545,16176,1369,7.8
37,167,Stanly,1994,27175,25479,1696,6.2
37,169,Stokes,1994,21341,20691,650,3.0
37,171,Surry,1994,35775,34320,1455,4.1
37,173,Swain,1994,6024,5089,935,15.5
37,175,Transylvania,1994,11420,10895,525,4.6
37,177,Tyrrell,1994,1822,1665,157,8.6
37,179,Union,1994,51790,50073,1717,3.3
37,181,Vance,1994,19693,17930,1763,9.0
37,183,Wake,1994,291766,284090,7676,2.6
37,185,Warren,1994,7137,6582,555,7.8
37,187,Washington,1994,6106,5641,465,7.6
37,189,Watauga,1994,21960,21450,510,2.3
37,191,Wayne,1994,48318,45775,2543,5.3
37,193,Wilkes,1994,32359,31115,1244,3.8
37,195,Wilson,1994,35898,32611,3287,9.2
37,197,Yadkin,1994,16943,16438,505,3.0
37,199,Yancey,1994,6629,6132,497,7.5
38,1,Adams,1994,1656,1624,32,1.9
38,3,Barnes,1994,6107,5935,172,2.8
38,5,Benson,1994,3052,2802,250,8.2
38,7,Billings,1994,467,449,18,3.9
38,9,Bottineau,1994,3584,3470,114,3.2
38,11,Bowman,1994,1848,1797,51,2.8
38,13,Burke,1994,1141,1112,29,2.5
38,15,Burleigh,1994,36869,35530,1339,3.6
38,17,Cass,1994,65585,64132,1453,2.2
38,19,Cavalier,1994,2757,2638,119,4.3
38,21,Dickey,1994,3023,2949,74,2.4
38,23,Divide,1994,1189,1169,20,1.7
38,25,Dunn,1994,2703,2634,69,2.6
38,27,Eddy,1994,1353,1254,99,7.3
38,29,Emmons,1994,2347,2262,85,3.6
38,31,Foster,1994,2051,1992,59,2.9
38,33,Golden Valley,1994,845,815,30,3.6
38,35,Grand Forks,1994,36249,35134,1115,3.1
38,37,Grant,1994,2250,2200,50,2.2
38,39,Griggs,1994,1826,1789,37,2.0
38,41,Hettinger,1994,1563,1518,45,2.9
38,43,Kidder,1994,1565,1484,81,5.2
38,45,LaMoure,1994,2493,2424,69,2.8
38,47,Logan,1994,1208,1180,28,2.3
38,49,McHenry,1994,2900,2761,139,4.8
38,51,McIntosh,1994,1738,1696,42,2.4
38,53,McKenzie,1994,3422,3342,80,2.3
38,55,McLean,1994,4642,4400,242,5.2
38,57,Mercer,1994,4984,4556,428,8.6
38,59,Morton,1994,12976,12399,577,4.4
38,61,Mountrail,1994,3328,3038,290,8.7
38,63,Nelson,1994,1709,1639,70,4.1
38,65,Oliver,1994,1157,1119,38,3.3
38,67,Pembina,1994,5033,4668,365,7.3
38,69,Pierce,1994,2241,2188,53,2.4
38,71,Ramsey,1994,6535,6309,226,3.5
38,73,Ransom,1994,2854,2776,78,2.7
38,75,Renville,1994,1419,1384,35,2.5
38,77,Richland,1994,9389,9074,315,3.4
38,79,Rolette,1994,5812,5127,685,11.8
38,81,Sargent,1994,2140,2081,59,2.8
38,83,Sheridan,1994,787,761,26,3.3
38,85,Sioux,1994,2053,1920,133,6.5
38,87,Slope,1994,539,525,14,2.6
38,89,Stark,1994,12832,12303,529,4.1
38,91,Steele,1994,1306,1288,18,1.4
38,93,Stutsman,1994,11409,11025,384,3.4
38,95,Towner,1994,1761,1723,38,2.2
38,97,Traill,1994,4085,3939,146,3.6
38,99,Walsh,1994,6270,5884,386,6.2
38,101,Ward,1994,28744,27706,1038,3.6
38,103,Wells,1994,2512,2366,146,5.8
38,105,Williams,1994,9995,9541,454,4.5
39,1,Adams,1994,11236,9742,1494,13.3
39,3,Allen,1994,51709,48186,3523,6.8
39,5,Ashland,1994,25723,24313,1410,5.5
39,7,Ashtabula,1994,45997,42140,3857,8.4
39,9,Athens,1994,25126,23770,1356,5.4
39,11,Auglaize,1994,24019,22575,1444,6.0
39,13,Belmont,1994,30867,28506,2361,7.6
39,15,Brown,1994,17888,16753,1135,6.3
39,17,Butler,1994,161362,152470,8892,5.5
39,19,Carroll,1994,12605,11818,787,6.2
39,21,Champaign,1994,18530,17389,1141,6.2
39,23,Clark,1994,69416,66009,3407,4.9
39,25,Clermont,1994,85500,81170,4330,5.1
39,27,Clinton,1994,21359,20284,1075,5.0
39,29,Columbiana,1994,51398,47459,3939,7.7
39,31,Coshocton,1994,16671,15636,1035,6.2
39,33,Crawford,1994,22457,20801,1656,7.4
39,35,Cuyahoga,1994,682495,642966,39529,5.8
39,37,Darke,1994,28986,27476,1510,5.2
39,39,Defiance,1994,20493,19330,1163,5.7
39,41,Delaware,1994,41777,40238,1539,3.7
39,43,Erie,1994,43551,41221,2330,5.4
39,45,Fairfield,1994,58854,55899,2955,5.0
39,47,Fayette,1994,14693,13938,755,5.1
39,49,Franklin,1994,559928,538625,21303,3.8
39,51,Fulton,1994,21732,20541,1191,5.5
39,53,Gallia,1994,13838,12670,1168,8.4
39,55,Geauga,1994,43874,41960,1914,4.4
39,57,Greene,1994,68392,65330,3062,4.5
39,59,Guernsey,1994,18347,16543,1804,9.8
39,61,Hamilton,1994,436543,414975,21568,4.9
39,63,Hancock,1994,39145,37560,1585,4.0
39,65,Hardin,1994,14487,13731,756,5.2
39,67,Harrison,1994,7252,6712,540,7.4
39,69,Henry,1994,16058,15071,987,6.1
39,71,Highland,1994,17191,16079,1112,6.5
39,73,Hocking,1994,12101,10954,1147,9.5
39,75,Holmes,1994,17381,16779,602,3.5
39,77,Huron,1994,29462,26857,2605,8.8
39,79,Jackson,1994,13854,12721,1133,8.2
39,81,Jefferson,1994,31709,29030,2679,8.4
39,83,Knox,1994,26715,25389,1326,5.0
39,85,Lake,1994,122209,115516,6693,5.5
39,87,Lawrence,1994,25845,23927,1918,7.4
39,89,Licking,1994,68366,65170,3196,4.7
39,91,Logan,1994,23609,22475,1134,4.8
39,93,Lorain,1994,137741,129812,7929,5.8
39,95,Lucas,1994,228218,214448,13770,6.0
39,97,Madison,1994,19484,18660,824,4.2
39,99,Mahoning,1994,120518,110195,10323,8.6
39,101,Marion,1994,31898,30002,1896,5.9
39,103,Medina,1994,71063,67616,3447,4.9
39,105,Meigs,1994,8573,7627,946,11.0
39,107,Mercer,1994,20646,19042,1604,7.8
39,109,Miami,1994,49398,47280,2118,4.3
39,111,Monroe,1994,6214,5610,604,9.7
39,113,Montgomery,1994,283298,269257,14041,5.0
39,115,Morgan,1994,5161,4474,687,13.3
39,117,Morrow,1994,14145,13283,862,6.1
39,119,Muskingum,1994,41829,38406,3423,8.2
39,121,Noble,1994,5114,4644,470,9.2
39,123,Ottawa,1994,20311,18604,1707,8.4
39,125,Paulding,1994,9649,9132,517,5.4
39,127,Perry,1994,14586,13105,1481,10.2
39,129,Pickaway,1994,23136,22013,1123,4.9
39,131,Pike,1994,10887,9643,1244,11.4
39,133,Portage,1994,80292,76001,4291,5.3
39,135,Preble,1994,21024,19944,1080,5.1
39,137,Putnam,1994,18825,17816,1009,5.4
39,139,Richland,1994,62882,57582,5300,8.4
39,141,Ross,1994,33174,30806,2368,7.1
39,143,Sandusky,1994,31897,29904,1993,6.2
39,145,Scioto,1994,31955,28668,3287,10.3
39,147,Seneca,1994,30011,28099,1912,6.4
39,149,Shelby,1994,26197,24820,1377,5.3
39,151,Stark,1994,185143,173528,11615,6.3
39,153,Summit,1994,273216,258817,14399,5.3
39,155,Trumbull,1994,112009,103187,8822,7.9
39,157,Tuscarawas,1994,43638,40802,2836,6.5
39,159,Union,1994,15737,15053,684,4.3
39,161,Van Wert,1994,15933,15226,707,4.4
39,163,Vinton,1994,3976,3514,462,11.6
39,165,Warren,1994,65985,62602,3383,5.1
39,167,Washington,1994,31896,29699,2197,6.9
39,169,Wayne,1994,54498,52299,2199,4.0
39,171,Williams,1994,22333,21408,925,4.1
39,173,Wood,1994,62956,60064,2892,4.6
39,175,Wyandot,1994,11532,10839,693,6.0
40,1,Adair,1994,10295,9869,426,4.1
40,3,Alfalfa,1994,2693,2660,33,1.2
40,5,Atoka,1994,4855,4602,253,5.2
40,7,Beaver,1994,3059,2966,93,3.0
40,9,Beckham,1994,9429,8988,441,4.7
40,11,Blaine,1994,5081,4902,179,3.5
40,13,Bryan,1994,13838,13182,656,4.7
40,15,Caddo,1994,11939,11274,665,5.6
40,17,Canadian,1994,40722,39433,1289,3.2
40,19,Carter,1994,20464,19271,1193,5.8
40,21,Cherokee,1994,16379,15372,1007,6.1
40,23,Choctaw,1994,5908,5286,622,10.5
40,25,Cimarron,1994,1776,1740,36,2.0
40,27,Cleveland,1994,98455,95327,3128,3.2
40,29,Coal,1994,2547,2316,231,9.1
40,31,Comanche,1994,41891,39442,2449,5.8
40,33,Cotton,1994,2467,2308,159,6.4
40,35,Craig,1994,6513,6181,332,5.1
40,37,Creek,1994,30546,28573,1973,6.5
40,39,Custer,1994,13457,12896,561,4.2
40,41,Delaware,1994,14744,14137,607,4.1
40,43,Dewey,1994,2358,2258,100,4.2
40,45,Ellis,1994,1935,1841,94,4.9
40,47,Garfield,1994,27498,26474,1024,3.7
40,49,Garvin,1994,11629,10934,695,6.0
40,51,Grady,1994,19924,18910,1014,5.1
40,53,Grant,1994,2501,2442,59,2.4
40,55,Greer,1994,2471,2395,76,3.1
40,57,Harmon,1994,1367,1323,44,3.2
40,59,Harper,1994,2022,1952,70,3.5
40,61,Haskell,1994,4275,3625,650,15.2
40,63,Hughes,1994,5667,4961,706,12.5
40,65,Jackson,1994,10885,10449,436,4.0
40,67,Jefferson,1994,3294,3112,182,5.5
40,69,Johnston,1994,4723,4489,234,5.0
40,71,Kay,1994,23229,21218,2011,8.7
40,73,Kingfisher,1994,6890,6625,265,3.8
40,75,Kiowa,1994,4897,4720,177,3.6
40,77,Latimer,1994,4281,3682,599,14.0
40,79,Le Flore,1994,19114,17666,1448,7.6
40,81,Lincoln,1994,14657,14005,652,4.4
40,83,Logan,1994,13759,13276,483,3.5
40,85,Love,1994,3978,3723,255,6.4
40,87,McClain,1994,11576,11144,432,3.7
40,89,McCurtain,1994,14890,13577,1313,8.8
40,91,McIntosh,1994,7184,6480,704,9.8
40,93,Major,1994,3848,3727,121,3.1
40,95,Marshall,1994,5162,4878,284,5.5
40,97,Mayes,1994,14956,13971,985,6.6
40,99,Murray,1994,5546,5067,479,8.6
40,101,Muskogee,1994,30090,27682,2408,8.0
40,103,Noble,1994,5713,5530,183,3.2
40,105,Nowata,1994,3913,3658,255,6.5
40,107,Okfuskee,1994,4368,4040,328,7.5
40,109,Oklahoma,1994,308885,294701,14184,4.6
40,111,Okmulgee,1994,15267,13776,1491,9.8
40,113,Osage,1994,19178,18293,885,4.6
40,115,Ottawa,1994,13148,12352,796,6.1
40,117,Pawnee,1994,6801,6115,686,10.1
40,119,Payne,1994,33953,32976,977,2.9
40,121,Pittsburg,1994,17988,16131,1857,10.3
40,123,Pontotoc,1994,16028,15178,850,5.3
40,125,Pottawatomie,1994,26345,24965,1380,5.2
40,127,Pushmataha,1994,4977,4588,389,7.8
40,129,Roger Mills,1994,2090,2020,70,3.3
40,131,Rogers,1994,30985,28992,1993,6.4
40,133,Seminole,1994,10783,9824,959,8.9
40,135,Sequoyah,1994,16395,15072,1323,8.1
40,137,Stephens,1994,18465,16909,1556,8.4
40,139,Texas,1994,9024,8760,264,2.9
40,141,Tillman,1994,4267,4047,220,5.2
40,143,Tulsa,1994,276990,262689,14301,5.2
40,145,Wagoner,1994,25684,24473,1211,4.7
40,147,Washington,1994,20530,19333,1197,5.8
40,149,Washita,1994,5278,5044,234,4.4
40,151,Woods,1994,4430,4298,132,3.0
40,153,Woodward,1994,9244,8773,471,5.1
41,1,Baker,1994,7459,6871,588,7.9
41,3,Benton,1994,39486,38496,990,2.5
41,5,Clackamas,1994,176701,170287,6414,3.6
41,7,Clatsop,1994,17397,16318,1079,6.2
41,9,Columbia,1994,20670,19352,1318,6.4
41,11,Coos,1994,27875,25529,2346,8.4
41,13,Crook,1994,8006,7415,591,7.4
41,15,Curry,1994,8368,7738,630,7.5
41,17,Deschutes,1994,49211,45733,3478,7.1
41,19,Douglas,1994,43013,39162,3851,9.0
41,21,Gilliam,1994,1106,1066,40,3.6
41,23,Grant,1994,4311,3904,407,9.4
41,25,Harney,1994,3764,3394,370,9.8
41,27,Hood River,1994,10195,9405,790,7.7
41,29,Jackson,1994,82470,77050,5420,6.6
41,31,Jefferson,1994,7831,7332,499,6.4
41,33,Josephine,1994,28490,25948,2542,8.9
41,35,Klamath,1994,28419,26012,2407,8.5
41,37,Lake,1994,3931,3612,319,8.1
41,39,Lane,1994,155474,147199,8275,5.3
41,41,Lincoln,1994,21008,19763,1245,5.9
41,43,Linn,1994,47926,44627,3299,6.9
41,45,Malheur,1994,14599,13602,997,6.8
41,47,Marion,1994,130415,123381,7034,5.4
41,49,Morrow,1994,3875,3560,315,8.1
41,51,Multnomah,1994,348910,332340,16570,4.7
41,53,Polk,1994,27840,26587,1253,4.5
41,55,Sherman,1994,962,903,59,6.1
41,57,Tillamook,1994,10843,10331,512,4.7
41,59,Umatilla,1994,32322,30076,2246,6.9
41,61,Union,1994,12507,11734,773,6.2
41,63,Wallowa,1994,3611,3281,330,9.1
41,65,Wasco,1994,11550,10721,829,7.2
41,67,Washington,1994,214253,206395,7858,3.7
41,69,Wheeler,1994,548,489,59,10.8
41,71,Yamhill,1994,36631,35044,1587,4.3
42,1,Adams,1994,41406,39493,1913,4.6
42,3,Allegheny,1994,657206,619147,38059,5.8
42,5,Armstrong,1994,32955,29302,3653,11.1
42,7,Beaver,1994,85526,79611,5915,6.9
42,9,Bedford,1994,23711,21549,2162,9.1
42,11,Berks,1994,177429,168583,8846,5.0
42,13,Blair,1994,62841,58605,4236,6.7
42,15,Bradford,1994,27966,26163,1803,6.4
42,17,Bucks,1994,306950,290543,16407,5.3
42,19,Butler,1994,81277,75941,5336,6.6
42,21,Cambria,1994,69480,62791,6689,9.6
42,23,Cameron,1994,2590,2416,174,6.7
42,25,Carbon,1994,26488,24329,2159,8.2
42,27,Centre,1994,62473,60167,2306,3.7
42,29,Chester,1994,213426,204686,8740,4.1
42,31,Clarion,1994,18418,16841,1577,8.6
42,33,Clearfield,1994,37160,33891,3269,8.8
42,35,Clinton,1994,17616,15719,1897,10.8
42,37,Columbia,1994,32314,30051,2263,7.0
42,39,Crawford,1994,41003,37916,3087,7.5
42,41,Cumberland,1994,114252,110600,3652,3.2
42,43,Dauphin,1994,134675,128835,5840,4.3
42,45,Delaware,1994,275559,260352,15207,5.5
42,47,Elk,1994,17821,16875,946,5.3
42,49,Erie,1994,139402,129872,9530,6.8
42,51,Fayette,1994,57064,51456,5608,9.8
42,53,Forest,1994,1869,1601,268,14.3
42,55,Franklin,1994,61335,58406,2929,4.8
42,57,Fulton,1994,6440,5967,473,7.3
42,59,Greene,1994,15434,13710,1724,11.2
42,61,Huntingdon,1994,19462,17279,2183,11.2
42,63,Indiana,1994,37075,33227,3848,10.4
42,65,Jefferson,1994,21683,20065,1618,7.5
42,67,Juniata,1994,10009,9210,799,8.0
42,69,Lackawanna,1994,106606,98423,8183,7.7
42,71,Lancaster,1994,230283,221463,8820,3.8
42,73,Lawrence,1994,40451,36866,3585,8.9
42,75,Lebanon,1994,63169,60319,2850,4.5
42,77,Lehigh,1994,152027,143461,8566,5.6
42,79,Luzerne,1994,159700,146017,13683,8.6
42,81,Lycoming,1994,57658,53334,4324,7.5
42,83,McKean,1994,21375,19682,1693,7.9
42,85,Mercer,1994,55261,51360,3901,7.1
42,87,Mifflin,1994,22160,20656,1504,6.8
42,89,Monroe,1994,49762,45323,4439,8.9
42,91,Montgomery,1994,380338,361174,19164,5.0
42,93,Montour,1994,8811,8500,311,3.5
42,95,Northampton,1994,125716,118203,7513,6.0
42,97,Northumberland,1994,45230,41821,3409,7.5
42,99,Perry,1994,22972,21856,1116,4.9
42,101,Philadelphia/city,1994,664369,610112,54257,8.2
42,103,Pike,1994,16486,15247,1239,7.5
42,105,Potter,1994,8322,7679,643,7.7
42,107,Schuylkill,1994,69232,63450,5782,8.4
42,109,Snyder,1994,18571,17683,888,4.8
42,111,Somerset,1994,37364,33944,3420,9.2
42,113,Sullivan,1994,2669,2517,152,5.7
42,115,Susquehanna,1994,18989,17433,1556,8.2
42,117,Tioga,1994,19478,18217,1261,6.5
42,119,Union,1994,18463,17726,737,4.0
42,121,Venango,1994,25837,23558,2279,8.8
42,123,Warren,1994,22198,20929,1269,5.7
42,125,Washington,1994,95119,88138,6981,7.3
42,127,Wayne,1994,18745,16957,1788,9.5
42,129,Westmoreland,1994,180064,166873,13191,7.3
42,131,Wyoming,1994,14868,13631,1237,8.3
42,133,York,1994,189796,181146,8650,4.6
44,1,Bristol,1994,25902,24342,1560,6.0
44,3,Kent,1994,88804,82965,5839,6.6
44,5,Newport,1994,40259,37499,2760,6.9
44,7,Providence,1994,298025,277036,20989,7.0
44,9,Washington,1994,61773,58755,3018,4.9
45,1,Abbeville,1994,12472,11437,1035,8.3
45,3,Aiken,1994,63776,59758,4018,6.3
45,5,Allendale,1994,4675,4142,533,11.4
45,7,Anderson,1994,80885,76507,4378,5.4
45,9,Bamberg,1994,7608,6733,875,11.5
45,11,Barnwell,1994,11037,9815,1222,11.1
45,13,Beaufort,1994,41509,39774,1735,4.2
45,15,Berkeley,1994,61585,58032,3553,5.8
45,17,Calhoun,1994,6361,5965,396,6.2
45,19,Charleston,1994,141839,132861,8978,6.3
45,21,Cherokee,1994,24049,22915,1134,4.7
45,23,Chester,1994,15680,13987,1693,10.8
45,25,Chesterfield,1994,20723,19136,1587,7.7
45,27,Clarendon,1994,11530,10119,1411,12.2
45,29,Colleton,1994,15689,14170,1519,9.7
45,31,Darlington,1994,31611,28268,3343,10.6
45,33,Dillon,1994,13972,12548,1424,10.2
45,35,Dorchester,1994,42655,40320,2335,5.5
45,37,Edgefield,1994,9105,8639,466,5.1
45,39,Fairfield,1994,11199,10075,1124,10.0
45,41,Florence,1994,61819,57093,4726,7.6
45,43,Georgetown,1994,23822,21254,2568,10.8
45,45,Greenville,1994,182552,175426,7126,3.9
45,47,Greenwood,1994,32409,30275,2134,6.6
45,49,Hampton,1994,8313,7513,800,9.6
45,51,Horry,1994,85914,79848,6066,7.1
45,53,Jasper,1994,7081,6711,370,5.2
45,55,Kershaw,1994,23018,20985,2033,8.8
45,57,Lancaster,1994,30133,27717,2416,8.0
45,59,Laurens,1994,30539,29000,1539,5.0
45,61,Lee,1994,8378,7397,981,11.7
45,63,Lexington,1994,107112,103387,3725,3.5
45,65,McCormick,1994,3880,3524,356,9.2
45,67,Marion,1994,17120,14886,2234,13.0
45,69,Marlboro,1994,11940,10274,1666,14.0
45,71,Newberry,1994,17672,16660,1012,5.7
45,73,Oconee,1994,28039,26112,1927,6.9
45,75,Orangeburg,1994,40996,37157,3839,9.4
45,77,Pickens,1994,53201,50756,2445,4.6
45,79,Richland,1994,148489,142031,6458,4.3
45,81,Saluda,1994,8436,7984,452,5.4
45,83,Spartanburg,1994,126116,120618,5498,4.4
45,85,Sumter,1994,44767,41279,3488,7.8
45,87,Union,1994,16101,14789,1312,8.1
45,89,Williamsburg,1994,17169,14792,2377,13.8
45,91,York,1994,78461,75048,3413,4.3
46,3,Aurora,1994,1365,1311,54,4.0
46,5,Beadle,1994,9422,9173,249,2.6
46,7,Bennett,1994,1071,1015,56,5.2
46,9,Bon Homme,1994,3077,3000,77,2.5
46,11,Brookings,1994,14899,14618,281,1.9
46,13,Brown,1994,20192,19728,464,2.3
46,15,Brule,1994,2920,2808,112,3.8
46,17,Buffalo,1994,795,701,94,11.8
46,19,Butte,1994,3630,3484,146,4.0
46,21,Campbell,1994,936,902,34,3.6
46,23,Charles Mix,1994,4631,4450,181,3.9
46,25,Clark,1994,1905,1830,75,3.9
46,27,Clay,1994,6860,6774,86,1.3
46,29,Codington,1994,13562,13094,468,3.5
46,31,Corson,1994,1471,1341,130,8.8
46,33,Custer,1994,3505,3312,193,5.5
46,35,Davison,1994,9521,9285,236,2.5
46,37,Day,1994,3085,2945,140,4.5
46,39,Deuel,1994,2303,2219,84,3.6
46,41,Dewey,1994,2197,1911,286,13.0
46,43,Douglas,1994,1552,1508,44,2.8
46,45,Edmunds,1994,2146,2107,39,1.8
46,47,Fall River,1994,3525,3398,127,3.6
46,49,Faulk,1994,1213,1186,27,2.2
46,51,Grant,1994,4134,3910,224,5.4
46,53,Gregory,1994,2607,2502,105,4.0
46,55,Haakon,1994,1189,1139,50,4.2
46,57,Hamlin,1994,2400,2315,85,3.5
46,59,Hand,1994,2189,2133,56,2.6
46,61,Hanson,1994,1564,1527,37,2.4
46,63,Harding,1994,832,797,35,4.2
46,65,Hughes,1994,9781,9523,258,2.6
46,67,Hutchinson,1994,3844,3727,117,3.0
46,69,Hyde,1994,850,825,25,2.9
46,71,Jackson,1994,1066,998,68,6.4
46,73,Jerauld,1994,1098,1058,40,3.6
46,75,Jones,1994,805,775,30,3.7
46,77,Kingsbury,1994,2559,2471,88,3.4
46,79,Lake,1994,5772,5578,194,3.4
46,81,Lawrence,1994,11968,11561,407,3.4
46,83,Lincoln,1994,9479,9291,188,2.0
46,85,Lyman,1994,2371,2261,110,4.6
46,87,McCook,1994,2570,2494,76,3.0
46,89,McPherson,1994,1446,1415,31,2.1
46,91,Marshall,1994,2370,2287,83,3.5
46,93,Meade,1994,11711,11276,435,3.7
46,95,Mellette,1994,798,731,67,8.4
46,97,Miner,1994,1411,1336,75,5.3
46,99,Minnehaha,1994,78668,76797,1871,2.4
46,101,Moody,1994,3572,3361,211,5.9
46,102,Oglala Lakota,1994,3002,2533,469,15.6
46,103,Pennington,1994,43831,42340,1491,3.4
46,105,Perkins,1994,2039,1993,46,2.3
46,107,Potter,1994,1535,1470,65,4.2
46,109,Roberts,1994,4786,4530,256,5.3
46,111,Sanborn,1994,1402,1356,46,3.3
46,115,Spink,1994,3592,3482,110,3.1
46,117,Stanley,1994,1699,1639,60,3.5
46,119,Sully,1994,930,900,30,3.2
46,121,Todd,1994,2583,2305,278,10.8
46,123,Tripp,1994,3484,3370,114,3.3
46,125,Turner,1994,4019,3882,137,3.4
46,127,Union,1994,6414,6163,251,3.9
46,129,Walworth,1994,3062,2945,117,3.8
46,135,Yankton,1994,10693,10504,189,1.8
46,137,Ziebach,1994,711,656,55,7.7
47,1,Anderson,1994,35861,34444,1417,4.0
47,3,Bedford,1994,16778,15862,916,5.5
47,5,Benton,1994,7236,6701,535,7.4
47,7,Bledsoe,1994,3632,3430,202,5.6
47,9,Blount,1994,48251,45890,2361,4.9
47,11,Bradley,1994,40770,38812,1958,4.8
47,13,Campbell,1994,16126,14834,1292,8.0
47,15,Cannon,1994,5066,4771,295,5.8
47,17,Carroll,1994,14292,13529,763,5.3
47,19,Carter,1994,25843,24282,1561,6.0
47,21,Cheatham,1994,16478,16040,438,2.7
47,23,Chester,1994,7221,6863,358,5.0
47,25,Claiborne,1994,13002,12374,628,4.8
47,27,Clay,1994,3861,3627,234,6.1
47,29,Cocke,1994,16822,14949,1873,11.1
47,31,Coffee,1994,22066,20914,1152,5.2
47,33,Crockett,1994,7497,7065,432,5.8
47,35,Cumberland,1994,18614,17303,1311,7.0
47,37,Davidson,1994,292947,284116,8831,3.0
47,39,Decatur,1994,5742,5402,340,5.9
47,41,DeKalb,1994,8317,7826,491,5.9
47,43,Dickson,1994,18679,17988,691,3.7
47,45,Dyer,1994,19285,18322,963,5.0
47,47,Fayette,1994,11661,11075,586,5.0
47,49,Fentress,1994,7491,6691,800,10.7
47,51,Franklin,1994,18336,17386,950,5.2
47,53,Gibson,1994,23035,21816,1219,5.3
47,55,Giles,1994,14997,14344,653,4.4
47,57,Grainger,1994,9538,8942,596,6.2
47,59,Greene,1994,32705,30011,2694,8.2
47,61,Grundy,1994,5566,5093,473,8.5
47,63,Hamblen,1994,30473,28297,2176,7.1
47,65,Hamilton,1994,149004,142871,6133,4.1
47,67,Hancock,1994,2449,2263,186,7.6
47,69,Hardeman,1994,9223,8224,999,10.8
47,71,Hardin,1994,11797,10789,1008,8.5
47,73,Hawkins,1994,22745,21503,1242,5.5
47,75,Haywood,1994,8958,8057,901,10.1
47,77,Henderson,1994,13121,12382,739,5.6
47,79,Henry,1994,14632,13856,776,5.3
47,81,Hickman,1994,8447,8035,412,4.9
47,83,Houston,1994,2900,2575,325,11.2
47,85,Humphreys,1994,8303,7632,671,8.1
47,87,Jackson,1994,4356,4063,293,6.7
47,89,Jefferson,1994,20671,19281,1390,6.7
47,91,Johnson,1994,8274,7660,614,7.4
47,93,Knox,1994,193138,186655,6483,3.4
47,95,Lake,1994,2994,2782,212,7.1
47,97,Lauderdale,1994,9570,8620,950,9.9
47,99,Lawrence,1994,21903,20494,1409,6.4
47,101,Lewis,1994,4878,4527,351,7.2
47,103,Lincoln,1994,15045,14286,759,5.0
47,105,Loudon,1994,18517,17796,721,3.9
47,107,McMinn,1994,21151,19808,1343,6.3
47,109,McNairy,1994,11451,10351,1100,9.6
47,111,Macon,1994,9686,8927,759,7.8
47,113,Madison,1994,45783,43908,1875,4.1
47,115,Marion,1994,12292,11589,703,5.7
47,117,Marshall,1994,12638,12103,535,4.2
47,119,Maury,1994,35739,34101,1638,4.6
47,121,Meigs,1994,4254,3862,392,9.2
47,123,Monroe,1994,17206,15747,1459,8.5
47,125,Montgomery,1994,50881,48727,2154,4.2
47,127,Moore,1994,3025,2911,114,3.8
47,129,Morgan,1994,7311,6822,489,6.7
47,131,Obion,1994,14742,13934,808,5.5
47,133,Overton,1994,9262,8628,634,6.8
47,135,Perry,1994,3294,3139,155,4.7
47,137,Pickett,1994,2129,1996,133,6.2
47,139,Polk,1994,6527,6127,400,6.1
47,141,Putnam,1994,29926,28231,1695,5.7
47,143,Rhea,1994,11909,10911,998,8.4
47,145,Roane,1994,30686,29335,1351,4.4
47,147,Robertson,1994,24203,23083,1120,4.6
47,149,Rutherford,1994,77795,75465,2330,3.0
47,151,Scott,1994,8132,7310,822,10.1
47,153,Sequatchie,1994,4725,4405,320,6.8
47,155,Sevier,1994,32333,29819,2514,7.8
47,157,Shelby,1994,415215,395741,19474,4.7
47,159,Smith,1994,9063,8660,403,4.4
47,161,Stewart,1994,4275,3870,405,9.5
47,163,Sullivan,1994,74446,70814,3632,4.9
47,165,Sumner,1994,60981,58830,2151,3.5
47,167,Tipton,1994,18844,17867,977,5.2
47,169,Trousdale,1994,2335,2190,145,6.2
47,171,Unicoi,1994,8071,7287,784,9.7
47,173,Union,1994,6978,6762,216,3.1
47,175,Van Buren,1994,2541,2311,230,9.1
47,177,Warren,1994,19070,18014,1056,5.5
47,179,Washington,1994,49846,47660,2186,4.4
47,181,Wayne,1994,7553,6932,621,8.2
47,183,Weakley,1994,17448,16957,491,2.8
47,185,White,1994,10718,10022,696,6.5
47,187,Williamson,1994,52961,51772,1189,2.2
47,189,Wilson,1994,40723,39345,1378,3.4
48,1,Anderson,1994,19733,18700,1033,5.2
48,3,Andrews,1994,5862,5458,404,6.9
48,5,Angelina,1994,34177,31953,2224,6.5
48,7,Aransas,1994,8730,8165,565,6.5
48,9,Archer,1994,3997,3833,164,4.1
48,11,Armstrong,1994,953,916,37,3.9
48,13,Atascosa,1994,15221,14487,734,4.8
48,15,Austin,1994,10655,10214,441,4.1
48,17,Bailey,1994,3642,3455,187,5.1
48,19,Bandera,1994,6523,6325,198,3.0
48,21,Bastrop,1994,22019,21334,685,3.1
48,23,Baylor,1994,1847,1760,87,4.7
48,25,Bee,1994,10577,9624,953,9.0
48,27,Bell,1994,86558,81694,4864,5.6
48,29,Bexar,1994,619095,589254,29841,4.8
48,31,Blanco,1994,3234,3145,89,2.8
48,33,Borden,1994,408,387,21,5.1
48,35,Bosque,1994,6267,5956,311,5.0
48,37,Bowie,1994,40027,36007,4020,10.0
48,39,Brazoria,1994,107102,99257,7845,7.3
48,41,Brazos,1994,68580,66716,1864,2.7
48,43,Brewster,1994,4700,4583,117,2.5
48,45,Briscoe,1994,955,924,31,3.2
48,47,Brooks,1994,3362,2978,384,11.4
48,49,Brown,1994,16442,15297,1145,7.0
48,51,Burleson,1994,7497,7137,360,4.8
48,53,Burnet,1994,10796,10323,473,4.4
48,55,Caldwell,1994,13379,12883,496,3.7
48,57,Calhoun,1994,9936,8703,1233,12.4
48,59,Callahan,1994,5909,5645,264,4.5
48,61,Cameron,1994,122516,106556,15960,13.0
48,63,Camp,1994,4967,4537,430,8.7
48,65,Carson,1994,3824,3689,135,3.5
48,67,Cass,1994,14683,13153,1530,10.4
48,69,Castro,1994,4184,3951,233,5.6
48,71,Chambers,1994,10514,9803,711,6.8
48,73,Cherokee,1994,19172,18089,1083,5.6
48,75,Childress,1994,3268,3145,123,3.8
48,77,Clay,1994,4847,4650,197,4.1
48,79,Cochran,1994,1733,1589,144,8.3
48,81,Coke,1994,1473,1421,52,3.5
48,83,Coleman,1994,3858,3619,239,6.2
48,85,Collin,1994,196666,189113,7553,3.8
48,87,Collingsworth,1994,1730,1621,109,6.3
48,89,Colorado,1994,8405,8056,349,4.2
48,91,Comal,1994,31290,30044,1246,4.0
48,93,Comanche,1994,6576,6324,252,3.8
48,95,Concho,1994,1451,1401,50,3.4
48,97,Cooke,1994,15578,14608,970,6.2
48,99,Coryell,1994,19600,18609,991,5.1
48,101,Cottle,1994,852,795,57,6.7
48,103,Crane,1994,2215,2089,126,5.7
48,105,Crockett,1994,1953,1889,64,3.3
48,107,Crosby,1994,3319,3065,254,7.7
48,109,Culberson,1994,1285,1212,73,5.7
48,111,Dallam,1994,3283,3199,84,2.6
48,113,Dallas,1994,1120494,1056318,64176,5.7
48,115,Dawson,1994,6411,5892,519,8.1
48,117,Deaf Smith,1994,9009,8299,710,7.9
48,119,Delta,1994,2481,2362,119,4.8
48,121,Denton,1994,196292,188412,7880,4.0
48,123,DeWitt,1994,8421,8000,421,5.0
48,125,Dickens,1994,1047,972,75,7.2
48,127,Dimmit,1994,3798,3115,683,18.0
48,129,Donley,1994,1605,1546,59,3.7
48,131,Duval,1994,4589,3981,608,13.2
48,133,Eastland,1994,8085,7638,447,5.5
48,135,Ector,1994,60606,55160,5446,9.0
48,137,Edwards,1994,951,885,66,6.9
48,139,Ellis,1994,47143,44565,2578,5.5
48,141,El Paso,1994,284605,254356,30249,10.6
48,143,Erath,1994,15695,15157,538,3.4
48,145,Falls,1994,7423,7065,358,4.8
48,147,Fannin,1994,11252,10454,798,7.1
48,149,Fayette,1994,10438,10165,273,2.6
48,151,Fisher,1994,1949,1828,121,6.2
48,153,Floyd,1994,3489,3286,203,5.8
48,155,Foard,1994,1017,991,26,2.6
48,157,Fort Bend,1994,148177,141435,6742,4.5
48,159,Franklin,1994,3845,3560,285,7.4
48,161,Freestone,1994,7519,6987,532,7.1
48,163,Frio,1994,6808,6026,782,11.5
48,165,Gaines,1994,6957,6621,336,4.8
48,167,Galveston,1994,125007,114263,10744,8.6
48,169,Garza,1994,2237,2086,151,6.8
48,171,Gillespie,1994,9648,9454,194,2.0
48,173,Glasscock,1994,596,580,16,2.7
48,175,Goliad,1994,2802,2614,188,6.7
48,177,Gonzales,1994,7742,7388,354,4.6
48,179,Gray,1994,11104,10590,514,4.6
48,181,Grayson,1994,47574,44603,2971,6.2
48,183,Gregg,1994,57759,52627,5132,8.9
48,185,Grimes,1994,8495,8093,402,4.7
48,187,Guadalupe,1994,36426,35249,1177,3.2
48,189,Hale,1994,17562,16684,878,5.0
48,191,Hall,1994,1886,1737,149,7.9
48,193,Hamilton,1994,3745,3623,122,3.3
48,195,Hansford,1994,2504,2433,71,2.8
48,197,Hardeman,1994,2048,1955,93,4.5
48,199,Hardin,1994,21757,19880,1877,8.6
48,201,Harris,1994,1655601,1541895,113706,6.9
48,203,Harrison,1994,27424,24730,2694,9.8
48,205,Hartley,1994,2140,2095,45,2.1
48,207,Haskell,1994,3016,2837,179,5.9
48,209,Hays,1994,40857,39568,1289,3.2
48,211,Hemphill,1994,1853,1775,78,4.2
48,213,Henderson,1994,26626,24889,1737,6.5
48,215,Hidalgo,1994,183302,146795,36507,19.9
48,217,Hill,1994,13474,12727,747,5.5
48,219,Hockley,1994,11677,11032,645,5.5
48,221,Hood,1994,14303,13205,1098,7.7
48,223,Hopkins,1994,15780,14654,1126,7.1
48,225,Houston,1994,8115,7755,360,4.4
48,227,Howard,1994,13973,13373,600,4.3
48,229,Hudspeth,1994,1600,1559,41,2.6
48,231,Hunt,1994,33755,30973,2782,8.2
48,233,Hutchinson,1994,10431,9590,841,8.1
48,235,Irion,1994,938,909,29,3.1
48,237,Jack,1994,3319,3159,160,4.8
48,239,Jackson,1994,7530,7212,318,4.2
48,241,Jasper,1994,15722,13999,1723,11.0
48,243,Jeff Davis,1994,1046,1008,38,3.6
48,245,Jefferson,1994,119267,107617,11650,9.8
48,247,Jim Hogg,1994,1939,1766,173,8.9
48,249,Jim Wells,1994,16323,14717,1606,9.8
48,251,Johnson,1994,52287,49352,2935,5.6
48,253,Jones,1994,9856,9464,392,4.0
48,255,Karnes,1994,5427,5146,281,5.2
48,257,Kaufman,1994,27830,26486,1344,4.8
48,259,Kendall,1994,9772,9568,204,2.1
48,261,Kenedy,1994,220,216,4,1.8
48,263,Kent,1994,368,352,16,4.3
48,265,Kerr,1994,16640,16016,624,3.8
48,267,Kimble,1994,2304,2221,83,3.6
48,269,King,1994,151,145,6,4.0
48,271,Kinney,1994,1127,1041,86,7.6
48,273,Kleberg,1994,13584,12524,1060,7.8
48,275,Knox,1994,2598,2492,106,4.1
48,277,Lamar,1994,22456,20608,1848,8.2
48,279,Lamb,1994,6828,6417,411,6.0
48,281,Lampasas,1994,6988,6608,380,5.4
48,283,La Salle,1994,2634,2412,222,8.4
48,285,Lavaca,1994,9286,9034,252,2.7
48,287,Lee,1994,7160,6887,273,3.8
48,289,Leon,1994,5542,5095,447,8.1
48,291,Liberty,1994,25619,23246,2373,9.3
48,293,Limestone,1994,9458,8901,557,5.9
48,295,Lipscomb,1994,1515,1483,32,2.1
48,297,Live Oak,1994,4756,4496,260,5.5
48,299,Llano,1994,4728,4554,174,3.7
48,301,Loving,1994,76,69,7,9.2
48,303,Lubbock,1994,117650,112561,5089,4.3
48,305,Lynn,1994,3018,2878,140,4.6
48,307,McCulloch,1994,3789,3510,279,7.4
48,309,McLennan,1994,97469,92750,4719,4.8
48,311,McMullen,1994,281,273,8,2.8
48,313,Madison,1994,4054,3899,155,3.8
48,315,Marion,1994,4032,3590,442,11.0
48,317,Martin,1994,1984,1919,65,3.3
48,319,Mason,1994,1596,1550,46,2.9
48,321,Matagorda,1994,17883,15233,2650,14.8
48,323,Maverick,1994,17705,12552,5153,29.1
48,325,Medina,1994,13688,13124,564,4.1
48,327,Menard,1994,1040,1011,29,2.8
48,329,Midland,1994,59213,55765,3448,5.8
48,331,Milam,1994,9845,9152,693,7.0
48,333,Mills,1994,2218,2129,89,4.0
48,335,Mitchell,1994,3424,3197,227,6.6
48,337,Montague,1994,7852,7349,503,6.4
48,339,Montgomery,1994,111052,105432,5620,5.1
48,341,Moore,1994,9103,8790,313,3.4
48,343,Morris,1994,5978,5315,663,11.1
48,345,Motley,1994,751,729,22,2.9
48,347,Nacogdoches,1994,26834,25558,1276,4.8
48,349,Navarro,1994,20449,19273,1176,5.8
48,351,Newton,1994,6202,5466,736,11.9
48,353,Nolan,1994,7698,7091,607,7.9
48,355,Nueces,1994,146072,132599,13473,9.2
48,357,Ochiltree,1994,4591,4408,183,4.0
48,359,Oldham,1994,1174,1116,58,4.9
48,361,Orange,1994,42060,36659,5401,12.8
48,363,Palo Pinto,1994,12597,11458,1139,9.0
48,365,Panola,1994,8236,7309,927,11.3
48,367,Parker,1994,35675,33692,1983,5.6
48,369,Parmer,1994,4496,4313,183,4.1
48,371,Pecos,1994,6937,6419,518,7.5
48,373,Polk,1994,14397,13294,1103,7.7
48,375,Potter,1994,51970,49612,2358,4.5
48,377,Presidio,1994,3605,2288,1317,36.5
48,379,Rains,1994,3300,3124,176,5.3
48,381,Randall,1994,55889,54394,1495,2.7
48,383,Reagan,1994,1958,1865,93,4.7
48,385,Real,1994,1197,1118,79,6.6
48,387,Red River,1994,6032,5550,482,8.0
48,389,Reeves,1994,7019,6075,944,13.4
48,391,Refugio,1994,3288,3050,238,7.2
48,393,Roberts,1994,559,530,29,5.2
48,395,Robertson,1994,6823,6406,417,6.1
48,397,Rockwall,1994,17679,17075,604,3.4
48,399,Runnels,1994,5427,5249,178,3.3
48,401,Rusk,1994,20616,19061,1555,7.5
48,403,Sabine,1994,3704,3366,338,9.1
48,405,San Augustine,1994,3103,2916,187,6.0
48,407,San Jacinto,1994,7756,7359,397,5.1
48,409,San Patricio,1994,28109,25173,2936,10.4
48,411,San Saba,1994,2300,2208,92,4.0
48,413,Schleicher,1994,1348,1284,64,4.7
48,415,Scurry,1994,8206,7705,501,6.1
48,417,Shackelford,1994,1537,1471,66,4.3
48,419,Shelby,1994,9874,9126,748,7.6
48,421,Sherman,1994,1377,1335,42,3.1
48,423,Smith,1994,82736,77836,4900,5.9
48,425,Somervell,1994,2197,1888,309,14.1
48,427,Starr,1994,20900,15074,5826,27.9
48,429,Stephens,1994,4072,3815,257,6.3
48,431,Sterling,1994,721,685,36,5.0
48,433,Stonewall,1994,818,790,28,3.4
48,435,Sutton,1994,2086,1999,87,4.2
48,437,Swisher,1994,4109,3940,169,4.1
48,439,Tarrant,1994,703190,663354,39836,5.7
48,441,Taylor,1994,58161,55141,3020,5.2
48,443,Terrell,1994,583,551,32,5.5
48,445,Terry,1994,6151,5685,466,7.6
48,447,Throckmorton,1994,902,860,42,4.7
48,449,Titus,1994,11954,10838,1116,9.3
48,451,Tom Green,1994,49653,47335,2318,4.7
48,453,Travis,1994,400669,386307,14362,3.6
48,455,Trinity,1994,4991,4703,288,5.8
48,457,Tyler,1994,7286,6637,649,8.9
48,459,Upshur,1994,15459,14555,904,5.8
48,461,Upton,1994,1904,1813,91,4.8
48,463,Uvalde,1994,10676,9441,1235,11.6
48,465,Val Verde,1994,18196,15995,2201,12.1
48,467,Van Zandt,1994,18692,17792,900,4.8
48,469,Victoria,1994,42088,39557,2531,6.0
48,471,Walker,1994,22056,21468,588,2.7
48,473,Waller,1994,11582,11038,544,4.7
48,475,Ward,1994,4771,4355,416,8.7
48,477,Washington,1994,14109,13672,437,3.1
48,479,Webb,1994,68252,61543,6709,9.8
48,481,Wharton,1994,19412,18081,1331,6.9
48,483,Wheeler,1994,2764,2657,107,3.9
48,485,Wichita,1994,59025,55827,3198,5.4
48,487,Wilbarger,1994,7219,6926,293,4.1
48,489,Willacy,1994,7674,5985,1689,22.0
48,491,Williamson,1994,102906,100850,2056,2.0
48,493,Wilson,1994,12289,11904,385,3.1
48,495,Winkler,1994,3158,2807,351,11.1
48,497,Wise,1994,18801,17942,859,4.6
48,499,Wood,1994,14263,13381,882,6.2
48,501,Yoakum,1994,3813,3589,224,5.9
48,503,Young,1994,8727,7954,773,8.9
48,505,Zapata,1994,3941,3345,596,15.1
48,507,Zavala,1994,4808,3556,1252,26.0
49,1,Beaver,1994,2213,2128,85,3.8
49,3,Box Elder,1994,18104,17229,875,4.8
49,5,Cache,1994,40735,39539,1196,2.9
49,7,Carbon,1994,9377,8678,699,7.5
49,9,Daggett,1994,472,449,23,4.9
49,11,Davis,1994,106306,102657,3649,3.4
49,13,Duchesne,1994,5903,5320,583,9.9
49,15,Emery,1994,4201,3870,331,7.9
49,17,Garfield,1994,2556,2286,270,10.6
49,19,Grand,1994,4935,4604,331,6.7
49,21,Iron,1994,12318,11885,433,3.5
49,23,Juab,1994,3348,3192,156,4.7
49,25,Kane,1994,2730,2493,237,8.7
49,27,Millard,1994,4772,4548,224,4.7
49,29,Morgan,1994,3075,2926,149,4.8
49,31,Piute,1994,496,455,41,8.3
49,33,Rich,1994,839,807,32,3.8
49,35,Salt Lake,1994,443557,428933,14624,3.3
49,37,San Juan,1994,5172,4751,421,8.1
49,39,Sanpete,1994,7550,7044,506,6.7
49,41,Sevier,1994,7504,7145,359,4.8
49,43,Summit,1994,11427,10926,501,4.4
49,45,Tooele,1994,11713,11043,670,5.7
49,47,Uintah,1994,10247,9492,755,7.4
49,49,Utah,1994,146071,141531,4540,3.1
49,51,Wasatch,1994,5394,5088,306,5.7
49,53,Washington,1994,30607,29702,905,3.0
49,55,Wayne,1994,1184,1092,92,7.8
49,57,Weber,1994,92383,88270,4113,4.5
50,1,Addison,1994,18403,17460,943,5.1
50,3,Bennington,1994,19147,18276,871,4.5
50,5,Caledonia,1994,14763,13868,895,6.1
50,7,Chittenden,1994,81825,79325,2500,3.1
50,9,Essex,1994,2802,2635,167,6.0
50,11,Franklin,1994,22010,20884,1126,5.1
50,13,Grand Isle,1994,3036,2824,212,7.0
50,15,Lamoille,1994,11007,10315,692,6.3
50,17,Orange,1994,14872,14361,511,3.4
50,19,Orleans,1994,12441,11421,1020,8.2
50,21,Rutland,1994,31523,29883,1640,5.2
50,23,Washington,1994,30702,29274,1428,4.7
50,25,Windham,1994,23425,22486,939,4.0
50,27,Windsor,1994,29925,28904,1021,3.4
51,1,Accomack,1994,15318,14095,1223,8.0
51,3,Albemarle,1994,36457,35603,854,2.3
51,5,Alleghany,1994,8445,7685,760,9.0
51,7,Amelia,1994,4492,4207,285,6.3
51,9,Amherst,1994,14851,14198,653,4.4
51,11,Appomattox,1994,6137,5725,412,6.7
51,13,Arlington,1994,109388,105604,3784,3.5
51,15,Augusta,1994,30027,28474,1553,5.2
51,17,Bath,1994,2951,2544,407,13.8
51,19,Bedford,1994,31224,30230,994,3.2
51,21,Bland,1994,3565,3289,276,7.7
51,23,Botetourt,1994,15233,14742,491,3.2
51,25,Brunswick,1994,6873,6321,552,8.0
51,27,Buchanan,1994,10591,8668,1923,18.2
51,29,Buckingham,1994,6073,5792,281,4.6
51,31,Campbell,1994,26569,25439,1130,4.3
51,33,Caroline,1994,10404,9660,744,7.2
51,35,Carroll,1994,14040,13391,649,4.6
51,36,Charles City,1994,3596,3361,235,6.5
51,37,Charlotte,1994,5540,5196,344,6.2
51,41,Chesterfield,1994,133949,129017,4932,3.7
51,43,Clarke,1994,6284,6113,171,2.7
51,45,Craig,1994,2396,2257,139,5.8
51,47,Culpeper,1994,14929,14271,658,4.4
51,49,Cumberland,1994,3940,3827,113,2.9
51,51,Dickenson,1994,6419,5217,1202,18.7
51,53,Dinwiddie,1994,11192,10530,662,5.9
51,57,Essex,1994,4623,4319,304,6.6
51,59,Fairfax,1994,510248,494840,15408,3.0
51,61,Fauquier,1994,27184,26308,876,3.2
51,63,Floyd,1994,6366,5965,401,6.3
51,65,Fluvanna,1994,7616,7326,290,3.8
51,67,Franklin,1994,23020,21939,1081,4.7
51,69,Frederick,1994,29038,27778,1260,4.3
51,71,Giles,1994,8300,7719,581,7.0
51,73,Gloucester,1994,16432,15689,743,4.5
51,75,Goochland,1994,8321,8012,309,3.7
51,77,Grayson,1994,8413,8042,371,4.4
51,79,Greene,1994,6719,6460,259,3.9
51,81,Greensville,1994,5116,4829,287,5.6
51,83,Halifax,1994,18157,16964,1193,6.6
51,85,Hanover,1994,40402,39266,1136,2.8
51,87,Henrico,1994,134018,129648,4370,3.3
51,89,Henry,1994,30454,28094,2360,7.7
51,91,Highland,1994,1335,1275,60,4.5
51,93,Isle of Wight,1994,13883,13043,840,6.1
51,95,James City,1994,20916,20285,631,3.0
51,97,King and Queen,1994,3126,2947,179,5.7
51,99,King George,1994,7992,7676,316,4.0
51,101,King William,1994,6381,6093,288,4.5
51,103,Lancaster,1994,5266,4525,741,14.1
51,105,Lee,1994,10347,9275,1072,10.4
51,107,Loudoun,1994,64451,62417,2034,3.2
51,109,Louisa,1994,10233,9398,835,8.2
51,111,Lunenburg,1994,4965,4497,468,9.4
51,113,Madison,1994,6703,6462,241,3.6
51,115,Mathews,1994,4378,4185,193,4.4
51,117,Mecklenburg,1994,15104,14199,905,6.0
51,119,Middlesex,1994,4365,4138,227,5.2
51,121,Montgomery,1994,36792,35390,1402,3.8
51,125,Nelson,1994,6647,6381,266,4.0
51,127,New Kent,1994,6058,5799,259,4.3
51,131,Northampton,1994,5537,5173,364,6.6
51,133,Northumberland,1994,5333,4644,689,12.9
51,135,Nottoway,1994,6303,5860,443,7.0
51,137,Orange,1994,10718,10224,494,4.6
51,139,Page,1994,11697,10887,810,6.9
51,141,Patrick,1994,9012,8617,395,4.4
51,143,Pittsylvania,1994,31238,29077,2161,6.9
51,145,Powhatan,1994,8991,8698,293,3.3
51,147,Prince Edward,1994,8294,7911,383,4.6
51,149,Prince George,1994,12003,11486,517,4.3
51,153,Prince William,1994,128394,124179,4215,3.3
51,155,Pulaski,1994,16933,15763,1170,6.9
51,157,Rappahannock,1994,3969,3770,199,5.0
51,159,Richmond,1994,4028,3748,280,7.0
51,161,Roanoke,1994,48382,47026,1356,2.8
51,163,Rockbridge,1994,9661,9108,553,5.7
51,165,Rockingham,1994,35996,34938,1058,2.9
51,167,Russell,1994,13684,11892,1792,13.1
51,169,Scott,1994,10187,9303,884,8.7
51,171,Shenandoah,1994,17649,17018,631,3.6
51,173,Smyth,1994,17390,15605,1785,10.3
51,175,Southampton,1994,7589,7190,399,5.3
51,177,Spotsylvania,1994,36141,34816,1325,3.7
51,179,Stafford,1994,39085,37894,1191,3.0
51,181,Surry,1994,2848,2512,336,11.8
51,183,Sussex,1994,4950,4583,367,7.4
51,185,Tazewell,1994,20891,18010,2881,13.8
51,187,Warren,1994,14756,13900,856,5.8
51,191,Washington,1994,25486,23756,1730,6.8
51,193,Westmoreland,1994,7414,6698,716,9.7
51,195,Wise,1994,15929,13915,2014,12.6
51,197,Wythe,1994,14658,13743,915,6.2
51,199,York,1994,25387,24430,957,3.8
51,510,Alexandria city,1994,74915,71570,3345,4.5
51,520,Bristol city,1994,8721,8183,538,6.2
51,530,Buena Vista city,1994,3218,3026,192,6.0
51,540,Charlottesville city,1994,19961,19312,649,3.3
51,550,Chesapeake city,1994,94210,89520,4690,5.0
51,570,Colonial Heights city,1994,8861,8441,420,4.7
51,580,Covington city,1994,3278,2893,385,11.7
51,590,Danville city,1994,27149,24838,2311,8.5
51,595,Emporia city,1994,2513,2336,177,7.0
51,600,Fairfax city,1994,12336,12157,179,1.5
51,610,Falls Church city,1994,5704,5555,149,2.6
51,620,Franklin city,1994,3714,3494,220,5.9
51,630,Fredericksburg city,1994,10978,10463,515,4.7
51,640,Galax city,1994,3411,3277,134,3.9
51,650,Hampton city,1994,66894,62797,4097,6.1
51,660,Harrisonburg city,1994,17603,17204,399,2.3
51,670,Hopewell city,1994,10921,10138,783,7.2
51,678,Lexington city,1994,2799,2698,101,3.6
51,680,Lynchburg city,1994,31949,30534,1415,4.4
51,683,Manassas city,1994,18497,17817,680,3.7
51,685,Manassas Park city,1994,4032,3910,122,3.0
51,690,Martinsville city,1994,7732,6985,747,9.7
51,700,Newport News city,1994,83885,78591,5294,6.3
51,710,Norfolk city,1994,90291,83965,6326,7.0
51,720,Norton city,1994,1655,1506,149,9.0
51,730,Petersburg city,1994,17795,16107,1688,9.5
51,735,Poquoson city,1994,5892,5701,191,3.2
51,740,Portsmouth city,1994,47267,43142,4125,8.7
51,750,Radford city,1994,6821,6478,343,5.0
51,760,Richmond city,1994,100740,94745,5995,6.0
51,770,Roanoke city,1994,50461,48214,2247,4.5
51,775,Salem city,1994,13539,13148,391,2.9
51,790,Staunton city,1994,11288,10699,589,5.2
51,800,Suffolk city,1994,26186,24313,1873,7.2
51,810,Virginia Beach city,1994,206932,197157,9775,4.7
51,820,Waynesboro city,1994,8791,8304,487,5.5
51,830,Williamsburg city,1994,6132,5493,639,10.4
51,840,Winchester city,1994,13206,12482,724,5.5
53,1,Adams,1994,8272,7245,1027,12.4
53,3,Asotin,1994,10875,10452,423,3.9
53,5,Benton,1994,72151,68071,4080,5.7
53,7,Chelan,1994,34110,31011,3099,9.1
53,9,Clallam,1994,23442,20875,2567,11.0
53,11,Clark,1994,142835,136263,6572,4.6
53,13,Columbia,1994,1542,1355,187,12.1
53,15,Cowlitz,1994,39276,35770,3506,8.9
53,17,Douglas,1994,18372,16986,1386,7.5
53,19,Ferry,1994,2919,2522,397,13.6
53,21,Franklin,1994,22472,20432,2040,9.1
53,23,Garfield,1994,1048,992,56,5.3
53,25,Grant,1994,33090,29710,3380,10.2
53,27,Grays Harbor,1994,27618,23956,3662,13.3
53,29,Island,1994,24832,23492,1340,5.4
53,31,Jefferson,1994,9377,8509,868,9.3
53,33,King,1994,896617,856851,39766,4.4
53,35,Kitsap,1994,89916,84064,5852,6.5
53,37,Kittitas,1994,14385,13078,1307,9.1
53,39,Klickitat,1994,8409,7359,1050,12.5
53,41,Lewis,1994,28696,26053,2643,9.2
53,43,Lincoln,1994,4477,4202,275,6.1
53,45,Mason,1994,17336,15757,1579,9.1
53,47,Okanogan,1994,22641,20285,2356,10.4
53,49,Pacific,1994,8050,7109,941,11.7
53,51,Pend Oreille,1994,3804,3315,489,12.9
53,53,Pierce,1994,306032,284494,21538,7.0
53,55,San Juan,1994,5441,5065,376,6.9
53,57,Skagit,1994,47702,43002,4700,9.9
53,59,Skamania,1994,3993,3536,457,11.4
53,61,Snohomish,1994,278771,264331,14440,5.2
53,63,Spokane,1994,192343,182026,10317,5.4
53,65,Stevens,1994,16417,14864,1553,9.5
53,67,Thurston,1994,90626,84572,6054,6.7
53,69,Wahkiakum,1994,1663,1501,162,9.7
53,71,Walla Walla,1994,25427,23897,1530,6.0
53,73,Whatcom,1994,75329,69350,5979,7.9
53,75,Whitman,1994,18118,17729,389,2.1
53,77,Yakima,1994,113074,98833,14241,12.6
54,1,Barbour,1994,6479,5732,747,11.5
54,3,Berkeley,1994,31121,29211,1910,6.1
54,5,Boone,1994,8415,7250,1165,13.8
54,7,Braxton,1994,4941,4169,772,15.6
54,9,Brooke,1994,11596,10610,986,8.5
54,11,Cabell,1994,43061,39694,3367,7.8
54,13,Calhoun,1994,2970,2316,654,22.0
54,15,Clay,1994,3361,2842,519,15.4
54,17,Doddridge,1994,3019,2749,270,8.9
54,19,Fayette,1994,17870,15613,2257,12.6
54,21,Gilmer,1994,2848,2583,265,9.3
54,23,Grant,1994,4874,4345,529,10.9
54,25,Greenbrier,1994,15789,13373,2416,15.3
54,27,Hampshire,1994,7586,7242,344,4.5
54,29,Hancock,1994,15373,14054,1319,8.6
54,31,Hardy,1994,6778,6465,313,4.6
54,33,Harrison,1994,32108,29436,2672,8.3
54,35,Jackson,1994,12345,11250,1095,8.9
54,37,Jefferson,1994,19391,18454,937,4.8
54,39,Kanawha,1994,102555,95832,6723,6.6
54,41,Lewis,1994,7133,6288,845,11.8
54,43,Lincoln,1994,7189,6239,950,13.2
54,45,Logan,1994,14764,12769,1995,13.5
54,47,McDowell,1994,8260,7114,1146,13.9
54,49,Marion,1994,24073,21400,2673,11.1
54,51,Marshall,1994,16376,14884,1492,9.1
54,53,Mason,1994,9647,8539,1108,11.5
54,55,Mercer,1994,28213,26203,2010,7.1
54,57,Mineral,1994,11462,10712,750,6.5
54,59,Mingo,1994,10354,8948,1406,13.6
54,61,Monongalia,1994,38982,37067,1915,4.9
54,63,Monroe,1994,5113,4660,453,8.9
54,65,Morgan,1994,5861,5550,311,5.3
54,67,Nicholas,1994,10607,9202,1405,13.2
54,69,Ohio,1994,24577,22729,1848,7.5
54,71,Pendleton,1994,3749,3560,189,5.0
54,73,Pleasants,1994,3129,2784,345,11.0
54,75,Pocahontas,1994,4315,3743,572,13.3
54,77,Preston,1994,12936,11756,1180,9.1
54,79,Putnam,1994,23660,22094,1566,6.6
54,81,Raleigh,1994,31425,28335,3090,9.8
54,83,Randolph,1994,12976,11629,1347,10.4
54,85,Ritchie,1994,4464,3790,674,15.1
54,87,Roane,1994,6166,5342,824,13.4
54,89,Summers,1994,4397,3861,536,12.2
54,91,Taylor,1994,6472,5870,602,9.3
54,93,Tucker,1994,3867,3365,502,13.0
54,95,Tyler,1994,4044,3723,321,7.9
54,97,Upshur,1994,9905,8945,960,9.7
54,99,Wayne,1994,16746,15198,1548,9.2
54,101,Webster,1994,3218,2695,523,16.3
54,103,Wetzel,1994,7402,6615,787,10.6
54,105,Wirt,1994,1980,1700,280,14.1
54,107,Wood,1994,43149,40010,3139,7.3
54,109,Wyoming,1994,8327,7257,1070,12.8
55,1,Adams,1994,6840,6466,374,5.5
55,3,Ashland,1994,8213,7577,636,7.7
55,5,Barron,1994,23362,22025,1337,5.7
55,7,Bayfield,1994,7456,6918,538,7.2
55,9,Brown,1994,122461,117783,4678,3.8
55,11,Buffalo,1994,7746,7393,353,4.6
55,13,Burnett,1994,6763,6377,386,5.7
55,15,Calumet,1994,23954,22866,1088,4.5
55,17,Chippewa,1994,28432,26865,1567,5.5
55,19,Clark,1994,16440,15303,1137,6.9
55,21,Columbia,1994,26484,24833,1651,6.2
55,23,Crawford,1994,9192,8681,511,5.6
55,25,Dane,1994,245325,240286,5039,2.1
55,27,Dodge,1994,45483,43708,1775,3.9
55,29,Door,1994,14867,13592,1275,8.6
55,31,Douglas,1994,21597,20122,1475,6.8
55,33,Dunn,1994,21285,20474,811,3.8
55,35,Eau Claire,1994,47786,45835,1951,4.1
55,37,Florence,1994,1539,1441,98,6.4
55,39,Fond du Lac,1994,54882,52896,1986,3.6
55,41,Forest,1994,4224,3943,281,6.7
55,43,Grant,1994,25867,24632,1235,4.8
55,45,Green,1994,18656,18061,595,3.2
55,47,Green Lake,1994,10759,10157,602,5.6
55,49,Iowa,1994,13340,12822,518,3.9
55,51,Iron,1994,3177,2942,235,7.4
55,53,Jackson,1994,9416,8854,562,6.0
55,55,Jefferson,1994,40605,39046,1559,3.8
55,57,Juneau,1994,11300,10542,758,6.7
55,59,Kenosha,1994,74574,71203,3371,4.5
55,61,Kewaunee,1994,10577,10085,492,4.7
55,63,La Crosse,1994,58722,56565,2157,3.7
55,65,Lafayette,1994,8374,8036,338,4.0
55,67,Langlade,1994,9486,8863,623,6.6
55,69,Lincoln,1994,14956,14094,862,5.8
55,71,Manitowoc,1994,44741,42786,1955,4.4
55,73,Marathon,1994,69314,65927,3387,4.9
55,75,Marinette,1994,19840,18557,1283,6.5
55,77,Marquette,1994,6518,6061,457,7.0
55,78,Menominee,1994,1961,1795,166,8.5
55,79,Milwaukee,1994,480819,458577,22242,4.6
55,81,Monroe,1994,19744,18621,1123,5.7
55,83,Oconto,1994,14813,13811,1002,6.8
55,85,Oneida,1994,18629,17714,915,4.9
55,87,Outagamie,1994,94079,90865,3214,3.4
55,89,Ozaukee,1994,45309,44066,1243,2.7
55,91,Pepin,1994,3540,3370,170,4.8
55,93,Pierce,1994,19529,18816,713,3.7
55,95,Polk,1994,19626,18686,940,4.8
55,97,Portage,1994,36390,34674,1716,4.7
55,99,Price,1994,7596,7091,505,6.6
55,101,Racine,1994,92421,87586,4835,5.2
55,103,Richland,1994,8798,8412,386,4.4
55,105,Rock,1994,76638,73044,3594,4.7
55,107,Rusk,1994,7116,6485,631,8.9
55,109,St. Croix,1994,29923,28913,1010,3.4
55,111,Sauk,1994,31305,29928,1377,4.4
55,113,Sawyer,1994,8415,7882,533,6.3
55,115,Shawano,1994,19954,18884,1070,5.4
55,117,Sheboygan,1994,59979,58201,1778,3.0
55,119,Taylor,1994,10717,9984,733,6.8
55,121,Trempealeau,1994,14054,13167,887,6.3
55,123,Vernon,1994,13416,12747,669,5.0
55,125,Vilas,1994,9869,9314,555,5.6
55,127,Walworth,1994,50300,48977,1323,2.6
55,129,Washburn,1994,7112,6626,486,6.8
55,131,Washington,1994,61827,59715,2112,3.4
55,133,Waukesha,1994,194738,188390,6348,3.3
55,135,Waupaca,1994,25793,24510,1283,5.0
55,137,Waushara,1994,9415,8778,637,6.8
55,139,Winnebago,1994,93625,90343,3282,3.5
55,141,Wood,1994,39557,37779,1778,4.5
56,1,Albany,1994,16211,15808,403,2.5
56,3,Big Horn,1994,5036,4713,323,6.4
56,5,Campbell,1994,18011,17195,816,4.5
56,7,Carbon,1994,8679,8237,442,5.1
56,9,Converse,1994,6210,5901,309,5.0
56,11,Crook,1994,2868,2761,107,3.7
56,13,Fremont,1994,17010,15785,1225,7.2
56,15,Goshen,1994,6312,6038,274,4.3
56,17,Hot Springs,1994,2551,2425,126,4.9
56,19,Johnson,1994,3604,3466,138,3.8
56,21,Laramie,1994,38672,37109,1563,4.0
56,23,Lincoln,1994,6214,5775,439,7.1
56,25,Natrona,1994,32003,30050,1953,6.1
56,27,Niobrara,1994,1178,1150,28,2.4
56,29,Park,1994,14485,13908,577,4.0
56,31,Platte,1994,4066,3866,200,4.9
56,33,Sheridan,1994,13310,12676,634,4.8
56,35,Sublette,1994,3001,2912,89,3.0
56,37,Sweetwater,1994,21718,20622,1096,5.0
56,39,Teton,1994,10083,9867,216,2.1
56,41,Uinta,1994,10631,9803,828,7.8
56,43,Washakie,1994,4674,4410,264,5.6
56,45,Weston,1994,3295,3119,176,5.3
72,1,Adjuntas Municipio,1994,5402,4559,843,15.6
72,3,Aguada Municipio,1994,13993,11268,2725,19.5
72,5,Aguadilla Municipio,1994,21155,17035,4120,19.5
72,7,Aguas Buenas Municipio,1994,8140,6814,1326,16.3
72,9,Aibonito Municipio,1994,9917,8405,1512,15.2
72,11,Anasco Municipio,1994,10215,8180,2035,19.9
72,13,Arecibo Municipio,1994,30085,24500,5585,18.6
72,15,Arroyo Municipio,1994,5111,4137,974,19.1
72,17,Barceloneta Municipio,1994,6971,5551,1420,20.4
72,19,Barranquitas Municipio,1994,7105,6117,988,13.9
72,21,Bayamon Municipio,1994,81135,73128,8007,9.9
72,23,Cabo Rojo Municipio,1994,15079,12832,2247,14.9
72,25,Caguas Municipio,1994,53772,46836,6936,12.9
72,27,Camuy Municipio,1994,9301,7776,1525,16.4
72,29,Canovanas Municipio,1994,14153,12019,2134,15.1
72,31,Carolina Municipio,1994,73596,66603,6993,9.5
72,33,Catano Municipio,1994,9904,8829,1075,10.9
72,35,Cayey Municipio,1994,15695,13043,2652,16.9
72,37,Ceiba Municipio,1994,5338,4511,827,15.5
72,39,Ciales Municipio,1994,5086,4039,1047,20.6
72,41,Cidra Municipio,1994,13417,11516,1901,14.2
72,43,Coamo Municipio,1994,8873,7129,1744,19.7
72,45,Comerio Municipio,1994,5168,4437,731,14.1
72,47,Corozal Municipio,1994,9221,8081,1140,12.4
72,49,Culebra Municipio,1994,751,697,54,7.2
72,51,Dorado Municipio,1994,9813,8667,1146,11.7
72,53,Fajardo Municipio,1994,12695,10232,2463,19.4
72,54,Florida Municipio,1994,2636,2068,568,21.5
72,55,Guanica Municipio,1994,4806,3396,1410,29.3
72,57,Guayama Municipio,1994,11241,8849,2392,21.3
72,59,Guayanilla Municipio,1994,6389,5003,1386,21.7
72,61,Guaynabo Municipio,1994,37972,35524,2448,6.4
72,63,Gurabo Municipio,1994,10602,9051,1551,14.6
72,65,Hatillo Municipio,1994,10485,8676,1809,17.3
72,67,Hormigueros Municipio,1994,6802,5791,1011,14.9
72,69,Humacao Municipio,1994,18813,15611,3202,17.0
72,71,Isabela Municipio,1994,13690,10929,2761,20.2
72,73,Jayuya Municipio,1994,3653,3082,571,15.6
72,75,Juana Diaz Municipio,1994,12752,10238,2514,19.7
72,77,Juncos Municipio,1994,10938,9092,1846,16.9
72,79,Lajas Municipio,1994,8730,7025,1705,19.5
72,81,Lares Municipio,1994,8294,6794,1500,18.1
72,83,Las Marias Municipio,1994,3173,2511,662,20.9
72,85,Las Piedras Municipio,1994,9512,7882,1630,17.1
72,87,Loiza Municipio,1994,7853,6755,1098,14.0
72,89,Luquillo Municipio,1994,6122,4863,1259,20.6
72,91,Manati Municipio,1994,12450,10011,2439,19.6
72,93,Maricao Municipio,1994,2149,1773,376,17.5
72,95,Maunabo Municipio,1994,2970,2181,789,26.6
72,97,Mayaguez Municipio,1994,35335,29734,5601,15.9
72,99,Moca Municipio,1994,11770,9548,2222,18.9
72,101,Morovis Municipio,1994,8709,7365,1344,15.4
72,103,Naguabo Municipio,1994,6367,5250,1117,17.5
72,105,Naranjito Municipio,1994,6663,5645,1018,15.3
72,107,Orocovis Municipio,1994,5793,4520,1273,22.0
72,109,Patillas Municipio,1994,5909,4567,1342,22.7
72,111,Penuelas Municipio,1994,7167,5687,1480,20.7
72,113,Ponce Municipio,1994,58065,48481,9584,16.5
72,115,Quebradillas Municipio,1994,7471,6381,1090,14.6
72,117,Rincon Municipio,1994,5423,4598,825,15.2
72,119,Rio Grande Municipio,1994,16028,13250,2778,17.3
72,121,Sabana Grande Municipio,1994,8357,6841,1516,18.1
72,123,Salinas Municipio,1994,8378,6236,2142,25.6
72,125,San German Municipio,1994,12931,10477,2454,19.0
72,127,San Juan Municipio,1994,156149,140626,15523,9.9
72,129,San Lorenzo Municipio,1994,11282,9220,2062,18.3
72,131,San Sebastian Municipio,1994,13043,9989,3054,23.4
72,133,Santa Isabel Municipio,1994,5184,3635,1549,29.9
72,135,Toa Alta Municipio,1994,16730,15180,1550,9.3
72,137,Toa Baja Municipio,1994,32622,29434,3188,9.8
72,139,Trujillo Alto Municipio,1994,25819,23860,1959,7.6
72,141,Utuado Municipio,1994,8065,6786,1279,15.9
72,143,Vega Alta Municipio,1994,10769,9447,1322,12.3
72,145,Vega Baja Municipio,1994,17994,15255,2739,15.2
72,147,Vieques Municipio,1994,2503,2124,379,15.1
72,149,Villalba Municipio,1994,6115,4619,1496,24.5
72,151,Yabucoa Municipio,1994,11459,8877,2582,22.5
72,153,Yauco Municipio,1994,13128,10611,2517,19.2
1,1,Autauga,1995,19632,18525,1107,5.6
1,3,Baldwin,1995,60795,57914,2881,4.7
1,5,Barbour,1995,12346,11335,1011,8.2
1,7,Bibb,1995,7987,7465,522,6.5
1,9,Blount,1995,20985,20065,920,4.4
1,11,Bullock,1995,4444,3706,738,16.6
1,13,Butler,1995,10010,9173,837,8.4
1,15,Calhoun,1995,53388,49241,4147,7.8
1,17,Chambers,1995,17141,15893,1248,7.3
1,19,Cherokee,1995,10146,9515,631,6.2
1,21,Chilton,1995,17542,16452,1090,6.2
1,23,Choctaw,1995,6815,6119,696,10.2
1,25,Clarke,1995,13548,12166,1382,10.2
1,27,Clay,1995,6615,6252,363,5.5
1,29,Cleburne,1995,7312,6913,399,5.5
1,31,Coffee,1995,21548,20603,945,4.4
1,33,Colbert,1995,26702,24815,1887,7.1
1,35,Conecuh,1995,6704,6008,696,10.4
1,37,Coosa,1995,5409,5147,262,4.8
1,39,Covington,1995,17669,16487,1182,6.7
1,41,Crenshaw,1995,6035,5692,343,5.7
1,43,Cullman,1995,37434,35483,1951,5.2
1,45,Dale,1995,20993,19609,1384,6.6
1,47,Dallas,1995,20975,18367,2608,12.4
1,49,DeKalb,1995,31216,29616,1600,5.1
1,51,Elmore,1995,26350,25088,1262,4.8
1,53,Escambia,1995,16300,14963,1337,8.2
1,55,Etowah,1995,48491,45450,3041,6.3
1,57,Fayette,1995,8749,8255,494,5.6
1,59,Franklin,1995,15929,14804,1125,7.1
1,61,Geneva,1995,12601,11773,828,6.6
1,63,Greene,1995,3627,3124,503,13.9
1,65,Hale,1995,7118,6456,662,9.3
1,67,Henry,1995,6466,6021,445,6.9
1,69,Houston,1995,42275,40257,2018,4.8
1,71,Jackson,1995,25219,22874,2345,9.3
1,73,Jefferson,1995,325100,311200,13900,4.3
1,75,Lamar,1995,7899,7427,472,6.0
1,77,Lauderdale,1995,42620,40191,2429,5.7
1,79,Lawrence,1995,15558,14415,1143,7.3
1,81,Lee,1995,46515,44558,1957,4.2
1,83,Limestone,1995,26800,25477,1323,4.9
1,85,Lowndes,1995,4277,3591,686,16.0
1,87,Macon,1995,8462,7762,700,8.3
1,89,Madison,1995,134770,128786,5984,4.4
1,91,Marengo,1995,10792,9903,889,8.2
1,93,Marion,1995,15626,14716,910,5.8
1,95,Marshall,1995,39422,36738,2684,6.8
1,97,Mobile,1995,192514,179086,13428,7.0
1,99,Monroe,1995,10538,9283,1255,11.9
1,101,Montgomery,1995,106792,101140,5652,5.3
1,103,Morgan,1995,53360,50221,3139,5.9
1,105,Perry,1995,4892,4062,830,17.0
1,107,Pickens,1995,8928,8145,783,8.8
1,109,Pike,1995,13356,12560,796,6.0
1,111,Randolph,1995,9801,9067,734,7.5
1,113,Russell,1995,24032,22569,1463,6.1
1,115,St. Clair,1995,27315,26314,1001,3.7
1,117,Shelby,1995,68530,66848,1682,2.5
1,119,Sumter,1995,6291,5477,814,12.9
1,121,Talladega,1995,35342,32778,2564,7.3
1,123,Tallapoosa,1995,20231,19097,1134,5.6
1,125,Tuscaloosa,1995,76333,72971,3362,4.4
1,127,Walker,1995,30279,28062,2217,7.3
1,129,Washington,1995,6385,5524,861,13.5
1,131,Wilcox,1995,3938,3323,615,15.6
1,133,Winston,1995,12770,11988,782,6.1
2,13,Aleutians East Borough,1995,1577,1522,55,3.5
2,16,Aleutians West Census Area,1995,2393,2328,65,2.7
2,20,Anchorage Borough/municipality,1995,133138,126126,7012,5.3
2,50,Bethel Census Area,1995,5728,5267,461,8.0
2,60,Bristol Bay Borough,1995,561,525,36,6.4
2,68,Denali Borough,1995,1136,1032,104,9.2
2,70,Dillingham Census Area,1995,1646,1543,103,6.3
2,90,Fairbanks North Star Borough,1995,41184,38082,3102,7.5
2,100,Haines Borough,1995,1183,1053,130,11.0
2,110,Juneau Borough/city,1995,16662,15699,963,5.8
2,122,Kenai Peninsula Borough,1995,21491,18847,2644,12.3
2,130,Ketchikan Gateway Borough,1995,7736,7147,589,7.6
2,150,Kodiak Island Borough,1995,7494,6750,744,9.9
2,158,Kusilvak Census Area,1995,1916,1691,225,11.7
2,164,Lake and Peninsula Borough,1995,590,548,42,7.1
2,170,Matanuska-Susitna Borough,1995,25439,22852,2587,10.2
2,180,Nome Census Area,1995,3391,2952,439,12.9
2,185,North Slope Borough,1995,3154,3037,117,3.7
2,188,Northwest Arctic Borough,1995,2206,1847,359,16.3
2,201,Prince of Wales-Outer Ketchikan Census Area,1995,3297,2942,355,10.8
2,220,Sitka Borough/city,1995,4588,4303,285,6.2
2,232,Skagway-Hoonah-Angoon Census Area,1995,2313,2135,178,7.7
2,240,Southeast Fairbanks Census Area,1995,2516,2201,315,12.5
2,261,Valdez-Cordova Census Area,1995,5358,4833,525,9.8
2,280,Wrangell-Petersburg Census Area,1995,3726,3336,390,10.5
2,282,Yakutat Borough/city,1995,304,282,22,7.2
2,290,Yukon-Koyukuk Census Area,1995,2030,1675,355,17.5
4,1,Apache,1995,20681,17150,3531,17.1
4,3,Cochise,1995,44535,40261,4274,9.6
4,5,Coconino,1995,61051,56110,4941,8.1
4,7,Gila,1995,19676,18046,1630,8.3
4,9,Graham,1995,12275,11226,1049,8.5
4,11,Greenlee,1995,4893,4551,342,7.0
4,12,La Paz,1995,6649,5932,717,10.8
4,13,Maricopa,1995,1375733,1326708,49025,3.6
4,15,Mohave,1995,61122,56820,4302,7.0
4,17,Navajo,1995,33266,28061,5205,15.6
4,19,Pima,1995,391800,378286,13514,3.4
4,21,Pinal,1995,53057,50416,2641,5.0
4,23,Santa Cruz,1995,15903,12656,3247,20.4
4,25,Yavapai,1995,65464,62195,3269,5.0
4,27,Yuma,1995,70824,49923,20901,29.5
5,1,Arkansas,1995,10786,10249,537,5.0
5,3,Ashley,1995,11134,10477,657,5.9
5,5,Baxter,1995,14486,14008,478,3.3
5,7,Benton,1995,62137,60738,1399,2.3
5,9,Boone,1995,14967,14347,620,4.1
5,11,Bradley,1995,4976,4556,420,8.4
5,13,Calhoun,1995,2361,2135,226,9.6
5,15,Carroll,1995,11970,11383,587,4.9
5,17,Chicot,1995,6354,5803,551,8.7
5,19,Clark,1995,11649,11318,331,2.8
5,21,Clay,1995,8199,7614,585,7.1
5,23,Cleburne,1995,9303,8842,461,5.0
5,25,Cleveland,1995,3976,3780,196,4.9
5,27,Columbia,1995,11702,10916,786,6.7
5,29,Conway,1995,9490,9008,482,5.1
5,31,Craighead,1995,40833,39375,1458,3.6
5,33,Crawford,1995,23551,22350,1201,5.1
5,35,Crittenden,1995,22388,21197,1191,5.3
5,37,Cross,1995,8779,8295,484,5.5
5,39,Dallas,1995,3802,3542,260,6.8
5,41,Desha,1995,7333,6668,665,9.1
5,43,Drew,1995,10266,9636,630,6.1
5,45,Faulkner,1995,38504,36800,1704,4.4
5,47,Franklin,1995,7980,7674,306,3.8
5,49,Fulton,1995,4608,4398,210,4.6
5,51,Garland,1995,35445,33686,1759,5.0
5,53,Grant,1995,7163,6824,339,4.7
5,55,Greene,1995,17812,16940,872,4.9
5,57,Hempstead,1995,11459,10668,791,6.9
5,59,Hot Spring,1995,11923,11339,584,4.9
5,61,Howard,1995,7060,6745,315,4.5
5,63,Independence,1995,16654,15645,1009,6.1
5,65,Izard,1995,4020,3753,267,6.6
5,67,Jackson,1995,8171,7421,750,9.2
5,69,Jefferson,1995,37063,34238,2825,7.6
5,71,Johnson,1995,10488,10067,421,4.0
5,73,Lafayette,1995,3549,3298,251,7.1
5,75,Lawrence,1995,7752,7301,451,5.8
5,77,Lee,1995,4800,4350,450,9.4
5,79,Lincoln,1995,5330,5012,318,6.0
5,81,Little River,1995,5744,5334,410,7.1
5,83,Logan,1995,10116,9623,493,4.9
5,85,Lonoke,1995,23415,22612,803,3.4
5,87,Madison,1995,6766,6562,204,3.0
5,89,Marion,1995,5964,5776,188,3.2
5,91,Miller,1995,17173,16030,1143,6.7
5,93,Mississippi,1995,26707,24134,2573,9.6
5,95,Monroe,1995,4338,4058,280,6.5
5,97,Montgomery,1995,3877,3730,147,3.8
5,99,Nevada,1995,4892,4616,276,5.6
5,101,Newton,1995,3002,2835,167,5.6
5,103,Ouachita,1995,12208,10895,1313,10.8
5,105,Perry,1995,3849,3602,247,6.4
5,107,Phillips,1995,10898,9735,1163,10.7
5,109,Pike,1995,5037,4787,250,5.0
5,111,Poinsett,1995,11066,10408,658,5.9
5,113,Polk,1995,8803,8473,330,3.7
5,115,Pope,1995,26614,25354,1260,4.7
5,117,Prairie,1995,4191,3946,245,5.8
5,119,Pulaski,1995,193018,186056,6962,3.6
5,121,Randolph,1995,7910,7339,571,7.2
5,123,St. Francis,1995,12745,11596,1149,9.0
5,125,Saline,1995,39080,38078,1002,2.6
5,127,Scott,1995,4957,4801,156,3.1
5,129,Searcy,1995,2996,2844,152,5.1
5,131,Sebastian,1995,55633,53063,2570,4.6
5,133,Sevier,1995,7037,6700,337,4.8
5,135,Sharp,1995,5773,5413,360,6.2
5,137,Stone,1995,5007,4735,272,5.4
5,139,Union,1995,21224,19933,1291,6.1
5,141,Van Buren,1995,6107,5693,414,6.8
5,143,Washington,1995,73058,71246,1812,2.5
5,145,White,1995,29857,28075,1782,6.0
5,147,Woodruff,1995,4208,3876,332,7.9
5,149,Yell,1995,9324,8990,334,3.6
6,1,Alameda,1995,677286,638518,38768,5.7
6,3,Alpine,1995,484,433,51,10.5
6,5,Amador,1995,13094,12050,1044,8.0
6,7,Butte,1995,82291,74106,8185,9.9
6,9,Calaveras,1995,14114,12558,1556,11.0
6,11,Colusa,1995,8562,6875,1687,19.7
6,13,Contra Costa,1995,452894,427107,25787,5.7
6,15,Del Norte,1995,10087,8848,1239,12.3
6,17,El Dorado,1995,72225,67255,4970,6.9
6,19,Fresno,1995,370491,318468,52023,14.0
6,21,Glenn,1995,11480,9695,1785,15.5
6,23,Humboldt,1995,59793,54827,4966,8.3
6,25,Imperial,1995,57977,41052,16925,29.2
6,27,Inyo,1995,7102,6437,665,9.4
6,29,Kern,1995,271178,233826,37352,13.8
6,31,Kings,1995,41865,35776,6089,14.5
6,33,Lake,1995,23705,20927,2778,11.7
6,35,Lassen,1995,10998,9783,1215,11.0
6,37,Los Angeles,1995,4288477,3939356,349121,8.1
6,39,Madera,1995,50706,43142,7564,14.9
6,41,Marin,1995,127732,122246,5486,4.3
6,43,Mariposa,1995,7448,6752,696,9.3
6,45,Mendocino,1995,41027,37129,3898,9.5
6,47,Merced,1995,82839,68722,14117,17.0
6,49,Modoc,1995,4218,3661,557,13.2
6,51,Mono,1995,6141,5479,662,10.8
6,53,Monterey,1995,174659,153122,21537,12.3
6,55,Napa,1995,57328,53774,3554,6.2
6,57,Nevada,1995,40162,37131,3031,7.5
6,59,Orange,1995,1321873,1255072,66801,5.1
6,61,Placer,1995,102109,95837,6272,6.1
6,63,Plumas,1995,9747,8461,1286,13.2
6,65,Riverside,1995,607553,550198,57355,9.4
6,67,Sacramento,1995,535088,498763,36325,6.8
6,69,San Benito,1995,22932,19816,3116,13.6
6,71,San Bernardino,1995,675999,622846,53153,7.9
6,73,San Diego,1995,1225334,1147735,77599,6.3
6,75,San Francisco/city,1995,395412,371554,23858,6.0
6,77,San Joaquin,1995,240288,210826,29462,12.3
6,79,San Luis Obispo,1995,100893,94279,6614,6.6
6,81,San Mateo,1995,367306,351882,15424,4.2
6,83,Santa Barbara,1995,191790,178970,12820,6.7
6,85,Santa Clara,1995,860942,818756,42186,4.9
6,87,Santa Cruz,1995,138732,125857,12875,9.3
6,89,Shasta,1995,72123,63979,8144,11.3
6,91,Sierra,1995,1692,1529,163,9.6
6,93,Siskiyou,1995,18857,16164,2693,14.3
6,95,Solano,1995,171811,158234,13577,7.9
6,97,Sonoma,1995,223749,211422,12327,5.5
6,99,Stanislaus,1995,192315,162679,29636,15.4
6,101,Sutter,1995,34287,28414,5873,17.1
6,103,Tehama,1995,23074,20476,2598,11.3
6,105,Trinity,1995,5281,4509,772,14.6
6,107,Tulare,1995,159773,133167,26606,16.7
6,109,Tuolumne,1995,20138,17955,2183,10.8
6,111,Ventura,1995,379479,351310,28169,7.4
6,113,Yolo,1995,86661,80721,5940,6.9
6,115,Yuba,1995,20983,17846,3137,15.0
8,1,Adams,1995,165630,159062,6568,4.0
8,3,Alamosa,1995,8005,7516,489,6.1
8,5,Arapahoe,1995,268432,260011,8421,3.1
8,7,Archuleta,1995,3644,3476,168,4.6
8,9,Baca,1995,2227,2172,55,2.5
8,11,Bent,1995,2308,2241,67,2.9
8,13,Boulder,1995,153061,146947,6114,4.0
8,14,Broomfield/city,1995,17320,16824,496,2.9
8,15,Chaffee,1995,7218,6933,285,3.9
8,17,Cheyenne,1995,1208,1171,37,3.1
8,19,Clear Creek,1995,5274,5057,217,4.1
8,21,Conejos,1995,3609,3299,310,8.6
8,23,Costilla,1995,1583,1407,176,11.1
8,25,Crowley,1995,1256,1210,46,3.7
8,27,Custer,1995,1549,1486,63,4.1
8,29,Delta,1995,10162,9566,596,5.9
8,31,Denver/city,1995,279349,266310,13039,4.7
8,33,Dolores,1995,640,584,56,8.8
8,35,Douglas,1995,60203,58818,1385,2.3
8,37,Eagle,1995,17782,17230,552,3.1
8,39,Elbert,1995,8943,8585,358,4.0
8,41,El Paso,1995,237520,227021,10499,4.4
8,43,Fremont,1995,16474,15609,865,5.3
8,45,Garfield,1995,20717,19908,809,3.9
8,47,Gilpin,1995,3478,3395,83,2.4
8,49,Grand,1995,5484,5322,162,3.0
8,51,Gunnison,1995,7888,7405,483,6.1
8,53,Hinsdale,1995,612,602,10,1.6
8,55,Huerfano,1995,3195,2982,213,6.7
8,57,Jackson,1995,923,859,64,6.9
8,59,Jefferson,1995,295829,286615,9214,3.1
8,61,Kiowa,1995,883,864,19,2.2
8,63,Kit Carson,1995,3436,3335,101,2.9
8,65,Lake,1995,3132,2981,151,4.8
8,67,La Plata,1995,23537,22482,1055,4.5
8,69,Larimer,1995,129581,124690,4891,3.8
8,71,Las Animas,1995,6498,6169,329,5.1
8,73,Lincoln,1995,2595,2533,62,2.4
8,75,Logan,1995,10040,9716,324,3.2
8,77,Mesa,1995,54537,51632,2905,5.3
8,79,Mineral,1995,397,364,33,8.3
8,81,Moffat,1995,6858,6464,394,5.7
8,83,Montezuma,1995,11413,10639,774,6.8
8,85,Montrose,1995,14903,14062,841,5.6
8,87,Morgan,1995,13104,12655,449,3.4
8,89,Otero,1995,9054,8573,481,5.3
8,91,Ouray,1995,1693,1610,83,4.9
8,93,Park,1995,7633,7334,299,3.9
8,95,Phillips,1995,1981,1951,30,1.5
8,97,Pitkin,1995,9089,8671,418,4.6
8,99,Prowers,1995,6498,6225,273,4.2
8,101,Pueblo,1995,57940,54599,3341,5.8
8,103,Rio Blanco,1995,3460,3224,236,6.8
8,105,Rio Grande,1995,5252,4808,444,8.5
8,107,Routt,1995,10362,9940,422,4.1
8,109,Saguache,1995,2678,2402,276,10.3
8,111,San Juan,1995,279,235,44,15.8
8,113,San Miguel,1995,4475,4294,181,4.0
8,115,Sedgwick,1995,1241,1200,41,3.3
8,117,Summit,1995,11503,11179,324,2.8
8,119,Teller,1995,13092,12518,574,4.4
8,121,Washington,1995,2373,2307,66,2.8
8,123,Weld,1995,80220,76584,3636,4.5
8,125,Yuma,1995,4282,4199,83,1.9
9,1,Fairfield,1995,448017,427387,20630,4.6
9,3,Hartford,1995,432811,407139,25672,5.9
9,5,Litchfield,1995,100667,96124,4543,4.5
9,7,Middlesex,1995,82101,77937,4164,5.1
9,9,New Haven,1995,415993,392639,23354,5.6
9,11,New London,1995,133842,127001,6841,5.1
9,13,Tolland,1995,70500,67176,3324,4.7
9,15,Windham,1995,56632,52999,3633,6.4
10,1,Kent,1995,69939,66801,3138,4.5
10,3,New Castle,1995,247517,237367,10150,4.1
10,5,Sussex,1995,68522,65373,3149,4.6
11,1,District of Colu,1995,300235,274298,25937,8.6
12,1,Alachua,1995,103550,100559,2991,2.9
12,3,Baker,1995,8790,8308,482,5.5
12,5,Bay,1995,64876,60489,4387,6.8
12,7,Bradford,1995,9762,9394,368,3.8
12,9,Brevard,1995,208370,194528,13842,6.6
12,11,Broward,1995,744653,701543,43110,5.8
12,13,Calhoun,1995,4847,4626,221,4.6
12,15,Charlotte,1995,45305,43140,2165,4.8
12,17,Citrus,1995,35372,32915,2457,6.9
12,19,Clay,1995,64540,62563,1977,3.1
12,21,Collier,1995,83691,77760,5931,7.1
12,23,Columbia,1995,23225,21899,1326,5.7
12,27,DeSoto,1995,10309,9625,684,6.6
12,29,Dixie,1995,4145,3795,350,8.4
12,31,Duval,1995,376344,361717,14627,3.9
12,33,Escambia,1995,123752,118399,5353,4.3
12,35,Flagler,1995,15169,14653,516,3.4
12,37,Franklin,1995,4907,4693,214,4.4
12,39,Gadsden,1995,19421,18584,837,4.3
12,41,Gilchrist,1995,4374,4213,161,3.7
12,43,Glades,1995,3551,3203,348,9.8
12,45,Gulf,1995,5843,5507,336,5.8
12,47,Hamilton,1995,3767,3513,254,6.7
12,49,Hardee,1995,11439,9940,1499,13.1
12,51,Hendry,1995,16609,14089,2520,15.2
12,53,Hernando,1995,43582,41214,2368,5.4
12,55,Highlands,1995,28567,26057,2510,8.8
12,57,Hillsborough,1995,507409,485152,22257,4.4
12,59,Holmes,1995,7038,6542,496,7.0
12,61,Indian River,1995,42909,38681,4228,9.9
12,63,Jackson,1995,19397,18336,1061,5.5
12,65,Jefferson,1995,5412,5150,262,4.8
12,67,Lafayette,1995,2667,2573,94,3.5
12,69,Lake,1995,78153,73989,4164,5.3
12,71,Lee,1995,175310,167899,7411,4.2
12,73,Leon,1995,127802,124212,3590,2.8
12,75,Levy,1995,12761,12154,607,4.8
12,77,Liberty,1995,2483,2426,57,2.3
12,79,Madison,1995,7496,7188,308,4.1
12,81,Manatee,1995,104548,100358,4190,4.0
12,83,Marion,1995,92121,87095,5026,5.5
12,85,Martin,1995,46523,42874,3649,7.8
12,86,Miami-Dade,1995,1036119,955097,81022,7.8
12,87,Monroe,1995,44632,43396,1236,2.8
12,89,Nassau,1995,26604,25522,1082,4.1
12,91,Okaloosa,1995,76877,73449,3428,4.5
12,93,Okeechobee,1995,15880,14292,1588,10.0
12,95,Orange,1995,435326,415475,19851,4.6
12,97,Osceola,1995,72205,68757,3448,4.8
12,99,Palm Beach,1995,470047,435851,34196,7.3
12,101,Pasco,1995,123958,117590,6368,5.1
12,103,Pinellas,1995,451029,432256,18773,4.2
12,105,Polk,1995,200050,185225,14825,7.4
12,107,Putnam,1995,30309,28722,1587,5.2
12,109,St. Johns,1995,54307,52426,1881,3.5
12,111,St. Lucie,1995,76183,66621,9562,12.6
12,113,Santa Rosa,1995,48373,46361,2012,4.2
12,115,Sarasota,1995,132593,128035,4558,3.4
12,117,Seminole,1995,195298,187369,7929,4.1
12,119,Sumter,1995,13104,12389,715,5.5
12,121,Suwannee,1995,13285,12597,688,5.2
12,123,Taylor,1995,7706,6943,763,9.9
12,125,Union,1995,4058,3872,186,4.6
12,127,Volusia,1995,179249,170477,8772,4.9
12,129,Wakulla,1995,9485,9084,401,4.2
12,131,Walton,1995,14745,14079,666,4.5
12,133,Washington,1995,8948,8388,560,6.3
13,1,Appling,1995,8144,7545,599,7.4
13,3,Atkinson,1995,3198,2984,214,6.7
13,5,Bacon,1995,4587,4381,206,4.5
13,7,Baker,1995,1475,1362,113,7.7
13,9,Baldwin,1995,17464,16795,669,3.8
13,11,Banks,1995,5747,5482,265,4.6
13,13,Barrow,1995,17847,16883,964,5.4
13,15,Bartow,1995,33537,31542,1995,5.9
13,17,Ben Hill,1995,8449,8022,427,5.1
13,19,Berrien,1995,6549,6172,377,5.8
13,21,Bibb,1995,71587,67828,3759,5.3
13,23,Bleckley,1995,5590,5357,233,4.2
13,25,Brantley,1995,4953,4540,413,8.3
13,27,Brooks,1995,6826,6567,259,3.8
13,29,Bryan,1995,9446,9069,377,4.0
13,31,Bulloch,1995,22930,22163,767,3.3
13,33,Burke,1995,8678,7497,1181,13.6
13,35,Butts,1995,7928,7484,444,5.6
13,37,Calhoun,1995,2254,2080,174,7.7
13,39,Camden,1995,15218,14635,583,3.8
13,43,Candler,1995,3647,3468,179,4.9
13,45,Carroll,1995,39763,37751,2012,5.1
13,47,Catoosa,1995,24303,23291,1012,4.2
13,49,Charlton,1995,3924,3680,244,6.2
13,51,Chatham,1995,104018,98484,5534,5.3
13,53,Chattahoochee,1995,2097,1947,150,7.2
13,55,Chattooga,1995,11954,11397,557,4.7
13,57,Cherokee,1995,64368,62176,2192,3.4
13,59,Clarke,1995,45660,44148,1512,3.3
13,61,Clay,1995,1512,1405,107,7.1
13,63,Clayton,1995,112531,106985,5546,4.9
13,65,Clinch,1995,3876,3727,149,3.8
13,67,Cobb,1995,311537,300457,11080,3.6
13,69,Coffee,1995,16685,15696,989,5.9
13,71,Colquitt,1995,17229,16546,683,4.0
13,73,Columbia,1995,40102,38472,1630,4.1
13,75,Cook,1995,7002,6755,247,3.5
13,77,Coweta,1995,36164,34722,1442,4.0
13,79,Crawford,1995,5335,5076,259,4.9
13,81,Crisp,1995,9868,9364,504,5.1
13,83,Dade,1995,6778,6455,323,4.8
13,85,Dawson,1995,8258,7942,316,3.8
13,87,Decatur,1995,11661,10906,755,6.5
13,89,DeKalb,1995,340694,324514,16180,4.7
13,91,Dodge,1995,9709,9195,514,5.3
13,93,Dooly,1995,4647,4335,312,6.7
13,95,Dougherty,1995,44651,41758,2893,6.5
13,97,Douglas,1995,45189,43605,1584,3.5
13,99,Early,1995,4982,4589,393,7.9
13,101,Echols,1995,1033,997,36,3.5
13,103,Effingham,1995,14922,14306,616,4.1
13,105,Elbert,1995,8698,8005,693,8.0
13,107,Emanuel,1995,8799,7879,920,10.5
13,109,Evans,1995,4475,4228,247,5.5
13,111,Fannin,1995,8032,7545,487,6.1
13,113,Fayette,1995,41624,40585,1039,2.5
13,115,Floyd,1995,45161,42767,2394,5.3
13,117,Forsyth,1995,34281,33262,1019,3.0
13,119,Franklin,1995,9485,8973,512,5.4
13,121,Fulton,1995,370407,350748,19659,5.3
13,123,Gilmer,1995,7264,6811,453,6.2
13,125,Glascock,1995,980,936,44,4.5
13,127,Glynn,1995,33398,32211,1187,3.6
13,129,Gordon,1995,20992,19734,1258,6.0
13,131,Grady,1995,9678,9187,491,5.1
13,133,Greene,1995,5240,4828,412,7.9
13,135,Gwinnett,1995,275580,267064,8516,3.1
13,137,Habersham,1995,14756,14172,584,4.0
13,139,Hall,1995,64433,62177,2256,3.5
13,141,Hancock,1995,4025,3759,266,6.6
13,143,Haralson,1995,9315,8603,712,7.6
13,145,Harris,1995,10057,9612,445,4.4
13,147,Hart,1995,8646,7869,777,9.0
13,149,Heard,1995,3732,3518,214,5.7
13,151,Henry,1995,45472,43969,1503,3.3
13,153,Houston,1995,47426,45517,1909,4.0
13,155,Irwin,1995,4280,4092,188,4.4
13,157,Jackson,1995,19843,18914,929,4.7
13,159,Jasper,1995,4368,4168,200,4.6
13,161,Jeff Davis,1995,5751,5408,343,6.0
13,163,Jefferson,1995,8187,7287,900,11.0
13,165,Jenkins,1995,4213,3864,349,8.3
13,167,Johnson,1995,4058,3633,425,10.5
13,169,Jones,1995,11258,10790,468,4.2
13,171,Lamar,1995,7134,6849,285,4.0
13,173,Lanier,1995,2922,2807,115,3.9
13,175,Laurens,1995,21677,20511,1166,5.4
13,177,Lee,1995,10015,9582,433,4.3
13,179,Liberty,1995,15746,14406,1340,8.5
13,181,Lincoln,1995,3601,3332,269,7.5
13,183,Long,1995,3049,2924,125,4.1
13,185,Lowndes,1995,38014,36559,1455,3.8
13,187,Lumpkin,1995,8548,8232,316,3.7
13,189,McDuffie,1995,9337,8764,573,6.1
13,191,McIntosh,1995,3777,3560,217,5.7
13,193,Macon,1995,5561,4931,630,11.3
13,195,Madison,1995,12585,12131,454,3.6
13,197,Marion,1995,3231,3093,138,4.3
13,199,Meriwether,1995,8898,8324,574,6.5
13,201,Miller,1995,3195,3023,172,5.4
13,205,Mitchell,1995,10302,9709,593,5.8
13,207,Monroe,1995,7886,7375,511,6.5
13,209,Montgomery,1995,3754,3484,270,7.2
13,211,Morgan,1995,6269,5908,361,5.8
13,213,Murray,1995,18047,17202,845,4.7
13,215,Muscogee,1995,79523,74889,4634,5.8
13,217,Newton,1995,24463,23414,1049,4.3
13,219,Oconee,1995,11607,11391,216,1.9
13,221,Oglethorpe,1995,5071,4842,229,4.5
13,223,Paulding,1995,31195,30130,1065,3.4
13,225,Peach,1995,10404,9675,729,7.0
13,227,Pickens,1995,8706,8239,467,5.4
13,229,Pierce,1995,6776,6338,438,6.5
13,231,Pike,1995,5652,5444,208,3.7
13,233,Polk,1995,15309,13997,1312,8.6
13,235,Pulaski,1995,4311,4137,174,4.0
13,237,Putnam,1995,7832,7607,225,2.9
13,239,Quitman,1995,1110,1020,90,8.1
13,241,Rabun,1995,6965,6678,287,4.1
13,243,Randolph,1995,3173,2904,269,8.5
13,245,Richmond,1995,81402,75626,5776,7.1
13,247,Rockdale,1995,35447,34275,1172,3.3
13,249,Schley,1995,1483,1421,62,4.2
13,251,Screven,1995,6766,6155,611,9.0
13,253,Seminole,1995,4290,4055,235,5.5
13,255,Spalding,1995,27842,26563,1279,4.6
13,257,Stephens,1995,12742,12090,652,5.1
13,259,Stewart,1995,2381,2248,133,5.6
13,261,Sumter,1995,15416,14671,745,4.8
13,263,Talbot,1995,2549,2322,227,8.9
13,265,Taliaferro,1995,570,528,42,7.4
13,267,Tattnall,1995,7040,6694,346,4.9
13,269,Taylor,1995,3391,3133,258,7.6
13,271,Telfair,1995,4837,4353,484,10.0
13,273,Terrell,1995,4267,3610,657,15.4
13,275,Thomas,1995,19998,19197,801,4.0
13,277,Tift,1995,19444,18352,1092,5.6
13,279,Toombs,1995,12142,11352,790,6.5
13,281,Towns,1995,3192,3064,128,4.0
13,283,Treutlen,1995,2987,2651,336,11.2
13,285,Troup,1995,27507,26111,1396,5.1
13,287,Turner,1995,4073,3786,287,7.0
13,289,Twiggs,1995,4082,3859,223,5.5
13,291,Union,1995,6377,6133,244,3.8
13,293,Upson,1995,12983,12402,581,4.5
13,295,Walker,1995,29999,28324,1675,5.6
13,297,Walton,1995,23349,22273,1076,4.6
13,299,Ware,1995,15441,14560,881,5.7
13,301,Warren,1995,2562,2393,169,6.6
13,303,Washington,1995,9376,8875,501,5.3
13,305,Wayne,1995,10954,10189,765,7.0
13,307,Webster,1995,1092,1047,45,4.1
13,309,Wheeler,1995,1956,1769,187,9.6
13,311,White,1995,8868,8595,273,3.1
13,313,Whitfield,1995,44216,42310,1906,4.3
13,315,Wilcox,1995,3331,3159,172,5.2
13,317,Wilkes,1995,5492,5189,303,5.5
13,319,Wilkinson,1995,4527,4313,214,4.7
13,321,Worth,1995,9067,8505,562,6.2
15,1,Hawaii,1995,64939,58701,6238,9.6
15,3,Honolulu/city,1995,424990,406657,18333,4.3
15,7,Kauai,1995,28674,25588,3086,10.8
15,9,Maui,1995,66764,62177,4587,6.9
16,1,Ada,1995,143754,138612,5142,3.6
16,3,Adams,1995,1781,1525,256,14.4
16,5,Bannock,1995,36367,34192,2175,6.0
16,7,Bear Lake,1995,2944,2791,153,5.2
16,9,Benewah,1995,4209,3755,454,10.8
16,11,Bingham,1995,20579,19401,1178,5.7
16,13,Blaine,1995,10257,9812,445,4.3
16,15,Boise,1995,2463,2335,128,5.2
16,17,Bonner,1995,15856,14408,1448,9.1
16,19,Bonneville,1995,43730,41818,1912,4.4
16,21,Boundary,1995,4296,3911,385,9.0
16,23,Butte,1995,1567,1502,65,4.1
16,25,Camas,1995,451,437,14,3.1
16,27,Canyon,1995,54541,51398,3143,5.8
16,29,Caribou,1995,3262,3037,225,6.9
16,31,Cassia,1995,9599,8954,645,6.7
16,33,Clark,1995,630,602,28,4.4
16,35,Clearwater,1995,4078,3531,547,13.4
16,37,Custer,1995,2525,2375,150,5.9
16,39,Elmore,1995,8504,7983,521,6.1
16,41,Franklin,1995,4296,4111,185,4.3
16,43,Fremont,1995,4606,4212,394,8.6
16,45,Gem,1995,6139,5672,467,7.6
16,47,Gooding,1995,6584,6308,276,4.2
16,49,Idaho,1995,6621,5841,780,11.8
16,51,Jefferson,1995,9293,8807,486,5.2
16,53,Jerome,1995,8854,8434,420,4.7
16,55,Kootenai,1995,48673,44910,3763,7.7
16,57,Latah,1995,16221,15729,492,3.0
16,59,Lemhi,1995,4168,3863,305,7.3
16,61,Lewis,1995,1640,1523,117,7.1
16,63,Lincoln,1995,2109,2022,87,4.1
16,65,Madison,1995,9827,9496,331,3.4
16,67,Minidoka,1995,10241,9441,800,7.8
16,69,Nez Perce,1995,22181,21262,919,4.1
16,71,Oneida,1995,1566,1502,64,4.1
16,73,Owyhee,1995,4647,4502,145,3.1
16,75,Payette,1995,9616,8932,684,7.1
16,77,Power,1995,3522,3276,246,7.0
16,79,Shoshone,1995,6669,5955,714,10.7
16,81,Teton,1995,2595,2507,88,3.4
16,83,Twin Falls,1995,32047,30489,1558,4.9
16,85,Valley,1995,4110,3731,379,9.2
16,87,Washington,1995,4388,3996,392,8.9
17,1,Adams,1995,35851,34406,1445,4.0
17,3,Alexander,1995,3890,3551,339,8.7
17,5,Bond,1995,7937,7524,413,5.2
17,7,Boone,1995,20266,19410,856,4.2
17,9,Brown,1995,2706,2626,80,3.0
17,11,Bureau,1995,18647,17673,974,5.2
17,13,Calhoun,1995,3006,2833,173,5.8
17,15,Carroll,1995,9249,8714,535,5.8
17,17,Cass,1995,7424,7055,369,5.0
17,19,Champaign,1995,93092,90614,2478,2.7
17,21,Christian,1995,19587,18337,1250,6.4
17,23,Clark,1995,9420,9051,369,3.9
17,25,Clay,1995,6943,6556,387,5.6
17,27,Clinton,1995,16821,16085,736,4.4
17,29,Coles,1995,27562,26574,988,3.6
17,31,Cook,1995,2658288,2498123,160165,6.0
17,33,Crawford,1995,9596,8929,667,7.0
17,35,Cumberland,1995,5635,5382,253,4.5
17,37,DeKalb,1995,45579,43884,1695,3.7
17,39,De Witt,1995,9381,8969,412,4.4
17,41,Douglas,1995,11532,11127,405,3.5
17,43,DuPage,1995,506050,487410,18640,3.7
17,45,Edgar,1995,9766,9353,413,4.2
17,47,Edwards,1995,3684,3491,193,5.2
17,49,Effingham,1995,17986,17278,708,3.9
17,51,Fayette,1995,9968,9406,562,5.6
17,53,Ford,1995,6923,6622,301,4.3
17,55,Franklin,1995,16341,14697,1644,10.1
17,57,Fulton,1995,14745,13748,997,6.8
17,59,Gallatin,1995,2848,2583,265,9.3
17,61,Greene,1995,6976,6603,373,5.3
17,63,Grundy,1995,18508,16975,1533,8.3
17,65,Hamilton,1995,3601,3311,290,8.1
17,67,Hancock,1995,12304,11811,493,4.0
17,69,Hardin,1995,1866,1745,121,6.5
17,71,Henderson,1995,4747,4579,168,3.5
17,73,Henry,1995,25719,24565,1154,4.5
17,75,Iroquois,1995,17555,16739,816,4.6
17,77,Jackson,1995,28799,27392,1407,4.9
17,79,Jasper,1995,4724,4490,234,5.0
17,81,Jefferson,1995,18080,16903,1177,6.5
17,83,Jersey,1995,10250,9683,567,5.5
17,85,Jo Daviess,1995,13497,12972,525,3.9
17,87,Johnson,1995,4522,4168,354,7.8
17,89,Kane,1995,199704,190369,9335,4.7
17,91,Kankakee,1995,52279,49243,3036,5.8
17,93,Kendall,1995,25834,24748,1086,4.2
17,95,Knox,1995,28625,27351,1274,4.5
17,97,Lake,1995,305009,294028,10981,3.6
17,99,LaSalle,1995,54760,50870,3890,7.1
17,101,Lawrence,1995,6963,6431,532,7.6
17,103,Lee,1995,17371,16601,770,4.4
17,105,Livingston,1995,19304,18656,648,3.4
17,107,Logan,1995,12857,12331,526,4.1
17,109,McDonough,1995,18748,18316,432,2.3
17,111,McHenry,1995,126849,121370,5479,4.3
17,113,McLean,1995,79908,77799,2109,2.6
17,115,Macon,1995,60560,56421,4139,6.8
17,117,Macoupin,1995,22695,21398,1297,5.7
17,119,Madison,1995,125977,119479,6498,5.2
17,121,Marion,1995,21185,19617,1568,7.4
17,123,Marshall,1995,6400,6120,280,4.4
17,125,Mason,1995,8072,7566,506,6.3
17,127,Massac,1995,7804,7431,373,4.8
17,129,Menard,1995,6032,5796,236,3.9
17,131,Mercer,1995,8401,7925,476,5.7
17,133,Monroe,1995,12813,12391,422,3.3
17,135,Montgomery,1995,14466,13459,1007,7.0
17,137,Morgan,1995,18264,17402,862,4.7
17,139,Moultrie,1995,7976,7652,324,4.1
17,141,Ogle,1995,27372,26198,1174,4.3
17,143,Peoria,1995,93959,90016,3943,4.2
17,145,Perry,1995,7877,7065,812,10.3
17,147,Piatt,1995,7908,7510,398,5.0
17,149,Pike,1995,8749,8297,452,5.2
17,151,Pope,1995,1646,1540,106,6.4
17,153,Pulaski,1995,2843,2553,290,10.2
17,155,Putnam,1995,3055,2872,183,6.0
17,157,Randolph,1995,14226,13324,902,6.3
17,159,Richland,1995,9757,9378,379,3.9
17,161,Rock Island,1995,72943,69542,3401,4.7
17,163,St. Clair,1995,116144,109683,6461,5.6
17,165,Saline,1995,10613,9488,1125,10.6
17,167,Sangamon,1995,101220,97194,4026,4.0
17,169,Schuyler,1995,3851,3656,195,5.1
17,171,Scott,1995,2755,2590,165,6.0
17,173,Shelby,1995,11495,10927,568,4.9
17,175,Stark,1995,2875,2724,151,5.3
17,177,Stephenson,1995,25525,24359,1166,4.6
17,179,Tazewell,1995,68510,65790,2720,4.0
17,181,Union,1995,7951,7340,611,7.7
17,183,Vermilion,1995,40449,37577,2872,7.1
17,185,Wabash,1995,5486,5127,359,6.5
17,187,Warren,1995,9841,9410,431,4.4
17,189,Washington,1995,8005,7692,313,3.9
17,191,Wayne,1995,8191,7723,468,5.7
17,193,White,1995,7485,6976,509,6.8
17,195,Whiteside,1995,31067,29898,1169,3.8
17,197,Will,1995,219219,206971,12248,5.6
17,199,Williamson,1995,26941,24846,2095,7.8
17,201,Winnebago,1995,146339,140938,5401,3.7
17,203,Woodford,1995,18195,17776,419,2.3
18,1,Adams,1995,16777,15968,809,4.8
18,3,Allen,1995,175807,169413,6394,3.6
18,5,Bartholomew,1995,40070,38897,1173,2.9
18,7,Benton,1995,5394,5140,254,4.7
18,9,Blackford,1995,6470,6071,399,6.2
18,11,Boone,1995,23475,22871,604,2.6
18,13,Brown,1995,8688,8450,238,2.7
18,15,Carroll,1995,12113,11725,388,3.2
18,17,Cass,1995,19134,17883,1251,6.5
18,19,Clark,1995,50707,48439,2268,4.5
18,21,Clay,1995,13249,12469,780,5.9
18,23,Clinton,1995,15897,15365,532,3.3
18,25,Crawford,1995,4871,4417,454,9.3
18,27,Daviess,1995,13794,13149,645,4.7
18,29,Dearborn,1995,22504,21084,1420,6.3
18,31,Decatur,1995,15388,14803,585,3.8
18,33,DeKalb,1995,21411,20621,790,3.7
18,35,Delaware,1995,66883,63725,3158,4.7
18,37,Dubois,1995,22756,22061,695,3.1
18,39,Elkhart,1995,96690,93265,3425,3.5
18,41,Fayette,1995,12521,11286,1235,9.9
18,43,Floyd,1995,37515,36021,1494,4.0
18,45,Fountain,1995,8780,8346,434,4.9
18,47,Franklin,1995,11000,10320,680,6.2
18,49,Fulton,1995,10788,10329,459,4.3
18,51,Gibson,1995,16138,15170,968,6.0
18,53,Grant,1995,36826,34306,2520,6.8
18,55,Greene,1995,15796,14389,1407,8.9
18,57,Hamilton,1995,81746,80131,1615,2.0
18,59,Hancock,1995,28470,27615,855,3.0
18,61,Harrison,1995,17421,16631,790,4.5
18,63,Hendricks,1995,48407,47309,1098,2.3
18,65,Henry,1995,25360,23935,1425,5.6
18,67,Howard,1995,44372,42496,1876,4.2
18,69,Huntington,1995,20699,19842,857,4.1
18,71,Jackson,1995,22081,21250,831,3.8
18,73,Jasper,1995,14500,13654,846,5.8
18,75,Jay,1995,12078,11428,650,5.4
18,77,Jefferson,1995,15141,14457,684,4.5
18,79,Jennings,1995,14189,13757,432,3.0
18,81,Johnson,1995,57721,56172,1549,2.7
18,83,Knox,1995,21012,20155,857,4.1
18,85,Kosciusko,1995,39666,38413,1253,3.2
18,87,LaGrange,1995,18913,18273,640,3.4
18,89,Lake,1995,229277,214090,15187,6.6
18,91,LaPorte,1995,55920,52955,2965,5.3
18,93,Lawrence,1995,25053,23475,1578,6.3
18,95,Madison,1995,67123,64025,3098,4.6
18,97,Marion,1995,457844,438930,18914,4.1
18,99,Marshall,1995,26527,25665,862,3.2
18,101,Martin,1995,5323,5007,316,5.9
18,103,Miami,1995,15629,14624,1005,6.4
18,105,Monroe,1995,60924,58948,1976,3.2
18,107,Montgomery,1995,20289,19756,533,2.6
18,109,Morgan,1995,33659,32468,1191,3.5
18,111,Newton,1995,6912,6554,358,5.2
18,113,Noble,1995,24626,23744,882,3.6
18,115,Ohio,1995,2702,2549,153,5.7
18,117,Orange,1995,9452,8604,848,9.0
18,119,Owen,1995,10070,9532,538,5.3
18,121,Parke,1995,7755,7331,424,5.5
18,123,Perry,1995,9322,8587,735,7.9
18,125,Pike,1995,6338,5926,412,6.5
18,127,Porter,1995,73172,69872,3300,4.5
18,129,Posey,1995,14022,13473,549,3.9
18,131,Pulaski,1995,6334,6023,311,4.9
18,133,Putnam,1995,17262,16648,614,3.6
18,135,Randolph,1995,12781,11860,921,7.2
18,137,Ripley,1995,13753,12992,761,5.5
18,139,Rush,1995,10267,9815,452,4.4
18,141,St. Joseph,1995,137703,132131,5572,4.0
18,143,Scott,1995,10657,10102,555,5.2
18,145,Shelby,1995,23753,22504,1249,5.3
18,147,Spencer,1995,11229,10618,611,5.4
18,149,Starke,1995,11471,10780,691,6.0
18,151,Steuben,1995,17865,17300,565,3.2
18,153,Sullivan,1995,10343,9461,882,8.5
18,155,Switzerland,1995,4448,4192,256,5.8
18,157,Tippecanoe,1995,72891,70996,1895,2.6
18,159,Tipton,1995,9160,8841,319,3.5
18,161,Union,1995,3999,3787,212,5.3
18,163,Vanderburgh,1995,92277,87628,4649,5.0
18,165,Vermillion,1995,8450,7781,669,7.9
18,167,Vigo,1995,54851,51754,3097,5.6
18,169,Wabash,1995,18465,17699,766,4.1
18,171,Warren,1995,4024,3847,177,4.4
18,173,Warrick,1995,27799,26548,1251,4.5
18,175,Washington,1995,12144,11407,737,6.1
18,177,Wayne,1995,38992,36834,2158,5.5
18,179,Wells,1995,14812,14326,486,3.3
18,181,White,1995,15591,14917,674,4.3
18,183,Whitley,1995,16393,15842,551,3.4
19,1,Adair,1995,4538,4382,156,3.4
19,3,Adams,1995,2438,2363,75,3.1
19,5,Allamakee,1995,7748,7347,401,5.2
19,7,Appanoose,1995,6753,6379,374,5.5
19,9,Audubon,1995,3739,3616,123,3.3
19,11,Benton,1995,11997,11486,511,4.3
19,13,Black Hawk,1995,69062,65951,3111,4.5
19,15,Boone,1995,13887,13468,419,3.0
19,17,Bremer,1995,12555,12176,379,3.0
19,19,Buchanan,1995,10894,10402,492,4.5
19,21,Buena Vista,1995,11230,10958,272,2.4
19,23,Butler,1995,8216,7796,420,5.1
19,25,Calhoun,1995,5267,5084,183,3.5
19,27,Carroll,1995,12128,11673,455,3.8
19,29,Cass,1995,7821,7460,361,4.6
19,31,Cedar,1995,9641,9365,276,2.9
19,33,Cerro Gordo,1995,26583,25645,938,3.5
19,35,Cherokee,1995,7039,6811,228,3.2
19,37,Chickasaw,1995,7835,7433,402,5.1
19,39,Clarke,1995,3943,3702,241,6.1
19,41,Clay,1995,9845,9559,286,2.9
19,43,Clayton,1995,10641,10071,570,5.4
19,45,Clinton,1995,27431,26077,1354,4.9
19,47,Crawford,1995,8951,8641,310,3.5
19,49,Dallas,1995,18648,18191,457,2.5
19,51,Davis,1995,4413,4230,183,4.1
19,53,Decatur,1995,4001,3729,272,6.8
19,55,Delaware,1995,9353,8874,479,5.1
19,57,Des Moines,1995,23849,22778,1071,4.5
19,59,Dickinson,1995,9900,9564,336,3.4
19,61,Dubuque,1995,50824,48960,1864,3.7
19,63,Emmet,1995,5652,5381,271,4.8
19,65,Fayette,1995,11627,11139,488,4.2
19,67,Floyd,1995,8262,7812,450,5.4
19,69,Franklin,1995,6148,5965,183,3.0
19,71,Fremont,1995,4012,3885,127,3.2
19,73,Greene,1995,5216,4995,221,4.2
19,75,Grundy,1995,6093,5856,237,3.9
19,77,Guthrie,1995,6002,5799,203,3.4
19,79,Hamilton,1995,8706,8347,359,4.1
19,81,Hancock,1995,6211,6011,200,3.2
19,83,Hardin,1995,9746,9361,385,4.0
19,85,Harrison,1995,7618,7272,346,4.5
19,87,Henry,1995,11312,10942,370,3.3
19,89,Howard,1995,5442,5239,203,3.7
19,91,Humboldt,1995,5436,5298,138,2.5
19,93,Ida,1995,4177,4062,115,2.8
19,95,Iowa,1995,9375,9141,234,2.5
19,97,Jackson,1995,10589,9977,612,5.8
19,99,Jasper,1995,18804,18173,631,3.4
19,101,Jefferson,1995,9725,9354,371,3.8
19,103,Johnson,1995,65473,63677,1796,2.7
19,105,Jones,1995,9808,9387,421,4.3
19,107,Keokuk,1995,5144,4897,247,4.8
19,109,Kossuth,1995,8896,8545,351,3.9
19,111,Lee,1995,20011,18990,1021,5.1
19,113,Linn,1995,108992,105945,3047,2.8
19,115,Louisa,1995,6603,6334,269,4.1
19,117,Lucas,1995,4158,3926,232,5.6
19,119,Lyon,1995,5860,5698,162,2.8
19,121,Madison,1995,7606,7281,325,4.3
19,123,Mahaska,1995,11275,10880,395,3.5
19,125,Marion,1995,17827,17226,601,3.4
19,127,Marshall,1995,21160,20468,692,3.3
19,129,Mills,1995,6293,6090,203,3.2
19,131,Mitchell,1995,5789,5600,189,3.3
19,133,Monona,1995,5265,5086,179,3.4
19,135,Monroe,1995,4319,4122,197,4.6
19,137,Montgomery,1995,6144,5908,236,3.8
19,139,Muscatine,1995,21752,21013,739,3.4
19,141,O'Brien,1995,8052,7832,220,2.7
19,143,Osceola,1995,3759,3629,130,3.5
19,145,Page,1995,9262,8927,335,3.6
19,147,Palo Alto,1995,5361,5188,173,3.2
19,149,Plymouth,1995,12909,12395,514,4.0
19,151,Pocahontas,1995,4400,4234,166,3.8
19,153,Polk,1995,213336,207705,5631,2.6
19,155,Pottawattamie,1995,47246,45737,1509,3.2
19,157,Poweshiek,1995,10568,10142,426,4.0
19,159,Ringgold,1995,2672,2564,108,4.0
19,161,Sac,1995,6087,5851,236,3.9
19,163,Scott,1995,84045,81015,3030,3.6
19,165,Shelby,1995,6865,6601,264,3.8
19,167,Sioux,1995,17311,16783,528,3.1
19,169,Story,1995,45537,44245,1292,2.8
19,171,Tama,1995,9849,9464,385,3.9
19,173,Taylor,1995,3439,3262,177,5.1
19,175,Union,1995,6431,6132,299,4.6
19,177,Van Buren,1995,4119,3950,169,4.1
19,179,Wapello,1995,18587,17662,925,5.0
19,181,Warren,1995,23103,22557,546,2.4
19,183,Washington,1995,11387,11024,363,3.2
19,185,Wayne,1995,3413,3277,136,4.0
19,187,Webster,1995,20614,19740,874,4.2
19,189,Winnebago,1995,6813,6632,181,2.7
19,191,Winneshiek,1995,12254,11669,585,4.8
19,193,Woodbury,1995,56052,54291,1761,3.1
19,195,Worth,1995,4140,3997,143,3.5
19,197,Wright,1995,7443,7158,285,3.8
20,1,Allen,1995,7054,6578,476,6.7
20,3,Anderson,1995,4073,3844,229,5.6
20,5,Atchison,1995,8453,7882,571,6.8
20,7,Barber,1995,2541,2437,104,4.1
20,9,Barton,1995,15503,14814,689,4.4
20,11,Bourbon,1995,6656,6277,379,5.7
20,13,Brown,1995,5076,4783,293,5.8
20,15,Butler,1995,29334,28190,1144,3.9
20,17,Chase,1995,1500,1419,81,5.4
20,19,Chautauqua,1995,1713,1621,92,5.4
20,21,Cherokee,1995,10438,9741,697,6.7
20,23,Cheyenne,1995,1563,1531,32,2.0
20,25,Clark,1995,1317,1286,31,2.4
20,27,Clay,1995,4736,4584,152,3.2
20,29,Cloud,1995,5302,5134,168,3.2
20,31,Coffey,1995,4258,3993,265,6.2
20,33,Comanche,1995,1078,1062,16,1.5
20,35,Cowley,1995,18453,17471,982,5.3
20,37,Crawford,1995,18109,17236,873,4.8
20,39,Decatur,1995,1887,1836,51,2.7
20,41,Dickinson,1995,10215,9657,558,5.5
20,43,Doniphan,1995,4143,3865,278,6.7
20,45,Douglas,1995,51396,48986,2410,4.7
20,47,Edwards,1995,1883,1831,52,2.8
20,49,Elk,1995,1511,1437,74,4.9
20,51,Ellis,1995,16375,15873,502,3.1
20,53,Ellsworth,1995,2920,2793,127,4.3
20,55,Finney,1995,19415,18765,650,3.3
20,57,Ford,1995,15875,15330,545,3.4
20,59,Franklin,1995,12513,11782,731,5.8
20,61,Geary,1995,10966,10250,716,6.5
20,63,Gove,1995,1571,1544,27,1.7
20,65,Graham,1995,1653,1581,72,4.4
20,67,Grant,1995,4078,3959,119,2.9
20,69,Gray,1995,2804,2733,71,2.5
20,71,Greeley,1995,916,887,29,3.2
20,73,Greenwood,1995,3360,3178,182,5.4
20,75,Hamilton,1995,1264,1236,28,2.2
20,77,Harper,1995,3061,2960,101,3.3
20,79,Harvey,1995,16045,15413,632,3.9
20,81,Haskell,1995,2150,2081,69,3.2
20,83,Hodgeman,1995,1024,1001,23,2.2
20,85,Jackson,1995,6352,5997,355,5.6
20,87,Jefferson,1995,9811,9393,418,4.3
20,89,Jewell,1995,2187,2133,54,2.5
20,91,Johnson,1995,237873,231035,6838,2.9
20,93,Kearny,1995,2199,2134,65,3.0
20,95,Kingman,1995,4267,4096,171,4.0
20,97,Kiowa,1995,1831,1786,45,2.5
20,99,Labette,1995,10709,10076,633,5.9
20,101,Lane,1995,1191,1149,42,3.5
20,103,Leavenworth,1995,27518,26123,1395,5.1
20,105,Lincoln,1995,1837,1741,96,5.2
20,107,Linn,1995,3538,3235,303,8.6
20,109,Logan,1995,1667,1631,36,2.2
20,111,Lyon,1995,20021,19146,875,4.4
20,113,McPherson,1995,15780,15360,420,2.7
20,115,Marion,1995,6942,6765,177,2.5
20,117,Marshall,1995,5953,5775,178,3.0
20,119,Meade,1995,2330,2274,56,2.4
20,121,Miami,1995,13065,12506,559,4.3
20,123,Mitchell,1995,3627,3521,106,2.9
20,125,Montgomery,1995,18082,17087,995,5.5
20,127,Morris,1995,3104,3011,93,3.0
20,129,Morton,1995,1749,1711,38,2.2
20,131,Nemaha,1995,5677,5550,127,2.2
20,133,Neosho,1995,9050,8650,400,4.4
20,135,Ness,1995,1977,1928,49,2.5
20,137,Norton,1995,3069,3007,62,2.0
20,139,Osage,1995,8309,7763,546,6.6
20,141,Osborne,1995,2547,2485,62,2.4
20,143,Ottawa,1995,2998,2892,106,3.5
20,145,Pawnee,1995,3945,3843,102,2.6
20,147,Phillips,1995,3303,3195,108,3.3
20,149,Pottawatomie,1995,9486,9107,379,4.0
20,151,Pratt,1995,5154,5003,151,2.9
20,153,Rawlins,1995,1693,1643,50,3.0
20,155,Reno,1995,32915,31616,1299,3.9
20,157,Republic,1995,3272,3197,75,2.3
20,159,Rice,1995,4943,4718,225,4.6
20,161,Riley,1995,30073,28783,1290,4.3
20,163,Rooks,1995,2950,2859,91,3.1
20,165,Rush,1995,1873,1816,57,3.0
20,167,Russell,1995,3757,3608,149,4.0
20,169,Saline,1995,29947,28747,1200,4.0
20,171,Scott,1995,2769,2713,56,2.0
20,173,Sedgwick,1995,221635,211088,10547,4.8
20,175,Seward,1995,10681,10233,448,4.2
20,177,Shawnee,1995,90149,86151,3998,4.4
20,179,Sheridan,1995,1516,1488,28,1.8
20,181,Sherman,1995,4018,3914,104,2.6
20,183,Smith,1995,2529,2452,77,3.0
20,185,Stafford,1995,2481,2406,75,3.0
20,187,Stanton,1995,1138,1114,24,2.1
20,189,Stevens,1995,2656,2597,59,2.2
20,191,Sumner,1995,12771,12108,663,5.2
20,193,Thomas,1995,4748,4617,131,2.8
20,195,Trego,1995,2046,1995,51,2.5
20,197,Wabaunsee,1995,3470,3313,157,4.5
20,199,Wallace,1995,888,869,19,2.1
20,201,Washington,1995,3615,3481,134,3.7
20,203,Wichita,1995,1305,1268,37,2.8
20,205,Wilson,1995,5325,5074,251,4.7
20,207,Woodson,1995,1663,1518,145,8.7
20,209,Wyandotte,1995,75983,69901,6082,8.0
21,1,Adair,1995,7951,7402,549,6.9
21,3,Allen,1995,8851,8551,300,3.4
21,5,Anderson,1995,9001,8721,280,3.1
21,7,Ballard,1995,3975,3707,268,6.7
21,9,Barren,1995,18093,17180,913,5.0
21,11,Bath,1995,4933,4459,474,9.6
21,13,Bell,1995,10208,9414,794,7.8
21,15,Boone,1995,37828,36284,1544,4.1
21,17,Bourbon,1995,9520,9233,287,3.0
21,19,Boyd,1995,22683,20868,1815,8.0
21,21,Boyle,1995,13172,12567,605,4.6
21,23,Bracken,1995,3751,3531,220,5.9
21,25,Breathitt,1995,4658,4147,511,11.0
21,27,Breckinridge,1995,7690,7197,493,6.4
21,29,Bullitt,1995,29773,28865,908,3.0
21,31,Butler,1995,5626,5187,439,7.8
21,33,Caldwell,1995,7004,6592,412,5.9
21,35,Calloway,1995,16633,15963,670,4.0
21,37,Campbell,1995,44363,42386,1977,4.5
21,39,Carlisle,1995,2650,2494,156,5.9
21,41,Carroll,1995,4762,4475,287,6.0
21,43,Carter,1995,11338,9746,1592,14.0
21,45,Casey,1995,7020,6653,367,5.2
21,47,Christian,1995,25780,24384,1396,5.4
21,49,Clark,1995,15189,14536,653,4.3
21,51,Clay,1995,7114,6563,551,7.7
21,53,Clinton,1995,4384,4028,356,8.1
21,55,Crittenden,1995,4335,4006,329,7.6
21,57,Cumberland,1995,2873,2561,312,10.9
21,59,Daviess,1995,48812,46061,2751,5.6
21,61,Edmonson,1995,4583,4263,320,7.0
21,63,Elliott,1995,2619,2154,465,17.8
21,65,Estill,1995,5914,5507,407,6.9
21,67,Fayette,1995,134291,130779,3512,2.6
21,69,Fleming,1995,6214,5862,352,5.7
21,71,Floyd,1995,14404,12891,1513,10.5
21,73,Franklin,1995,24183,23474,709,2.9
21,75,Fulton,1995,3991,3795,196,4.9
21,77,Gallatin,1995,3042,2866,176,5.8
21,79,Garrard,1995,6362,6079,283,4.4
21,81,Grant,1995,8943,8474,469,5.2
21,83,Graves,1995,16530,15478,1052,6.4
21,85,Grayson,1995,10761,10022,739,6.9
21,87,Green,1995,5278,4894,384,7.3
21,89,Greenup,1995,16307,15104,1203,7.4
21,91,Hancock,1995,3464,3222,242,7.0
21,93,Hardin,1995,35075,33037,2038,5.8
21,95,Harlan,1995,10160,8510,1650,16.2
21,97,Harrison,1995,7574,7174,400,5.3
21,99,Hart,1995,7802,7301,501,6.4
21,101,Henderson,1995,23544,22166,1378,5.9
21,103,Henry,1995,7505,7181,324,4.3
21,105,Hickman,1995,2492,2336,156,6.3
21,107,Hopkins,1995,20424,18932,1492,7.3
21,109,Jackson,1995,5352,4916,436,8.1
21,111,Jefferson,1995,360727,344436,16291,4.5
21,113,Jessamine,1995,18539,18096,443,2.4
21,115,Johnson,1995,10336,9492,844,8.2
21,117,Kenton,1995,76629,73402,3227,4.2
21,119,Knott,1995,5902,5280,622,10.5
21,121,Knox,1995,10788,10024,764,7.1
21,123,Larue,1995,5777,5513,264,4.6
21,125,Laurel,1995,21100,19788,1312,6.2
21,127,Lawrence,1995,5189,4523,666,12.8
21,129,Lee,1995,2495,2295,200,8.0
21,131,Leslie,1995,4397,4007,390,8.9
21,133,Letcher,1995,8088,7107,981,12.1
21,135,Lewis,1995,5470,4871,599,11.0
21,137,Lincoln,1995,9744,9264,480,4.9
21,139,Livingston,1995,4761,4451,310,6.5
21,141,Logan,1995,13262,12692,570,4.3
21,143,Lyon,1995,3170,2955,215,6.8
21,145,McCracken,1995,32788,31406,1382,4.2
21,147,McCreary,1995,6310,5801,509,8.1
21,149,McLean,1995,4272,3882,390,9.1
21,151,Madison,1995,32870,31329,1541,4.7
21,153,Magoffin,1995,4863,4123,740,15.2
21,155,Marion,1995,8478,7860,618,7.3
21,157,Marshall,1995,13700,12951,749,5.5
21,159,Martin,1995,3467,3058,409,11.8
21,161,Mason,1995,8603,8134,469,5.5
21,163,Meade,1995,9787,9280,507,5.2
21,165,Menifee,1995,2421,2164,257,10.6
21,167,Mercer,1995,10505,10120,385,3.7
21,169,Metcalfe,1995,4778,4515,263,5.5
21,171,Monroe,1995,5480,5248,232,4.2
21,173,Montgomery,1995,10543,9830,713,6.8
21,175,Morgan,1995,4559,4071,488,10.7
21,177,Muhlenberg,1995,12264,11208,1056,8.6
21,179,Nelson,1995,17378,16181,1197,6.9
21,181,Nicholas,1995,3351,3056,295,8.8
21,183,Ohio,1995,9180,8171,1009,11.0
21,185,Oldham,1995,21553,21065,488,2.3
21,187,Owen,1995,4559,4375,184,4.0
21,189,Owsley,1995,1569,1473,96,6.1
21,191,Pendleton,1995,6251,5955,296,4.7
21,193,Perry,1995,11682,10460,1222,10.5
21,195,Pike,1995,27839,25245,2594,9.3
21,197,Powell,1995,6696,6231,465,6.9
21,199,Pulaski,1995,24117,22806,1311,5.4
21,201,Robertson,1995,1006,946,60,6.0
21,203,Rockcastle,1995,6013,5604,409,6.8
21,205,Rowan,1995,9138,8583,555,6.1
21,207,Russell,1995,6584,5954,630,9.6
21,209,Scott,1995,14926,14512,414,2.8
21,211,Shelby,1995,15991,15515,476,3.0
21,213,Simpson,1995,8206,7800,406,4.9
21,215,Spencer,1995,4661,4485,176,3.8
21,217,Taylor,1995,11366,10857,509,4.5
21,219,Todd,1995,5451,5201,250,4.6
21,221,Trigg,1995,5773,5499,274,4.7
21,223,Trimble,1995,3121,2996,125,4.0
21,225,Union,1995,6652,6205,447,6.7
21,227,Warren,1995,46306,44288,2018,4.4
21,229,Washington,1995,5768,5548,220,3.8
21,231,Wayne,1995,7762,7246,516,6.6
21,233,Webster,1995,5667,5204,463,8.2
21,235,Whitley,1995,13633,12754,879,6.4
21,237,Wolfe,1995,3356,3098,258,7.7
21,239,Woodford,1995,12226,11957,269,2.2
22,1,Acadia Parish,1995,22160,20605,1555,7.0
22,3,Allen Parish,1995,8574,7802,772,9.0
22,5,Ascension Parish,1995,30131,28218,1913,6.3
22,7,Assumption Parish,1995,9159,8438,721,7.9
22,9,Avoyelles Parish,1995,16147,14796,1351,8.4
22,11,Beauregard Parish,1995,12608,11721,887,7.0
22,13,Bienville Parish,1995,6287,5713,574,9.1
22,15,Bossier Parish,1995,43056,40598,2458,5.7
22,17,Caddo Parish,1995,115449,108037,7412,6.4
22,19,Calcasieu Parish,1995,84835,79826,5009,5.9
22,21,Caldwell Parish,1995,4320,3960,360,8.3
22,23,Cameron Parish,1995,3686,3464,222,6.0
22,25,Catahoula Parish,1995,5244,4746,498,9.5
22,27,Claiborne Parish,1995,5835,5383,452,7.7
22,29,Concordia Parish,1995,8266,7377,889,10.8
22,31,De Soto Parish,1995,11326,10521,805,7.1
22,33,East Baton Rouge Parish,1995,200550,190418,10132,5.1
22,35,East Carroll Parish,1995,3348,2855,493,14.7
22,37,East Feliciana Parish,1995,7653,7128,525,6.9
22,39,Evangeline Parish,1995,11766,10914,852,7.2
22,41,Franklin Parish,1995,10983,10088,895,8.1
22,43,Grant Parish,1995,6728,6123,605,9.0
22,45,Iberia Parish,1995,29981,27994,1987,6.6
22,47,Iberville Parish,1995,12377,11159,1218,9.8
22,49,Jackson Parish,1995,6326,5960,366,5.8
22,51,Jefferson Parish,1995,236627,221041,15586,6.6
22,53,Jefferson Davis Parish,1995,11862,11048,814,6.9
22,55,Lafayette Parish,1995,89219,85136,4083,4.6
22,57,Lafourche Parish,1995,37683,35938,1745,4.6
22,59,LaSalle Parish,1995,5690,5320,370,6.5
22,61,Lincoln Parish,1995,18288,17750,538,2.9
22,63,Livingston Parish,1995,37485,34645,2840,7.6
22,65,Madison Parish,1995,5615,4921,694,12.4
22,67,Morehouse Parish,1995,12480,11352,1128,9.0
22,69,Natchitoches Parish,1995,16702,15482,1220,7.3
22,71,Orleans Parish,1995,207526,188841,18685,9.0
22,73,Ouachita Parish,1995,67119,63559,3560,5.3
22,75,Plaquemines Parish,1995,10527,9673,854,8.1
22,77,Pointe Coupee Parish,1995,9341,8467,874,9.4
22,79,Rapides Parish,1995,58044,54537,3507,6.0
22,81,Red River Parish,1995,3810,3441,369,9.7
22,83,Richland Parish,1995,8134,7324,810,10.0
22,85,Sabine Parish,1995,8915,8346,569,6.4
22,87,St. Bernard Parish,1995,32235,29287,2948,9.1
22,89,St. Charles Parish,1995,22076,20366,1710,7.7
22,91,St. Helena Parish,1995,4019,3722,297,7.4
22,93,St. James Parish,1995,8757,7914,843,9.6
22,95,St. John the Baptist Parish,1995,19457,17482,1975,10.2
22,97,St. Landry Parish,1995,30362,27812,2550,8.4
22,99,St. Martin Parish,1995,19737,18400,1337,6.8
22,101,St. Mary Parish,1995,24128,22073,2055,8.5
22,103,St. Tammany Parish,1995,82768,77432,5336,6.4
22,105,Tangipahoa Parish,1995,41671,38083,3588,8.6
22,107,Tensas Parish,1995,3144,2880,264,8.4
22,109,Terrebonne Parish,1995,42514,40306,2208,5.2
22,111,Union Parish,1995,11057,10504,553,5.0
22,113,Vermilion Parish,1995,22350,21056,1294,5.8
22,115,Vernon Parish,1995,16977,15856,1121,6.6
22,117,Washington Parish,1995,17009,15636,1373,8.1
22,119,Webster Parish,1995,18647,16746,1901,10.2
22,121,West Baton Rouge Parish,1995,9550,8891,659,6.9
22,123,West Carroll Parish,1995,5253,4413,840,16.0
22,125,West Feliciana Parish,1995,3621,3361,260,7.2
22,127,Winn Parish,1995,6543,6165,378,5.8
23,1,Androscoggin,1995,57071,53697,3374,5.9
23,3,Aroostook,1995,38666,34647,4019,10.4
23,5,Cumberland,1995,131401,126586,4815,3.7
23,7,Franklin,1995,15031,14018,1013,6.7
23,9,Hancock,1995,26519,24756,1763,6.6
23,11,Kennebec,1995,59890,55863,4027,6.7
23,13,Knox,1995,20298,19466,832,4.1
23,15,Lincoln,1995,16697,15907,790,4.7
23,17,Oxford,1995,25408,23540,1868,7.4
23,19,Penobscot,1995,74322,69681,4641,6.2
23,21,Piscataquis,1995,8490,7811,679,8.0
23,23,Sagadahoc,1995,15901,15234,667,4.2
23,25,Somerset,1995,25582,23237,2345,9.2
23,27,Waldo,1995,17776,16487,1289,7.3
23,29,Washington,1995,16454,14843,1611,9.8
23,31,York,1995,89617,85725,3892,4.3
24,1,Allegany,1995,32795,29778,3017,9.2
24,3,Anne Arundel,1995,245898,236179,9719,4.0
24,5,Baltimore,1995,388322,368061,20261,5.2
24,9,Calvert,1995,34235,32876,1359,4.0
24,11,Caroline,1995,15465,14639,826,5.3
24,13,Carroll,1995,76073,72972,3101,4.1
24,15,Cecil,1995,38580,35581,2999,7.8
24,17,Charles,1995,58860,56656,2204,3.7
24,19,Dorchester,1995,15799,14263,1536,9.7
24,21,Frederick,1995,96464,92596,3868,4.0
24,23,Garrett,1995,14032,12593,1439,10.3
24,25,Harford,1995,108688,102692,5996,5.5
24,27,Howard,1995,129541,125323,4218,3.3
24,29,Kent,1995,10289,9618,671,6.5
24,31,Montgomery,1995,462971,449692,13279,2.9
24,33,Prince George's,1995,444997,424087,20910,4.7
24,35,Queen Anne's,1995,19370,18508,862,4.5
24,37,St. Mary's,1995,41745,39700,2045,4.9
24,39,Somerset,1995,11295,10102,1193,10.6
24,41,Talbot,1995,17913,17289,624,3.5
24,43,Washington,1995,66505,62498,4007,6.0
24,45,Wicomico,1995,45839,43142,2697,5.9
24,47,Worcester,1995,24340,22044,2296,9.4
24,510,Baltimore city,1995,312744,286939,25805,8.3
25,1,Barnstable,1995,102398,95044,7354,7.2
25,3,Berkshire,1995,66054,61884,4170,6.3
25,5,Bristol,1995,265818,243907,21911,8.2
25,7,Dukes,1995,8706,8213,493,5.7
25,9,Essex,1995,352496,333090,19406,5.5
25,11,Franklin,1995,37407,35613,1794,4.8
25,13,Hampden,1995,211869,197779,14090,6.7
25,15,Hampshire,1995,79149,75852,3297,4.2
25,17,Middlesex,1995,786532,752002,34530,4.4
25,19,Nantucket/town,1995,5688,5538,150,2.6
25,21,Norfolk,1995,352728,337088,15640,4.4
25,23,Plymouth,1995,236542,222736,13806,5.8
25,25,Suffolk,1995,337230,318387,18843,5.6
25,27,Worcester,1995,360966,341571,19395,5.4
26,1,Alcona,1995,4876,4370,506,10.4
26,3,Alger,1995,4250,3871,379,8.9
26,5,Allegan,1995,51045,49109,1936,3.8
26,7,Alpena,1995,15351,13726,1625,10.6
26,9,Antrim,1995,9405,8614,791,8.4
26,11,Arenac,1995,6665,6014,651,9.8
26,13,Baraga,1995,3989,3580,409,10.3
26,15,Barry,1995,29461,28220,1241,4.2
26,17,Bay,1995,54461,51037,3424,6.3
26,19,Benzie,1995,7080,6431,649,9.2
26,21,Berrien,1995,82843,78294,4549,5.5
26,23,Branch,1995,19828,18898,930,4.7
26,25,Calhoun,1995,67063,63399,3664,5.5
26,27,Cass,1995,25808,24564,1244,4.8
26,29,Charlevoix,1995,12749,11669,1080,8.5
26,31,Cheboygan,1995,11949,10451,1498,12.5
26,33,Chippewa,1995,17478,15759,1719,9.8
26,35,Clare,1995,10354,9200,1154,11.1
26,37,Clinton,1995,32373,31241,1132,3.5
26,39,Crawford,1995,5572,5070,502,9.0
26,41,Delta,1995,18088,16318,1770,9.8
26,43,Dickinson,1995,13713,12756,957,7.0
26,45,Eaton,1995,53035,51249,1786,3.4
26,47,Emmet,1995,15983,14234,1749,10.9
26,49,Genesee,1995,205806,191734,14072,6.8
26,51,Gladwin,1995,8886,8074,812,9.1
26,53,Gogebic,1995,8402,7549,853,10.2
26,55,Grand Traverse,1995,41886,39471,2415,5.8
26,57,Gratiot,1995,18959,17586,1373,7.2
26,59,Hillsdale,1995,22016,20948,1068,4.9
26,61,Houghton,1995,16367,15084,1283,7.8
26,63,Huron,1995,17274,15819,1455,8.4
26,65,Ingham,1995,149604,143824,5780,3.9
26,67,Ionia,1995,26570,24919,1651,6.2
26,69,Iosco,1995,11154,10105,1049,9.4
26,71,Iron,1995,5520,4997,523,9.5
26,73,Isabella,1995,28368,26998,1370,4.8
26,75,Jackson,1995,74468,70446,4022,5.4
26,77,Kalamazoo,1995,123288,118979,4309,3.5
26,79,Kalkaska,1995,7183,6555,628,8.7
26,81,Kent,1995,297411,286134,11277,3.8
26,83,Keweenaw,1995,748,653,95,12.7
26,85,Lake,1995,3158,2741,417,13.2
26,87,Lapeer,1995,40529,38179,2350,5.8
26,89,Leelanau,1995,10293,9714,579,5.6
26,91,Lenawee,1995,45582,43225,2357,5.2
26,93,Livingston,1995,71415,68939,2476,3.5
26,95,Luce,1995,2597,2321,276,10.6
26,97,Mackinac,1995,7287,6409,878,12.0
26,99,Macomb,1995,413510,394376,19134,4.6
26,101,Manistee,1995,10235,9024,1211,11.8
26,103,Marquette,1995,32565,29934,2631,8.1
26,105,Mason,1995,14181,12760,1421,10.0
26,107,Mecosta,1995,17162,16231,931,5.4
26,109,Menominee,1995,13105,12232,873,6.7
26,111,Midland,1995,40816,38731,2085,5.1
26,113,Missaukee,1995,6197,5664,533,8.6
26,115,Monroe,1995,68498,64923,3575,5.2
26,117,Montcalm,1995,24776,22891,1885,7.6
26,119,Montmorency,1995,3472,2923,549,15.8
26,121,Muskegon,1995,78414,73315,5099,6.5
26,123,Newaygo,1995,20000,17986,2014,10.1
26,125,Oakland,1995,636689,613590,23099,3.6
26,127,Oceana,1995,13015,11513,1502,11.5
26,129,Ogemaw,1995,8340,7472,868,10.4
26,131,Ontonagon,1995,3878,3490,388,10.0
26,133,Osceola,1995,10613,9698,915,8.6
26,135,Oscoda,1995,3644,3283,361,9.9
26,137,Otsego,1995,12144,11377,767,6.3
26,139,Ottawa,1995,121057,117166,3891,3.2
26,141,Presque Isle,1995,6293,5267,1026,16.3
26,143,Roscommon,1995,8202,7341,861,10.5
26,145,Saginaw,1995,99041,93029,6012,6.1
26,147,St. Clair,1995,75353,70561,4792,6.4
26,149,St. Joseph,1995,32831,31418,1413,4.3
26,151,Sanilac,1995,20712,19023,1689,8.2
26,153,Schoolcraft,1995,4117,3545,572,13.9
26,155,Shiawassee,1995,34890,32319,2571,7.4
26,157,Tuscola,1995,27254,25127,2127,7.8
26,159,Van Buren,1995,35862,33475,2387,6.7
26,161,Washtenaw,1995,162141,157673,4468,2.8
26,163,Wayne,1995,939434,884091,55343,5.9
26,165,Wexford,1995,14159,12589,1570,11.1
27,1,Aitkin,1995,5793,5250,543,9.4
27,3,Anoka,1995,167900,162773,5127,3.1
27,5,Becker,1995,13112,12118,994,7.6
27,7,Beltrami,1995,18809,17583,1226,6.5
27,9,Benton,1995,19520,18666,854,4.4
27,11,Big Stone,1995,2817,2680,137,4.9
27,13,Blue Earth,1995,32860,31804,1056,3.2
27,15,Brown,1995,15089,14527,562,3.7
27,17,Carlton,1995,15273,14227,1046,6.8
27,19,Carver,1995,35538,34692,846,2.4
27,21,Cass,1995,11267,10345,922,8.2
27,23,Chippewa,1995,6765,6413,352,5.2
27,25,Chisago,1995,19162,18302,860,4.5
27,27,Clay,1995,29422,28336,1086,3.7
27,29,Clearwater,1995,3977,3376,601,15.1
27,31,Cook,1995,2991,2821,170,5.7
27,33,Cottonwood,1995,6225,5792,433,7.0
27,35,Crow Wing,1995,25815,24208,1607,6.2
27,37,Dakota,1995,195761,190884,4877,2.5
27,39,Dodge,1995,9111,8622,489,5.4
27,41,Douglas,1995,16156,15456,700,4.3
27,43,Faribault,1995,8333,7902,431,5.2
27,45,Fillmore,1995,10202,9730,472,4.6
27,47,Freeborn,1995,16392,15632,760,4.6
27,49,Goodhue,1995,23756,22872,884,3.7
27,51,Grant,1995,3038,2891,147,4.8
27,53,Hennepin,1995,648646,630424,18222,2.8
27,55,Houston,1995,10944,10559,385,3.5
27,57,Hubbard,1995,7795,7265,530,6.8
27,59,Isanti,1995,14791,14124,667,4.5
27,61,Itasca,1995,20055,18159,1896,9.5
27,63,Jackson,1995,5991,5707,284,4.7
27,65,Kanabec,1995,7473,6881,592,7.9
27,67,Kandiyohi,1995,21026,20290,736,3.5
27,69,Kittson,1995,2474,2316,158,6.4
27,71,Koochiching,1995,6377,5839,538,8.4
27,73,Lac qui Parle,1995,4007,3867,140,3.5
27,75,Lake,1995,5610,5319,291,5.2
27,77,Lake of the Woods,1995,2446,2346,100,4.1
27,79,Le Sueur,1995,13764,13156,608,4.4
27,81,Lincoln,1995,3125,2966,159,5.1
27,83,Lyon,1995,15012,14501,511,3.4
27,85,McLeod,1995,20265,19554,711,3.5
27,87,Mahnomen,1995,2510,2334,176,7.0
27,89,Marshall,1995,4783,4313,470,9.8
27,91,Martin,1995,11728,11207,521,4.4
27,93,Meeker,1995,9457,8880,577,6.1
27,95,Mille Lacs,1995,9033,8310,723,8.0
27,97,Morrison,1995,15043,13908,1135,7.5
27,99,Mower,1995,18740,18149,591,3.2
27,101,Murray,1995,4447,4198,249,5.6
27,103,Nicollet,1995,18197,17673,524,2.9
27,105,Nobles,1995,10209,9807,402,3.9
27,107,Norman,1995,3693,3495,198,5.4
27,109,Olmsted,1995,64945,63068,1877,2.9
27,111,Otter Tail,1995,26835,25368,1467,5.5
27,113,Pennington,1995,7720,7252,468,6.1
27,115,Pine,1995,11344,10440,904,8.0
27,117,Pipestone,1995,5087,4915,172,3.4
27,119,Polk,1995,17101,16244,857,5.0
27,121,Pope,1995,5348,5128,220,4.1
27,123,Ramsey,1995,279730,271589,8141,2.9
27,125,Red Lake,1995,2025,1816,209,10.3
27,127,Redwood,1995,8937,8667,270,3.0
27,129,Renville,1995,8357,7944,413,4.9
27,131,Rice,1995,28446,27298,1148,4.0
27,133,Rock,1995,5081,4957,124,2.4
27,135,Roseau,1995,8948,8619,329,3.7
27,137,St. Louis,1995,101813,96082,5731,5.6
27,139,Scott,1995,41496,40247,1249,3.0
27,141,Sherburne,1995,28905,27774,1131,3.9
27,143,Sibley,1995,6913,6554,359,5.2
27,145,Stearns,1995,74184,71161,3023,4.1
27,147,Steele,1995,18371,17671,700,3.8
27,149,Stevens,1995,5405,5221,184,3.4
27,151,Swift,1995,5350,5105,245,4.6
27,153,Todd,1995,10342,9628,714,6.9
27,155,Traverse,1995,1865,1776,89,4.8
27,157,Wabasha,1995,12000,11511,489,4.1
27,159,Wadena,1995,6315,5981,334,5.3
27,161,Waseca,1995,9528,9190,338,3.5
27,163,Washington,1995,104650,101928,2722,2.6
27,165,Watonwan,1995,5837,5590,247,4.2
27,167,Wilkin,1995,3880,3725,155,4.0
27,169,Winona,1995,28336,27303,1033,3.6
27,171,Wright,1995,43700,41968,1732,4.0
27,173,Yellow Medicine,1995,5461,5188,273,5.0
28,1,Adams,1995,14652,13573,1079,7.4
28,3,Alcorn,1995,15519,14181,1338,8.6
28,5,Amite,1995,5239,4963,276,5.3
28,7,Attala,1995,7954,7352,602,7.6
28,9,Benton,1995,3208,2882,326,10.2
28,11,Bolivar,1995,17915,16345,1570,8.8
28,13,Calhoun,1995,7102,6794,308,4.3
28,15,Carroll,1995,4417,4173,244,5.5
28,17,Chickasaw,1995,8460,7527,933,11.0
28,19,Choctaw,1995,3541,3207,334,9.4
28,21,Claiborne,1995,3799,3421,378,9.9
28,23,Clarke,1995,8472,8018,454,5.4
28,25,Clay,1995,8944,8032,912,10.2
28,27,Coahoma,1995,12774,11444,1330,10.4
28,29,Copiah,1995,11463,10629,834,7.3
28,31,Covington,1995,8802,8356,446,5.1
28,33,DeSoto,1995,44717,42841,1876,4.2
28,35,Forrest,1995,33120,31644,1476,4.5
28,37,Franklin,1995,3227,3016,211,6.5
28,39,George,1995,8129,7335,794,9.8
28,41,Greene,1995,4725,4305,420,8.9
28,43,Grenada,1995,10122,9410,712,7.0
28,45,Hancock,1995,15992,14921,1071,6.7
28,47,Harrison,1995,81462,76198,5264,6.5
28,49,Hinds,1995,127535,121894,5641,4.4
28,51,Holmes,1995,7421,6506,915,12.3
28,53,Humphreys,1995,4974,4386,588,11.8
28,55,Issaquena,1995,776,651,125,16.1
28,57,Itawamba,1995,11281,10720,561,5.0
28,59,Jackson,1995,64554,60778,3776,5.8
28,61,Jasper,1995,7622,7134,488,6.4
28,63,Jefferson,1995,2493,2107,386,15.5
28,65,Jefferson Davis,1995,5254,4573,681,13.0
28,67,Jones,1995,29813,28605,1208,4.1
28,69,Kemper,1995,4330,3981,349,8.1
28,71,Lafayette,1995,16090,15675,415,2.6
28,73,Lamar,1995,15953,15432,521,3.3
28,75,Lauderdale,1995,35608,33662,1946,5.5
28,77,Lawrence,1995,5283,4888,395,7.5
28,79,Leake,1995,8812,8306,506,5.7
28,81,Lee,1995,39348,37719,1629,4.1
28,83,Leflore,1995,15815,14307,1508,9.5
28,85,Lincoln,1995,13407,12607,800,6.0
28,87,Lowndes,1995,27677,26152,1525,5.5
28,89,Madison,1995,32946,31747,1199,3.6
28,91,Marion,1995,9796,9064,732,7.5
28,93,Marshall,1995,13837,12458,1379,10.0
28,95,Monroe,1995,17072,15480,1592,9.3
28,97,Montgomery,1995,5482,5112,370,6.7
28,99,Neshoba,1995,15262,14665,597,3.9
28,101,Newton,1995,8628,7932,696,8.1
28,103,Noxubee,1995,4573,4156,417,9.1
28,105,Oktibbeha,1995,19026,18452,574,3.0
28,107,Panola,1995,13480,12320,1160,8.6
28,109,Pearl River,1995,18800,17720,1080,5.7
28,111,Perry,1995,4945,4562,383,7.7
28,113,Pike,1995,15709,14743,966,6.1
28,115,Pontotoc,1995,13115,12422,693,5.3
28,117,Prentiss,1995,12228,11396,832,6.8
28,119,Quitman,1995,3712,3229,483,13.0
28,121,Rankin,1995,53500,51906,1594,3.0
28,123,Scott,1995,13128,12485,643,4.9
28,125,Sharkey,1995,3101,2530,571,18.4
28,127,Simpson,1995,10596,10031,565,5.3
28,129,Smith,1995,6140,5885,255,4.2
28,131,Stone,1995,4986,4649,337,6.8
28,133,Sunflower,1995,11651,10343,1308,11.2
28,135,Tallahatchie,1995,5570,4920,650,11.7
28,137,Tate,1995,10666,9989,677,6.3
28,139,Tippah,1995,9590,9013,577,6.0
28,141,Tishomingo,1995,9959,9266,693,7.0
28,143,Tunica,1995,5019,4371,648,12.9
28,145,Union,1995,12199,11536,663,5.4
28,147,Walthall,1995,5810,5467,343,5.9
28,149,Warren,1995,27310,25663,1647,6.0
28,151,Washington,1995,29258,26301,2957,10.1
28,153,Wayne,1995,9095,8442,653,7.2
28,155,Webster,1995,4442,4056,386,8.7
28,157,Wilkinson,1995,3588,3193,395,11.0
28,159,Winston,1995,7679,7183,496,6.5
28,161,Yalobusha,1995,5331,4953,378,7.1
28,163,Yazoo,1995,9574,8677,897,9.4
29,1,Adair,1995,14696,14265,431,2.9
29,3,Andrew,1995,8077,7611,466,5.8
29,5,Atchison,1995,3239,3149,90,2.8
29,7,Audrain,1995,12478,11946,532,4.3
29,9,Barry,1995,15064,14311,753,5.0
29,11,Barton,1995,6845,6626,219,3.2
29,13,Bates,1995,7467,7048,419,5.6
29,15,Benton,1995,6091,5602,489,8.0
29,17,Bollinger,1995,5053,4725,328,6.5
29,19,Boone,1995,76734,75311,1423,1.9
29,21,Buchanan,1995,42277,39141,3136,7.4
29,23,Butler,1995,19388,18126,1262,6.5
29,25,Caldwell,1995,3741,3545,196,5.2
29,27,Callaway,1995,19480,18790,690,3.5
29,29,Camden,1995,16000,14900,1100,6.9
29,31,Cape Girardeau,1995,35420,34153,1267,3.6
29,33,Carroll,1995,5548,5249,299,5.4
29,35,Carter,1995,2614,2394,220,8.4
29,37,Cass,1995,40733,39149,1584,3.9
29,39,Cedar,1995,5495,5203,292,5.3
29,41,Chariton,1995,4124,3853,271,6.6
29,43,Christian,1995,24170,23243,927,3.8
29,45,Clark,1995,3642,3466,176,4.8
29,47,Clay,1995,99529,96270,3259,3.3
29,49,Clinton,1995,9068,8675,393,4.3
29,51,Cole,1995,37829,36890,939,2.5
29,53,Cooper,1995,8426,8082,344,4.1
29,55,Crawford,1995,10415,9699,716,6.9
29,57,Dade,1995,3240,3090,150,4.6
29,59,Dallas,1995,6327,5901,426,6.7
29,61,Daviess,1995,3638,3446,192,5.3
29,63,DeKalb,1995,4101,3897,204,5.0
29,65,Dent,1995,6399,5983,416,6.5
29,67,Douglas,1995,5898,5334,564,9.6
29,69,Dunklin,1995,14039,12950,1089,7.8
29,71,Franklin,1995,46041,43557,2484,5.4
29,73,Gasconade,1995,7462,7096,366,4.9
29,75,Gentry,1995,3621,3504,117,3.2
29,77,Greene,1995,126667,122578,4089,3.2
29,79,Grundy,1995,5290,5033,257,4.9
29,81,Harrison,1995,4529,4332,197,4.3
29,83,Henry,1995,9922,9215,707,7.1
29,85,Hickory,1995,2868,2665,203,7.1
29,87,Holt,1995,2793,2660,133,4.8
29,89,Howard,1995,4910,4677,233,4.7
29,91,Howell,1995,17223,16057,1166,6.8
29,93,Iron,1995,4412,3979,433,9.8
29,95,Jackson,1995,359011,341438,17573,4.9
29,97,Jasper,1995,51641,49437,2204,4.3
29,99,Jefferson,1995,100169,95265,4904,4.9
29,101,Johnson,1995,22213,21582,631,2.8
29,103,Knox,1995,1886,1794,92,4.9
29,105,Laclede,1995,14896,13792,1104,7.4
29,107,Lafayette,1995,16252,15506,746,4.6
29,109,Lawrence,1995,15710,14970,740,4.7
29,111,Lewis,1995,5403,5184,219,4.1
29,113,Lincoln,1995,16805,15894,911,5.4
29,115,Linn,1995,7147,6516,631,8.8
29,117,Livingston,1995,7281,6977,304,4.2
29,119,McDonald,1995,8087,7695,392,4.8
29,121,Macon,1995,7833,7284,549,7.0
29,123,Madison,1995,4641,4227,414,8.9
29,125,Maries,1995,4140,3961,179,4.3
29,127,Marion,1995,15341,14607,734,4.8
29,129,Mercer,1995,2220,2129,91,4.1
29,131,Miller,1995,11375,10590,785,6.9
29,133,Mississippi,1995,6167,5578,589,9.6
29,135,Moniteau,1995,6999,6707,292,4.2
29,137,Monroe,1995,4243,3995,248,5.8
29,139,Montgomery,1995,6005,5714,291,4.8
29,141,Morgan,1995,8152,7632,520,6.4
29,143,New Madrid,1995,8794,8118,676,7.7
29,145,Newton,1995,25785,24443,1342,5.2
29,147,Nodaway,1995,12146,11964,182,1.5
29,149,Oregon,1995,4434,4152,282,6.4
29,151,Osage,1995,7013,6810,203,2.9
29,153,Ozark,1995,4084,3828,256,6.3
29,155,Pemiscot,1995,8460,7416,1044,12.3
29,157,Perry,1995,10210,9773,437,4.3
29,159,Pettis,1995,20477,19387,1090,5.3
29,161,Phelps,1995,18401,17678,723,3.9
29,163,Pike,1995,7240,6650,590,8.1
29,165,Platte,1995,40991,39810,1181,2.9
29,167,Polk,1995,11311,10786,525,4.6
29,169,Pulaski,1995,12279,11392,887,7.2
29,171,Putnam,1995,2256,2175,81,3.6
29,173,Ralls,1995,5112,4860,252,4.9
29,175,Randolph,1995,10605,9923,682,6.4
29,177,Ray,1995,10786,10287,499,4.6
29,179,Reynolds,1995,3276,3091,185,5.6
29,181,Ripley,1995,5288,4776,512,9.7
29,183,St. Charles,1995,144455,139657,4798,3.3
29,185,St. Clair,1995,3953,3687,266,6.7
29,186,Ste. Genevieve,1995,9080,8618,462,5.1
29,187,St. Francois,1995,22928,21153,1775,7.7
29,189,St. Louis,1995,567588,546836,20752,3.7
29,195,Saline,1995,12221,11704,517,4.2
29,197,Schuyler,1995,2490,2373,117,4.7
29,199,Scotland,1995,2262,2157,105,4.6
29,201,Scott,1995,19851,18657,1194,6.0
29,203,Shannon,1995,3956,3674,282,7.1
29,205,Shelby,1995,3594,3433,161,4.5
29,207,Stoddard,1995,13973,12752,1221,8.7
29,209,Stone,1995,13723,12201,1522,11.1
29,211,Sullivan,1995,3372,3220,152,4.5
29,213,Taney,1995,26876,24510,2366,8.8
29,215,Texas,1995,9604,8684,920,9.6
29,217,Vernon,1995,9021,8621,400,4.4
29,219,Warren,1995,11535,11009,526,4.6
29,221,Washington,1995,8914,8020,894,10.0
29,223,Wayne,1995,3839,3144,695,18.1
29,225,Webster,1995,13306,12719,587,4.4
29,227,Worth,1995,961,909,52,5.4
29,229,Wright,1995,7758,6790,968,12.5
29,510,St. Louis city,1995,169030,155892,13138,7.8
30,1,Beaverhead,1995,4981,4776,205,4.1
30,3,Big Horn,1995,4965,4352,613,12.3
30,5,Blaine,1995,2861,2591,270,9.4
30,7,Broadwater,1995,1891,1789,102,5.4
30,9,Carbon,1995,4307,4056,251,5.8
30,11,Carter,1995,890,874,16,1.8
30,13,Cascade,1995,37328,35362,1966,5.3
30,15,Chouteau,1995,2663,2575,88,3.3
30,17,Custer,1995,6000,5732,268,4.5
30,19,Daniels,1995,1222,1189,33,2.7
30,21,Dawson,1995,4815,4639,176,3.7
30,23,Deer Lodge,1995,3933,3583,350,8.9
30,25,Fallon,1995,1552,1501,51,3.3
30,27,Fergus,1995,5959,5602,357,6.0
30,29,Flathead,1995,36260,33405,2855,7.9
30,31,Gallatin,1995,36588,35638,950,2.6
30,33,Garfield,1995,894,866,28,3.1
30,35,Glacier,1995,5658,4848,810,14.3
30,37,Golden Valley,1995,489,453,36,7.4
30,39,Granite,1995,1111,1029,82,7.4
30,41,Hill,1995,9064,8531,533,5.9
30,43,Jefferson,1995,4678,4467,211,4.5
30,45,Judith Basin,1995,1069,1022,47,4.4
30,47,Lake,1995,10416,9608,808,7.8
30,49,Lewis and Clark,1995,27889,26495,1394,5.0
30,51,Liberty,1995,1110,1083,27,2.4
30,53,Lincoln,1995,7471,6389,1082,14.5
30,55,McCone,1995,1177,1142,35,3.0
30,57,Madison,1995,3534,3362,172,4.9
30,59,Meagher,1995,955,899,56,5.9
30,61,Mineral,1995,1710,1498,212,12.4
30,63,Missoula,1995,48598,46168,2430,5.0
30,65,Musselshell,1995,1956,1792,164,8.4
30,67,Park,1995,10166,9709,457,4.5
30,69,Petroleum,1995,303,290,13,4.3
30,71,Phillips,1995,2475,2327,148,6.0
30,73,Pondera,1995,3045,2916,129,4.2
30,75,Powder River,1995,1163,1136,27,2.3
30,77,Powell,1995,2385,2202,183,7.7
30,79,Prairie,1995,657,628,29,4.4
30,81,Ravalli,1995,15301,14369,932,6.1
30,83,Richland,1995,5466,5161,305,5.6
30,85,Roosevelt,1995,4161,3734,427,10.3
30,87,Rosebud,1995,4752,4328,424,8.9
30,89,Sanders,1995,4138,3568,570,13.8
30,91,Sheridan,1995,2096,2037,59,2.8
30,93,Silver Bow,1995,16952,16001,951,5.6
30,95,Stillwater,1995,3763,3583,180,4.8
30,97,Sweet Grass,1995,1686,1626,60,3.6
30,99,Teton,1995,3036,2936,100,3.3
30,101,Toole,1995,2816,2669,147,5.2
30,103,Treasure,1995,433,418,15,3.5
30,105,Valley,1995,4261,4078,183,4.3
30,107,Wheatland,1995,1304,1240,64,4.9
30,109,Wibaux,1995,571,546,25,4.4
30,111,Yellowstone,1995,67699,64547,3152,4.7
31,1,Adams,1995,15873,15641,232,1.5
31,3,Antelope,1995,3311,3188,123,3.7
31,5,Arthur,1995,211,203,8,3.8
31,7,Banner,1995,421,407,14,3.3
31,9,Blaine,1995,367,355,12,3.3
31,11,Boone,1995,2933,2876,57,1.9
31,13,Box Butte,1995,6327,6046,281,4.4
31,15,Boyd,1995,1232,1203,29,2.4
31,17,Brown,1995,1886,1812,74,3.9
31,19,Buffalo,1995,23790,23183,607,2.6
31,21,Burt,1995,3614,3475,139,3.8
31,23,Butler,1995,4373,4263,110,2.5
31,25,Cass,1995,11874,11539,335,2.8
31,27,Cedar,1995,5202,5091,111,2.1
31,29,Chase,1995,2012,1970,42,2.1
31,31,Cherry,1995,3491,3416,75,2.1
31,33,Cheyenne,1995,5165,5053,112,2.2
31,35,Clay,1995,3514,3444,70,2.0
31,37,Colfax,1995,4818,4723,95,2.0
31,39,Cuming,1995,5421,5306,115,2.1
31,41,Custer,1995,5782,5650,132,2.3
31,43,Dakota,1995,10035,9775,260,2.6
31,45,Dawes,1995,4545,4386,159,3.5
31,47,Dawson,1995,13500,13063,437,3.2
31,49,Deuel,1995,1022,988,34,3.3
31,51,Dixon,1995,2852,2788,64,2.2
31,53,Dodge,1995,18893,18353,540,2.9
31,55,Douglas,1995,246822,239920,6902,2.8
31,57,Dundy,1995,1219,1186,33,2.7
31,59,Fillmore,1995,3354,3287,67,2.0
31,61,Franklin,1995,1749,1719,30,1.7
31,63,Frontier,1995,1638,1593,45,2.7
31,65,Furnas,1995,2677,2615,62,2.3
31,67,Gage,1995,11951,11681,270,2.3
31,69,Garden,1995,1110,1064,46,4.1
31,71,Garfield,1995,1073,1045,28,2.6
31,73,Gosper,1995,1336,1304,32,2.4
31,75,Grant,1995,388,381,7,1.8
31,77,Greeley,1995,1561,1512,49,3.1
31,79,Hall,1995,30675,30021,654,2.1
31,81,Hamilton,1995,5245,5170,75,1.4
31,83,Harlan,1995,1825,1792,33,1.8
31,85,Hayes,1995,534,515,19,3.6
31,87,Hitchcock,1995,1657,1610,47,2.8
31,89,Holt,1995,6575,6401,174,2.6
31,91,Hooker,1995,438,423,15,3.4
31,93,Howard,1995,3428,3348,80,2.3
31,95,Jefferson,1995,4242,4144,98,2.3
31,97,Johnson,1995,2334,2263,71,3.0
31,99,Kearney,1995,3516,3454,62,1.8
31,101,Keith,1995,4547,4420,127,2.8
31,103,Keya Paha,1995,516,492,24,4.7
31,105,Kimball,1995,2144,2091,53,2.5
31,107,Knox,1995,4674,4499,175,3.7
31,109,Lancaster,1995,136879,133836,3043,2.2
31,111,Lincoln,1995,18299,17545,754,4.1
31,113,Logan,1995,454,443,11,2.4
31,115,Loup,1995,474,464,10,2.1
31,117,McPherson,1995,323,317,6,1.9
31,119,Madison,1995,20015,19519,496,2.5
31,121,Merrick,1995,4638,4554,84,1.8
31,123,Morrill,1995,2783,2658,125,4.5
31,125,Nance,1995,1946,1896,50,2.6
31,127,Nemaha,1995,4004,3859,145,3.6
31,129,Nuckolls,1995,2467,2403,64,2.6
31,131,Otoe,1995,7737,7499,238,3.1
31,133,Pawnee,1995,1498,1445,53,3.5
31,135,Perkins,1995,1523,1485,38,2.5
31,137,Phelps,1995,5394,5299,95,1.8
31,139,Pierce,1995,4043,3950,93,2.3
31,141,Platte,1995,17677,17254,423,2.4
31,143,Polk,1995,2620,2568,52,2.0
31,145,Red Willow,1995,6143,5977,166,2.7
31,147,Richardson,1995,4724,4539,185,3.9
31,149,Rock,1995,966,932,34,3.5
31,151,Saline,1995,7190,7080,110,1.5
31,153,Sarpy,1995,55820,54578,1242,2.2
31,155,Saunders,1995,10713,10407,306,2.9
31,157,Scotts Bluff,1995,18311,17464,847,4.6
31,159,Seward,1995,9514,9304,210,2.2
31,161,Sheridan,1995,3065,2988,77,2.5
31,163,Sherman,1995,1658,1608,50,3.0
31,165,Sioux,1995,827,811,16,1.9
31,167,Stanton,1995,3380,3300,80,2.4
31,169,Thayer,1995,3328,3260,68,2.0
31,171,Thomas,1995,471,445,26,5.5
31,173,Thurston,1995,2870,2682,188,6.6
31,175,Valley,1995,2769,2712,57,2.1
31,177,Washington,1995,10186,9975,211,2.1
31,179,Wayne,1995,5946,5773,173,2.9
31,181,Webster,1995,1849,1816,33,1.8
31,183,Wheeler,1995,439,424,15,3.4
31,185,York,1995,8785,8661,124,1.4
32,1,Churchill,1995,8983,8342,641,7.1
32,3,Clark,1995,555425,524361,31064,5.6
32,5,Douglas,1995,17813,16720,1093,6.1
32,7,Elko,1995,21029,19759,1270,6.0
32,9,Esmeralda,1995,618,569,49,7.9
32,11,Eureka,1995,792,721,71,9.0
32,13,Humboldt,1995,8491,8110,381,4.5
32,15,Lander,1995,3073,2783,290,9.4
32,17,Lincoln,1995,1312,1151,161,12.3
32,19,Lyon,1995,11576,10615,961,8.3
32,21,Mineral,1995,2881,2660,221,7.7
32,23,Nye,1995,12575,12002,573,4.6
32,27,Pershing,1995,2182,2062,120,5.5
32,29,Storey,1995,1548,1487,61,3.9
32,31,Washoe,1995,173006,164512,8494,4.9
32,33,White Pine,1995,4317,4032,285,6.6
32,510,Carson City,1995,22833,21236,1597,7.0
33,1,Belknap,1995,27680,26693,987,3.6
33,3,Carroll,1995,19901,19195,706,3.5
33,5,Cheshire,1995,39067,37775,1292,3.3
33,7,Coos,1995,16824,15788,1036,6.2
33,9,Grafton,1995,42262,41005,1257,3.0
33,11,Hillsborough,1995,191991,184245,7746,4.0
33,13,Merrimack,1995,71267,69361,1906,2.7
33,15,Rockingham,1995,145618,139054,6564,4.5
33,17,Strafford,1995,56939,54832,2107,3.7
33,19,Sullivan,1995,20816,20238,578,2.8
34,1,Atlantic,1995,125347,114603,10744,8.6
34,3,Bergen,1995,436566,411287,25279,5.8
34,5,Burlington,1995,212656,202033,10623,5.0
34,7,Camden,1995,254852,238448,16404,6.4
34,9,Cape May,1995,46254,40651,5603,12.1
34,11,Cumberland,1995,65153,58755,6398,9.8
34,13,Essex,1995,374736,345896,28840,7.7
34,15,Gloucester,1995,125893,117645,8248,6.6
34,17,Hudson,1995,287768,260876,26892,9.3
34,19,Hunterdon,1995,63782,61748,2034,3.2
34,21,Mercer,1995,170702,161430,9272,5.4
34,23,Middlesex,1995,388431,367010,21421,5.5
34,25,Monmouth,1995,302206,285779,16427,5.4
34,27,Morris,1995,251038,240168,10870,4.3
34,29,Ocean,1995,204316,191627,12689,6.2
34,31,Passaic,1995,232788,212736,20052,8.6
34,33,Salem,1995,31503,29445,2058,6.5
34,35,Somerset,1995,153709,147893,5816,3.8
34,37,Sussex,1995,74326,70050,4276,5.8
34,39,Union,1995,263508,246238,17270,6.6
34,41,Warren,1995,49757,46909,2848,5.7
35,1,Bernalillo,1995,281239,269265,11974,4.3
35,3,Catron,1995,1195,1052,143,12.0
35,5,Chaves,1995,25537,23360,2177,8.5
35,6,Cibola,1995,10365,9288,1077,10.4
35,7,Colfax,1995,6450,5930,520,8.1
35,9,Curry,1995,19564,18485,1079,5.5
35,11,De Baca,1995,889,860,29,3.3
35,13,Dona Ana,1995,64412,58588,5824,9.0
35,15,Eddy,1995,22886,21013,1873,8.2
35,17,Grant,1995,12193,11264,929,7.6
35,19,Guadalupe,1995,1895,1675,220,11.6
35,21,Harding,1995,444,419,25,5.6
35,23,Hidalgo,1995,2701,2557,144,5.3
35,25,Lea,1995,24086,22705,1381,5.7
35,27,Lincoln,1995,6914,6277,637,9.2
35,28,Los Alamos,1995,10811,10582,229,2.1
35,29,Luna,1995,10668,8021,2647,24.8
35,31,McKinley,1995,24992,22797,2195,8.8
35,33,Mora,1995,1732,1358,374,21.6
35,35,Otero,1995,20607,19158,1449,7.0
35,37,Quay,1995,4646,4363,283,6.1
35,39,Rio Arriba,1995,17561,15353,2208,12.6
35,41,Roosevelt,1995,7477,7056,421,5.6
35,43,Sandoval,1995,38060,36354,1706,4.5
35,45,San Juan,1995,47689,42612,5077,10.6
35,47,San Miguel,1995,12426,11338,1088,8.8
35,49,Santa Fe,1995,63396,60535,2861,4.5
35,51,Sierra,1995,3700,3525,175,4.7
35,53,Socorro,1995,6545,5997,548,8.4
35,55,Taos,1995,13024,10974,2050,15.7
35,57,Torrance,1995,5232,4855,377,7.2
35,59,Union,1995,1911,1828,83,4.3
35,61,Valencia,1995,25493,24292,1201,4.7
36,1,Albany,1995,158219,151651,6568,4.2
36,3,Allegany,1995,23093,21319,1774,7.7
36,5,Bronx,1995,447781,404624,43157,9.6
36,7,Broome,1995,98481,93263,5218,5.3
36,9,Cattaraugus,1995,39578,36586,2992,7.6
36,11,Cayuga,1995,37698,35349,2349,6.2
36,13,Chautauqua,1995,67352,63399,3953,5.9
36,15,Chemung,1995,43017,40956,2061,4.8
36,17,Chenango,1995,24583,22786,1797,7.3
36,19,Clinton,1995,40267,37549,2718,6.7
36,21,Columbia,1995,32784,31414,1370,4.2
36,23,Cortland,1995,23890,22238,1652,6.9
36,25,Delaware,1995,21043,19893,1150,5.5
36,27,Dutchess,1995,116073,110299,5774,5.0
36,29,Erie,1995,466397,442138,24259,5.2
36,31,Essex,1995,18044,16425,1619,9.0
36,33,Franklin,1995,21415,19650,1765,8.2
36,35,Fulton,1995,27442,25243,2199,8.0
36,37,Genesee,1995,31892,30040,1852,5.8
36,39,Greene,1995,21082,19515,1567,7.4
36,41,Hamilton,1995,2507,2222,285,11.4
36,43,Herkimer,1995,31303,29104,2199,7.0
36,45,Jefferson,1995,43884,39944,3940,9.0
36,47,Kings,1995,935258,848833,86425,9.2
36,49,Lewis,1995,12575,11532,1043,8.3
36,51,Livingston,1995,34029,32189,1840,5.4
36,53,Madison,1995,35037,33004,2033,5.8
36,55,Monroe,1995,381270,366266,15004,3.9
36,57,Montgomery,1995,24126,22170,1956,8.1
36,59,Nassau,1995,675855,645363,30492,4.5
36,61,New York,1995,782249,727654,54595,7.0
36,63,Niagara,1995,108339,101844,6495,6.0
36,65,Oneida,1995,113300,107515,5785,5.1
36,67,Onondaga,1995,235000,224281,10719,4.6
36,69,Ontario,1995,52809,50184,2625,5.0
36,71,Orange,1995,153099,145583,7516,4.9
36,73,Orleans,1995,21250,19610,1640,7.7
36,75,Oswego,1995,57329,52451,4878,8.5
36,77,Otsego,1995,30868,29190,1678,5.4
36,79,Putnam,1995,49051,47137,1914,3.9
36,81,Queens,1995,947926,875345,72581,7.7
36,83,Rensselaer,1995,80678,76326,4352,5.4
36,85,Richmond,1995,184854,171001,13853,7.5
36,87,Rockland,1995,140642,133768,6874,4.9
36,89,St. Lawrence,1995,50796,46532,4264,8.4
36,91,Saratoga,1995,101301,96549,4752,4.7
36,93,Schenectady,1995,73902,70033,3869,5.2
36,95,Schoharie,1995,15265,14327,938,6.1
36,97,Schuyler,1995,8777,8248,529,6.0
36,99,Seneca,1995,14936,14043,893,6.0
36,101,Steuben,1995,47950,44733,3217,6.7
36,103,Suffolk,1995,692933,655694,37239,5.4
36,105,Sullivan,1995,32253,30218,2035,6.3
36,107,Tioga,1995,25784,24331,1453,5.6
36,109,Tompkins,1995,49085,47366,1719,3.5
36,111,Ulster,1995,78456,74192,4264,5.4
36,113,Warren,1995,32848,30523,2325,7.1
36,115,Washington,1995,29827,28065,1762,5.9
36,117,Wayne,1995,48624,45911,2713,5.6
36,119,Westchester,1995,438050,418738,19312,4.4
36,121,Wyoming,1995,21290,19852,1438,6.8
36,123,Yates,1995,12949,12342,607,4.7
37,1,Alamance,1995,64353,61969,2384,3.7
37,3,Alexander,1995,17065,16465,600,3.5
37,5,Alleghany,1995,5307,4985,322,6.1
37,7,Anson,1995,11520,10447,1073,9.3
37,9,Ashe,1995,11817,10875,942,8.0
37,11,Avery,1995,7505,7043,462,6.2
37,13,Beaufort,1995,19975,18309,1666,8.3
37,15,Bertie,1995,9408,8761,647,6.9
37,17,Bladen,1995,17751,16543,1208,6.8
37,19,Brunswick,1995,29353,26796,2557,8.7
37,21,Buncombe,1995,99078,95424,3654,3.7
37,23,Burke,1995,44091,42029,2062,4.7
37,25,Cabarrus,1995,60658,58550,2108,3.5
37,27,Caldwell,1995,41412,39823,1589,3.8
37,29,Camden,1995,3033,2899,134,4.4
37,31,Carteret,1995,28241,26621,1620,5.7
37,33,Caswell,1995,11750,11320,430,3.7
37,35,Catawba,1995,75033,71823,3210,4.3
37,37,Chatham,1995,24045,23388,657,2.7
37,39,Cherokee,1995,9819,9197,622,6.3
37,41,Chowan,1995,6742,6317,425,6.3
37,43,Clay,1995,3555,3377,178,5.0
37,45,Cleveland,1995,46759,44296,2463,5.3
37,47,Columbus,1995,25758,24000,1758,6.8
37,49,Craven,1995,35092,33233,1859,5.3
37,51,Cumberland,1995,112773,106687,6086,5.4
37,53,Currituck,1995,7942,7664,278,3.5
37,55,Dare,1995,15955,15017,938,5.9
37,57,Davidson,1995,76407,73941,2466,3.2
37,59,Davie,1995,16381,15780,601,3.7
37,61,Duplin,1995,22403,21157,1246,5.6
37,63,Durham,1995,108341,105093,3248,3.0
37,65,Edgecombe,1995,27460,25212,2248,8.2
37,67,Forsyth,1995,151097,146115,4982,3.3
37,69,Franklin,1995,21159,20261,898,4.2
37,71,Gaston,1995,98131,94035,4096,4.2
37,73,Gates,1995,4555,4402,153,3.4
37,75,Graham,1995,4429,3800,629,14.2
37,77,Granville,1995,21615,20682,933,4.3
37,79,Greene,1995,8346,7978,368,4.4
37,81,Guilford,1995,213120,205979,7141,3.4
37,83,Halifax,1995,24047,21871,2176,9.0
37,85,Harnett,1995,34449,33163,1286,3.7
37,87,Haywood,1995,23806,22465,1341,5.6
37,89,Henderson,1995,35819,34664,1155,3.2
37,91,Hertford,1995,9976,9405,571,5.7
37,93,Hoke,1995,10828,10102,726,6.7
37,95,Hyde,1995,2884,2595,289,10.0
37,97,Iredell,1995,57757,55822,1935,3.4
37,99,Jackson,1995,14892,14049,843,5.7
37,101,Johnston,1995,50682,49220,1462,2.9
37,103,Jones,1995,4531,4279,252,5.6
37,105,Lee,1995,25919,24695,1224,4.7
37,107,Lenoir,1995,29471,27601,1870,6.3
37,109,Lincoln,1995,30854,29381,1473,4.8
37,111,McDowell,1995,20539,19335,1204,5.9
37,113,Macon,1995,12646,12141,505,4.0
37,115,Madison,1995,8634,8274,360,4.2
37,117,Martin,1995,12961,12130,831,6.4
37,119,Mecklenburg,1995,334499,324256,10243,3.1
37,121,Mitchell,1995,7040,6507,533,7.6
37,123,Montgomery,1995,11864,11059,805,6.8
37,125,Moore,1995,28466,27367,1099,3.9
37,127,Nash,1995,44360,42014,2346,5.3
37,129,New Hanover,1995,74882,70617,4265,5.7
37,131,Northampton,1995,8490,7855,635,7.5
37,133,Onslow,1995,43520,41784,1736,4.0
37,135,Orange,1995,59945,58789,1156,1.9
37,137,Pamlico,1995,5424,5094,330,6.1
37,139,Pasquotank,1995,14484,13770,714,4.9
37,141,Pender,1995,14939,14055,884,5.9
37,143,Perquimans,1995,4604,4369,235,5.1
37,145,Person,1995,17159,16237,922,5.4
37,147,Pitt,1995,63649,60592,3057,4.8
37,149,Polk,1995,7585,7381,204,2.7
37,151,Randolph,1995,66971,65042,1929,2.9
37,153,Richmond,1995,21154,19122,2032,9.6
37,155,Robeson,1995,54992,50209,4783,8.7
37,157,Rockingham,1995,47494,45296,2198,4.6
37,159,Rowan,1995,62286,60004,2282,3.7
37,161,Rutherford,1995,30911,29109,1802,5.8
37,163,Sampson,1995,23797,22419,1378,5.8
37,165,Scotland,1995,17616,16363,1253,7.1
37,167,Stanly,1995,26994,25403,1591,5.9
37,169,Stokes,1995,21950,21328,622,2.8
37,171,Surry,1995,36343,34564,1779,4.9
37,173,Swain,1995,5954,4953,1001,16.8
37,175,Transylvania,1995,11085,10625,460,4.1
37,177,Tyrrell,1995,1828,1641,187,10.2
37,179,Union,1995,53669,52242,1427,2.7
37,181,Vance,1995,19484,17852,1632,8.4
37,183,Wake,1995,302038,294906,7132,2.4
37,185,Warren,1995,7213,6595,618,8.6
37,187,Washington,1995,6242,5588,654,10.5
37,189,Watauga,1995,22568,21827,741,3.3
37,191,Wayne,1995,48643,46158,2485,5.1
37,193,Wilkes,1995,32985,31411,1574,4.8
37,195,Wilson,1995,36108,32920,3188,8.8
37,197,Yadkin,1995,17662,16965,697,3.9
37,199,Yancey,1995,6236,5867,369,5.9
38,1,Adams,1995,1496,1471,25,1.7
38,3,Barnes,1995,5934,5783,151,2.5
38,5,Benson,1995,2819,2524,295,10.5
38,7,Billings,1995,589,573,16,2.7
38,9,Bottineau,1995,3415,3322,93,2.7
38,11,Bowman,1995,1841,1803,38,2.1
38,13,Burke,1995,1085,1054,31,2.9
38,15,Burleigh,1995,38470,37287,1183,3.1
38,17,Cass,1995,67312,65962,1350,2.0
38,19,Cavalier,1995,2583,2481,102,3.9
38,21,Dickey,1995,2926,2861,65,2.2
38,23,Divide,1995,1224,1204,20,1.6
38,25,Dunn,1995,2034,1985,49,2.4
38,27,Eddy,1995,1291,1214,77,6.0
38,29,Emmons,1995,2163,2092,71,3.3
38,31,Foster,1995,2174,2113,61,2.8
38,33,Golden Valley,1995,952,923,29,3.0
38,35,Grand Forks,1995,37670,36684,986,2.6
38,37,Grant,1995,1666,1618,48,2.9
38,39,Griggs,1995,1848,1814,34,1.8
38,41,Hettinger,1995,1455,1411,44,3.0
38,43,Kidder,1995,1541,1467,74,4.8
38,45,LaMoure,1995,2370,2307,63,2.7
38,47,Logan,1995,1257,1234,23,1.8
38,49,McHenry,1995,2867,2753,114,4.0
38,51,McIntosh,1995,1812,1775,37,2.0
38,53,McKenzie,1995,3276,3185,91,2.8
38,55,McLean,1995,4650,4439,211,4.5
38,57,Mercer,1995,5241,4868,373,7.1
38,59,Morton,1995,13495,12940,555,4.1
38,61,Mountrail,1995,3187,2887,300,9.4
38,63,Nelson,1995,1762,1697,65,3.7
38,65,Oliver,1995,1183,1148,35,3.0
38,67,Pembina,1995,5194,4885,309,5.9
38,69,Pierce,1995,2418,2365,53,2.2
38,71,Ramsey,1995,6622,6407,215,3.2
38,73,Ransom,1995,2821,2766,55,1.9
38,75,Renville,1995,1393,1365,28,2.0
38,77,Richland,1995,9210,8917,293,3.2
38,79,Rolette,1995,5835,5125,710,12.2
38,81,Sargent,1995,2419,2361,58,2.4
38,83,Sheridan,1995,753,735,18,2.4
38,85,Sioux,1995,1653,1544,109,6.6
38,87,Slope,1995,428,416,12,2.8
38,89,Stark,1995,12421,12009,412,3.3
38,91,Steele,1995,1131,1110,21,1.9
38,93,Stutsman,1995,11389,11032,357,3.1
38,95,Towner,1995,1559,1517,42,2.7
38,97,Traill,1995,4040,3900,140,3.5
38,99,Walsh,1995,6552,6218,334,5.1
38,101,Ward,1995,29065,28130,935,3.2
38,103,Wells,1995,2553,2445,108,4.2
38,105,Williams,1995,10290,9930,360,3.5
39,1,Adams,1995,11455,9980,1475,12.9
39,3,Allen,1995,51312,48177,3135,6.1
39,5,Ashland,1995,26092,24819,1273,4.9
39,7,Ashtabula,1995,45708,42436,3272,7.2
39,9,Athens,1995,25522,24052,1470,5.8
39,11,Auglaize,1995,24088,22802,1286,5.3
39,13,Belmont,1995,30967,28766,2201,7.1
39,15,Brown,1995,18171,17055,1116,6.1
39,17,Butler,1995,165859,158860,6999,4.2
39,19,Carroll,1995,12845,12187,658,5.1
39,21,Champaign,1995,18621,17721,900,4.8
39,23,Clark,1995,70092,66847,3245,4.6
39,25,Clermont,1995,86952,83031,3921,4.5
39,27,Clinton,1995,22751,21692,1059,4.7
39,29,Columbiana,1995,51725,48749,2976,5.8
39,31,Coshocton,1995,16825,15824,1001,5.9
39,33,Crawford,1995,22522,21052,1470,6.5
39,35,Cuyahoga,1995,679291,648785,30506,4.5
39,37,Darke,1995,29246,27933,1313,4.5
39,39,Defiance,1995,21117,20112,1005,4.8
39,41,Delaware,1995,43486,42125,1361,3.1
39,43,Erie,1995,42990,40750,2240,5.2
39,45,Fairfield,1995,60428,58059,2369,3.9
39,47,Fayette,1995,14449,13620,829,5.7
39,49,Franklin,1995,566497,548848,17649,3.1
39,51,Fulton,1995,22151,20907,1244,5.6
39,53,Gallia,1995,13870,12604,1266,9.1
39,55,Geauga,1995,44430,42912,1518,3.4
39,57,Greene,1995,69200,66507,2693,3.9
39,59,Guernsey,1995,18357,16836,1521,8.3
39,61,Hamilton,1995,432686,414162,18524,4.3
39,63,Hancock,1995,39942,38450,1492,3.7
39,65,Hardin,1995,15113,14344,769,5.1
39,67,Harrison,1995,7041,6455,586,8.3
39,69,Henry,1995,16137,15206,931,5.8
39,71,Highland,1995,17593,16484,1109,6.3
39,73,Hocking,1995,12123,11167,956,7.9
39,75,Holmes,1995,17963,17365,598,3.3
39,77,Huron,1995,29959,27304,2655,8.9
39,79,Jackson,1995,13995,12962,1033,7.4
39,81,Jefferson,1995,31154,28817,2337,7.5
39,83,Knox,1995,27023,25698,1325,4.9
39,85,Lake,1995,121406,116484,4922,4.1
39,87,Lawrence,1995,25899,24137,1762,6.8
39,89,Licking,1995,69682,66858,2824,4.1
39,91,Logan,1995,24162,23129,1033,4.3
39,93,Lorain,1995,138706,130707,7999,5.8
39,95,Lucas,1995,225724,213626,12098,5.4
39,97,Madison,1995,19840,19210,630,3.2
39,99,Mahoning,1995,120413,112254,8159,6.8
39,101,Marion,1995,32925,30870,2055,6.2
39,103,Medina,1995,72259,69485,2774,3.8
39,105,Meigs,1995,8760,7730,1030,11.8
39,107,Mercer,1995,21006,19036,1970,9.4
39,109,Miami,1995,49956,48029,1927,3.9
39,111,Monroe,1995,6132,5512,620,10.1
39,113,Montgomery,1995,282991,271002,11989,4.2
39,115,Morgan,1995,5151,4440,711,13.8
39,117,Morrow,1995,13581,12744,837,6.2
39,119,Muskingum,1995,42554,39313,3241,7.6
39,121,Noble,1995,5220,4779,441,8.4
39,123,Ottawa,1995,20033,18610,1423,7.1
39,125,Paulding,1995,9853,9416,437,4.4
39,127,Perry,1995,14833,13505,1328,9.0
39,129,Pickaway,1995,23516,22629,887,3.8
39,131,Pike,1995,11055,10032,1023,9.3
39,133,Portage,1995,81182,77625,3557,4.4
39,135,Preble,1995,21402,20484,918,4.3
39,137,Putnam,1995,19701,18785,916,4.6
39,139,Richland,1995,62355,58351,4004,6.4
39,141,Ross,1995,33470,31435,2035,6.1
39,143,Sandusky,1995,31786,29971,1815,5.7
39,145,Scioto,1995,32616,29281,3335,10.2
39,147,Seneca,1995,29480,27684,1796,6.1
39,149,Shelby,1995,27179,25911,1268,4.7
39,151,Stark,1995,186147,176446,9701,5.2
39,153,Summit,1995,275908,262719,13189,4.8
39,155,Trumbull,1995,113214,105458,7756,6.9
39,157,Tuscarawas,1995,44577,42023,2554,5.7
39,159,Union,1995,16106,15470,636,3.9
39,161,Van Wert,1995,16642,15885,757,4.5
39,163,Vinton,1995,3938,3486,452,11.5
39,165,Warren,1995,67467,64759,2708,4.0
39,167,Washington,1995,31960,29869,2091,6.5
39,169,Wayne,1995,56806,54700,2106,3.7
39,171,Williams,1995,22047,21201,846,3.8
39,173,Wood,1995,63611,61005,2606,4.1
39,175,Wyandot,1995,12031,11405,626,5.2
40,1,Adair,1995,9984,9496,488,4.9
40,3,Alfalfa,1995,2630,2591,39,1.5
40,5,Atoka,1995,4960,4713,247,5.0
40,7,Beaver,1995,3004,2921,83,2.8
40,9,Beckham,1995,9588,9120,468,4.9
40,11,Blaine,1995,4892,4736,156,3.2
40,13,Bryan,1995,13888,13344,544,3.9
40,15,Caddo,1995,11875,11275,600,5.1
40,17,Canadian,1995,41918,40872,1046,2.5
40,19,Carter,1995,20966,19626,1340,6.4
40,21,Cherokee,1995,16528,15684,844,5.1
40,23,Choctaw,1995,5590,5003,587,10.5
40,25,Cimarron,1995,1731,1690,41,2.4
40,27,Cleveland,1995,101360,98613,2747,2.7
40,29,Coal,1995,2726,2486,240,8.8
40,31,Comanche,1995,40961,38859,2102,5.1
40,33,Cotton,1995,2359,2251,108,4.6
40,35,Craig,1995,6471,6281,190,2.9
40,37,Creek,1995,30613,29205,1408,4.6
40,39,Custer,1995,13310,12843,467,3.5
40,41,Delaware,1995,15770,15176,594,3.8
40,43,Dewey,1995,2281,2187,94,4.1
40,45,Ellis,1995,1853,1784,69,3.7
40,47,Garfield,1995,27227,26247,980,3.6
40,49,Garvin,1995,11061,10506,555,5.0
40,51,Grady,1995,20502,19482,1020,5.0
40,53,Grant,1995,2546,2478,68,2.7
40,55,Greer,1995,2441,2359,82,3.4
40,57,Harmon,1995,1366,1320,46,3.4
40,59,Harper,1995,1930,1869,61,3.2
40,61,Haskell,1995,4183,3692,491,11.7
40,63,Hughes,1995,5461,4988,473,8.7
40,65,Jackson,1995,11312,10723,589,5.2
40,67,Jefferson,1995,3320,3160,160,4.8
40,69,Johnston,1995,4848,4627,221,4.6
40,71,Kay,1995,23071,21465,1606,7.0
40,73,Kingfisher,1995,7064,6861,203,2.9
40,75,Kiowa,1995,4781,4636,145,3.0
40,77,Latimer,1995,4351,3897,454,10.4
40,79,Le Flore,1995,19735,18346,1389,7.0
40,81,Lincoln,1995,14867,14268,599,4.0
40,83,Logan,1995,14108,13660,448,3.2
40,85,Love,1995,3909,3669,240,6.1
40,87,McClain,1995,12085,11671,414,3.4
40,89,McCurtain,1995,14977,13644,1333,8.9
40,91,McIntosh,1995,7136,6537,599,8.4
40,93,Major,1995,3952,3841,111,2.8
40,95,Marshall,1995,5212,4938,274,5.3
40,97,Mayes,1995,15415,14642,773,5.0
40,99,Murray,1995,5693,5328,365,6.4
40,101,Muskogee,1995,29153,27261,1892,6.5
40,103,Noble,1995,5640,5443,197,3.5
40,105,Nowata,1995,3810,3577,233,6.1
40,107,Okfuskee,1995,4313,4045,268,6.2
40,109,Oklahoma,1995,313374,301557,11817,3.8
40,111,Okmulgee,1995,14955,13439,1516,10.1
40,113,Osage,1995,19047,18350,697,3.7
40,115,Ottawa,1995,13432,12636,796,5.9
40,117,Pawnee,1995,6606,6113,493,7.5
40,119,Payne,1995,34703,33970,733,2.1
40,121,Pittsburg,1995,17691,16237,1454,8.2
40,123,Pontotoc,1995,16398,15357,1041,6.3
40,125,Pottawatomie,1995,26856,25708,1148,4.3
40,127,Pushmataha,1995,5023,4643,380,7.6
40,129,Roger Mills,1995,1988,1931,57,2.9
40,131,Rogers,1995,31148,29808,1340,4.3
40,133,Seminole,1995,10545,9699,846,8.0
40,135,Sequoyah,1995,16429,15305,1124,6.8
40,137,Stephens,1995,17722,16479,1243,7.0
40,139,Texas,1995,9579,9328,251,2.6
40,141,Tillman,1995,4064,3850,214,5.3
40,143,Tulsa,1995,275730,265090,10640,3.9
40,145,Wagoner,1995,25918,24956,962,3.7
40,147,Washington,1995,19866,18798,1068,5.4
40,149,Washita,1995,5282,5115,167,3.2
40,151,Woods,1995,4281,4194,87,2.0
40,153,Woodward,1995,9050,8629,421,4.7
41,1,Baker,1995,7447,6861,586,7.9
41,3,Benton,1995,41443,40547,896,2.2
41,5,Clackamas,1995,179880,174219,5661,3.1
41,7,Clatsop,1995,17345,16490,855,4.9
41,9,Columbia,1995,20780,19802,978,4.7
41,11,Coos,1995,27623,25623,2000,7.2
41,13,Crook,1995,7824,7224,600,7.7
41,15,Curry,1995,8248,7640,608,7.4
41,17,Deschutes,1995,50709,47451,3258,6.4
41,19,Douglas,1995,43514,40083,3431,7.9
41,21,Gilliam,1995,1106,1071,35,3.2
41,23,Grant,1995,4204,3781,423,10.1
41,25,Harney,1995,3558,3167,391,11.0
41,27,Hood River,1995,10346,9498,848,8.2
41,29,Jackson,1995,83012,77663,5349,6.4
41,31,Jefferson,1995,7995,7519,476,6.0
41,33,Josephine,1995,28279,25954,2325,8.2
41,35,Klamath,1995,28531,26465,2066,7.2
41,37,Lake,1995,3726,3413,313,8.4
41,39,Lane,1995,156464,148419,8045,5.1
41,41,Lincoln,1995,21155,19697,1458,6.9
41,43,Linn,1995,49511,46559,2952,6.0
41,45,Malheur,1995,14412,13482,930,6.5
41,47,Marion,1995,131490,125338,6152,4.7
41,49,Morrow,1995,3855,3576,279,7.2
41,51,Multnomah,1995,351220,336913,14307,4.1
41,53,Polk,1995,28174,27089,1085,3.9
41,55,Sherman,1995,900,837,63,7.0
41,57,Tillamook,1995,10969,10434,535,4.9
41,59,Umatilla,1995,32713,30492,2221,6.8
41,61,Union,1995,12378,11614,764,6.2
41,63,Wallowa,1995,3435,3078,357,10.4
41,65,Wasco,1995,11377,10597,780,6.9
41,67,Washington,1995,220869,214192,6677,3.0
41,69,Wheeler,1995,553,514,39,7.1
41,71,Yamhill,1995,37980,36520,1460,3.8
42,1,Adams,1995,43190,41339,1851,4.3
42,3,Allegheny,1995,651976,617544,34432,5.3
42,5,Armstrong,1995,32329,29266,3063,9.5
42,7,Beaver,1995,85044,79904,5140,6.0
42,9,Bedford,1995,24470,22471,1999,8.2
42,11,Berks,1995,179219,170678,8541,4.8
42,13,Blair,1995,62167,58201,3966,6.4
42,15,Bradford,1995,28604,26896,1708,6.0
42,17,Bucks,1995,308633,292969,15664,5.1
42,19,Butler,1995,82678,78099,4579,5.5
42,21,Cambria,1995,69404,63661,5743,8.3
42,23,Cameron,1995,2611,2440,171,6.5
42,25,Carbon,1995,26306,24305,2001,7.6
42,27,Centre,1995,63575,61452,2123,3.3
42,29,Chester,1995,216701,208204,8497,3.9
42,31,Clarion,1995,18362,16844,1518,8.3
42,33,Clearfield,1995,37702,34472,3230,8.6
42,35,Clinton,1995,17387,15694,1693,9.7
42,37,Columbia,1995,32900,30468,2432,7.4
42,39,Crawford,1995,41133,38480,2653,6.4
42,41,Cumberland,1995,116266,112543,3723,3.2
42,43,Dauphin,1995,136021,130646,5375,4.0
42,45,Delaware,1995,274679,259507,15172,5.5
42,47,Elk,1995,18299,17251,1048,5.7
42,49,Erie,1995,140327,131328,8999,6.4
42,51,Fayette,1995,57174,51664,5510,9.6
42,53,Forest,1995,1835,1624,211,11.5
42,55,Franklin,1995,63992,61098,2894,4.5
42,57,Fulton,1995,6625,6257,368,5.6
42,59,Greene,1995,15686,14054,1632,10.4
42,61,Huntingdon,1995,19246,17271,1975,10.3
42,63,Indiana,1995,37495,34038,3457,9.2
42,65,Jefferson,1995,22009,20348,1661,7.5
42,67,Juniata,1995,10082,9206,876,8.7
42,69,Lackawanna,1995,106541,99248,7293,6.8
42,71,Lancaster,1995,234107,225800,8307,3.5
42,73,Lawrence,1995,39710,36906,2804,7.1
42,75,Lebanon,1995,63873,61137,2736,4.3
42,77,Lehigh,1995,151380,143172,8208,5.4
42,79,Luzerne,1995,159988,146528,13460,8.4
42,81,Lycoming,1995,57568,53345,4223,7.3
42,83,McKean,1995,21602,20234,1368,6.3
42,85,Mercer,1995,55325,52519,2806,5.1
42,87,Mifflin,1995,22958,21334,1624,7.1
42,89,Monroe,1995,49852,45537,4315,8.7
42,91,Montgomery,1995,379644,362731,16913,4.5
42,93,Montour,1995,8759,8446,313,3.6
42,95,Northampton,1995,125614,118861,6753,5.4
42,97,Northumberland,1995,44480,41348,3132,7.0
42,99,Perry,1995,23314,22284,1030,4.4
42,101,Philadelphia/city,1995,651116,600714,50402,7.7
42,103,Pike,1995,16706,15699,1007,6.0
42,105,Potter,1995,8510,7875,635,7.5
42,107,Schuylkill,1995,68411,62990,5421,7.9
42,109,Snyder,1995,18580,17548,1032,5.6
42,111,Somerset,1995,38153,34893,3260,8.5
42,113,Sullivan,1995,2691,2527,164,6.1
42,115,Susquehanna,1995,19200,17809,1391,7.2
42,117,Tioga,1995,19646,18257,1389,7.1
42,119,Union,1995,18341,17531,810,4.4
42,121,Venango,1995,25950,24044,1906,7.3
42,123,Warren,1995,21893,20823,1070,4.9
42,125,Washington,1995,94750,88349,6401,6.8
42,127,Wayne,1995,18904,17224,1680,8.9
42,129,Westmoreland,1995,180455,168389,12066,6.7
42,131,Wyoming,1995,14866,13717,1149,7.7
42,133,York,1995,193100,185033,8067,4.2
44,1,Bristol,1995,25801,24466,1335,5.2
44,3,Kent,1995,88519,82908,5611,6.3
44,5,Newport,1995,39451,37071,2380,6.0
44,7,Providence,1995,295461,275311,20150,6.8
44,9,Washington,1995,62590,59630,2960,4.7
45,1,Abbeville,1995,12657,11853,804,6.4
45,3,Aiken,1995,64663,59983,4680,7.2
45,5,Allendale,1995,4824,4394,430,8.9
45,7,Anderson,1995,81629,78329,3300,4.0
45,9,Bamberg,1995,7617,6879,738,9.7
45,11,Barnwell,1995,11106,9911,1195,10.8
45,13,Beaufort,1995,43884,42549,1335,3.0
45,15,Berkeley,1995,61106,58622,2484,4.1
45,17,Calhoun,1995,6506,6064,442,6.8
45,19,Charleston,1995,142717,134968,7749,5.4
45,21,Cherokee,1995,24588,23471,1117,4.5
45,23,Chester,1995,15529,14083,1446,9.3
45,25,Chesterfield,1995,20862,19344,1518,7.3
45,27,Clarendon,1995,11736,10721,1015,8.6
45,29,Colleton,1995,15717,14686,1031,6.6
45,31,Darlington,1995,31591,28856,2735,8.7
45,33,Dillon,1995,14050,12589,1461,10.4
45,35,Dorchester,1995,41974,39690,2284,5.4
45,37,Edgefield,1995,9217,8594,623,6.8
45,39,Fairfield,1995,11055,10159,896,8.1
45,41,Florence,1995,61545,57589,3956,6.4
45,43,Georgetown,1995,24292,22052,2240,9.2
45,45,Greenville,1995,184431,179769,4662,2.5
45,47,Greenwood,1995,33289,31550,1739,5.2
45,49,Hampton,1995,8300,7713,587,7.1
45,51,Horry,1995,91309,86667,4642,5.1
45,53,Jasper,1995,7391,7048,343,4.6
45,55,Kershaw,1995,22983,21552,1431,6.2
45,57,Lancaster,1995,29194,27497,1697,5.8
45,59,Laurens,1995,31308,30099,1209,3.9
45,61,Lee,1995,8155,7466,689,8.4
45,63,Lexington,1995,110070,106735,3335,3.0
45,65,McCormick,1995,4061,3683,378,9.3
45,67,Marion,1995,16547,14771,1776,10.7
45,69,Marlboro,1995,11836,10424,1412,11.9
45,71,Newberry,1995,18195,17160,1035,5.7
45,73,Oconee,1995,28449,27134,1315,4.6
45,75,Orangeburg,1995,41167,37299,3868,9.4
45,77,Pickens,1995,54237,52097,2140,3.9
45,79,Richland,1995,149789,144512,5277,3.5
45,81,Saluda,1995,8392,7982,410,4.9
45,83,Spartanburg,1995,128188,123364,4824,3.8
45,85,Sumter,1995,45300,42613,2687,5.9
45,87,Union,1995,15716,14293,1423,9.1
45,89,Williamsburg,1995,16464,14076,2388,14.5
45,91,York,1995,80592,77655,2937,3.6
46,3,Aurora,1995,1426,1380,46,3.2
46,5,Beadle,1995,9546,9281,265,2.8
46,7,Bennett,1995,1078,1016,62,5.8
46,9,Bon Homme,1995,3163,3092,71,2.2
46,11,Brookings,1995,15264,15020,244,1.6
46,13,Brown,1995,20653,20217,436,2.1
46,15,Brule,1995,2953,2822,131,4.4
46,17,Buffalo,1995,812,724,88,10.8
46,19,Butte,1995,3833,3681,152,4.0
46,21,Campbell,1995,951,923,28,2.9
46,23,Charles Mix,1995,4770,4594,176,3.7
46,25,Clark,1995,1961,1882,79,4.0
46,27,Clay,1995,6873,6795,78,1.1
46,29,Codington,1995,14029,13573,456,3.3
46,31,Corson,1995,1529,1406,123,8.0
46,33,Custer,1995,3466,3291,175,5.0
46,35,Davison,1995,9789,9493,296,3.0
46,37,Day,1995,3074,2916,158,5.1
46,39,Deuel,1995,2339,2261,78,3.3
46,41,Dewey,1995,2265,1949,316,14.0
46,43,Douglas,1995,1577,1520,57,3.6
46,45,Edmunds,1995,2241,2203,38,1.7
46,47,Fall River,1995,3546,3450,96,2.7
46,49,Faulk,1995,1237,1203,34,2.7
46,51,Grant,1995,4157,3954,203,4.9
46,53,Gregory,1995,2647,2545,102,3.9
46,55,Haakon,1995,1206,1163,43,3.6
46,57,Hamlin,1995,2491,2410,81,3.3
46,59,Hand,1995,2202,2138,64,2.9
46,61,Hanson,1995,1636,1590,46,2.8
46,63,Harding,1995,839,807,32,3.8
46,65,Hughes,1995,9594,9321,273,2.8
46,67,Hutchinson,1995,3927,3801,126,3.2
46,69,Hyde,1995,893,855,38,4.3
46,71,Jackson,1995,1105,1037,68,6.2
46,73,Jerauld,1995,1130,1091,39,3.5
46,75,Jones,1995,818,789,29,3.5
46,77,Kingsbury,1995,2613,2513,100,3.8
46,79,Lake,1995,5953,5798,155,2.6
46,81,Lawrence,1995,11949,11527,422,3.5
46,83,Lincoln,1995,9940,9770,170,1.7
46,85,Lyman,1995,2414,2305,109,4.5
46,87,McCook,1995,2557,2490,67,2.6
46,89,McPherson,1995,1432,1385,47,3.3
46,91,Marshall,1995,2353,2273,80,3.4
46,93,Meade,1995,12031,11609,422,3.5
46,95,Mellette,1995,777,733,44,5.7
46,97,Miner,1995,1438,1366,72,5.0
46,99,Minnehaha,1995,80763,78949,1814,2.2
46,101,Moody,1995,3670,3460,210,5.7
46,102,Oglala Lakota,1995,3133,2676,457,14.6
46,103,Pennington,1995,44489,43044,1445,3.2
46,105,Perkins,1995,2021,1971,50,2.5
46,107,Potter,1995,1524,1464,60,3.9
46,109,Roberts,1995,4835,4592,243,5.0
46,111,Sanborn,1995,1449,1395,54,3.7
46,115,Spink,1995,3591,3475,116,3.2
46,117,Stanley,1995,1772,1710,62,3.5
46,119,Sully,1995,957,923,34,3.6
46,121,Todd,1995,2708,2478,230,8.5
46,123,Tripp,1995,3626,3497,129,3.6
46,125,Turner,1995,4187,4043,144,3.4
46,127,Union,1995,6736,6481,255,3.8
46,129,Walworth,1995,3110,2975,135,4.3
46,135,Yankton,1995,10863,10637,226,2.1
46,137,Ziebach,1995,718,666,52,7.2
47,1,Anderson,1995,36231,34811,1420,3.9
47,3,Bedford,1995,17180,16115,1065,6.2
47,5,Benton,1995,7923,7372,551,7.0
47,7,Bledsoe,1995,3841,3650,191,5.0
47,9,Blount,1995,50042,47419,2623,5.2
47,11,Bradley,1995,41744,39643,2101,5.0
47,13,Campbell,1995,16536,15178,1358,8.2
47,15,Cannon,1995,5095,4819,276,5.4
47,17,Carroll,1995,14397,13483,914,6.3
47,19,Carter,1995,26116,24662,1454,5.6
47,21,Cheatham,1995,17181,16751,430,2.5
47,23,Chester,1995,7427,7043,384,5.2
47,25,Claiborne,1995,12998,12348,650,5.0
47,27,Clay,1995,3874,3592,282,7.3
47,29,Cocke,1995,16929,15006,1923,11.4
47,31,Coffee,1995,22484,21305,1179,5.2
47,33,Crockett,1995,7605,7105,500,6.6
47,35,Cumberland,1995,18576,17248,1328,7.1
47,37,Davidson,1995,299903,290105,9798,3.3
47,39,Decatur,1995,5914,5434,480,8.1
47,41,DeKalb,1995,8532,7906,626,7.3
47,43,Dickson,1995,19443,18627,816,4.2
47,45,Dyer,1995,18906,17943,963,5.1
47,47,Fayette,1995,12207,11577,630,5.2
47,49,Fentress,1995,7412,6620,792,10.7
47,51,Franklin,1995,18519,17465,1054,5.7
47,53,Gibson,1995,23496,22067,1429,6.1
47,55,Giles,1995,16118,15341,777,4.8
47,57,Grainger,1995,9730,9082,648,6.7
47,59,Greene,1995,33532,30595,2937,8.8
47,61,Grundy,1995,5825,5301,524,9.0
47,63,Hamblen,1995,30501,28390,2111,6.9
47,65,Hamilton,1995,149627,142853,6774,4.5
47,67,Hancock,1995,2682,2512,170,6.3
47,69,Hardeman,1995,9135,8286,849,9.3
47,71,Hardin,1995,12387,11406,981,7.9
47,73,Hawkins,1995,23424,22151,1273,5.4
47,75,Haywood,1995,8999,7951,1048,11.6
47,77,Henderson,1995,13442,12420,1022,7.6
47,79,Henry,1995,14810,13974,836,5.6
47,81,Hickman,1995,8682,8292,390,4.5
47,83,Houston,1995,2984,2514,470,15.8
47,85,Humphreys,1995,8325,7525,800,9.6
47,87,Jackson,1995,4451,4161,290,6.5
47,89,Jefferson,1995,21621,20089,1532,7.1
47,91,Johnson,1995,8492,7322,1170,13.8
47,93,Knox,1995,197255,190565,6690,3.4
47,95,Lake,1995,2836,2670,166,5.9
47,97,Lauderdale,1995,9616,8773,843,8.8
47,99,Lawrence,1995,21761,19443,2318,10.7
47,101,Lewis,1995,5173,4684,489,9.5
47,103,Lincoln,1995,15419,14514,905,5.9
47,105,Loudon,1995,19169,18401,768,4.0
47,107,McMinn,1995,22292,20245,2047,9.2
47,109,McNairy,1995,11663,10485,1178,10.1
47,111,Macon,1995,9382,8566,816,8.7
47,113,Madison,1995,46795,44542,2253,4.8
47,115,Marion,1995,12441,11613,828,6.7
47,117,Marshall,1995,12395,11649,746,6.0
47,119,Maury,1995,36412,34295,2117,5.8
47,121,Meigs,1995,4421,3958,463,10.5
47,123,Monroe,1995,18024,16417,1607,8.9
47,125,Montgomery,1995,52406,50434,1972,3.8
47,127,Moore,1995,3000,2916,84,2.8
47,129,Morgan,1995,7581,6943,638,8.4
47,131,Obion,1995,14901,14070,831,5.6
47,133,Overton,1995,9339,8632,707,7.6
47,135,Perry,1995,3403,3192,211,6.2
47,137,Pickett,1995,2272,2025,247,10.9
47,139,Polk,1995,6805,6274,531,7.8
47,141,Putnam,1995,30236,28760,1476,4.9
47,143,Rhea,1995,12147,11040,1107,9.1
47,145,Roane,1995,28961,27294,1667,5.8
47,147,Robertson,1995,25400,24254,1146,4.5
47,149,Rutherford,1995,82853,80004,2849,3.4
47,151,Scott,1995,8663,7778,885,10.2
47,153,Sequatchie,1995,4674,4396,278,5.9
47,155,Sevier,1995,33489,30636,2853,8.5
47,157,Shelby,1995,428788,407806,20982,4.9
47,159,Smith,1995,9205,8763,442,4.8
47,161,Stewart,1995,3973,3361,612,15.4
47,163,Sullivan,1995,75995,72472,3523,4.6
47,165,Sumner,1995,63529,61123,2406,3.8
47,167,Tipton,1995,20023,18951,1072,5.4
47,169,Trousdale,1995,2329,2121,208,8.9
47,171,Unicoi,1995,8103,7493,610,7.5
47,173,Union,1995,7386,7049,337,4.6
47,175,Van Buren,1995,2466,2291,175,7.1
47,177,Warren,1995,19350,18119,1231,6.4
47,179,Washington,1995,51319,49259,2060,4.0
47,181,Wayne,1995,7608,6734,874,11.5
47,183,Weakley,1995,17706,17042,664,3.8
47,185,White,1995,10725,9987,738,6.9
47,187,Williamson,1995,55697,54542,1155,2.1
47,189,Wilson,1995,42474,40831,1643,3.9
48,1,Anderson,1995,20563,19457,1106,5.4
48,3,Andrews,1995,5508,5215,293,5.3
48,5,Angelina,1995,34310,32478,1832,5.3
48,7,Aransas,1995,8860,8306,554,6.3
48,9,Archer,1995,4059,3941,118,2.9
48,11,Armstrong,1995,958,926,32,3.3
48,13,Atascosa,1995,15501,14724,777,5.0
48,15,Austin,1995,11321,10903,418,3.7
48,17,Bailey,1995,3773,3542,231,6.1
48,19,Bandera,1995,6697,6459,238,3.6
48,21,Bastrop,1995,23185,22540,645,2.8
48,23,Baylor,1995,1893,1798,95,5.0
48,25,Bee,1995,11252,10331,921,8.2
48,27,Bell,1995,89857,85371,4486,5.0
48,29,Bexar,1995,635272,605688,29584,4.7
48,31,Blanco,1995,3407,3324,83,2.4
48,33,Borden,1995,406,395,11,2.7
48,35,Bosque,1995,6280,5961,319,5.1
48,37,Bowie,1995,39783,36394,3389,8.5
48,39,Brazoria,1995,105689,97718,7971,7.5
48,41,Brazos,1995,68875,66768,2107,3.1
48,43,Brewster,1995,4688,4570,118,2.5
48,45,Briscoe,1995,971,931,40,4.1
48,47,Brooks,1995,3207,2760,447,13.9
48,49,Brown,1995,16886,15817,1069,6.3
48,51,Burleson,1995,7396,7003,393,5.3
48,53,Burnet,1995,12130,11646,484,4.0
48,55,Caldwell,1995,14347,13807,540,3.8
48,57,Calhoun,1995,9550,8664,886,9.3
48,59,Callahan,1995,6279,6021,258,4.1
48,61,Cameron,1995,122763,106996,15767,12.8
48,63,Camp,1995,5008,4598,410,8.2
48,65,Carson,1995,3841,3696,145,3.8
48,67,Cass,1995,15211,13771,1440,9.5
48,69,Castro,1995,4172,3958,214,5.1
48,71,Chambers,1995,10807,10196,611,5.7
48,73,Cherokee,1995,20194,19116,1078,5.3
48,75,Childress,1995,3355,3218,137,4.1
48,77,Clay,1995,5279,5098,181,3.4
48,79,Cochran,1995,1645,1539,106,6.4
48,81,Coke,1995,1552,1515,37,2.4
48,83,Coleman,1995,3973,3704,269,6.8
48,85,Collin,1995,209711,202856,6855,3.3
48,87,Collingsworth,1995,1667,1602,65,3.9
48,89,Colorado,1995,8203,7922,281,3.4
48,91,Comal,1995,33160,31960,1200,3.6
48,93,Comanche,1995,6601,6355,246,3.7
48,95,Concho,1995,1422,1391,31,2.2
48,97,Cooke,1995,15579,14776,803,5.2
48,99,Coryell,1995,20608,19597,1011,4.9
48,101,Cottle,1995,868,813,55,6.3
48,103,Crane,1995,2235,2138,97,4.3
48,105,Crockett,1995,2035,1973,62,3.0
48,107,Crosby,1995,3221,3005,216,6.7
48,109,Culberson,1995,1281,1206,75,5.9
48,111,Dallam,1995,3292,3180,112,3.4
48,113,Dallas,1995,1136542,1077754,58788,5.2
48,115,Dawson,1995,6341,5912,429,6.8
48,117,Deaf Smith,1995,8741,8049,692,7.9
48,119,Delta,1995,2585,2470,115,4.4
48,121,Denton,1995,204226,197106,7120,3.5
48,123,DeWitt,1995,8557,8112,445,5.2
48,125,Dickens,1995,1102,991,111,10.1
48,127,Dimmit,1995,3780,3146,634,16.8
48,129,Donley,1995,1591,1542,49,3.1
48,131,Duval,1995,4814,4150,664,13.8
48,133,Eastland,1995,8158,7724,434,5.3
48,135,Ector,1995,60076,55543,4533,7.5
48,137,Edwards,1995,911,870,41,4.5
48,139,Ellis,1995,48206,45880,2326,4.8
48,141,El Paso,1995,286797,256381,30416,10.6
48,143,Erath,1995,16020,15567,453,2.8
48,145,Falls,1995,7585,7231,354,4.7
48,147,Fannin,1995,11809,10965,844,7.1
48,149,Fayette,1995,10682,10355,327,3.1
48,151,Fisher,1995,1931,1823,108,5.6
48,153,Floyd,1995,3507,3279,228,6.5
48,155,Foard,1995,1030,1009,21,2.0
48,157,Fort Bend,1995,153958,148273,5685,3.7
48,159,Franklin,1995,3993,3729,264,6.6
48,161,Freestone,1995,7348,6923,425,5.8
48,163,Frio,1995,6624,5898,726,11.0
48,165,Gaines,1995,6999,6641,358,5.1
48,167,Galveston,1995,126731,117043,9688,7.6
48,169,Garza,1995,2211,2080,131,5.9
48,171,Gillespie,1995,9945,9772,173,1.7
48,173,Glasscock,1995,633,614,19,3.0
48,175,Goliad,1995,2736,2545,191,7.0
48,177,Gonzales,1995,7513,7196,317,4.2
48,179,Gray,1995,10903,10380,523,4.8
48,181,Grayson,1995,48077,45599,2478,5.2
48,183,Gregg,1995,57790,53333,4457,7.7
48,185,Grimes,1995,8606,8135,471,5.5
48,187,Guadalupe,1995,37688,36583,1105,2.9
48,189,Hale,1995,17818,16707,1111,6.2
48,191,Hall,1995,1786,1660,126,7.1
48,193,Hamilton,1995,3886,3765,121,3.1
48,195,Hansford,1995,2428,2351,77,3.2
48,197,Hardeman,1995,2083,2004,79,3.8
48,199,Hardin,1995,22193,20291,1902,8.6
48,201,Harris,1995,1671230,1569613,101617,6.1
48,203,Harrison,1995,27687,25329,2358,8.5
48,205,Hartley,1995,2775,2704,71,2.6
48,207,Haskell,1995,2882,2765,117,4.1
48,209,Hays,1995,43689,42324,1365,3.1
48,211,Hemphill,1995,1864,1800,64,3.4
48,213,Henderson,1995,27434,25785,1649,6.0
48,215,Hidalgo,1995,188041,150308,37733,20.1
48,217,Hill,1995,14302,13650,652,4.6
48,219,Hockley,1995,11357,10628,729,6.4
48,221,Hood,1995,14997,14077,920,6.1
48,223,Hopkins,1995,15934,14933,1001,6.3
48,225,Houston,1995,8340,7977,363,4.4
48,227,Howard,1995,13902,13338,564,4.1
48,229,Hudspeth,1995,1485,1456,29,2.0
48,231,Hunt,1995,33603,31521,2082,6.2
48,233,Hutchinson,1995,10252,9520,732,7.1
48,235,Irion,1995,903,873,30,3.3
48,237,Jack,1995,3302,3156,146,4.4
48,239,Jackson,1995,8518,8174,344,4.0
48,241,Jasper,1995,15658,13880,1778,11.4
48,243,Jeff Davis,1995,1096,1054,42,3.8
48,245,Jefferson,1995,118845,107775,11070,9.3
48,247,Jim Hogg,1995,1987,1783,204,10.3
48,249,Jim Wells,1995,16506,14776,1730,10.5
48,251,Johnson,1995,53914,51374,2540,4.7
48,253,Jones,1995,10114,9779,335,3.3
48,255,Karnes,1995,5568,5182,386,6.9
48,257,Kaufman,1995,28715,27436,1279,4.5
48,259,Kendall,1995,10931,10713,218,2.0
48,261,Kenedy,1995,224,218,6,2.7
48,263,Kent,1995,432,421,11,2.5
48,265,Kerr,1995,16938,16460,478,2.8
48,267,Kimble,1995,2256,2195,61,2.7
48,269,King,1995,134,126,8,6.0
48,271,Kinney,1995,1110,1023,87,7.8
48,273,Kleberg,1995,13179,12132,1047,7.9
48,275,Knox,1995,2311,2214,97,4.2
48,277,Lamar,1995,22008,20296,1712,7.8
48,279,Lamb,1995,6821,6357,464,6.8
48,281,Lampasas,1995,7191,6832,359,5.0
48,283,La Salle,1995,2641,2409,232,8.8
48,285,Lavaca,1995,9452,9193,259,2.7
48,287,Lee,1995,7300,6970,330,4.5
48,289,Leon,1995,5482,5103,379,6.9
48,291,Liberty,1995,27004,24782,2222,8.2
48,293,Limestone,1995,9489,8957,532,5.6
48,295,Lipscomb,1995,1603,1563,40,2.5
48,297,Live Oak,1995,4530,4306,224,4.9
48,299,Llano,1995,4760,4600,160,3.4
48,301,Loving,1995,91,82,9,9.9
48,303,Lubbock,1995,120201,115263,4938,4.1
48,305,Lynn,1995,3056,2945,111,3.6
48,307,McCulloch,1995,3903,3647,256,6.6
48,309,McLennan,1995,99297,94650,4647,4.7
48,311,McMullen,1995,276,268,8,2.9
48,313,Madison,1995,4153,3983,170,4.1
48,315,Marion,1995,3937,3521,416,10.6
48,317,Martin,1995,1888,1833,55,2.9
48,319,Mason,1995,1624,1581,43,2.6
48,321,Matagorda,1995,17434,14929,2505,14.4
48,323,Maverick,1995,18389,12871,5518,30.0
48,325,Medina,1995,14798,14198,600,4.1
48,327,Menard,1995,1033,1013,20,1.9
48,329,Midland,1995,59655,56707,2948,4.9
48,331,Milam,1995,9658,9093,565,5.9
48,333,Mills,1995,2240,2162,78,3.5
48,335,Mitchell,1995,3322,3111,211,6.4
48,337,Montague,1995,7962,7489,473,5.9
48,339,Montgomery,1995,116395,111203,5192,4.5
48,341,Moore,1995,9014,8649,365,4.0
48,343,Morris,1995,5917,5319,598,10.1
48,345,Motley,1995,715,684,31,4.3
48,347,Nacogdoches,1995,27620,26266,1354,4.9
48,349,Navarro,1995,21213,20040,1173,5.5
48,351,Newton,1995,6283,5580,703,11.2
48,353,Nolan,1995,7728,7184,544,7.0
48,355,Nueces,1995,146395,133034,13361,9.1
48,357,Ochiltree,1995,4406,4246,160,3.6
48,359,Oldham,1995,1144,1093,51,4.5
48,361,Orange,1995,41946,36674,5272,12.6
48,363,Palo Pinto,1995,12699,11607,1092,8.6
48,365,Panola,1995,8193,7310,883,10.8
48,367,Parker,1995,36441,34780,1661,4.6
48,369,Parmer,1995,4446,4270,176,4.0
48,371,Pecos,1995,7162,6690,472,6.6
48,373,Polk,1995,14615,13741,874,6.0
48,375,Potter,1995,54357,51739,2618,4.8
48,377,Presidio,1995,3635,2242,1393,38.3
48,379,Rains,1995,3585,3409,176,4.9
48,381,Randall,1995,56961,55303,1658,2.9
48,383,Reagan,1995,2015,1939,76,3.8
48,385,Real,1995,1294,1230,64,4.9
48,387,Red River,1995,6190,5742,448,7.2
48,389,Reeves,1995,7016,6278,738,10.5
48,391,Refugio,1995,3058,2881,177,5.8
48,393,Roberts,1995,519,506,13,2.5
48,395,Robertson,1995,6766,6315,451,6.7
48,397,Rockwall,1995,18495,17887,608,3.3
48,399,Runnels,1995,5373,5178,195,3.6
48,401,Rusk,1995,20162,18719,1443,7.2
48,403,Sabine,1995,3748,3430,318,8.5
48,405,San Augustine,1995,3228,3043,185,5.7
48,407,San Jacinto,1995,7577,7231,346,4.6
48,409,San Patricio,1995,28659,25827,2832,9.9
48,411,San Saba,1995,2350,2260,90,3.8
48,413,Schleicher,1995,1412,1343,69,4.9
48,415,Scurry,1995,7916,7546,370,4.7
48,417,Shackelford,1995,1461,1409,52,3.6
48,419,Shelby,1995,10167,9499,668,6.6
48,421,Sherman,1995,1386,1355,31,2.2
48,423,Smith,1995,84904,80148,4756,5.6
48,425,Somervell,1995,2228,1961,267,12.0
48,427,Starr,1995,21803,15492,6311,28.9
48,429,Stephens,1995,4071,3889,182,4.5
48,431,Sterling,1995,658,618,40,6.1
48,433,Stonewall,1995,836,803,33,3.9
48,435,Sutton,1995,2168,2081,87,4.0
48,437,Swisher,1995,4050,3851,199,4.9
48,439,Tarrant,1995,713118,677810,35308,5.0
48,441,Taylor,1995,59802,56675,3127,5.2
48,443,Terrell,1995,591,563,28,4.7
48,445,Terry,1995,6016,5567,449,7.5
48,447,Throckmorton,1995,850,818,32,3.8
48,449,Titus,1995,11993,11030,963,8.0
48,451,Tom Green,1995,50152,48056,2096,4.2
48,453,Travis,1995,417687,404404,13283,3.2
48,455,Trinity,1995,4928,4648,280,5.7
48,457,Tyler,1995,7502,6911,591,7.9
48,459,Upshur,1995,16004,14964,1040,6.5
48,461,Upton,1995,1869,1790,79,4.2
48,463,Uvalde,1995,10940,9641,1299,11.9
48,465,Val Verde,1995,18149,16121,2028,11.2
48,467,Van Zandt,1995,19156,18378,778,4.1
48,469,Victoria,1995,41816,39232,2584,6.2
48,471,Walker,1995,22626,22067,559,2.5
48,473,Waller,1995,11626,11006,620,5.3
48,475,Ward,1995,4606,4290,316,6.9
48,477,Washington,1995,14659,14216,443,3.0
48,479,Webb,1995,70625,59627,10998,15.6
48,481,Wharton,1995,19518,18234,1284,6.6
48,483,Wheeler,1995,2819,2710,109,3.9
48,485,Wichita,1995,60541,57575,2966,4.9
48,487,Wilbarger,1995,7215,6951,264,3.7
48,489,Willacy,1995,7678,6045,1633,21.3
48,491,Williamson,1995,110458,108306,2152,1.9
48,493,Wilson,1995,13207,12798,409,3.1
48,495,Winkler,1995,3066,2822,244,8.0
48,497,Wise,1995,19811,18966,845,4.3
48,499,Wood,1995,13923,13147,776,5.6
48,501,Yoakum,1995,3699,3495,204,5.5
48,503,Young,1995,8749,8117,632,7.2
48,505,Zapata,1995,4262,3731,531,12.5
48,507,Zavala,1995,4679,3474,1205,25.8
49,1,Beaver,1995,2362,2269,93,3.9
49,3,Box Elder,1995,17937,17122,815,4.5
49,5,Cache,1995,41877,40614,1263,3.0
49,7,Carbon,1995,9181,8593,588,6.4
49,9,Daggett,1995,449,421,28,6.2
49,11,Davis,1995,106602,103058,3544,3.3
49,13,Duchesne,1995,5791,5267,524,9.0
49,15,Emery,1995,4250,3920,330,7.8
49,17,Garfield,1995,2655,2329,326,12.3
49,19,Grand,1995,4989,4659,330,6.6
49,21,Iron,1995,13072,12641,431,3.3
49,23,Juab,1995,3363,3202,161,4.8
49,25,Kane,1995,2723,2490,233,8.6
49,27,Millard,1995,4742,4517,225,4.7
49,29,Morgan,1995,3417,3261,156,4.6
49,31,Piute,1995,491,463,28,5.7
49,33,Rich,1995,897,862,35,3.9
49,35,Salt Lake,1995,456747,443301,13446,2.9
49,37,San Juan,1995,5246,4805,441,8.4
49,39,Sanpete,1995,7830,7365,465,5.9
49,41,Sevier,1995,7678,7300,378,4.9
49,43,Summit,1995,12126,11662,464,3.8
49,45,Tooele,1995,11534,10906,628,5.4
49,47,Uintah,1995,10378,9662,716,6.9
49,49,Utah,1995,149864,145663,4201,2.8
49,51,Wasatch,1995,5460,5191,269,4.9
49,53,Washington,1995,32967,31920,1047,3.2
49,55,Wayne,1995,1331,1248,83,6.2
49,57,Weber,1995,92776,88920,3856,4.2
50,1,Addison,1995,18507,17709,798,4.3
50,3,Bennington,1995,19449,18639,810,4.2
50,5,Caledonia,1995,14825,13952,873,5.9
50,7,Chittenden,1995,83407,81079,2328,2.8
50,9,Essex,1995,2849,2649,200,7.0
50,11,Franklin,1995,22229,21204,1025,4.6
50,13,Grand Isle,1995,3075,2892,183,6.0
50,15,Lamoille,1995,11276,10624,652,5.8
50,17,Orange,1995,15077,14538,539,3.6
50,19,Orleans,1995,12516,11470,1046,8.4
50,21,Rutland,1995,32165,30680,1485,4.6
50,23,Washington,1995,30835,29393,1442,4.7
50,25,Windham,1995,23624,22697,927,3.9
50,27,Windsor,1995,30039,29036,1003,3.3
51,1,Accomack,1995,15351,14104,1247,8.1
51,3,Albemarle,1995,36809,36102,707,1.9
51,5,Alleghany,1995,8565,8026,539,6.3
51,7,Amelia,1995,4384,4160,224,5.1
51,9,Amherst,1995,14890,14351,539,3.6
51,11,Appomattox,1995,6019,5660,359,6.0
51,13,Arlington,1995,109514,105682,3832,3.5
51,15,Augusta,1995,30318,28559,1759,5.8
51,17,Bath,1995,2651,2405,246,9.3
51,19,Bedford,1995,31499,30537,962,3.1
51,21,Bland,1995,3580,3346,234,6.5
51,23,Botetourt,1995,15884,15482,402,2.5
51,25,Brunswick,1995,6801,6336,465,6.8
51,27,Buchanan,1995,9561,8285,1276,13.3
51,29,Buckingham,1995,6290,5981,309,4.9
51,31,Campbell,1995,26661,25610,1051,3.9
51,33,Caroline,1995,10170,9422,748,7.4
51,35,Carroll,1995,14090,13417,673,4.8
51,36,Charles City,1995,3663,3453,210,5.7
51,37,Charlotte,1995,5697,5292,405,7.1
51,41,Chesterfield,1995,135892,131780,4112,3.0
51,43,Clarke,1995,6413,6221,192,3.0
51,45,Craig,1995,2434,2322,112,4.6
51,47,Culpeper,1995,15708,15014,694,4.4
51,49,Cumberland,1995,3998,3894,104,2.6
51,51,Dickenson,1995,6255,5052,1203,19.2
51,53,Dinwiddie,1995,11099,10609,490,4.4
51,57,Essex,1995,4626,4269,357,7.7
51,59,Fairfax,1995,512837,498442,14395,2.8
51,61,Fauquier,1995,27078,26212,866,3.2
51,63,Floyd,1995,6457,6134,323,5.0
51,65,Fluvanna,1995,8030,7791,239,3.0
51,67,Franklin,1995,22710,21501,1209,5.3
51,69,Frederick,1995,29787,28507,1280,4.3
51,71,Giles,1995,8447,7842,605,7.2
51,73,Gloucester,1995,16758,16163,595,3.6
51,75,Goochland,1995,8530,8289,241,2.8
51,77,Grayson,1995,8490,8057,433,5.1
51,79,Greene,1995,6730,6535,195,2.9
51,81,Greensville,1995,5450,5119,331,6.1
51,83,Halifax,1995,18217,16862,1355,7.4
51,85,Hanover,1995,42115,41221,894,2.1
51,87,Henrico,1995,133947,130070,3877,2.9
51,89,Henry,1995,30135,27617,2518,8.4
51,91,Highland,1995,1343,1230,113,8.4
51,93,Isle of Wight,1995,14257,13549,708,5.0
51,95,James City,1995,21781,21158,623,2.9
51,97,King and Queen,1995,3227,3072,155,4.8
51,99,King George,1995,8217,7861,356,4.3
51,101,King William,1995,6566,6336,230,3.5
51,103,Lancaster,1995,5261,4537,724,13.8
51,105,Lee,1995,10881,9626,1255,11.5
51,107,Loudoun,1995,68543,66653,1890,2.8
51,109,Louisa,1995,10058,9089,969,9.6
51,111,Lunenburg,1995,4956,4333,623,12.6
51,113,Madison,1995,7098,6879,219,3.1
51,115,Mathews,1995,4398,4239,159,3.6
51,117,Mecklenburg,1995,15259,14209,1050,6.9
51,119,Middlesex,1995,4652,4472,180,3.9
51,121,Montgomery,1995,36998,35821,1177,3.2
51,125,Nelson,1995,6820,6570,250,3.7
51,127,New Kent,1995,6235,6044,191,3.1
51,131,Northampton,1995,5713,5211,502,8.8
51,133,Northumberland,1995,5258,4598,660,12.6
51,135,Nottoway,1995,6557,6193,364,5.6
51,137,Orange,1995,10728,10220,508,4.7
51,139,Page,1995,11936,11054,882,7.4
51,141,Patrick,1995,9187,8602,585,6.4
51,143,Pittsylvania,1995,31838,29159,2679,8.4
51,145,Powhatan,1995,9489,9244,245,2.6
51,147,Prince Edward,1995,8529,8081,448,5.3
51,149,Prince George,1995,12042,11574,468,3.9
51,153,Prince William,1995,129493,125339,4154,3.2
51,155,Pulaski,1995,16997,15957,1040,6.1
51,157,Rappahannock,1995,3987,3794,193,4.8
51,159,Richmond,1995,4007,3760,247,6.2
51,161,Roanoke,1995,48965,47911,1054,2.2
51,163,Rockbridge,1995,9655,9181,474,4.9
51,165,Rockingham,1995,36836,35724,1112,3.0
51,167,Russell,1995,14147,12610,1537,10.9
51,169,Scott,1995,10307,9395,912,8.8
51,171,Shenandoah,1995,17947,16922,1025,5.7
51,173,Smyth,1995,17587,15894,1693,9.6
51,175,Southampton,1995,7702,7373,329,4.3
51,177,Spotsylvania,1995,37400,36106,1294,3.5
51,179,Stafford,1995,40593,39359,1234,3.0
51,181,Surry,1995,2712,2459,253,9.3
51,183,Sussex,1995,5048,4737,311,6.2
51,185,Tazewell,1995,20133,18089,2044,10.2
51,187,Warren,1995,14892,14052,840,5.6
51,191,Washington,1995,26310,24419,1891,7.2
51,193,Westmoreland,1995,7399,6733,666,9.0
51,195,Wise,1995,16242,13503,2739,16.9
51,197,Wythe,1995,14952,13982,970,6.5
51,199,York,1995,26096,25349,747,2.9
51,510,Alexandria city,1995,75375,72090,3285,4.4
51,520,Bristol city,1995,8873,8412,461,5.2
51,530,Buena Vista city,1995,3235,3051,184,5.7
51,540,Charlottesville city,1995,20112,19586,526,2.6
51,550,Chesapeake city,1995,97524,93701,3823,3.9
51,570,Colonial Heights city,1995,9017,8622,395,4.4
51,580,Covington city,1995,3345,3024,321,9.6
51,590,Danville city,1995,27097,24907,2190,8.1
51,595,Emporia city,1995,2680,2476,204,7.6
51,600,Fairfax city,1995,12416,12242,174,1.4
51,610,Falls Church city,1995,5844,5593,251,4.3
51,620,Franklin city,1995,3772,3577,195,5.2
51,630,Fredericksburg city,1995,11325,10851,474,4.2
51,640,Galax city,1995,3415,3284,131,3.8
51,650,Hampton city,1995,66786,63165,3621,5.4
51,660,Harrisonburg city,1995,18008,17594,414,2.3
51,670,Hopewell city,1995,10865,10215,650,6.0
51,678,Lexington city,1995,2796,2720,76,2.7
51,680,Lynchburg city,1995,32066,30846,1220,3.8
51,683,Manassas city,1995,18634,17976,658,3.5
51,685,Manassas Park city,1995,4033,3943,90,2.2
51,690,Martinsville city,1995,7542,6866,676,9.0
51,700,Newport News city,1995,83984,79328,4656,5.5
51,710,Norfolk city,1995,87551,82020,5531,6.3
51,720,Norton city,1995,1663,1460,203,12.2
51,730,Petersburg city,1995,17817,16466,1351,7.6
51,735,Poquoson city,1995,6092,5914,178,2.9
51,740,Portsmouth city,1995,46037,42809,3228,7.0
51,750,Radford city,1995,6820,6557,263,3.9
51,760,Richmond city,1995,100367,95052,5315,5.3
51,770,Roanoke city,1995,50930,49124,1806,3.5
51,775,Salem city,1995,13738,13394,344,2.5
51,790,Staunton city,1995,11303,10732,571,5.1
51,800,Suffolk city,1995,27026,25347,1679,6.2
51,810,Virginia Beach city,1995,208860,200051,8809,4.2
51,820,Waynesboro city,1995,8769,8329,440,5.0
51,830,Williamsburg city,1995,6211,5728,483,7.8
51,840,Winchester city,1995,13471,12819,652,4.8
53,1,Adams,1995,8704,7706,998,11.5
53,3,Asotin,1995,11342,10836,506,4.5
53,5,Benton,1995,72405,66808,5597,7.7
53,7,Chelan,1995,33853,30333,3520,10.4
53,9,Clallam,1995,24376,22225,2151,8.8
53,11,Clark,1995,152785,146348,6437,4.2
53,13,Columbia,1995,1496,1298,198,13.2
53,15,Cowlitz,1995,40663,37491,3172,7.8
53,17,Douglas,1995,18333,16910,1423,7.8
53,19,Ferry,1995,2923,2525,398,13.6
53,21,Franklin,1995,22765,20483,2282,10.0
53,23,Garfield,1995,1032,985,47,4.6
53,25,Grant,1995,33886,30480,3406,10.1
53,27,Grays Harbor,1995,28024,24897,3127,11.2
53,29,Island,1995,25666,24467,1199,4.7
53,31,Jefferson,1995,9887,9143,744,7.5
53,33,King,1995,903354,862474,40880,4.5
53,35,Kitsap,1995,90395,84159,6236,6.9
53,37,Kittitas,1995,15326,13954,1372,9.0
53,39,Klickitat,1995,8794,7731,1063,12.1
53,41,Lewis,1995,29886,27223,2663,8.9
53,43,Lincoln,1995,4719,4424,295,6.3
53,45,Mason,1995,18504,16982,1522,8.2
53,47,Okanogan,1995,23070,20573,2497,10.8
53,49,Pacific,1995,8320,7484,836,10.0
53,51,Pend Oreille,1995,4020,3465,555,13.8
53,53,Pierce,1995,316618,296320,20298,6.4
53,55,San Juan,1995,5630,5248,382,6.8
53,57,Skagit,1995,49263,44744,4519,9.2
53,59,Skamania,1995,4123,3685,438,10.6
53,61,Snohomish,1995,282542,268356,14186,5.0
53,63,Spokane,1995,199365,188229,11136,5.6
53,65,Stevens,1995,16738,15089,1649,9.9
53,67,Thurston,1995,94620,88529,6091,6.4
53,69,Wahkiakum,1995,1681,1569,112,6.7
53,71,Walla Walla,1995,26132,24486,1646,6.3
53,73,Whatcom,1995,79146,73226,5920,7.5
53,75,Whitman,1995,18340,17937,403,2.2
53,77,Yakima,1995,114953,99973,14980,13.0
54,1,Barbour,1995,6381,5502,879,13.8
54,3,Berkeley,1995,32067,30134,1933,6.0
54,5,Boone,1995,8445,7544,901,10.7
54,7,Braxton,1995,5202,4498,704,13.5
54,9,Brooke,1995,11357,10654,703,6.2
54,11,Cabell,1995,42537,40040,2497,5.9
54,13,Calhoun,1995,2761,2117,644,23.3
54,15,Clay,1995,3473,2980,493,14.2
54,17,Doddridge,1995,3033,2778,255,8.4
54,19,Fayette,1995,17917,15965,1952,10.9
54,21,Gilmer,1995,2679,2388,291,10.9
54,23,Grant,1995,4854,4350,504,10.4
54,25,Greenbrier,1995,15179,13637,1542,10.2
54,27,Hampshire,1995,7684,7369,315,4.1
54,29,Hancock,1995,14994,14062,932,6.2
54,31,Hardy,1995,6878,6570,308,4.5
54,33,Harrison,1995,32344,29519,2825,8.7
54,35,Jackson,1995,12609,11574,1035,8.2
54,37,Jefferson,1995,19744,18876,868,4.4
54,39,Kanawha,1995,102262,96336,5926,5.8
54,41,Lewis,1995,7129,6296,833,11.7
54,43,Lincoln,1995,6957,6037,920,13.2
54,45,Logan,1995,14520,12724,1796,12.4
54,47,McDowell,1995,8148,7120,1028,12.6
54,49,Marion,1995,24239,22078,2161,8.9
54,51,Marshall,1995,16080,14844,1236,7.7
54,53,Mason,1995,9802,8655,1147,11.7
54,55,Mercer,1995,27760,26161,1599,5.8
54,57,Mineral,1995,11630,10892,738,6.3
54,59,Mingo,1995,10054,8661,1393,13.9
54,61,Monongalia,1995,38159,36487,1672,4.4
54,63,Monroe,1995,5074,4717,357,7.0
54,65,Morgan,1995,5901,5555,346,5.9
54,67,Nicholas,1995,10271,9226,1045,10.2
54,69,Ohio,1995,24202,22961,1241,5.1
54,71,Pendleton,1995,3805,3619,186,4.9
54,73,Pleasants,1995,3076,2753,323,10.5
54,75,Pocahontas,1995,4291,3527,764,17.8
54,77,Preston,1995,12672,11594,1078,8.5
54,79,Putnam,1995,24041,22701,1340,5.6
54,81,Raleigh,1995,32579,29849,2730,8.4
54,83,Randolph,1995,13134,11646,1488,11.3
54,85,Ritchie,1995,4305,3722,583,13.5
54,87,Roane,1995,6190,5311,879,14.2
54,89,Summers,1995,4422,3911,511,11.6
54,91,Taylor,1995,6578,5948,630,9.6
54,93,Tucker,1995,3831,3390,441,11.5
54,95,Tyler,1995,4125,3771,354,8.6
54,97,Upshur,1995,10206,8869,1337,13.1
54,99,Wayne,1995,16645,15389,1256,7.5
54,101,Webster,1995,3104,2689,415,13.4
54,103,Wetzel,1995,7527,6665,862,11.5
54,105,Wirt,1995,2097,1756,341,16.3
54,107,Wood,1995,43587,40341,3246,7.4
54,109,Wyoming,1995,7960,7085,875,11.0
55,1,Adams,1995,7054,6700,354,5.0
55,3,Ashland,1995,8019,7493,526,6.6
55,5,Barron,1995,23584,22447,1137,4.8
55,7,Bayfield,1995,7401,6906,495,6.7
55,9,Brown,1995,126967,122891,4076,3.2
55,11,Buffalo,1995,7782,7463,319,4.1
55,13,Burnett,1995,7010,6690,320,4.6
55,15,Calumet,1995,24502,23385,1117,4.6
55,17,Chippewa,1995,29027,27690,1337,4.6
55,19,Clark,1995,16928,15810,1118,6.6
55,21,Columbia,1995,26894,25480,1414,5.3
55,23,Crawford,1995,9350,8877,473,5.1
55,25,Dane,1995,250365,245904,4461,1.8
55,27,Dodge,1995,46135,44658,1477,3.2
55,29,Door,1995,14981,13974,1007,6.7
55,31,Douglas,1995,22105,20828,1277,5.8
55,33,Dunn,1995,22150,21353,797,3.6
55,35,Eau Claire,1995,48896,47311,1585,3.2
55,37,Florence,1995,1599,1514,85,5.3
55,39,Fond du Lac,1995,55231,53386,1845,3.3
55,41,Forest,1995,4398,4102,296,6.7
55,43,Grant,1995,25716,24498,1218,4.7
55,45,Green,1995,18985,18392,593,3.1
55,47,Green Lake,1995,10726,10234,492,4.6
55,49,Iowa,1995,13349,12828,521,3.9
55,51,Iron,1995,3154,2926,228,7.2
55,53,Jackson,1995,9709,9202,507,5.2
55,55,Jefferson,1995,41400,40069,1331,3.2
55,57,Juneau,1995,10987,10293,694,6.3
55,59,Kenosha,1995,76647,73737,2910,3.8
55,61,Kewaunee,1995,10390,9987,403,3.9
55,63,La Crosse,1995,59936,57712,2224,3.7
55,65,Lafayette,1995,8370,8039,331,4.0
55,67,Langlade,1995,9656,9065,591,6.1
55,69,Lincoln,1995,15543,14582,961,6.2
55,71,Manitowoc,1995,45269,43166,2103,4.6
55,73,Marathon,1995,70501,67342,3159,4.5
55,75,Marinette,1995,20073,18919,1154,5.7
55,77,Marquette,1995,6792,6298,494,7.3
55,78,Menominee,1995,2051,1877,174,8.5
55,79,Milwaukee,1995,480801,461610,19191,4.0
55,81,Monroe,1995,19976,19018,958,4.8
55,83,Oconto,1995,14916,14005,911,6.1
55,85,Oneida,1995,19691,18805,886,4.5
55,87,Outagamie,1995,97155,94296,2859,2.9
55,89,Ozaukee,1995,46611,45483,1128,2.4
55,91,Pepin,1995,3502,3334,168,4.8
55,93,Pierce,1995,19915,19296,619,3.1
55,95,Polk,1995,20385,19511,874,4.3
55,97,Portage,1995,36832,35143,1689,4.6
55,99,Price,1995,7844,7424,420,5.4
55,101,Racine,1995,93146,89069,4077,4.4
55,103,Richland,1995,8839,8466,373,4.2
55,105,Rock,1995,79091,75918,3173,4.0
55,107,Rusk,1995,7240,6696,544,7.5
55,109,St. Croix,1995,30733,29801,932,3.0
55,111,Sauk,1995,32243,30967,1276,4.0
55,113,Sawyer,1995,8870,8361,509,5.7
55,115,Shawano,1995,20392,19394,998,4.9
55,117,Sheboygan,1995,61458,59786,1672,2.7
55,119,Taylor,1995,10766,10081,685,6.4
55,121,Trempealeau,1995,14310,13555,755,5.3
55,123,Vernon,1995,13650,12992,658,4.8
55,125,Vilas,1995,10491,9995,496,4.7
55,127,Walworth,1995,51268,49946,1322,2.6
55,129,Washburn,1995,7333,6845,488,6.7
55,131,Washington,1995,63814,61951,1863,2.9
55,133,Waukesha,1995,200345,195042,5303,2.6
55,135,Waupaca,1995,25860,24730,1130,4.4
55,137,Waushara,1995,9756,9208,548,5.6
55,139,Winnebago,1995,94813,92035,2778,2.9
55,141,Wood,1995,39628,37961,1667,4.2
56,1,Albany,1995,16588,16226,362,2.2
56,3,Big Horn,1995,5102,4806,296,5.8
56,5,Campbell,1995,18212,17350,862,4.7
56,7,Carbon,1995,8627,8171,456,5.3
56,9,Converse,1995,6337,6003,334,5.3
56,11,Crook,1995,3023,2899,124,4.1
56,13,Fremont,1995,17402,16122,1280,7.4
56,15,Goshen,1995,6384,6103,281,4.4
56,17,Hot Springs,1995,2406,2292,114,4.7
56,19,Johnson,1995,3560,3426,134,3.8
56,21,Laramie,1995,38786,37348,1438,3.7
56,23,Lincoln,1995,6324,5859,465,7.4
56,25,Natrona,1995,32489,30642,1847,5.7
56,27,Niobrara,1995,1225,1197,28,2.3
56,29,Park,1995,15113,14486,627,4.1
56,31,Platte,1995,4166,3987,179,4.3
56,33,Sheridan,1995,13565,12922,643,4.7
56,35,Sublette,1995,2994,2882,112,3.7
56,37,Sweetwater,1995,21530,20390,1140,5.3
56,39,Teton,1995,10420,10180,240,2.3
56,41,Uinta,1995,10827,10098,729,6.7
56,43,Washakie,1995,4791,4488,303,6.3
56,45,Weston,1995,3346,3184,162,4.8
72,1,Adjuntas Municipio,1995,5657,4899,758,13.4
72,3,Aguada Municipio,1995,14230,11589,2641,18.6
72,5,Aguadilla Municipio,1995,21406,17631,3775,17.6
72,7,Aguas Buenas Municipio,1995,8628,7456,1172,13.6
72,9,Aibonito Municipio,1995,10734,9651,1083,10.1
72,11,Anasco Municipio,1995,10201,8501,1700,16.7
72,13,Arecibo Municipio,1995,30803,25458,5345,17.4
72,15,Arroyo Municipio,1995,5098,4044,1054,20.7
72,17,Barceloneta Municipio,1995,7493,6206,1287,17.2
72,19,Barranquitas Municipio,1995,7455,6478,977,13.1
72,21,Bayamon Municipio,1995,84461,76604,7857,9.3
72,23,Cabo Rojo Municipio,1995,15475,13554,1921,12.4
72,25,Caguas Municipio,1995,54451,47926,6525,12.0
72,27,Camuy Municipio,1995,9537,8106,1431,15.0
72,29,Canovanas Municipio,1995,16053,13861,2192,13.7
72,31,Carolina Municipio,1995,76187,69082,7105,9.3
72,33,Catano Municipio,1995,9762,8753,1009,10.3
72,35,Cayey Municipio,1995,16060,13647,2413,15.0
72,37,Ceiba Municipio,1995,5595,4709,886,15.8
72,39,Ciales Municipio,1995,5042,3511,1531,30.4
72,41,Cidra Municipio,1995,14342,12662,1680,11.7
72,43,Coamo Municipio,1995,9040,7517,1523,16.8
72,45,Comerio Municipio,1995,5214,4563,651,12.5
72,47,Corozal Municipio,1995,9560,8431,1129,11.8
72,49,Culebra Municipio,1995,756,721,35,4.6
72,51,Dorado Municipio,1995,10243,9011,1232,12.0
72,53,Fajardo Municipio,1995,13236,10790,2446,18.5
72,54,Florida Municipio,1995,2654,2121,533,20.1
72,55,Guanica Municipio,1995,5795,4473,1322,22.8
72,57,Guayama Municipio,1995,11176,8552,2624,23.5
72,59,Guayanilla Municipio,1995,7413,6098,1315,17.7
72,61,Guaynabo Municipio,1995,40074,37681,2393,6.0
72,63,Gurabo Municipio,1995,10472,9018,1454,13.9
72,65,Hatillo Municipio,1995,10969,9215,1754,16.0
72,67,Hormigueros Municipio,1995,6888,5924,964,14.0
72,69,Humacao Municipio,1995,19378,16454,2924,15.1
72,71,Isabela Municipio,1995,14030,11101,2929,20.9
72,73,Jayuya Municipio,1995,3864,3327,537,13.9
72,75,Juana Diaz Municipio,1995,13036,10568,2468,18.9
72,77,Juncos Municipio,1995,11739,10041,1698,14.5
72,79,Lajas Municipio,1995,8605,7308,1297,15.1
72,81,Lares Municipio,1995,8601,7101,1500,17.4
72,83,Las Marias Municipio,1995,3099,2531,568,18.3
72,85,Las Piedras Municipio,1995,9825,8319,1506,15.3
72,87,Loiza Municipio,1995,8190,7164,1026,12.5
72,89,Luquillo Municipio,1995,6413,5162,1251,19.5
72,91,Manati Municipio,1995,12980,10541,2439,18.8
72,93,Maricao Municipio,1995,2268,1865,403,17.8
72,95,Maunabo Municipio,1995,3191,2487,704,22.1
72,97,Mayaguez Municipio,1995,35629,30506,5123,14.4
72,99,Moca Municipio,1995,12141,9915,2226,18.3
72,101,Morovis Municipio,1995,9314,7898,1416,15.2
72,103,Naguabo Municipio,1995,6668,5526,1142,17.1
72,105,Naranjito Municipio,1995,7187,6101,1086,15.1
72,107,Orocovis Municipio,1995,5701,4529,1172,20.6
72,109,Patillas Municipio,1995,5648,4394,1254,22.2
72,111,Penuelas Municipio,1995,7237,5908,1329,18.4
72,113,Ponce Municipio,1995,59327,49832,9495,16.0
72,115,Quebradillas Municipio,1995,7662,6545,1117,14.6
72,117,Rincon Municipio,1995,5539,4714,825,14.9
72,119,Rio Grande Municipio,1995,16713,14059,2654,15.9
72,121,Sabana Grande Municipio,1995,8440,7182,1258,14.9
72,123,Salinas Municipio,1995,8183,5979,2204,26.9
72,125,San German Municipio,1995,13257,10974,2283,17.2
72,127,San Juan Municipio,1995,160114,144511,15603,9.7
72,129,San Lorenzo Municipio,1995,11788,9655,2133,18.1
72,131,San Sebastian Municipio,1995,13366,10214,3152,23.6
72,133,Santa Isabel Municipio,1995,5185,3742,1443,27.8
72,135,Toa Alta Municipio,1995,18425,16722,1703,9.2
72,137,Toa Baja Municipio,1995,33331,30238,3093,9.3
72,139,Trujillo Alto Municipio,1995,27536,25390,2146,7.8
72,141,Utuado Municipio,1995,7994,6882,1112,13.9
72,143,Vega Alta Municipio,1995,11389,9703,1686,14.8
72,145,Vega Baja Municipio,1995,18558,15783,2775,15.0
72,147,Vieques Municipio,1995,2512,2166,346,13.8
72,149,Villalba Municipio,1995,6042,4716,1326,21.9
72,151,Yabucoa Municipio,1995,11825,9552,2273,19.2
72,153,Yauco Municipio,1995,13101,10728,2373,18.1
1,1,Autauga,1996,20263,19474,789,3.9
1,3,Baldwin,1996,63985,61145,2840,4.4
1,5,Barbour,1996,12515,11322,1193,9.5
1,7,Bibb,1996,7888,7326,562,7.1
1,9,Blount,1996,21685,20974,711,3.3
1,11,Bullock,1996,4560,3893,667,14.6
1,13,Butler,1996,9970,9055,915,9.2
1,15,Calhoun,1996,52929,49628,3301,6.2
1,17,Chambers,1996,16842,15975,867,5.1
1,19,Cherokee,1996,10510,10049,461,4.4
1,21,Chilton,1996,17655,16798,857,4.9
1,23,Choctaw,1996,6303,5425,878,13.9
1,25,Clarke,1996,14744,13435,1309,8.9
1,27,Clay,1996,6616,6291,325,4.9
1,29,Cleburne,1996,7112,6798,314,4.4
1,31,Coffee,1996,21510,20430,1080,5.0
1,33,Colbert,1996,26914,25053,1861,6.9
1,35,Conecuh,1996,6937,6077,860,12.4
1,37,Coosa,1996,5327,5070,257,4.8
1,39,Covington,1996,17628,16221,1407,8.0
1,41,Crenshaw,1996,6047,5499,548,9.1
1,43,Cullman,1996,37549,35770,1779,4.7
1,45,Dale,1996,21005,19894,1111,5.3
1,47,Dallas,1996,20213,17705,2508,12.4
1,49,DeKalb,1996,31661,29831,1830,5.8
1,51,Elmore,1996,27378,26329,1049,3.8
1,53,Escambia,1996,16360,15350,1010,6.2
1,55,Etowah,1996,48861,46232,2629,5.4
1,57,Fayette,1996,8507,8148,359,4.2
1,59,Franklin,1996,16542,15339,1203,7.3
1,61,Geneva,1996,11911,10902,1009,8.5
1,63,Greene,1996,3585,2937,648,18.1
1,65,Hale,1996,7151,6566,585,8.2
1,67,Henry,1996,6455,6020,435,6.7
1,69,Houston,1996,43466,41640,1826,4.2
1,71,Jackson,1996,25975,23526,2449,9.4
1,73,Jefferson,1996,327151,315627,11524,3.5
1,75,Lamar,1996,7919,7386,533,6.7
1,77,Lauderdale,1996,43297,40740,2557,5.9
1,79,Lawrence,1996,15808,14765,1043,6.6
1,81,Lee,1996,47611,46062,1549,3.3
1,83,Limestone,1996,27468,26194,1274,4.6
1,85,Lowndes,1996,4302,3672,630,14.6
1,87,Macon,1996,8224,7582,642,7.8
1,89,Madison,1996,135873,131409,4464,3.3
1,91,Marengo,1996,11157,10112,1045,9.4
1,93,Marion,1996,15885,14707,1178,7.4
1,95,Marshall,1996,39631,37315,2316,5.8
1,97,Mobile,1996,193735,182944,10791,5.6
1,99,Monroe,1996,10642,9041,1601,15.0
1,101,Montgomery,1996,107929,103377,4552,4.2
1,103,Morgan,1996,53811,51245,2566,4.8
1,105,Perry,1996,4509,3939,570,12.6
1,107,Pickens,1996,8894,8062,832,9.4
1,109,Pike,1996,13537,12643,894,6.6
1,111,Randolph,1996,9661,9087,574,5.9
1,113,Russell,1996,25081,23919,1162,4.6
1,115,St. Clair,1996,28578,27645,933,3.3
1,117,Shelby,1996,71941,70538,1403,2.0
1,119,Sumter,1996,6217,5438,779,12.5
1,121,Talladega,1996,35749,32913,2836,7.9
1,123,Tallapoosa,1996,20526,19326,1200,5.8
1,125,Tuscaloosa,1996,78151,75339,2812,3.6
1,127,Walker,1996,30371,28397,1974,6.5
1,129,Washington,1996,6194,5493,701,11.3
1,131,Wilcox,1996,3883,3335,548,14.1
1,133,Winston,1996,13067,12243,824,6.3
2,13,Aleutians East Borough,1996,1603,1537,66,4.1
2,16,Aleutians West Census Area,1996,2319,2230,89,3.8
2,20,Anchorage Borough/municipality,1996,134880,127872,7008,5.2
2,50,Bethel Census Area,1996,5916,5375,541,9.1
2,60,Bristol Bay Borough,1996,583,543,40,6.9
2,68,Denali Borough,1996,1205,1102,103,8.5
2,70,Dillingham Census Area,1996,1699,1571,128,7.5
2,90,Fairbanks North Star Borough,1996,42624,39525,3099,7.3
2,100,Haines Borough,1996,1175,1045,130,11.1
2,110,Juneau Borough/city,1996,17026,16032,994,5.8
2,122,Kenai Peninsula Borough,1996,22109,19166,2943,13.3
2,130,Ketchikan Gateway Borough,1996,7893,7241,652,8.3
2,150,Kodiak Island Borough,1996,7416,6750,666,9.0
2,158,Kusilvak Census Area,1996,1925,1728,197,10.2
2,164,Lake and Peninsula Borough,1996,587,542,45,7.7
2,170,Matanuska-Susitna Borough,1996,26679,23933,2746,10.3
2,180,Nome Census Area,1996,3398,2978,420,12.4
2,185,North Slope Borough,1996,3233,3084,149,4.6
2,188,Northwest Arctic Borough,1996,2246,1851,395,17.6
2,201,Prince of Wales-Outer Ketchikan Census Area,1996,3411,2976,435,12.8
2,220,Sitka Borough/city,1996,4507,4219,288,6.4
2,232,Skagway-Hoonah-Angoon Census Area,1996,2255,2122,133,5.9
2,240,Southeast Fairbanks Census Area,1996,2496,2170,326,13.1
2,261,Valdez-Cordova Census Area,1996,5307,4750,557,10.5
2,280,Wrangell-Petersburg Census Area,1996,3690,3307,383,10.4
2,282,Yakutat Borough/city,1996,320,301,19,5.9
2,290,Yukon-Koyukuk Census Area,1996,2065,1712,353,17.1
4,1,Apache,1996,20609,16561,4048,19.6
4,3,Cochise,1996,43706,39451,4255,9.7
4,5,Coconino,1996,59171,54026,5145,8.7
4,7,Gila,1996,19325,17664,1661,8.6
4,9,Graham,1996,11425,10285,1140,10.0
4,11,Greenlee,1996,4948,4559,389,7.9
4,12,La Paz,1996,7010,6214,796,11.4
4,13,Maricopa,1996,1429843,1377933,51910,3.6
4,15,Mohave,1996,63183,58620,4563,7.2
4,17,Navajo,1996,33343,28038,5305,15.9
4,19,Pima,1996,385769,371272,14497,3.8
4,21,Pinal,1996,57180,53810,3370,5.9
4,23,Santa Cruz,1996,15610,11595,4015,25.7
4,25,Yavapai,1996,65869,62731,3138,4.8
4,27,Yuma,1996,70159,48686,21473,30.6
5,1,Arkansas,1996,10756,10172,584,5.4
5,3,Ashley,1996,11375,10630,745,6.5
5,5,Baxter,1996,14554,13961,593,4.1
5,7,Benton,1996,64613,62810,1803,2.8
5,9,Boone,1996,14964,14176,788,5.3
5,11,Bradley,1996,5041,4509,532,10.6
5,13,Calhoun,1996,2272,2089,183,8.1
5,15,Carroll,1996,11842,11207,635,5.4
5,17,Chicot,1996,6490,5882,608,9.4
5,19,Clark,1996,11890,11575,315,2.6
5,21,Clay,1996,8105,7557,548,6.8
5,23,Cleburne,1996,9180,8680,500,5.4
5,25,Cleveland,1996,3871,3642,229,5.9
5,27,Columbia,1996,11695,10937,758,6.5
5,29,Conway,1996,9755,9267,488,5.0
5,31,Craighead,1996,41160,39543,1617,3.9
5,33,Crawford,1996,23752,22602,1150,4.8
5,35,Crittenden,1996,22419,21198,1221,5.4
5,37,Cross,1996,8795,8307,488,5.5
5,39,Dallas,1996,3730,3443,287,7.7
5,41,Desha,1996,7355,6581,774,10.5
5,43,Drew,1996,10275,9507,768,7.5
5,45,Faulkner,1996,40174,38440,1734,4.3
5,47,Franklin,1996,8376,8053,323,3.9
5,49,Fulton,1996,4545,4306,239,5.3
5,51,Garland,1996,35765,34089,1676,4.7
5,53,Grant,1996,7250,6932,318,4.4
5,55,Greene,1996,18149,17089,1060,5.8
5,57,Hempstead,1996,11797,10861,936,7.9
5,59,Hot Spring,1996,12131,11548,583,4.8
5,61,Howard,1996,7206,6798,408,5.7
5,63,Independence,1996,16842,15799,1043,6.2
5,65,Izard,1996,3943,3575,368,9.3
5,67,Jackson,1996,8215,7307,908,11.1
5,69,Jefferson,1996,37276,34517,2759,7.4
5,71,Johnson,1996,10656,10248,408,3.8
5,73,Lafayette,1996,3510,3248,262,7.5
5,75,Lawrence,1996,7953,7330,623,7.8
5,77,Lee,1996,4694,4159,535,11.4
5,79,Lincoln,1996,5349,4971,378,7.1
5,81,Little River,1996,5765,5320,445,7.7
5,83,Logan,1996,10264,9769,495,4.8
5,85,Lonoke,1996,24550,23572,978,4.0
5,87,Madison,1996,6724,6491,233,3.5
5,89,Marion,1996,6185,5886,299,4.8
5,91,Miller,1996,17351,16265,1086,6.3
5,93,Mississippi,1996,27273,24878,2395,8.8
5,95,Monroe,1996,4358,3985,373,8.6
5,97,Montgomery,1996,4049,3885,164,4.1
5,99,Nevada,1996,5089,4705,384,7.5
5,101,Newton,1996,2926,2736,190,6.5
5,103,Ouachita,1996,11938,10723,1215,10.2
5,105,Perry,1996,4037,3785,252,6.2
5,107,Phillips,1996,10624,9540,1084,10.2
5,109,Pike,1996,5047,4762,285,5.6
5,111,Poinsett,1996,11210,10469,741,6.6
5,113,Polk,1996,9057,8655,402,4.4
5,115,Pope,1996,26826,25671,1155,4.3
5,117,Prairie,1996,4026,3657,369,9.2
5,119,Pulaski,1996,194689,187498,7191,3.7
5,121,Randolph,1996,7962,6869,1093,13.7
5,123,St. Francis,1996,12600,11245,1355,10.8
5,125,Saline,1996,39830,38738,1092,2.7
5,127,Scott,1996,4998,4833,165,3.3
5,129,Searcy,1996,2951,2762,189,6.4
5,131,Sebastian,1996,55795,53126,2669,4.8
5,133,Sevier,1996,6861,6436,425,6.2
5,135,Sharp,1996,5963,5570,393,6.6
5,137,Stone,1996,5031,4757,274,5.4
5,139,Union,1996,21196,19712,1484,7.0
5,141,Van Buren,1996,6346,5943,403,6.4
5,143,Washington,1996,74316,72201,2115,2.8
5,145,White,1996,30223,28436,1787,5.9
5,147,Woodruff,1996,4309,3923,386,9.0
5,149,Yell,1996,9498,9170,328,3.5
6,1,Alameda,1996,676460,641796,34664,5.1
6,3,Alpine,1996,487,438,49,10.1
6,5,Amador,1996,13199,12296,903,6.8
6,7,Butte,1996,82505,74918,7587,9.2
6,9,Calaveras,1996,14043,12718,1325,9.4
6,11,Colusa,1996,8593,6870,1723,20.1
6,13,Contra Costa,1996,456576,433523,23053,5.0
6,15,Del Norte,1996,10141,9076,1065,10.5
6,17,El Dorado,1996,73795,69049,4746,6.4
6,19,Fresno,1996,369326,319655,49671,13.4
6,21,Glenn,1996,11372,9621,1751,15.4
6,23,Humboldt,1996,59873,55226,4647,7.8
6,25,Imperial,1996,57453,40161,17292,30.1
6,27,Inyo,1996,7243,6614,629,8.7
6,29,Kern,1996,276884,240699,36185,13.1
6,31,Kings,1996,42881,37159,5722,13.3
6,33,Lake,1996,23542,20766,2776,11.8
6,35,Lassen,1996,11707,10424,1283,11.0
6,37,Los Angeles,1996,4328370,3975414,352956,8.2
6,39,Madera,1996,51940,44497,7443,14.3
6,41,Marin,1996,128282,123799,4483,3.5
6,43,Mariposa,1996,7468,6792,676,9.1
6,45,Mendocino,1996,41874,38200,3674,8.8
6,47,Merced,1996,81656,67968,13688,16.8
6,49,Modoc,1996,4140,3633,507,12.2
6,51,Mono,1996,6039,5380,659,10.9
6,53,Monterey,1996,177428,157183,20245,11.4
6,55,Napa,1996,57898,54355,3543,6.1
6,57,Nevada,1996,40093,37281,2812,7.0
6,59,Orange,1996,1331313,1275059,56254,4.2
6,61,Placer,1996,105654,99867,5787,5.5
6,63,Plumas,1996,9894,8676,1218,12.3
6,65,Riverside,1996,612312,560729,51583,8.4
6,67,Sacramento,1996,538410,504735,33675,6.3
6,69,San Benito,1996,24682,21720,2962,12.0
6,71,San Bernardino,1996,682675,631685,50990,7.5
6,73,San Diego,1996,1233562,1166670,66892,5.4
6,75,San Francisco/city,1996,396938,377625,19313,4.9
6,77,San Joaquin,1996,239726,212190,27536,11.5
6,79,San Luis Obispo,1996,101821,96015,5806,5.7
6,81,San Mateo,1996,373499,360590,12909,3.5
6,83,Santa Barbara,1996,189905,178739,11166,5.9
6,85,Santa Clara,1996,888999,856031,32968,3.7
6,87,Santa Cruz,1996,137987,126117,11870,8.6
6,89,Shasta,1996,71727,64448,7279,10.1
6,91,Sierra,1996,1725,1529,196,11.4
6,93,Siskiyou,1996,18580,16009,2571,13.8
6,95,Solano,1996,172970,159455,13515,7.8
6,97,Sonoma,1996,228503,218150,10353,4.5
6,99,Stanislaus,1996,194342,166173,28169,14.5
6,101,Sutter,1996,34197,28666,5531,16.2
6,103,Tehama,1996,22826,20358,2468,10.8
6,105,Trinity,1996,5145,4383,762,14.8
6,107,Tulare,1996,159074,133061,26013,16.4
6,109,Tuolumne,1996,19503,17481,2022,10.4
6,111,Ventura,1996,375646,348151,27495,7.3
6,113,Yolo,1996,86007,80407,5600,6.5
6,115,Yuba,1996,20865,17880,2985,14.3
8,1,Adams,1996,168160,161159,7001,4.2
8,3,Alamosa,1996,8183,7698,485,5.9
8,5,Arapahoe,1996,269937,261422,8515,3.2
8,7,Archuleta,1996,3870,3666,204,5.3
8,9,Baca,1996,2277,2229,48,2.1
8,11,Bent,1996,2244,2155,89,4.0
8,13,Boulder,1996,153621,147779,5842,3.8
8,14,Broomfield/city,1996,17439,16948,491,2.8
8,15,Chaffee,1996,7427,7085,342,4.6
8,17,Cheyenne,1996,1230,1199,31,2.5
8,19,Clear Creek,1996,5213,5007,206,4.0
8,21,Conejos,1996,3701,3382,319,8.6
8,23,Costilla,1996,1596,1425,171,10.7
8,25,Crowley,1996,1346,1275,71,5.3
8,27,Custer,1996,1703,1626,77,4.5
8,29,Delta,1996,10348,9675,673,6.5
8,31,Denver/city,1996,278524,264845,13679,4.9
8,33,Dolores,1996,659,581,78,11.8
8,35,Douglas,1996,66576,65156,1420,2.1
8,37,Eagle,1996,18509,17946,563,3.0
8,39,Elbert,1996,9482,9118,364,3.8
8,41,El Paso,1996,245807,234566,11241,4.6
8,43,Fremont,1996,16639,15812,827,5.0
8,45,Garfield,1996,21069,20117,952,4.5
8,47,Gilpin,1996,3262,3169,93,2.9
8,49,Grand,1996,5665,5486,179,3.2
8,51,Gunnison,1996,7796,7320,476,6.1
8,53,Hinsdale,1996,588,579,9,1.5
8,55,Huerfano,1996,3375,3155,220,6.5
8,57,Jackson,1996,900,841,59,6.6
8,59,Jefferson,1996,296893,286836,10057,3.4
8,61,Kiowa,1996,843,824,19,2.3
8,63,Kit Carson,1996,3533,3409,124,3.5
8,65,Lake,1996,3176,2974,202,6.4
8,67,La Plata,1996,24141,22985,1156,4.8
8,69,Larimer,1996,135072,129964,5108,3.8
8,71,Las Animas,1996,6584,5955,629,9.6
8,73,Lincoln,1996,2586,2529,57,2.2
8,75,Logan,1996,10024,9660,364,3.6
8,77,Mesa,1996,55815,52841,2974,5.3
8,79,Mineral,1996,406,373,33,8.1
8,81,Moffat,1996,6710,6297,413,6.2
8,83,Montezuma,1996,11541,10745,796,6.9
8,85,Montrose,1996,15094,14017,1077,7.1
8,87,Morgan,1996,12977,12488,489,3.8
8,89,Otero,1996,9180,8636,544,5.9
8,91,Ouray,1996,1707,1605,102,6.0
8,93,Park,1996,7595,7256,339,4.5
8,95,Phillips,1996,1989,1948,41,2.1
8,97,Pitkin,1996,9170,8760,410,4.5
8,99,Prowers,1996,6625,6349,276,4.2
8,101,Pueblo,1996,58740,55291,3449,5.9
8,103,Rio Blanco,1996,3287,3104,183,5.6
8,105,Rio Grande,1996,5286,4765,521,9.9
8,107,Routt,1996,10611,10195,416,3.9
8,109,Saguache,1996,2783,2469,314,11.3
8,111,San Juan,1996,272,231,41,15.1
8,113,San Miguel,1996,4331,4119,212,4.9
8,115,Sedgwick,1996,1230,1184,46,3.7
8,117,Summit,1996,11861,11577,284,2.4
8,119,Teller,1996,13257,12607,650,4.9
8,121,Washington,1996,2397,2338,59,2.5
8,123,Weld,1996,80593,76854,3739,4.6
8,125,Yuma,1996,4406,4312,94,2.1
9,1,Fairfield,1996,450965,430938,20027,4.4
9,3,Hartford,1996,432046,407109,24937,5.8
9,5,Litchfield,1996,100876,96475,4401,4.4
9,7,Middlesex,1996,83347,78986,4361,5.2
9,9,New Haven,1996,419716,396185,23531,5.6
9,11,New London,1996,134416,127198,7218,5.4
9,13,Tolland,1996,70795,67814,2981,4.2
9,15,Windham,1996,57078,53455,3623,6.3
10,1,Kent,1996,70087,66630,3457,4.9
10,3,New Castle,1996,249789,236894,12895,5.2
10,5,Sussex,1996,68961,65965,2996,4.3
11,1,District of Colu,1996,290648,266160,24488,8.4
12,1,Alachua,1996,103939,100904,3035,2.9
12,3,Baker,1996,8619,8178,441,5.1
12,5,Bay,1996,66339,62172,4167,6.3
12,7,Bradford,1996,9996,9620,376,3.8
12,9,Brevard,1996,205490,193826,11664,5.7
12,11,Broward,1996,760134,719200,40934,5.4
12,13,Calhoun,1996,5012,4767,245,4.9
12,15,Charlotte,1996,46020,44009,2011,4.4
12,17,Citrus,1996,35713,33406,2307,6.5
12,19,Clay,1996,66218,64170,2048,3.1
12,21,Collier,1996,86102,80887,5215,6.1
12,23,Columbia,1996,23998,22778,1220,5.1
12,27,DeSoto,1996,10217,9449,768,7.5
12,29,Dixie,1996,3998,3653,345,8.6
12,31,Duval,1996,378961,363959,15002,4.0
12,33,Escambia,1996,122869,117581,5288,4.3
12,35,Flagler,1996,16141,15592,549,3.4
12,37,Franklin,1996,4468,4144,324,7.3
12,39,Gadsden,1996,20066,19068,998,5.0
12,41,Gilchrist,1996,4558,4361,197,4.3
12,43,Glades,1996,4218,3840,378,9.0
12,45,Gulf,1996,5798,5382,416,7.2
12,47,Hamilton,1996,3819,3516,303,7.9
12,49,Hardee,1996,11420,9795,1625,14.2
12,51,Hendry,1996,16605,14159,2446,14.7
12,53,Hernando,1996,44758,42654,2104,4.7
12,55,Highlands,1996,28595,26089,2506,8.8
12,57,Hillsborough,1996,513967,493407,20560,4.0
12,59,Holmes,1996,7004,6504,500,7.1
12,61,Indian River,1996,44220,40049,4171,9.4
12,63,Jackson,1996,19181,18277,904,4.7
12,65,Jefferson,1996,5449,5181,268,4.9
12,67,Lafayette,1996,2695,2614,81,3.0
12,69,Lake,1996,81631,77852,3779,4.6
12,71,Lee,1996,174740,167828,6912,4.0
12,73,Leon,1996,126333,122541,3792,3.0
12,75,Levy,1996,13228,12624,604,4.6
12,77,Liberty,1996,2475,2404,71,2.9
12,79,Madison,1996,7440,7083,357,4.8
12,81,Manatee,1996,113095,108980,4115,3.6
12,83,Marion,1996,94777,89964,4813,5.1
12,85,Martin,1996,47642,44028,3614,7.6
12,86,Miami-Dade,1996,1069620,991441,78179,7.3
12,87,Monroe,1996,45596,44317,1279,2.8
12,89,Nassau,1996,26843,25704,1139,4.2
12,91,Okaloosa,1996,77481,74359,3122,4.0
12,93,Okeechobee,1996,17583,15817,1766,10.0
12,95,Orange,1996,447259,429582,17677,4.0
12,97,Osceola,1996,75328,72364,2964,3.9
12,99,Palm Beach,1996,483879,450302,33577,6.9
12,101,Pasco,1996,127784,121372,6412,5.0
12,103,Pinellas,1996,452499,434821,17678,3.9
12,105,Polk,1996,201275,187307,13968,6.9
12,107,Putnam,1996,28875,27227,1648,5.7
12,109,St. Johns,1996,55861,54178,1683,3.0
12,111,St. Lucie,1996,78072,68070,10002,12.8
12,113,Santa Rosa,1996,49762,47952,1810,3.6
12,115,Sarasota,1996,142562,137994,4568,3.2
12,117,Seminole,1996,199641,192247,7394,3.7
12,119,Sumter,1996,14334,13662,672,4.7
12,121,Suwannee,1996,13303,12679,624,4.7
12,123,Taylor,1996,7842,7045,797,10.2
12,125,Union,1996,3980,3785,195,4.9
12,127,Volusia,1996,177540,169588,7952,4.5
12,129,Wakulla,1996,9869,9432,437,4.4
12,131,Walton,1996,15257,14564,693,4.5
12,133,Washington,1996,9286,8720,566,6.1
13,1,Appling,1996,8275,7488,787,9.5
13,3,Atkinson,1996,3184,2954,230,7.2
13,5,Bacon,1996,4674,4380,294,6.3
13,7,Baker,1996,1504,1402,102,6.8
13,9,Baldwin,1996,17461,16616,845,4.8
13,11,Banks,1996,5976,5691,285,4.8
13,13,Barrow,1996,18747,18033,714,3.8
13,15,Bartow,1996,35295,33427,1868,5.3
13,17,Ben Hill,1996,8769,8209,560,6.4
13,19,Berrien,1996,6745,6396,349,5.2
13,21,Bibb,1996,73136,69315,3821,5.2
13,23,Bleckley,1996,5344,5052,292,5.5
13,25,Brantley,1996,5487,5078,409,7.5
13,27,Brooks,1996,7017,6740,277,3.9
13,29,Bryan,1996,10007,9629,378,3.8
13,31,Bulloch,1996,24547,23807,740,3.0
13,33,Burke,1996,8860,7410,1450,16.4
13,35,Butts,1996,8090,7616,474,5.9
13,37,Calhoun,1996,2299,2109,190,8.3
13,39,Camden,1996,15697,15012,685,4.4
13,43,Candler,1996,3897,3726,171,4.4
13,45,Carroll,1996,41115,39010,2105,5.1
13,47,Catoosa,1996,24795,23707,1088,4.4
13,49,Charlton,1996,3906,3633,273,7.0
13,51,Chatham,1996,104794,99438,5356,5.1
13,53,Chattahoochee,1996,2216,2054,162,7.3
13,55,Chattooga,1996,12097,11562,535,4.4
13,57,Cherokee,1996,68559,66750,1809,2.6
13,59,Clarke,1996,46433,44927,1506,3.2
13,61,Clay,1996,1566,1438,128,8.2
13,63,Clayton,1996,115818,110596,5222,4.5
13,65,Clinch,1996,3851,3669,182,4.7
13,67,Cobb,1996,322599,312869,9730,3.0
13,69,Coffee,1996,17522,16453,1069,6.1
13,71,Colquitt,1996,18175,17307,868,4.8
13,73,Columbia,1996,41040,39370,1670,4.1
13,75,Cook,1996,7270,6985,285,3.9
13,77,Coweta,1996,38848,37371,1477,3.8
13,79,Crawford,1996,5496,5220,276,5.0
13,81,Crisp,1996,9920,9217,703,7.1
13,83,Dade,1996,6974,6648,326,4.7
13,85,Dawson,1996,9045,8751,294,3.3
13,87,Decatur,1996,11773,11193,580,4.9
13,89,DeKalb,1996,347040,331664,15376,4.4
13,91,Dodge,1996,9369,8526,843,9.0
13,93,Dooly,1996,4681,4293,388,8.3
13,95,Dougherty,1996,45861,42886,2975,6.5
13,97,Douglas,1996,47281,45781,1500,3.2
13,99,Early,1996,4908,4537,371,7.6
13,101,Echols,1996,1082,1047,35,3.2
13,103,Effingham,1996,15738,15130,608,3.9
13,105,Elbert,1996,8828,7984,844,9.6
13,107,Emanuel,1996,8736,7883,853,9.8
13,109,Evans,1996,4633,4408,225,4.9
13,111,Fannin,1996,8354,7785,569,6.8
13,113,Fayette,1996,43989,42966,1023,2.3
13,115,Floyd,1996,45629,43275,2354,5.2
13,117,Forsyth,1996,38402,37602,800,2.1
13,119,Franklin,1996,9955,9366,589,5.9
13,121,Fulton,1996,382086,363145,18941,5.0
13,123,Gilmer,1996,8162,7657,505,6.2
13,125,Glascock,1996,1033,943,90,8.7
13,127,Glynn,1996,34050,32937,1113,3.3
13,129,Gordon,1996,20972,19852,1120,5.3
13,131,Grady,1996,9797,9317,480,4.9
13,133,Greene,1996,5338,4941,397,7.4
13,135,Gwinnett,1996,291421,283354,8067,2.8
13,137,Habersham,1996,14870,14130,740,5.0
13,139,Hall,1996,65757,63625,2132,3.2
13,141,Hancock,1996,4019,3418,601,15.0
13,143,Haralson,1996,9369,8620,749,8.0
13,145,Harris,1996,10788,10443,345,3.2
13,147,Hart,1996,8507,7862,645,7.6
13,149,Heard,1996,3649,3349,300,8.2
13,151,Henry,1996,49653,48254,1399,2.8
13,153,Houston,1996,49034,47191,1843,3.8
13,155,Irwin,1996,4472,4251,221,4.9
13,157,Jackson,1996,20500,19649,851,4.2
13,159,Jasper,1996,4711,4391,320,6.8
13,161,Jeff Davis,1996,5723,5269,454,7.9
13,163,Jefferson,1996,8098,7005,1093,13.5
13,165,Jenkins,1996,4286,4086,200,4.7
13,167,Johnson,1996,3737,3387,350,9.4
13,169,Jones,1996,11545,11080,465,4.0
13,171,Lamar,1996,7350,7046,304,4.1
13,173,Lanier,1996,3213,3041,172,5.4
13,175,Laurens,1996,21796,20664,1132,5.2
13,177,Lee,1996,10748,10334,414,3.9
13,179,Liberty,1996,16348,15109,1239,7.6
13,181,Lincoln,1996,3449,3225,224,6.5
13,183,Long,1996,3278,3164,114,3.5
13,185,Lowndes,1996,39405,37966,1439,3.7
13,187,Lumpkin,1996,8563,8288,275,3.2
13,189,McDuffie,1996,9642,8730,912,9.5
13,191,McIntosh,1996,3899,3659,240,6.2
13,193,Macon,1996,5709,5039,670,11.7
13,195,Madison,1996,13170,12668,502,3.8
13,197,Marion,1996,3048,2902,146,4.8
13,199,Meriwether,1996,8978,8401,577,6.4
13,201,Miller,1996,2928,2750,178,6.1
13,205,Mitchell,1996,10897,10220,677,6.2
13,207,Monroe,1996,7664,7208,456,5.9
13,209,Montgomery,1996,3720,3404,316,8.5
13,211,Morgan,1996,6641,6348,293,4.4
13,213,Murray,1996,17908,17040,868,4.8
13,215,Muscogee,1996,81835,77428,4407,5.4
13,217,Newton,1996,26075,24918,1157,4.4
13,219,Oconee,1996,12415,12169,246,2.0
13,221,Oglethorpe,1996,5000,4762,238,4.8
13,223,Paulding,1996,33735,32844,891,2.6
13,225,Peach,1996,10759,10049,710,6.6
13,227,Pickens,1996,9147,8798,349,3.8
13,229,Pierce,1996,6960,6536,424,6.1
13,231,Pike,1996,5935,5666,269,4.5
13,233,Polk,1996,14982,13593,1389,9.3
13,235,Pulaski,1996,4308,4100,208,4.8
13,237,Putnam,1996,8666,8325,341,3.9
13,239,Quitman,1996,1236,1154,82,6.6
13,241,Rabun,1996,6888,6650,238,3.5
13,243,Randolph,1996,3398,3048,350,10.3
13,245,Richmond,1996,80668,74693,5975,7.4
13,247,Rockdale,1996,36456,35333,1123,3.1
13,249,Schley,1996,1701,1593,108,6.3
13,251,Screven,1996,6490,5751,739,11.4
13,253,Seminole,1996,4451,4203,248,5.6
13,255,Spalding,1996,28599,27149,1450,5.1
13,257,Stephens,1996,12967,12119,848,6.5
13,259,Stewart,1996,2452,2318,134,5.5
13,261,Sumter,1996,15501,14534,967,6.2
13,263,Talbot,1996,2641,2397,244,9.2
13,265,Taliaferro,1996,663,602,61,9.2
13,267,Tattnall,1996,7226,6859,367,5.1
13,269,Taylor,1996,3354,3044,310,9.2
13,271,Telfair,1996,4736,4143,593,12.5
13,273,Terrell,1996,4069,3539,530,13.0
13,275,Thomas,1996,20728,19847,881,4.3
13,277,Tift,1996,20424,19303,1121,5.5
13,279,Toombs,1996,12323,11272,1051,8.5
13,281,Towns,1996,3521,3318,203,5.8
13,283,Treutlen,1996,2807,2570,237,8.4
13,285,Troup,1996,28272,26849,1423,5.0
13,287,Turner,1996,4225,3915,310,7.3
13,289,Twiggs,1996,4127,3876,251,6.1
13,291,Union,1996,6911,6507,404,5.8
13,293,Upson,1996,13077,12300,777,5.9
13,295,Walker,1996,30319,28762,1557,5.1
13,297,Walton,1996,24861,23845,1016,4.1
13,299,Ware,1996,15519,14679,840,5.4
13,301,Warren,1996,2813,2536,277,9.8
13,303,Washington,1996,9495,8927,568,6.0
13,305,Wayne,1996,10737,9955,782,7.3
13,307,Webster,1996,1105,1048,57,5.2
13,309,Wheeler,1996,1970,1718,252,12.8
13,311,White,1996,9345,9023,322,3.4
13,313,Whitfield,1996,45294,43435,1859,4.1
13,315,Wilcox,1996,3381,3117,264,7.8
13,317,Wilkes,1996,5553,5200,353,6.4
13,319,Wilkinson,1996,4496,4227,269,6.0
13,321,Worth,1996,9102,8494,608,6.7
15,1,Hawaii,1996,67210,60988,6222,9.3
15,3,Honolulu/city,1996,430661,409480,21181,4.9
15,7,Kauai,1996,28956,25652,3304,11.4
15,9,Maui,1996,68147,63503,4644,6.8
16,1,Ada,1996,150733,145552,5181,3.4
16,3,Adams,1996,1837,1566,271,14.8
16,5,Bannock,1996,35582,33578,2004,5.6
16,7,Bear Lake,1996,2920,2770,150,5.1
16,9,Benewah,1996,4335,3819,516,11.9
16,11,Bingham,1996,21017,19869,1148,5.5
16,13,Blaine,1996,10679,10230,449,4.2
16,15,Boise,1996,2475,2322,153,6.2
16,17,Bonner,1996,16440,14852,1588,9.7
16,19,Bonneville,1996,44317,42453,1864,4.2
16,21,Boundary,1996,4419,3983,436,9.9
16,23,Butte,1996,1625,1546,79,4.9
16,25,Camas,1996,454,433,21,4.6
16,27,Canyon,1996,57138,53995,3143,5.5
16,29,Caribou,1996,3350,3123,227,6.8
16,31,Cassia,1996,9844,9210,634,6.4
16,33,Clark,1996,641,617,24,3.7
16,35,Clearwater,1996,4151,3639,512,12.3
16,37,Custer,1996,2486,2328,158,6.4
16,39,Elmore,1996,8771,8219,552,6.3
16,41,Franklin,1996,4589,4379,210,4.6
16,43,Fremont,1996,4577,4203,374,8.2
16,45,Gem,1996,6245,5788,457,7.3
16,47,Gooding,1996,6758,6465,293,4.3
16,49,Idaho,1996,6584,5828,756,11.5
16,51,Jefferson,1996,9503,9040,463,4.9
16,53,Jerome,1996,9006,8608,398,4.4
16,55,Kootenai,1996,50988,46851,4137,8.1
16,57,Latah,1996,15018,14512,506,3.4
16,59,Lemhi,1996,4243,3883,360,8.5
16,61,Lewis,1996,1654,1532,122,7.4
16,63,Lincoln,1996,2187,2079,108,4.9
16,65,Madison,1996,9207,8899,308,3.3
16,67,Minidoka,1996,10295,9542,753,7.3
16,69,Nez Perce,1996,22682,21853,829,3.7
16,71,Oneida,1996,1712,1657,55,3.2
16,73,Owyhee,1996,4729,4579,150,3.2
16,75,Payette,1996,9958,9243,715,7.2
16,77,Power,1996,3547,3321,226,6.4
16,79,Shoshone,1996,6629,5939,690,10.4
16,81,Teton,1996,2690,2559,131,4.9
16,83,Twin Falls,1996,32324,30824,1500,4.6
16,85,Valley,1996,4213,3809,404,9.6
16,87,Washington,1996,4542,4164,378,8.3
17,1,Adams,1996,35491,34060,1431,4.0
17,3,Alexander,1996,4037,3697,340,8.4
17,5,Bond,1996,8090,7652,438,5.4
17,7,Boone,1996,20939,19904,1035,4.9
17,9,Brown,1996,2700,2603,97,3.6
17,11,Bureau,1996,18472,17456,1016,5.5
17,13,Calhoun,1996,3009,2842,167,5.6
17,15,Carroll,1996,8930,8426,504,5.6
17,17,Cass,1996,7528,7154,374,5.0
17,19,Champaign,1996,94949,92295,2654,2.8
17,21,Christian,1996,19324,18179,1145,5.9
17,23,Clark,1996,9532,9127,405,4.2
17,25,Clay,1996,6839,6476,363,5.3
17,27,Clinton,1996,17205,16343,862,5.0
17,29,Coles,1996,27745,26598,1147,4.1
17,31,Cook,1996,2668192,2507310,160882,6.0
17,33,Crawford,1996,9528,8879,649,6.8
17,35,Cumberland,1996,5698,5423,275,4.8
17,37,DeKalb,1996,46946,44920,2026,4.3
17,39,De Witt,1996,9150,8687,463,5.1
17,41,Douglas,1996,11808,11381,427,3.6
17,43,DuPage,1996,514894,496139,18755,3.6
17,45,Edgar,1996,9996,9523,473,4.7
17,47,Edwards,1996,3838,3633,205,5.3
17,49,Effingham,1996,18203,17447,756,4.2
17,51,Fayette,1996,10132,9560,572,5.6
17,53,Ford,1996,6711,6431,280,4.2
17,55,Franklin,1996,16780,14918,1862,11.1
17,57,Fulton,1996,14796,13536,1260,8.5
17,59,Gallatin,1996,2720,2511,209,7.7
17,61,Greene,1996,7000,6587,413,5.9
17,63,Grundy,1996,18721,17383,1338,7.1
17,65,Hamilton,1996,3626,3266,360,9.9
17,67,Hancock,1996,12338,11894,444,3.6
17,69,Hardin,1996,1899,1670,229,12.1
17,71,Henderson,1996,4728,4512,216,4.6
17,73,Henry,1996,26239,24984,1255,4.8
17,75,Iroquois,1996,16599,15878,721,4.3
17,77,Jackson,1996,28968,27548,1420,4.9
17,79,Jasper,1996,4358,4066,292,6.7
17,81,Jefferson,1996,18025,16623,1402,7.8
17,83,Jersey,1996,10444,9868,576,5.5
17,85,Jo Daviess,1996,13285,12722,563,4.2
17,87,Johnson,1996,4634,4244,390,8.4
17,89,Kane,1996,207702,197692,10010,4.8
17,91,Kankakee,1996,52519,49775,2744,5.2
17,93,Kendall,1996,27393,26223,1170,4.3
17,95,Knox,1996,28647,27295,1352,4.7
17,97,Lake,1996,314178,303074,11104,3.5
17,99,LaSalle,1996,54534,50621,3913,7.2
17,101,Lawrence,1996,7032,6309,723,10.3
17,103,Lee,1996,17843,17137,706,4.0
17,105,Livingston,1996,19481,18648,833,4.3
17,107,Logan,1996,12952,12236,716,5.5
17,109,McDonough,1996,19108,18692,416,2.2
17,111,McHenry,1996,131371,125777,5594,4.3
17,113,McLean,1996,80842,78583,2259,2.8
17,115,Macon,1996,60364,55944,4420,7.3
17,117,Macoupin,1996,22987,21633,1354,5.9
17,119,Madison,1996,128629,122208,6421,5.0
17,121,Marion,1996,21006,19366,1640,7.8
17,123,Marshall,1996,6609,6185,424,6.4
17,125,Mason,1996,8234,7580,654,7.9
17,127,Massac,1996,7604,7251,353,4.6
17,129,Menard,1996,6129,5869,260,4.2
17,131,Mercer,1996,8364,7910,454,5.4
17,133,Monroe,1996,13303,12876,427,3.2
17,135,Montgomery,1996,15161,14054,1107,7.3
17,137,Morgan,1996,18197,17357,840,4.6
17,139,Moultrie,1996,7953,7657,296,3.7
17,141,Ogle,1996,27624,26542,1082,3.9
17,143,Peoria,1996,95052,89440,5612,5.9
17,145,Perry,1996,8507,7556,951,11.2
17,147,Piatt,1996,7742,7337,405,5.2
17,149,Pike,1996,8723,8241,482,5.5
17,151,Pope,1996,1671,1511,160,9.6
17,153,Pulaski,1996,2927,2664,263,9.0
17,155,Putnam,1996,3068,2855,213,6.9
17,157,Randolph,1996,14335,12894,1441,10.1
17,159,Richland,1996,9868,9429,439,4.4
17,161,Rock Island,1996,73421,70376,3045,4.1
17,163,St. Clair,1996,117376,111042,6334,5.4
17,165,Saline,1996,10149,9259,890,8.8
17,167,Sangamon,1996,101737,97688,4049,4.0
17,169,Schuyler,1996,3771,3575,196,5.2
17,171,Scott,1996,2730,2565,165,6.0
17,173,Shelby,1996,11625,10999,626,5.4
17,175,Stark,1996,2991,2754,237,7.9
17,177,Stephenson,1996,25698,24611,1087,4.2
17,179,Tazewell,1996,69435,65667,3768,5.4
17,181,Union,1996,8129,7430,699,8.6
17,183,Vermilion,1996,40292,37392,2900,7.2
17,185,Wabash,1996,5532,5135,397,7.2
17,187,Warren,1996,9732,9299,433,4.4
17,189,Washington,1996,8258,7890,368,4.5
17,191,Wayne,1996,7973,7517,456,5.7
17,193,White,1996,7259,6783,476,6.6
17,195,Whiteside,1996,31653,30491,1162,3.7
17,197,Will,1996,229255,216869,12386,5.4
17,199,Williamson,1996,27362,25086,2276,8.3
17,201,Winnebago,1996,148406,142091,6315,4.3
17,203,Woodford,1996,18535,17786,749,4.0
18,1,Adams,1996,16615,15970,645,3.9
18,3,Allen,1996,175027,169059,5968,3.4
18,5,Bartholomew,1996,39646,38553,1093,2.8
18,7,Benton,1996,5255,5035,220,4.2
18,9,Blackford,1996,6497,6149,348,5.4
18,11,Boone,1996,23638,23110,528,2.2
18,13,Brown,1996,8591,8412,179,2.1
18,15,Carroll,1996,11954,11630,324,2.7
18,17,Cass,1996,19580,18515,1065,5.4
18,19,Clark,1996,51135,49071,2064,4.0
18,21,Clay,1996,12999,12240,759,5.8
18,23,Clinton,1996,16054,15536,518,3.2
18,25,Crawford,1996,4773,4328,445,9.3
18,27,Daviess,1996,13586,13080,506,3.7
18,29,Dearborn,1996,22824,21669,1155,5.1
18,31,Decatur,1996,15314,14872,442,2.9
18,33,DeKalb,1996,21356,20631,725,3.4
18,35,Delaware,1996,63792,60962,2830,4.4
18,37,Dubois,1996,22627,22008,619,2.7
18,39,Elkhart,1996,95033,91438,3595,3.8
18,41,Fayette,1996,11928,11168,760,6.4
18,43,Floyd,1996,37892,36532,1360,3.6
18,45,Fountain,1996,8849,8426,423,4.8
18,47,Franklin,1996,10798,10310,488,4.5
18,49,Fulton,1996,10487,10070,417,4.0
18,51,Gibson,1996,15764,14977,787,5.0
18,53,Grant,1996,35738,33732,2006,5.6
18,55,Greene,1996,15124,13946,1178,7.8
18,57,Hamilton,1996,85024,83688,1336,1.6
18,59,Hancock,1996,28870,28088,782,2.7
18,61,Harrison,1996,17739,17023,716,4.0
18,63,Hendricks,1996,49498,48546,952,1.9
18,65,Henry,1996,25151,23898,1253,5.0
18,67,Howard,1996,43849,42297,1552,3.5
18,69,Huntington,1996,20559,19787,772,3.8
18,71,Jackson,1996,21155,20330,825,3.9
18,73,Jasper,1996,14453,13656,797,5.5
18,75,Jay,1996,12284,11709,575,4.7
18,77,Jefferson,1996,14747,13981,766,5.2
18,79,Jennings,1996,14293,13848,445,3.1
18,81,Johnson,1996,58785,57416,1369,2.3
18,83,Knox,1996,21440,20469,971,4.5
18,85,Kosciusko,1996,39108,37860,1248,3.2
18,87,LaGrange,1996,17172,16493,679,4.0
18,89,Lake,1996,228453,215992,12461,5.5
18,91,LaPorte,1996,54689,52020,2669,4.9
18,93,Lawrence,1996,24443,22771,1672,6.8
18,95,Madison,1996,66549,63667,2882,4.3
18,97,Marion,1996,452355,436436,15919,3.5
18,99,Marshall,1996,26112,25186,926,3.5
18,101,Martin,1996,5298,4999,299,5.6
18,103,Miami,1996,15306,14426,880,5.7
18,105,Monroe,1996,61288,59664,1624,2.6
18,107,Montgomery,1996,19766,19191,575,2.9
18,109,Morgan,1996,34074,32980,1094,3.2
18,111,Newton,1996,6532,6180,352,5.4
18,113,Noble,1996,25196,24286,910,3.6
18,115,Ohio,1996,2715,2575,140,5.2
18,117,Orange,1996,9132,8291,841,9.2
18,119,Owen,1996,10394,9923,471,4.5
18,121,Parke,1996,7780,7391,389,5.0
18,123,Perry,1996,9168,8497,671,7.3
18,125,Pike,1996,6212,5890,322,5.2
18,127,Porter,1996,74329,71647,2682,3.6
18,129,Posey,1996,14043,13548,495,3.5
18,131,Pulaski,1996,6165,5828,337,5.5
18,133,Putnam,1996,16810,16215,595,3.5
18,135,Randolph,1996,12508,11513,995,8.0
18,137,Ripley,1996,13498,12907,591,4.4
18,139,Rush,1996,10213,9838,375,3.7
18,141,St. Joseph,1996,136249,131002,5247,3.9
18,143,Scott,1996,10777,10249,528,4.9
18,145,Shelby,1996,23248,22415,833,3.6
18,147,Spencer,1996,11103,10580,523,4.7
18,149,Starke,1996,11497,10838,659,5.7
18,151,Steuben,1996,17351,16736,615,3.5
18,153,Sullivan,1996,10307,9499,808,7.8
18,155,Switzerland,1996,3990,3715,275,6.9
18,157,Tippecanoe,1996,73140,71214,1926,2.6
18,159,Tipton,1996,9017,8722,295,3.3
18,161,Union,1996,3992,3814,178,4.5
18,163,Vanderburgh,1996,91318,87703,3615,4.0
18,165,Vermillion,1996,8185,7590,595,7.3
18,167,Vigo,1996,53536,50224,3312,6.2
18,169,Wabash,1996,17856,17140,716,4.0
18,171,Warren,1996,3944,3808,136,3.4
18,173,Warrick,1996,28011,27006,1005,3.6
18,175,Washington,1996,11938,11148,790,6.6
18,177,Wayne,1996,38777,37045,1732,4.5
18,179,Wells,1996,14744,14268,476,3.2
18,181,White,1996,14563,13643,920,6.3
18,183,Whitley,1996,16386,15908,478,2.9
19,1,Adair,1996,4455,4309,146,3.3
19,3,Adams,1996,2412,2200,212,8.8
19,5,Allamakee,1996,7818,7442,376,4.8
19,7,Appanoose,1996,6768,6405,363,5.4
19,9,Audubon,1996,3779,3650,129,3.4
19,11,Benton,1996,12245,11765,480,3.9
19,13,Black Hawk,1996,69407,66391,3016,4.3
19,15,Boone,1996,14180,13812,368,2.6
19,17,Bremer,1996,12871,12514,357,2.8
19,19,Buchanan,1996,11029,10517,512,4.6
19,21,Buena Vista,1996,11228,10956,272,2.4
19,23,Butler,1996,8208,7793,415,5.1
19,25,Calhoun,1996,5248,5059,189,3.6
19,27,Carroll,1996,12270,11873,397,3.2
19,29,Cass,1996,7804,7401,403,5.2
19,31,Cedar,1996,9778,9422,356,3.6
19,33,Cerro Gordo,1996,27255,26198,1057,3.9
19,35,Cherokee,1996,7145,6913,232,3.2
19,37,Chickasaw,1996,7841,7415,426,5.4
19,39,Clarke,1996,4065,3853,212,5.2
19,41,Clay,1996,10260,10001,259,2.5
19,43,Clayton,1996,10931,10294,637,5.8
19,45,Clinton,1996,28001,26709,1292,4.6
19,47,Crawford,1996,9065,8769,296,3.3
19,49,Dallas,1996,19572,19132,440,2.2
19,51,Davis,1996,4390,4222,168,3.8
19,53,Decatur,1996,3857,3642,215,5.6
19,55,Delaware,1996,9638,9039,599,6.2
19,57,Des Moines,1996,24140,23009,1131,4.7
19,59,Dickinson,1996,10274,9955,319,3.1
19,61,Dubuque,1996,50948,48135,2813,5.5
19,63,Emmet,1996,5780,5535,245,4.2
19,65,Fayette,1996,11603,11153,450,3.9
19,67,Floyd,1996,8466,8034,432,5.1
19,69,Franklin,1996,6184,5993,191,3.1
19,71,Fremont,1996,3935,3786,149,3.8
19,73,Greene,1996,5272,5105,167,3.2
19,75,Grundy,1996,6147,5917,230,3.7
19,77,Guthrie,1996,6112,5910,202,3.3
19,79,Hamilton,1996,8725,8460,265,3.0
19,81,Hancock,1996,6100,5920,180,3.0
19,83,Hardin,1996,9730,9361,369,3.8
19,85,Harrison,1996,7806,7512,294,3.8
19,87,Henry,1996,11339,10969,370,3.3
19,89,Howard,1996,5506,5286,220,4.0
19,91,Humboldt,1996,5641,5509,132,2.3
19,93,Ida,1996,4295,4185,110,2.6
19,95,Iowa,1996,9622,9362,260,2.7
19,97,Jackson,1996,10866,10198,668,6.1
19,99,Jasper,1996,19092,18465,627,3.3
19,101,Jefferson,1996,9967,9664,303,3.0
19,103,Johnson,1996,65868,64056,1812,2.8
19,105,Jones,1996,9961,9557,404,4.1
19,107,Keokuk,1996,5342,5093,249,4.7
19,109,Kossuth,1996,9156,8869,287,3.1
19,111,Lee,1996,20230,19042,1188,5.9
19,113,Linn,1996,110239,107150,3089,2.8
19,115,Louisa,1996,6669,6375,294,4.4
19,117,Lucas,1996,4017,3813,204,5.1
19,119,Lyon,1996,5971,5811,160,2.7
19,121,Madison,1996,7771,7473,298,3.8
19,123,Mahaska,1996,11201,10823,378,3.4
19,125,Marion,1996,18315,17710,605,3.3
19,127,Marshall,1996,21267,20532,735,3.5
19,129,Mills,1996,6363,6164,199,3.1
19,131,Mitchell,1996,5801,5604,197,3.4
19,133,Monona,1996,5226,5037,189,3.6
19,135,Monroe,1996,4223,4043,180,4.3
19,137,Montgomery,1996,6452,6073,379,5.9
19,139,Muscatine,1996,22131,21095,1036,4.7
19,141,O'Brien,1996,8191,7996,195,2.4
19,143,Osceola,1996,3873,3757,116,3.0
19,145,Page,1996,9477,9111,366,3.9
19,147,Palo Alto,1996,5622,5448,174,3.1
19,149,Plymouth,1996,13200,12700,500,3.8
19,151,Pocahontas,1996,4440,4306,134,3.0
19,153,Polk,1996,216033,210052,5981,2.8
19,155,Pottawattamie,1996,48261,46743,1518,3.1
19,157,Poweshiek,1996,10566,10053,513,4.9
19,159,Ringgold,1996,2743,2641,102,3.7
19,161,Sac,1996,6101,5870,231,3.8
19,163,Scott,1996,85379,82228,3151,3.7
19,165,Shelby,1996,7255,6994,261,3.6
19,167,Sioux,1996,17638,17093,545,3.1
19,169,Story,1996,46250,44987,1263,2.7
19,171,Tama,1996,9667,9242,425,4.4
19,173,Taylor,1996,3501,3270,231,6.6
19,175,Union,1996,6521,6206,315,4.8
19,177,Van Buren,1996,4208,4048,160,3.8
19,179,Wapello,1996,18745,17812,933,5.0
19,181,Warren,1996,23473,22954,519,2.2
19,183,Washington,1996,11651,11243,408,3.5
19,185,Wayne,1996,3419,3252,167,4.9
19,187,Webster,1996,20447,19703,744,3.6
19,189,Winnebago,1996,7080,6909,171,2.4
19,191,Winneshiek,1996,12470,11910,560,4.5
19,193,Woodbury,1996,56700,54693,2007,3.5
19,195,Worth,1996,4273,4114,159,3.7
19,197,Wright,1996,7338,7109,229,3.1
20,1,Allen,1996,6917,6492,425,6.1
20,3,Anderson,1996,3911,3699,212,5.4
20,5,Atchison,1996,8244,7613,631,7.7
20,7,Barber,1996,2570,2473,97,3.8
20,9,Barton,1996,15424,14818,606,3.9
20,11,Bourbon,1996,6822,6436,386,5.7
20,13,Brown,1996,4974,4645,329,6.6
20,15,Butler,1996,29790,28696,1094,3.7
20,17,Chase,1996,1476,1399,77,5.2
20,19,Chautauqua,1996,1740,1633,107,6.1
20,21,Cherokee,1996,10421,9671,750,7.2
20,23,Cheyenne,1996,1563,1530,33,2.1
20,25,Clark,1996,1342,1311,31,2.3
20,27,Clay,1996,4757,4610,147,3.1
20,29,Cloud,1996,5208,5025,183,3.5
20,31,Coffey,1996,4330,4061,269,6.2
20,33,Comanche,1996,1063,1039,24,2.3
20,35,Cowley,1996,18543,17701,842,4.5
20,37,Crawford,1996,18550,17629,921,5.0
20,39,Decatur,1996,1849,1792,57,3.1
20,41,Dickinson,1996,10440,9920,520,5.0
20,43,Doniphan,1996,4255,3981,274,6.4
20,45,Douglas,1996,51479,49071,2408,4.7
20,47,Edwards,1996,1773,1715,58,3.3
20,49,Elk,1996,1420,1365,55,3.9
20,51,Ellis,1996,16419,15923,496,3.0
20,53,Ellsworth,1996,2901,2801,100,3.4
20,55,Finney,1996,19449,18734,715,3.7
20,57,Ford,1996,15569,14975,594,3.8
20,59,Franklin,1996,13479,12863,616,4.6
20,61,Geary,1996,10248,9571,677,6.6
20,63,Gove,1996,1504,1477,27,1.8
20,65,Graham,1996,1615,1552,63,3.9
20,67,Grant,1996,4003,3869,134,3.3
20,69,Gray,1996,2769,2692,77,2.8
20,71,Greeley,1996,876,852,24,2.7
20,73,Greenwood,1996,3377,3218,159,4.7
20,75,Hamilton,1996,1221,1193,28,2.3
20,77,Harper,1996,3121,3013,108,3.5
20,79,Harvey,1996,16044,15446,598,3.7
20,81,Haskell,1996,2093,2031,62,3.0
20,83,Hodgeman,1996,992,969,23,2.3
20,85,Jackson,1996,6661,6280,381,5.7
20,87,Jefferson,1996,10096,9624,472,4.7
20,89,Jewell,1996,2147,2070,77,3.6
20,91,Johnson,1996,243385,236564,6821,2.8
20,93,Kearny,1996,2182,2120,62,2.8
20,95,Kingman,1996,4241,4058,183,4.3
20,97,Kiowa,1996,1691,1644,47,2.8
20,99,Labette,1996,10811,10141,670,6.2
20,101,Lane,1996,1130,1102,28,2.5
20,103,Leavenworth,1996,27960,26522,1438,5.1
20,105,Lincoln,1996,1809,1735,74,4.1
20,107,Linn,1996,3349,3078,271,8.1
20,109,Logan,1996,1604,1562,42,2.6
20,111,Lyon,1996,19705,18872,833,4.2
20,113,McPherson,1996,16001,15547,454,2.8
20,115,Marion,1996,7010,6818,192,2.7
20,117,Marshall,1996,5989,5793,196,3.3
20,119,Meade,1996,2243,2192,51,2.3
20,121,Miami,1996,13351,12823,528,4.0
20,123,Mitchell,1996,3659,3555,104,2.8
20,125,Montgomery,1996,18320,17023,1297,7.1
20,127,Morris,1996,3114,3014,100,3.2
20,129,Morton,1996,1772,1727,45,2.5
20,131,Nemaha,1996,5709,5534,175,3.1
20,133,Neosho,1996,8923,8518,405,4.5
20,135,Ness,1996,1916,1869,47,2.5
20,137,Norton,1996,3088,3031,57,1.8
20,139,Osage,1996,8662,8143,519,6.0
20,141,Osborne,1996,2384,2314,70,2.9
20,143,Ottawa,1996,3071,2961,110,3.6
20,145,Pawnee,1996,3645,3546,99,2.7
20,147,Phillips,1996,3287,3170,117,3.6
20,149,Pottawatomie,1996,10202,9836,366,3.6
20,151,Pratt,1996,5111,4939,172,3.4
20,153,Rawlins,1996,1639,1593,46,2.8
20,155,Reno,1996,33068,31809,1259,3.8
20,157,Republic,1996,3229,3156,73,2.3
20,159,Rice,1996,4829,4614,215,4.5
20,161,Riley,1996,30258,28987,1271,4.2
20,163,Rooks,1996,3023,2924,99,3.3
20,165,Rush,1996,1877,1823,54,2.9
20,167,Russell,1996,3732,3585,147,3.9
20,169,Saline,1996,30403,29288,1115,3.7
20,171,Scott,1996,2712,2636,76,2.8
20,173,Sedgwick,1996,226046,216632,9414,4.2
20,175,Seward,1996,10741,10255,486,4.5
20,177,Shawnee,1996,91332,86888,4444,4.9
20,179,Sheridan,1996,1546,1504,42,2.7
20,181,Sherman,1996,4031,3934,97,2.4
20,183,Smith,1996,2477,2397,80,3.2
20,185,Stafford,1996,2500,2421,79,3.2
20,187,Stanton,1996,1119,1092,27,2.4
20,189,Stevens,1996,2762,2658,104,3.8
20,191,Sumner,1996,12910,12369,541,4.2
20,193,Thomas,1996,4728,4597,131,2.8
20,195,Trego,1996,1996,1941,55,2.8
20,197,Wabaunsee,1996,3491,3334,157,4.5
20,199,Wallace,1996,864,845,19,2.2
20,201,Washington,1996,3564,3425,139,3.9
20,203,Wichita,1996,1256,1221,35,2.8
20,205,Wilson,1996,5461,5167,294,5.4
20,207,Woodson,1996,1596,1492,104,6.5
20,209,Wyandotte,1996,75869,69833,6036,8.0
21,1,Adair,1996,8221,7523,698,8.5
21,3,Allen,1996,8816,8259,557,6.3
21,5,Anderson,1996,9283,8860,423,4.6
21,7,Ballard,1996,4058,3795,263,6.5
21,9,Barren,1996,18718,17515,1203,6.4
21,11,Bath,1996,5130,4775,355,6.9
21,13,Bell,1996,10026,9243,783,7.8
21,15,Boone,1996,39535,38025,1510,3.8
21,17,Bourbon,1996,9621,9300,321,3.3
21,19,Boyd,1996,22330,20799,1531,6.9
21,21,Boyle,1996,13459,12891,568,4.2
21,23,Bracken,1996,3848,3622,226,5.9
21,25,Breathitt,1996,4422,3931,491,11.1
21,27,Breckinridge,1996,7859,7329,530,6.7
21,29,Bullitt,1996,30668,29538,1130,3.7
21,31,Butler,1996,5638,5224,414,7.3
21,33,Caldwell,1996,6375,5764,611,9.6
21,35,Calloway,1996,17171,16382,789,4.6
21,37,Campbell,1996,44623,42701,1922,4.3
21,39,Carlisle,1996,2718,2550,168,6.2
21,41,Carroll,1996,4573,4364,209,4.6
21,43,Carter,1996,11189,9870,1319,11.8
21,45,Casey,1996,6893,6434,459,6.7
21,47,Christian,1996,26874,25752,1122,4.2
21,49,Clark,1996,15594,14963,631,4.0
21,51,Clay,1996,7161,6530,631,8.8
21,53,Clinton,1996,4516,4053,463,10.3
21,55,Crittenden,1996,4275,3966,309,7.2
21,57,Cumberland,1996,2848,2402,446,15.7
21,59,Daviess,1996,47961,45261,2700,5.6
21,61,Edmonson,1996,4844,4373,471,9.7
21,63,Elliott,1996,2780,2370,410,14.7
21,65,Estill,1996,5922,5594,328,5.5
21,67,Fayette,1996,135777,132525,3252,2.4
21,69,Fleming,1996,6141,5820,321,5.2
21,71,Floyd,1996,14034,12563,1471,10.5
21,73,Franklin,1996,24087,23205,882,3.7
21,75,Fulton,1996,4104,3506,598,14.6
21,77,Gallatin,1996,3190,3015,175,5.5
21,79,Garrard,1996,6562,6313,249,3.8
21,81,Grant,1996,9362,8832,530,5.7
21,83,Graves,1996,17324,15969,1355,7.8
21,85,Grayson,1996,11183,10395,788,7.0
21,87,Green,1996,5218,4824,394,7.6
21,89,Greenup,1996,16194,15166,1028,6.3
21,91,Hancock,1996,3605,3360,245,6.8
21,93,Hardin,1996,35822,33905,1917,5.4
21,95,Harlan,1996,9355,8109,1246,13.3
21,97,Harrison,1996,7369,7003,366,5.0
21,99,Hart,1996,7906,7409,497,6.3
21,101,Henderson,1996,23906,22259,1647,6.9
21,103,Henry,1996,7216,6918,298,4.1
21,105,Hickman,1996,2544,2364,180,7.1
21,107,Hopkins,1996,20481,19037,1444,7.1
21,109,Jackson,1996,6114,5734,380,6.2
21,111,Jefferson,1996,360580,344570,16010,4.4
21,113,Jessamine,1996,19190,18733,457,2.4
21,115,Johnson,1996,9959,9048,911,9.1
21,117,Kenton,1996,76878,73764,3114,4.1
21,119,Knott,1996,5843,5231,612,10.5
21,121,Knox,1996,11261,10037,1224,10.9
21,123,Larue,1996,6054,5812,242,4.0
21,125,Laurel,1996,21561,20150,1411,6.5
21,127,Lawrence,1996,5290,4623,667,12.6
21,129,Lee,1996,2417,2264,153,6.3
21,131,Leslie,1996,4268,3977,291,6.8
21,133,Letcher,1996,7792,6939,853,10.9
21,135,Lewis,1996,5322,4713,609,11.4
21,137,Lincoln,1996,10037,9565,472,4.7
21,139,Livingston,1996,4727,4458,269,5.7
21,141,Logan,1996,13108,12439,669,5.1
21,143,Lyon,1996,3323,3078,245,7.4
21,145,McCracken,1996,33412,32018,1394,4.2
21,147,McCreary,1996,6313,5599,714,11.3
21,149,McLean,1996,4345,3994,351,8.1
21,151,Madison,1996,33339,32236,1103,3.3
21,153,Magoffin,1996,4822,4120,702,14.6
21,155,Marion,1996,8824,8173,651,7.4
21,157,Marshall,1996,14216,13382,834,5.9
21,159,Martin,1996,3286,2819,467,14.2
21,161,Mason,1996,8612,8190,422,4.9
21,163,Meade,1996,10303,9816,487,4.7
21,165,Menifee,1996,2579,2354,225,8.7
21,167,Mercer,1996,10508,10097,411,3.9
21,169,Metcalfe,1996,4870,4568,302,6.2
21,171,Monroe,1996,5487,5141,346,6.3
21,173,Montgomery,1996,11211,10626,585,5.2
21,175,Morgan,1996,4812,4342,470,9.8
21,177,Muhlenberg,1996,12037,11042,995,8.3
21,179,Nelson,1996,17850,16568,1282,7.2
21,181,Nicholas,1996,3220,3061,159,4.9
21,183,Ohio,1996,9838,9011,827,8.4
21,185,Oldham,1996,22205,21657,548,2.5
21,187,Owen,1996,4520,4330,190,4.2
21,189,Owsley,1996,1571,1488,83,5.3
21,191,Pendleton,1996,6441,6120,321,5.0
21,193,Perry,1996,11409,10387,1022,9.0
21,195,Pike,1996,27246,24641,2605,9.6
21,197,Powell,1996,6946,6487,459,6.6
21,199,Pulaski,1996,24455,23107,1348,5.5
21,201,Robertson,1996,997,950,47,4.7
21,203,Rockcastle,1996,6090,5683,407,6.7
21,205,Rowan,1996,8821,8313,508,5.8
21,207,Russell,1996,6414,5675,739,11.5
21,209,Scott,1996,15465,15031,434,2.8
21,211,Shelby,1996,16432,16028,404,2.5
21,213,Simpson,1996,7528,7082,446,5.9
21,215,Spencer,1996,4597,4410,187,4.1
21,217,Taylor,1996,11313,10674,639,5.6
21,219,Todd,1996,5372,5139,233,4.3
21,221,Trigg,1996,5876,5618,258,4.4
21,223,Trimble,1996,3127,2996,131,4.2
21,225,Union,1996,6414,5944,470,7.3
21,227,Warren,1996,48205,45303,2902,6.0
21,229,Washington,1996,5815,5491,324,5.6
21,231,Wayne,1996,7700,7041,659,8.6
21,233,Webster,1996,5643,5232,411,7.3
21,235,Whitley,1996,14039,12820,1219,8.7
21,237,Wolfe,1996,3347,3124,223,6.7
21,239,Woodford,1996,12585,12314,271,2.2
22,1,Acadia Parish,1996,22846,21221,1625,7.1
22,3,Allen Parish,1996,8711,8046,665,7.6
22,5,Ascension Parish,1996,31366,29490,1876,6.0
22,7,Assumption Parish,1996,9166,8564,602,6.6
22,9,Avoyelles Parish,1996,16086,14710,1376,8.6
22,11,Beauregard Parish,1996,12617,11711,906,7.2
22,13,Bienville Parish,1996,5986,5361,625,10.4
22,15,Bossier Parish,1996,44605,41971,2634,5.9
22,17,Caddo Parish,1996,116564,109131,7433,6.4
22,19,Calcasieu Parish,1996,87655,82774,4881,5.6
22,21,Caldwell Parish,1996,4443,4010,433,9.7
22,23,Cameron Parish,1996,3592,3398,194,5.4
22,25,Catahoula Parish,1996,4935,4417,518,10.5
22,27,Claiborne Parish,1996,5945,5409,536,9.0
22,29,Concordia Parish,1996,8020,7069,951,11.9
22,31,De Soto Parish,1996,10845,9877,968,8.9
22,33,East Baton Rouge Parish,1996,202842,193077,9765,4.8
22,35,East Carroll Parish,1996,3154,2662,492,15.6
22,37,East Feliciana Parish,1996,7550,7024,526,7.0
22,39,Evangeline Parish,1996,11798,11067,731,6.2
22,41,Franklin Parish,1996,9791,8864,927,9.5
22,43,Grant Parish,1996,6370,5750,620,9.7
22,45,Iberia Parish,1996,30811,29077,1734,5.6
22,47,Iberville Parish,1996,12122,11088,1034,8.5
22,49,Jackson Parish,1996,6402,6015,387,6.0
22,51,Jefferson Parish,1996,238749,224843,13906,5.8
22,53,Jefferson Davis Parish,1996,11663,10831,832,7.1
22,55,Lafayette Parish,1996,91639,87906,3733,4.1
22,57,Lafourche Parish,1996,38900,37387,1513,3.9
22,59,LaSalle Parish,1996,5602,5296,306,5.5
22,61,Lincoln Parish,1996,18401,17857,544,3.0
22,63,Livingston Parish,1996,38922,36263,2659,6.8
22,65,Madison Parish,1996,5652,4982,670,11.9
22,67,Morehouse Parish,1996,12702,11331,1371,10.8
22,69,Natchitoches Parish,1996,17306,16047,1259,7.3
22,71,Orleans Parish,1996,208151,190153,17998,8.6
22,73,Ouachita Parish,1996,68438,64508,3930,5.7
22,75,Plaquemines Parish,1996,10569,9909,660,6.2
22,77,Pointe Coupee Parish,1996,9237,8506,731,7.9
22,79,Rapides Parish,1996,57962,54400,3562,6.1
22,81,Red River Parish,1996,3760,3299,461,12.3
22,83,Richland Parish,1996,7898,7141,757,9.6
22,85,Sabine Parish,1996,9158,8548,610,6.7
22,87,St. Bernard Parish,1996,32262,29803,2459,7.6
22,89,St. Charles Parish,1996,22776,21104,1672,7.3
22,91,St. Helena Parish,1996,3985,3707,278,7.0
22,93,St. James Parish,1996,8857,7965,892,10.1
22,95,St. John the Baptist Parish,1996,20006,17949,2057,10.3
22,97,St. Landry Parish,1996,30825,28505,2320,7.5
22,99,St. Martin Parish,1996,20179,18957,1222,6.1
22,101,St. Mary Parish,1996,24088,22408,1680,7.0
22,103,St. Tammany Parish,1996,86261,81747,4514,5.2
22,105,Tangipahoa Parish,1996,42239,38646,3593,8.5
22,107,Tensas Parish,1996,3047,2789,258,8.5
22,109,Terrebonne Parish,1996,44280,42361,1919,4.3
22,111,Union Parish,1996,11269,10586,683,6.1
22,113,Vermilion Parish,1996,22698,21528,1170,5.2
22,115,Vernon Parish,1996,17142,16013,1129,6.6
22,117,Washington Parish,1996,16767,15483,1284,7.7
22,119,Webster Parish,1996,18782,17096,1686,9.0
22,121,West Baton Rouge Parish,1996,9706,9133,573,5.9
22,123,West Carroll Parish,1996,5119,4420,699,13.7
22,125,West Feliciana Parish,1996,3647,3393,254,7.0
22,127,Winn Parish,1996,6559,6141,418,6.4
23,1,Androscoggin,1996,57333,53900,3433,6.0
23,3,Aroostook,1996,38257,34674,3583,9.4
23,5,Cumberland,1996,136622,132418,4204,3.1
23,7,Franklin,1996,15294,14271,1023,6.7
23,9,Hancock,1996,26980,25365,1615,6.0
23,11,Kennebec,1996,60621,57072,3549,5.9
23,13,Knox,1996,20716,19946,770,3.7
23,15,Lincoln,1996,16996,16307,689,4.1
23,17,Oxford,1996,25948,24266,1682,6.5
23,19,Penobscot,1996,75305,71146,4159,5.5
23,21,Piscataquis,1996,8542,7877,665,7.8
23,23,Sagadahoc,1996,15783,15121,662,4.2
23,25,Somerset,1996,26217,24005,2212,8.4
23,27,Waldo,1996,19708,18493,1215,6.2
23,29,Washington,1996,16667,15050,1617,9.7
23,31,York,1996,93516,89807,3709,4.0
24,1,Allegany,1996,32931,30016,2915,8.9
24,3,Anne Arundel,1996,250788,240621,10167,4.1
24,5,Baltimore,1996,394241,373591,20650,5.2
24,9,Calvert,1996,35479,34039,1440,4.1
24,11,Caroline,1996,15787,14850,937,5.9
24,13,Carroll,1996,78771,75547,3224,4.1
24,15,Cecil,1996,40979,36909,4070,9.9
24,17,Charles,1996,59457,57383,2074,3.5
24,19,Dorchester,1996,15645,13965,1680,10.7
24,21,Frederick,1996,97582,94257,3325,3.4
24,23,Garrett,1996,14449,12908,1541,10.7
24,25,Harford,1996,111512,105615,5897,5.3
24,27,Howard,1996,133720,129667,4053,3.0
24,29,Kent,1996,10326,9492,834,8.1
24,31,Montgomery,1996,468151,455628,12523,2.7
24,33,Prince George's,1996,445255,424047,21208,4.8
24,35,Queen Anne's,1996,20252,19333,919,4.5
24,37,St. Mary's,1996,44707,42632,2075,4.6
24,39,Somerset,1996,11619,10456,1163,10.0
24,41,Talbot,1996,18213,17481,732,4.0
24,43,Washington,1996,69013,65402,3611,5.2
24,45,Wicomico,1996,47139,44298,2841,6.0
24,47,Worcester,1996,24422,22056,2366,9.7
24,510,Baltimore city,1996,308656,282835,25821,8.4
25,1,Barnstable,1996,103915,97416,6499,6.3
25,3,Berkshire,1996,66278,62785,3493,5.3
25,5,Bristol,1996,265381,245539,19842,7.5
25,7,Dukes,1996,9085,8595,490,5.4
25,9,Essex,1996,358777,341837,16940,4.7
25,11,Franklin,1996,37308,35803,1505,4.0
25,13,Hampden,1996,211341,200041,11300,5.3
25,15,Hampshire,1996,79919,77190,2729,3.4
25,17,Middlesex,1996,798203,770360,27843,3.5
25,19,Nantucket/town,1996,5834,5694,140,2.4
25,21,Norfolk,1996,357672,344735,12937,3.6
25,23,Plymouth,1996,239478,226996,12482,5.2
25,25,Suffolk,1996,339119,322689,16430,4.8
25,27,Worcester,1996,363751,346943,16808,4.6
26,1,Alcona,1996,4955,4519,436,8.8
26,3,Alger,1996,4219,3915,304,7.2
26,5,Allegan,1996,52166,50302,1864,3.6
26,7,Alpena,1996,15583,14171,1412,9.1
26,9,Antrim,1996,9600,8944,656,6.8
26,11,Arenac,1996,6790,6159,631,9.3
26,13,Baraga,1996,4025,3657,368,9.1
26,15,Barry,1996,29663,28552,1111,3.7
26,17,Bay,1996,54341,51575,2766,5.1
26,19,Benzie,1996,7166,6658,508,7.1
26,21,Berrien,1996,82668,77919,4749,5.7
26,23,Branch,1996,20300,19270,1030,5.1
26,25,Calhoun,1996,66496,63428,3068,4.6
26,27,Cass,1996,25704,24375,1329,5.2
26,29,Charlevoix,1996,13212,12352,860,6.5
26,31,Cheboygan,1996,11893,10604,1289,10.8
26,33,Chippewa,1996,17691,16224,1467,8.3
26,35,Clare,1996,9914,9055,859,8.7
26,37,Clinton,1996,33108,31980,1128,3.4
26,39,Crawford,1996,5440,5050,390,7.2
26,41,Delta,1996,18391,16925,1466,8.0
26,43,Dickinson,1996,13912,13135,777,5.6
26,45,Eaton,1996,54081,52364,1717,3.2
26,47,Emmet,1996,16253,14756,1497,9.2
26,49,Genesee,1996,204969,192556,12413,6.1
26,51,Gladwin,1996,8998,8305,693,7.7
26,53,Gogebic,1996,8276,7350,926,11.2
26,55,Grand Traverse,1996,42814,40824,1990,4.6
26,57,Gratiot,1996,18775,17542,1233,6.6
26,59,Hillsdale,1996,22087,21112,975,4.4
26,61,Houghton,1996,16550,15468,1082,6.5
26,63,Huron,1996,17198,16140,1058,6.2
26,65,Ingham,1996,150639,145055,5584,3.7
26,67,Ionia,1996,26700,25124,1576,5.9
26,69,Iosco,1996,11298,10379,919,8.1
26,71,Iron,1996,5539,5088,451,8.1
26,73,Isabella,1996,28282,27227,1055,3.7
26,75,Jackson,1996,75143,71472,3671,4.9
26,77,Kalamazoo,1996,123607,119431,4176,3.4
26,79,Kalkaska,1996,7441,6867,574,7.7
26,81,Kent,1996,302726,291066,11660,3.9
26,83,Keweenaw,1996,788,694,94,11.9
26,85,Lake,1996,3105,2771,334,10.8
26,87,Lapeer,1996,41874,39641,2233,5.3
26,89,Leelanau,1996,10422,9948,474,4.5
26,91,Lenawee,1996,45649,43668,1981,4.3
26,93,Livingston,1996,74075,71595,2480,3.3
26,95,Luce,1996,2722,2515,207,7.6
26,97,Mackinac,1996,7246,6504,742,10.2
26,99,Macomb,1996,424835,406255,18580,4.4
26,101,Manistee,1996,10095,9072,1023,10.1
26,103,Marquette,1996,31576,29651,1925,6.1
26,105,Mason,1996,13713,12533,1180,8.6
26,107,Mecosta,1996,17318,16434,884,5.1
26,109,Menominee,1996,13056,12301,755,5.8
26,111,Midland,1996,41379,39803,1576,3.8
26,113,Missaukee,1996,6190,5776,414,6.7
26,115,Monroe,1996,69133,66430,2703,3.9
26,117,Montcalm,1996,24499,22480,2019,8.2
26,119,Montmorency,1996,3344,2927,417,12.5
26,121,Muskegon,1996,79106,74458,4648,5.9
26,123,Newaygo,1996,20130,18222,1908,9.5
26,125,Oakland,1996,650168,627234,22934,3.5
26,127,Oceana,1996,13364,11982,1382,10.3
26,129,Ogemaw,1996,8424,7631,793,9.4
26,131,Ontonagon,1996,3571,2989,582,16.3
26,133,Osceola,1996,10701,9997,704,6.6
26,135,Oscoda,1996,3430,3096,334,9.7
26,137,Otsego,1996,12304,11679,625,5.1
26,139,Ottawa,1996,125067,121246,3821,3.1
26,141,Presque Isle,1996,6194,5371,823,13.3
26,143,Roscommon,1996,7999,7255,744,9.3
26,145,Saginaw,1996,99375,94501,4874,4.9
26,147,St. Clair,1996,76640,72218,4422,5.8
26,149,St. Joseph,1996,32633,31148,1485,4.6
26,151,Sanilac,1996,20523,19127,1396,6.8
26,153,Schoolcraft,1996,4107,3640,467,11.4
26,155,Shiawassee,1996,35081,32835,2246,6.4
26,157,Tuscola,1996,27012,25302,1710,6.3
26,159,Van Buren,1996,36111,33816,2295,6.4
26,161,Washtenaw,1996,163938,160249,3689,2.3
26,163,Wayne,1996,953691,898622,55069,5.8
26,165,Wexford,1996,13974,12756,1218,8.7
27,1,Aitkin,1996,6024,5462,562,9.3
27,3,Anoka,1996,171388,166057,5331,3.1
27,5,Becker,1996,13552,12502,1050,7.7
27,7,Beltrami,1996,19000,17678,1322,7.0
27,9,Benton,1996,19927,18944,983,4.9
27,11,Big Stone,1996,2843,2719,124,4.4
27,13,Blue Earth,1996,32880,31808,1072,3.3
27,15,Brown,1996,15391,14718,673,4.4
27,17,Carlton,1996,15431,14365,1066,6.9
27,19,Carver,1996,37024,36156,868,2.3
27,21,Cass,1996,11660,10634,1026,8.8
27,23,Chippewa,1996,7090,6753,337,4.8
27,25,Chisago,1996,19818,18883,935,4.7
27,27,Clay,1996,29753,28554,1199,4.0
27,29,Clearwater,1996,4070,3476,594,14.6
27,31,Cook,1996,2978,2820,158,5.3
27,33,Cottonwood,1996,6262,5828,434,6.9
27,35,Crow Wing,1996,26610,24873,1737,6.5
27,37,Dakota,1996,202268,197252,5016,2.5
27,39,Dodge,1996,8949,8464,485,5.4
27,41,Douglas,1996,16663,15925,738,4.4
27,43,Faribault,1996,8426,8008,418,5.0
27,45,Fillmore,1996,10290,9783,507,4.9
27,47,Freeborn,1996,16565,15861,704,4.2
27,49,Goodhue,1996,23810,22824,986,4.1
27,51,Grant,1996,3068,2898,170,5.5
27,53,Hennepin,1996,648592,630193,18399,2.8
27,55,Houston,1996,10978,10566,412,3.8
27,57,Hubbard,1996,8014,7373,641,8.0
27,59,Isanti,1996,15193,14459,734,4.8
27,61,Itasca,1996,19864,18019,1845,9.3
27,63,Jackson,1996,6168,5871,297,4.8
27,65,Kanabec,1996,7487,6798,689,9.2
27,67,Kandiyohi,1996,21457,20585,872,4.1
27,69,Kittson,1996,2461,2295,166,6.7
27,71,Koochiching,1996,6702,6190,512,7.6
27,73,Lac qui Parle,1996,4009,3875,134,3.3
27,75,Lake,1996,5874,5549,325,5.5
27,77,Lake of the Woods,1996,2540,2418,122,4.8
27,79,Le Sueur,1996,13953,13293,660,4.7
27,81,Lincoln,1996,3110,2957,153,4.9
27,83,Lyon,1996,15221,14700,521,3.4
27,85,McLeod,1996,21199,20417,782,3.7
27,87,Mahnomen,1996,2472,2245,227,9.2
27,89,Marshall,1996,4845,4287,558,11.5
27,91,Martin,1996,11433,10881,552,4.8
27,93,Meeker,1996,9638,9019,619,6.4
27,95,Mille Lacs,1996,9434,8614,820,8.7
27,97,Morrison,1996,15437,14158,1279,8.3
27,99,Mower,1996,18875,18253,622,3.3
27,101,Murray,1996,4471,4221,250,5.6
27,103,Nicollet,1996,18309,17781,528,2.9
27,105,Nobles,1996,10361,9992,369,3.6
27,107,Norman,1996,3687,3474,213,5.8
27,109,Olmsted,1996,65804,63896,1908,2.9
27,111,Otter Tail,1996,27918,26310,1608,5.8
27,113,Pennington,1996,8024,7527,497,6.2
27,115,Pine,1996,11407,10436,971,8.5
27,117,Pipestone,1996,5261,5077,184,3.5
27,119,Polk,1996,17218,16274,944,5.5
27,121,Pope,1996,5500,5245,255,4.6
27,123,Ramsey,1996,279671,271108,8563,3.1
27,125,Red Lake,1996,2037,1795,242,11.9
27,127,Redwood,1996,9244,8898,346,3.7
27,129,Renville,1996,8501,8044,457,5.4
27,131,Rice,1996,28901,27774,1127,3.9
27,133,Rock,1996,5134,4996,138,2.7
27,135,Roseau,1996,9307,8795,512,5.5
27,137,St. Louis,1996,102157,96576,5581,5.5
27,139,Scott,1996,43022,41758,1264,2.9
27,141,Sherburne,1996,30274,29074,1200,4.0
27,143,Sibley,1996,6938,6571,367,5.3
27,145,Stearns,1996,75402,71828,3574,4.7
27,147,Steele,1996,18960,18298,662,3.5
27,149,Stevens,1996,5623,5431,192,3.4
27,151,Swift,1996,5566,5285,281,5.0
27,153,Todd,1996,10466,9678,788,7.5
27,155,Traverse,1996,1917,1821,96,5.0
27,157,Wabasha,1996,12274,11727,547,4.5
27,159,Wadena,1996,6421,6000,421,6.6
27,161,Waseca,1996,9662,9265,397,4.1
27,163,Washington,1996,108884,106103,2781,2.6
27,165,Watonwan,1996,5928,5693,235,4.0
27,167,Wilkin,1996,4025,3879,146,3.6
27,169,Winona,1996,28581,27513,1068,3.7
27,171,Wright,1996,45138,43359,1779,3.9
27,173,Yellow Medicine,1996,5476,5185,291,5.3
28,1,Adams,1996,14251,13280,971,6.8
28,3,Alcorn,1996,15156,13662,1494,9.9
28,5,Amite,1996,5407,5139,268,5.0
28,7,Attala,1996,7811,6986,825,10.6
28,9,Benton,1996,3151,2874,277,8.8
28,11,Bolivar,1996,17560,15933,1627,9.3
28,13,Calhoun,1996,6890,6522,368,5.3
28,15,Carroll,1996,4471,4221,250,5.6
28,17,Chickasaw,1996,8629,7780,849,9.8
28,19,Choctaw,1996,3314,3012,302,9.1
28,21,Claiborne,1996,3553,3187,366,10.3
28,23,Clarke,1996,8600,8011,589,6.8
28,25,Clay,1996,9287,8326,961,10.3
28,27,Coahoma,1996,12445,11235,1210,9.7
28,29,Copiah,1996,11018,10172,846,7.7
28,31,Covington,1996,8605,8067,538,6.3
28,33,DeSoto,1996,47139,45556,1583,3.4
28,35,Forrest,1996,33390,31966,1424,4.3
28,37,Franklin,1996,3269,3105,164,5.0
28,39,George,1996,8476,7681,795,9.4
28,41,Greene,1996,5259,4832,427,8.1
28,43,Grenada,1996,10113,9458,655,6.5
28,45,Hancock,1996,16344,15431,913,5.6
28,47,Harrison,1996,81312,77433,3879,4.8
28,49,Hinds,1996,128648,123573,5075,3.9
28,51,Holmes,1996,7507,6631,876,11.7
28,53,Humphreys,1996,4895,4393,502,10.3
28,55,Issaquena,1996,719,590,129,17.9
28,57,Itawamba,1996,11477,10731,746,6.5
28,59,Jackson,1996,64992,61462,3530,5.4
28,61,Jasper,1996,7664,7213,451,5.9
28,63,Jefferson,1996,2478,2100,378,15.3
28,65,Jefferson Davis,1996,4904,4252,652,13.3
28,67,Jones,1996,30193,29147,1046,3.5
28,69,Kemper,1996,4274,3937,337,7.9
28,71,Lafayette,1996,16577,16138,439,2.6
28,73,Lamar,1996,16499,15963,536,3.2
28,75,Lauderdale,1996,35261,33404,1857,5.3
28,77,Lawrence,1996,5577,5207,370,6.6
28,79,Leake,1996,9224,8767,457,5.0
28,81,Lee,1996,39596,37778,1818,4.6
28,83,Leflore,1996,15654,14216,1438,9.2
28,85,Lincoln,1996,13454,12733,721,5.4
28,87,Lowndes,1996,27820,26016,1804,6.5
28,89,Madison,1996,34315,33132,1183,3.4
28,91,Marion,1996,10256,9579,677,6.6
28,93,Marshall,1996,13467,12423,1044,7.8
28,95,Monroe,1996,16052,14275,1777,11.1
28,97,Montgomery,1996,5449,5079,370,6.8
28,99,Neshoba,1996,16350,15758,592,3.6
28,101,Newton,1996,8444,7973,471,5.6
28,103,Noxubee,1996,4520,4095,425,9.4
28,105,Oktibbeha,1996,19769,19223,546,2.8
28,107,Panola,1996,13816,11461,2355,17.0
28,109,Pearl River,1996,19113,18285,828,4.3
28,111,Perry,1996,4700,4325,375,8.0
28,113,Pike,1996,16180,15344,836,5.2
28,115,Pontotoc,1996,13162,12472,690,5.2
28,117,Prentiss,1996,12395,11386,1009,8.1
28,119,Quitman,1996,3527,2939,588,16.7
28,121,Rankin,1996,55714,54238,1476,2.6
28,123,Scott,1996,12737,12021,716,5.6
28,125,Sharkey,1996,2746,2274,472,17.2
28,127,Simpson,1996,10567,9795,772,7.3
28,129,Smith,1996,6028,5755,273,4.5
28,131,Stone,1996,5032,4708,324,6.4
28,133,Sunflower,1996,11207,9814,1393,12.4
28,135,Tallahatchie,1996,5448,4778,670,12.3
28,137,Tate,1996,10628,10048,580,5.5
28,139,Tippah,1996,9657,9007,650,6.7
28,141,Tishomingo,1996,9955,9014,941,9.5
28,143,Tunica,1996,5716,5290,426,7.5
28,145,Union,1996,12307,11529,778,6.3
28,147,Walthall,1996,6098,5751,347,5.7
28,149,Warren,1996,26513,25106,1407,5.3
28,151,Washington,1996,29026,26141,2885,9.9
28,153,Wayne,1996,9161,8662,499,5.4
28,155,Webster,1996,4422,4159,263,5.9
28,157,Wilkinson,1996,3524,3038,486,13.8
28,159,Winston,1996,7925,7308,617,7.8
28,161,Yalobusha,1996,5228,4844,384,7.3
28,163,Yazoo,1996,9380,8481,899,9.6
29,1,Adair,1996,15055,14627,428,2.8
29,3,Andrew,1996,7961,7545,416,5.2
29,5,Atchison,1996,3602,3497,105,2.9
29,7,Audrain,1996,12613,12036,577,4.6
29,9,Barry,1996,15415,14488,927,6.0
29,11,Barton,1996,6944,6665,279,4.0
29,13,Bates,1996,7716,7220,496,6.4
29,15,Benton,1996,6380,5955,425,6.7
29,17,Bollinger,1996,5283,4842,441,8.3
29,19,Boone,1996,79569,78203,1366,1.7
29,21,Buchanan,1996,41648,38682,2966,7.1
29,23,Butler,1996,19736,18509,1227,6.2
29,25,Caldwell,1996,3825,3632,193,5.0
29,27,Callaway,1996,20681,19883,798,3.9
29,29,Camden,1996,16509,15412,1097,6.6
29,31,Cape Girardeau,1996,36472,34779,1693,4.6
29,33,Carroll,1996,5563,5277,286,5.1
29,35,Carter,1996,2747,2498,249,9.1
29,37,Cass,1996,42032,40471,1561,3.7
29,39,Cedar,1996,5663,5321,342,6.0
29,41,Chariton,1996,4262,3974,288,6.8
29,43,Christian,1996,25777,24781,996,3.9
29,45,Clark,1996,3782,3558,224,5.9
29,47,Clay,1996,102163,99086,3077,3.0
29,49,Clinton,1996,9268,8895,373,4.0
29,51,Cole,1996,39156,38113,1043,2.7
29,53,Cooper,1996,8557,8235,322,3.8
29,55,Crawford,1996,10411,9443,968,9.3
29,57,Dade,1996,3388,3207,181,5.3
29,59,Dallas,1996,6561,6117,444,6.8
29,61,Daviess,1996,3661,3461,200,5.5
29,63,DeKalb,1996,4249,4041,208,4.9
29,65,Dent,1996,6622,6209,413,6.2
29,67,Douglas,1996,6240,5455,785,12.6
29,69,Dunklin,1996,14419,13407,1012,7.0
29,71,Franklin,1996,47390,45025,2365,5.0
29,73,Gasconade,1996,7574,7161,413,5.5
29,75,Gentry,1996,3836,3718,118,3.1
29,77,Greene,1996,128635,124306,4329,3.4
29,79,Grundy,1996,5147,4962,185,3.6
29,81,Harrison,1996,4641,4423,218,4.7
29,83,Henry,1996,10251,9606,645,6.3
29,85,Hickory,1996,3091,2863,228,7.4
29,87,Holt,1996,2819,2687,132,4.7
29,89,Howard,1996,4816,4630,186,3.9
29,91,Howell,1996,17700,16499,1201,6.8
29,93,Iron,1996,4470,4076,394,8.8
29,95,Jackson,1996,362069,345248,16821,4.6
29,97,Jasper,1996,53291,51102,2189,4.1
29,99,Jefferson,1996,102861,98306,4555,4.4
29,101,Johnson,1996,22489,21854,635,2.8
29,103,Knox,1996,1995,1917,78,3.9
29,105,Laclede,1996,15460,14429,1031,6.7
29,107,Lafayette,1996,16484,15761,723,4.4
29,109,Lawrence,1996,15864,14973,891,5.6
29,111,Lewis,1996,5567,5344,223,4.0
29,113,Lincoln,1996,17496,16666,830,4.7
29,115,Linn,1996,7183,6488,695,9.7
29,117,Livingston,1996,7426,7129,297,4.0
29,119,McDonald,1996,8693,8249,444,5.1
29,121,Macon,1996,7704,7250,454,5.9
29,123,Madison,1996,4571,4109,462,10.1
29,125,Maries,1996,4285,4078,207,4.8
29,127,Marion,1996,15717,14964,753,4.8
29,129,Mercer,1996,2177,2107,70,3.2
29,131,Miller,1996,11575,10750,825,7.1
29,133,Mississippi,1996,6108,5583,525,8.6
29,135,Moniteau,1996,7224,6938,286,4.0
29,137,Monroe,1996,4444,4200,244,5.5
29,139,Montgomery,1996,6252,5955,297,4.8
29,141,Morgan,1996,8457,7916,541,6.4
29,143,New Madrid,1996,8791,8136,655,7.5
29,145,Newton,1996,26589,25237,1352,5.1
29,147,Nodaway,1996,12762,12573,189,1.5
29,149,Oregon,1996,4483,4175,308,6.9
29,151,Osage,1996,7245,7025,220,3.0
29,153,Ozark,1996,4201,3899,302,7.2
29,155,Pemiscot,1996,8767,7979,788,9.0
29,157,Perry,1996,10318,9877,441,4.3
29,159,Pettis,1996,21189,19980,1209,5.7
29,161,Phelps,1996,19204,18402,802,4.2
29,163,Pike,1996,7324,6827,497,6.8
29,165,Platte,1996,41939,40806,1133,2.7
29,167,Polk,1996,11839,11286,553,4.7
29,169,Pulaski,1996,12382,11591,791,6.4
29,171,Putnam,1996,2318,2217,101,4.4
29,173,Ralls,1996,5241,5010,231,4.4
29,175,Randolph,1996,10651,10039,612,5.7
29,177,Ray,1996,11078,10563,515,4.6
29,179,Reynolds,1996,3278,3082,196,6.0
29,181,Ripley,1996,5380,4911,469,8.7
29,183,St. Charles,1996,150305,145776,4529,3.0
29,185,St. Clair,1996,4112,3833,279,6.8
29,186,Ste. Genevieve,1996,8844,8391,453,5.1
29,187,St. Francois,1996,23821,22022,1799,7.6
29,189,St. Louis,1996,573982,553496,20486,3.6
29,195,Saline,1996,12464,11919,545,4.4
29,197,Schuyler,1996,2568,2439,129,5.0
29,199,Scotland,1996,2236,2119,117,5.2
29,201,Scott,1996,20177,18792,1385,6.9
29,203,Shannon,1996,3943,3666,277,7.0
29,205,Shelby,1996,3701,3569,132,3.6
29,207,Stoddard,1996,14472,12963,1509,10.4
29,209,Stone,1996,14200,12558,1642,11.6
29,211,Sullivan,1996,3493,3342,151,4.3
29,213,Taney,1996,27721,25099,2622,9.5
29,215,Texas,1996,9817,8662,1155,11.8
29,217,Vernon,1996,9248,8812,436,4.7
29,219,Warren,1996,11911,11351,560,4.7
29,221,Washington,1996,9319,8362,957,10.3
29,223,Wayne,1996,3733,3217,516,13.8
29,225,Webster,1996,13934,13304,630,4.5
29,227,Worth,1996,977,923,54,5.5
29,229,Wright,1996,7614,6719,895,11.8
29,510,St. Louis city,1996,166669,153411,13258,8.0
30,1,Beaverhead,1996,4989,4774,215,4.3
30,3,Big Horn,1996,5087,4550,537,10.6
30,5,Blaine,1996,2914,2611,303,10.4
30,7,Broadwater,1996,1931,1822,109,5.6
30,9,Carbon,1996,4504,4236,268,6.0
30,11,Carter,1996,954,939,15,1.6
30,13,Cascade,1996,37167,35306,1861,5.0
30,15,Chouteau,1996,2752,2676,76,2.8
30,17,Custer,1996,6001,5706,295,4.9
30,19,Daniels,1996,1275,1244,31,2.4
30,21,Dawson,1996,4759,4600,159,3.3
30,23,Deer Lodge,1996,3783,3490,293,7.7
30,25,Fallon,1996,1641,1600,41,2.5
30,27,Fergus,1996,6159,5793,366,5.9
30,29,Flathead,1996,36887,34032,2855,7.7
30,31,Gallatin,1996,37997,36974,1023,2.7
30,33,Garfield,1996,934,907,27,2.9
30,35,Glacier,1996,5696,4881,815,14.3
30,37,Golden Valley,1996,502,471,31,6.2
30,39,Granite,1996,1135,1070,65,5.7
30,41,Hill,1996,9033,8576,457,5.1
30,43,Jefferson,1996,4829,4576,253,5.2
30,45,Judith Basin,1996,1109,1061,48,4.3
30,47,Lake,1996,10742,9941,801,7.5
30,49,Lewis and Clark,1996,27715,26387,1328,4.8
30,51,Liberty,1996,1099,1076,23,2.1
30,53,Lincoln,1996,7202,6318,884,12.3
30,55,McCone,1996,1200,1156,44,3.7
30,57,Madison,1996,3617,3462,155,4.3
30,59,Meagher,1996,964,914,50,5.2
30,61,Mineral,1996,1642,1485,157,9.6
30,63,Missoula,1996,50109,47985,2124,4.2
30,65,Musselshell,1996,1947,1781,166,8.5
30,67,Park,1996,10450,9924,526,5.0
30,69,Petroleum,1996,311,298,13,4.2
30,71,Phillips,1996,2470,2249,221,8.9
30,73,Pondera,1996,3168,3021,147,4.6
30,75,Powder River,1996,1258,1236,22,1.7
30,77,Powell,1996,2434,2297,137,5.6
30,79,Prairie,1996,677,643,34,5.0
30,81,Ravalli,1996,16067,15043,1024,6.4
30,83,Richland,1996,5426,5105,321,5.9
30,85,Roosevelt,1996,4065,3634,431,10.6
30,87,Rosebud,1996,4591,4022,569,12.4
30,89,Sanders,1996,4097,3558,539,13.2
30,91,Sheridan,1996,2051,1998,53,2.6
30,93,Silver Bow,1996,17035,15987,1048,6.2
30,95,Stillwater,1996,3958,3769,189,4.8
30,97,Sweet Grass,1996,1706,1654,52,3.0
30,99,Teton,1996,3138,3027,111,3.5
30,101,Toole,1996,2818,2706,112,4.0
30,103,Treasure,1996,443,426,17,3.8
30,105,Valley,1996,4396,4195,201,4.6
30,107,Wheatland,1996,1359,1298,61,4.5
30,109,Wibaux,1996,570,547,23,4.0
30,111,Yellowstone,1996,67575,64401,3174,4.7
31,1,Adams,1996,16083,15798,285,1.8
31,3,Antelope,1996,3196,3069,127,4.0
31,5,Arthur,1996,210,204,6,2.9
31,7,Banner,1996,433,425,8,1.8
31,9,Blaine,1996,363,349,14,3.9
31,11,Boone,1996,2965,2891,74,2.5
31,13,Box Butte,1996,6185,5847,338,5.5
31,15,Boyd,1996,1202,1175,27,2.2
31,17,Brown,1996,1790,1712,78,4.4
31,19,Buffalo,1996,24082,23450,632,2.6
31,21,Burt,1996,3536,3393,143,4.0
31,23,Butler,1996,4316,4206,110,2.5
31,25,Cass,1996,12348,11989,359,2.9
31,27,Cedar,1996,5099,4993,106,2.1
31,29,Chase,1996,1999,1956,43,2.2
31,31,Cherry,1996,3428,3337,91,2.7
31,33,Cheyenne,1996,5153,5036,117,2.3
31,35,Clay,1996,3563,3488,75,2.1
31,37,Colfax,1996,4847,4746,101,2.1
31,39,Cuming,1996,5311,5182,129,2.4
31,41,Custer,1996,5711,5573,138,2.4
31,43,Dakota,1996,10273,9952,321,3.1
31,45,Dawes,1996,4555,4373,182,4.0
31,47,Dawson,1996,13543,13116,427,3.2
31,49,Deuel,1996,1044,1018,26,2.5
31,51,Dixon,1996,2621,2551,70,2.7
31,53,Dodge,1996,19213,18655,558,2.9
31,55,Douglas,1996,252254,245324,6930,2.7
31,57,Dundy,1996,1169,1145,24,2.1
31,59,Fillmore,1996,3371,3311,60,1.8
31,61,Franklin,1996,1720,1685,35,2.0
31,63,Frontier,1996,1575,1530,45,2.9
31,65,Furnas,1996,2609,2541,68,2.6
31,67,Gage,1996,12400,12126,274,2.2
31,69,Garden,1996,1109,1086,23,2.1
31,71,Garfield,1996,1078,1053,25,2.3
31,73,Gosper,1996,1352,1325,27,2.0
31,75,Grant,1996,378,370,8,2.1
31,77,Greeley,1996,1552,1497,55,3.5
31,79,Hall,1996,31028,30248,780,2.5
31,81,Hamilton,1996,5308,5222,86,1.6
31,83,Harlan,1996,1836,1787,49,2.7
31,85,Hayes,1996,523,503,20,3.8
31,87,Hitchcock,1996,1613,1570,43,2.7
31,89,Holt,1996,6577,6380,197,3.0
31,91,Hooker,1996,429,416,13,3.0
31,93,Howard,1996,3485,3388,97,2.8
31,95,Jefferson,1996,4320,4228,92,2.1
31,97,Johnson,1996,2232,2148,84,3.8
31,99,Kearney,1996,3556,3492,64,1.8
31,101,Keith,1996,4643,4468,175,3.8
31,103,Keya Paha,1996,484,465,19,3.9
31,105,Kimball,1996,1993,1950,43,2.2
31,107,Knox,1996,4801,4630,171,3.6
31,109,Lancaster,1996,141624,138308,3316,2.3
31,111,Lincoln,1996,17656,16991,665,3.8
31,113,Logan,1996,451,439,12,2.7
31,115,Loup,1996,463,452,11,2.4
31,117,McPherson,1996,321,311,10,3.1
31,119,Madison,1996,20326,19795,531,2.6
31,121,Merrick,1996,4670,4573,97,2.1
31,123,Morrill,1996,2939,2829,110,3.7
31,125,Nance,1996,1840,1792,48,2.6
31,127,Nemaha,1996,3931,3747,184,4.7
31,129,Nuckolls,1996,2395,2338,57,2.4
31,131,Otoe,1996,7623,7382,241,3.2
31,133,Pawnee,1996,1462,1412,50,3.4
31,135,Perkins,1996,1520,1483,37,2.4
31,137,Phelps,1996,5418,5309,109,2.0
31,139,Pierce,1996,4083,3984,99,2.4
31,141,Platte,1996,18025,17549,476,2.6
31,143,Polk,1996,2495,2445,50,2.0
31,145,Red Willow,1996,6134,5962,172,2.8
31,147,Richardson,1996,4700,4489,211,4.5
31,149,Rock,1996,948,915,33,3.5
31,151,Saline,1996,7120,6999,121,1.7
31,153,Sarpy,1996,58308,57061,1247,2.1
31,155,Saunders,1996,10557,10252,305,2.9
31,157,Scotts Bluff,1996,18460,17601,859,4.7
31,159,Seward,1996,9213,8961,252,2.7
31,161,Sheridan,1996,3075,2987,88,2.9
31,163,Sherman,1996,1618,1570,48,3.0
31,165,Sioux,1996,785,773,12,1.5
31,167,Stanton,1996,3385,3306,79,2.3
31,169,Thayer,1996,3274,3210,64,2.0
31,171,Thomas,1996,483,449,34,7.0
31,173,Thurston,1996,2905,2675,230,7.9
31,175,Valley,1996,2689,2634,55,2.0
31,177,Washington,1996,10493,10293,200,1.9
31,179,Wayne,1996,5747,5559,188,3.3
31,181,Webster,1996,1832,1796,36,2.0
31,183,Wheeler,1996,365,352,13,3.6
31,185,York,1996,8736,8590,146,1.7
32,1,Churchill,1996,9654,9002,652,6.8
32,3,Clark,1996,593669,564281,29388,5.0
32,5,Douglas,1996,17823,16689,1134,6.4
32,7,Elko,1996,22141,21035,1106,5.0
32,9,Esmeralda,1996,569,528,41,7.2
32,11,Eureka,1996,854,794,60,7.0
32,13,Humboldt,1996,8952,8610,342,3.8
32,15,Lander,1996,3261,2996,265,8.1
32,17,Lincoln,1996,1219,1074,145,11.9
32,19,Lyon,1996,11934,10973,961,8.1
32,21,Mineral,1996,2774,2581,193,7.0
32,23,Nye,1996,13216,12566,650,4.9
32,27,Pershing,1996,2455,2334,121,4.9
32,29,Storey,1996,1585,1515,70,4.4
32,31,Washoe,1996,176997,168930,8067,4.6
32,33,White Pine,1996,4197,3883,314,7.5
32,510,Carson City,1996,23225,21435,1790,7.7
33,1,Belknap,1996,28256,27211,1045,3.7
33,3,Carroll,1996,20816,19977,839,4.0
33,5,Cheshire,1996,38482,37218,1264,3.3
33,7,Coos,1996,16769,15682,1087,6.5
33,9,Grafton,1996,41138,39779,1359,3.3
33,11,Hillsborough,1996,193976,187084,6892,3.6
33,13,Merrimack,1996,70853,68902,1951,2.8
33,15,Rockingham,1996,148096,141449,6647,4.5
33,17,Strafford,1996,56984,54775,2209,3.9
33,19,Sullivan,1996,20861,20286,575,2.8
34,1,Atlantic,1996,128073,117468,10605,8.3
34,3,Bergen,1996,442981,419753,23228,5.2
34,5,Burlington,1996,220170,209812,10358,4.7
34,7,Camden,1996,257301,241916,15385,6.0
34,9,Cape May,1996,46864,41368,5496,11.7
34,11,Cumberland,1996,65536,59102,6434,9.8
34,13,Essex,1996,375379,346400,28979,7.7
34,15,Gloucester,1996,128343,120456,7887,6.1
34,17,Hudson,1996,290352,263797,26555,9.1
34,19,Hunterdon,1996,66550,64502,2048,3.1
34,21,Mercer,1996,171264,161688,9576,5.6
34,23,Middlesex,1996,397497,376995,20502,5.2
34,25,Monmouth,1996,308730,292607,16123,5.2
34,27,Morris,1996,255147,245071,10076,3.9
34,29,Ocean,1996,210554,197741,12813,6.1
34,31,Passaic,1996,235501,216184,19317,8.2
34,33,Salem,1996,32713,30369,2344,7.2
34,35,Somerset,1996,159355,153931,5424,3.4
34,37,Sussex,1996,75349,71385,3964,5.3
34,39,Union,1996,265533,248885,16648,6.3
34,41,Warren,1996,50687,47921,2766,5.5
35,1,Bernalillo,1996,285448,271222,14226,5.0
35,3,Catron,1996,1247,1068,179,14.4
35,5,Chaves,1996,25997,23666,2331,9.0
35,6,Cibola,1996,10616,9133,1483,14.0
35,7,Colfax,1996,6490,5720,770,11.9
35,9,Curry,1996,20125,18866,1259,6.3
35,11,De Baca,1996,954,907,47,4.9
35,13,Dona Ana,1996,66400,59912,6488,9.8
35,15,Eddy,1996,23063,21290,1773,7.7
35,17,Grant,1996,12865,11893,972,7.6
35,19,Guadalupe,1996,1883,1637,246,13.1
35,21,Harding,1996,444,424,20,4.5
35,23,Hidalgo,1996,2616,2455,161,6.2
35,25,Lea,1996,24471,22952,1519,6.2
35,27,Lincoln,1996,6898,6316,582,8.4
35,28,Los Alamos,1996,10410,10107,303,2.9
35,29,Luna,1996,11314,8265,3049,26.9
35,31,McKinley,1996,24823,22263,2560,10.3
35,33,Mora,1996,1734,1371,363,20.9
35,35,Otero,1996,20944,19147,1797,8.6
35,37,Quay,1996,4617,4331,286,6.2
35,39,Rio Arriba,1996,18422,15806,2616,14.2
35,41,Roosevelt,1996,7537,7085,452,6.0
35,43,Sandoval,1996,40002,37994,2008,5.0
35,45,San Juan,1996,49235,43283,5952,12.1
35,47,San Miguel,1996,12669,11080,1589,12.5
35,49,Santa Fe,1996,63351,60133,3218,5.1
35,51,Sierra,1996,3997,3818,179,4.5
35,53,Socorro,1996,6492,5961,531,8.2
35,55,Taos,1996,13418,11135,2283,17.0
35,57,Torrance,1996,5728,5261,467,8.2
35,59,Union,1996,1923,1832,91,4.7
35,61,Valencia,1996,26874,25573,1301,4.8
36,1,Albany,1996,156649,150788,5861,3.7
36,3,Allegany,1996,23349,21578,1771,7.6
36,5,Bronx,1996,462270,413620,48650,10.5
36,7,Broome,1996,96582,92341,4241,4.4
36,9,Cattaraugus,1996,41035,38145,2890,7.0
36,11,Cayuga,1996,37921,35759,2162,5.7
36,13,Chautauqua,1996,68175,64678,3497,5.1
36,15,Chemung,1996,44005,42123,1882,4.3
36,17,Chenango,1996,23917,22352,1565,6.5
36,19,Clinton,1996,39807,37097,2710,6.8
36,21,Columbia,1996,32537,31213,1324,4.1
36,23,Cortland,1996,23684,22217,1467,6.2
36,25,Delaware,1996,20578,19494,1084,5.3
36,27,Dutchess,1996,118167,113190,4977,4.2
36,29,Erie,1996,467758,445083,22675,4.8
36,31,Essex,1996,17993,16464,1529,8.5
36,33,Franklin,1996,21727,19904,1823,8.4
36,35,Fulton,1996,27170,24894,2276,8.4
36,37,Genesee,1996,32314,30678,1636,5.1
36,39,Greene,1996,20965,19553,1412,6.7
36,41,Hamilton,1996,2513,2234,279,11.1
36,43,Herkimer,1996,31508,29415,2093,6.6
36,45,Jefferson,1996,44041,40304,3737,8.5
36,47,Kings,1996,956921,861630,95291,10.0
36,49,Lewis,1996,12488,11508,980,7.8
36,51,Livingston,1996,34589,32807,1782,5.2
36,53,Madison,1996,35714,33846,1868,5.2
36,55,Monroe,1996,382527,369204,13323,3.5
36,57,Montgomery,1996,23992,22050,1942,8.1
36,59,Nassau,1996,679341,653927,25414,3.7
36,61,New York,1996,809171,749523,59648,7.4
36,63,Niagara,1996,109816,103112,6704,6.1
36,65,Oneida,1996,111320,105851,5469,4.9
36,67,Onondaga,1996,235391,225749,9642,4.1
36,69,Ontario,1996,53540,51159,2381,4.4
36,71,Orange,1996,154688,148085,6603,4.3
36,73,Orleans,1996,21003,19830,1173,5.6
36,75,Oswego,1996,57309,53305,4004,7.0
36,77,Otsego,1996,31407,29783,1624,5.2
36,79,Putnam,1996,49912,48132,1780,3.6
36,81,Queens,1996,977553,898752,78801,8.1
36,83,Rensselaer,1996,80328,76383,3945,4.9
36,85,Richmond,1996,191623,176726,14897,7.8
36,87,Rockland,1996,140931,134843,6088,4.3
36,89,St. Lawrence,1996,50952,46825,4127,8.1
36,91,Saratoga,1996,101490,97100,4390,4.3
36,93,Schenectady,1996,73066,69619,3447,4.7
36,95,Schoharie,1996,15327,14399,928,6.1
36,97,Schuyler,1996,9037,8530,507,5.6
36,99,Seneca,1996,15264,14449,815,5.3
36,101,Steuben,1996,48269,45393,2876,6.0
36,103,Suffolk,1996,699412,667114,32298,4.6
36,105,Sullivan,1996,32460,30376,2084,6.4
36,107,Tioga,1996,25725,24531,1194,4.6
36,109,Tompkins,1996,49447,47946,1501,3.0
36,111,Ulster,1996,77836,74318,3518,4.5
36,113,Warren,1996,32473,30237,2236,6.9
36,115,Washington,1996,29308,27662,1646,5.6
36,117,Wayne,1996,49414,46922,2492,5.0
36,119,Westchester,1996,444810,426685,18125,4.1
36,121,Wyoming,1996,20440,19094,1346,6.6
36,123,Yates,1996,13089,12552,537,4.1
37,1,Alamance,1996,66343,63966,2377,3.6
37,3,Alexander,1996,17285,16680,605,3.5
37,5,Alleghany,1996,5597,5140,457,8.2
37,7,Anson,1996,11474,10646,828,7.2
37,9,Ashe,1996,11791,10511,1280,10.9
37,11,Avery,1996,7702,7310,392,5.1
37,13,Beaufort,1996,20398,18753,1645,8.1
37,15,Bertie,1996,9384,8752,632,6.7
37,17,Bladen,1996,19448,18256,1192,6.1
37,19,Brunswick,1996,30894,28659,2235,7.2
37,21,Buncombe,1996,102545,99177,3368,3.3
37,23,Burke,1996,44468,42487,1981,4.5
37,25,Cabarrus,1996,63409,61297,2112,3.3
37,27,Caldwell,1996,42012,40352,1660,4.0
37,29,Camden,1996,3141,3020,121,3.9
37,31,Carteret,1996,29144,27712,1432,4.9
37,33,Caswell,1996,12205,11774,431,3.5
37,35,Catawba,1996,76472,73397,3075,4.0
37,37,Chatham,1996,25406,24730,676,2.7
37,39,Cherokee,1996,10066,9381,685,6.8
37,41,Chowan,1996,6670,6294,376,5.6
37,43,Clay,1996,3684,3455,229,6.2
37,45,Cleveland,1996,48007,44475,3532,7.4
37,47,Columbus,1996,24551,22584,1967,8.0
37,49,Craven,1996,36213,34487,1726,4.8
37,51,Cumberland,1996,116429,110985,5444,4.7
37,53,Currituck,1996,8344,8091,253,3.0
37,55,Dare,1996,16663,15690,973,5.8
37,57,Davidson,1996,78960,76446,2514,3.2
37,59,Davie,1996,17038,16419,619,3.6
37,61,Duplin,1996,22582,21367,1215,5.4
37,63,Durham,1996,112741,109522,3219,2.9
37,65,Edgecombe,1996,28790,25337,3453,12.0
37,67,Forsyth,1996,155517,150411,5106,3.3
37,69,Franklin,1996,22449,21521,928,4.1
37,71,Gaston,1996,101414,96018,5396,5.3
37,73,Gates,1996,4641,4493,148,3.2
37,75,Graham,1996,4506,3958,548,12.2
37,77,Granville,1996,22605,21737,868,3.8
37,79,Greene,1996,8671,8333,338,3.9
37,81,Guilford,1996,219614,212174,7440,3.4
37,83,Halifax,1996,24081,21687,2394,9.9
37,85,Harnett,1996,35980,34595,1385,3.8
37,87,Haywood,1996,24961,23715,1246,5.0
37,89,Henderson,1996,36426,35333,1093,3.0
37,91,Hertford,1996,10124,9545,579,5.7
37,93,Hoke,1996,11165,10568,597,5.3
37,95,Hyde,1996,3006,2729,277,9.2
37,97,Iredell,1996,59581,57476,2105,3.5
37,99,Jackson,1996,15536,14658,878,5.7
37,101,Johnston,1996,54077,52723,1354,2.5
37,103,Jones,1996,4493,4299,194,4.3
37,105,Lee,1996,26295,25041,1254,4.8
37,107,Lenoir,1996,30317,28225,2092,6.9
37,109,Lincoln,1996,31871,30231,1640,5.1
37,111,McDowell,1996,20719,19350,1369,6.6
37,113,Macon,1996,13292,12716,576,4.3
37,115,Madison,1996,9096,8652,444,4.9
37,117,Martin,1996,12859,11460,1399,10.9
37,119,Mecklenburg,1996,349224,338829,10395,3.0
37,121,Mitchell,1996,7452,7045,407,5.5
37,123,Montgomery,1996,12165,11343,822,6.8
37,125,Moore,1996,29797,28352,1445,4.8
37,127,Nash,1996,45947,43061,2886,6.3
37,129,New Hanover,1996,78422,74858,3564,4.5
37,131,Northampton,1996,8544,7878,666,7.8
37,133,Onslow,1996,45439,43580,1859,4.1
37,135,Orange,1996,61474,60375,1099,1.8
37,137,Pamlico,1996,5542,5257,285,5.1
37,139,Pasquotank,1996,14992,14222,770,5.1
37,141,Pender,1996,16023,15180,843,5.3
37,143,Perquimans,1996,4799,4577,222,4.6
37,145,Person,1996,18342,17309,1033,5.6
37,147,Pitt,1996,65206,61893,3313,5.1
37,149,Polk,1996,7701,7514,187,2.4
37,151,Randolph,1996,70087,67668,2419,3.5
37,153,Richmond,1996,21230,18807,2423,11.4
37,155,Robeson,1996,55738,50480,5258,9.4
37,157,Rockingham,1996,48473,46180,2293,4.7
37,159,Rowan,1996,64594,62260,2334,3.6
37,161,Rutherford,1996,31318,29298,2020,6.4
37,163,Sampson,1996,23928,22409,1519,6.3
37,165,Scotland,1996,18066,16788,1278,7.1
37,167,Stanly,1996,27355,25624,1731,6.3
37,169,Stokes,1996,22798,22210,588,2.6
37,171,Surry,1996,36518,34743,1775,4.9
37,173,Swain,1996,6137,5032,1105,18.0
37,175,Transylvania,1996,11235,10885,350,3.1
37,177,Tyrrell,1996,1820,1649,171,9.4
37,179,Union,1996,56434,55022,1412,2.5
37,181,Vance,1996,19953,18341,1612,8.1
37,183,Wake,1996,322213,315517,6696,2.1
37,185,Warren,1996,7490,6728,762,10.2
37,187,Washington,1996,6079,5628,451,7.4
37,189,Watauga,1996,22807,22151,656,2.9
37,191,Wayne,1996,48840,46455,2385,4.9
37,193,Wilkes,1996,33315,31481,1834,5.5
37,195,Wilson,1996,35653,32478,3175,8.9
37,197,Yadkin,1996,18238,17689,549,3.0
37,199,Yancey,1996,6294,5913,381,6.1
38,1,Adams,1996,1516,1490,26,1.7
38,3,Barnes,1996,6022,5847,175,2.9
38,5,Benson,1996,2873,2565,308,10.7
38,7,Billings,1996,581,562,19,3.3
38,9,Bottineau,1996,3460,3352,108,3.1
38,11,Bowman,1996,1826,1789,37,2.0
38,13,Burke,1996,1082,1049,33,3.0
38,15,Burleigh,1996,39274,38173,1101,2.8
38,17,Cass,1996,69777,68541,1236,1.8
38,19,Cavalier,1996,2611,2502,109,4.2
38,21,Dickey,1996,2861,2809,52,1.8
38,23,Divide,1996,1212,1183,29,2.4
38,25,Dunn,1996,1998,1924,74,3.7
38,27,Eddy,1996,1322,1250,72,5.4
38,29,Emmons,1996,2126,2048,78,3.7
38,31,Foster,1996,2173,2117,56,2.6
38,33,Golden Valley,1996,908,877,31,3.4
38,35,Grand Forks,1996,38152,37216,936,2.5
38,37,Grant,1996,1631,1587,44,2.7
38,39,Griggs,1996,1670,1630,40,2.4
38,41,Hettinger,1996,1407,1373,34,2.4
38,43,Kidder,1996,1500,1434,66,4.4
38,45,LaMoure,1996,2376,2312,64,2.7
38,47,Logan,1996,1232,1204,28,2.3
38,49,McHenry,1996,2892,2759,133,4.6
38,51,McIntosh,1996,1800,1763,37,2.1
38,53,McKenzie,1996,3291,3180,111,3.4
38,55,McLean,1996,4696,4430,266,5.7
38,57,Mercer,1996,5549,5248,301,5.4
38,59,Morton,1996,13566,13064,502,3.7
38,61,Mountrail,1996,3112,2894,218,7.0
38,63,Nelson,1996,1762,1690,72,4.1
38,65,Oliver,1996,1142,1092,50,4.4
38,67,Pembina,1996,5159,4841,318,6.2
38,69,Pierce,1996,2484,2419,65,2.6
38,71,Ramsey,1996,6746,6526,220,3.3
38,73,Ransom,1996,2900,2834,66,2.3
38,75,Renville,1996,1394,1365,29,2.1
38,77,Richland,1996,9711,9436,275,2.8
38,79,Rolette,1996,5702,4940,762,13.4
38,81,Sargent,1996,2387,2338,49,2.1
38,83,Sheridan,1996,721,697,24,3.3
38,85,Sioux,1996,1658,1547,111,6.7
38,87,Slope,1996,420,411,9,2.1
38,89,Stark,1996,12743,12355,388,3.0
38,91,Steele,1996,1116,1095,21,1.9
38,93,Stutsman,1996,11744,11406,338,2.9
38,95,Towner,1996,1594,1546,48,3.0
38,97,Traill,1996,4029,3881,148,3.7
38,99,Walsh,1996,6605,6297,308,4.7
38,101,Ward,1996,29693,28799,894,3.0
38,103,Wells,1996,2540,2430,110,4.3
38,105,Williams,1996,10484,10181,303,2.9
39,1,Adams,1996,11313,9782,1531,13.5
39,3,Allen,1996,51656,48028,3628,7.0
39,5,Ashland,1996,25903,24294,1609,6.2
39,7,Ashtabula,1996,46652,43066,3586,7.7
39,9,Athens,1996,26318,24687,1631,6.2
39,11,Auglaize,1996,24261,22941,1320,5.4
39,13,Belmont,1996,31592,29180,2412,7.6
39,15,Brown,1996,18831,17630,1201,6.4
39,17,Butler,1996,168024,160636,7388,4.4
39,19,Carroll,1996,13204,12450,754,5.7
39,21,Champaign,1996,18557,17407,1150,6.2
39,23,Clark,1996,71314,67000,4314,6.0
39,25,Clermont,1996,90057,85759,4298,4.8
39,27,Clinton,1996,23438,22439,999,4.3
39,29,Columbiana,1996,52147,48711,3436,6.6
39,31,Coshocton,1996,17290,16124,1166,6.7
39,33,Crawford,1996,22439,20909,1530,6.8
39,35,Cuyahoga,1996,679876,653698,26178,3.9
39,37,Darke,1996,29473,27872,1601,5.4
39,39,Defiance,1996,21660,20668,992,4.6
39,41,Delaware,1996,46300,44538,1762,3.8
39,43,Erie,1996,42925,40492,2433,5.7
39,45,Fairfield,1996,61605,59245,2360,3.8
39,47,Fayette,1996,14163,13336,827,5.8
39,49,Franklin,1996,570044,552176,17868,3.1
39,51,Fulton,1996,22630,21365,1265,5.6
39,53,Gallia,1996,14033,12702,1331,9.5
39,55,Geauga,1996,45607,44410,1197,2.6
39,57,Greene,1996,69238,66341,2897,4.2
39,59,Guernsey,1996,18681,16999,1682,9.0
39,61,Hamilton,1996,437063,417742,19321,4.4
39,63,Hancock,1996,40359,38849,1510,3.7
39,65,Hardin,1996,15235,14336,899,5.9
39,67,Harrison,1996,7024,6421,603,8.6
39,69,Henry,1996,16116,15306,810,5.0
39,71,Highland,1996,18463,17147,1316,7.1
39,73,Hocking,1996,12649,11702,947,7.5
39,75,Holmes,1996,18104,17384,720,4.0
39,77,Huron,1996,30387,27315,3072,10.1
39,79,Jackson,1996,14169,12981,1188,8.4
39,81,Jefferson,1996,31806,28488,3318,10.4
39,83,Knox,1996,27891,26312,1579,5.7
39,85,Lake,1996,122903,118829,4074,3.3
39,87,Lawrence,1996,26360,24488,1872,7.1
39,89,Licking,1996,70519,67669,2850,4.0
39,91,Logan,1996,26447,25223,1224,4.6
39,93,Lorain,1996,139871,133212,6659,4.8
39,95,Lucas,1996,227742,215319,12423,5.5
39,97,Madison,1996,20032,19363,669,3.3
39,99,Mahoning,1996,119755,111252,8503,7.1
39,101,Marion,1996,33126,30855,2271,6.9
39,103,Medina,1996,74477,72054,2423,3.3
39,105,Meigs,1996,8681,7658,1023,11.8
39,107,Mercer,1996,20470,18774,1696,8.3
39,109,Miami,1996,50625,48354,2271,4.5
39,111,Monroe,1996,6162,5439,723,11.7
39,113,Montgomery,1996,283912,270523,13389,4.7
39,115,Morgan,1996,5000,4214,786,15.7
39,117,Morrow,1996,13581,12557,1024,7.5
39,119,Muskingum,1996,42290,38674,3616,8.6
39,121,Noble,1996,5216,4791,425,8.1
39,123,Ottawa,1996,20905,19360,1545,7.4
39,125,Paulding,1996,10060,9602,458,4.6
39,127,Perry,1996,15147,13711,1436,9.5
39,129,Pickaway,1996,23843,22838,1005,4.2
39,131,Pike,1996,11422,10304,1118,9.8
39,133,Portage,1996,82906,78987,3919,4.7
39,135,Preble,1996,21462,20389,1073,5.0
39,137,Putnam,1996,19972,18945,1027,5.1
39,139,Richland,1996,62028,58054,3974,6.4
39,141,Ross,1996,34459,32203,2256,6.5
39,143,Sandusky,1996,31924,29803,2121,6.6
39,145,Scioto,1996,33072,29555,3517,10.6
39,147,Seneca,1996,29184,27331,1853,6.3
39,149,Shelby,1996,27883,26596,1287,4.6
39,151,Stark,1996,189061,178190,10871,5.7
39,153,Summit,1996,279587,265618,13969,5.0
39,155,Trumbull,1996,112358,104950,7408,6.6
39,157,Tuscarawas,1996,44749,42119,2630,5.9
39,159,Union,1996,16733,15974,759,4.5
39,161,Van Wert,1996,16576,15721,855,5.2
39,163,Vinton,1996,3830,3370,460,12.0
39,165,Warren,1996,70647,67807,2840,4.0
39,167,Washington,1996,32754,30470,2284,7.0
39,169,Wayne,1996,57197,54538,2659,4.6
39,171,Williams,1996,21376,20238,1138,5.3
39,173,Wood,1996,64742,62186,2556,3.9
39,175,Wyandot,1996,12288,11647,641,5.2
40,1,Adair,1996,10004,9430,574,5.7
40,3,Alfalfa,1996,2505,2458,47,1.9
40,5,Atoka,1996,4897,4688,209,4.3
40,7,Beaver,1996,2856,2791,65,2.3
40,9,Beckham,1996,9336,8978,358,3.8
40,11,Blaine,1996,4921,4731,190,3.9
40,13,Bryan,1996,14577,14049,528,3.6
40,15,Caddo,1996,11991,11443,548,4.6
40,17,Canadian,1996,43631,42722,909,2.1
40,19,Carter,1996,20699,19611,1088,5.3
40,21,Cherokee,1996,16808,15958,850,5.1
40,23,Choctaw,1996,5624,4996,628,11.2
40,25,Cimarron,1996,1706,1670,36,2.1
40,27,Cleveland,1996,104971,102278,2693,2.6
40,29,Coal,1996,2659,2441,218,8.2
40,31,Comanche,1996,41322,39430,1892,4.6
40,33,Cotton,1996,2360,2240,120,5.1
40,35,Craig,1996,6572,6388,184,2.8
40,37,Creek,1996,31329,30017,1312,4.2
40,39,Custer,1996,12858,12380,478,3.7
40,41,Delaware,1996,15962,15289,673,4.2
40,43,Dewey,1996,2162,2078,84,3.9
40,45,Ellis,1996,1734,1676,58,3.3
40,47,Garfield,1996,27320,26407,913,3.3
40,49,Garvin,1996,11509,10940,569,4.9
40,51,Grady,1996,20663,19724,939,4.5
40,53,Grant,1996,2472,2405,67,2.7
40,55,Greer,1996,2535,2472,63,2.5
40,57,Harmon,1996,1333,1275,58,4.4
40,59,Harper,1996,1790,1738,52,2.9
40,61,Haskell,1996,4243,3776,467,11.0
40,63,Hughes,1996,5147,4730,417,8.1
40,65,Jackson,1996,11518,11051,467,4.1
40,67,Jefferson,1996,3371,3246,125,3.7
40,69,Johnston,1996,4835,4555,280,5.8
40,71,Kay,1996,22857,21436,1421,6.2
40,73,Kingfisher,1996,6717,6523,194,2.9
40,75,Kiowa,1996,4639,4448,191,4.1
40,77,Latimer,1996,4604,4205,399,8.7
40,79,Le Flore,1996,19542,18235,1307,6.7
40,81,Lincoln,1996,14676,14004,672,4.6
40,83,Logan,1996,14163,13750,413,2.9
40,85,Love,1996,3926,3748,178,4.5
40,87,McClain,1996,12482,12060,422,3.4
40,89,McCurtain,1996,14920,13559,1361,9.1
40,91,McIntosh,1996,7324,6777,547,7.5
40,93,Major,1996,3999,3874,125,3.1
40,95,Marshall,1996,5040,4809,231,4.6
40,97,Mayes,1996,15767,15089,678,4.3
40,99,Murray,1996,5670,5298,372,6.6
40,101,Muskogee,1996,29883,28192,1691,5.7
40,103,Noble,1996,5607,5422,185,3.3
40,105,Nowata,1996,3717,3437,280,7.5
40,107,Okfuskee,1996,4410,4163,247,5.6
40,109,Oklahoma,1996,321217,309680,11537,3.6
40,111,Okmulgee,1996,14699,13437,1262,8.6
40,113,Osage,1996,19356,18677,679,3.5
40,115,Ottawa,1996,13264,12393,871,6.6
40,117,Pawnee,1996,6668,6255,413,6.2
40,119,Payne,1996,35473,34819,654,1.8
40,121,Pittsburg,1996,17529,16325,1204,6.9
40,123,Pontotoc,1996,16349,15489,860,5.3
40,125,Pottawatomie,1996,27972,26661,1311,4.7
40,127,Pushmataha,1996,5261,4944,317,6.0
40,129,Roger Mills,1996,1961,1907,54,2.8
40,131,Rogers,1996,32218,31138,1080,3.4
40,133,Seminole,1996,10474,9652,822,7.8
40,135,Sequoyah,1996,16625,15548,1077,6.5
40,137,Stephens,1996,17567,16815,752,4.3
40,139,Texas,1996,11709,11437,272,2.3
40,141,Tillman,1996,3950,3774,176,4.5
40,143,Tulsa,1996,281353,272422,8931,3.2
40,145,Wagoner,1996,26768,25956,812,3.0
40,147,Washington,1996,18957,18073,884,4.7
40,149,Washita,1996,5158,4996,162,3.1
40,151,Woods,1996,4263,4156,107,2.5
40,153,Woodward,1996,9207,8814,393,4.3
41,1,Baker,1996,7587,6768,819,10.8
41,3,Benton,1996,42611,41529,1082,2.5
41,5,Clackamas,1996,186809,179882,6927,3.7
41,7,Clatsop,1996,17455,16413,1042,6.0
41,9,Columbia,1996,21773,20514,1259,5.8
41,11,Coos,1996,28128,25681,2447,8.7
41,13,Crook,1996,7785,6934,851,10.9
41,15,Curry,1996,8513,7745,768,9.0
41,17,Deschutes,1996,53291,49025,4266,8.0
41,19,Douglas,1996,44249,40511,3738,8.4
41,21,Gilliam,1996,1218,1173,45,3.7
41,23,Grant,1996,4294,3809,485,11.3
41,25,Harney,1996,3725,3267,458,12.3
41,27,Hood River,1996,10535,9478,1057,10.0
41,29,Jackson,1996,85856,79184,6672,7.8
41,31,Jefferson,1996,8353,7741,612,7.3
41,33,Josephine,1996,28723,26030,2693,9.4
41,35,Klamath,1996,29630,27193,2437,8.2
41,37,Lake,1996,3860,3433,427,11.1
41,39,Lane,1996,159367,150696,8671,5.4
41,41,Lincoln,1996,21621,20099,1522,7.0
41,43,Linn,1996,51977,48553,3424,6.6
41,45,Malheur,1996,14567,13379,1188,8.2
41,47,Marion,1996,134901,127403,7498,5.6
41,49,Morrow,1996,4080,3722,358,8.8
41,51,Multnomah,1996,359388,341749,17639,4.9
41,53,Polk,1996,28986,27685,1301,4.5
41,55,Sherman,1996,1038,963,75,7.2
41,57,Tillamook,1996,11384,10743,641,5.6
41,59,Umatilla,1996,33119,30502,2617,7.9
41,61,Union,1996,12568,11647,921,7.3
41,63,Wallowa,1996,3572,3178,394,11.0
41,65,Wasco,1996,11558,10607,951,8.2
41,67,Washington,1996,230149,221853,8296,3.6
41,69,Wheeler,1996,614,564,50,8.1
41,71,Yamhill,1996,39772,37964,1808,4.5
42,1,Adams,1996,44200,42103,2097,4.7
42,3,Allegheny,1996,656483,625762,30721,4.7
42,5,Armstrong,1996,32234,29696,2538,7.9
42,7,Beaver,1996,85879,81466,4413,5.1
42,9,Bedford,1996,24894,22953,1941,7.8
42,11,Berks,1996,182666,174501,8165,4.5
42,13,Blair,1996,62992,59263,3729,5.9
42,15,Bradford,1996,28935,27293,1642,5.7
42,17,Bucks,1996,317247,302739,14508,4.6
42,19,Butler,1996,85425,81053,4372,5.1
42,21,Cambria,1996,69642,63791,5851,8.4
42,23,Cameron,1996,2644,2442,202,7.6
42,25,Carbon,1996,26756,24676,2080,7.8
42,27,Centre,1996,66058,64048,2010,3.0
42,29,Chester,1996,223251,215644,7607,3.4
42,31,Clarion,1996,18588,17211,1377,7.4
42,33,Clearfield,1996,38770,35487,3283,8.5
42,35,Clinton,1996,17329,15881,1448,8.4
42,37,Columbia,1996,33568,31048,2520,7.5
42,39,Crawford,1996,41775,39270,2505,6.0
42,41,Cumberland,1996,120492,116920,3572,3.0
42,43,Dauphin,1996,139801,134735,5066,3.6
42,45,Delaware,1996,278557,264649,13908,5.0
42,47,Elk,1996,18575,17394,1181,6.4
42,49,Erie,1996,141422,132906,8516,6.0
42,51,Fayette,1996,57505,52752,4753,8.3
42,53,Forest,1996,1869,1680,189,10.1
42,55,Franklin,1996,65645,62317,3328,5.1
42,57,Fulton,1996,6719,6343,376,5.6
42,59,Greene,1996,16125,14660,1465,9.1
42,61,Huntingdon,1996,19093,17064,2029,10.6
42,63,Indiana,1996,37845,34584,3261,8.6
42,65,Jefferson,1996,22441,20643,1798,8.0
42,67,Juniata,1996,10245,9302,943,9.2
42,69,Lackawanna,1996,107442,99706,7736,7.2
42,71,Lancaster,1996,239207,231074,8133,3.4
42,73,Lawrence,1996,40327,37677,2650,6.6
42,75,Lebanon,1996,65798,63202,2596,3.9
42,77,Lehigh,1996,153414,145185,8229,5.4
42,79,Luzerne,1996,159197,147403,11794,7.4
42,81,Lycoming,1996,58723,54770,3953,6.7
42,83,McKean,1996,22063,20705,1358,6.2
42,85,Mercer,1996,56326,53746,2580,4.6
42,87,Mifflin,1996,22796,20822,1974,8.7
42,89,Monroe,1996,50297,46180,4117,8.2
42,91,Montgomery,1996,389364,373871,15493,4.0
42,93,Montour,1996,8658,8262,396,4.6
42,95,Northampton,1996,128100,120942,7158,5.6
42,97,Northumberland,1996,43827,40727,3100,7.1
42,99,Perry,1996,24117,23107,1010,4.2
42,101,Philadelphia/city,1996,651028,603372,47656,7.3
42,103,Pike,1996,17387,16495,892,5.1
42,105,Potter,1996,8527,7910,617,7.2
42,107,Schuylkill,1996,69059,63158,5901,8.5
42,109,Snyder,1996,18824,17597,1227,6.5
42,111,Somerset,1996,38322,35332,2990,7.8
42,113,Sullivan,1996,2745,2559,186,6.8
42,115,Susquehanna,1996,19160,17749,1411,7.4
42,117,Tioga,1996,19675,18195,1480,7.5
42,119,Union,1996,18772,17843,929,4.9
42,121,Venango,1996,26441,24503,1938,7.3
42,123,Warren,1996,21795,20642,1153,5.3
42,125,Washington,1996,95651,90250,5401,5.6
42,127,Wayne,1996,18928,17271,1657,8.8
42,129,Westmoreland,1996,182726,172015,10711,5.9
42,131,Wyoming,1996,15370,14135,1235,8.0
42,133,York,1996,195618,186788,8830,4.5
44,1,Bristol,1996,26244,25135,1109,4.2
44,3,Kent,1996,89602,84944,4658,5.2
44,5,Newport,1996,40775,38700,2075,5.1
44,7,Providence,1996,297802,280944,16858,5.7
44,9,Washington,1996,64165,61757,2408,3.8
45,1,Abbeville,1996,12463,11661,802,6.4
45,3,Aiken,1996,63377,59151,4226,6.7
45,5,Allendale,1996,4606,4214,392,8.5
45,7,Anderson,1996,82467,78602,3865,4.7
45,9,Bamberg,1996,7735,7009,726,9.4
45,11,Barnwell,1996,11177,10029,1148,10.3
45,13,Beaufort,1996,45863,44439,1424,3.1
45,15,Berkeley,1996,59779,57120,2659,4.4
45,17,Calhoun,1996,6686,6083,603,9.0
45,19,Charleston,1996,143207,135134,8073,5.6
45,21,Cherokee,1996,24894,23583,1311,5.3
45,23,Chester,1996,15841,14249,1592,10.0
45,25,Chesterfield,1996,21292,19666,1626,7.6
45,27,Clarendon,1996,11960,10909,1051,8.8
45,29,Colleton,1996,15646,14619,1027,6.6
45,31,Darlington,1996,32109,29266,2843,8.9
45,33,Dillon,1996,14308,12690,1618,11.3
45,35,Dorchester,1996,43074,41015,2059,4.8
45,37,Edgefield,1996,9326,8674,652,7.0
45,39,Fairfield,1996,10586,9643,943,8.9
45,41,Florence,1996,63074,58125,4949,7.8
45,43,Georgetown,1996,25210,22237,2973,11.8
45,45,Greenville,1996,186526,180798,5728,3.1
45,47,Greenwood,1996,33743,31506,2237,6.6
45,49,Hampton,1996,8505,7911,594,7.0
45,51,Horry,1996,94870,89937,4933,5.2
45,53,Jasper,1996,7596,7221,375,4.9
45,55,Kershaw,1996,23546,22096,1450,6.2
45,57,Lancaster,1996,28521,26795,1726,6.1
45,59,Laurens,1996,31485,29619,1866,5.9
45,61,Lee,1996,8149,7396,753,9.2
45,63,Lexington,1996,110675,107170,3505,3.2
45,65,McCormick,1996,4073,3684,389,9.6
45,67,Marion,1996,16546,14413,2133,12.9
45,69,Marlboro,1996,12014,10211,1803,15.0
45,71,Newberry,1996,18575,17470,1105,5.9
45,73,Oconee,1996,28617,26867,1750,6.1
45,75,Orangeburg,1996,41164,37144,4020,9.8
45,77,Pickens,1996,54754,52037,2717,5.0
45,79,Richland,1996,154372,148662,5710,3.7
45,81,Saluda,1996,8548,8025,523,6.1
45,83,Spartanburg,1996,129543,123670,5873,4.5
45,85,Sumter,1996,45651,42865,2786,6.1
45,87,Union,1996,15280,13997,1283,8.4
45,89,Williamsburg,1996,16084,13193,2891,18.0
45,91,York,1996,82545,78413,4132,5.0
46,3,Aurora,1996,1311,1269,42,3.2
46,5,Beadle,1996,9627,9344,283,2.9
46,7,Bennett,1996,1064,1010,54,5.1
46,9,Bon Homme,1996,3131,3051,80,2.6
46,11,Brookings,1996,15626,15371,255,1.6
46,13,Brown,1996,20971,20520,451,2.2
46,15,Brule,1996,2964,2846,118,4.0
46,17,Buffalo,1996,734,657,77,10.5
46,19,Butte,1996,3761,3583,178,4.7
46,21,Campbell,1996,936,906,30,3.2
46,23,Charles Mix,1996,4697,4532,165,3.5
46,25,Clark,1996,1962,1883,79,4.0
46,27,Clay,1996,6858,6764,94,1.4
46,29,Codington,1996,14413,13947,466,3.2
46,31,Corson,1996,1476,1334,142,9.6
46,33,Custer,1996,3367,3154,213,6.3
46,35,Davison,1996,10082,9738,344,3.4
46,37,Day,1996,3065,2926,139,4.5
46,39,Deuel,1996,2333,2248,85,3.6
46,41,Dewey,1996,2275,1965,310,13.6
46,43,Douglas,1996,1611,1569,42,2.6
46,45,Edmunds,1996,2278,2238,40,1.8
46,47,Fall River,1996,3608,3464,144,4.0
46,49,Faulk,1996,1231,1195,36,2.9
46,51,Grant,1996,4275,4096,179,4.2
46,53,Gregory,1996,2623,2529,94,3.6
46,55,Haakon,1996,1178,1134,44,3.7
46,57,Hamlin,1996,2543,2453,90,3.5
46,59,Hand,1996,2125,2069,56,2.6
46,61,Hanson,1996,1582,1534,48,3.0
46,63,Harding,1996,834,800,34,4.1
46,65,Hughes,1996,9563,9289,274,2.9
46,67,Hutchinson,1996,3913,3785,128,3.3
46,69,Hyde,1996,874,844,30,3.4
46,71,Jackson,1996,1106,1044,62,5.6
46,73,Jerauld,1996,1136,1094,42,3.7
46,75,Jones,1996,792,765,27,3.4
46,77,Kingsbury,1996,2670,2565,105,3.9
46,79,Lake,1996,6056,5861,195,3.2
46,81,Lawrence,1996,12043,11561,482,4.0
46,83,Lincoln,1996,10391,10195,196,1.9
46,85,Lyman,1996,2426,2319,107,4.4
46,87,McCook,1996,2518,2453,65,2.6
46,89,McPherson,1996,1366,1306,60,4.4
46,91,Marshall,1996,2293,2210,83,3.6
46,93,Meade,1996,12228,11772,456,3.7
46,95,Mellette,1996,780,721,59,7.6
46,97,Miner,1996,1381,1258,123,8.9
46,99,Minnehaha,1996,83611,81766,1845,2.2
46,101,Moody,1996,3602,3421,181,5.0
46,102,Oglala Lakota,1996,3241,2741,500,15.4
46,103,Pennington,1996,45440,43894,1546,3.4
46,105,Perkins,1996,2022,1956,66,3.3
46,107,Potter,1996,1522,1466,56,3.7
46,109,Roberts,1996,4906,4648,258,5.3
46,111,Sanborn,1996,1462,1394,68,4.7
46,115,Spink,1996,3534,3436,98,2.8
46,117,Stanley,1996,1821,1757,64,3.5
46,119,Sully,1996,929,890,39,4.2
46,121,Todd,1996,2748,2499,249,9.1
46,123,Tripp,1996,3610,3494,116,3.2
46,125,Turner,1996,4118,3990,128,3.1
46,127,Union,1996,7154,6866,288,4.0
46,129,Walworth,1996,3091,2969,122,3.9
46,135,Yankton,1996,10854,10595,259,2.4
46,137,Ziebach,1996,706,659,47,6.7
47,1,Anderson,1996,36345,34579,1766,4.9
47,3,Bedford,1996,17776,16716,1060,6.0
47,5,Benton,1996,8128,7237,891,11.0
47,7,Bledsoe,1996,4042,3823,219,5.4
47,9,Blount,1996,50198,47962,2236,4.5
47,11,Bradley,1996,42545,40391,2154,5.1
47,13,Campbell,1996,17370,15886,1484,8.5
47,15,Cannon,1996,5015,4699,316,6.3
47,17,Carroll,1996,14236,12831,1405,9.9
47,19,Carter,1996,26353,24891,1462,5.5
47,21,Cheatham,1996,17867,17427,440,2.5
47,23,Chester,1996,7763,7325,438,5.6
47,25,Claiborne,1996,13057,12392,665,5.1
47,27,Clay,1996,3785,3262,523,13.8
47,29,Cocke,1996,16999,15216,1783,10.5
47,31,Coffee,1996,22532,21195,1337,5.9
47,33,Crockett,1996,7475,6957,518,6.9
47,35,Cumberland,1996,19593,18320,1273,6.5
47,37,Davidson,1996,302551,292881,9670,3.2
47,39,Decatur,1996,5933,5302,631,10.6
47,41,DeKalb,1996,8669,8026,643,7.4
47,43,Dickson,1996,20237,19333,904,4.5
47,45,Dyer,1996,19423,18047,1376,7.1
47,47,Fayette,1996,12944,12326,618,4.8
47,49,Fentress,1996,7374,6709,665,9.0
47,51,Franklin,1996,18585,17206,1379,7.4
47,53,Gibson,1996,23206,21007,2199,9.5
47,55,Giles,1996,16166,15092,1074,6.6
47,57,Grainger,1996,9978,9385,593,5.9
47,59,Greene,1996,34572,31411,3161,9.1
47,61,Grundy,1996,5886,5386,500,8.5
47,63,Hamblen,1996,30542,28866,1676,5.5
47,65,Hamilton,1996,151115,144635,6480,4.3
47,67,Hancock,1996,2686,2533,153,5.7
47,69,Hardeman,1996,9240,8429,811,8.8
47,71,Hardin,1996,12556,11422,1134,9.0
47,73,Hawkins,1996,23641,22518,1123,4.8
47,75,Haywood,1996,8907,7859,1048,11.8
47,77,Henderson,1996,13893,12501,1392,10.0
47,79,Henry,1996,15098,14137,961,6.4
47,81,Hickman,1996,8843,8233,610,6.9
47,83,Houston,1996,3119,2682,437,14.0
47,85,Humphreys,1996,8485,7506,979,11.5
47,87,Jackson,1996,4507,4292,215,4.8
47,89,Jefferson,1996,22353,21074,1279,5.7
47,91,Johnson,1996,7970,6965,1005,12.6
47,93,Knox,1996,196981,190218,6763,3.4
47,95,Lake,1996,2847,2589,258,9.1
47,97,Lauderdale,1996,10011,9183,828,8.3
47,99,Lawrence,1996,22189,19494,2695,12.1
47,101,Lewis,1996,5140,4342,798,15.5
47,103,Lincoln,1996,15285,13607,1678,11.0
47,105,Loudon,1996,19631,18866,765,3.9
47,107,McMinn,1996,22653,20633,2020,8.9
47,109,McNairy,1996,11933,10945,988,8.3
47,111,Macon,1996,9307,8389,918,9.9
47,113,Madison,1996,47334,45188,2146,4.5
47,115,Marion,1996,12558,11771,787,6.3
47,117,Marshall,1996,12643,12082,561,4.4
47,119,Maury,1996,36848,35026,1822,4.9
47,121,Meigs,1996,4553,4066,487,10.7
47,123,Monroe,1996,18050,15972,2078,11.5
47,125,Montgomery,1996,52899,50757,2142,4.0
47,127,Moore,1996,3038,2882,156,5.1
47,129,Morgan,1996,7088,6629,459,6.5
47,131,Obion,1996,15483,14120,1363,8.8
47,133,Overton,1996,9662,9028,634,6.6
47,135,Perry,1996,3614,3419,195,5.4
47,137,Pickett,1996,2308,2083,225,9.7
47,139,Polk,1996,6851,6360,491,7.2
47,141,Putnam,1996,31181,29695,1486,4.8
47,143,Rhea,1996,12542,11224,1318,10.5
47,145,Roane,1996,28009,26507,1502,5.4
47,147,Robertson,1996,26615,25290,1325,5.0
47,149,Rutherford,1996,87078,84053,3025,3.5
47,151,Scott,1996,8704,7834,870,10.0
47,153,Sequatchie,1996,4883,4585,298,6.1
47,155,Sevier,1996,34177,31341,2836,8.3
47,157,Shelby,1996,434168,415097,19071,4.4
47,159,Smith,1996,9253,8782,471,5.1
47,161,Stewart,1996,3815,3244,571,15.0
47,163,Sullivan,1996,76420,73399,3021,4.0
47,165,Sumner,1996,65513,63126,2387,3.6
47,167,Tipton,1996,20867,19833,1034,5.0
47,169,Trousdale,1996,2096,1872,224,10.7
47,171,Unicoi,1996,8180,7653,527,6.4
47,173,Union,1996,7461,7142,319,4.3
47,175,Van Buren,1996,2435,2250,185,7.6
47,177,Warren,1996,19238,18038,1200,6.2
47,179,Washington,1996,52296,50288,2008,3.8
47,181,Wayne,1996,7792,6934,858,11.0
47,183,Weakley,1996,18154,17220,934,5.1
47,185,White,1996,11414,10601,813,7.1
47,187,Williamson,1996,58602,57394,1208,2.1
47,189,Wilson,1996,43907,42291,1616,3.7
48,1,Anderson,1996,20169,18977,1192,5.9
48,3,Andrews,1996,5521,5255,266,4.8
48,5,Angelina,1996,34943,33058,1885,5.4
48,7,Aransas,1996,8981,8543,438,4.9
48,9,Archer,1996,4119,3995,124,3.0
48,11,Armstrong,1996,1004,975,29,2.9
48,13,Atascosa,1996,15474,14752,722,4.7
48,15,Austin,1996,11475,11058,417,3.6
48,17,Bailey,1996,3745,3539,206,5.5
48,19,Bandera,1996,6523,6290,233,3.6
48,21,Bastrop,1996,24824,23971,853,3.4
48,23,Baylor,1996,1825,1726,99,5.4
48,25,Bee,1996,11085,10313,772,7.0
48,27,Bell,1996,90950,86390,4560,5.0
48,29,Bexar,1996,643571,614047,29524,4.6
48,31,Blanco,1996,3556,3456,100,2.8
48,33,Borden,1996,391,384,7,1.8
48,35,Bosque,1996,6445,6166,279,4.3
48,37,Bowie,1996,40004,36826,3178,7.9
48,39,Brazoria,1996,104774,97549,7225,6.9
48,41,Brazos,1996,69276,67526,1750,2.5
48,43,Brewster,1996,4856,4718,138,2.8
48,45,Briscoe,1996,969,938,31,3.2
48,47,Brooks,1996,3094,2674,420,13.6
48,49,Brown,1996,16999,15885,1114,6.6
48,51,Burleson,1996,7449,7143,306,4.1
48,53,Burnet,1996,12929,12404,525,4.1
48,55,Caldwell,1996,14910,14327,583,3.9
48,57,Calhoun,1996,9777,9051,726,7.4
48,59,Callahan,1996,6471,6205,266,4.1
48,61,Cameron,1996,124421,108480,15941,12.8
48,63,Camp,1996,5314,4889,425,8.0
48,65,Carson,1996,3585,3427,158,4.4
48,67,Cass,1996,15626,14252,1374,8.8
48,69,Castro,1996,4174,3972,202,4.8
48,71,Chambers,1996,11127,10536,591,5.3
48,73,Cherokee,1996,20670,19665,1005,4.9
48,75,Childress,1996,3291,3134,157,4.8
48,77,Clay,1996,5331,5148,183,3.4
48,79,Cochran,1996,1627,1534,93,5.7
48,81,Coke,1996,1599,1563,36,2.3
48,83,Coleman,1996,3996,3718,278,7.0
48,85,Collin,1996,224983,219141,5842,2.6
48,87,Collingsworth,1996,1722,1656,66,3.8
48,89,Colorado,1996,8115,7834,281,3.5
48,91,Comal,1996,34935,33788,1147,3.3
48,93,Comanche,1996,6713,6414,299,4.5
48,95,Concho,1996,1473,1440,33,2.2
48,97,Cooke,1996,15985,15341,644,4.0
48,99,Coryell,1996,21766,20745,1021,4.7
48,101,Cottle,1996,879,814,65,7.4
48,103,Crane,1996,2330,2246,84,3.6
48,105,Crockett,1996,2000,1936,64,3.2
48,107,Crosby,1996,3173,2913,260,8.2
48,109,Culberson,1996,1350,1226,124,9.2
48,111,Dallam,1996,3272,3170,102,3.1
48,113,Dallas,1996,1152643,1099902,52741,4.6
48,115,Dawson,1996,6286,5837,449,7.1
48,117,Deaf Smith,1996,8601,7940,661,7.7
48,119,Delta,1996,2728,2617,111,4.1
48,121,Denton,1996,213811,207722,6089,2.8
48,123,DeWitt,1996,8087,7715,372,4.6
48,125,Dickens,1996,1025,954,71,6.9
48,127,Dimmit,1996,3690,3116,574,15.6
48,129,Donley,1996,1618,1567,51,3.2
48,131,Duval,1996,4739,4142,597,12.6
48,133,Eastland,1996,8596,8182,414,4.8
48,135,Ector,1996,60387,56168,4219,7.0
48,137,Edwards,1996,919,870,49,5.3
48,139,Ellis,1996,49964,47723,2241,4.5
48,141,El Paso,1996,290846,256497,34349,11.8
48,143,Erath,1996,16128,15689,439,2.7
48,145,Falls,1996,7693,7422,271,3.5
48,147,Fannin,1996,12555,11830,725,5.8
48,149,Fayette,1996,10669,10324,345,3.2
48,151,Fisher,1996,1871,1772,99,5.3
48,153,Floyd,1996,3539,3289,250,7.1
48,155,Foard,1996,1110,1055,55,5.0
48,157,Fort Bend,1996,160734,155750,4984,3.1
48,159,Franklin,1996,4305,4034,271,6.3
48,161,Freestone,1996,7588,7178,410,5.4
48,163,Frio,1996,6232,5623,609,9.8
48,165,Gaines,1996,6946,6656,290,4.2
48,167,Galveston,1996,126682,116216,10466,8.3
48,169,Garza,1996,2231,2103,128,5.7
48,171,Gillespie,1996,9967,9800,167,1.7
48,173,Glasscock,1996,614,597,17,2.8
48,175,Goliad,1996,2678,2547,131,4.9
48,177,Gonzales,1996,7598,7218,380,5.0
48,179,Gray,1996,10940,10439,501,4.6
48,181,Grayson,1996,49418,46978,2440,4.9
48,183,Gregg,1996,58268,53961,4307,7.4
48,185,Grimes,1996,8575,8019,556,6.5
48,187,Guadalupe,1996,39050,37841,1209,3.1
48,189,Hale,1996,17722,16558,1164,6.6
48,191,Hall,1996,1774,1640,134,7.6
48,193,Hamilton,1996,3851,3714,137,3.6
48,195,Hansford,1996,2523,2437,86,3.4
48,197,Hardeman,1996,2061,1951,110,5.3
48,199,Hardin,1996,22521,20665,1856,8.2
48,201,Harris,1996,1682262,1587999,94263,5.6
48,203,Harrison,1996,28206,25443,2763,9.8
48,205,Hartley,1996,2845,2783,62,2.2
48,207,Haskell,1996,2824,2703,121,4.3
48,209,Hays,1996,46275,44851,1424,3.1
48,211,Hemphill,1996,1930,1872,58,3.0
48,213,Henderson,1996,28053,26545,1508,5.4
48,215,Hidalgo,1996,189642,152812,36830,19.4
48,217,Hill,1996,15053,14407,646,4.3
48,219,Hockley,1996,11159,10575,584,5.2
48,221,Hood,1996,15603,14852,751,4.8
48,223,Hopkins,1996,15994,15084,910,5.7
48,225,Houston,1996,8200,7898,302,3.7
48,227,Howard,1996,13939,13352,587,4.2
48,229,Hudspeth,1996,1464,1439,25,1.7
48,231,Hunt,1996,34661,32526,2135,6.2
48,233,Hutchinson,1996,10054,9217,837,8.3
48,235,Irion,1996,841,825,16,1.9
48,237,Jack,1996,3347,3226,121,3.6
48,239,Jackson,1996,9135,8800,335,3.7
48,241,Jasper,1996,15644,13562,2082,13.3
48,243,Jeff Davis,1996,1164,1131,33,2.8
48,245,Jefferson,1996,117003,106632,10371,8.9
48,247,Jim Hogg,1996,2059,1874,185,9.0
48,249,Jim Wells,1996,16384,14818,1566,9.6
48,251,Johnson,1996,55992,53481,2511,4.5
48,253,Jones,1996,10286,9952,334,3.2
48,255,Karnes,1996,6077,5763,314,5.2
48,257,Kaufman,1996,29735,28504,1231,4.1
48,259,Kendall,1996,11775,11510,265,2.3
48,261,Kenedy,1996,227,218,9,4.0
48,263,Kent,1996,421,410,11,2.6
48,265,Kerr,1996,17357,16868,489,2.8
48,267,Kimble,1996,2359,2313,46,1.9
48,269,King,1996,115,107,8,7.0
48,271,Kinney,1996,1109,1025,84,7.6
48,273,Kleberg,1996,13192,12249,943,7.1
48,275,Knox,1996,2229,2107,122,5.5
48,277,Lamar,1996,22058,20651,1407,6.4
48,279,Lamb,1996,6850,6428,422,6.2
48,281,Lampasas,1996,7526,7145,381,5.1
48,283,La Salle,1996,2775,2551,224,8.1
48,285,Lavaca,1996,9430,9151,279,3.0
48,287,Lee,1996,7126,6812,314,4.4
48,289,Leon,1996,5597,5211,386,6.9
48,291,Liberty,1996,27430,25166,2264,8.3
48,293,Limestone,1996,9553,9011,542,5.7
48,295,Lipscomb,1996,1609,1570,39,2.4
48,297,Live Oak,1996,4476,4300,176,3.9
48,299,Llano,1996,4842,4664,178,3.7
48,301,Loving,1996,92,85,7,7.6
48,303,Lubbock,1996,121740,116834,4906,4.0
48,305,Lynn,1996,3069,2946,123,4.0
48,307,McCulloch,1996,3943,3760,183,4.6
48,309,McLennan,1996,99462,94928,4534,4.6
48,311,McMullen,1996,273,267,6,2.2
48,313,Madison,1996,4104,3943,161,3.9
48,315,Marion,1996,3954,3479,475,12.0
48,317,Martin,1996,1797,1731,66,3.7
48,319,Mason,1996,1608,1567,41,2.5
48,321,Matagorda,1996,16312,14074,2238,13.7
48,323,Maverick,1996,18231,12713,5518,30.3
48,325,Medina,1996,15290,14790,500,3.3
48,327,Menard,1996,1090,1061,29,2.7
48,329,Midland,1996,59882,57122,2760,4.6
48,331,Milam,1996,9507,8983,524,5.5
48,333,Mills,1996,2308,2221,87,3.8
48,335,Mitchell,1996,3250,3023,227,7.0
48,337,Montague,1996,7720,7344,376,4.9
48,339,Montgomery,1996,121922,116907,5015,4.1
48,341,Moore,1996,9106,8766,340,3.7
48,343,Morris,1996,6140,5633,507,8.3
48,345,Motley,1996,675,648,27,4.0
48,347,Nacogdoches,1996,27913,26406,1507,5.4
48,349,Navarro,1996,21169,19947,1222,5.8
48,351,Newton,1996,6063,5343,720,11.9
48,353,Nolan,1996,7705,7123,582,7.6
48,355,Nueces,1996,149088,136289,12799,8.6
48,357,Ochiltree,1996,4654,4492,162,3.5
48,359,Oldham,1996,1167,1121,46,3.9
48,361,Orange,1996,41185,36608,4577,11.1
48,363,Palo Pinto,1996,12542,11569,973,7.8
48,365,Panola,1996,8190,7310,880,10.7
48,367,Parker,1996,37818,36417,1401,3.7
48,369,Parmer,1996,4450,4265,185,4.2
48,371,Pecos,1996,6906,6468,438,6.3
48,373,Polk,1996,15005,14146,859,5.7
48,375,Potter,1996,54392,51688,2704,5.0
48,377,Presidio,1996,3408,2196,1212,35.6
48,379,Rains,1996,3556,3390,166,4.7
48,381,Randall,1996,57131,55394,1737,3.0
48,383,Reagan,1996,1980,1909,71,3.6
48,385,Real,1996,1288,1219,69,5.4
48,387,Red River,1996,6206,5754,452,7.3
48,389,Reeves,1996,7130,6345,785,11.0
48,391,Refugio,1996,3006,2858,148,4.9
48,393,Roberts,1996,515,502,13,2.5
48,395,Robertson,1996,6617,6218,399,6.0
48,397,Rockwall,1996,19402,18846,556,2.9
48,399,Runnels,1996,5367,5207,160,3.0
48,401,Rusk,1996,20777,19409,1368,6.6
48,403,Sabine,1996,4021,3641,380,9.5
48,405,San Augustine,1996,3481,3241,240,6.9
48,407,San Jacinto,1996,7823,7474,349,4.5
48,409,San Patricio,1996,29236,26760,2476,8.5
48,411,San Saba,1996,2383,2244,139,5.8
48,413,Schleicher,1996,1426,1353,73,5.1
48,415,Scurry,1996,7834,7484,350,4.5
48,417,Shackelford,1996,1476,1411,65,4.4
48,419,Shelby,1996,9824,9099,725,7.4
48,421,Sherman,1996,1411,1373,38,2.7
48,423,Smith,1996,86941,81267,5674,6.5
48,425,Somervell,1996,2144,1943,201,9.4
48,427,Starr,1996,21927,15651,6276,28.6
48,429,Stephens,1996,4235,4077,158,3.7
48,431,Sterling,1996,629,604,25,4.0
48,433,Stonewall,1996,812,784,28,3.4
48,435,Sutton,1996,2270,2183,87,3.8
48,437,Swisher,1996,3849,3676,173,4.5
48,439,Tarrant,1996,726670,697647,29023,4.0
48,441,Taylor,1996,60358,57343,3015,5.0
48,443,Terrell,1996,571,547,24,4.2
48,445,Terry,1996,6058,5701,357,5.9
48,447,Throckmorton,1996,810,783,27,3.3
48,449,Titus,1996,12497,11566,931,7.4
48,451,Tom Green,1996,50640,48804,1836,3.6
48,453,Travis,1996,428288,414119,14169,3.3
48,455,Trinity,1996,4779,4524,255,5.3
48,457,Tyler,1996,7129,6201,928,13.0
48,459,Upshur,1996,16167,15136,1031,6.4
48,461,Upton,1996,1794,1731,63,3.5
48,463,Uvalde,1996,11002,9719,1283,11.7
48,465,Val Verde,1996,18149,15950,2199,12.1
48,467,Van Zandt,1996,19491,18723,768,3.9
48,469,Victoria,1996,42066,39899,2167,5.2
48,471,Walker,1996,22573,21976,597,2.6
48,473,Waller,1996,11901,11333,568,4.8
48,475,Ward,1996,4460,4169,291,6.5
48,477,Washington,1996,14979,14559,420,2.8
48,479,Webb,1996,69322,60329,8993,13.0
48,481,Wharton,1996,19287,18055,1232,6.4
48,483,Wheeler,1996,2882,2757,125,4.3
48,485,Wichita,1996,61515,58600,2915,4.7
48,487,Wilbarger,1996,7133,6805,328,4.6
48,489,Willacy,1996,7711,6057,1654,21.4
48,491,Williamson,1996,119627,117241,2386,2.0
48,493,Wilson,1996,13807,13415,392,2.8
48,495,Winkler,1996,3028,2793,235,7.8
48,497,Wise,1996,20591,19868,723,3.5
48,499,Wood,1996,14375,13505,870,6.1
48,501,Yoakum,1996,3711,3512,199,5.4
48,503,Young,1996,8506,7906,600,7.1
48,505,Zapata,1996,4432,4025,407,9.2
48,507,Zavala,1996,4495,3422,1073,23.9
49,1,Beaver,1996,2508,2377,131,5.2
49,3,Box Elder,1996,18017,17254,763,4.2
49,5,Cache,1996,42094,40866,1228,2.9
49,7,Carbon,1996,9452,8885,567,6.0
49,9,Daggett,1996,413,396,17,4.1
49,11,Davis,1996,111596,108115,3481,3.1
49,13,Duchesne,1996,5819,5333,486,8.4
49,15,Emery,1996,4205,3891,314,7.5
49,17,Garfield,1996,2680,2411,269,10.0
49,19,Grand,1996,5080,4723,357,7.0
49,21,Iron,1996,13430,12931,499,3.7
49,23,Juab,1996,3413,3277,136,4.0
49,25,Kane,1996,2588,2397,191,7.4
49,27,Millard,1996,4757,4559,198,4.2
49,29,Morgan,1996,3503,3357,146,4.2
49,31,Piute,1996,524,500,24,4.6
49,33,Rich,1996,972,938,34,3.5
49,35,Salt Lake,1996,462495,449114,13381,2.9
49,37,San Juan,1996,5116,4631,485,9.5
49,39,Sanpete,1996,8282,7779,503,6.1
49,41,Sevier,1996,7876,7514,362,4.6
49,43,Summit,1996,12786,12343,443,3.5
49,45,Tooele,1996,11766,11164,602,5.1
49,47,Uintah,1996,10236,9498,738,7.2
49,49,Utah,1996,154282,149895,4387,2.8
49,51,Wasatch,1996,5661,5419,242,4.3
49,53,Washington,1996,34801,33585,1216,3.5
49,55,Wayne,1996,1344,1271,73,5.4
49,57,Weber,1996,96256,92320,3936,4.1
50,1,Addison,1996,18963,18111,852,4.5
50,3,Bennington,1996,19889,18992,897,4.5
50,5,Caledonia,1996,15157,14220,937,6.2
50,7,Chittenden,1996,85788,83385,2403,2.8
50,9,Essex,1996,2843,2618,225,7.9
50,11,Franklin,1996,22837,21767,1070,4.7
50,13,Grand Isle,1996,3212,3002,210,6.5
50,15,Lamoille,1996,11615,10861,754,6.5
50,17,Orange,1996,15248,14749,499,3.3
50,19,Orleans,1996,12338,11265,1073,8.7
50,21,Rutland,1996,32622,30999,1623,5.0
50,23,Washington,1996,31020,29522,1498,4.8
50,25,Windham,1996,23703,22785,918,3.9
50,27,Windsor,1996,30246,29228,1018,3.4
51,1,Accomack,1996,15094,13742,1352,9.0
51,3,Albemarle,1996,38592,37787,805,2.1
51,5,Alleghany,1996,8574,8101,473,5.5
51,7,Amelia,1996,4323,4165,158,3.7
51,9,Amherst,1996,14687,14117,570,3.9
51,11,Appomattox,1996,5832,5496,336,5.8
51,13,Arlington,1996,106008,102659,3349,3.2
51,15,Augusta,1996,31035,29853,1182,3.8
51,17,Bath,1996,2358,2196,162,6.9
51,19,Bedford,1996,32284,31225,1059,3.3
51,21,Bland,1996,3581,3336,245,6.8
51,23,Botetourt,1996,16107,15707,400,2.5
51,25,Brunswick,1996,6650,6176,474,7.1
51,27,Buchanan,1996,9548,8133,1415,14.8
51,29,Buckingham,1996,6277,5966,311,5.0
51,31,Campbell,1996,26375,25372,1003,3.8
51,33,Caroline,1996,10081,9267,814,8.1
51,35,Carroll,1996,14087,13263,824,5.8
51,36,Charles City,1996,3610,3438,172,4.8
51,37,Charlotte,1996,5847,5346,501,8.6
51,41,Chesterfield,1996,134723,130684,4039,3.0
51,43,Clarke,1996,6358,6172,186,2.9
51,45,Craig,1996,2390,2286,104,4.4
51,47,Culpeper,1996,15734,15016,718,4.6
51,49,Cumberland,1996,3948,3837,111,2.8
51,51,Dickenson,1996,5974,4769,1205,20.2
51,53,Dinwiddie,1996,11620,11166,454,3.9
51,57,Essex,1996,4527,4132,395,8.7
51,59,Fairfax,1996,511244,497628,13616,2.7
51,61,Fauquier,1996,26835,26073,762,2.8
51,63,Floyd,1996,6512,6179,333,5.1
51,65,Fluvanna,1996,8375,8156,219,2.6
51,67,Franklin,1996,22632,21524,1108,4.9
51,69,Frederick,1996,31333,30075,1258,4.0
51,71,Giles,1996,8331,7757,574,6.9
51,73,Gloucester,1996,17010,16398,612,3.6
51,75,Goochland,1996,8893,8689,204,2.3
51,77,Grayson,1996,8327,7762,565,6.8
51,79,Greene,1996,6903,6695,208,3.0
51,81,Greensville,1996,5606,5324,282,5.0
51,83,Halifax,1996,18256,16234,2022,11.1
51,85,Hanover,1996,42670,41761,909,2.1
51,87,Henrico,1996,137490,133547,3943,2.9
51,89,Henry,1996,29374,27335,2039,6.9
51,91,Highland,1996,1315,1201,114,8.7
51,93,Isle of Wight,1996,14515,13791,724,5.0
51,95,James City,1996,22671,22011,660,2.9
51,97,King and Queen,1996,3000,2845,155,5.2
51,99,King George,1996,8078,7752,326,4.0
51,101,King William,1996,6238,5965,273,4.4
51,103,Lancaster,1996,5248,4505,743,14.2
51,105,Lee,1996,10945,9674,1271,11.6
51,107,Loudoun,1996,71768,70091,1677,2.3
51,109,Louisa,1996,9411,8597,814,8.6
51,111,Lunenburg,1996,5106,4611,495,9.7
51,113,Madison,1996,7264,6993,271,3.7
51,115,Mathews,1996,4488,4341,147,3.3
51,117,Mecklenburg,1996,15206,13916,1290,8.5
51,119,Middlesex,1996,4586,4427,159,3.5
51,121,Montgomery,1996,37182,35871,1311,3.5
51,125,Nelson,1996,6773,6496,277,4.1
51,127,New Kent,1996,6330,6131,199,3.1
51,131,Northampton,1996,5481,5041,440,8.0
51,133,Northumberland,1996,5243,4582,661,12.6
51,135,Nottoway,1996,6332,5938,394,6.2
51,137,Orange,1996,10889,10314,575,5.3
51,139,Page,1996,11700,10886,814,7.0
51,141,Patrick,1996,9121,8675,446,4.9
51,143,Pittsylvania,1996,32006,29935,2071,6.5
51,145,Powhatan,1996,10049,9821,228,2.3
51,147,Prince Edward,1996,8414,7926,488,5.8
51,149,Prince George,1996,12598,12154,444,3.5
51,153,Prince William,1996,130012,126420,3592,2.8
51,155,Pulaski,1996,17544,15902,1642,9.4
51,157,Rappahannock,1996,4021,3875,146,3.6
51,159,Richmond,1996,3962,3662,300,7.6
51,161,Roanoke,1996,48953,47892,1061,2.2
51,163,Rockbridge,1996,9816,9388,428,4.4
51,165,Rockingham,1996,36623,35667,956,2.6
51,167,Russell,1996,14280,12691,1589,11.1
51,169,Scott,1996,9912,9190,722,7.3
51,171,Shenandoah,1996,17420,16573,847,4.9
51,173,Smyth,1996,16883,15089,1794,10.6
51,175,Southampton,1996,7539,7170,369,4.9
51,177,Spotsylvania,1996,39961,38711,1250,3.1
51,179,Stafford,1996,42398,41285,1113,2.6
51,181,Surry,1996,2698,2424,274,10.2
51,183,Sussex,1996,5089,4714,375,7.4
51,185,Tazewell,1996,19928,18046,1882,9.4
51,187,Warren,1996,14893,14153,740,5.0
51,191,Washington,1996,26398,24385,2013,7.6
51,193,Westmoreland,1996,7505,6800,705,9.4
51,195,Wise,1996,15256,12875,2381,15.6
51,197,Wythe,1996,15355,14017,1338,8.7
51,199,York,1996,27227,26421,806,3.0
51,510,Alexandria city,1996,73164,70286,2878,3.9
51,520,Bristol city,1996,8497,8031,466,5.5
51,530,Buena Vista city,1996,3125,2938,187,6.0
51,540,Charlottesville city,1996,18782,18198,584,3.1
51,550,Chesapeake city,1996,99778,95980,3798,3.8
51,570,Colonial Heights city,1996,8741,8391,350,4.0
51,580,Covington city,1996,3469,3195,274,7.9
51,590,Danville city,1996,25743,23599,2144,8.3
51,595,Emporia city,1996,2489,2335,154,6.2
51,600,Fairfax city,1996,11875,11697,178,1.5
51,610,Falls Church city,1996,5799,5566,233,4.0
51,620,Franklin city,1996,3778,3568,210,5.6
51,630,Fredericksburg city,1996,10379,9947,432,4.2
51,640,Galax city,1996,3491,3334,157,4.5
51,650,Hampton city,1996,66045,62766,3279,5.0
51,660,Harrisonburg city,1996,17690,17253,437,2.5
51,670,Hopewell city,1996,10591,9956,635,6.0
51,678,Lexington city,1996,2819,2741,78,2.8
51,680,Lynchburg city,1996,30393,29261,1132,3.7
51,683,Manassas city,1996,18985,18340,645,3.4
51,685,Manassas Park city,1996,4540,4370,170,3.7
51,690,Martinsville city,1996,7419,6810,609,8.2
51,700,Newport News city,1996,82575,78249,4326,5.2
51,710,Norfolk city,1996,86515,80759,5756,6.7
51,720,Norton city,1996,1554,1385,169,10.9
51,730,Petersburg city,1996,16040,14617,1423,8.9
51,735,Poquoson city,1996,5982,5804,178,3.0
51,740,Portsmouth city,1996,45848,42458,3390,7.4
51,750,Radford city,1996,6467,6183,284,4.4
51,760,Richmond city,1996,95478,90324,5154,5.4
51,770,Roanoke city,1996,50425,48539,1886,3.7
51,775,Salem city,1996,14141,13806,335,2.4
51,790,Staunton city,1996,10598,10098,500,4.7
51,800,Suffolk city,1996,28055,26409,1646,5.9
51,810,Virginia Beach city,1996,208729,200302,8427,4.0
51,820,Waynesboro city,1996,8584,8204,380,4.4
51,830,Williamsburg city,1996,5746,5281,465,8.1
51,840,Winchester city,1996,12876,12291,585,4.5
53,1,Adams,1996,8788,7801,987,11.2
53,3,Asotin,1996,11935,11434,501,4.2
53,5,Benton,1996,72407,66731,5676,7.8
53,7,Chelan,1996,35291,31785,3506,9.9
53,9,Clallam,1996,24837,22609,2228,9.0
53,11,Clark,1996,165400,158659,6741,4.1
53,13,Columbia,1996,1437,1226,211,14.7
53,15,Cowlitz,1996,41808,38459,3349,8.0
53,17,Douglas,1996,19165,17683,1482,7.7
53,19,Ferry,1996,2913,2541,372,12.8
53,21,Franklin,1996,22988,20396,2592,11.3
53,23,Garfield,1996,1106,1061,45,4.1
53,25,Grant,1996,35821,32334,3487,9.7
53,27,Grays Harbor,1996,28038,24969,3069,10.9
53,29,Island,1996,26614,25402,1212,4.6
53,31,Jefferson,1996,10091,9320,771,7.6
53,33,King,1996,930596,891379,39217,4.2
53,35,Kitsap,1996,95296,89343,5953,6.2
53,37,Kittitas,1996,15485,14242,1243,8.0
53,39,Klickitat,1996,9007,7973,1034,11.5
53,41,Lewis,1996,31058,28199,2859,9.2
53,43,Lincoln,1996,5075,4807,268,5.3
53,45,Mason,1996,19481,17953,1528,7.8
53,47,Okanogan,1996,23629,21119,2510,10.6
53,49,Pacific,1996,8405,7580,825,9.8
53,51,Pend Oreille,1996,4161,3526,635,15.3
53,53,Pierce,1996,324725,305896,18829,5.8
53,55,San Juan,1996,5687,5309,378,6.6
53,57,Skagit,1996,47818,43529,4289,9.0
53,59,Skamania,1996,4026,3604,422,10.5
53,61,Snohomish,1996,294038,280554,13484,4.6
53,63,Spokane,1996,205963,194901,11062,5.4
53,65,Stevens,1996,17301,15563,1738,10.0
53,67,Thurston,1996,98502,92478,6024,6.1
53,69,Wahkiakum,1996,1743,1631,112,6.4
53,71,Walla Walla,1996,26659,24793,1866,7.0
53,73,Whatcom,1996,80215,74608,5607,7.0
53,75,Whitman,1996,19258,18847,411,2.1
53,77,Yakima,1996,117102,102422,14680,12.5
54,1,Barbour,1996,6373,5496,877,13.8
54,3,Berkeley,1996,32189,30418,1771,5.5
54,5,Boone,1996,8384,7548,836,10.0
54,7,Braxton,1996,5422,4763,659,12.2
54,9,Brooke,1996,11234,10546,688,6.1
54,11,Cabell,1996,42906,40206,2700,6.3
54,13,Calhoun,1996,2607,2096,511,19.6
54,15,Clay,1996,3702,3196,506,13.7
54,17,Doddridge,1996,3081,2848,233,7.6
54,19,Fayette,1996,18142,16362,1780,9.8
54,21,Gilmer,1996,2783,2524,259,9.3
54,23,Grant,1996,4782,4268,514,10.7
54,25,Greenbrier,1996,15017,13702,1315,8.8
54,27,Hampshire,1996,8023,7644,379,4.7
54,29,Hancock,1996,15067,14080,987,6.6
54,31,Hardy,1996,6800,6517,283,4.2
54,33,Harrison,1996,33310,30599,2711,8.1
54,35,Jackson,1996,12531,11559,972,7.8
54,37,Jefferson,1996,19709,18892,817,4.1
54,39,Kanawha,1996,103012,97294,5718,5.6
54,41,Lewis,1996,7057,6362,695,9.8
54,43,Lincoln,1996,7100,6211,889,12.5
54,45,Logan,1996,14008,12443,1565,11.2
54,47,McDowell,1996,8039,6997,1042,13.0
54,49,Marion,1996,24229,21607,2622,10.8
54,51,Marshall,1996,15992,14917,1075,6.7
54,53,Mason,1996,9442,8363,1079,11.4
54,55,Mercer,1996,27658,26162,1496,5.4
54,57,Mineral,1996,11590,10874,716,6.2
54,59,Mingo,1996,9813,8399,1414,14.4
54,61,Monongalia,1996,38559,36536,2023,5.2
54,63,Monroe,1996,5051,4745,306,6.1
54,65,Morgan,1996,6161,5821,340,5.5
54,67,Nicholas,1996,10523,9362,1161,11.0
54,69,Ohio,1996,24294,23150,1144,4.7
54,71,Pendleton,1996,3682,3528,154,4.2
54,73,Pleasants,1996,3092,2798,294,9.5
54,75,Pocahontas,1996,4224,3670,554,13.1
54,77,Preston,1996,12826,11578,1248,9.7
54,79,Putnam,1996,24661,23320,1341,5.4
54,81,Raleigh,1996,33960,31104,2856,8.4
54,83,Randolph,1996,13172,11641,1531,11.6
54,85,Ritchie,1996,4329,3727,602,13.9
54,87,Roane,1996,6179,5448,731,11.8
54,89,Summers,1996,4312,3874,438,10.2
54,91,Taylor,1996,6863,6139,724,10.5
54,93,Tucker,1996,3859,3346,513,13.3
54,95,Tyler,1996,4215,3898,317,7.5
54,97,Upshur,1996,10075,9085,990,9.8
54,99,Wayne,1996,16700,15472,1228,7.4
54,101,Webster,1996,3058,2721,337,11.0
54,103,Wetzel,1996,7574,6805,769,10.2
54,105,Wirt,1996,2019,1679,340,16.8
54,107,Wood,1996,43446,40780,2666,6.1
54,109,Wyoming,1996,8136,7270,866,10.6
55,1,Adams,1996,7335,6973,362,4.9
55,3,Ashland,1996,8219,7649,570,6.9
55,5,Barron,1996,24199,23081,1118,4.6
55,7,Bayfield,1996,7570,7107,463,6.1
55,9,Brown,1996,130854,126820,4034,3.1
55,11,Buffalo,1996,7978,7717,261,3.3
55,13,Burnett,1996,7019,6691,328,4.7
55,15,Calumet,1996,24734,24010,724,2.9
55,17,Chippewa,1996,29779,28437,1342,4.5
55,19,Clark,1996,17021,16011,1010,5.9
55,21,Columbia,1996,27340,25920,1420,5.2
55,23,Crawford,1996,9422,8989,433,4.6
55,25,Dane,1996,257044,252688,4356,1.7
55,27,Dodge,1996,47296,45928,1368,2.9
55,29,Door,1996,15566,14580,986,6.3
55,31,Douglas,1996,22689,21478,1211,5.3
55,33,Dunn,1996,22637,21902,735,3.2
55,35,Eau Claire,1996,50532,48842,1690,3.3
55,37,Florence,1996,1647,1541,106,6.4
55,39,Fond du Lac,1996,55377,53512,1865,3.4
55,41,Forest,1996,4646,4398,248,5.3
55,43,Grant,1996,25798,24172,1626,6.3
55,45,Green,1996,18677,18030,647,3.5
55,47,Green Lake,1996,10736,10209,527,4.9
55,49,Iowa,1996,13421,12918,503,3.7
55,51,Iron,1996,3263,2995,268,8.2
55,53,Jackson,1996,10583,10079,504,4.8
55,55,Jefferson,1996,42192,41055,1137,2.7
55,57,Juneau,1996,11337,10570,767,6.8
55,59,Kenosha,1996,77015,74252,2763,3.6
55,61,Kewaunee,1996,10456,10047,409,3.9
55,63,La Crosse,1996,60356,58517,1839,3.0
55,65,Lafayette,1996,8368,7994,374,4.5
55,67,Langlade,1996,9677,9142,535,5.5
55,69,Lincoln,1996,15830,15020,810,5.1
55,71,Manitowoc,1996,44561,42644,1917,4.3
55,73,Marathon,1996,71545,68700,2845,4.0
55,75,Marinette,1996,20378,19172,1206,5.9
55,77,Marquette,1996,6993,6542,451,6.4
55,78,Menominee,1996,2197,2015,182,8.3
55,79,Milwaukee,1996,483975,463756,20219,4.2
55,81,Monroe,1996,20257,19341,916,4.5
55,83,Oconto,1996,15110,14197,913,6.0
55,85,Oneida,1996,20306,19451,855,4.2
55,87,Outagamie,1996,99715,96816,2899,2.9
55,89,Ozaukee,1996,47661,46628,1033,2.2
55,91,Pepin,1996,3445,3280,165,4.8
55,93,Pierce,1996,20434,19765,669,3.3
55,95,Polk,1996,21524,20656,868,4.0
55,97,Portage,1996,37712,36131,1581,4.2
55,99,Price,1996,7911,7408,503,6.4
55,101,Racine,1996,93707,89674,4033,4.3
55,103,Richland,1996,8810,8473,337,3.8
55,105,Rock,1996,79470,76385,3085,3.9
55,107,Rusk,1996,7089,6584,505,7.1
55,109,St. Croix,1996,31906,30943,963,3.0
55,111,Sauk,1996,32983,31750,1233,3.7
55,113,Sawyer,1996,9165,8551,614,6.7
55,115,Shawano,1996,20585,19668,917,4.5
55,117,Sheboygan,1996,61379,59602,1777,2.9
55,119,Taylor,1996,10820,10274,546,5.0
55,121,Trempealeau,1996,14713,13998,715,4.9
55,123,Vernon,1996,13613,12985,628,4.6
55,125,Vilas,1996,10930,10422,508,4.6
55,127,Walworth,1996,52524,51142,1382,2.6
55,129,Washburn,1996,7560,7105,455,6.0
55,131,Washington,1996,65751,63977,1774,2.7
55,133,Waukesha,1996,206241,201109,5132,2.5
55,135,Waupaca,1996,26305,25338,967,3.7
55,137,Waushara,1996,10129,9530,599,5.9
55,139,Winnebago,1996,96560,93899,2661,2.8
55,141,Wood,1996,39896,38335,1561,3.9
56,1,Albany,1996,16916,16597,319,1.9
56,3,Big Horn,1996,5348,5028,320,6.0
56,5,Campbell,1996,18493,17621,872,4.7
56,7,Carbon,1996,8487,8040,447,5.3
56,9,Converse,1996,6493,6144,349,5.4
56,11,Crook,1996,3040,2903,137,4.5
56,13,Fremont,1996,17725,16356,1369,7.7
56,15,Goshen,1996,6424,6102,322,5.0
56,17,Hot Springs,1996,2520,2414,106,4.2
56,19,Johnson,1996,3731,3589,142,3.8
56,21,Laramie,1996,38986,37573,1413,3.6
56,23,Lincoln,1996,6397,5968,429,6.7
56,25,Natrona,1996,32552,30485,2067,6.3
56,27,Niobrara,1996,1288,1258,30,2.3
56,29,Park,1996,15108,14456,652,4.3
56,31,Platte,1996,4238,4072,166,3.9
56,33,Sheridan,1996,13547,12900,647,4.8
56,35,Sublette,1996,3046,2937,109,3.6
56,37,Sweetwater,1996,21031,19714,1317,6.3
56,39,Teton,1996,10573,10277,296,2.8
56,41,Uinta,1996,10984,10174,810,7.4
56,43,Washakie,1996,4849,4578,271,5.6
56,45,Weston,1996,3312,3138,174,5.3
72,1,Adjuntas Municipio,1996,5789,5066,723,12.5
72,3,Aguada Municipio,1996,15250,11720,3530,23.1
72,5,Aguadilla Municipio,1996,21751,17831,3920,18.0
72,7,Aguas Buenas Municipio,1996,8792,7739,1053,12.0
72,9,Aibonito Municipio,1996,11109,9617,1492,13.4
72,11,Anasco Municipio,1996,10587,8555,2032,19.2
72,13,Arecibo Municipio,1996,30465,25542,4923,16.2
72,15,Arroyo Municipio,1996,5434,4456,978,18.0
72,17,Barceloneta Municipio,1996,7645,6441,1204,15.7
72,19,Barranquitas Municipio,1996,7429,6517,912,12.3
72,21,Bayamon Municipio,1996,86898,79509,7389,8.5
72,23,Cabo Rojo Municipio,1996,15761,13640,2121,13.5
72,25,Caguas Municipio,1996,56742,50323,6419,11.3
72,27,Camuy Municipio,1996,9767,8133,1634,16.7
72,29,Canovanas Municipio,1996,16589,14386,2203,13.3
72,31,Carolina Municipio,1996,78911,71701,7210,9.1
72,33,Catano Municipio,1996,10088,9084,1004,10.0
72,35,Cayey Municipio,1996,16532,14329,2203,13.3
72,37,Ceiba Municipio,1996,5702,4888,814,14.3
72,39,Ciales Municipio,1996,4488,3371,1117,24.9
72,41,Cidra Municipio,1996,14983,13295,1688,11.3
72,43,Coamo Municipio,1996,9321,7747,1574,16.9
72,45,Comerio Municipio,1996,5484,4736,748,13.6
72,47,Corozal Municipio,1996,9880,8751,1129,11.4
72,49,Culebra Municipio,1996,711,650,61,8.6
72,51,Dorado Municipio,1996,10489,9353,1136,10.8
72,53,Fajardo Municipio,1996,13461,11199,2262,16.8
72,54,Florida Municipio,1996,2699,2202,497,18.4
72,55,Guanica Municipio,1996,5794,4406,1388,24.0
72,57,Guayama Municipio,1996,11781,9424,2357,20.0
72,59,Guayanilla Municipio,1996,7694,6205,1489,19.4
72,61,Guaynabo Municipio,1996,41423,39110,2313,5.6
72,63,Gurabo Municipio,1996,10825,9469,1356,12.5
72,65,Hatillo Municipio,1996,10985,9246,1739,15.8
72,67,Hormigueros Municipio,1996,6932,5962,970,14.0
72,69,Humacao Municipio,1996,20302,17077,3225,15.9
72,71,Isabela Municipio,1996,14054,11488,2566,18.3
72,73,Jayuya Municipio,1996,4029,3508,521,12.9
72,75,Juana Diaz Municipio,1996,13281,10755,2526,19.0
72,77,Juncos Municipio,1996,12015,10421,1594,13.3
72,79,Lajas Municipio,1996,9456,7917,1539,16.3
72,81,Lares Municipio,1996,8888,7238,1650,18.6
72,83,Las Marias Municipio,1996,3063,2516,547,17.9
72,85,Las Piedras Municipio,1996,10254,8635,1619,15.8
72,87,Loiza Municipio,1996,8466,7435,1031,12.2
72,89,Luquillo Municipio,1996,6636,5358,1278,19.3
72,91,Manati Municipio,1996,13276,10940,2336,17.6
72,93,Maricao Municipio,1996,2327,1942,385,16.5
72,95,Maunabo Municipio,1996,3160,2382,778,24.6
72,97,Mayaguez Municipio,1996,36227,30698,5529,15.3
72,99,Moca Municipio,1996,12440,10027,2413,19.4
72,101,Morovis Municipio,1996,9465,8198,1267,13.4
72,103,Naguabo Municipio,1996,6928,5736,1192,17.2
72,105,Naranjito Municipio,1996,7331,6332,999,13.6
72,107,Orocovis Municipio,1996,5636,4653,983,17.4
72,109,Patillas Municipio,1996,6185,4841,1344,21.7
72,111,Penuelas Municipio,1996,7965,6013,1952,24.5
72,113,Ponce Municipio,1996,60697,50712,9985,16.5
72,115,Quebradillas Municipio,1996,7949,6836,1113,14.0
72,117,Rincon Municipio,1996,5747,4713,1034,18.0
72,119,Rio Grande Municipio,1996,17360,14592,2768,15.9
72,121,Sabana Grande Municipio,1996,8600,7227,1373,16.0
72,123,Salinas Municipio,1996,8578,6587,1991,23.2
72,125,San German Municipio,1996,13431,11043,2388,17.8
72,127,San Juan Municipio,1996,164830,149991,14839,9.0
72,129,San Lorenzo Municipio,1996,12098,10138,1960,16.2
72,131,San Sebastian Municipio,1996,13442,9988,3454,25.7
72,133,Santa Isabel Municipio,1996,5671,4332,1339,23.6
72,135,Toa Alta Municipio,1996,19091,17356,1735,9.1
72,137,Toa Baja Municipio,1996,34349,31384,2965,8.6
72,139,Trujillo Alto Municipio,1996,28403,26353,2050,7.2
72,141,Utuado Municipio,1996,8354,7283,1071,12.8
72,143,Vega Alta Municipio,1996,11408,10071,1337,11.7
72,145,Vega Baja Municipio,1996,19157,16382,2775,14.5
72,147,Vieques Municipio,1996,2566,2210,356,13.9
72,149,Villalba Municipio,1996,6203,4800,1403,22.6
72,151,Yabucoa Municipio,1996,12231,9914,2317,18.9
72,153,Yauco Municipio,1996,13546,10917,2629,19.4
1,1,Autauga,1997,21087,20269,818,3.9
1,3,Baldwin,1997,67122,64800,2322,3.5
1,5,Barbour,1997,12473,11566,907,7.3
1,7,Bibb,1997,8032,7437,595,7.4
1,9,Blount,1997,22676,22003,673,3.0
1,11,Bullock,1997,4580,4108,472,10.3
1,13,Butler,1997,9908,8940,968,9.8
1,15,Calhoun,1997,54204,51235,2969,5.5
1,17,Chambers,1997,17023,16245,778,4.6
1,19,Cherokee,1997,10731,10298,433,4.0
1,21,Chilton,1997,18246,17360,886,4.9
1,23,Choctaw,1997,5975,5114,861,14.4
1,25,Clarke,1997,14567,13147,1420,9.7
1,27,Clay,1997,6700,6398,302,4.5
1,29,Cleburne,1997,7267,7013,254,3.5
1,31,Coffee,1997,21997,21127,870,4.0
1,33,Colbert,1997,27040,25117,1923,7.1
1,35,Conecuh,1997,6751,6051,700,10.4
1,37,Coosa,1997,5317,5086,231,4.3
1,39,Covington,1997,17656,16469,1187,6.7
1,41,Crenshaw,1997,5925,5442,483,8.2
1,43,Cullman,1997,38559,36970,1589,4.1
1,45,Dale,1997,21196,20044,1152,5.4
1,47,Dallas,1997,20216,18010,2206,10.9
1,49,DeKalb,1997,32149,30498,1651,5.1
1,51,Elmore,1997,28467,27449,1018,3.6
1,53,Escambia,1997,16882,15788,1094,6.5
1,55,Etowah,1997,49420,46922,2498,5.1
1,57,Fayette,1997,8637,8219,418,4.8
1,59,Franklin,1997,16822,15422,1400,8.3
1,61,Geneva,1997,12037,11338,699,5.8
1,63,Greene,1997,3499,2855,644,18.4
1,65,Hale,1997,7385,6823,562,7.6
1,67,Henry,1997,6452,6088,364,5.6
1,69,Houston,1997,44520,42578,1942,4.4
1,71,Jackson,1997,25986,23885,2101,8.1
1,73,Jefferson,1997,333350,321345,12005,3.6
1,75,Lamar,1997,7754,7106,648,8.4
1,77,Lauderdale,1997,43151,40531,2620,6.1
1,79,Lawrence,1997,16118,15060,1058,6.6
1,81,Lee,1997,49600,47760,1840,3.7
1,83,Limestone,1997,28279,27168,1111,3.9
1,85,Lowndes,1997,4324,3711,613,14.2
1,87,Macon,1997,8021,7383,638,8.0
1,89,Madison,1997,139249,135263,3986,2.9
1,91,Marengo,1997,10977,9887,1090,9.9
1,93,Marion,1997,16106,14820,1286,8.0
1,95,Marshall,1997,40383,38174,2209,5.5
1,97,Mobile,1997,197841,187480,10361,5.2
1,99,Monroe,1997,10212,8685,1527,15.0
1,101,Montgomery,1997,109793,105065,4728,4.3
1,103,Morgan,1997,54989,52420,2569,4.7
1,105,Perry,1997,4498,4045,453,10.1
1,107,Pickens,1997,8815,8131,684,7.8
1,109,Pike,1997,13427,12538,889,6.6
1,111,Randolph,1997,9511,9073,438,4.6
1,113,Russell,1997,25206,24073,1133,4.5
1,115,St. Clair,1997,29769,28786,983,3.3
1,117,Shelby,1997,76489,75105,1384,1.8
1,119,Sumter,1997,6078,5337,741,12.2
1,121,Talladega,1997,35379,33009,2370,6.7
1,123,Tallapoosa,1997,20488,19442,1046,5.1
1,125,Tuscaloosa,1997,81314,78651,2663,3.3
1,127,Walker,1997,30133,27780,2353,7.8
1,129,Washington,1997,6474,5622,852,13.2
1,131,Wilcox,1997,3902,3355,547,14.0
1,133,Winston,1997,13163,12175,988,7.5
2,13,Aleutians East Borough,1997,1569,1514,55,3.5
2,16,Aleutians West Census Area,1997,2256,2132,124,5.5
2,20,Anchorage Borough/municipality,1997,137247,130280,6967,5.1
2,50,Bethel Census Area,1997,5813,5353,460,7.9
2,60,Bristol Bay Borough,1997,595,552,43,7.2
2,68,Denali Borough,1997,1225,1101,124,10.1
2,70,Dillingham Census Area,1997,1667,1559,108,6.5
2,90,Fairbanks North Star Borough,1997,43290,40411,2879,6.7
2,100,Haines Borough,1997,1195,1071,124,10.4
2,110,Juneau Borough/city,1997,17293,16335,958,5.5
2,122,Kenai Peninsula Borough,1997,21960,19330,2630,12.0
2,130,Ketchikan Gateway Borough,1997,7581,6948,633,8.3
2,150,Kodiak Island Borough,1997,7324,6684,640,8.7
2,158,Kusilvak Census Area,1997,1954,1738,216,11.1
2,164,Lake and Peninsula Borough,1997,566,529,37,6.5
2,170,Matanuska-Susitna Borough,1997,28067,25473,2594,9.2
2,180,Nome Census Area,1997,3296,2952,344,10.4
2,185,North Slope Borough,1997,3248,3091,157,4.8
2,188,Northwest Arctic Borough,1997,2168,1858,310,14.3
2,201,Prince of Wales-Outer Ketchikan Census Area,1997,3395,2978,417,12.3
2,220,Sitka Borough/city,1997,4510,4249,261,5.8
2,232,Skagway-Hoonah-Angoon Census Area,1997,2284,2134,150,6.6
2,240,Southeast Fairbanks Census Area,1997,2460,2187,273,11.1
2,261,Valdez-Cordova Census Area,1997,5338,4817,521,9.8
2,280,Wrangell-Petersburg Census Area,1997,3627,3301,326,9.0
2,282,Yakutat Borough/city,1997,326,299,27,8.3
2,290,Yukon-Koyukuk Census Area,1997,2009,1724,285,14.2
4,1,Apache,1997,21647,17882,3765,17.4
4,3,Cochise,1997,41425,37957,3468,8.4
4,5,Coconino,1997,59154,54194,4960,8.4
4,7,Gila,1997,19516,17969,1547,7.9
4,9,Graham,1997,11154,10157,997,8.9
4,11,Greenlee,1997,4862,4511,351,7.2
4,12,La Paz,1997,7240,6550,690,9.5
4,13,Maricopa,1997,1454954,1411868,43086,3.0
4,15,Mohave,1997,61905,58606,3299,5.3
4,17,Navajo,1997,32606,27626,4980,15.3
4,19,Pima,1997,383178,370600,12578,3.3
4,21,Pinal,1997,57518,54645,2873,5.0
4,23,Santa Cruz,1997,14910,11825,3085,20.7
4,25,Yavapai,1997,67616,64928,2688,4.0
4,27,Yuma,1997,67230,48727,18503,27.5
5,1,Arkansas,1997,10506,9888,618,5.9
5,3,Ashley,1997,11414,10575,839,7.4
5,5,Baxter,1997,14408,13815,593,4.1
5,7,Benton,1997,65764,63990,1774,2.7
5,9,Boone,1997,14728,13922,806,5.5
5,11,Bradley,1997,4993,4437,556,11.1
5,13,Calhoun,1997,2319,2124,195,8.4
5,15,Carroll,1997,11639,10990,649,5.6
5,17,Chicot,1997,6368,5829,539,8.5
5,19,Clark,1997,12020,11594,426,3.5
5,21,Clay,1997,8176,7723,453,5.5
5,23,Cleburne,1997,9343,8932,411,4.4
5,25,Cleveland,1997,3982,3762,220,5.5
5,27,Columbia,1997,11587,10744,843,7.3
5,29,Conway,1997,9823,9344,479,4.9
5,31,Craighead,1997,41323,39732,1591,3.9
5,33,Crawford,1997,23973,22894,1079,4.5
5,35,Crittenden,1997,22611,21517,1094,4.8
5,37,Cross,1997,8589,8070,519,6.0
5,39,Dallas,1997,3706,3443,263,7.1
5,41,Desha,1997,7191,6555,636,8.8
5,43,Drew,1997,10001,9183,818,8.2
5,45,Faulkner,1997,41683,39657,2026,4.9
5,47,Franklin,1997,8126,7846,280,3.4
5,49,Fulton,1997,4342,4147,195,4.5
5,51,Garland,1997,35876,34279,1597,4.5
5,53,Grant,1997,7477,7130,347,4.6
5,55,Greene,1997,17875,16918,957,5.4
5,57,Hempstead,1997,11927,11045,882,7.4
5,59,Hot Spring,1997,12282,11609,673,5.5
5,61,Howard,1997,7121,6726,395,5.5
5,63,Independence,1997,17049,16080,969,5.7
5,65,Izard,1997,4142,3875,267,6.4
5,67,Jackson,1997,7923,7095,828,10.5
5,69,Jefferson,1997,37035,34075,2960,8.0
5,71,Johnson,1997,10619,10191,428,4.0
5,73,Lafayette,1997,3520,3279,241,6.8
5,75,Lawrence,1997,7845,7322,523,6.7
5,77,Lee,1997,4508,3971,537,11.9
5,79,Lincoln,1997,5323,4960,363,6.8
5,81,Little River,1997,5638,5199,439,7.8
5,83,Logan,1997,10192,9706,486,4.8
5,85,Lonoke,1997,25222,24403,819,3.2
5,87,Madison,1997,6414,6166,248,3.9
5,89,Marion,1997,6136,5898,238,3.9
5,91,Miller,1997,17322,16488,834,4.8
5,93,Mississippi,1997,27479,24762,2717,9.9
5,95,Monroe,1997,4292,3940,352,8.2
5,97,Montgomery,1997,4049,3900,149,3.7
5,99,Nevada,1997,5159,4809,350,6.8
5,101,Newton,1997,3038,2777,261,8.6
5,103,Ouachita,1997,11917,10794,1123,9.4
5,105,Perry,1997,3782,3520,262,6.9
5,107,Phillips,1997,10220,9228,992,9.7
5,109,Pike,1997,5058,4794,264,5.2
5,111,Poinsett,1997,10965,10279,686,6.3
5,113,Polk,1997,9033,8619,414,4.6
5,115,Pope,1997,26854,25648,1206,4.5
5,117,Prairie,1997,3836,3499,337,8.8
5,119,Pulaski,1997,193884,186409,7475,3.9
5,121,Randolph,1997,7761,6939,822,10.6
5,123,St. Francis,1997,12738,11472,1266,9.9
5,125,Saline,1997,40800,39583,1217,3.0
5,127,Scott,1997,4973,4831,142,2.9
5,129,Searcy,1997,3020,2754,266,8.8
5,131,Sebastian,1997,55865,53433,2432,4.4
5,133,Sevier,1997,6989,6579,410,5.9
5,135,Sharp,1997,6139,5757,382,6.2
5,137,Stone,1997,4910,4660,250,5.1
5,139,Union,1997,21100,19648,1452,6.9
5,141,Van Buren,1997,6350,5888,462,7.3
5,143,Washington,1997,74875,72525,2350,3.1
5,145,White,1997,30543,28864,1679,5.5
5,147,Woodruff,1997,4245,3893,352,8.3
5,149,Yell,1997,9582,9188,394,4.1
6,1,Alameda,1997,693449,662316,31133,4.5
6,3,Alpine,1997,497,450,47,9.5
6,5,Amador,1997,13194,12380,814,6.2
6,7,Butte,1997,83889,76576,7313,8.7
6,9,Calaveras,1997,14039,12757,1282,9.1
6,11,Colusa,1997,9097,7373,1724,19.0
6,13,Contra Costa,1997,469170,449404,19766,4.2
6,15,Del Norte,1997,10161,9122,1039,10.2
6,17,El Dorado,1997,75722,71536,4186,5.5
6,19,Fresno,1997,372149,321691,50458,13.6
6,21,Glenn,1997,10963,9485,1478,13.5
6,23,Humboldt,1997,60352,55895,4457,7.4
6,25,Imperial,1997,56186,41047,15139,26.9
6,27,Inyo,1997,7287,6686,601,8.2
6,29,Kern,1997,278233,243585,34648,12.5
6,31,Kings,1997,43638,37841,5797,13.3
6,33,Lake,1997,23010,20526,2484,10.8
6,35,Lassen,1997,11651,10523,1128,9.7
6,37,Los Angeles,1997,4434117,4128390,305727,6.9
6,39,Madera,1997,52072,44995,7077,13.6
6,41,Marin,1997,130851,127063,3788,2.9
6,43,Mariposa,1997,6859,6166,693,10.1
6,45,Mendocino,1997,42427,39004,3423,8.1
6,47,Merced,1997,83311,70212,13099,15.7
6,49,Modoc,1997,3906,3448,458,11.7
6,51,Mono,1997,6063,5431,632,10.4
6,53,Monterey,1997,181854,161859,19995,11.0
6,55,Napa,1997,59167,56105,3062,5.2
6,57,Nevada,1997,40779,38247,2532,6.2
6,59,Orange,1997,1374222,1328578,45644,3.3
6,61,Placer,1997,109791,104662,5129,4.7
6,63,Plumas,1997,9848,8800,1048,10.6
6,65,Riverside,1997,638299,589754,48545,7.6
6,67,Sacramento,1997,550667,519844,30823,5.6
6,69,San Benito,1997,26131,23202,2929,11.2
6,71,San Bernardino,1997,704281,658770,45511,6.5
6,73,San Diego,1997,1275278,1220418,54860,4.3
6,75,San Francisco/city,1997,408423,391598,16825,4.1
6,77,San Joaquin,1997,244562,218064,26498,10.8
6,79,San Luis Obispo,1997,105368,100328,5040,4.8
6,81,San Mateo,1997,384217,373742,10475,2.7
6,83,Santa Barbara,1997,194135,184280,9855,5.1
6,85,Santa Clara,1997,930160,901507,28653,3.1
6,87,Santa Cruz,1997,140701,129579,11122,7.9
6,89,Shasta,1997,72649,65928,6721,9.3
6,91,Sierra,1997,1723,1542,181,10.5
6,93,Siskiyou,1997,18541,16277,2264,12.2
6,95,Solano,1997,177877,166202,11675,6.6
6,97,Sonoma,1997,237753,228616,9137,3.8
6,99,Stanislaus,1997,197920,171638,26282,13.3
6,101,Sutter,1997,35321,29941,5380,15.2
6,103,Tehama,1997,24007,21782,2225,9.3
6,105,Trinity,1997,5153,4445,708,13.7
6,107,Tulare,1997,160117,135392,24725,15.4
6,109,Tuolumne,1997,19709,17969,1740,8.8
6,111,Ventura,1997,378688,353485,25203,6.7
6,113,Yolo,1997,85725,80613,5112,6.0
6,115,Yuba,1997,20902,18116,2786,13.3
8,1,Adams,1997,172446,166860,5586,3.2
8,3,Alamosa,1997,8338,7902,436,5.2
8,5,Arapahoe,1997,276948,270147,6801,2.5
8,7,Archuleta,1997,4076,3864,212,5.2
8,9,Baca,1997,2373,2335,38,1.6
8,11,Bent,1997,2266,2201,65,2.9
8,13,Boulder,1997,158399,153740,4659,2.9
8,14,Broomfield/city,1997,17987,17597,390,2.2
8,15,Chaffee,1997,7602,7326,276,3.6
8,17,Cheyenne,1997,1313,1280,33,2.5
8,19,Clear Creek,1997,5263,5085,178,3.4
8,21,Conejos,1997,3785,3461,324,8.6
8,23,Costilla,1997,1449,1226,223,15.4
8,25,Crowley,1997,1322,1273,49,3.7
8,27,Custer,1997,1814,1740,74,4.1
8,29,Delta,1997,10653,10138,515,4.8
8,31,Denver/city,1997,281460,270394,11066,3.9
8,33,Dolores,1997,645,556,89,13.8
8,35,Douglas,1997,76132,74891,1241,1.6
8,37,Eagle,1997,19695,19149,546,2.8
8,39,Elbert,1997,10132,9791,341,3.4
8,41,El Paso,1997,252461,243020,9441,3.7
8,43,Fremont,1997,17056,16377,679,4.0
8,45,Garfield,1997,21580,20759,821,3.8
8,47,Gilpin,1997,3184,3111,73,2.3
8,49,Grand,1997,5769,5603,166,2.9
8,51,Gunnison,1997,7987,7589,398,5.0
8,53,Hinsdale,1997,610,597,13,2.1
8,55,Huerfano,1997,3741,3545,196,5.2
8,57,Jackson,1997,917,861,56,6.1
8,59,Jefferson,1997,302209,294563,7646,2.5
8,61,Kiowa,1997,881,866,15,1.7
8,63,Kit Carson,1997,3578,3490,88,2.5
8,65,Lake,1997,3234,3080,154,4.8
8,67,La Plata,1997,24421,23305,1116,4.6
8,69,Larimer,1997,137524,133001,4523,3.3
8,71,Las Animas,1997,6531,6098,433,6.6
8,73,Lincoln,1997,2645,2596,49,1.9
8,75,Logan,1997,10012,9654,358,3.6
8,77,Mesa,1997,57647,55056,2591,4.5
8,79,Mineral,1997,422,403,19,4.5
8,81,Moffat,1997,6669,6307,362,5.4
8,83,Montezuma,1997,11428,10643,785,6.9
8,85,Montrose,1997,15620,14756,864,5.5
8,87,Morgan,1997,13398,12971,427,3.2
8,89,Otero,1997,9145,8687,458,5.0
8,91,Ouray,1997,1781,1693,88,4.9
8,93,Park,1997,7678,7416,262,3.4
8,95,Phillips,1997,2052,2014,38,1.9
8,97,Pitkin,1997,9423,9046,377,4.0
8,99,Prowers,1997,6861,6654,207,3.0
8,101,Pueblo,1997,60563,57604,2959,4.9
8,103,Rio Blanco,1997,3264,3134,130,4.0
8,105,Rio Grande,1997,5268,4853,415,7.9
8,107,Routt,1997,10760,10374,386,3.6
8,109,Saguache,1997,2797,2569,228,8.2
8,111,San Juan,1997,259,230,29,11.2
8,113,San Miguel,1997,4361,4169,192,4.4
8,115,Sedgwick,1997,1276,1245,31,2.4
8,117,Summit,1997,12465,12192,273,2.2
8,119,Teller,1997,13834,13283,551,4.0
8,121,Washington,1997,2476,2402,74,3.0
8,123,Weld,1997,82461,79157,3304,4.0
8,125,Yuma,1997,4485,4386,99,2.2
9,1,Fairfield,1997,455413,437486,17927,3.9
9,3,Hartford,1997,429150,407103,22047,5.1
9,5,Litchfield,1997,101975,97977,3998,3.9
9,7,Middlesex,1997,83496,79764,3732,4.5
9,9,New Haven,1997,421104,399848,21256,5.0
9,11,New London,1997,135917,128911,7006,5.2
9,13,Tolland,1997,71058,68446,2612,3.7
9,15,Windham,1997,56487,53042,3445,6.1
10,1,Kent,1997,68123,65079,3044,4.5
10,3,New Castle,1997,252034,242205,9829,3.9
10,5,Sussex,1997,69554,66886,2668,3.8
11,1,District of Colu,1997,287313,263995,23318,8.1
12,1,Alachua,1997,105487,102318,3169,3.0
12,3,Baker,1997,8661,8241,420,4.8
12,5,Bay,1997,67625,62878,4747,7.0
12,7,Bradford,1997,10119,9722,397,3.9
12,9,Brevard,1997,210165,199996,10169,4.8
12,11,Broward,1997,778195,737934,40261,5.2
12,13,Calhoun,1997,5408,5099,309,5.7
12,15,Charlotte,1997,46857,44865,1992,4.3
12,17,Citrus,1997,36131,33936,2195,6.1
12,19,Clay,1997,68781,66559,2222,3.2
12,21,Collier,1997,90700,85849,4851,5.3
12,23,Columbia,1997,25293,24062,1231,4.9
12,27,DeSoto,1997,10117,9372,745,7.4
12,29,Dixie,1997,3998,3689,309,7.7
12,31,Duval,1997,385825,370237,15588,4.0
12,33,Escambia,1997,123744,118209,5535,4.5
12,35,Flagler,1997,16691,16126,565,3.4
12,37,Franklin,1997,4618,4291,327,7.1
12,39,Gadsden,1997,19813,18849,964,4.9
12,41,Gilchrist,1997,4708,4506,202,4.3
12,43,Glades,1997,4166,3799,367,8.8
12,45,Gulf,1997,5898,5156,742,12.6
12,47,Hamilton,1997,3547,3283,264,7.4
12,49,Hardee,1997,11086,9598,1488,13.4
12,51,Hendry,1997,17454,15044,2410,13.8
12,53,Hernando,1997,46452,44506,1946,4.2
12,55,Highlands,1997,28149,25676,2473,8.8
12,57,Hillsborough,1997,534238,515303,18935,3.5
12,59,Holmes,1997,6844,6387,457,6.7
12,61,Indian River,1997,45701,41767,3934,8.6
12,63,Jackson,1997,18722,17774,948,5.1
12,65,Jefferson,1997,5337,5082,255,4.8
12,67,Lafayette,1997,2892,2809,83,2.9
12,69,Lake,1997,86359,82751,3608,4.2
12,71,Lee,1997,177361,170987,6374,3.6
12,73,Leon,1997,129065,125159,3906,3.0
12,75,Levy,1997,13337,12726,611,4.6
12,77,Liberty,1997,2560,2440,120,4.7
12,79,Madison,1997,7452,7054,398,5.3
12,81,Manatee,1997,117964,114248,3716,3.2
12,83,Marion,1997,97989,93238,4751,4.8
12,85,Martin,1997,47984,44486,3498,7.3
12,86,Miami-Dade,1997,1094851,1022299,72552,6.6
12,87,Monroe,1997,47074,45906,1168,2.5
12,89,Nassau,1997,27963,26877,1086,3.9
12,91,Okaloosa,1997,81668,78595,3073,3.8
12,93,Okeechobee,1997,17397,15831,1566,9.0
12,95,Orange,1997,469448,452777,16671,3.6
12,97,Osceola,1997,79595,76497,3098,3.9
12,99,Palm Beach,1997,502703,469370,33333,6.6
12,101,Pasco,1997,132569,126952,5617,4.2
12,103,Pinellas,1997,466688,449589,17099,3.7
12,105,Polk,1997,203888,190066,13822,6.8
12,107,Putnam,1997,28577,26827,1750,6.1
12,109,St. Johns,1997,58582,56725,1857,3.2
12,111,St. Lucie,1997,77964,69182,8782,11.3
12,113,Santa Rosa,1997,51212,49274,1938,3.8
12,115,Sarasota,1997,149224,145071,4153,2.8
12,117,Seminole,1997,208864,201628,7236,3.5
12,119,Sumter,1997,14580,13909,671,4.6
12,121,Suwannee,1997,13360,12748,612,4.6
12,123,Taylor,1997,7649,6914,735,9.6
12,125,Union,1997,4061,3902,159,3.9
12,127,Volusia,1997,178588,171124,7464,4.2
12,129,Wakulla,1997,10398,9997,401,3.9
12,131,Walton,1997,15515,14809,706,4.6
12,133,Washington,1997,9379,8850,529,5.6
13,1,Appling,1997,8514,7810,704,8.3
13,3,Atkinson,1997,3372,3093,279,8.3
13,5,Bacon,1997,4453,4099,354,7.9
13,7,Baker,1997,1612,1462,150,9.3
13,9,Baldwin,1997,17554,16799,755,4.3
13,11,Banks,1997,6110,5789,321,5.3
13,13,Barrow,1997,19812,19027,785,4.0
13,15,Bartow,1997,37437,35429,2008,5.4
13,17,Ben Hill,1997,8958,8361,597,6.7
13,19,Berrien,1997,7006,6677,329,4.7
13,21,Bibb,1997,74634,70837,3797,5.1
13,23,Bleckley,1997,5455,5203,252,4.6
13,25,Brantley,1997,5746,5331,415,7.2
13,27,Brooks,1997,7898,7505,393,5.0
13,29,Bryan,1997,10617,10244,373,3.5
13,31,Bulloch,1997,25996,25163,833,3.2
13,33,Burke,1997,8747,7486,1261,14.4
13,35,Butts,1997,8399,8000,399,4.8
13,37,Calhoun,1997,2352,2168,184,7.8
13,39,Camden,1997,16317,15557,760,4.7
13,43,Candler,1997,4162,3981,181,4.3
13,45,Carroll,1997,42861,40757,2104,4.9
13,47,Catoosa,1997,25406,24413,993,3.9
13,49,Charlton,1997,3752,3565,187,5.0
13,51,Chatham,1997,107391,101897,5494,5.1
13,53,Chattahoochee,1997,2331,2160,171,7.3
13,55,Chattooga,1997,11947,11366,581,4.9
13,57,Cherokee,1997,72649,70944,1705,2.3
13,59,Clarke,1997,47188,45726,1462,3.1
13,61,Clay,1997,1717,1582,135,7.9
13,63,Clayton,1997,118526,113692,4834,4.1
13,65,Clinch,1997,4039,3864,175,4.3
13,67,Cobb,1997,335716,325814,9902,2.9
13,69,Coffee,1997,18249,17129,1120,6.1
13,71,Colquitt,1997,19215,18256,959,5.0
13,73,Columbia,1997,42648,40998,1650,3.9
13,75,Cook,1997,7778,7375,403,5.2
13,77,Coweta,1997,41773,40155,1618,3.9
13,79,Crawford,1997,5124,4872,252,4.9
13,81,Crisp,1997,10035,9324,711,7.1
13,83,Dade,1997,7104,6775,329,4.6
13,85,Dawson,1997,10142,9855,287,2.8
13,87,Decatur,1997,12303,11707,596,4.8
13,89,DeKalb,1997,353080,337499,15581,4.4
13,91,Dodge,1997,9360,8764,596,6.4
13,93,Dooly,1997,4746,4371,375,7.9
13,95,Dougherty,1997,46648,43375,3273,7.0
13,97,Douglas,1997,49212,47702,1510,3.1
13,99,Early,1997,4910,4509,401,8.2
13,101,Echols,1997,1185,1143,42,3.5
13,103,Effingham,1997,16937,16325,612,3.6
13,105,Elbert,1997,8966,8217,749,8.4
13,107,Emanuel,1997,8622,7734,888,10.3
13,109,Evans,1997,5088,4892,196,3.9
13,111,Fannin,1997,8634,8007,627,7.3
13,113,Fayette,1997,46447,45385,1062,2.3
13,115,Floyd,1997,46404,44258,2146,4.6
13,117,Forsyth,1997,42694,41817,877,2.1
13,119,Franklin,1997,10233,9734,499,4.9
13,121,Fulton,1997,390797,372935,17862,4.6
13,123,Gilmer,1997,8364,7826,538,6.4
13,125,Glascock,1997,1137,993,144,12.7
13,127,Glynn,1997,34633,33405,1228,3.5
13,129,Gordon,1997,21661,20462,1199,5.5
13,131,Grady,1997,10016,9151,865,8.6
13,133,Greene,1997,5716,5355,361,6.3
13,135,Gwinnett,1997,309732,301893,7839,2.5
13,137,Habersham,1997,15270,14505,765,5.0
13,139,Hall,1997,68346,66331,2015,2.9
13,141,Hancock,1997,3858,3436,422,10.9
13,143,Haralson,1997,9352,8715,637,6.8
13,145,Harris,1997,11632,11289,343,2.9
13,147,Hart,1997,8579,8104,475,5.5
13,149,Heard,1997,3869,3630,239,6.2
13,151,Henry,1997,54057,52708,1349,2.5
13,153,Houston,1997,51142,49091,2051,4.0
13,155,Irwin,1997,4655,4397,258,5.5
13,157,Jackson,1997,21855,21042,813,3.7
13,159,Jasper,1997,4861,4592,269,5.5
13,161,Jeff Davis,1997,5646,5271,375,6.6
13,163,Jefferson,1997,8082,7023,1059,13.1
13,165,Jenkins,1997,4649,4391,258,5.5
13,167,Johnson,1997,3669,3375,294,8.0
13,169,Jones,1997,11906,11474,432,3.6
13,171,Lamar,1997,7466,7133,333,4.5
13,173,Lanier,1997,3426,3309,117,3.4
13,175,Laurens,1997,22218,21244,974,4.4
13,177,Lee,1997,11552,11099,453,3.9
13,179,Liberty,1997,17181,15926,1255,7.3
13,181,Lincoln,1997,3692,3431,261,7.1
13,183,Long,1997,3476,3348,128,3.7
13,185,Lowndes,1997,41816,40147,1669,4.0
13,187,Lumpkin,1997,9644,9351,293,3.0
13,189,McDuffie,1997,9850,8891,959,9.7
13,191,McIntosh,1997,4523,4287,236,5.2
13,193,Macon,1997,5847,5103,744,12.7
13,195,Madison,1997,13418,12970,448,3.3
13,197,Marion,1997,3412,3233,179,5.2
13,199,Meriwether,1997,9186,8682,504,5.5
13,201,Miller,1997,3094,2945,149,4.8
13,205,Mitchell,1997,11444,10359,1085,9.5
13,207,Monroe,1997,7563,7098,465,6.1
13,209,Montgomery,1997,3787,3466,321,8.5
13,211,Morgan,1997,7195,6881,314,4.4
13,213,Murray,1997,17598,16611,987,5.6
13,215,Muscogee,1997,84557,80262,4295,5.1
13,217,Newton,1997,27727,26443,1284,4.6
13,219,Oconee,1997,12910,12662,248,1.9
13,221,Oglethorpe,1997,5361,5125,236,4.4
13,223,Paulding,1997,36897,35938,959,2.6
13,225,Peach,1997,11135,10441,694,6.2
13,227,Pickens,1997,9781,9427,354,3.6
13,229,Pierce,1997,7443,7056,387,5.2
13,231,Pike,1997,6270,6031,239,3.8
13,233,Polk,1997,15174,14090,1084,7.1
13,235,Pulaski,1997,4474,4250,224,5.0
13,237,Putnam,1997,9016,8616,400,4.4
13,239,Quitman,1997,1311,1248,63,4.8
13,241,Rabun,1997,7122,6893,229,3.2
13,243,Randolph,1997,3412,3112,300,8.8
13,245,Richmond,1997,81404,75481,5923,7.3
13,247,Rockdale,1997,38059,36872,1187,3.1
13,249,Schley,1997,1775,1664,111,6.3
13,251,Screven,1997,6471,5732,739,11.4
13,253,Seminole,1997,4567,4350,217,4.8
13,255,Spalding,1997,28827,27373,1454,5.0
13,257,Stephens,1997,13015,12289,726,5.6
13,259,Stewart,1997,2618,2452,166,6.3
13,261,Sumter,1997,15784,14302,1482,9.4
13,263,Talbot,1997,2685,2512,173,6.4
13,265,Taliaferro,1997,687,631,56,8.2
13,267,Tattnall,1997,7300,6955,345,4.7
13,269,Taylor,1997,3435,3180,255,7.4
13,271,Telfair,1997,4859,4406,453,9.3
13,273,Terrell,1997,4042,3558,484,12.0
13,275,Thomas,1997,21202,20251,951,4.5
13,277,Tift,1997,21343,20145,1198,5.6
13,279,Toombs,1997,12584,11377,1207,9.6
13,281,Towns,1997,3815,3441,374,9.8
13,283,Treutlen,1997,2868,2604,264,9.2
13,285,Troup,1997,28870,27307,1563,5.4
13,287,Turner,1997,4526,4035,491,10.8
13,289,Twiggs,1997,4145,3932,213,5.1
13,291,Union,1997,7208,6793,415,5.8
13,293,Upson,1997,12987,12431,556,4.3
13,295,Walker,1997,30926,29244,1682,5.4
13,297,Walton,1997,26439,25282,1157,4.4
13,299,Ware,1997,15853,15044,809,5.1
13,301,Warren,1997,2756,2424,332,12.0
13,303,Washington,1997,9916,9054,862,8.7
13,305,Wayne,1997,11105,10318,787,7.1
13,307,Webster,1997,1181,1113,68,5.8
13,309,Wheeler,1997,2067,1866,201,9.7
13,311,White,1997,9512,9118,394,4.1
13,313,Whitfield,1997,46881,45012,1869,4.0
13,315,Wilcox,1997,3556,3185,371,10.4
13,317,Wilkes,1997,5722,5381,341,6.0
13,319,Wilkinson,1997,4544,4287,257,5.7
13,321,Worth,1997,9260,8541,719,7.8
15,1,Hawaii,1997,69364,62791,6573,9.5
15,3,Honolulu/city,1997,433534,412254,21280,4.9
15,7,Kauai,1997,28852,25819,3033,10.5
15,9,Maui,1997,69988,65124,4864,6.9
16,1,Ada,1997,156240,151398,4842,3.1
16,3,Adams,1997,1679,1427,252,15.0
16,5,Bannock,1997,38794,36710,2084,5.4
16,7,Bear Lake,1997,2657,2534,123,4.6
16,9,Benewah,1997,4386,3947,439,10.0
16,11,Bingham,1997,21496,20454,1042,4.8
16,13,Blaine,1997,10729,10218,511,4.8
16,15,Boise,1997,2488,2326,162,6.5
16,17,Bonner,1997,17054,15590,1464,8.6
16,19,Bonneville,1997,45584,43851,1733,3.8
16,21,Boundary,1997,4504,4111,393,8.7
16,23,Butte,1997,1644,1566,78,4.7
16,25,Camas,1997,440,421,19,4.3
16,27,Canyon,1997,59817,56600,3217,5.4
16,29,Caribou,1997,3274,3075,199,6.1
16,31,Cassia,1997,9549,8893,656,6.9
16,33,Clark,1997,600,573,27,4.5
16,35,Clearwater,1997,4248,3735,513,12.1
16,37,Custer,1997,2144,1983,161,7.5
16,39,Elmore,1997,8978,8428,550,6.1
16,41,Franklin,1997,4546,4361,185,4.1
16,43,Fremont,1997,4919,4546,373,7.6
16,45,Gem,1997,6321,5905,416,6.6
16,47,Gooding,1997,6611,6336,275,4.2
16,49,Idaho,1997,6391,5709,682,10.7
16,51,Jefferson,1997,9668,9250,418,4.3
16,53,Jerome,1997,8739,8333,406,4.6
16,55,Kootenai,1997,54185,49731,4454,8.2
16,57,Latah,1997,14808,14291,517,3.5
16,59,Lemhi,1997,4126,3741,385,9.3
16,61,Lewis,1997,1619,1497,122,7.5
16,63,Lincoln,1997,1827,1722,105,5.7
16,65,Madison,1997,9620,9309,311,3.2
16,67,Minidoka,1997,9925,9121,804,8.1
16,69,Nez Perce,1997,23214,22402,812,3.5
16,71,Oneida,1997,1665,1607,58,3.5
16,73,Owyhee,1997,4492,4370,122,2.7
16,75,Payette,1997,10138,9360,778,7.7
16,77,Power,1997,3507,3290,217,6.2
16,79,Shoshone,1997,6767,6081,686,10.1
16,81,Teton,1997,2779,2650,129,4.6
16,83,Twin Falls,1997,31631,30190,1441,4.6
16,85,Valley,1997,4233,3823,410,9.7
16,87,Washington,1997,4604,4237,367,8.0
17,1,Adams,1997,36078,34934,1144,3.2
17,3,Alexander,1997,3835,3507,328,8.6
17,5,Bond,1997,8183,7822,361,4.4
17,7,Boone,1997,21646,20609,1037,4.8
17,9,Brown,1997,2749,2673,76,2.8
17,11,Bureau,1997,18570,17728,842,4.5
17,13,Calhoun,1997,3223,3071,152,4.7
17,15,Carroll,1997,8959,8519,440,4.9
17,17,Cass,1997,7495,7163,332,4.4
17,19,Champaign,1997,95636,93295,2341,2.4
17,21,Christian,1997,19367,18482,885,4.6
17,23,Clark,1997,9841,9445,396,4.0
17,25,Clay,1997,7157,6802,355,5.0
17,27,Clinton,1997,17536,16792,744,4.2
17,29,Coles,1997,27585,26695,890,3.2
17,31,Cook,1997,2683613,2529899,153714,5.7
17,33,Crawford,1997,9598,8980,618,6.4
17,35,Cumberland,1997,5708,5462,246,4.3
17,37,DeKalb,1997,46480,44880,1600,3.4
17,39,De Witt,1997,8411,8007,404,4.8
17,41,Douglas,1997,11968,11594,374,3.1
17,43,DuPage,1997,513350,496015,17335,3.4
17,45,Edgar,1997,10047,9653,394,3.9
17,47,Edwards,1997,3851,3664,187,4.9
17,49,Effingham,1997,18408,17653,755,4.1
17,51,Fayette,1997,10522,9962,560,5.3
17,53,Ford,1997,6642,6383,259,3.9
17,55,Franklin,1997,16865,15194,1671,9.9
17,57,Fulton,1997,14235,13303,932,6.5
17,59,Gallatin,1997,2717,2536,181,6.7
17,61,Greene,1997,7089,6708,381,5.4
17,63,Grundy,1997,18917,17465,1452,7.7
17,65,Hamilton,1997,3708,3416,292,7.9
17,67,Hancock,1997,12371,11940,431,3.5
17,69,Hardin,1997,1863,1681,182,9.8
17,71,Henderson,1997,4618,4433,185,4.0
17,73,Henry,1997,26711,25843,868,3.2
17,75,Iroquois,1997,16002,15400,602,3.8
17,77,Jackson,1997,29436,28183,1253,4.3
17,79,Jasper,1997,4020,3603,417,10.4
17,81,Jefferson,1997,17758,16596,1162,6.5
17,83,Jersey,1997,10645,10153,492,4.6
17,85,Jo Daviess,1997,12724,12247,477,3.7
17,87,Johnson,1997,4759,4430,329,6.9
17,89,Kane,1997,210835,202467,8368,4.0
17,91,Kankakee,1997,52925,50402,2523,4.8
17,93,Kendall,1997,28075,27064,1011,3.6
17,95,Knox,1997,29065,27955,1110,3.8
17,97,Lake,1997,321728,311974,9754,3.0
17,99,LaSalle,1997,54779,51441,3338,6.1
17,101,Lawrence,1997,6795,6263,532,7.8
17,103,Lee,1997,18005,17381,624,3.5
17,105,Livingston,1997,19276,18675,601,3.1
17,107,Logan,1997,12703,12121,582,4.6
17,109,McDonough,1997,18871,18500,371,2.0
17,111,McHenry,1997,132594,127154,5440,4.1
17,113,McLean,1997,84061,82219,1842,2.2
17,115,Macon,1997,60035,56433,3602,6.0
17,117,Macoupin,1997,22899,21784,1115,4.9
17,119,Madison,1997,131249,125970,5279,4.0
17,121,Marion,1997,21100,19588,1512,7.2
17,123,Marshall,1997,6550,6303,247,3.8
17,125,Mason,1997,8167,7657,510,6.2
17,127,Massac,1997,7863,7569,294,3.7
17,129,Menard,1997,6219,5996,223,3.6
17,131,Mercer,1997,9110,8701,409,4.5
17,133,Monroe,1997,13832,13450,382,2.8
17,135,Montgomery,1997,14988,14046,942,6.3
17,137,Morgan,1997,18383,17655,728,4.0
17,139,Moultrie,1997,7848,7596,252,3.2
17,141,Ogle,1997,28002,27044,958,3.4
17,143,Peoria,1997,96636,92685,3951,4.1
17,145,Perry,1997,8323,7555,768,9.2
17,147,Piatt,1997,7871,7518,353,4.5
17,149,Pike,1997,8905,8494,411,4.6
17,151,Pope,1997,1697,1555,142,8.4
17,153,Pulaski,1997,2823,2583,240,8.5
17,155,Putnam,1997,3097,2930,167,5.4
17,157,Randolph,1997,13982,13099,883,6.3
17,159,Richland,1997,10131,9685,446,4.4
17,161,Rock Island,1997,75314,72703,2611,3.5
17,163,St. Clair,1997,119452,113631,5821,4.9
17,165,Saline,1997,10170,9373,797,7.8
17,167,Sangamon,1997,102478,98767,3711,3.6
17,169,Schuyler,1997,3916,3715,201,5.1
17,171,Scott,1997,2796,2642,154,5.5
17,173,Shelby,1997,11619,11106,513,4.4
17,175,Stark,1997,2904,2747,157,5.4
17,177,Stephenson,1997,25499,24358,1141,4.5
17,179,Tazewell,1997,70421,67859,2562,3.6
17,181,Union,1997,8184,7636,548,6.7
17,183,Vermilion,1997,39956,37491,2465,6.2
17,185,Wabash,1997,5208,4773,435,8.4
17,187,Warren,1997,9884,9539,345,3.5
17,189,Washington,1997,8872,8526,346,3.9
17,191,Wayne,1997,8105,7717,388,4.8
17,193,White,1997,7408,6969,439,5.9
17,195,Whiteside,1997,32411,31412,999,3.1
17,197,Will,1997,233798,221971,11827,5.1
17,199,Williamson,1997,27644,25763,1881,6.8
17,201,Winnebago,1997,150895,144932,5963,4.0
17,203,Woodford,1997,19064,18576,488,2.6
18,1,Adams,1997,16694,16225,469,2.8
18,3,Allen,1997,177027,172089,4938,2.8
18,5,Bartholomew,1997,39779,38904,875,2.2
18,7,Benton,1997,5153,4968,185,3.6
18,9,Blackford,1997,6575,6278,297,4.5
18,11,Boone,1997,24061,23625,436,1.8
18,13,Brown,1997,8742,8565,177,2.0
18,15,Carroll,1997,12206,11914,292,2.4
18,17,Cass,1997,20025,19200,825,4.1
18,19,Clark,1997,51967,50256,1711,3.3
18,21,Clay,1997,12626,11945,681,5.4
18,23,Clinton,1997,16318,15799,519,3.2
18,25,Crawford,1997,4793,4423,370,7.7
18,27,Daviess,1997,13750,13288,462,3.4
18,29,Dearborn,1997,23338,22486,852,3.7
18,31,Decatur,1997,16340,15954,386,2.4
18,33,DeKalb,1997,21929,21306,623,2.8
18,35,Delaware,1997,63088,60681,2407,3.8
18,37,Dubois,1997,22741,22219,522,2.3
18,39,Elkhart,1997,94705,91695,3010,3.2
18,41,Fayette,1997,11702,11074,628,5.4
18,43,Floyd,1997,38653,37532,1121,2.9
18,45,Fountain,1997,8749,8348,401,4.6
18,47,Franklin,1997,10739,10343,396,3.7
18,49,Fulton,1997,10521,10077,444,4.2
18,51,Gibson,1997,15736,14878,858,5.5
18,53,Grant,1997,34652,33131,1521,4.4
18,55,Greene,1997,14726,13719,1007,6.8
18,57,Hamilton,1997,89638,88516,1122,1.3
18,59,Hancock,1997,29635,28965,670,2.3
18,61,Harrison,1997,18327,17714,613,3.3
18,63,Hendricks,1997,51534,50663,871,1.7
18,65,Henry,1997,25686,24565,1121,4.4
18,67,Howard,1997,42517,41115,1402,3.3
18,69,Huntington,1997,20851,20127,724,3.5
18,71,Jackson,1997,21082,20238,844,4.0
18,73,Jasper,1997,14472,13838,634,4.4
18,75,Jay,1997,11892,11328,564,4.7
18,77,Jefferson,1997,14735,14013,722,4.9
18,79,Jennings,1997,14555,14147,408,2.8
18,81,Johnson,1997,60373,59137,1236,2.0
18,83,Knox,1997,20183,19387,796,3.9
18,85,Kosciusko,1997,38329,37110,1219,3.2
18,87,LaGrange,1997,17163,16657,506,2.9
18,89,Lake,1997,230093,220036,10057,4.4
18,91,LaPorte,1997,54631,52534,2097,3.8
18,93,Lawrence,1997,24456,23202,1254,5.1
18,95,Madison,1997,66475,64048,2427,3.7
18,97,Marion,1997,453579,439614,13965,3.1
18,99,Marshall,1997,25870,25068,802,3.1
18,101,Martin,1997,5219,5030,189,3.6
18,103,Miami,1997,15452,14691,761,4.9
18,105,Monroe,1997,62226,60798,1428,2.3
18,107,Montgomery,1997,19713,19149,564,2.9
18,109,Morgan,1997,35054,34060,994,2.8
18,111,Newton,1997,6617,6342,275,4.2
18,113,Noble,1997,25045,24205,840,3.4
18,115,Ohio,1997,2695,2603,92,3.4
18,117,Orange,1997,9053,8414,639,7.1
18,119,Owen,1997,10726,10261,465,4.3
18,121,Parke,1997,7388,7028,360,4.9
18,123,Perry,1997,9273,8608,665,7.2
18,125,Pike,1997,6345,6049,296,4.7
18,127,Porter,1997,76247,74061,2186,2.9
18,129,Posey,1997,14115,13651,464,3.3
18,131,Pulaski,1997,6300,5883,417,6.6
18,133,Putnam,1997,16742,16172,570,3.4
18,135,Randolph,1997,11805,10781,1024,8.7
18,137,Ripley,1997,13386,12946,440,3.3
18,139,Rush,1997,10258,9965,293,2.9
18,141,St. Joseph,1997,138053,133614,4439,3.2
18,143,Scott,1997,11023,10482,541,4.9
18,145,Shelby,1997,23554,22795,759,3.2
18,147,Spencer,1997,11279,10785,494,4.4
18,149,Starke,1997,11513,10929,584,5.1
18,151,Steuben,1997,18006,17488,518,2.9
18,153,Sullivan,1997,10116,9469,647,6.4
18,155,Switzerland,1997,3810,3624,186,4.9
18,157,Tippecanoe,1997,73580,71929,1651,2.2
18,159,Tipton,1997,8769,8506,263,3.0
18,161,Union,1997,3972,3840,132,3.3
18,163,Vanderburgh,1997,91970,88218,3752,4.1
18,165,Vermillion,1997,7997,7463,534,6.7
18,167,Vigo,1997,51580,48642,2938,5.7
18,169,Wabash,1997,17797,17067,730,4.1
18,171,Warren,1997,3909,3786,123,3.1
18,173,Warrick,1997,28666,27660,1006,3.5
18,175,Washington,1997,12114,11476,638,5.3
18,177,Wayne,1997,38665,37232,1433,3.7
18,179,Wells,1997,14884,14538,346,2.3
18,181,White,1997,13061,12153,908,7.0
18,183,Whitley,1997,16627,16222,405,2.4
19,1,Adair,1997,4333,4211,122,2.8
19,3,Adams,1997,2335,2203,132,5.7
19,5,Allamakee,1997,7681,7342,339,4.4
19,7,Appanoose,1997,6862,6554,308,4.5
19,9,Audubon,1997,3621,3500,121,3.3
19,11,Benton,1997,12094,11690,404,3.3
19,13,Black Hawk,1997,69723,67133,2590,3.7
19,15,Boone,1997,14240,13864,376,2.6
19,17,Bremer,1997,13005,12697,308,2.4
19,19,Buchanan,1997,11089,10657,432,3.9
19,21,Buena Vista,1997,10989,10759,230,2.1
19,23,Butler,1997,7952,7630,322,4.0
19,25,Calhoun,1997,5058,4904,154,3.0
19,27,Carroll,1997,12583,12196,387,3.1
19,29,Cass,1997,7833,7462,371,4.7
19,31,Cedar,1997,9759,9475,284,2.9
19,33,Cerro Gordo,1997,27043,26199,844,3.1
19,35,Cherokee,1997,7088,6881,207,2.9
19,37,Chickasaw,1997,7660,7307,353,4.6
19,39,Clarke,1997,4255,4086,169,4.0
19,41,Clay,1997,10290,10011,279,2.7
19,43,Clayton,1997,10874,10377,497,4.6
19,45,Clinton,1997,27645,26650,995,3.6
19,47,Crawford,1997,9063,8774,289,3.2
19,49,Dallas,1997,19944,19526,418,2.1
19,51,Davis,1997,4215,4059,156,3.7
19,53,Decatur,1997,3854,3685,169,4.4
19,55,Delaware,1997,9686,9221,465,4.8
19,57,Des Moines,1997,23747,22837,910,3.8
19,59,Dickinson,1997,10033,9685,348,3.5
19,61,Dubuque,1997,50129,48223,1906,3.8
19,63,Emmet,1997,5858,5610,248,4.2
19,65,Fayette,1997,11519,11153,366,3.2
19,67,Floyd,1997,8115,7732,383,4.7
19,69,Franklin,1997,6095,5901,194,3.2
19,71,Fremont,1997,3814,3712,102,2.7
19,73,Greene,1997,5011,4884,127,2.5
19,75,Grundy,1997,6284,6120,164,2.6
19,77,Guthrie,1997,6123,5941,182,3.0
19,79,Hamilton,1997,8629,8366,263,3.0
19,81,Hancock,1997,6855,6704,151,2.2
19,83,Hardin,1997,9672,9287,385,4.0
19,85,Harrison,1997,7818,7554,264,3.4
19,87,Henry,1997,11287,10988,299,2.6
19,89,Howard,1997,5524,5348,176,3.2
19,91,Humboldt,1997,5709,5585,124,2.2
19,93,Ida,1997,4265,4147,118,2.8
19,95,Iowa,1997,9447,9215,232,2.5
19,97,Jackson,1997,10682,10138,544,5.1
19,99,Jasper,1997,19416,18898,518,2.7
19,101,Jefferson,1997,10483,10155,328,3.1
19,103,Johnson,1997,65758,64154,1604,2.4
19,105,Jones,1997,9882,9528,354,3.6
19,107,Keokuk,1997,5414,5175,239,4.4
19,109,Kossuth,1997,9231,9000,231,2.5
19,111,Lee,1997,19930,18881,1049,5.3
19,113,Linn,1997,110319,107602,2717,2.5
19,115,Louisa,1997,5842,5577,265,4.5
19,117,Lucas,1997,4018,3850,168,4.2
19,119,Lyon,1997,5912,5782,130,2.2
19,121,Madison,1997,7593,7306,287,3.8
19,123,Mahaska,1997,11474,11159,315,2.7
19,125,Marion,1997,18302,17762,540,3.0
19,127,Marshall,1997,20815,20192,623,3.0
19,129,Mills,1997,6196,6012,184,3.0
19,131,Mitchell,1997,5695,5563,132,2.3
19,133,Monona,1997,5389,5222,167,3.1
19,135,Monroe,1997,4223,4051,172,4.1
19,137,Montgomery,1997,6340,6037,303,4.8
19,139,Muscatine,1997,21409,20549,860,4.0
19,141,O'Brien,1997,8083,7894,189,2.3
19,143,Osceola,1997,3786,3681,105,2.8
19,145,Page,1997,9382,9097,285,3.0
19,147,Palo Alto,1997,5585,5443,142,2.5
19,149,Plymouth,1997,13155,12740,415,3.2
19,151,Pocahontas,1997,4371,4268,103,2.4
19,153,Polk,1997,213887,208379,5508,2.6
19,155,Pottawattamie,1997,48271,46653,1618,3.4
19,157,Poweshiek,1997,10427,10042,385,3.7
19,159,Ringgold,1997,2656,2578,78,2.9
19,161,Sac,1997,6240,6040,200,3.2
19,163,Scott,1997,85773,83126,2647,3.1
19,165,Shelby,1997,7190,6965,225,3.1
19,167,Sioux,1997,17974,17506,468,2.6
19,169,Story,1997,45876,44689,1187,2.6
19,171,Tama,1997,9415,9111,304,3.2
19,173,Taylor,1997,3343,3158,185,5.5
19,175,Union,1997,6557,6313,244,3.7
19,177,Van Buren,1997,4386,4242,144,3.3
19,179,Wapello,1997,18107,16993,1114,6.2
19,181,Warren,1997,23265,22792,473,2.0
19,183,Washington,1997,11566,11237,329,2.8
19,185,Wayne,1997,3253,3115,138,4.2
19,187,Webster,1997,20280,19595,685,3.4
19,189,Winnebago,1997,6739,6588,151,2.2
19,191,Winneshiek,1997,12365,11901,464,3.8
19,193,Woodbury,1997,55951,54102,1849,3.3
19,195,Worth,1997,4200,4075,125,3.0
19,197,Wright,1997,7106,6921,185,2.6
20,1,Allen,1997,6948,6567,381,5.5
20,3,Anderson,1997,4056,3839,217,5.4
20,5,Atchison,1997,8220,7672,548,6.7
20,7,Barber,1997,2440,2350,90,3.7
20,9,Barton,1997,15029,14543,486,3.2
20,11,Bourbon,1997,6656,6296,360,5.4
20,13,Brown,1997,4846,4560,286,5.9
20,15,Butler,1997,30802,29785,1017,3.3
20,17,Chase,1997,1467,1403,64,4.4
20,19,Chautauqua,1997,1594,1482,112,7.0
20,21,Cherokee,1997,10905,10243,662,6.1
20,23,Cheyenne,1997,1481,1452,29,2.0
20,25,Clark,1997,1313,1282,31,2.4
20,27,Clay,1997,4627,4490,137,3.0
20,29,Cloud,1997,5157,4975,182,3.5
20,31,Coffey,1997,4694,4422,272,5.8
20,33,Comanche,1997,1034,1013,21,2.0
20,35,Cowley,1997,18782,17878,904,4.8
20,37,Crawford,1997,17914,17002,912,5.1
20,39,Decatur,1997,1720,1671,49,2.8
20,41,Dickinson,1997,10494,10049,445,4.2
20,43,Doniphan,1997,4242,3969,273,6.4
20,45,Douglas,1997,52767,50547,2220,4.2
20,47,Edwards,1997,1720,1662,58,3.4
20,49,Elk,1997,1380,1321,59,4.3
20,51,Ellis,1997,17053,16631,422,2.5
20,53,Ellsworth,1997,2812,2741,71,2.5
20,55,Finney,1997,19188,18633,555,2.9
20,57,Ford,1997,15646,15187,459,2.9
20,59,Franklin,1997,14030,13443,587,4.2
20,61,Geary,1997,10092,9389,703,7.0
20,63,Gove,1997,1489,1458,31,2.1
20,65,Graham,1997,1532,1485,47,3.1
20,67,Grant,1997,4089,3943,146,3.6
20,69,Gray,1997,2591,2527,64,2.5
20,71,Greeley,1997,871,845,26,3.0
20,73,Greenwood,1997,3174,3020,154,4.9
20,75,Hamilton,1997,1181,1159,22,1.9
20,77,Harper,1997,3052,2967,85,2.8
20,79,Harvey,1997,17150,16667,483,2.8
20,81,Haskell,1997,2012,1960,52,2.6
20,83,Hodgeman,1997,941,923,18,1.9
20,85,Jackson,1997,6760,6376,384,5.7
20,87,Jefferson,1997,10577,10068,509,4.8
20,89,Jewell,1997,2083,2032,51,2.4
20,91,Johnson,1997,251715,245907,5808,2.3
20,93,Kearny,1997,2138,2087,51,2.4
20,95,Kingman,1997,4268,4112,156,3.7
20,97,Kiowa,1997,1632,1597,35,2.1
20,99,Labette,1997,10537,9956,581,5.5
20,101,Lane,1997,1073,1021,52,4.8
20,103,Leavenworth,1997,28174,26900,1274,4.5
20,105,Lincoln,1997,1717,1662,55,3.2
20,107,Linn,1997,3402,3106,296,8.7
20,109,Logan,1997,1677,1634,43,2.6
20,111,Lyon,1997,19581,18793,788,4.0
20,113,McPherson,1997,16129,15691,438,2.7
20,115,Marion,1997,7117,6956,161,2.3
20,117,Marshall,1997,5954,5775,179,3.0
20,119,Meade,1997,2307,2260,47,2.0
20,121,Miami,1997,13754,13221,533,3.9
20,123,Mitchell,1997,3489,3413,76,2.2
20,125,Montgomery,1997,17358,16405,953,5.5
20,127,Morris,1997,3116,2988,128,4.1
20,129,Morton,1997,1781,1743,38,2.1
20,131,Nemaha,1997,5881,5687,194,3.3
20,133,Neosho,1997,9014,8618,396,4.4
20,135,Ness,1997,1809,1763,46,2.5
20,137,Norton,1997,3163,3095,68,2.1
20,139,Osage,1997,9261,8633,628,6.8
20,141,Osborne,1997,2302,2245,57,2.5
20,143,Ottawa,1997,3119,2985,134,4.3
20,145,Pawnee,1997,3577,3491,86,2.4
20,147,Phillips,1997,3149,3063,86,2.7
20,149,Pottawatomie,1997,10646,10258,388,3.6
20,151,Pratt,1997,5029,4900,129,2.6
20,153,Rawlins,1997,1568,1521,47,3.0
20,155,Reno,1997,32713,31510,1203,3.7
20,157,Republic,1997,3099,3019,80,2.6
20,159,Rice,1997,4629,4450,179,3.9
20,161,Riley,1997,30627,29362,1265,4.1
20,163,Rooks,1997,3077,2999,78,2.5
20,165,Rush,1997,1821,1758,63,3.5
20,167,Russell,1997,3642,3512,130,3.6
20,169,Saline,1997,30233,29129,1104,3.7
20,171,Scott,1997,2683,2625,58,2.2
20,173,Sedgwick,1997,230084,222138,7946,3.5
20,175,Seward,1997,10766,10429,337,3.1
20,177,Shawnee,1997,89963,85518,4445,4.9
20,179,Sheridan,1997,1494,1463,31,2.1
20,181,Sherman,1997,4203,4116,87,2.1
20,183,Smith,1997,2353,2289,64,2.7
20,185,Stafford,1997,2364,2302,62,2.6
20,187,Stanton,1997,1077,1048,29,2.7
20,189,Stevens,1997,2805,2736,69,2.5
20,191,Sumner,1997,12770,12367,403,3.2
20,193,Thomas,1997,4791,4663,128,2.7
20,195,Trego,1997,1985,1930,55,2.8
20,197,Wabaunsee,1997,3411,3250,161,4.7
20,199,Wallace,1997,836,814,22,2.6
20,201,Washington,1997,3425,3309,116,3.4
20,203,Wichita,1997,1207,1159,48,4.0
20,205,Wilson,1997,5431,5206,225,4.1
20,207,Woodson,1997,1426,1344,82,5.8
20,209,Wyandotte,1997,75920,70563,5357,7.1
21,1,Adair,1997,8368,6910,1458,17.4
21,3,Allen,1997,8953,8316,637,7.1
21,5,Anderson,1997,9542,9151,391,4.1
21,7,Ballard,1997,4277,3863,414,9.7
21,9,Barren,1997,18344,17401,943,5.1
21,11,Bath,1997,5499,5138,361,6.6
21,13,Bell,1997,10177,9371,806,7.9
21,15,Boone,1997,41927,40519,1408,3.4
21,17,Bourbon,1997,9874,9580,294,3.0
21,19,Boyd,1997,22688,21092,1596,7.0
21,21,Boyle,1997,13657,13121,536,3.9
21,23,Bracken,1997,3790,3566,224,5.9
21,25,Breathitt,1997,4183,3767,416,9.9
21,27,Breckinridge,1997,7928,7422,506,6.4
21,29,Bullitt,1997,31605,30587,1018,3.2
21,31,Butler,1997,5689,5367,322,5.7
21,33,Caldwell,1997,6321,5920,401,6.3
21,35,Calloway,1997,17645,16756,889,5.0
21,37,Campbell,1997,45548,43783,1765,3.9
21,39,Carlisle,1997,2755,2567,188,6.8
21,41,Carroll,1997,4754,4548,206,4.3
21,43,Carter,1997,11482,10176,1306,11.4
21,45,Casey,1997,7045,6546,499,7.1
21,47,Christian,1997,27289,25998,1291,4.7
21,49,Clark,1997,16053,15400,653,4.1
21,51,Clay,1997,7221,6581,640,8.9
21,53,Clinton,1997,4465,4138,327,7.3
21,55,Crittenden,1997,4204,3883,321,7.6
21,57,Cumberland,1997,2784,2465,319,11.5
21,59,Daviess,1997,49194,46389,2805,5.7
21,61,Edmonson,1997,4935,4518,417,8.4
21,63,Elliott,1997,2899,2492,407,14.0
21,65,Estill,1997,6142,5826,316,5.1
21,67,Fayette,1997,139551,136208,3343,2.4
21,69,Fleming,1997,6047,5522,525,8.7
21,71,Floyd,1997,13883,12675,1208,8.7
21,73,Franklin,1997,24285,23540,745,3.1
21,75,Fulton,1997,3974,3616,358,9.0
21,77,Gallatin,1997,3424,3239,185,5.4
21,79,Garrard,1997,6802,6563,239,3.5
21,81,Grant,1997,9721,9226,495,5.1
21,83,Graves,1997,17330,16070,1260,7.3
21,85,Grayson,1997,11408,10531,877,7.7
21,87,Green,1997,4923,4508,415,8.4
21,89,Greenup,1997,16595,15452,1143,6.9
21,91,Hancock,1997,3923,3663,260,6.6
21,93,Hardin,1997,36310,34341,1969,5.4
21,95,Harlan,1997,9390,8217,1173,12.5
21,97,Harrison,1997,7458,7037,421,5.6
21,99,Hart,1997,7854,7360,494,6.3
21,101,Henderson,1997,23962,22575,1387,5.8
21,103,Henry,1997,7081,6833,248,3.5
21,105,Hickman,1997,2495,2358,137,5.5
21,107,Hopkins,1997,20372,19159,1213,6.0
21,109,Jackson,1997,6740,6380,360,5.3
21,111,Jefferson,1997,369148,352901,16247,4.4
21,113,Jessamine,1997,20032,19615,417,2.1
21,115,Johnson,1997,9779,9045,734,7.5
21,117,Kenton,1997,78745,75858,2887,3.7
21,119,Knott,1997,5798,5335,463,8.0
21,121,Knox,1997,11191,10159,1032,9.2
21,123,Larue,1997,6104,5847,257,4.2
21,125,Laurel,1997,22123,20740,1383,6.3
21,127,Lawrence,1997,5169,4593,576,11.1
21,129,Lee,1997,2608,2454,154,5.9
21,131,Leslie,1997,4422,4091,331,7.5
21,133,Letcher,1997,7717,7045,672,8.7
21,135,Lewis,1997,5299,4518,781,14.7
21,137,Lincoln,1997,10211,9797,414,4.1
21,139,Livingston,1997,4877,4550,327,6.7
21,141,Logan,1997,13110,12505,605,4.6
21,143,Lyon,1997,3383,3118,265,7.8
21,145,McCracken,1997,33875,32146,1729,5.1
21,147,McCreary,1997,6314,5718,596,9.4
21,149,McLean,1997,4596,4172,424,9.2
21,151,Madison,1997,34695,33653,1042,3.0
21,153,Magoffin,1997,4799,4130,669,13.9
21,155,Marion,1997,9335,8690,645,6.9
21,157,Marshall,1997,14505,13521,984,6.8
21,159,Martin,1997,3088,2768,320,10.4
21,161,Mason,1997,8360,7982,378,4.5
21,163,Meade,1997,10512,10040,472,4.5
21,165,Menifee,1997,2787,2533,254,9.1
21,167,Mercer,1997,10799,10386,413,3.8
21,169,Metcalfe,1997,4785,4544,241,5.0
21,171,Monroe,1997,5425,5065,360,6.6
21,173,Montgomery,1997,11833,11277,556,4.7
21,175,Morgan,1997,4889,4449,440,9.0
21,177,Muhlenberg,1997,12337,11287,1050,8.5
21,179,Nelson,1997,18284,17176,1108,6.1
21,181,Nicholas,1997,3305,3162,143,4.3
21,183,Ohio,1997,10304,9460,844,8.2
21,185,Oldham,1997,23195,22736,459,2.0
21,187,Owen,1997,4515,4348,167,3.7
21,189,Owsley,1997,1630,1548,82,5.0
21,191,Pendleton,1997,6771,6311,460,6.8
21,193,Perry,1997,11551,10726,825,7.1
21,195,Pike,1997,27511,25407,2104,7.6
21,197,Powell,1997,6724,6265,459,6.8
21,199,Pulaski,1997,25244,23821,1423,5.6
21,201,Robertson,1997,976,921,55,5.6
21,203,Rockcastle,1997,6059,5705,354,5.8
21,205,Rowan,1997,9116,8664,452,5.0
21,207,Russell,1997,6245,5393,852,13.6
21,209,Scott,1997,16294,15908,386,2.4
21,211,Shelby,1997,16305,15889,416,2.6
21,213,Simpson,1997,7621,7294,327,4.3
21,215,Spencer,1997,4747,4543,204,4.3
21,217,Taylor,1997,11096,10046,1050,9.5
21,219,Todd,1997,5411,5162,249,4.6
21,221,Trigg,1997,5864,5581,283,4.8
21,223,Trimble,1997,3143,3009,134,4.3
21,225,Union,1997,5978,5432,546,9.1
21,227,Warren,1997,49217,46610,2607,5.3
21,229,Washington,1997,5910,5649,261,4.4
21,231,Wayne,1997,7824,7198,626,8.0
21,233,Webster,1997,5698,5308,390,6.8
21,235,Whitley,1997,13998,13008,990,7.1
21,237,Wolfe,1997,3352,3101,251,7.5
21,239,Woodford,1997,13032,12754,278,2.1
22,1,Acadia Parish,1997,23075,21755,1320,5.7
22,3,Allen Parish,1997,8794,8174,620,7.1
22,5,Ascension Parish,1997,31988,30357,1631,5.1
22,7,Assumption Parish,1997,9814,9253,561,5.7
22,9,Avoyelles Parish,1997,16256,15018,1238,7.6
22,11,Beauregard Parish,1997,12239,11406,833,6.8
22,13,Bienville Parish,1997,5556,4551,1005,18.1
22,15,Bossier Parish,1997,45337,42696,2641,5.8
22,17,Caddo Parish,1997,116921,109434,7487,6.4
22,19,Calcasieu Parish,1997,88793,83664,5129,5.8
22,21,Caldwell Parish,1997,4319,3922,397,9.2
22,23,Cameron Parish,1997,3626,3451,175,4.8
22,25,Catahoula Parish,1997,4839,4382,457,9.4
22,27,Claiborne Parish,1997,6126,5576,550,9.0
22,29,Concordia Parish,1997,8204,7238,966,11.8
22,31,De Soto Parish,1997,10984,10014,970,8.8
22,33,East Baton Rouge Parish,1997,201838,192352,9486,4.7
22,35,East Carroll Parish,1997,3080,2642,438,14.2
22,37,East Feliciana Parish,1997,7450,7004,446,6.0
22,39,Evangeline Parish,1997,11952,11286,666,5.6
22,41,Franklin Parish,1997,9671,8718,953,9.9
22,43,Grant Parish,1997,6275,5726,549,8.7
22,45,Iberia Parish,1997,31714,30155,1559,4.9
22,47,Iberville Parish,1997,12075,11152,923,7.6
22,49,Jackson Parish,1997,6088,5633,455,7.5
22,51,Jefferson Parish,1997,240726,228747,11979,5.0
22,53,Jefferson Davis Parish,1997,11837,11065,772,6.5
22,55,Lafayette Parish,1997,94983,91487,3496,3.7
22,57,Lafourche Parish,1997,41075,39834,1241,3.0
22,59,LaSalle Parish,1997,5423,5092,331,6.1
22,61,Lincoln Parish,1997,18407,17789,618,3.4
22,63,Livingston Parish,1997,39703,37449,2254,5.7
22,65,Madison Parish,1997,5472,4829,643,11.8
22,67,Morehouse Parish,1997,12288,10748,1540,12.5
22,69,Natchitoches Parish,1997,16898,15702,1196,7.1
22,71,Orleans Parish,1997,206810,192194,14616,7.1
22,73,Ouachita Parish,1997,68486,64408,4078,6.0
22,75,Plaquemines Parish,1997,10868,10284,584,5.4
22,77,Pointe Coupee Parish,1997,9334,8595,739,7.9
22,79,Rapides Parish,1997,57452,54133,3319,5.8
22,81,Red River Parish,1997,3534,2755,779,22.0
22,83,Richland Parish,1997,8071,7268,803,9.9
22,85,Sabine Parish,1997,8951,8441,510,5.7
22,87,St. Bernard Parish,1997,32383,30339,2044,6.3
22,89,St. Charles Parish,1997,23118,21868,1250,5.4
22,91,St. Helena Parish,1997,3880,3625,255,6.6
22,93,St. James Parish,1997,8684,8020,664,7.6
22,95,St. John the Baptist Parish,1997,19780,18281,1499,7.6
22,97,St. Landry Parish,1997,31799,29400,2399,7.5
22,99,St. Martin Parish,1997,20969,19704,1265,6.0
22,101,St. Mary Parish,1997,25428,23979,1449,5.7
22,103,St. Tammany Parish,1997,90266,86228,4038,4.5
22,105,Tangipahoa Parish,1997,41853,38708,3145,7.5
22,107,Tensas Parish,1997,3054,2815,239,7.8
22,109,Terrebonne Parish,1997,46911,45286,1625,3.5
22,111,Union Parish,1997,11789,11157,632,5.4
22,113,Vermilion Parish,1997,22929,21782,1147,5.0
22,115,Vernon Parish,1997,16843,15787,1056,6.3
22,117,Washington Parish,1997,16617,15388,1229,7.4
22,119,Webster Parish,1997,18833,17253,1580,8.4
22,121,West Baton Rouge Parish,1997,9578,9067,511,5.3
22,123,West Carroll Parish,1997,5239,4510,729,13.9
22,125,West Feliciana Parish,1997,3742,3489,253,6.8
22,127,Winn Parish,1997,6650,6263,387,5.8
23,1,Androscoggin,1997,57324,54064,3260,5.7
23,3,Aroostook,1997,38427,34955,3472,9.0
23,5,Cumberland,1997,139717,135799,3918,2.8
23,7,Franklin,1997,15103,13950,1153,7.6
23,9,Hancock,1997,27651,26077,1574,5.7
23,11,Kennebec,1997,60276,56840,3436,5.7
23,13,Knox,1997,20110,19290,820,4.1
23,15,Lincoln,1997,16916,16261,655,3.9
23,17,Oxford,1997,26047,24342,1705,6.5
23,19,Penobscot,1997,74967,70710,4257,5.7
23,21,Piscataquis,1997,8481,7804,677,8.0
23,23,Sagadahoc,1997,15728,15120,608,3.9
23,25,Somerset,1997,26306,23979,2327,8.8
23,27,Waldo,1997,20373,19183,1190,5.8
23,29,Washington,1997,16745,14962,1783,10.6
23,31,York,1997,94043,90602,3441,3.7
24,1,Allegany,1997,33292,30156,3136,9.4
24,3,Anne Arundel,1997,254524,245126,9398,3.7
24,5,Baltimore,1997,398144,378465,19679,4.9
24,9,Calvert,1997,36276,35019,1257,3.5
24,11,Caroline,1997,16029,15237,792,4.9
24,13,Carroll,1997,80840,77878,2962,3.7
24,15,Cecil,1997,40905,37838,3067,7.5
24,17,Charles,1997,60254,57981,2273,3.8
24,19,Dorchester,1997,15655,14082,1573,10.0
24,21,Frederick,1997,98873,95333,3540,3.6
24,23,Garrett,1997,14435,12552,1883,13.0
24,25,Harford,1997,113645,108197,5448,4.8
24,27,Howard,1997,137427,133649,3778,2.7
24,29,Kent,1997,10223,9530,693,6.8
24,31,Montgomery,1997,465272,453857,11415,2.5
24,33,Prince George's,1997,446745,425575,21170,4.7
24,35,Queen Anne's,1997,20756,19948,808,3.9
24,37,St. Mary's,1997,48981,46956,2025,4.1
24,39,Somerset,1997,11499,10443,1056,9.2
24,41,Talbot,1997,18657,17905,752,4.0
24,43,Washington,1997,69751,66493,3258,4.7
24,45,Wicomico,1997,47112,44344,2768,5.9
24,47,Worcester,1997,24840,22285,2555,10.3
24,510,Baltimore city,1997,306893,279049,27844,9.1
25,1,Barnstable,1997,105813,99609,6204,5.9
25,3,Berkshire,1997,66816,63550,3266,4.9
25,5,Bristol,1997,269236,252185,17051,6.3
25,7,Dukes,1997,9318,8852,466,5.0
25,9,Essex,1997,367013,351302,15711,4.3
25,11,Franklin,1997,38118,36646,1472,3.9
25,13,Hampden,1997,215288,204946,10342,4.8
25,15,Hampshire,1997,81631,79239,2392,2.9
25,17,Middlesex,1997,820349,795508,24841,3.0
25,19,Nantucket/town,1997,6122,5981,141,2.3
25,21,Norfolk,1997,361854,350457,11397,3.1
25,23,Plymouth,1997,246495,235556,10939,4.4
25,25,Suffolk,1997,344566,329720,14846,4.3
25,27,Worcester,1997,372975,357994,14981,4.0
26,1,Alcona,1997,5096,4681,415,8.1
26,3,Alger,1997,4287,4011,276,6.4
26,5,Allegan,1997,54319,52682,1637,3.0
26,7,Alpena,1997,15958,14725,1233,7.7
26,9,Antrim,1997,10090,9532,558,5.5
26,11,Arenac,1997,6905,6330,575,8.3
26,13,Baraga,1997,4201,3896,305,7.3
26,15,Barry,1997,30823,29780,1043,3.4
26,17,Bay,1997,55239,52656,2583,4.7
26,19,Benzie,1997,7559,7083,476,6.3
26,21,Berrien,1997,82880,78758,4122,5.0
26,23,Branch,1997,21021,20261,760,3.6
26,25,Calhoun,1997,67302,64492,2810,4.2
26,27,Cass,1997,25551,24368,1183,4.6
26,29,Charlevoix,1997,13722,12980,742,5.4
26,31,Cheboygan,1997,12192,10945,1247,10.2
26,33,Chippewa,1997,17893,16472,1421,7.9
26,35,Clare,1997,10322,9513,809,7.8
26,37,Clinton,1997,33666,32785,881,2.6
26,39,Crawford,1997,5594,5221,373,6.7
26,41,Delta,1997,18833,17480,1353,7.2
26,43,Dickinson,1997,14094,13286,808,5.7
26,45,Eaton,1997,55115,53714,1401,2.5
26,47,Emmet,1997,17068,15736,1332,7.8
26,49,Genesee,1997,201807,191045,10762,5.3
26,51,Gladwin,1997,9254,8554,700,7.6
26,53,Gogebic,1997,8202,7450,752,9.2
26,55,Grand Traverse,1997,44621,42857,1764,4.0
26,57,Gratiot,1997,19016,17963,1053,5.5
26,59,Hillsdale,1997,22684,21833,851,3.8
26,61,Houghton,1997,17052,16101,951,5.6
26,63,Huron,1997,17907,17020,887,5.0
26,65,Ingham,1997,153096,148420,4676,3.1
26,67,Ionia,1997,26936,25593,1343,5.0
26,69,Iosco,1997,11642,10726,916,7.9
26,71,Iron,1997,5655,5258,397,7.0
26,73,Isabella,1997,29817,28825,992,3.3
26,75,Jackson,1997,76000,72691,3309,4.4
26,77,Kalamazoo,1997,125954,122060,3894,3.1
26,79,Kalkaska,1997,7634,7146,488,6.4
26,81,Kent,1997,313336,303556,9780,3.1
26,83,Keweenaw,1997,819,738,81,9.9
26,85,Lake,1997,3097,2829,268,8.7
26,87,Lapeer,1997,42632,40566,2066,4.8
26,89,Leelanau,1997,11009,10578,431,3.9
26,91,Lenawee,1997,46331,44594,1737,3.7
26,93,Livingston,1997,75828,73614,2214,2.9
26,95,Luce,1997,2825,2576,249,8.8
26,97,Mackinac,1997,7356,6633,723,9.8
26,99,Macomb,1997,428205,411835,16370,3.8
26,101,Manistee,1997,10292,9477,815,7.9
26,103,Marquette,1997,32030,30162,1868,5.8
26,105,Mason,1997,14060,13054,1006,7.2
26,107,Mecosta,1997,17621,16825,796,4.5
26,109,Menominee,1997,13047,12327,720,5.5
26,111,Midland,1997,42456,41114,1342,3.2
26,113,Missaukee,1997,6262,5867,395,6.3
26,115,Monroe,1997,71285,68691,2594,3.6
26,117,Montcalm,1997,24680,22941,1739,7.0
26,119,Montmorency,1997,3475,3078,397,11.4
26,121,Muskegon,1997,81250,77344,3906,4.8
26,123,Newaygo,1997,20290,18701,1589,7.8
26,125,Oakland,1997,658166,638086,20080,3.1
26,127,Oceana,1997,13901,12833,1068,7.7
26,129,Ogemaw,1997,8603,7924,679,7.9
26,131,Ontonagon,1997,3261,2854,407,12.5
26,133,Osceola,1997,10989,10285,704,6.4
26,135,Oscoda,1997,3420,3134,286,8.4
26,137,Otsego,1997,12898,12328,570,4.4
26,139,Ottawa,1997,131180,127646,3534,2.7
26,141,Presque Isle,1997,6279,5553,726,11.6
26,143,Roscommon,1997,8159,7492,667,8.2
26,145,Saginaw,1997,100734,96272,4462,4.4
26,147,St. Clair,1997,78018,73659,4359,5.6
26,149,St. Joseph,1997,32955,31788,1167,3.5
26,151,Sanilac,1997,20838,19616,1222,5.9
26,153,Schoolcraft,1997,4260,3820,440,10.3
26,155,Shiawassee,1997,35558,33738,1820,5.1
26,157,Tuscola,1997,27646,26238,1408,5.1
26,159,Van Buren,1997,36525,34556,1969,5.4
26,161,Washtenaw,1997,167866,164438,3428,2.0
26,163,Wayne,1997,951091,901922,49169,5.2
26,165,Wexford,1997,14372,13131,1241,8.6
27,1,Aitkin,1997,6199,5681,518,8.4
27,3,Anoka,1997,174351,169835,4516,2.6
27,5,Becker,1997,13685,12685,1000,7.3
27,7,Beltrami,1997,19869,18659,1210,6.1
27,9,Benton,1997,19853,19014,839,4.2
27,11,Big Stone,1997,2871,2763,108,3.8
27,13,Blue Earth,1997,32652,31776,876,2.7
27,15,Brown,1997,15461,14759,702,4.5
27,17,Carlton,1997,15472,14522,950,6.1
27,19,Carver,1997,38023,37252,771,2.0
27,21,Cass,1997,11908,11040,868,7.3
27,23,Chippewa,1997,7202,6891,311,4.3
27,25,Chisago,1997,20508,19695,813,4.0
27,27,Clay,1997,30012,29147,865,2.9
27,29,Clearwater,1997,4100,3570,530,12.9
27,31,Cook,1997,2960,2822,138,4.7
27,33,Cottonwood,1997,6129,5846,283,4.6
27,35,Crow Wing,1997,26927,25369,1558,5.8
27,37,Dakota,1997,206892,202827,4065,2.0
27,39,Dodge,1997,8962,8583,379,4.2
27,41,Douglas,1997,16761,16135,626,3.7
27,43,Faribault,1997,8287,7931,356,4.3
27,45,Fillmore,1997,10073,9696,377,3.7
27,47,Freeborn,1997,16558,15983,575,3.5
27,49,Goodhue,1997,23702,22957,745,3.1
27,51,Grant,1997,2945,2796,149,5.1
27,53,Hennepin,1997,649847,634478,15369,2.4
27,55,Houston,1997,11004,10675,329,3.0
27,57,Hubbard,1997,8360,7815,545,6.5
27,59,Isanti,1997,15458,14831,627,4.1
27,61,Itasca,1997,19909,18212,1697,8.5
27,63,Jackson,1997,6038,5830,208,3.4
27,65,Kanabec,1997,7389,6828,561,7.6
27,67,Kandiyohi,1997,21529,20793,736,3.4
27,69,Kittson,1997,2405,2260,145,6.0
27,71,Koochiching,1997,6769,6296,473,7.0
27,73,Lac qui Parle,1997,3913,3773,140,3.6
27,75,Lake,1997,5844,5547,297,5.1
27,77,Lake of the Woods,1997,2513,2402,111,4.4
27,79,Le Sueur,1997,14099,13533,566,4.0
27,81,Lincoln,1997,3107,2970,137,4.4
27,83,Lyon,1997,15068,14585,483,3.2
27,85,McLeod,1997,21317,20640,677,3.2
27,87,Mahnomen,1997,2422,2190,232,9.6
27,89,Marshall,1997,4823,4290,533,11.1
27,91,Martin,1997,11458,11053,405,3.5
27,93,Meeker,1997,9638,9126,512,5.3
27,95,Mille Lacs,1997,9303,8613,690,7.4
27,97,Morrison,1997,15061,13961,1100,7.3
27,99,Mower,1997,19128,18611,517,2.7
27,101,Murray,1997,4491,4271,220,4.9
27,103,Nicollet,1997,18359,17929,430,2.3
27,105,Nobles,1997,10198,9804,394,3.9
27,107,Norman,1997,3611,3338,273,7.6
27,109,Olmsted,1997,68119,66664,1455,2.1
27,111,Otter Tail,1997,27825,26418,1407,5.1
27,113,Pennington,1997,8091,7651,440,5.4
27,115,Pine,1997,11430,10571,859,7.5
27,117,Pipestone,1997,5181,5009,172,3.3
27,119,Polk,1997,16907,15972,935,5.5
27,121,Pope,1997,5577,5370,207,3.7
27,123,Ramsey,1997,280676,273324,7352,2.6
27,125,Red Lake,1997,2002,1795,207,10.3
27,127,Redwood,1997,9104,8815,289,3.2
27,129,Renville,1997,8310,7941,369,4.4
27,131,Rice,1997,29015,28069,946,3.3
27,133,Rock,1997,5119,4995,124,2.4
27,135,Roseau,1997,9376,8876,500,5.3
27,137,St. Louis,1997,103206,98165,5041,4.9
27,139,Scott,1997,45146,44052,1094,2.4
27,141,Sherburne,1997,31688,30640,1048,3.3
27,143,Sibley,1997,6805,6492,313,4.6
27,145,Stearns,1997,74730,71717,3013,4.0
27,147,Steele,1997,19134,18547,587,3.1
27,149,Stevens,1997,5584,5420,164,2.9
27,151,Swift,1997,5685,5455,230,4.0
27,153,Todd,1997,9861,9185,676,6.9
27,155,Traverse,1997,1860,1777,83,4.5
27,157,Wabasha,1997,12276,11873,403,3.3
27,159,Wadena,1997,6790,6402,388,5.7
27,161,Waseca,1997,9790,9490,300,3.1
27,163,Washington,1997,111755,109455,2300,2.1
27,165,Watonwan,1997,5899,5702,197,3.3
27,167,Wilkin,1997,4008,3908,100,2.5
27,169,Winona,1997,28539,27646,893,3.1
27,171,Wright,1997,46278,44725,1553,3.4
27,173,Yellow Medicine,1997,5373,5126,247,4.6
28,1,Adams,1997,15009,13675,1334,8.9
28,3,Alcorn,1997,15568,14323,1245,8.0
28,5,Amite,1997,5462,5236,226,4.1
28,7,Attala,1997,7578,6858,720,9.5
28,9,Benton,1997,3207,3048,159,5.0
28,11,Bolivar,1997,17070,15421,1649,9.7
28,13,Calhoun,1997,6576,6155,421,6.4
28,15,Carroll,1997,4480,4207,273,6.1
28,17,Chickasaw,1997,8312,7499,813,9.8
28,19,Choctaw,1997,3176,2906,270,8.5
28,21,Claiborne,1997,3236,2919,317,9.8
28,23,Clarke,1997,8667,8125,542,6.3
28,25,Clay,1997,9096,8086,1010,11.1
28,27,Coahoma,1997,12250,10976,1274,10.4
28,29,Copiah,1997,11129,10260,869,7.8
28,31,Covington,1997,8282,7837,445,5.4
28,33,DeSoto,1997,50103,48555,1548,3.1
28,35,Forrest,1997,33941,32774,1167,3.4
28,37,Franklin,1997,3385,3175,210,6.2
28,39,George,1997,8419,7718,701,8.3
28,41,Greene,1997,5587,5146,441,7.9
28,43,Grenada,1997,10252,9538,714,7.0
28,45,Hancock,1997,16779,16028,751,4.5
28,47,Harrison,1997,81843,78116,3727,4.6
28,49,Hinds,1997,128004,122826,5178,4.0
28,51,Holmes,1997,7468,6636,832,11.1
28,53,Humphreys,1997,4970,4437,533,10.7
28,55,Issaquena,1997,692,592,100,14.5
28,57,Itawamba,1997,11267,10593,674,6.0
28,59,Jackson,1997,65744,62322,3422,5.2
28,61,Jasper,1997,7843,7346,497,6.3
28,63,Jefferson,1997,2463,2076,387,15.7
28,65,Jefferson Davis,1997,4823,4414,409,8.5
28,67,Jones,1997,30444,29368,1076,3.5
28,69,Kemper,1997,4315,3971,344,8.0
28,71,Lafayette,1997,16838,16446,392,2.3
28,73,Lamar,1997,17103,16668,435,2.5
28,75,Lauderdale,1997,35293,33483,1810,5.1
28,77,Lawrence,1997,5532,5225,307,5.5
28,79,Leake,1997,9908,9391,517,5.2
28,81,Lee,1997,39469,37618,1851,4.7
28,83,Leflore,1997,15690,14238,1452,9.3
28,85,Lincoln,1997,13410,12667,743,5.5
28,87,Lowndes,1997,27966,25935,2031,7.3
28,89,Madison,1997,35826,34577,1249,3.5
28,91,Marion,1997,10475,9847,628,6.0
28,93,Marshall,1997,14039,13137,902,6.4
28,95,Monroe,1997,15747,14107,1640,10.4
28,97,Montgomery,1997,5521,5138,383,6.9
28,99,Neshoba,1997,16126,15518,608,3.8
28,101,Newton,1997,8544,8174,370,4.3
28,103,Noxubee,1997,4481,4066,415,9.3
28,105,Oktibbeha,1997,20176,19618,558,2.8
28,107,Panola,1997,13136,11615,1521,11.6
28,109,Pearl River,1997,19638,18726,912,4.6
28,111,Perry,1997,4235,3897,338,8.0
28,113,Pike,1997,16342,15485,857,5.2
28,115,Pontotoc,1997,13076,12499,577,4.4
28,117,Prentiss,1997,12227,11388,839,6.9
28,119,Quitman,1997,3386,2953,433,12.8
28,121,Rankin,1997,58403,57012,1391,2.4
28,123,Scott,1997,12447,11601,846,6.8
28,125,Sharkey,1997,2634,2249,385,14.6
28,127,Simpson,1997,10576,10035,541,5.1
28,129,Smith,1997,5968,5730,238,4.0
28,131,Stone,1997,5190,4909,281,5.4
28,133,Sunflower,1997,11051,9537,1514,13.7
28,135,Tallahatchie,1997,5560,4926,634,11.4
28,137,Tate,1997,10599,10040,559,5.3
28,139,Tippah,1997,10177,9604,573,5.6
28,141,Tishomingo,1997,9682,8824,858,8.9
28,143,Tunica,1997,5691,5283,408,7.2
28,145,Union,1997,12153,11645,508,4.2
28,147,Walthall,1997,6182,5785,397,6.4
28,149,Warren,1997,26524,25103,1421,5.4
28,151,Washington,1997,28780,26159,2621,9.1
28,153,Wayne,1997,8932,8265,667,7.5
28,155,Webster,1997,4490,4277,213,4.7
28,157,Wilkinson,1997,3409,3050,359,10.5
28,159,Winston,1997,8000,7219,781,9.8
28,161,Yalobusha,1997,5230,4868,362,6.9
28,163,Yazoo,1997,9539,8708,831,8.7
29,1,Adair,1997,15233,14870,363,2.4
29,3,Andrew,1997,8268,7950,318,3.8
29,5,Atchison,1997,3604,3513,91,2.5
29,7,Audrain,1997,13365,12879,486,3.6
29,9,Barry,1997,15812,14952,860,5.4
29,11,Barton,1997,7301,7057,244,3.3
29,13,Bates,1997,7822,7352,470,6.0
29,15,Benton,1997,6431,6030,401,6.2
29,17,Bollinger,1997,5495,5084,411,7.5
29,19,Boone,1997,85087,83779,1308,1.5
29,21,Buchanan,1997,42625,40317,2308,5.4
29,23,Butler,1997,20139,19059,1080,5.4
29,25,Caldwell,1997,3686,3361,325,8.8
29,27,Callaway,1997,21782,21013,769,3.5
29,29,Camden,1997,17371,16287,1084,6.2
29,31,Cape Girardeau,1997,37893,36360,1533,4.0
29,33,Carroll,1997,5507,5255,252,4.6
29,35,Carter,1997,2819,2634,185,6.6
29,37,Cass,1997,43080,41623,1457,3.4
29,39,Cedar,1997,5771,5457,314,5.4
29,41,Chariton,1997,4209,3944,265,6.3
29,43,Christian,1997,26587,25610,977,3.7
29,45,Clark,1997,3842,3578,264,6.9
29,47,Clay,1997,104050,100929,3121,3.0
29,49,Clinton,1997,9563,9149,414,4.3
29,51,Cole,1997,41046,39983,1063,2.6
29,53,Cooper,1997,8750,8360,390,4.5
29,55,Crawford,1997,10685,9951,734,6.9
29,57,Dade,1997,3589,3420,169,4.7
29,59,Dallas,1997,6676,6341,335,5.0
29,61,Daviess,1997,3951,3736,215,5.4
29,63,DeKalb,1997,4753,4520,233,4.9
29,65,Dent,1997,6865,6487,378,5.5
29,67,Douglas,1997,6354,5553,801,12.6
29,69,Dunklin,1997,14938,13950,988,6.6
29,71,Franklin,1997,47356,45100,2256,4.8
29,73,Gasconade,1997,7762,7379,383,4.9
29,75,Gentry,1997,3780,3678,102,2.7
29,77,Greene,1997,127747,123575,4172,3.3
29,79,Grundy,1997,5132,4942,190,3.7
29,81,Harrison,1997,4608,4441,167,3.6
29,83,Henry,1997,10535,10044,491,4.7
29,85,Hickory,1997,3106,2897,209,6.7
29,87,Holt,1997,2780,2670,110,4.0
29,89,Howard,1997,5086,4889,197,3.9
29,91,Howell,1997,18465,17339,1126,6.1
29,93,Iron,1997,4636,4264,372,8.0
29,95,Jackson,1997,364729,348925,15804,4.3
29,97,Jasper,1997,56814,54713,2101,3.7
29,99,Jefferson,1997,102983,98762,4221,4.1
29,101,Johnson,1997,23859,23256,603,2.5
29,103,Knox,1997,2096,2035,61,2.9
29,105,Laclede,1997,16374,15362,1012,6.2
29,107,Lafayette,1997,16503,15802,701,4.2
29,109,Lawrence,1997,16464,15437,1027,6.2
29,111,Lewis,1997,6155,5950,205,3.3
29,113,Lincoln,1997,17760,16983,777,4.4
29,115,Linn,1997,6894,6320,574,8.3
29,117,Livingston,1997,7951,7697,254,3.2
29,119,McDonald,1997,9324,8874,450,4.8
29,121,Macon,1997,7973,7530,443,5.6
29,123,Madison,1997,4762,4386,376,7.9
29,125,Maries,1997,4465,4279,186,4.2
29,127,Marion,1997,16257,15545,712,4.4
29,129,Mercer,1997,1722,1671,51,3.0
29,131,Miller,1997,12109,11259,850,7.0
29,133,Mississippi,1997,6253,5744,509,8.1
29,135,Moniteau,1997,7622,7345,277,3.6
29,137,Monroe,1997,4484,4259,225,5.0
29,139,Montgomery,1997,6393,5946,447,7.0
29,141,Morgan,1997,8637,8099,538,6.2
29,143,New Madrid,1997,9152,8439,713,7.8
29,145,Newton,1997,28265,27045,1220,4.3
29,147,Nodaway,1997,13202,13006,196,1.5
29,149,Oregon,1997,4566,4296,270,5.9
29,151,Osage,1997,7586,7343,243,3.2
29,153,Ozark,1997,4372,4087,285,6.5
29,155,Pemiscot,1997,9602,8777,825,8.6
29,157,Perry,1997,10663,10282,381,3.6
29,159,Pettis,1997,22398,21331,1067,4.8
29,161,Phelps,1997,20046,19229,817,4.1
29,163,Pike,1997,7572,7149,423,5.6
29,165,Platte,1997,42731,41600,1131,2.6
29,167,Polk,1997,12355,11811,544,4.4
29,169,Pulaski,1997,12410,11701,709,5.7
29,171,Putnam,1997,2025,1939,86,4.2
29,173,Ralls,1997,5429,5189,240,4.4
29,175,Randolph,1997,10795,10162,633,5.9
29,177,Ray,1997,11401,10826,575,5.0
29,179,Reynolds,1997,3433,3258,175,5.1
29,181,Ripley,1997,5489,5141,348,6.3
29,183,St. Charles,1997,152818,148657,4161,2.7
29,185,St. Clair,1997,4007,3759,248,6.2
29,186,Ste. Genevieve,1997,9190,8801,389,4.2
29,187,St. Francois,1997,25254,23583,1671,6.6
29,189,St. Louis,1997,563487,545423,18064,3.2
29,195,Saline,1997,12755,12203,552,4.3
29,197,Schuyler,1997,2621,2504,117,4.5
29,199,Scotland,1997,2283,2206,77,3.4
29,201,Scott,1997,20872,19659,1213,5.8
29,203,Shannon,1997,4221,3881,340,8.1
29,205,Shelby,1997,3785,3639,146,3.9
29,207,Stoddard,1997,14388,13089,1299,9.0
29,209,Stone,1997,13849,12104,1745,12.6
29,211,Sullivan,1997,4198,4058,140,3.3
29,213,Taney,1997,29620,26868,2752,9.3
29,215,Texas,1997,9815,8963,852,8.7
29,217,Vernon,1997,9458,9011,447,4.7
29,219,Warren,1997,12153,11584,569,4.7
29,221,Washington,1997,9846,9002,844,8.6
29,223,Wayne,1997,3598,3189,409,11.4
29,225,Webster,1997,14236,13486,750,5.3
29,227,Worth,1997,936,889,47,5.0
29,229,Wright,1997,7577,6835,742,9.8
29,510,St. Louis city,1997,161839,149496,12343,7.6
30,1,Beaverhead,1997,5020,4809,211,4.2
30,3,Big Horn,1997,5121,4628,493,9.6
30,5,Blaine,1997,2842,2544,298,10.5
30,7,Broadwater,1997,2054,1971,83,4.0
30,9,Carbon,1997,4602,4328,274,6.0
30,11,Carter,1997,916,896,20,2.2
30,13,Cascade,1997,37622,35581,2041,5.4
30,15,Chouteau,1997,2682,2617,65,2.4
30,17,Custer,1997,5954,5673,281,4.7
30,19,Daniels,1997,1263,1240,23,1.8
30,21,Dawson,1997,4760,4603,157,3.3
30,23,Deer Lodge,1997,3757,3510,247,6.6
30,25,Fallon,1997,1669,1612,57,3.4
30,27,Fergus,1997,6187,5811,376,6.1
30,29,Flathead,1997,37392,34564,2828,7.6
30,31,Gallatin,1997,39079,37896,1183,3.0
30,33,Garfield,1997,899,866,33,3.7
30,35,Glacier,1997,5652,4854,798,14.1
30,37,Golden Valley,1997,484,452,32,6.6
30,39,Granite,1997,1144,1059,85,7.4
30,41,Hill,1997,8969,8474,495,5.5
30,43,Jefferson,1997,4893,4670,223,4.6
30,45,Judith Basin,1997,1080,1026,54,5.0
30,47,Lake,1997,10910,10121,789,7.2
30,49,Lewis and Clark,1997,27953,26528,1425,5.1
30,51,Liberty,1997,1057,1029,28,2.6
30,53,Lincoln,1997,7226,6334,892,12.3
30,55,McCone,1997,1169,1127,42,3.6
30,57,Madison,1997,3628,3463,165,4.5
30,59,Meagher,1997,955,900,55,5.8
30,61,Mineral,1997,1673,1514,159,9.5
30,63,Missoula,1997,51063,48833,2230,4.4
30,65,Musselshell,1997,1931,1775,156,8.1
30,67,Park,1997,10396,9854,542,5.2
30,69,Petroleum,1997,298,284,14,4.7
30,71,Phillips,1997,2374,2207,167,7.0
30,73,Pondera,1997,3156,3027,129,4.1
30,75,Powder River,1997,1228,1204,24,2.0
30,77,Powell,1997,2442,2303,139,5.7
30,79,Prairie,1997,657,620,37,5.6
30,81,Ravalli,1997,16432,15361,1071,6.5
30,83,Richland,1997,5481,5187,294,5.4
30,85,Roosevelt,1997,3994,3627,367,9.2
30,87,Rosebud,1997,4623,4213,410,8.9
30,89,Sanders,1997,4069,3623,446,11.0
30,91,Sheridan,1997,2030,1971,59,2.9
30,93,Silver Bow,1997,17330,16437,893,5.2
30,95,Stillwater,1997,4043,3817,226,5.6
30,97,Sweet Grass,1997,1710,1644,66,3.9
30,99,Teton,1997,3070,2978,92,3.0
30,101,Toole,1997,2780,2684,96,3.5
30,103,Treasure,1997,433,416,17,3.9
30,105,Valley,1997,4346,4163,183,4.2
30,107,Wheatland,1997,1350,1288,62,4.6
30,109,Wibaux,1997,564,543,21,3.7
30,111,Yellowstone,1997,68232,65063,3169,4.6
31,1,Adams,1997,15915,15628,287,1.8
31,3,Antelope,1997,3004,2910,94,3.1
31,5,Arthur,1997,213,207,6,2.8
31,7,Banner,1997,436,429,7,1.6
31,9,Blaine,1997,331,324,7,2.1
31,11,Boone,1997,2822,2772,50,1.8
31,13,Box Butte,1997,6390,6079,311,4.9
31,15,Boyd,1997,1142,1113,29,2.5
31,17,Brown,1997,1773,1724,49,2.8
31,19,Buffalo,1997,24294,23710,584,2.4
31,21,Burt,1997,3591,3473,118,3.3
31,23,Butler,1997,4225,4126,99,2.3
31,25,Cass,1997,12637,12315,322,2.5
31,27,Cedar,1997,4810,4712,98,2.0
31,29,Chase,1997,1907,1878,29,1.5
31,31,Cherry,1997,3308,3226,82,2.5
31,33,Cheyenne,1997,5033,4941,92,1.8
31,35,Clay,1997,3500,3428,72,2.1
31,37,Colfax,1997,5015,4923,92,1.8
31,39,Cuming,1997,5153,5063,90,1.7
31,41,Custer,1997,5567,5454,113,2.0
31,43,Dakota,1997,10428,10102,326,3.1
31,45,Dawes,1997,4280,4138,142,3.3
31,47,Dawson,1997,13466,13119,347,2.6
31,49,Deuel,1997,966,944,22,2.3
31,51,Dixon,1997,2553,2487,66,2.6
31,53,Dodge,1997,19540,18999,541,2.8
31,55,Douglas,1997,255911,249268,6643,2.6
31,57,Dundy,1997,1125,1109,16,1.4
31,59,Fillmore,1997,3182,3121,61,1.9
31,61,Franklin,1997,1618,1591,27,1.7
31,63,Frontier,1997,1533,1490,43,2.8
31,65,Furnas,1997,2536,2484,52,2.1
31,67,Gage,1997,12564,12318,246,2.0
31,69,Garden,1997,1092,1075,17,1.6
31,71,Garfield,1997,1031,1005,26,2.5
31,73,Gosper,1997,1361,1342,19,1.4
31,75,Grant,1997,378,372,6,1.6
31,77,Greeley,1997,1497,1454,43,2.9
31,79,Hall,1997,31131,30461,670,2.2
31,81,Hamilton,1997,5437,5357,80,1.5
31,83,Harlan,1997,1807,1771,36,2.0
31,85,Hayes,1997,519,501,18,3.5
31,87,Hitchcock,1997,1601,1558,43,2.7
31,89,Holt,1997,6403,6237,166,2.6
31,91,Hooker,1997,395,383,12,3.0
31,93,Howard,1997,3499,3417,82,2.3
31,95,Jefferson,1997,3980,3912,68,1.7
31,97,Johnson,1997,2031,1917,114,5.6
31,99,Kearney,1997,3598,3542,56,1.6
31,101,Keith,1997,4555,4449,106,2.3
31,103,Keya Paha,1997,453,442,11,2.4
31,105,Kimball,1997,2002,1963,39,1.9
31,107,Knox,1997,4729,4576,153,3.2
31,109,Lancaster,1997,143336,140353,2983,2.1
31,111,Lincoln,1997,18025,17398,627,3.5
31,113,Logan,1997,464,452,12,2.6
31,115,Loup,1997,407,400,7,1.7
31,117,McPherson,1997,322,317,5,1.6
31,119,Madison,1997,20516,20012,504,2.5
31,121,Merrick,1997,4680,4598,82,1.8
31,123,Morrill,1997,2821,2724,97,3.4
31,125,Nance,1997,1768,1730,38,2.1
31,127,Nemaha,1997,3811,3637,174,4.6
31,129,Nuckolls,1997,2345,2304,41,1.7
31,131,Otoe,1997,7890,7653,237,3.0
31,133,Pawnee,1997,1487,1439,48,3.2
31,135,Perkins,1997,1521,1484,37,2.4
31,137,Phelps,1997,5233,5135,98,1.9
31,139,Pierce,1997,4108,4021,87,2.1
31,141,Platte,1997,17895,17504,391,2.2
31,143,Polk,1997,2381,2342,39,1.6
31,145,Red Willow,1997,5993,5855,138,2.3
31,147,Richardson,1997,4578,4387,191,4.2
31,149,Rock,1997,900,877,23,2.6
31,151,Saline,1997,7098,6982,116,1.6
31,153,Sarpy,1997,60005,58885,1120,1.9
31,155,Saunders,1997,10411,10141,270,2.6
31,157,Scotts Bluff,1997,18277,17535,742,4.1
31,159,Seward,1997,9319,9116,203,2.2
31,161,Sheridan,1997,3023,2925,98,3.2
31,163,Sherman,1997,1544,1508,36,2.3
31,165,Sioux,1997,793,782,11,1.4
31,167,Stanton,1997,3401,3326,75,2.2
31,169,Thayer,1997,3207,3150,57,1.8
31,171,Thomas,1997,459,430,29,6.3
31,173,Thurston,1997,2876,2656,220,7.6
31,175,Valley,1997,2576,2525,51,2.0
31,177,Washington,1997,10712,10526,186,1.7
31,179,Wayne,1997,5721,5560,161,2.8
31,181,Webster,1997,1806,1768,38,2.1
31,183,Wheeler,1997,337,332,5,1.5
31,185,York,1997,8970,8868,102,1.1
32,1,Churchill,1997,9747,9179,568,5.8
32,3,Clark,1997,635785,608742,27043,4.3
32,5,Douglas,1997,18167,17104,1063,5.9
32,7,Elko,1997,22603,21555,1048,4.6
32,9,Esmeralda,1997,616,582,34,5.5
32,11,Eureka,1997,982,923,59,6.0
32,13,Humboldt,1997,9390,8987,403,4.3
32,15,Lander,1997,3280,3039,241,7.3
32,17,Lincoln,1997,1219,1118,101,8.3
32,19,Lyon,1997,12549,11644,905,7.2
32,21,Mineral,1997,2650,2482,168,6.3
32,23,Nye,1997,14474,13863,611,4.2
32,27,Pershing,1997,2610,2499,111,4.3
32,29,Storey,1997,1606,1546,60,3.7
32,31,Washoe,1997,182683,175531,7152,3.9
32,33,White Pine,1997,4058,3807,251,6.2
32,510,Carson City,1997,23458,21951,1507,6.4
33,1,Belknap,1997,29443,28517,926,3.1
33,3,Carroll,1997,21399,20665,734,3.4
33,5,Cheshire,1997,37978,36578,1400,3.7
33,7,Coos,1997,16652,15762,890,5.3
33,9,Grafton,1997,42626,41465,1161,2.7
33,11,Hillsborough,1997,200654,194641,6013,3.0
33,13,Merrimack,1997,72501,70510,1991,2.7
33,15,Rockingham,1997,152042,145832,6210,4.1
33,17,Strafford,1997,58193,56199,1994,3.4
33,19,Sullivan,1997,21115,20463,652,3.1
34,1,Atlantic,1997,130619,120627,9992,7.6
34,3,Bergen,1997,449325,429090,20235,4.5
34,5,Burlington,1997,225209,216297,8912,4.0
34,7,Camden,1997,260946,247745,13201,5.1
34,9,Cape May,1997,47551,42226,5325,11.2
34,11,Cumberland,1997,66339,60465,5874,8.9
34,13,Essex,1997,376248,350788,25460,6.8
34,15,Gloucester,1997,130962,124316,6646,5.1
34,17,Hudson,1997,289704,266273,23431,8.1
34,19,Hunterdon,1997,68934,67218,1716,2.5
34,21,Mercer,1997,172557,164391,8166,4.7
34,23,Middlesex,1997,408736,391055,17681,4.3
34,25,Monmouth,1997,312644,298384,14260,4.6
34,27,Morris,1997,261286,252438,8848,3.4
34,29,Ocean,1997,214871,202985,11886,5.5
34,31,Passaic,1997,236985,220348,16637,7.0
34,33,Salem,1997,32651,30738,1913,5.9
34,35,Somerset,1997,166532,161774,4758,2.9
34,37,Sussex,1997,76426,73004,3422,4.5
34,39,Union,1997,268693,253712,14981,5.6
34,41,Warren,1997,51330,48943,2387,4.7
35,1,Bernalillo,1997,287400,274756,12644,4.4
35,3,Catron,1997,1222,1078,144,11.8
35,5,Chaves,1997,25782,23989,1793,7.0
35,6,Cibola,1997,10623,9469,1154,10.9
35,7,Colfax,1997,6373,5888,485,7.6
35,9,Curry,1997,20314,19182,1132,5.6
35,11,De Baca,1997,946,905,41,4.3
35,13,Dona Ana,1997,66937,61085,5852,8.7
35,15,Eddy,1997,23587,22077,1510,6.4
35,17,Grant,1997,13031,12149,882,6.8
35,19,Guadalupe,1997,1921,1690,231,12.0
35,21,Harding,1997,464,434,30,6.5
35,23,Hidalgo,1997,2591,2473,118,4.6
35,25,Lea,1997,24911,23698,1213,4.9
35,27,Lincoln,1997,7247,6787,460,6.3
35,28,Los Alamos,1997,10215,10030,185,1.8
35,29,Luna,1997,11391,8463,2928,25.7
35,31,McKinley,1997,24593,22389,2204,9.0
35,33,Mora,1997,1723,1376,347,20.1
35,35,Otero,1997,20848,19354,1494,7.2
35,37,Quay,1997,4554,4273,281,6.2
35,39,Rio Arriba,1997,18870,16794,2076,11.0
35,41,Roosevelt,1997,7479,7151,328,4.4
35,43,Sandoval,1997,41509,39691,1818,4.4
35,45,San Juan,1997,49666,44695,4971,10.0
35,47,San Miguel,1997,12490,11175,1315,10.5
35,49,Santa Fe,1997,63625,60916,2709,4.3
35,51,Sierra,1997,4297,4137,160,3.7
35,53,Socorro,1997,6445,5993,452,7.0
35,55,Taos,1997,13374,11387,1987,14.9
35,57,Torrance,1997,5950,5544,406,6.8
35,59,Union,1997,1962,1870,92,4.7
35,61,Valencia,1997,28327,27001,1326,4.7
36,1,Albany,1997,159390,154060,5330,3.3
36,3,Allegany,1997,23620,21680,1940,8.2
36,5,Bronx,1997,480009,424461,55548,11.6
36,7,Broome,1997,99763,95504,4259,4.3
36,9,Cattaraugus,1997,42408,39357,3051,7.2
36,11,Cayuga,1997,38580,36308,2272,5.9
36,13,Chautauqua,1997,69574,65631,3943,5.7
36,15,Chemung,1997,45132,43141,1991,4.4
36,17,Chenango,1997,24290,22762,1528,6.3
36,19,Clinton,1997,40377,37656,2721,6.7
36,21,Columbia,1997,33569,32354,1215,3.6
36,23,Cortland,1997,24292,22657,1635,6.7
36,25,Delaware,1997,21410,20279,1131,5.3
36,27,Dutchess,1997,120611,115744,4867,4.0
36,29,Erie,1997,476350,452301,24049,5.0
36,31,Essex,1997,18298,16729,1569,8.6
36,33,Franklin,1997,21742,19837,1905,8.8
36,35,Fulton,1997,27514,25448,2066,7.5
36,37,Genesee,1997,32772,30932,1840,5.6
36,39,Greene,1997,21695,20360,1335,6.2
36,41,Hamilton,1997,2539,2252,287,11.3
36,43,Herkimer,1997,31746,29640,2106,6.6
36,45,Jefferson,1997,45004,40998,4006,8.9
36,47,Kings,1997,993554,887933,105621,10.6
36,49,Lewis,1997,12729,11726,1003,7.9
36,51,Livingston,1997,35262,33431,1831,5.2
36,53,Madison,1997,36043,34194,1849,5.1
36,55,Monroe,1997,389761,375754,14007,3.6
36,57,Montgomery,1997,24230,22454,1776,7.3
36,59,Nassau,1997,692777,668469,24308,3.5
36,61,New York,1997,839623,774472,65151,7.8
36,63,Niagara,1997,112417,105071,7346,6.5
36,65,Oneida,1997,112811,107335,5476,4.9
36,67,Onondaga,1997,238095,228903,9192,3.9
36,69,Ontario,1997,54538,52267,2271,4.2
36,71,Orange,1997,158110,151536,6574,4.2
36,73,Orleans,1997,21497,20154,1343,6.2
36,75,Oswego,1997,58341,54286,4055,7.0
36,77,Otsego,1997,31857,30152,1705,5.4
36,79,Putnam,1997,52047,50458,1589,3.1
36,81,Queens,1997,1011779,926192,85587,8.5
36,83,Rensselaer,1997,81486,77770,3716,4.6
36,85,Richmond,1997,198893,182404,16489,8.3
36,87,Rockland,1997,144170,138356,5814,4.0
36,89,St. Lawrence,1997,51702,47542,4160,8.0
36,91,Saratoga,1997,104258,100182,4076,3.9
36,93,Schenectady,1997,74307,70984,3323,4.5
36,95,Schoharie,1997,15551,14633,918,5.9
36,97,Schuyler,1997,8996,8461,535,5.9
36,99,Seneca,1997,15371,14526,845,5.5
36,101,Steuben,1997,49300,46036,3264,6.6
36,103,Suffolk,1997,716210,685812,30398,4.2
36,105,Sullivan,1997,31806,29748,2058,6.5
36,107,Tioga,1997,26593,25536,1057,4.0
36,109,Tompkins,1997,50329,48746,1583,3.1
36,111,Ulster,1997,81003,77645,3358,4.1
36,113,Warren,1997,32616,30392,2224,6.8
36,115,Washington,1997,29661,27920,1741,5.9
36,117,Wayne,1997,50206,47791,2415,4.8
36,119,Westchester,1997,453046,436116,16930,3.7
36,121,Wyoming,1997,20884,19457,1427,6.8
36,123,Yates,1997,13568,13002,566,4.2
37,1,Alamance,1997,67608,65269,2339,3.5
37,3,Alexander,1997,17457,16913,544,3.1
37,5,Alleghany,1997,5678,5370,308,5.4
37,7,Anson,1997,11521,10807,714,6.2
37,9,Ashe,1997,11635,10457,1178,10.1
37,11,Avery,1997,7890,7547,343,4.3
37,13,Beaufort,1997,21037,19478,1559,7.4
37,15,Bertie,1997,9244,8713,531,5.7
37,17,Bladen,1997,20167,19095,1072,5.3
37,19,Brunswick,1997,32170,30401,1769,5.5
37,21,Buncombe,1997,105318,102271,3047,2.9
37,23,Burke,1997,44547,42809,1738,3.9
37,25,Cabarrus,1997,65024,63073,1951,3.0
37,27,Caldwell,1997,42750,40672,2078,4.9
37,29,Camden,1997,3189,3084,105,3.3
37,31,Carteret,1997,30247,28819,1428,4.7
37,33,Caswell,1997,12822,12348,474,3.7
37,35,Catawba,1997,76537,73977,2560,3.3
37,37,Chatham,1997,26337,25660,677,2.6
37,39,Cherokee,1997,10147,9476,671,6.6
37,41,Chowan,1997,6636,6392,244,3.7
37,43,Clay,1997,3840,3526,314,8.2
37,45,Cleveland,1997,47466,44736,2730,5.8
37,47,Columbus,1997,24574,22990,1584,6.4
37,49,Craven,1997,37561,35908,1653,4.4
37,51,Cumberland,1997,118589,113415,5174,4.4
37,53,Currituck,1997,8892,8629,263,3.0
37,55,Dare,1997,17751,16724,1027,5.8
37,57,Davidson,1997,80596,78175,2421,3.0
37,59,Davie,1997,17460,17017,443,2.5
37,61,Duplin,1997,22664,21605,1059,4.7
37,63,Durham,1997,116143,113253,2890,2.5
37,65,Edgecombe,1997,27176,24069,3107,11.4
37,67,Forsyth,1997,157110,152597,4513,2.9
37,69,Franklin,1997,23208,22370,838,3.6
37,71,Gaston,1997,101186,96944,4242,4.2
37,73,Gates,1997,4626,4492,134,2.9
37,75,Graham,1997,4373,3881,492,11.3
37,77,Granville,1997,23346,22684,662,2.8
37,79,Greene,1997,9042,8757,285,3.2
37,81,Guilford,1997,222978,215927,7051,3.2
37,83,Halifax,1997,23882,21677,2205,9.2
37,85,Harnett,1997,37638,36296,1342,3.6
37,87,Haywood,1997,26040,24844,1196,4.6
37,89,Henderson,1997,36903,36053,850,2.3
37,91,Hertford,1997,10628,10070,558,5.3
37,93,Hoke,1997,11375,10801,574,5.0
37,95,Hyde,1997,3116,2887,229,7.3
37,97,Iredell,1997,61399,59627,1772,2.9
37,99,Jackson,1997,16288,15371,917,5.6
37,101,Johnston,1997,57090,55721,1369,2.4
37,103,Jones,1997,4589,4409,180,3.9
37,105,Lee,1997,26760,25771,989,3.7
37,107,Lenoir,1997,30395,28846,1549,5.1
37,109,Lincoln,1997,31992,30828,1164,3.6
37,111,McDowell,1997,20812,19724,1088,5.2
37,113,Macon,1997,14033,13459,574,4.1
37,115,Madison,1997,9328,8973,355,3.8
37,117,Martin,1997,12430,11199,1231,9.9
37,119,Mecklenburg,1997,360556,350513,10043,2.8
37,121,Mitchell,1997,7531,7084,447,5.9
37,123,Montgomery,1997,12276,11557,719,5.9
37,125,Moore,1997,29934,28816,1118,3.7
37,127,Nash,1997,44730,42020,2710,6.1
37,129,New Hanover,1997,80811,77658,3153,3.9
37,131,Northampton,1997,8613,7953,660,7.7
37,133,Onslow,1997,47754,46112,1642,3.4
37,135,Orange,1997,63503,62518,985,1.6
37,137,Pamlico,1997,5624,5377,247,4.4
37,139,Pasquotank,1997,15272,14546,726,4.8
37,141,Pender,1997,16531,15739,792,4.8
37,143,Perquimans,1997,4798,4576,222,4.6
37,145,Person,1997,18335,17447,888,4.8
37,147,Pitt,1997,66640,63243,3397,5.1
37,149,Polk,1997,7807,7629,178,2.3
37,151,Randolph,1997,71324,69381,1943,2.7
37,153,Richmond,1997,20307,18440,1867,9.2
37,155,Robeson,1997,56735,52148,4587,8.1
37,157,Rockingham,1997,48237,45564,2673,5.5
37,159,Rowan,1997,65460,63408,2052,3.1
37,161,Rutherford,1997,31265,29363,1902,6.1
37,163,Sampson,1997,24421,23101,1320,5.4
37,165,Scotland,1997,18065,16729,1336,7.4
37,167,Stanly,1997,27609,26241,1368,5.0
37,169,Stokes,1997,23235,22720,515,2.2
37,171,Surry,1997,36651,35312,1339,3.7
37,173,Swain,1997,6344,5249,1095,17.3
37,175,Transylvania,1997,11600,11348,252,2.2
37,177,Tyrrell,1997,1828,1666,162,8.9
37,179,Union,1997,58462,57000,1462,2.5
37,181,Vance,1997,19953,18569,1384,6.9
37,183,Wake,1997,338017,332072,5945,1.8
37,185,Warren,1997,7232,6788,444,6.1
37,187,Washington,1997,5968,5595,373,6.3
37,189,Watauga,1997,23229,22709,520,2.2
37,191,Wayne,1997,50094,47949,2145,4.3
37,193,Wilkes,1997,32989,31796,1193,3.6
37,195,Wilson,1997,36697,33687,3010,8.2
37,197,Yadkin,1997,18572,18029,543,2.9
37,199,Yancey,1997,6496,6154,342,5.3
38,1,Adams,1997,1440,1407,33,2.3
38,3,Barnes,1997,6005,5850,155,2.6
38,5,Benson,1997,2751,2550,201,7.3
38,7,Billings,1997,522,508,14,2.7
38,9,Bottineau,1997,3489,3384,105,3.0
38,11,Bowman,1997,1853,1828,25,1.3
38,13,Burke,1997,1067,1043,24,2.2
38,15,Burleigh,1997,40322,39265,1057,2.6
38,17,Cass,1997,72608,71465,1143,1.6
38,19,Cavalier,1997,2561,2475,86,3.4
38,21,Dickey,1997,2787,2743,44,1.6
38,23,Divide,1997,1177,1156,21,1.8
38,25,Dunn,1997,1968,1900,68,3.5
38,27,Eddy,1997,1277,1218,59,4.6
38,29,Emmons,1997,2087,2018,69,3.3
38,31,Foster,1997,2194,2147,47,2.1
38,33,Golden Valley,1997,868,843,25,2.9
38,35,Grand Forks,1997,37537,36331,1206,3.2
38,37,Grant,1997,1512,1476,36,2.4
38,39,Griggs,1997,1651,1622,29,1.8
38,41,Hettinger,1997,1376,1337,39,2.8
38,43,Kidder,1997,1437,1377,60,4.2
38,45,LaMoure,1997,2333,2272,61,2.6
38,47,Logan,1997,1169,1142,27,2.3
38,49,McHenry,1997,2938,2806,132,4.5
38,51,McIntosh,1997,1721,1689,32,1.9
38,53,McKenzie,1997,3243,3143,100,3.1
38,55,McLean,1997,4632,4354,278,6.0
38,57,Mercer,1997,5066,4717,349,6.9
38,59,Morton,1997,13826,13326,500,3.6
38,61,Mountrail,1997,3013,2867,146,4.8
38,63,Nelson,1997,1692,1616,76,4.5
38,65,Oliver,1997,1162,1104,58,5.0
38,67,Pembina,1997,5085,4788,297,5.8
38,69,Pierce,1997,2456,2392,64,2.6
38,71,Ramsey,1997,6713,6524,189,2.8
38,73,Ransom,1997,2841,2786,55,1.9
38,75,Renville,1997,1413,1388,25,1.8
38,77,Richland,1997,9756,9518,238,2.4
38,79,Rolette,1997,5659,5011,648,11.5
38,81,Sargent,1997,2376,2334,42,1.8
38,83,Sheridan,1997,693,676,17,2.5
38,85,Sioux,1997,1622,1511,111,6.8
38,87,Slope,1997,393,387,6,1.5
38,89,Stark,1997,12996,12641,355,2.7
38,91,Steele,1997,1119,1099,20,1.8
38,93,Stutsman,1997,11960,11689,271,2.3
38,95,Towner,1997,1522,1484,38,2.5
38,97,Traill,1997,3990,3853,137,3.4
38,99,Walsh,1997,6373,6099,274,4.3
38,101,Ward,1997,29901,29100,801,2.7
38,103,Wells,1997,2529,2430,99,3.9
38,105,Williams,1997,10331,10042,289,2.8
39,1,Adams,1997,11251,9917,1334,11.9
39,3,Allen,1997,51005,47966,3039,6.0
39,5,Ashland,1997,25765,24399,1366,5.3
39,7,Ashtabula,1997,46948,43878,3070,6.5
39,9,Athens,1997,26613,25161,1452,5.5
39,11,Auglaize,1997,24131,23030,1101,4.6
39,13,Belmont,1997,32069,29555,2514,7.8
39,15,Brown,1997,19315,18172,1143,5.9
39,17,Butler,1997,175705,169219,6486,3.7
39,19,Carroll,1997,13446,12726,720,5.4
39,21,Champaign,1997,19055,18088,967,5.1
39,23,Clark,1997,70507,67003,3504,5.0
39,25,Clermont,1997,92498,88462,4036,4.4
39,27,Clinton,1997,24232,23349,883,3.6
39,29,Columbiana,1997,52864,49594,3270,6.2
39,31,Coshocton,1997,17699,16533,1166,6.6
39,33,Crawford,1997,22333,20925,1408,6.3
39,35,Cuyahoga,1997,685267,659390,25877,3.8
39,37,Darke,1997,29910,28181,1729,5.8
39,39,Defiance,1997,21702,20680,1022,4.7
39,41,Delaware,1997,49027,47591,1436,2.9
39,43,Erie,1997,43337,40967,2370,5.5
39,45,Fairfield,1997,63500,61358,2142,3.4
39,47,Fayette,1997,14727,13952,775,5.3
39,49,Franklin,1997,580802,564067,16735,2.9
39,51,Fulton,1997,22877,21699,1178,5.1
39,53,Gallia,1997,14106,12863,1243,8.8
39,55,Geauga,1997,46945,45763,1182,2.5
39,57,Greene,1997,72964,70220,2744,3.8
39,59,Guernsey,1997,19027,17450,1577,8.3
39,61,Hamilton,1997,438110,421149,16961,3.9
39,63,Hancock,1997,40751,39246,1505,3.7
39,65,Hardin,1997,15261,14432,829,5.4
39,67,Harrison,1997,6826,6277,549,8.0
39,69,Henry,1997,15860,14930,930,5.9
39,71,Highland,1997,19389,18152,1237,6.4
39,73,Hocking,1997,12523,11718,805,6.4
39,75,Holmes,1997,18151,17505,646,3.6
39,77,Huron,1997,30197,27459,2738,9.1
39,79,Jackson,1997,14405,13143,1262,8.8
39,81,Jefferson,1997,31696,27553,4143,13.1
39,83,Knox,1997,26684,25410,1274,4.8
39,85,Lake,1997,124490,120645,3845,3.1
39,87,Lawrence,1997,26679,24849,1830,6.9
39,89,Licking,1997,70604,67674,2930,4.1
39,91,Logan,1997,26886,25706,1180,4.4
39,93,Lorain,1997,141938,135523,6415,4.5
39,95,Lucas,1997,228870,216228,12642,5.5
39,97,Madison,1997,20397,19772,625,3.1
39,99,Mahoning,1997,120223,112331,7892,6.6
39,101,Marion,1997,32610,30690,1920,5.9
39,103,Medina,1997,76793,74492,2301,3.0
39,105,Meigs,1997,8645,7700,945,10.9
39,107,Mercer,1997,19993,18869,1124,5.6
39,109,Miami,1997,51401,49047,2354,4.6
39,111,Monroe,1997,6121,5479,642,10.5
39,113,Montgomery,1997,282698,270575,12123,4.3
39,115,Morgan,1997,4972,4319,653,13.1
39,117,Morrow,1997,13516,12633,883,6.5
39,119,Muskingum,1997,42219,38925,3294,7.8
39,121,Noble,1997,5384,4993,391,7.3
39,123,Ottawa,1997,21029,19464,1565,7.4
39,125,Paulding,1997,10128,9668,460,4.5
39,127,Perry,1997,14501,13320,1181,8.1
39,129,Pickaway,1997,24353,23405,948,3.9
39,131,Pike,1997,11579,10453,1126,9.7
39,133,Portage,1997,82610,79037,3573,4.3
39,135,Preble,1997,21140,20228,912,4.3
39,137,Putnam,1997,20403,19462,941,4.6
39,139,Richland,1997,61957,58095,3862,6.2
39,141,Ross,1997,34621,32466,2155,6.2
39,143,Sandusky,1997,32191,29791,2400,7.5
39,145,Scioto,1997,33798,30262,3536,10.5
39,147,Seneca,1997,29039,27077,1962,6.8
39,149,Shelby,1997,28517,27200,1317,4.6
39,151,Stark,1997,189302,179574,9728,5.1
39,153,Summit,1997,281174,267878,13296,4.7
39,155,Trumbull,1997,113045,106429,6616,5.9
39,157,Tuscarawas,1997,44484,42018,2466,5.5
39,159,Union,1997,17607,16922,685,3.9
39,161,Van Wert,1997,16385,15780,605,3.7
39,163,Vinton,1997,3843,3374,469,12.2
39,165,Warren,1997,73664,71251,2413,3.3
39,167,Washington,1997,32845,30765,2080,6.3
39,169,Wayne,1997,57594,55000,2594,4.5
39,171,Williams,1997,21200,20213,987,4.7
39,173,Wood,1997,65754,63330,2424,3.7
39,175,Wyandot,1997,12323,11594,729,5.9
40,1,Adair,1997,8983,8472,511,5.7
40,3,Alfalfa,1997,2407,2376,31,1.3
40,5,Atoka,1997,4783,4595,188,3.9
40,7,Beaver,1997,2850,2782,68,2.4
40,9,Beckham,1997,9472,9156,316,3.3
40,11,Blaine,1997,4871,4728,143,2.9
40,13,Bryan,1997,14858,14359,499,3.4
40,15,Caddo,1997,12230,11621,609,5.0
40,17,Canadian,1997,44441,43450,991,2.2
40,19,Carter,1997,20933,19801,1132,5.4
40,21,Cherokee,1997,17426,16635,791,4.5
40,23,Choctaw,1997,5626,4939,687,12.2
40,25,Cimarron,1997,1635,1604,31,1.9
40,27,Cleveland,1997,107222,104511,2711,2.5
40,29,Coal,1997,2651,2426,225,8.5
40,31,Comanche,1997,40896,38887,2009,4.9
40,33,Cotton,1997,2348,2218,130,5.5
40,35,Craig,1997,6897,6710,187,2.7
40,37,Creek,1997,32275,31010,1265,3.9
40,39,Custer,1997,12563,12093,470,3.7
40,41,Delaware,1997,16389,15728,661,4.0
40,43,Dewey,1997,2074,2006,68,3.3
40,45,Ellis,1997,1630,1570,60,3.7
40,47,Garfield,1997,28260,27381,879,3.1
40,49,Garvin,1997,11400,10828,572,5.0
40,51,Grady,1997,20401,19553,848,4.2
40,53,Grant,1997,2436,2371,65,2.7
40,55,Greer,1997,2569,2499,70,2.7
40,57,Harmon,1997,1336,1270,66,4.9
40,59,Harper,1997,1680,1629,51,3.0
40,61,Haskell,1997,4701,4236,465,9.9
40,63,Hughes,1997,5104,4750,354,6.9
40,65,Jackson,1997,12364,11838,526,4.3
40,67,Jefferson,1997,3451,3329,122,3.5
40,69,Johnston,1997,4506,4191,315,7.0
40,71,Kay,1997,22338,20839,1499,6.7
40,73,Kingfisher,1997,6983,6790,193,2.8
40,75,Kiowa,1997,4573,4360,213,4.7
40,77,Latimer,1997,4836,4383,453,9.4
40,79,Le Flore,1997,19287,18018,1269,6.6
40,81,Lincoln,1997,14517,13820,697,4.8
40,83,Logan,1997,14326,13893,433,3.0
40,85,Love,1997,3919,3763,156,4.0
40,87,McClain,1997,12619,12264,355,2.8
40,89,McCurtain,1997,14709,13404,1305,8.9
40,91,McIntosh,1997,7407,6901,506,6.8
40,93,Major,1997,4032,3908,124,3.1
40,95,Marshall,1997,5041,4804,237,4.7
40,97,Mayes,1997,14506,13847,659,4.5
40,99,Murray,1997,5738,5349,389,6.8
40,101,Muskogee,1997,30254,28492,1762,5.8
40,103,Noble,1997,5832,5638,194,3.3
40,105,Nowata,1997,4061,3863,198,4.9
40,107,Okfuskee,1997,4543,4312,231,5.1
40,109,Oklahoma,1997,323143,312184,10959,3.4
40,111,Okmulgee,1997,14992,13775,1217,8.1
40,113,Osage,1997,19825,19035,790,4.0
40,115,Ottawa,1997,13414,12486,928,6.9
40,117,Pawnee,1997,6325,5933,392,6.2
40,119,Payne,1997,35030,34396,634,1.8
40,121,Pittsburg,1997,17859,16565,1294,7.2
40,123,Pontotoc,1997,16641,15871,770,4.6
40,125,Pottawatomie,1997,28023,26745,1278,4.6
40,127,Pushmataha,1997,4985,4693,292,5.9
40,129,Roger Mills,1997,1991,1934,57,2.9
40,131,Rogers,1997,33746,32671,1075,3.2
40,133,Seminole,1997,10289,9496,793,7.7
40,135,Sequoyah,1997,17165,15831,1334,7.8
40,137,Stephens,1997,17881,17172,709,4.0
40,139,Texas,1997,13476,13177,299,2.2
40,141,Tillman,1997,3829,3632,197,5.1
40,143,Tulsa,1997,289582,280162,9420,3.3
40,145,Wagoner,1997,27590,26790,800,2.9
40,147,Washington,1997,21077,20302,775,3.7
40,149,Washita,1997,5054,4899,155,3.1
40,151,Woods,1997,4387,4278,109,2.5
40,153,Woodward,1997,9192,8824,368,4.0
41,1,Baker,1997,7589,6855,734,9.7
41,3,Benton,1997,42777,41772,1005,2.3
41,5,Clackamas,1997,192850,185599,7251,3.8
41,7,Clatsop,1997,17799,16667,1132,6.4
41,9,Columbia,1997,22378,21072,1306,5.8
41,11,Coos,1997,27826,25260,2566,9.2
41,13,Crook,1997,7670,6931,739,9.6
41,15,Curry,1997,8460,7707,753,8.9
41,17,Deschutes,1997,55224,51044,4180,7.6
41,19,Douglas,1997,45531,41734,3797,8.3
41,21,Gilliam,1997,1261,1195,66,5.2
41,23,Grant,1997,4250,3703,547,12.9
41,25,Harney,1997,3792,3436,356,9.4
41,27,Hood River,1997,11104,9969,1135,10.2
41,29,Jackson,1997,87498,81177,6321,7.2
41,31,Jefferson,1997,8260,7733,527,6.4
41,33,Josephine,1997,28956,26357,2599,9.0
41,35,Klamath,1997,29408,26661,2747,9.3
41,37,Lake,1997,3787,3362,425,11.2
41,39,Lane,1997,159116,150487,8629,5.4
41,41,Lincoln,1997,21707,19931,1776,8.2
41,43,Linn,1997,52550,48878,3672,7.0
41,45,Malheur,1997,14563,13356,1207,8.3
41,47,Marion,1997,136261,128496,7765,5.7
41,49,Morrow,1997,4264,3900,364,8.5
41,51,Multnomah,1997,366990,349687,17303,4.7
41,53,Polk,1997,29574,28169,1405,4.8
41,55,Sherman,1997,1064,1006,58,5.5
41,57,Tillamook,1997,11230,10532,698,6.2
41,59,Umatilla,1997,33794,31212,2582,7.6
41,61,Union,1997,12562,11618,944,7.5
41,63,Wallowa,1997,3616,3248,368,10.2
41,65,Wasco,1997,11554,10578,976,8.4
41,67,Washington,1997,238306,229605,8701,3.7
41,69,Wheeler,1997,644,572,72,11.2
41,71,Yamhill,1997,41185,39230,1955,4.7
42,1,Adams,1997,43398,41336,2062,4.8
42,3,Allegheny,1997,661149,632425,28724,4.3
42,5,Armstrong,1997,32131,29686,2445,7.6
42,7,Beaver,1997,86936,82569,4367,5.0
42,9,Bedford,1997,25161,23318,1843,7.3
42,11,Berks,1997,187175,179235,7940,4.2
42,13,Blair,1997,63951,60398,3553,5.6
42,15,Bradford,1997,28960,27354,1606,5.5
42,17,Bucks,1997,324301,310917,13384,4.1
42,19,Butler,1997,87553,83356,4197,4.8
42,21,Cambria,1997,69211,63724,5487,7.9
42,23,Cameron,1997,2682,2505,177,6.6
42,25,Carbon,1997,27379,25398,1981,7.2
42,27,Centre,1997,66873,64866,2007,3.0
42,29,Chester,1997,230242,223044,7198,3.1
42,31,Clarion,1997,19144,17900,1244,6.5
42,33,Clearfield,1997,38978,35817,3161,8.1
42,35,Clinton,1997,17514,16187,1327,7.6
42,37,Columbia,1997,33987,31550,2437,7.2
42,39,Crawford,1997,42258,39892,2366,5.6
42,41,Cumberland,1997,122531,119058,3473,2.8
42,43,Dauphin,1997,141584,136681,4903,3.5
42,45,Delaware,1997,281473,268753,12720,4.5
42,47,Elk,1997,18510,17401,1109,6.0
42,49,Erie,1997,142547,134268,8279,5.8
42,51,Fayette,1997,58435,53609,4826,8.3
42,53,Forest,1997,1812,1632,180,9.9
42,55,Franklin,1997,66850,63639,3211,4.8
42,57,Fulton,1997,6989,6440,549,7.9
42,59,Greene,1997,16767,15275,1492,8.9
42,61,Huntingdon,1997,19563,17548,2015,10.3
42,63,Indiana,1997,38231,35174,3057,8.0
42,65,Jefferson,1997,22370,20767,1603,7.2
42,67,Juniata,1997,10351,9543,808,7.8
42,69,Lackawanna,1997,108455,100828,7627,7.0
42,71,Lancaster,1997,245575,238293,7282,3.0
42,73,Lawrence,1997,40953,38371,2582,6.3
42,75,Lebanon,1997,66462,64274,2188,3.3
42,77,Lehigh,1997,156747,149539,7208,4.6
42,79,Luzerne,1997,160452,148912,11540,7.2
42,81,Lycoming,1997,58828,55035,3793,6.4
42,83,McKean,1997,22017,20583,1434,6.5
42,85,Mercer,1997,57542,54529,3013,5.2
42,87,Mifflin,1997,22484,20894,1590,7.1
42,89,Monroe,1997,52050,47981,4069,7.8
42,91,Montgomery,1997,398179,383700,14479,3.6
42,93,Montour,1997,8677,8298,379,4.4
42,95,Northampton,1997,130887,124374,6513,5.0
42,97,Northumberland,1997,43886,40804,3082,7.0
42,99,Perry,1997,24626,23683,943,3.8
42,101,Philadelphia/city,1997,651508,606720,44788,6.9
42,103,Pike,1997,18069,17141,928,5.1
42,105,Potter,1997,8882,8231,651,7.3
42,107,Schuylkill,1997,68953,63710,5243,7.6
42,109,Snyder,1997,18703,17791,912,4.9
42,111,Somerset,1997,38385,35560,2825,7.4
42,113,Sullivan,1997,2715,2527,188,6.9
42,115,Susquehanna,1997,19132,17764,1368,7.2
42,117,Tioga,1997,20234,18897,1337,6.6
42,119,Union,1997,18822,17990,832,4.4
42,121,Venango,1997,26691,24916,1775,6.7
42,123,Warren,1997,21469,20346,1123,5.2
42,125,Washington,1997,96919,91743,5176,5.3
42,127,Wayne,1997,18973,17420,1553,8.2
42,129,Westmoreland,1997,184813,174556,10257,5.5
42,131,Wyoming,1997,15605,14315,1290,8.3
42,133,York,1997,196538,188526,8012,4.1
44,1,Bristol,1997,26793,25633,1160,4.3
44,3,Kent,1997,91458,86685,4773,5.2
44,5,Newport,1997,42594,40394,2200,5.2
44,7,Providence,1997,303887,286301,17586,5.8
44,9,Washington,1997,66695,64130,2565,3.8
45,1,Abbeville,1997,12943,12107,836,6.5
45,3,Aiken,1997,63514,59771,3743,5.9
45,5,Allendale,1997,4937,4610,327,6.6
45,7,Anderson,1997,83858,80758,3100,3.7
45,9,Bamberg,1997,7617,6998,619,8.1
45,11,Barnwell,1997,11199,10328,871,7.8
45,13,Beaufort,1997,48108,46949,1159,2.4
45,15,Berkeley,1997,59802,57362,2440,4.1
45,17,Calhoun,1997,6802,6398,404,5.9
45,19,Charleston,1997,154548,148339,6209,4.0
45,21,Cherokee,1997,25183,24211,972,3.9
45,23,Chester,1997,15586,14175,1411,9.1
45,25,Chesterfield,1997,20529,19047,1482,7.2
45,27,Clarendon,1997,12451,11413,1038,8.3
45,29,Colleton,1997,15734,14966,768,4.9
45,31,Darlington,1997,31440,29197,2243,7.1
45,33,Dillon,1997,14465,13294,1171,8.1
45,35,Dorchester,1997,41332,39726,1606,3.9
45,37,Edgefield,1997,9198,8783,415,4.5
45,39,Fairfield,1997,10887,10063,824,7.6
45,41,Florence,1997,63911,60380,3531,5.5
45,43,Georgetown,1997,25661,23214,2447,9.5
45,45,Greenville,1997,190036,185596,4440,2.3
45,47,Greenwood,1997,34230,32548,1682,4.9
45,49,Hampton,1997,8503,8020,483,5.7
45,51,Horry,1997,98595,94083,4512,4.6
45,53,Jasper,1997,7877,7583,294,3.7
45,55,Kershaw,1997,23798,22545,1253,5.3
45,57,Lancaster,1997,29158,27641,1517,5.2
45,59,Laurens,1997,30044,28888,1156,3.8
45,61,Lee,1997,8121,7349,772,9.5
45,63,Lexington,1997,114726,112182,2544,2.2
45,65,McCormick,1997,4182,3835,347,8.3
45,67,Marion,1997,16203,14673,1530,9.4
45,69,Marlboro,1997,11957,10503,1454,12.2
45,71,Newberry,1997,18755,17916,839,4.5
45,73,Oconee,1997,28858,27617,1241,4.3
45,75,Orangeburg,1997,41766,38478,3288,7.9
45,77,Pickens,1997,55214,53503,1711,3.1
45,79,Richland,1997,156890,152224,4666,3.0
45,81,Saluda,1997,9053,8694,359,4.0
45,83,Spartanburg,1997,131312,126382,4930,3.8
45,85,Sumter,1997,46305,43804,2501,5.4
45,87,Union,1997,15240,14270,970,6.4
45,89,Williamsburg,1997,15005,12652,2353,15.7
45,91,York,1997,84718,81264,3454,4.1
46,3,Aurora,1997,1300,1269,31,2.4
46,5,Beadle,1997,9546,9101,445,4.7
46,7,Bennett,1997,1056,1009,47,4.5
46,9,Bon Homme,1997,3128,3061,67,2.1
46,11,Brookings,1997,15854,15603,251,1.6
46,13,Brown,1997,20963,20512,451,2.2
46,15,Brule,1997,2855,2735,120,4.2
46,17,Buffalo,1997,685,600,85,12.4
46,19,Butte,1997,3785,3593,192,5.1
46,21,Campbell,1997,898,867,31,3.5
46,23,Charles Mix,1997,4537,4385,152,3.4
46,25,Clark,1997,1942,1867,75,3.9
46,27,Clay,1997,6893,6815,78,1.1
46,29,Codington,1997,14744,14273,471,3.2
46,31,Corson,1997,1418,1313,105,7.4
46,33,Custer,1997,3319,3157,162,4.9
46,35,Davison,1997,10288,10025,263,2.6
46,37,Day,1997,3082,2937,145,4.7
46,39,Deuel,1997,2357,2283,74,3.1
46,41,Dewey,1997,2263,2005,258,11.4
46,43,Douglas,1997,1603,1566,37,2.3
46,45,Edmunds,1997,2215,2176,39,1.8
46,47,Fall River,1997,3514,3385,129,3.7
46,49,Faulk,1997,1161,1137,24,2.1
46,51,Grant,1997,4379,4217,162,3.7
46,53,Gregory,1997,2549,2476,73,2.9
46,55,Haakon,1997,1154,1112,42,3.6
46,57,Hamlin,1997,2579,2489,90,3.5
46,59,Hand,1997,2048,1990,58,2.8
46,61,Hanson,1997,1630,1589,41,2.5
46,63,Harding,1997,787,765,22,2.8
46,65,Hughes,1997,9619,9378,241,2.5
46,67,Hutchinson,1997,3815,3719,96,2.5
46,69,Hyde,1997,872,843,29,3.3
46,71,Jackson,1997,1108,1049,59,5.3
46,73,Jerauld,1997,1145,1103,42,3.7
46,75,Jones,1997,792,763,29,3.7
46,77,Kingsbury,1997,2636,2542,94,3.6
46,79,Lake,1997,6070,5933,137,2.3
46,81,Lawrence,1997,11859,11452,407,3.4
46,83,Lincoln,1997,11277,11110,167,1.5
46,85,Lyman,1997,2416,2294,122,5.0
46,87,McCook,1997,2476,2404,72,2.9
46,89,McPherson,1997,1278,1247,31,2.4
46,91,Marshall,1997,2251,2182,69,3.1
46,93,Meade,1997,12241,11866,375,3.1
46,95,Mellette,1997,727,671,56,7.7
46,97,Miner,1997,1266,1223,43,3.4
46,99,Minnehaha,1997,86425,84759,1666,1.9
46,101,Moody,1997,3520,3348,172,4.9
46,102,Oglala Lakota,1997,3260,2882,378,11.6
46,103,Pennington,1997,46084,44721,1363,3.0
46,105,Perkins,1997,1936,1883,53,2.7
46,107,Potter,1997,1462,1411,51,3.5
46,109,Roberts,1997,4771,4520,251,5.3
46,111,Sanborn,1997,1460,1406,54,3.7
46,115,Spink,1997,3512,3414,98,2.8
46,117,Stanley,1997,1843,1789,54,2.9
46,119,Sully,1997,892,866,26,2.9
46,121,Todd,1997,2763,2531,232,8.4
46,123,Tripp,1997,3514,3410,104,3.0
46,125,Turner,1997,4119,4015,104,2.5
46,127,Union,1997,7163,6924,239,3.3
46,129,Walworth,1997,3054,2948,106,3.5
46,135,Yankton,1997,10995,10741,254,2.3
46,137,Ziebach,1997,700,632,68,9.7
47,1,Anderson,1997,36340,34363,1977,5.4
47,3,Bedford,1997,17734,16670,1064,6.0
47,5,Benton,1997,8002,7340,662,8.3
47,7,Bledsoe,1997,4044,3824,220,5.4
47,9,Blount,1997,50442,48287,2155,4.3
47,11,Bradley,1997,43257,40948,2309,5.3
47,13,Campbell,1997,17206,15920,1286,7.5
47,15,Cannon,1997,4896,4546,350,7.1
47,17,Carroll,1997,13720,12553,1167,8.5
47,19,Carter,1997,26705,24793,1912,7.2
47,21,Cheatham,1997,18592,18093,499,2.7
47,23,Chester,1997,8043,7615,428,5.3
47,25,Claiborne,1997,12679,11990,689,5.4
47,27,Clay,1997,3310,2410,900,27.2
47,29,Cocke,1997,16715,15055,1660,9.9
47,31,Coffee,1997,23071,21695,1376,6.0
47,33,Crockett,1997,7253,6707,546,7.5
47,35,Cumberland,1997,20045,18687,1358,6.8
47,37,Davidson,1997,304347,294242,10105,3.3
47,39,Decatur,1997,6053,5537,516,8.5
47,41,DeKalb,1997,8906,8324,582,6.5
47,43,Dickson,1997,20860,19888,972,4.7
47,45,Dyer,1997,19006,17901,1105,5.8
47,47,Fayette,1997,13731,12954,777,5.7
47,49,Fentress,1997,7199,6500,699,9.7
47,51,Franklin,1997,18525,17549,976,5.3
47,53,Gibson,1997,22359,20688,1671,7.5
47,55,Giles,1997,15643,14733,910,5.8
47,57,Grainger,1997,10009,9367,642,6.4
47,59,Greene,1997,35283,32051,3232,9.2
47,61,Grundy,1997,5910,5396,514,8.7
47,63,Hamblen,1997,30162,28443,1719,5.7
47,65,Hamilton,1997,149421,142191,7230,4.8
47,67,Hancock,1997,2668,2499,169,6.3
47,69,Hardeman,1997,9382,8326,1056,11.3
47,71,Hardin,1997,12771,11619,1152,9.0
47,73,Hawkins,1997,23934,22606,1328,5.5
47,75,Haywood,1997,8656,7592,1064,12.3
47,77,Henderson,1997,14180,12955,1225,8.6
47,79,Henry,1997,14851,13778,1073,7.2
47,81,Hickman,1997,8503,8017,486,5.7
47,83,Houston,1997,3048,2548,500,16.4
47,85,Humphreys,1997,8056,7197,859,10.7
47,87,Jackson,1997,4579,4213,366,8.0
47,89,Jefferson,1997,23069,21563,1506,6.5
47,91,Johnson,1997,7394,6699,695,9.4
47,93,Knox,1997,197074,190123,6951,3.5
47,95,Lake,1997,2702,2467,235,8.7
47,97,Lauderdale,1997,10040,9170,870,8.7
47,99,Lawrence,1997,21873,19426,2447,11.2
47,101,Lewis,1997,4682,3887,795,17.0
47,103,Lincoln,1997,14708,13430,1278,8.7
47,105,Loudon,1997,20129,19247,882,4.4
47,107,McMinn,1997,22560,20801,1759,7.8
47,109,McNairy,1997,11929,10987,942,7.9
47,111,Macon,1997,8567,7692,875,10.2
47,113,Madison,1997,48661,46511,2150,4.4
47,115,Marion,1997,12509,11652,857,6.9
47,117,Marshall,1997,12702,12101,601,4.7
47,119,Maury,1997,37005,35081,1924,5.2
47,121,Meigs,1997,4684,4225,459,9.8
47,123,Monroe,1997,17775,16182,1593,9.0
47,125,Montgomery,1997,54158,51744,2414,4.5
47,127,Moore,1997,3015,2907,108,3.6
47,129,Morgan,1997,6727,6187,540,8.0
47,131,Obion,1997,15056,13905,1151,7.6
47,133,Overton,1997,9972,9014,958,9.6
47,135,Perry,1997,3918,3655,263,6.7
47,137,Pickett,1997,2213,2035,178,8.0
47,139,Polk,1997,6996,6470,526,7.5
47,141,Putnam,1997,31127,29346,1781,5.7
47,143,Rhea,1997,11883,10717,1166,9.8
47,145,Roane,1997,27199,25259,1940,7.1
47,147,Robertson,1997,27535,26265,1270,4.6
47,149,Rutherford,1997,90684,87335,3349,3.7
47,151,Scott,1997,8605,7865,740,8.6
47,153,Sequatchie,1997,4801,4473,328,6.8
47,155,Sevier,1997,34727,31883,2844,8.2
47,157,Shelby,1997,440426,420395,20031,4.5
47,159,Smith,1997,9413,8917,496,5.3
47,161,Stewart,1997,3502,3013,489,14.0
47,163,Sullivan,1997,76146,73195,2951,3.9
47,165,Sumner,1997,66953,64478,2475,3.7
47,167,Tipton,1997,21700,20569,1131,5.2
47,169,Trousdale,1997,2038,1846,192,9.4
47,171,Unicoi,1997,8167,7615,552,6.8
47,173,Union,1997,7547,7291,256,3.4
47,175,Van Buren,1997,2456,2221,235,9.6
47,177,Warren,1997,19395,17873,1522,7.8
47,179,Washington,1997,52681,50539,2142,4.1
47,181,Wayne,1997,7868,6860,1008,12.8
47,183,Weakley,1997,17710,16668,1042,5.9
47,185,White,1997,11231,10232,999,8.9
47,187,Williamson,1997,61481,60161,1320,2.1
47,189,Wilson,1997,45162,43444,1718,3.8
48,1,Anderson,1997,20145,18970,1175,5.8
48,3,Andrews,1997,5457,5174,283,5.2
48,5,Angelina,1997,35884,33942,1942,5.4
48,7,Aransas,1997,9417,8798,619,6.6
48,9,Archer,1997,4138,4028,110,2.7
48,11,Armstrong,1997,934,897,37,4.0
48,13,Atascosa,1997,16163,15386,777,4.8
48,15,Austin,1997,11765,11298,467,4.0
48,17,Bailey,1997,3544,3303,241,6.8
48,19,Bandera,1997,6270,6024,246,3.9
48,21,Bastrop,1997,26083,24994,1089,4.2
48,23,Baylor,1997,1788,1684,104,5.8
48,25,Bee,1997,10910,10264,646,5.9
48,27,Bell,1997,92277,87474,4803,5.2
48,29,Bexar,1997,656022,628239,27783,4.2
48,31,Blanco,1997,3610,3517,93,2.6
48,33,Borden,1997,392,385,7,1.8
48,35,Bosque,1997,6463,6156,307,4.8
48,37,Bowie,1997,40160,36769,3391,8.4
48,39,Brazoria,1997,106091,98315,7776,7.3
48,41,Brazos,1997,70966,69445,1521,2.1
48,43,Brewster,1997,4990,4851,139,2.8
48,45,Briscoe,1997,919,892,27,2.9
48,47,Brooks,1997,2885,2517,368,12.8
48,49,Brown,1997,16674,15686,988,5.9
48,51,Burleson,1997,7271,6962,309,4.2
48,53,Burnet,1997,13264,12723,541,4.1
48,55,Caldwell,1997,15439,14786,653,4.2
48,57,Calhoun,1997,9038,8228,810,9.0
48,59,Callahan,1997,5904,5668,236,4.0
48,61,Cameron,1997,126908,110952,15956,12.6
48,63,Camp,1997,5461,5083,378,6.9
48,65,Carson,1997,3337,3184,153,4.6
48,67,Cass,1997,15379,14192,1187,7.7
48,69,Castro,1997,4184,3977,207,4.9
48,71,Chambers,1997,11464,10852,612,5.3
48,73,Cherokee,1997,20492,19545,947,4.6
48,75,Childress,1997,3117,2975,142,4.6
48,77,Clay,1997,5225,5040,185,3.5
48,79,Cochran,1997,1495,1417,78,5.2
48,81,Coke,1997,1540,1492,48,3.1
48,83,Coleman,1997,4034,3691,343,8.5
48,85,Collin,1997,245115,239402,5713,2.3
48,87,Collingsworth,1997,1685,1618,67,4.0
48,89,Colorado,1997,8177,7848,329,4.0
48,91,Comal,1997,36680,35569,1111,3.0
48,93,Comanche,1997,6626,6346,280,4.2
48,95,Concho,1997,1531,1490,41,2.7
48,97,Cooke,1997,16475,15858,617,3.7
48,99,Coryell,1997,22101,21021,1080,4.9
48,101,Cottle,1997,842,775,67,8.0
48,103,Crane,1997,2228,2145,83,3.7
48,105,Crockett,1997,2017,1953,64,3.2
48,107,Crosby,1997,3081,2848,233,7.6
48,109,Culberson,1997,1368,1240,128,9.4
48,111,Dallam,1997,3396,3270,126,3.7
48,113,Dallas,1997,1183076,1133257,49819,4.2
48,115,Dawson,1997,6044,5682,362,6.0
48,117,Deaf Smith,1997,8283,7631,652,7.9
48,119,Delta,1997,2692,2569,123,4.6
48,121,Denton,1997,226009,220839,5170,2.3
48,123,DeWitt,1997,8112,7720,392,4.8
48,125,Dickens,1997,1044,993,51,4.9
48,127,Dimmit,1997,3673,3052,621,16.9
48,129,Donley,1997,1511,1461,50,3.3
48,131,Duval,1997,4777,4343,434,9.1
48,133,Eastland,1997,8642,8218,424,4.9
48,135,Ector,1997,61694,57820,3874,6.3
48,137,Edwards,1997,860,810,50,5.8
48,139,Ellis,1997,52284,50072,2212,4.2
48,141,El Paso,1997,292557,259859,32698,11.2
48,143,Erath,1997,16287,15861,426,2.6
48,145,Falls,1997,7528,7172,356,4.7
48,147,Fannin,1997,12672,12041,631,5.0
48,149,Fayette,1997,10404,10121,283,2.7
48,151,Fisher,1997,1837,1764,73,4.0
48,153,Floyd,1997,3413,3158,255,7.5
48,155,Foard,1997,891,836,55,6.2
48,157,Fort Bend,1997,169597,164315,5282,3.1
48,159,Franklin,1997,4438,4226,212,4.8
48,161,Freestone,1997,7478,7075,403,5.4
48,163,Frio,1997,6315,5766,549,8.7
48,165,Gaines,1997,6768,6487,281,4.2
48,167,Galveston,1997,125597,115346,10251,8.2
48,169,Garza,1997,2143,1985,158,7.4
48,171,Gillespie,1997,10105,9943,162,1.6
48,173,Glasscock,1997,641,627,14,2.2
48,175,Goliad,1997,2482,2367,115,4.6
48,177,Gonzales,1997,7319,6966,353,4.8
48,179,Gray,1997,10693,10235,458,4.3
48,181,Grayson,1997,50299,48002,2297,4.6
48,183,Gregg,1997,59294,54976,4318,7.3
48,185,Grimes,1997,8858,8402,456,5.1
48,187,Guadalupe,1997,40759,39548,1211,3.0
48,189,Hale,1997,17319,16174,1145,6.6
48,191,Hall,1997,1702,1582,120,7.1
48,193,Hamilton,1997,3804,3685,119,3.1
48,195,Hansford,1997,2507,2440,67,2.7
48,197,Hardeman,1997,1978,1872,106,5.4
48,199,Hardin,1997,23075,21421,1654,7.2
48,201,Harris,1997,1714040,1623852,90188,5.3
48,203,Harrison,1997,28147,25801,2346,8.3
48,205,Hartley,1997,2788,2744,44,1.6
48,207,Haskell,1997,2753,2638,115,4.2
48,209,Hays,1997,48007,46452,1555,3.2
48,211,Hemphill,1997,1899,1831,68,3.6
48,213,Henderson,1997,29152,27760,1392,4.8
48,215,Hidalgo,1997,192762,157526,35236,18.3
48,217,Hill,1997,15156,14482,674,4.4
48,219,Hockley,1997,11603,11048,555,4.8
48,221,Hood,1997,16111,15325,786,4.9
48,223,Hopkins,1997,15748,14968,780,5.0
48,225,Houston,1997,8552,8212,340,4.0
48,227,Howard,1997,13885,13323,562,4.0
48,229,Hudspeth,1997,1355,1319,36,2.7
48,231,Hunt,1997,35313,33552,1761,5.0
48,233,Hutchinson,1997,9647,9032,615,6.4
48,235,Irion,1997,750,735,15,2.0
48,237,Jack,1997,3453,3336,117,3.4
48,239,Jackson,1997,8796,8458,338,3.8
48,241,Jasper,1997,15206,13307,1899,12.5
48,243,Jeff Davis,1997,1393,1364,29,2.1
48,245,Jefferson,1997,117168,108358,8810,7.5
48,247,Jim Hogg,1997,2124,1923,201,9.5
48,249,Jim Wells,1997,16679,15358,1321,7.9
48,251,Johnson,1997,57348,55149,2199,3.8
48,253,Jones,1997,10259,9941,318,3.1
48,255,Karnes,1997,6201,5927,274,4.4
48,257,Kaufman,1997,31477,29929,1548,4.9
48,259,Kendall,1997,12219,11892,327,2.7
48,261,Kenedy,1997,226,216,10,4.4
48,263,Kent,1997,419,403,16,3.8
48,265,Kerr,1997,17377,16940,437,2.5
48,267,Kimble,1997,2394,2314,80,3.3
48,269,King,1997,110,104,6,5.5
48,271,Kinney,1997,1090,994,96,8.8
48,273,Kleberg,1997,13074,12218,856,6.5
48,275,Knox,1997,2203,2089,114,5.2
48,277,Lamar,1997,21867,20576,1291,5.9
48,279,Lamb,1997,6600,6155,445,6.7
48,281,Lampasas,1997,7389,7014,375,5.1
48,283,La Salle,1997,2866,2635,231,8.1
48,285,Lavaca,1997,9224,9015,209,2.3
48,287,Lee,1997,7164,6897,267,3.7
48,289,Leon,1997,5543,5153,390,7.0
48,291,Liberty,1997,28350,25880,2470,8.7
48,293,Limestone,1997,9275,8771,504,5.4
48,295,Lipscomb,1997,1615,1578,37,2.3
48,297,Live Oak,1997,4485,4298,187,4.2
48,299,Llano,1997,4931,4755,176,3.6
48,301,Loving,1997,75,67,8,10.7
48,303,Lubbock,1997,123109,118257,4852,3.9
48,305,Lynn,1997,3073,2945,128,4.2
48,307,McCulloch,1997,3809,3598,211,5.5
48,309,McLennan,1997,100618,95957,4661,4.6
48,311,McMullen,1997,253,243,10,4.0
48,313,Madison,1997,4447,4272,175,3.9
48,315,Marion,1997,3962,3502,460,11.6
48,317,Martin,1997,1739,1653,86,4.9
48,319,Mason,1997,1560,1503,57,3.7
48,321,Matagorda,1997,16731,14464,2267,13.5
48,323,Maverick,1997,17632,12736,4896,27.8
48,325,Medina,1997,15310,14651,659,4.3
48,327,Menard,1997,1052,1012,40,3.8
48,329,Midland,1997,62464,60009,2455,3.9
48,331,Milam,1997,9529,8969,560,5.9
48,333,Mills,1997,2286,2223,63,2.8
48,335,Mitchell,1997,3235,3056,179,5.5
48,337,Montague,1997,7639,7318,321,4.2
48,339,Montgomery,1997,129220,124163,5057,3.9
48,341,Moore,1997,9167,8852,315,3.4
48,343,Morris,1997,6258,5747,511,8.2
48,345,Motley,1997,607,584,23,3.8
48,347,Nacogdoches,1997,27011,25663,1348,5.0
48,349,Navarro,1997,21243,20105,1138,5.4
48,351,Newton,1997,6029,5234,795,13.2
48,353,Nolan,1997,7320,6836,484,6.6
48,355,Nueces,1997,148662,137058,11604,7.8
48,357,Ochiltree,1997,4667,4536,131,2.8
48,359,Oldham,1997,1127,1080,47,4.2
48,361,Orange,1997,41680,37535,4145,9.9
48,363,Palo Pinto,1997,12316,11478,838,6.8
48,365,Panola,1997,7979,7224,755,9.5
48,367,Parker,1997,39005,37748,1257,3.2
48,369,Parmer,1997,4473,4311,162,3.6
48,371,Pecos,1997,6733,6314,419,6.2
48,373,Polk,1997,15003,14051,952,6.3
48,375,Potter,1997,54509,51207,3302,6.1
48,377,Presidio,1997,3362,2239,1123,33.4
48,379,Rains,1997,3577,3382,195,5.5
48,381,Randall,1997,56493,55433,1060,1.9
48,383,Reagan,1997,1934,1852,82,4.2
48,385,Real,1997,1245,1171,74,5.9
48,387,Red River,1997,6004,5559,445,7.4
48,389,Reeves,1997,6531,5928,603,9.2
48,391,Refugio,1997,2965,2783,182,6.1
48,393,Roberts,1997,522,507,15,2.9
48,395,Robertson,1997,6327,5934,393,6.2
48,397,Rockwall,1997,20457,19914,543,2.7
48,399,Runnels,1997,5205,5026,179,3.4
48,401,Rusk,1997,20568,19247,1321,6.4
48,403,Sabine,1997,4003,3654,349,8.7
48,405,San Augustine,1997,3375,3131,244,7.2
48,407,San Jacinto,1997,7757,7377,380,4.9
48,409,San Patricio,1997,29797,27411,2386,8.0
48,411,San Saba,1997,2499,2355,144,5.8
48,413,Schleicher,1997,1481,1426,55,3.7
48,415,Scurry,1997,8128,7757,371,4.6
48,417,Shackelford,1997,1412,1353,59,4.2
48,419,Shelby,1997,9483,8793,690,7.3
48,421,Sherman,1997,1406,1372,34,2.4
48,423,Smith,1997,89135,83595,5540,6.2
48,425,Somervell,1997,2055,1863,192,9.3
48,427,Starr,1997,20795,14894,5901,28.4
48,429,Stephens,1997,4323,4157,166,3.8
48,431,Sterling,1997,670,651,19,2.8
48,433,Stonewall,1997,785,749,36,4.6
48,435,Sutton,1997,2149,2082,67,3.1
48,437,Swisher,1997,3689,3520,169,4.6
48,439,Tarrant,1997,738791,711839,26952,3.6
48,441,Taylor,1997,60381,57930,2451,4.1
48,443,Terrell,1997,466,433,33,7.1
48,445,Terry,1997,6302,5944,358,5.7
48,447,Throckmorton,1997,766,742,24,3.1
48,449,Titus,1997,12765,11934,831,6.5
48,451,Tom Green,1997,51942,50085,1857,3.6
48,453,Travis,1997,436486,422336,14150,3.2
48,455,Trinity,1997,4699,4449,250,5.3
48,457,Tyler,1997,6565,5865,700,10.7
48,459,Upshur,1997,16727,15635,1092,6.5
48,461,Upton,1997,1656,1601,55,3.3
48,463,Uvalde,1997,10755,9440,1315,12.2
48,465,Val Verde,1997,17470,15461,2009,11.5
48,467,Van Zandt,1997,19581,18726,855,4.4
48,469,Victoria,1997,43282,41098,2184,5.0
48,471,Walker,1997,23311,22707,604,2.6
48,473,Waller,1997,12234,11597,637,5.2
48,475,Ward,1997,4497,4197,300,6.7
48,477,Washington,1997,14897,14485,412,2.8
48,479,Webb,1997,70565,63151,7414,10.5
48,481,Wharton,1997,19040,17859,1181,6.2
48,483,Wheeler,1997,2830,2750,80,2.8
48,485,Wichita,1997,61691,58878,2813,4.6
48,487,Wilbarger,1997,7111,6853,258,3.6
48,489,Willacy,1997,7436,5781,1655,22.3
48,491,Williamson,1997,127593,124921,2672,2.1
48,493,Wilson,1997,14658,14222,436,3.0
48,495,Winkler,1997,3066,2844,222,7.2
48,497,Wise,1997,21401,20703,698,3.3
48,499,Wood,1997,13546,12733,813,6.0
48,501,Yoakum,1997,3412,3216,196,5.7
48,503,Young,1997,8365,7811,554,6.6
48,505,Zapata,1997,4117,3714,403,9.8
48,507,Zavala,1997,4293,3225,1068,24.9
49,1,Beaver,1997,2553,2431,122,4.8
49,3,Box Elder,1997,18707,17998,709,3.8
49,5,Cache,1997,43164,42053,1111,2.6
49,7,Carbon,1997,9687,9200,487,5.0
49,9,Daggett,1997,409,392,17,4.2
49,11,Davis,1997,115793,112345,3448,3.0
49,13,Duchesne,1997,5922,5532,390,6.6
49,15,Emery,1997,4178,3903,275,6.6
49,17,Garfield,1997,2756,2521,235,8.5
49,19,Grand,1997,5214,4880,334,6.4
49,21,Iron,1997,14231,13757,474,3.3
49,23,Juab,1997,3440,3308,132,3.8
49,25,Kane,1997,2620,2488,132,5.0
49,27,Millard,1997,4755,4572,183,3.8
49,29,Morgan,1997,3614,3475,139,3.8
49,31,Piute,1997,521,495,26,5.0
49,33,Rich,1997,937,907,30,3.2
49,35,Salt Lake,1997,474285,461076,13209,2.8
49,37,San Juan,1997,4893,4468,425,8.7
49,39,Sanpete,1997,8589,8126,463,5.4
49,41,Sevier,1997,8097,7776,321,4.0
49,43,Summit,1997,13389,12928,461,3.4
49,45,Tooele,1997,11768,11240,528,4.5
49,47,Uintah,1997,10640,10041,599,5.6
49,49,Utah,1997,158110,153942,4168,2.6
49,51,Wasatch,1997,5900,5667,233,3.9
49,53,Washington,1997,35423,34247,1176,3.3
49,55,Wayne,1997,1406,1335,71,5.0
49,57,Weber,1997,98942,95074,3868,3.9
50,1,Addison,1997,19245,18484,761,4.0
50,3,Bennington,1997,19849,18994,855,4.3
50,5,Caledonia,1997,15343,14522,821,5.4
50,7,Chittenden,1997,87226,84993,2233,2.6
50,9,Essex,1997,2857,2664,193,6.8
50,11,Franklin,1997,23141,22187,954,4.1
50,13,Grand Isle,1997,3337,3144,193,5.8
50,15,Lamoille,1997,11950,11304,646,5.4
50,17,Orange,1997,15769,15277,492,3.1
50,19,Orleans,1997,12445,11464,981,7.9
50,21,Rutland,1997,33052,31511,1541,4.7
50,23,Washington,1997,31331,29839,1492,4.8
50,25,Windham,1997,23119,22249,870,3.8
50,27,Windsor,1997,31375,30417,958,3.1
51,1,Accomack,1997,14776,13462,1314,8.9
51,3,Albemarle,1997,38548,37931,617,1.6
51,5,Alleghany,1997,8608,8124,484,5.6
51,7,Amelia,1997,4648,4439,209,4.5
51,9,Amherst,1997,14335,13890,445,3.1
51,11,Appomattox,1997,5816,5496,320,5.5
51,13,Arlington,1997,106547,104054,2493,2.3
51,15,Augusta,1997,31739,30829,910,2.9
51,17,Bath,1997,2359,2206,153,6.5
51,19,Bedford,1997,31857,30854,1003,3.1
51,21,Bland,1997,3551,3330,221,6.2
51,23,Botetourt,1997,16232,15755,477,2.9
51,25,Brunswick,1997,6874,6454,420,6.1
51,27,Buchanan,1997,9639,8317,1322,13.7
51,29,Buckingham,1997,6315,5955,360,5.7
51,31,Campbell,1997,26120,25161,959,3.7
51,33,Caroline,1997,10247,9504,743,7.3
51,35,Carroll,1997,13768,13218,550,4.0
51,36,Charles City,1997,3652,3484,168,4.6
51,37,Charlotte,1997,6123,5750,373,6.1
51,41,Chesterfield,1997,135709,132154,3555,2.6
51,43,Clarke,1997,6407,6252,155,2.4
51,45,Craig,1997,2485,2381,104,4.2
51,47,Culpeper,1997,15623,15138,485,3.1
51,49,Cumberland,1997,3915,3733,182,4.6
51,51,Dickenson,1997,5842,4927,915,15.7
51,53,Dinwiddie,1997,11700,11277,423,3.6
51,57,Essex,1997,4418,4116,302,6.8
51,59,Fairfax,1997,514440,503540,10900,2.1
51,61,Fauquier,1997,27189,26569,620,2.3
51,63,Floyd,1997,6542,6303,239,3.7
51,65,Fluvanna,1997,8785,8587,198,2.3
51,67,Franklin,1997,23222,22391,831,3.6
51,69,Frederick,1997,31638,30577,1061,3.4
51,71,Giles,1997,8300,7775,525,6.3
51,73,Gloucester,1997,17497,16991,506,2.9
51,75,Goochland,1997,9106,8893,213,2.3
51,77,Grayson,1997,8159,7737,422,5.2
51,79,Greene,1997,7120,6888,232,3.3
51,81,Greensville,1997,5638,5409,229,4.1
51,83,Halifax,1997,18303,16299,2004,10.9
51,85,Hanover,1997,44161,43150,1011,2.3
51,87,Henrico,1997,138472,135027,3445,2.5
51,89,Henry,1997,28163,27079,1084,3.8
51,91,Highland,1997,1312,1227,85,6.5
51,93,Isle of Wight,1997,14744,14122,622,4.2
51,95,James City,1997,23612,22962,650,2.8
51,97,King and Queen,1997,3116,2977,139,4.5
51,99,King George,1997,8246,7979,267,3.2
51,101,King William,1997,6474,6202,272,4.2
51,103,Lancaster,1997,5203,4559,644,12.4
51,105,Lee,1997,10314,9408,906,8.8
51,107,Loudoun,1997,76348,74917,1431,1.9
51,109,Louisa,1997,9421,8761,660,7.0
51,111,Lunenburg,1997,4890,4444,446,9.1
51,113,Madison,1997,7680,7457,223,2.9
51,115,Mathews,1997,4582,4432,150,3.3
51,117,Mecklenburg,1997,15069,14215,854,5.7
51,119,Middlesex,1997,4782,4642,140,2.9
51,121,Montgomery,1997,37063,36178,885,2.4
51,125,Nelson,1997,7066,6804,262,3.7
51,127,New Kent,1997,6717,6539,178,2.6
51,131,Northampton,1997,5234,4905,329,6.3
51,133,Northumberland,1997,5295,4713,582,11.0
51,135,Nottoway,1997,6298,5874,424,6.7
51,137,Orange,1997,10863,10420,443,4.1
51,139,Page,1997,11687,11040,647,5.5
51,141,Patrick,1997,9051,8732,319,3.5
51,143,Pittsylvania,1997,31681,29992,1689,5.3
51,145,Powhatan,1997,10534,10267,267,2.5
51,147,Prince Edward,1997,8509,7843,666,7.8
51,149,Prince George,1997,12669,12285,384,3.0
51,153,Prince William,1997,132337,129004,3333,2.5
51,155,Pulaski,1997,16896,16037,859,5.1
51,157,Rappahannock,1997,4356,4103,253,5.8
51,159,Richmond,1997,3930,3697,233,5.9
51,161,Roanoke,1997,48193,47118,1075,2.2
51,163,Rockbridge,1997,9936,9628,308,3.1
51,165,Rockingham,1997,36907,36287,620,1.7
51,167,Russell,1997,14183,12797,1386,9.8
51,169,Scott,1997,9645,9003,642,6.7
51,171,Shenandoah,1997,17289,16739,550,3.2
51,173,Smyth,1997,16596,15285,1311,7.9
51,175,Southampton,1997,7697,7392,305,4.0
51,177,Spotsylvania,1997,41078,39975,1103,2.7
51,179,Stafford,1997,43446,42574,872,2.0
51,181,Surry,1997,2658,2437,221,8.3
51,183,Sussex,1997,5591,5297,294,5.3
51,185,Tazewell,1997,20134,18434,1700,8.4
51,187,Warren,1997,14720,14111,609,4.1
51,191,Washington,1997,25508,24050,1458,5.7
51,193,Westmoreland,1997,7516,6962,554,7.4
51,195,Wise,1997,14984,13258,1726,11.5
51,197,Wythe,1997,14940,13971,969,6.5
51,199,York,1997,28309,27587,722,2.6
51,510,Alexandria city,1997,73325,71114,2211,3.0
51,520,Bristol city,1997,8320,7922,398,4.8
51,530,Buena Vista city,1997,3148,3013,135,4.3
51,540,Charlottesville city,1997,18735,18271,464,2.5
51,550,Chesapeake city,1997,102992,99237,3755,3.6
51,570,Colonial Heights city,1997,8803,8476,327,3.7
51,580,Covington city,1997,3495,3204,291,8.3
51,590,Danville city,1997,25399,23644,1755,6.9
51,595,Emporia city,1997,2512,2367,145,5.8
51,600,Fairfax city,1997,11996,11830,166,1.4
51,610,Falls Church city,1997,5823,5629,194,3.3
51,620,Franklin city,1997,3856,3680,176,4.6
51,630,Fredericksburg city,1997,10613,10232,381,3.6
51,640,Galax city,1997,3425,3324,101,2.9
51,650,Hampton city,1997,67183,63950,3233,4.8
51,660,Harrisonburg city,1997,17855,17546,309,1.7
51,670,Hopewell city,1997,10616,10060,556,5.2
51,678,Lexington city,1997,2857,2804,53,1.9
51,680,Lynchburg city,1997,30119,28909,1210,4.0
51,683,Manassas city,1997,19232,18705,527,2.7
51,685,Manassas Park city,1997,4542,4456,86,1.9
51,690,Martinsville city,1997,7103,6746,357,5.0
51,700,Newport News city,1997,82516,78485,4031,4.9
51,710,Norfolk city,1997,86090,80510,5580,6.5
51,720,Norton city,1997,1553,1425,128,8.2
51,730,Petersburg city,1997,16031,14772,1259,7.9
51,735,Poquoson city,1997,6003,5830,173,2.9
51,740,Portsmouth city,1997,45529,42241,3288,7.2
51,750,Radford city,1997,6439,6236,203,3.2
51,760,Richmond city,1997,95771,91284,4487,4.7
51,770,Roanoke city,1997,49737,47753,1984,4.0
51,775,Salem city,1997,13982,13584,398,2.8
51,790,Staunton city,1997,10781,10427,354,3.3
51,800,Suffolk city,1997,29306,27763,1543,5.3
51,810,Virginia Beach city,1997,211557,203651,7906,3.7
51,820,Waynesboro city,1997,8838,8472,366,4.1
51,830,Williamsburg city,1997,5852,5445,407,7.0
51,840,Winchester city,1997,13083,12491,592,4.5
53,1,Adams,1997,8909,8036,873,9.8
53,3,Asotin,1997,12356,11921,435,3.5
53,5,Benton,1997,72265,67627,4638,6.4
53,7,Chelan,1997,35307,32576,2731,7.7
53,9,Clallam,1997,25013,23094,1919,7.7
53,11,Clark,1997,176043,170031,6012,3.4
53,13,Columbia,1997,1479,1315,164,11.1
53,15,Cowlitz,1997,42084,39183,2901,6.9
53,17,Douglas,1997,19458,18245,1213,6.2
53,19,Ferry,1997,2858,2566,292,10.2
53,21,Franklin,1997,22680,20582,2098,9.3
53,23,Garfield,1997,1095,1056,39,3.6
53,25,Grant,1997,36939,33859,3080,8.3
53,27,Grays Harbor,1997,28318,25736,2582,9.1
53,29,Island,1997,28273,27322,951,3.4
53,31,Jefferson,1997,10066,9400,666,6.6
53,33,King,1997,956746,920451,36295,3.8
53,35,Kitsap,1997,94643,89612,5031,5.3
53,37,Kittitas,1997,15450,14544,906,5.9
53,39,Klickitat,1997,9314,8371,943,10.1
53,41,Lewis,1997,32244,29815,2429,7.5
53,43,Lincoln,1997,5014,4786,228,4.5
53,45,Mason,1997,20364,19018,1346,6.6
53,47,Okanogan,1997,23863,21688,2175,9.1
53,49,Pacific,1997,8837,8061,776,8.8
53,51,Pend Oreille,1997,4271,3733,538,12.6
53,53,Pierce,1997,334301,319654,14647,4.4
53,55,San Juan,1997,5848,5535,313,5.4
53,57,Skagit,1997,48750,45380,3370,6.9
53,59,Skamania,1997,4162,3759,403,9.7
53,61,Snohomish,1997,309830,297839,11991,3.9
53,63,Spokane,1997,208962,199601,9361,4.5
53,65,Stevens,1997,17601,16035,1566,8.9
53,67,Thurston,1997,100892,95878,5014,5.0
53,69,Wahkiakum,1997,1875,1767,108,5.8
53,71,Walla Walla,1997,27118,25440,1678,6.2
53,73,Whatcom,1997,80254,75647,4607,5.7
53,75,Whitman,1997,19503,19165,338,1.7
53,77,Yakima,1997,116821,105491,11330,9.7
54,1,Barbour,1997,6141,5445,696,11.3
54,3,Berkeley,1997,32972,31444,1528,4.6
54,5,Boone,1997,8227,7483,744,9.0
54,7,Braxton,1997,5129,4549,580,11.3
54,9,Brooke,1997,11131,10222,909,8.2
54,11,Cabell,1997,42620,40179,2441,5.7
54,13,Calhoun,1997,2493,2050,443,17.8
54,15,Clay,1997,3985,3496,489,12.3
54,17,Doddridge,1997,3233,3028,205,6.3
54,19,Fayette,1997,17915,16236,1679,9.4
54,21,Gilmer,1997,2671,2473,198,7.4
54,23,Grant,1997,4747,4231,516,10.9
54,25,Greenbrier,1997,15170,13911,1259,8.3
54,27,Hampshire,1997,8351,7863,488,5.8
54,29,Hancock,1997,14680,13629,1051,7.2
54,31,Hardy,1997,6840,6564,276,4.0
54,33,Harrison,1997,34179,31676,2503,7.3
54,35,Jackson,1997,12620,11743,877,6.9
54,37,Jefferson,1997,20122,19397,725,3.6
54,39,Kanawha,1997,103343,98209,5134,5.0
54,41,Lewis,1997,7010,6377,633,9.0
54,43,Lincoln,1997,6890,6108,782,11.3
54,45,Logan,1997,13913,12574,1339,9.6
54,47,McDowell,1997,7580,6752,828,10.9
54,49,Marion,1997,24088,21739,2349,9.8
54,51,Marshall,1997,16228,15017,1211,7.5
54,53,Mason,1997,9047,8014,1033,11.4
54,55,Mercer,1997,27875,26330,1545,5.5
54,57,Mineral,1997,11681,11087,594,5.1
54,59,Mingo,1997,9082,7913,1169,12.9
54,61,Monongalia,1997,38000,36217,1783,4.7
54,63,Monroe,1997,5200,4899,301,5.8
54,65,Morgan,1997,5885,5575,310,5.3
54,67,Nicholas,1997,10612,9502,1110,10.5
54,69,Ohio,1997,24798,23377,1421,5.7
54,71,Pendleton,1997,3773,3634,139,3.7
54,73,Pleasants,1997,3275,3008,267,8.2
54,75,Pocahontas,1997,4206,3835,371,8.8
54,77,Preston,1997,12645,11530,1115,8.8
54,79,Putnam,1997,25353,24146,1207,4.8
54,81,Raleigh,1997,33859,31242,2617,7.7
54,83,Randolph,1997,12999,11814,1185,9.1
54,85,Ritchie,1997,4202,3723,479,11.4
54,87,Roane,1997,6303,5582,721,11.4
54,89,Summers,1997,4263,3884,379,8.9
54,91,Taylor,1997,6939,6374,565,8.1
54,93,Tucker,1997,3716,3265,451,12.1
54,95,Tyler,1997,4136,3850,286,6.9
54,97,Upshur,1997,10045,9251,794,7.9
54,99,Wayne,1997,16673,15563,1110,6.7
54,101,Webster,1997,3072,2735,337,11.0
54,103,Wetzel,1997,7384,6710,674,9.1
54,105,Wirt,1997,1928,1646,282,14.6
54,107,Wood,1997,43394,41012,2382,5.5
54,109,Wyoming,1997,8245,7478,767,9.3
55,1,Adams,1997,7774,7392,382,4.9
55,3,Ashland,1997,8286,7746,540,6.5
55,5,Barron,1997,24546,23430,1116,4.5
55,7,Bayfield,1997,7742,7249,493,6.4
55,9,Brown,1997,132553,128554,3999,3.0
55,11,Buffalo,1997,8091,7808,283,3.5
55,13,Burnett,1997,7183,6845,338,4.7
55,15,Calumet,1997,25146,24360,786,3.1
55,17,Chippewa,1997,30607,29377,1230,4.0
55,19,Clark,1997,16725,15697,1028,6.1
55,21,Columbia,1997,27545,26247,1298,4.7
55,23,Crawford,1997,9720,9358,362,3.7
55,25,Dane,1997,260716,256474,4242,1.6
55,27,Dodge,1997,47871,46418,1453,3.0
55,29,Door,1997,15735,14831,904,5.7
55,31,Douglas,1997,22964,21811,1153,5.0
55,33,Dunn,1997,22600,21853,747,3.3
55,35,Eau Claire,1997,52129,50467,1662,3.2
55,37,Florence,1997,1724,1597,127,7.4
55,39,Fond du Lac,1997,55468,53623,1845,3.3
55,41,Forest,1997,4637,4359,278,6.0
55,43,Grant,1997,25411,24079,1332,5.2
55,45,Green,1997,18831,18199,632,3.4
55,47,Green Lake,1997,10728,10195,533,5.0
55,49,Iowa,1997,13524,13046,478,3.5
55,51,Iron,1997,3295,3048,247,7.5
55,53,Jackson,1997,11253,10725,528,4.7
55,55,Jefferson,1997,42311,41088,1223,2.9
55,57,Juneau,1997,11282,10457,825,7.3
55,59,Kenosha,1997,79232,76505,2727,3.4
55,61,Kewaunee,1997,10632,10249,383,3.6
55,63,La Crosse,1997,60810,59101,1709,2.8
55,65,Lafayette,1997,8141,7846,295,3.6
55,67,Langlade,1997,9630,9085,545,5.7
55,69,Lincoln,1997,16043,15202,841,5.2
55,71,Manitowoc,1997,44803,43191,1612,3.6
55,73,Marathon,1997,73353,70762,2591,3.5
55,75,Marinette,1997,20864,19754,1110,5.3
55,77,Marquette,1997,7153,6725,428,6.0
55,78,Menominee,1997,2379,2154,225,9.5
55,79,Milwaukee,1997,486787,466985,19802,4.1
55,81,Monroe,1997,20030,19026,1004,5.0
55,83,Oconto,1997,15376,14523,853,5.5
55,85,Oneida,1997,20500,19554,946,4.6
55,87,Outagamie,1997,101124,98201,2923,2.9
55,89,Ozaukee,1997,48243,47288,955,2.0
55,91,Pepin,1997,3476,3316,160,4.6
55,93,Pierce,1997,20585,19977,608,3.0
55,95,Polk,1997,22404,21515,889,4.0
55,97,Portage,1997,38189,36628,1561,4.1
55,99,Price,1997,7675,7298,377,4.9
55,101,Racine,1997,94018,90120,3898,4.1
55,103,Richland,1997,8916,8592,324,3.6
55,105,Rock,1997,80939,77667,3272,4.0
55,107,Rusk,1997,7160,6620,540,7.5
55,109,St. Croix,1997,32722,31786,936,2.9
55,111,Sauk,1997,33571,32376,1195,3.6
55,113,Sawyer,1997,9311,8706,605,6.5
55,115,Shawano,1997,21211,20279,932,4.4
55,117,Sheboygan,1997,60921,59407,1514,2.5
55,119,Taylor,1997,10749,10201,548,5.1
55,121,Trempealeau,1997,14654,13927,727,5.0
55,123,Vernon,1997,13864,13253,611,4.4
55,125,Vilas,1997,11105,10572,533,4.8
55,127,Walworth,1997,52160,50636,1524,2.9
55,129,Washburn,1997,7842,7360,482,6.1
55,131,Washington,1997,66888,65131,1757,2.6
55,133,Waukesha,1997,210560,205455,5105,2.4
55,135,Waupaca,1997,27016,26081,935,3.5
55,137,Waushara,1997,10667,10064,603,5.7
55,139,Winnebago,1997,97170,94447,2723,2.8
55,141,Wood,1997,40484,38768,1716,4.2
56,1,Albany,1997,16945,16613,332,2.0
56,3,Big Horn,1997,5598,5292,306,5.5
56,5,Campbell,1997,18891,17955,936,5.0
56,7,Carbon,1997,8366,7963,403,4.8
56,9,Converse,1997,6627,6241,386,5.8
56,11,Crook,1997,3006,2870,136,4.5
56,13,Fremont,1997,17569,16189,1380,7.9
56,15,Goshen,1997,6443,6140,303,4.7
56,17,Hot Springs,1997,2430,2329,101,4.2
56,19,Johnson,1997,3754,3592,162,4.3
56,21,Laramie,1997,39265,37843,1422,3.6
56,23,Lincoln,1997,6351,5963,388,6.1
56,25,Natrona,1997,32994,31153,1841,5.6
56,27,Niobrara,1997,1225,1201,24,2.0
56,29,Park,1997,15083,14411,672,4.5
56,31,Platte,1997,4368,4194,174,4.0
56,33,Sheridan,1997,13615,12936,679,5.0
56,35,Sublette,1997,3007,2923,84,2.8
56,37,Sweetwater,1997,20956,19789,1167,5.6
56,39,Teton,1997,10786,10525,261,2.4
56,41,Uinta,1997,10748,10123,625,5.8
56,43,Washakie,1997,4848,4594,254,5.2
56,45,Weston,1997,3276,3104,172,5.3
72,1,Adjuntas Municipio,1997,5979,4893,1086,18.2
72,3,Aguada Municipio,1997,15823,12288,3535,22.3
72,5,Aguadilla Municipio,1997,22395,18430,3965,17.7
72,7,Aguas Buenas Municipio,1997,8920,7833,1087,12.2
72,9,Aibonito Municipio,1997,10672,9261,1411,13.2
72,11,Anasco Municipio,1997,10989,8746,2243,20.4
72,13,Arecibo Municipio,1997,31918,26655,5263,16.5
72,15,Arroyo Municipio,1997,5591,4516,1075,19.2
72,17,Barceloneta Municipio,1997,8160,6773,1387,17.0
72,19,Barranquitas Municipio,1997,7478,6586,892,11.9
72,21,Bayamon Municipio,1997,87369,80137,7232,8.3
72,23,Cabo Rojo Municipio,1997,16487,14197,2290,13.9
72,25,Caguas Municipio,1997,58382,52142,6240,10.7
72,27,Camuy Municipio,1997,9830,8334,1496,15.2
72,29,Canovanas Municipio,1997,16879,14809,2070,12.3
72,31,Carolina Municipio,1997,79851,72570,7281,9.1
72,33,Catano Municipio,1997,9907,8991,916,9.2
72,35,Cayey Municipio,1997,16939,14682,2257,13.3
72,37,Ceiba Municipio,1997,5755,4953,802,13.9
72,39,Ciales Municipio,1997,4399,3261,1138,25.9
72,41,Cidra Municipio,1997,16442,14699,1743,10.6
72,43,Coamo Municipio,1997,9761,8070,1691,17.3
72,45,Comerio Municipio,1997,5604,4887,717,12.8
72,47,Corozal Municipio,1997,10025,9006,1019,10.2
72,49,Culebra Municipio,1997,758,712,46,6.1
72,51,Dorado Municipio,1997,10702,9579,1123,10.5
72,53,Fajardo Municipio,1997,13512,11287,2225,16.5
72,54,Florida Municipio,1997,2899,2273,626,21.6
72,55,Guanica Municipio,1997,6104,4590,1514,24.8
72,57,Guayama Municipio,1997,11936,9570,2366,19.8
72,59,Guayanilla Municipio,1997,7992,6613,1379,17.3
72,61,Guaynabo Municipio,1997,41686,39395,2291,5.5
72,63,Gurabo Municipio,1997,11795,10336,1459,12.4
72,65,Hatillo Municipio,1997,11530,9860,1670,14.5
72,67,Hormigueros Municipio,1997,6834,5799,1035,15.1
72,69,Humacao Municipio,1997,20584,17121,3463,16.8
72,71,Isabela Municipio,1997,14088,11442,2646,18.8
72,73,Jayuya Municipio,1997,4174,3495,679,16.3
72,75,Juana Diaz Municipio,1997,14156,11593,2563,18.1
72,77,Juncos Municipio,1997,12844,11138,1706,13.3
72,79,Lajas Municipio,1997,9895,8452,1443,14.6
72,81,Lares Municipio,1997,9470,7843,1627,17.2
72,83,Las Marias Municipio,1997,3197,2545,652,20.4
72,85,Las Piedras Municipio,1997,10359,8756,1603,15.5
72,87,Loiza Municipio,1997,8518,7349,1169,13.7
72,89,Luquillo Municipio,1997,6664,5410,1254,18.8
72,91,Manati Municipio,1997,13566,11027,2539,18.7
72,93,Maricao Municipio,1997,2404,1897,507,21.1
72,95,Maunabo Municipio,1997,3143,2303,840,26.7
72,97,Mayaguez Municipio,1997,36729,30418,6311,17.2
72,99,Moca Municipio,1997,13306,10672,2634,19.8
72,101,Morovis Municipio,1997,9833,8455,1378,14.0
72,103,Naguabo Municipio,1997,7477,6211,1266,16.9
72,105,Naranjito Municipio,1997,7317,6281,1036,14.2
72,107,Orocovis Municipio,1997,5769,4831,938,16.3
72,109,Patillas Municipio,1997,6340,4957,1383,21.8
72,111,Penuelas Municipio,1997,7979,6321,1658,20.8
72,113,Ponce Municipio,1997,60950,50868,10082,16.5
72,115,Quebradillas Municipio,1997,7799,6652,1147,14.7
72,117,Rincon Municipio,1997,6126,5028,1098,17.9
72,119,Rio Grande Municipio,1997,17734,15157,2577,14.5
72,121,Sabana Grande Municipio,1997,8827,7382,1445,16.4
72,123,Salinas Municipio,1997,8621,6748,1873,21.7
72,125,San German Municipio,1997,13542,11131,2411,17.8
72,127,San Juan Municipio,1997,163482,148997,14485,8.9
72,129,San Lorenzo Municipio,1997,12630,10346,2284,18.1
72,131,San Sebastian Municipio,1997,13509,10126,3383,25.0
72,133,Santa Isabel Municipio,1997,5399,3996,1403,26.0
72,135,Toa Alta Municipio,1997,20737,19117,1620,7.8
72,137,Toa Baja Municipio,1997,35070,31920,3150,9.0
72,139,Trujillo Alto Municipio,1997,29705,27496,2209,7.4
72,141,Utuado Municipio,1997,8706,7277,1429,16.4
72,143,Vega Alta Municipio,1997,11421,10039,1382,12.1
72,145,Vega Baja Municipio,1997,20133,16768,3365,16.7
72,147,Vieques Municipio,1997,2675,2288,387,14.5
72,149,Villalba Municipio,1997,6207,4758,1449,23.3
72,151,Yabucoa Municipio,1997,12897,10085,2812,21.8
72,153,Yauco Municipio,1997,13919,11232,2687,19.3
1,1,Autauga,1998,21681,20988,693,3.2
1,3,Baldwin,1998,69460,67488,1972,2.8
1,5,Barbour,1998,12861,12225,636,4.9
1,7,Bibb,1998,7782,7226,556,7.1
1,9,Blount,1998,23669,22884,785,3.3
1,11,Bullock,1998,4566,4084,482,10.6
1,13,Butler,1998,10060,8939,1121,11.1
1,15,Calhoun,1998,54511,51906,2605,4.8
1,17,Chambers,1998,16915,16194,721,4.3
1,19,Cherokee,1998,10311,9859,452,4.4
1,21,Chilton,1998,18059,17234,825,4.6
1,23,Choctaw,1998,5601,4965,636,11.4
1,25,Clarke,1998,13775,12537,1238,9.0
1,27,Clay,1998,6687,6439,248,3.7
1,29,Cleburne,1998,7277,7002,275,3.8
1,31,Coffee,1998,21901,20999,902,4.1
1,33,Colbert,1998,26230,24103,2127,8.1
1,35,Conecuh,1998,6479,5899,580,9.0
1,37,Coosa,1998,5333,5100,233,4.4
1,39,Covington,1998,17298,16130,1168,6.8
1,41,Crenshaw,1998,5624,5154,470,8.4
1,43,Cullman,1998,38811,37398,1413,3.6
1,45,Dale,1998,20932,20050,882,4.2
1,47,Dallas,1998,19970,17919,2051,10.3
1,49,DeKalb,1998,32189,30776,1413,4.4
1,51,Elmore,1998,29523,28637,886,3.0
1,53,Escambia,1998,16472,15449,1023,6.2
1,55,Etowah,1998,50029,47461,2568,5.1
1,57,Fayette,1998,8301,7685,616,7.4
1,59,Franklin,1998,17105,15796,1309,7.7
1,61,Geneva,1998,11367,10652,715,6.3
1,63,Greene,1998,3272,2821,451,13.8
1,65,Hale,1998,7393,6825,568,7.7
1,67,Henry,1998,6430,6099,331,5.1
1,69,Houston,1998,44511,42980,1531,3.4
1,71,Jackson,1998,25326,23734,1592,6.3
1,73,Jefferson,1998,335371,324331,11040,3.3
1,75,Lamar,1998,7505,6883,622,8.3
1,77,Lauderdale,1998,42035,39081,2954,7.0
1,79,Lawrence,1998,16351,15433,918,5.6
1,81,Lee,1998,48859,47080,1779,3.6
1,83,Limestone,1998,28994,27785,1209,4.2
1,85,Lowndes,1998,4081,3620,461,11.3
1,87,Macon,1998,8014,7362,652,8.1
1,89,Madison,1998,142186,138115,4071,2.9
1,91,Marengo,1998,11112,10271,841,7.6
1,93,Marion,1998,16492,15314,1178,7.1
1,95,Marshall,1998,40273,37763,2510,6.2
1,97,Mobile,1998,198563,189634,8929,4.5
1,99,Monroe,1998,9567,8456,1111,11.6
1,101,Montgomery,1998,110178,106225,3953,3.6
1,103,Morgan,1998,56203,53929,2274,4.0
1,105,Perry,1998,4458,4063,395,8.9
1,107,Pickens,1998,8729,8018,711,8.1
1,109,Pike,1998,13247,12554,693,5.2
1,111,Randolph,1998,9685,9177,508,5.2
1,113,Russell,1998,25473,24444,1029,4.0
1,115,St. Clair,1998,30596,29691,905,3.0
1,117,Shelby,1998,79922,78662,1260,1.6
1,119,Sumter,1998,5670,5115,555,9.8
1,121,Talladega,1998,34951,33011,1940,5.6
1,123,Tallapoosa,1998,20363,19437,926,4.5
1,125,Tuscaloosa,1998,83288,80884,2404,2.9
1,127,Walker,1998,29468,27702,1766,6.0
1,129,Washington,1998,6254,5438,816,13.0
1,131,Wilcox,1998,3787,3272,515,13.6
1,133,Winston,1998,12704,11958,746,5.9
2,13,Aleutians East Borough,1998,1568,1517,51,3.3
2,16,Aleutians West Census Area,1998,2033,1892,141,6.9
2,20,Anchorage Borough/municipality,1998,140544,134234,6310,4.5
2,50,Bethel Census Area,1998,6167,5661,506,8.2
2,60,Bristol Bay Borough,1998,506,463,43,8.5
2,68,Denali Borough,1998,1178,1076,102,8.7
2,70,Dillingham Census Area,1998,1759,1634,125,7.1
2,90,Fairbanks North Star Borough,1998,43381,40723,2658,6.1
2,100,Haines Borough,1998,1229,1105,124,10.1
2,110,Juneau Borough/city,1998,16921,15959,962,5.7
2,122,Kenai Peninsula Borough,1998,21626,19331,2295,10.6
2,130,Ketchikan Gateway Borough,1998,7564,6987,577,7.6
2,150,Kodiak Island Borough,1998,6953,6402,551,7.9
2,158,Kusilvak Census Area,1998,2137,1835,302,14.1
2,164,Lake and Peninsula Borough,1998,604,556,48,7.9
2,170,Matanuska-Susitna Borough,1998,28884,26703,2181,7.6
2,180,Nome Census Area,1998,3408,3070,338,9.9
2,185,North Slope Borough,1998,3288,3098,190,5.8
2,188,Northwest Arctic Borough,1998,2205,1947,258,11.7
2,201,Prince of Wales-Outer Ketchikan Census Area,1998,3224,2799,425,13.2
2,220,Sitka Borough/city,1998,4318,4073,245,5.7
2,232,Skagway-Hoonah-Angoon Census Area,1998,2161,1976,185,8.6
2,240,Southeast Fairbanks Census Area,1998,2611,2353,258,9.9
2,261,Valdez-Cordova Census Area,1998,5102,4642,460,9.0
2,280,Wrangell-Petersburg Census Area,1998,3504,3172,332,9.5
2,282,Yakutat Borough/city,1998,323,279,44,13.6
2,290,Yukon-Koyukuk Census Area,1998,2118,1838,280,13.2
4,1,Apache,1998,22417,18837,3580,16.0
4,3,Cochise,1998,41016,38139,2877,7.0
4,5,Coconino,1998,60352,55763,4589,7.6
4,7,Gila,1998,19634,18138,1496,7.6
4,9,Graham,1998,10865,9909,956,8.8
4,11,Greenlee,1998,4710,4316,394,8.4
4,12,La Paz,1998,7131,6519,612,8.6
4,13,Maricopa,1998,1524864,1482962,41902,2.7
4,15,Mohave,1998,62541,59744,2797,4.5
4,17,Navajo,1998,33122,28457,4665,14.1
4,19,Pima,1998,390744,379664,11080,2.8
4,21,Pinal,1998,59796,57214,2582,4.3
4,23,Santa Cruz,1998,14278,11666,2612,18.3
4,25,Yavapai,1998,69810,67408,2402,3.4
4,27,Yuma,1998,67909,48512,19397,28.6
5,1,Arkansas,1998,10591,9994,597,5.6
5,3,Ashley,1998,11308,10339,969,8.6
5,5,Baxter,1998,14315,13711,604,4.2
5,7,Benton,1998,65779,63987,1792,2.7
5,9,Boone,1998,14890,13863,1027,6.9
5,11,Bradley,1998,4757,4234,523,11.0
5,13,Calhoun,1998,2367,2132,235,9.9
5,15,Carroll,1998,11788,11191,597,5.1
5,17,Chicot,1998,6398,5843,555,8.7
5,19,Clark,1998,11807,11424,383,3.2
5,21,Clay,1998,8182,7669,513,6.3
5,23,Cleburne,1998,9529,9139,390,4.1
5,25,Cleveland,1998,3706,3480,226,6.1
5,27,Columbia,1998,11527,10711,816,7.1
5,29,Conway,1998,9922,9448,474,4.8
5,31,Craighead,1998,42263,40731,1532,3.6
5,33,Crawford,1998,24321,23313,1008,4.1
5,35,Crittenden,1998,22803,21745,1058,4.6
5,37,Cross,1998,8315,7725,590,7.1
5,39,Dallas,1998,3708,3437,271,7.3
5,41,Desha,1998,7231,6562,669,9.3
5,43,Drew,1998,9919,9059,860,8.7
5,45,Faulkner,1998,42480,40740,1740,4.1
5,47,Franklin,1998,7821,7525,296,3.8
5,49,Fulton,1998,4287,4090,197,4.6
5,51,Garland,1998,36162,34479,1683,4.7
5,53,Grant,1998,7716,7389,327,4.2
5,55,Greene,1998,18485,17526,959,5.2
5,57,Hempstead,1998,11571,10749,822,7.1
5,59,Hot Spring,1998,12337,11656,681,5.5
5,61,Howard,1998,7027,6639,388,5.5
5,63,Independence,1998,16910,16066,844,5.0
5,65,Izard,1998,4229,3953,276,6.5
5,67,Jackson,1998,8142,7332,810,9.9
5,69,Jefferson,1998,37144,34101,3043,8.2
5,71,Johnson,1998,10738,10347,391,3.6
5,73,Lafayette,1998,3484,3224,260,7.5
5,75,Lawrence,1998,7690,7095,595,7.7
5,77,Lee,1998,4428,4023,405,9.1
5,79,Lincoln,1998,5361,4994,367,6.8
5,81,Little River,1998,5526,5161,365,6.6
5,83,Logan,1998,10109,9526,583,5.8
5,85,Lonoke,1998,25723,24882,841,3.3
5,87,Madison,1998,6579,6319,260,4.0
5,89,Marion,1998,6228,5988,240,3.9
5,91,Miller,1998,17153,16352,801,4.7
5,93,Mississippi,1998,26985,24020,2965,11.0
5,95,Monroe,1998,4120,3802,318,7.7
5,97,Montgomery,1998,3991,3834,157,3.9
5,99,Nevada,1998,4998,4633,365,7.3
5,101,Newton,1998,2974,2751,223,7.5
5,103,Ouachita,1998,12006,10800,1206,10.0
5,105,Perry,1998,3555,3303,252,7.1
5,107,Phillips,1998,9963,9095,868,8.7
5,109,Pike,1998,5022,4786,236,4.7
5,111,Poinsett,1998,10693,9887,806,7.5
5,113,Polk,1998,9213,8873,340,3.7
5,115,Pope,1998,27097,25842,1255,4.6
5,117,Prairie,1998,3830,3550,280,7.3
5,119,Pulaski,1998,194173,186746,7427,3.8
5,121,Randolph,1998,7887,7118,769,9.8
5,123,St. Francis,1998,13028,11860,1168,9.0
5,125,Saline,1998,41530,40374,1156,2.8
5,127,Scott,1998,4937,4778,159,3.2
5,129,Searcy,1998,2963,2721,242,8.2
5,131,Sebastian,1998,55764,53535,2229,4.0
5,133,Sevier,1998,7041,6672,369,5.2
5,135,Sharp,1998,6156,5807,349,5.7
5,137,Stone,1998,5013,4762,251,5.0
5,139,Union,1998,21098,19733,1365,6.5
5,141,Van Buren,1998,6242,5757,485,7.8
5,143,Washington,1998,77020,74610,2410,3.1
5,145,White,1998,31256,29676,1580,5.1
5,147,Woodruff,1998,4125,3681,444,10.8
5,149,Yell,1998,9472,9064,408,4.3
6,1,Alameda,1998,704133,674916,29217,4.1
6,3,Alpine,1998,484,437,47,9.7
6,5,Amador,1998,13322,12591,731,5.5
6,7,Butte,1998,85156,78043,7113,8.4
6,9,Calaveras,1998,14141,12891,1250,8.8
6,11,Colusa,1998,8842,7063,1779,20.1
6,13,Contra Costa,1998,477441,460117,17324,3.6
6,15,Del Norte,1998,9968,8938,1030,10.3
6,17,El Dorado,1998,77004,73170,3834,5.0
6,19,Fresno,1998,376500,322777,53723,14.3
6,21,Glenn,1998,10504,9093,1411,13.4
6,23,Humboldt,1998,60725,56324,4401,7.2
6,25,Imperial,1998,55969,41406,14563,26.0
6,27,Inyo,1998,7268,6739,529,7.3
6,29,Kern,1998,278962,245052,33910,12.2
6,31,Kings,1998,43259,37251,6008,13.9
6,33,Lake,1998,23170,20935,2235,9.6
6,35,Lassen,1998,11303,10237,1066,9.4
6,37,Los Angeles,1998,4545220,4248522,296698,6.5
6,39,Madera,1998,52437,45731,6706,12.8
6,41,Marin,1998,132938,129814,3124,2.3
6,43,Mariposa,1998,6899,6366,533,7.7
6,45,Mendocino,1998,42389,39040,3349,7.9
6,47,Merced,1998,85228,72311,12917,15.2
6,49,Modoc,1998,3972,3526,446,11.2
6,51,Mono,1998,6130,5625,505,8.2
6,53,Monterey,1998,184345,164512,19833,10.8
6,55,Napa,1998,60575,58132,2443,4.0
6,57,Nevada,1998,42724,40399,2325,5.4
6,59,Orange,1998,1427584,1386214,41370,2.9
6,61,Placer,1998,113410,108757,4653,4.1
6,63,Plumas,1998,9690,8690,1000,10.3
6,65,Riverside,1998,660337,616284,44053,6.7
6,67,Sacramento,1998,565771,537405,28366,5.0
6,69,San Benito,1998,26156,23386,2770,10.6
6,71,San Bernardino,1998,721349,680525,40824,5.7
6,73,San Diego,1998,1314183,1267786,46397,3.5
6,75,San Francisco/city,1998,414958,399683,15275,3.7
6,77,San Joaquin,1998,247454,221196,26258,10.6
6,79,San Luis Obispo,1998,108281,103749,4532,4.2
6,81,San Mateo,1998,392003,382371,9632,2.5
6,83,Santa Barbara,1998,194901,186256,8645,4.4
6,85,Santa Clara,1998,953862,922913,30949,3.2
6,87,Santa Cruz,1998,140559,130235,10324,7.3
6,89,Shasta,1998,72200,65653,6547,9.1
6,91,Sierra,1998,1636,1443,193,11.8
6,93,Siskiyou,1998,18347,16033,2314,12.6
6,95,Solano,1998,182326,172183,10143,5.6
6,97,Sonoma,1998,245751,237559,8192,3.3
6,99,Stanislaus,1998,201595,176857,24738,12.3
6,101,Sutter,1998,35441,29907,5534,15.6
6,103,Tehama,1998,23974,21879,2095,8.7
6,105,Trinity,1998,4996,4328,668,13.4
6,107,Tulare,1998,162821,137266,25555,15.7
6,109,Tuolumne,1998,19558,17995,1563,8.0
6,111,Ventura,1998,386328,364771,21557,5.6
6,113,Yolo,1998,86879,82147,4732,5.4
6,115,Yuba,1998,20713,17897,2816,13.6
8,1,Adams,1998,180396,174198,6198,3.4
8,3,Alamosa,1998,8585,8020,565,6.6
8,5,Arapahoe,1998,288616,281228,7388,2.6
8,7,Archuleta,1998,4474,4241,233,5.2
8,9,Baca,1998,2449,2399,50,2.0
8,11,Bent,1998,2359,2270,89,3.8
8,13,Boulder,1998,164525,159274,5251,3.2
8,14,Broomfield/city,1998,18698,18262,436,2.3
8,15,Chaffee,1998,7906,7576,330,4.2
8,17,Cheyenne,1998,1419,1367,52,3.7
8,19,Clear Creek,1998,5478,5321,157,2.9
8,21,Conejos,1998,3884,3528,356,9.2
8,23,Costilla,1998,1503,1278,225,15.0
8,25,Crowley,1998,1357,1299,58,4.3
8,27,Custer,1998,1887,1808,79,4.2
8,29,Delta,1998,11235,10651,584,5.2
8,31,Denver/city,1998,286209,275012,11197,3.9
8,33,Dolores,1998,677,604,73,10.8
8,35,Douglas,1998,86617,85226,1391,1.6
8,37,Eagle,1998,21091,20462,629,3.0
8,39,Elbert,1998,11139,10769,370,3.3
8,41,El Paso,1998,260701,249706,10995,4.2
8,43,Fremont,1998,17978,17179,799,4.4
8,45,Garfield,1998,22831,21958,873,3.8
8,47,Gilpin,1998,3220,3109,111,3.4
8,49,Grand,1998,6119,5953,166,2.7
8,51,Gunnison,1998,8399,7927,472,5.6
8,53,Hinsdale,1998,639,628,11,1.7
8,55,Huerfano,1998,4131,3866,265,6.4
8,57,Jackson,1998,947,893,54,5.7
8,59,Jefferson,1998,311163,302997,8166,2.6
8,61,Kiowa,1998,898,877,21,2.3
8,63,Kit Carson,1998,3751,3664,87,2.3
8,65,Lake,1998,3302,3117,185,5.6
8,67,La Plata,1998,25137,23915,1222,4.9
8,69,Larimer,1998,144254,139053,5201,3.6
8,71,Las Animas,1998,7010,6592,418,6.0
8,73,Lincoln,1998,2666,2621,45,1.7
8,75,Logan,1998,10221,9654,567,5.5
8,77,Mesa,1998,59960,57140,2820,4.7
8,79,Mineral,1998,450,431,19,4.2
8,81,Moffat,1998,6579,6197,382,5.8
8,83,Montezuma,1998,12056,11274,782,6.5
8,85,Montrose,1998,15975,14972,1003,6.3
8,87,Morgan,1998,13572,13032,540,4.0
8,89,Otero,1998,9242,8732,510,5.5
8,91,Ouray,1998,1838,1744,94,5.1
8,93,Park,1998,8170,7878,292,3.6
8,95,Phillips,1998,2107,2057,50,2.4
8,97,Pitkin,1998,9567,9171,396,4.1
8,99,Prowers,1998,7262,6995,267,3.7
8,101,Pueblo,1998,63894,59293,4601,7.2
8,103,Rio Blanco,1998,3220,3085,135,4.2
8,105,Rio Grande,1998,5446,4985,461,8.5
8,107,Routt,1998,11447,11056,391,3.4
8,109,Saguache,1998,2961,2675,286,9.7
8,111,San Juan,1998,309,263,46,14.9
8,113,San Miguel,1998,4502,4275,227,5.0
8,115,Sedgwick,1998,1296,1248,48,3.7
8,117,Summit,1998,12857,12538,319,2.5
8,119,Teller,1998,14199,13595,604,4.3
8,121,Washington,1998,2513,2438,75,3.0
8,123,Weld,1998,87055,83341,3714,4.3
8,125,Yuma,1998,4630,4521,109,2.4
9,1,Fairfield,1998,454297,441514,12783,2.8
9,3,Hartford,1998,422043,407342,14701,3.5
9,5,Litchfield,1998,101892,99208,2684,2.6
9,7,Middlesex,1998,82911,80442,2469,3.0
9,9,New Haven,1998,419600,405048,14552,3.5
9,11,New London,1998,132910,127946,4964,3.7
9,13,Tolland,1998,70439,68654,1785,2.5
9,15,Windham,1998,56188,53718,2470,4.4
10,1,Kent,1998,69218,66506,2712,3.9
10,3,New Castle,1998,256142,247466,8676,3.4
10,5,Sussex,1998,70683,68159,2524,3.6
11,1,District of Colu,1998,293324,268937,24387,8.3
12,1,Alachua,1998,107839,104923,2916,2.7
12,3,Baker,1998,8952,8591,361,4.0
12,5,Bay,1998,68727,63845,4882,7.1
12,7,Bradford,1998,9953,9486,467,4.7
12,9,Brevard,1998,213140,203387,9753,4.6
12,11,Broward,1998,791744,753476,38268,4.8
12,13,Calhoun,1998,5326,5011,315,5.9
12,15,Charlotte,1998,47874,46081,1793,3.7
12,17,Citrus,1998,36931,34622,2309,6.3
12,19,Clay,1998,71619,69547,2072,2.9
12,21,Collier,1998,96041,91762,4279,4.5
12,23,Columbia,1998,25625,24385,1240,4.8
12,27,DeSoto,1998,9379,8662,717,7.6
12,29,Dixie,1998,3929,3656,273,6.9
12,31,Duval,1998,392020,378393,13627,3.5
12,33,Escambia,1998,125308,120117,5191,4.1
12,35,Flagler,1998,17609,17038,571,3.2
12,37,Franklin,1998,4744,4484,260,5.5
12,39,Gadsden,1998,20319,19352,967,4.8
12,41,Gilchrist,1998,4761,4560,201,4.2
12,43,Glades,1998,3968,3602,366,9.2
12,45,Gulf,1998,5483,4796,687,12.5
12,47,Hamilton,1998,3571,3271,300,8.4
12,49,Hardee,1998,9873,8629,1244,12.6
12,51,Hendry,1998,16318,14114,2204,13.5
12,53,Hernando,1998,48439,46434,2005,4.1
12,55,Highlands,1998,28403,25949,2454,8.6
12,57,Hillsborough,1998,554026,537611,16415,3.0
12,59,Holmes,1998,6868,6391,477,6.9
12,61,Indian River,1998,47567,43569,3998,8.4
12,63,Jackson,1998,18950,17884,1066,5.6
12,65,Jefferson,1998,5184,4954,230,4.4
12,67,Lafayette,1998,2890,2807,83,2.9
12,69,Lake,1998,90954,87834,3120,3.4
12,71,Lee,1998,182656,176847,5809,3.2
12,73,Leon,1998,132434,128466,3968,3.0
12,75,Levy,1998,13362,12773,589,4.4
12,77,Liberty,1998,2441,2300,141,5.8
12,79,Madison,1998,7503,7125,378,5.0
12,81,Manatee,1998,119340,115996,3344,2.8
12,83,Marion,1998,100510,96013,4497,4.5
12,85,Martin,1998,48951,45910,3041,6.2
12,86,Miami-Dade,1998,1096706,1032818,63888,5.8
12,87,Monroe,1998,47912,46562,1350,2.8
12,89,Nassau,1998,29015,27990,1025,3.5
12,91,Okaloosa,1998,82758,79855,2903,3.5
12,93,Okeechobee,1998,16795,15307,1488,8.9
12,95,Orange,1998,490956,475225,15731,3.2
12,97,Osceola,1998,83700,80926,2774,3.3
12,99,Palm Beach,1998,518734,487580,31154,6.0
12,101,Pasco,1998,138358,132799,5559,4.0
12,103,Pinellas,1998,478704,462835,15869,3.3
12,105,Polk,1998,206971,194859,12112,5.9
12,107,Putnam,1998,29115,27506,1609,5.5
12,109,St. Johns,1998,61525,59908,1617,2.6
12,111,St. Lucie,1998,79648,70928,8720,10.9
12,113,Santa Rosa,1998,53828,51507,2321,4.3
12,115,Sarasota,1998,149931,145948,3983,2.7
12,117,Seminole,1998,216818,210426,6392,2.9
12,119,Sumter,1998,14499,13992,507,3.5
12,121,Suwannee,1998,13929,13291,638,4.6
12,123,Taylor,1998,7565,6955,610,8.1
12,125,Union,1998,3780,3667,113,3.0
12,127,Volusia,1998,180656,174008,6648,3.7
12,129,Wakulla,1998,11249,10845,404,3.6
12,131,Walton,1998,15891,15203,688,4.3
12,133,Washington,1998,9307,8824,483,5.2
13,1,Appling,1998,8519,7640,879,10.3
13,3,Atkinson,1998,3176,2927,249,7.8
13,5,Bacon,1998,4341,3945,396,9.1
13,7,Baker,1998,1655,1503,152,9.2
13,9,Baldwin,1998,17909,16910,999,5.6
13,11,Banks,1998,6103,5859,244,4.0
13,13,Barrow,1998,20816,19985,831,4.0
13,15,Bartow,1998,38952,37288,1664,4.3
13,17,Ben Hill,1998,9255,8697,558,6.0
13,19,Berrien,1998,6901,6586,315,4.6
13,21,Bibb,1998,74955,70506,4449,5.9
13,23,Bleckley,1998,5757,5473,284,4.9
13,25,Brantley,1998,6027,5633,394,6.5
13,27,Brooks,1998,7733,7272,461,6.0
13,29,Bryan,1998,10845,10492,353,3.3
13,31,Bulloch,1998,25888,24958,930,3.6
13,33,Burke,1998,8208,7135,1073,13.1
13,35,Butts,1998,8544,8134,410,4.8
13,37,Calhoun,1998,2282,2096,186,8.2
13,39,Camden,1998,16751,16085,666,4.0
13,43,Candler,1998,4054,3825,229,5.6
13,45,Carroll,1998,43989,42012,1977,4.5
13,47,Catoosa,1998,26153,25122,1031,3.9
13,49,Charlton,1998,3766,3579,187,5.0
13,51,Chatham,1998,107798,102736,5062,4.7
13,53,Chattahoochee,1998,2400,2226,174,7.3
13,55,Chattooga,1998,11770,11304,466,4.0
13,57,Cherokee,1998,77779,76058,1721,2.2
13,59,Clarke,1998,47689,46162,1527,3.2
13,61,Clay,1998,1578,1462,116,7.4
13,63,Clayton,1998,122342,117775,4567,3.7
13,65,Clinch,1998,4073,3934,139,3.4
13,67,Cobb,1998,347953,338740,9213,2.6
13,69,Coffee,1998,19020,18022,998,5.2
13,71,Colquitt,1998,19044,18156,888,4.7
13,73,Columbia,1998,44130,42684,1446,3.3
13,75,Cook,1998,7747,7375,372,4.8
13,77,Coweta,1998,44346,42889,1457,3.3
13,79,Crawford,1998,5215,5004,211,4.0
13,81,Crisp,1998,9862,9240,622,6.3
13,83,Dade,1998,7318,6998,320,4.4
13,85,Dawson,1998,10673,10367,306,2.9
13,87,Decatur,1998,12452,11822,630,5.1
13,89,DeKalb,1998,359384,344578,14806,4.1
13,91,Dodge,1998,9763,9172,591,6.1
13,93,Dooly,1998,4636,4324,312,6.7
13,95,Dougherty,1998,46764,42664,4100,8.8
13,97,Douglas,1998,51368,49810,1558,3.0
13,99,Early,1998,4737,4315,422,8.9
13,101,Echols,1998,1177,1131,46,3.9
13,103,Effingham,1998,17872,17213,659,3.7
13,105,Elbert,1998,8728,8003,725,8.3
13,107,Emanuel,1998,8522,7767,755,8.9
13,109,Evans,1998,5001,4802,199,4.0
13,111,Fannin,1998,8870,8383,487,5.5
13,113,Fayette,1998,49037,47926,1111,2.3
13,115,Floyd,1998,45392,43390,2002,4.4
13,117,Forsyth,1998,49153,48279,874,1.8
13,119,Franklin,1998,9928,9550,378,3.8
13,121,Fulton,1998,401444,385126,16318,4.1
13,123,Gilmer,1998,8235,7796,439,5.3
13,125,Glascock,1998,1014,888,126,12.4
13,127,Glynn,1998,35530,34342,1188,3.3
13,129,Gordon,1998,21372,20407,965,4.5
13,131,Grady,1998,9590,8903,687,7.2
13,133,Greene,1998,5835,5451,384,6.6
13,135,Gwinnett,1998,326949,318884,8065,2.5
13,137,Habersham,1998,15588,14977,611,3.9
13,139,Hall,1998,70772,68711,2061,2.9
13,141,Hancock,1998,3963,3499,464,11.7
13,143,Haralson,1998,9368,8809,559,6.0
13,145,Harris,1998,11939,11614,325,2.7
13,147,Hart,1998,8873,8497,376,4.2
13,149,Heard,1998,4840,4594,246,5.1
13,151,Henry,1998,58419,57057,1362,2.3
13,153,Houston,1998,51788,49860,1928,3.7
13,155,Irwin,1998,4833,4580,253,5.2
13,157,Jackson,1998,21893,21017,876,4.0
13,159,Jasper,1998,4793,4607,186,3.9
13,161,Jeff Davis,1998,5632,5183,449,8.0
13,163,Jefferson,1998,7750,6805,945,12.2
13,165,Jenkins,1998,4544,4299,245,5.4
13,167,Johnson,1998,3694,3228,466,12.6
13,169,Jones,1998,12142,11606,536,4.4
13,171,Lamar,1998,7215,6900,315,4.4
13,173,Lanier,1998,3544,3442,102,2.9
13,175,Laurens,1998,22884,21150,1734,7.6
13,177,Lee,1998,12045,11456,589,4.9
13,179,Liberty,1998,16960,15755,1205,7.1
13,181,Lincoln,1998,3522,3275,247,7.0
13,183,Long,1998,3577,3459,118,3.3
13,185,Lowndes,1998,42974,41258,1716,4.0
13,187,Lumpkin,1998,10200,9877,323,3.2
13,189,McDuffie,1998,9870,9094,776,7.9
13,191,McIntosh,1998,4594,4387,207,4.5
13,193,Macon,1998,5410,4837,573,10.6
13,195,Madison,1998,13623,13176,447,3.3
13,197,Marion,1998,3290,3138,152,4.6
13,199,Meriwether,1998,9179,8707,472,5.1
13,201,Miller,1998,3040,2912,128,4.2
13,205,Mitchell,1998,11605,10652,953,8.2
13,207,Monroe,1998,7502,6978,524,7.0
13,209,Montgomery,1998,3749,3425,324,8.6
13,211,Morgan,1998,7261,6968,293,4.0
13,213,Murray,1998,18492,17716,776,4.2
13,215,Muscogee,1998,86632,82158,4474,5.2
13,217,Newton,1998,29228,28081,1147,3.9
13,219,Oconee,1998,13449,13216,233,1.7
13,221,Oglethorpe,1998,5764,5524,240,4.2
13,223,Paulding,1998,39866,38972,894,2.2
13,225,Peach,1998,11302,10577,725,6.4
13,227,Pickens,1998,10434,10137,297,2.8
13,229,Pierce,1998,7396,7022,374,5.1
13,231,Pike,1998,6188,5958,230,3.7
13,233,Polk,1998,15681,14812,869,5.5
13,235,Pulaski,1998,4686,4438,248,5.3
13,237,Putnam,1998,9090,8774,316,3.5
13,239,Quitman,1998,1340,1270,70,5.2
13,241,Rabun,1998,7107,6910,197,2.8
13,243,Randolph,1998,3364,2895,469,13.9
13,245,Richmond,1998,81954,76133,5821,7.1
13,247,Rockdale,1998,39135,38003,1132,2.9
13,249,Schley,1998,1794,1699,95,5.3
13,251,Screven,1998,6136,5619,517,8.4
13,253,Seminole,1998,4458,4248,210,4.7
13,255,Spalding,1998,29318,28012,1306,4.5
13,257,Stephens,1998,12743,12027,716,5.6
13,259,Stewart,1998,2577,2408,169,6.6
13,261,Sumter,1998,15561,14334,1227,7.9
13,263,Talbot,1998,2773,2638,135,4.9
13,265,Taliaferro,1998,689,641,48,7.0
13,267,Tattnall,1998,7078,6704,374,5.3
13,269,Taylor,1998,3578,3367,211,5.9
13,271,Telfair,1998,4930,4472,458,9.3
13,273,Terrell,1998,3994,3476,518,13.0
13,275,Thomas,1998,21190,20212,978,4.6
13,277,Tift,1998,21198,20012,1186,5.6
13,279,Toombs,1998,12494,11362,1132,9.1
13,281,Towns,1998,3886,3698,188,4.8
13,283,Treutlen,1998,2829,2582,247,8.7
13,285,Troup,1998,29292,27874,1418,4.8
13,287,Turner,1998,4439,3905,534,12.0
13,289,Twiggs,1998,4322,4012,310,7.2
13,291,Union,1998,7284,6993,291,4.0
13,293,Upson,1998,13299,12830,469,3.5
13,295,Walker,1998,31247,29815,1432,4.6
13,297,Walton,1998,28025,27123,902,3.2
13,299,Ware,1998,16046,15306,740,4.6
13,301,Warren,1998,2958,2476,482,16.3
13,303,Washington,1998,9802,8984,818,8.3
13,305,Wayne,1998,11394,10570,824,7.2
13,307,Webster,1998,1134,1083,51,4.5
13,309,Wheeler,1998,2061,1862,199,9.7
13,311,White,1998,9161,8806,355,3.9
13,313,Whitfield,1998,47039,45581,1458,3.1
13,315,Wilcox,1998,3381,3173,208,6.2
13,317,Wilkes,1998,5689,5340,349,6.1
13,319,Wilkinson,1998,4577,4211,366,8.0
13,321,Worth,1998,9442,8740,702,7.4
15,1,Hawaii,1998,69357,63117,6240,9.0
15,3,Honolulu/city,1998,433414,411732,21682,5.0
15,7,Kauai,1998,28981,26298,2683,9.3
15,9,Maui,1998,70898,66399,4499,6.3
16,1,Ada,1998,163577,158204,5373,3.3
16,3,Adams,1998,1676,1422,254,15.2
16,5,Bannock,1998,39412,37400,2012,5.1
16,7,Bear Lake,1998,2867,2732,135,4.7
16,9,Benewah,1998,4548,3994,554,12.2
16,11,Bingham,1998,21850,20738,1112,5.1
16,13,Blaine,1998,10985,10536,449,4.1
16,15,Boise,1998,2563,2406,157,6.1
16,17,Bonner,1998,17363,15891,1472,8.5
16,19,Bonneville,1998,46156,44443,1713,3.7
16,21,Boundary,1998,4540,4114,426,9.4
16,23,Butte,1998,1621,1550,71,4.4
16,25,Camas,1998,411,396,15,3.6
16,27,Canyon,1998,62451,59230,3221,5.2
16,29,Caribou,1998,3274,3073,201,6.1
16,31,Cassia,1998,9687,8976,711,7.3
16,33,Clark,1998,592,568,24,4.1
16,35,Clearwater,1998,4328,3753,575,13.3
16,37,Custer,1998,2144,1953,191,8.9
16,39,Elmore,1998,9263,8697,566,6.1
16,41,Franklin,1998,4685,4515,170,3.6
16,43,Fremont,1998,4984,4622,362,7.3
16,45,Gem,1998,6436,5975,461,7.2
16,47,Gooding,1998,6718,6451,267,4.0
16,49,Idaho,1998,6444,5739,705,10.9
16,51,Jefferson,1998,10113,9664,449,4.4
16,53,Jerome,1998,9049,8625,424,4.7
16,55,Kootenai,1998,55537,51062,4475,8.1
16,57,Latah,1998,15071,14543,528,3.5
16,59,Lemhi,1998,4100,3740,360,8.8
16,61,Lewis,1998,1617,1492,125,7.7
16,63,Lincoln,1998,1854,1758,96,5.2
16,65,Madison,1998,10215,9915,300,2.9
16,67,Minidoka,1998,9935,9112,823,8.3
16,69,Nez Perce,1998,23823,22894,929,3.9
16,71,Oneida,1998,1766,1700,66,3.7
16,73,Owyhee,1998,4545,4415,130,2.9
16,75,Payette,1998,10260,9503,757,7.4
16,77,Power,1998,3663,3448,215,5.9
16,79,Shoshone,1998,6844,6057,787,11.5
16,81,Teton,1998,2940,2830,110,3.7
16,83,Twin Falls,1998,32482,30884,1598,4.9
16,85,Valley,1998,4181,3779,402,9.6
16,87,Washington,1998,4685,4325,360,7.7
17,1,Adams,1998,37277,36061,1216,3.3
17,3,Alexander,1998,4077,3761,316,7.8
17,5,Bond,1998,8256,7881,375,4.5
17,7,Boone,1998,21692,20850,842,3.9
17,9,Brown,1998,3058,2986,72,2.4
17,11,Bureau,1998,18982,18255,727,3.8
17,13,Calhoun,1998,3363,3227,136,4.0
17,15,Carroll,1998,9178,8807,371,4.0
17,17,Cass,1998,7377,7050,327,4.4
17,19,Champaign,1998,95796,93523,2273,2.4
17,21,Christian,1998,19205,18392,813,4.2
17,23,Clark,1998,10242,9866,376,3.7
17,25,Clay,1998,7433,6987,446,6.0
17,27,Clinton,1998,17557,16865,692,3.9
17,29,Coles,1998,27735,26809,926,3.3
17,31,Cook,1998,2675126,2532588,142538,5.3
17,33,Crawford,1998,10092,9474,618,6.1
17,35,Cumberland,1998,5622,5386,236,4.2
17,37,DeKalb,1998,47942,46385,1557,3.2
17,39,De Witt,1998,8440,8073,367,4.3
17,41,Douglas,1998,12596,12232,364,2.9
17,43,DuPage,1998,518679,502855,15824,3.1
17,45,Edgar,1998,10296,9913,383,3.7
17,47,Edwards,1998,3797,3587,210,5.5
17,49,Effingham,1998,18317,17544,773,4.2
17,51,Fayette,1998,10994,10362,632,5.7
17,53,Ford,1998,6707,6452,255,3.8
17,55,Franklin,1998,16911,15456,1455,8.6
17,57,Fulton,1998,14555,13696,859,5.9
17,59,Gallatin,1998,2902,2698,204,7.0
17,61,Greene,1998,7370,7045,325,4.4
17,63,Grundy,1998,19099,17724,1375,7.2
17,65,Hamilton,1998,3839,3518,321,8.4
17,67,Hancock,1998,12729,12324,405,3.2
17,69,Hardin,1998,1903,1782,121,6.4
17,71,Henderson,1998,5026,4863,163,3.2
17,73,Henry,1998,27072,26198,874,3.2
17,75,Iroquois,1998,16258,15585,673,4.1
17,77,Jackson,1998,29974,28814,1160,3.9
17,79,Jasper,1998,4016,3663,353,8.8
17,81,Jefferson,1998,18887,17837,1050,5.6
17,83,Jersey,1998,10704,10224,480,4.5
17,85,Jo Daviess,1998,12831,12431,400,3.1
17,87,Johnson,1998,5028,4678,350,7.0
17,89,Kane,1998,216227,208290,7937,3.7
17,91,Kankakee,1998,52600,49864,2736,5.2
17,93,Kendall,1998,29052,28116,936,3.2
17,95,Knox,1998,29470,28431,1039,3.5
17,97,Lake,1998,329089,318768,10321,3.1
17,99,LaSalle,1998,56672,53634,3038,5.4
17,101,Lawrence,1998,7153,6684,469,6.6
17,103,Lee,1998,18295,17705,590,3.2
17,105,Livingston,1998,20306,19748,558,2.7
17,107,Logan,1998,13638,13157,481,3.5
17,109,McDonough,1998,17932,17566,366,2.0
17,111,McHenry,1998,135148,129849,5299,3.9
17,113,McLean,1998,87773,86029,1744,2.0
17,115,Macon,1998,59329,56522,2807,4.7
17,117,Macoupin,1998,23119,22060,1059,4.6
17,119,Madison,1998,130966,125589,5377,4.1
17,121,Marion,1998,20830,19516,1314,6.3
17,123,Marshall,1998,7006,6773,233,3.3
17,125,Mason,1998,8425,7962,463,5.5
17,127,Massac,1998,8228,7897,331,4.0
17,129,Menard,1998,6263,6058,205,3.3
17,131,Mercer,1998,9247,8842,405,4.4
17,133,Monroe,1998,14189,13789,400,2.8
17,135,Montgomery,1998,15654,14550,1104,7.1
17,137,Morgan,1998,18730,18066,664,3.5
17,139,Moultrie,1998,7702,7479,223,2.9
17,141,Ogle,1998,27860,26954,906,3.3
17,143,Peoria,1998,96398,93145,3253,3.4
17,145,Perry,1998,8302,7598,704,8.5
17,147,Piatt,1998,8230,7955,275,3.3
17,149,Pike,1998,9173,8757,416,4.5
17,151,Pope,1998,1823,1674,149,8.2
17,153,Pulaski,1998,3010,2740,270,9.0
17,155,Putnam,1998,3181,3037,144,4.5
17,157,Randolph,1998,14181,13455,726,5.1
17,159,Richland,1998,9122,8653,469,5.1
17,161,Rock Island,1998,76274,73701,2573,3.4
17,163,St. Clair,1998,118308,112264,6044,5.1
17,165,Saline,1998,10795,9992,803,7.4
17,167,Sangamon,1998,102445,99003,3442,3.4
17,169,Schuyler,1998,4353,4171,182,4.2
17,171,Scott,1998,2877,2738,139,4.8
17,173,Shelby,1998,11441,10975,466,4.1
17,175,Stark,1998,2985,2857,128,4.3
17,177,Stephenson,1998,25631,24605,1026,4.0
17,179,Tazewell,1998,71613,69471,2142,3.0
17,181,Union,1998,8299,7769,530,6.4
17,183,Vermilion,1998,39347,37088,2259,5.7
17,185,Wabash,1998,5013,4617,396,7.9
17,187,Warren,1998,10083,9767,316,3.1
17,189,Washington,1998,9322,9004,318,3.4
17,191,Wayne,1998,8519,7998,521,6.1
17,193,White,1998,7608,7082,526,6.9
17,195,Whiteside,1998,32472,31506,966,3.0
17,197,Will,1998,241060,229828,11232,4.7
17,199,Williamson,1998,28576,26644,1932,6.8
17,201,Winnebago,1998,149749,143915,5834,3.9
17,203,Woodford,1998,19387,18953,434,2.2
18,1,Adams,1998,16669,16316,353,2.1
18,3,Allen,1998,178077,173211,4866,2.7
18,5,Bartholomew,1998,40033,39192,841,2.1
18,7,Benton,1998,5068,4905,163,3.2
18,9,Blackford,1998,6609,6291,318,4.8
18,11,Boone,1998,24546,24159,387,1.6
18,13,Brown,1998,8904,8762,142,1.6
18,15,Carroll,1998,12382,12153,229,1.8
18,17,Cass,1998,20173,19580,593,2.9
18,19,Clark,1998,52675,51295,1380,2.6
18,21,Clay,1998,12416,11910,506,4.1
18,23,Clinton,1998,16133,15651,482,3.0
18,25,Crawford,1998,4777,4501,276,5.8
18,27,Daviess,1998,13765,13374,391,2.8
18,29,Dearborn,1998,23696,22927,769,3.2
18,31,Decatur,1998,16083,15724,359,2.2
18,33,DeKalb,1998,22034,21490,544,2.5
18,35,Delaware,1998,62461,59967,2494,4.0
18,37,Dubois,1998,23023,22634,389,1.7
18,39,Elkhart,1998,96065,93801,2264,2.4
18,41,Fayette,1998,11416,10807,609,5.3
18,43,Floyd,1998,39025,38138,887,2.3
18,45,Fountain,1998,8787,8379,408,4.6
18,47,Franklin,1998,10951,10621,330,3.0
18,49,Fulton,1998,10252,9830,422,4.1
18,51,Gibson,1998,16166,15539,627,3.9
18,53,Grant,1998,33670,32410,1260,3.7
18,55,Greene,1998,14738,13860,878,6.0
18,57,Hamilton,1998,94193,93141,1052,1.1
18,59,Hancock,1998,30325,29740,585,1.9
18,61,Harrison,1998,18722,18212,510,2.7
18,63,Hendricks,1998,53237,52495,742,1.4
18,65,Henry,1998,24818,23810,1008,4.1
18,67,Howard,1998,42474,41102,1372,3.2
18,69,Huntington,1998,20953,20183,770,3.7
18,71,Jackson,1998,21131,20518,613,2.9
18,73,Jasper,1998,14268,13727,541,3.8
18,75,Jay,1998,11271,10797,474,4.2
18,77,Jefferson,1998,13914,13366,548,3.9
18,79,Jennings,1998,14737,14420,317,2.2
18,81,Johnson,1998,61943,60822,1121,1.8
18,83,Knox,1998,19712,19037,675,3.4
18,85,Kosciusko,1998,38061,37094,967,2.5
18,87,LaGrange,1998,17405,16956,449,2.6
18,89,Lake,1998,229767,220449,9318,4.1
18,91,LaPorte,1998,54142,52399,1743,3.2
18,93,Lawrence,1998,23749,22305,1444,6.1
18,95,Madison,1998,66230,63751,2479,3.7
18,97,Marion,1998,452202,439605,12597,2.8
18,99,Marshall,1998,24742,24086,656,2.7
18,101,Martin,1998,5182,5005,177,3.4
18,103,Miami,1998,15547,14909,638,4.1
18,105,Monroe,1998,61923,60379,1544,2.5
18,107,Montgomery,1998,18854,18365,489,2.6
18,109,Morgan,1998,35515,34545,970,2.7
18,111,Newton,1998,6767,6538,229,3.4
18,113,Noble,1998,24751,24059,692,2.8
18,115,Ohio,1998,2700,2614,86,3.2
18,117,Orange,1998,9137,8540,597,6.5
18,119,Owen,1998,10688,10273,415,3.9
18,121,Parke,1998,7753,7451,302,3.9
18,123,Perry,1998,8952,8507,445,5.0
18,125,Pike,1998,6322,6123,199,3.1
18,127,Porter,1998,76992,74948,2044,2.7
18,129,Posey,1998,13940,13561,379,2.7
18,131,Pulaski,1998,6232,5934,298,4.8
18,133,Putnam,1998,16643,16259,384,2.3
18,135,Randolph,1998,11451,10590,861,7.5
18,137,Ripley,1998,13573,13151,422,3.1
18,139,Rush,1998,10097,9831,266,2.6
18,141,St. Joseph,1998,137447,133718,3729,2.7
18,143,Scott,1998,11076,10719,357,3.2
18,145,Shelby,1998,23543,22910,633,2.7
18,147,Spencer,1998,12132,11750,382,3.1
18,149,Starke,1998,11015,10529,486,4.4
18,151,Steuben,1998,18248,17740,508,2.8
18,153,Sullivan,1998,9854,9308,546,5.5
18,155,Switzerland,1998,3711,3528,183,4.9
18,157,Tippecanoe,1998,74225,72753,1472,2.0
18,159,Tipton,1998,8882,8643,239,2.7
18,161,Union,1998,3973,3839,134,3.4
18,163,Vanderburgh,1998,91015,88059,2956,3.2
18,165,Vermillion,1998,7845,7368,477,6.1
18,167,Vigo,1998,50239,47940,2299,4.6
18,169,Wabash,1998,17618,17033,585,3.3
18,171,Warren,1998,3968,3850,118,3.0
18,173,Warrick,1998,28719,27873,846,2.9
18,175,Washington,1998,12032,11446,586,4.9
18,177,Wayne,1998,39023,37534,1489,3.8
18,179,Wells,1998,14929,14570,359,2.4
18,181,White,1998,13696,13193,503,3.7
18,183,Whitley,1998,16763,16376,387,2.3
19,1,Adair,1998,4264,4156,108,2.5
19,3,Adams,1998,2181,2106,75,3.4
19,5,Allamakee,1998,7428,7061,367,4.9
19,7,Appanoose,1998,6799,6490,309,4.5
19,9,Audubon,1998,3455,3350,105,3.0
19,11,Benton,1998,11813,11454,359,3.0
19,13,Black Hawk,1998,70388,67816,2572,3.7
19,15,Boone,1998,14215,13880,335,2.4
19,17,Bremer,1998,12782,12450,332,2.6
19,19,Buchanan,1998,11233,10777,456,4.1
19,21,Buena Vista,1998,10967,10741,226,2.1
19,23,Butler,1998,7820,7491,329,4.2
19,25,Calhoun,1998,4871,4733,138,2.8
19,27,Carroll,1998,12790,12472,318,2.5
19,29,Cass,1998,7605,7305,300,3.9
19,31,Cedar,1998,9422,9168,254,2.7
19,33,Cerro Gordo,1998,26709,25902,807,3.0
19,35,Cherokee,1998,6831,6642,189,2.8
19,37,Chickasaw,1998,7611,7313,298,3.9
19,39,Clarke,1998,4396,4229,167,3.8
19,41,Clay,1998,10089,9793,296,2.9
19,43,Clayton,1998,10392,9873,519,5.0
19,45,Clinton,1998,27155,26275,880,3.2
19,47,Crawford,1998,8938,8684,254,2.8
19,49,Dallas,1998,20513,20131,382,1.9
19,51,Davis,1998,4231,4084,147,3.5
19,53,Decatur,1998,3795,3596,199,5.2
19,55,Delaware,1998,9509,9074,435,4.6
19,57,Des Moines,1998,23716,22953,763,3.2
19,59,Dickinson,1998,9839,9519,320,3.3
19,61,Dubuque,1998,49510,47883,1627,3.3
19,63,Emmet,1998,5782,5573,209,3.6
19,65,Fayette,1998,11186,10723,463,4.1
19,67,Floyd,1998,7688,7344,344,4.5
19,69,Franklin,1998,6030,5845,185,3.1
19,71,Fremont,1998,3684,3582,102,2.8
19,73,Greene,1998,5023,4870,153,3.0
19,75,Grundy,1998,6150,6000,150,2.4
19,77,Guthrie,1998,6009,5851,158,2.6
19,79,Hamilton,1998,8385,8150,235,2.8
19,81,Hancock,1998,6753,6621,132,2.0
19,83,Hardin,1998,9618,9264,354,3.7
19,85,Harrison,1998,7695,7463,232,3.0
19,87,Henry,1998,11107,10803,304,2.7
19,89,Howard,1998,5560,5386,174,3.1
19,91,Humboldt,1998,5712,5593,119,2.1
19,93,Ida,1998,4063,3962,101,2.5
19,95,Iowa,1998,9351,9139,212,2.3
19,97,Jackson,1998,10433,9964,469,4.5
19,99,Jasper,1998,19173,18706,467,2.4
19,101,Jefferson,1998,10202,9894,308,3.0
19,103,Johnson,1998,67384,65824,1560,2.3
19,105,Jones,1998,9663,9383,280,2.9
19,107,Keokuk,1998,5250,5011,239,4.6
19,109,Kossuth,1998,8904,8652,252,2.8
19,111,Lee,1998,19658,18800,858,4.4
19,113,Linn,1998,112353,110167,2186,1.9
19,115,Louisa,1998,5360,5170,190,3.5
19,117,Lucas,1998,4099,3946,153,3.7
19,119,Lyon,1998,5668,5532,136,2.4
19,121,Madison,1998,7702,7480,222,2.9
19,123,Mahaska,1998,11437,11154,283,2.5
19,125,Marion,1998,18243,17766,477,2.6
19,127,Marshall,1998,20734,20142,592,2.9
19,129,Mills,1998,6030,5889,141,2.3
19,131,Mitchell,1998,5519,5363,156,2.8
19,133,Monona,1998,5074,4891,183,3.6
19,135,Monroe,1998,4214,4081,133,3.2
19,137,Montgomery,1998,6103,5900,203,3.3
19,139,Muscatine,1998,21963,21343,620,2.8
19,141,O'Brien,1998,7871,7671,200,2.5
19,143,Osceola,1998,3680,3573,107,2.9
19,145,Page,1998,8983,8721,262,2.9
19,147,Palo Alto,1998,5366,5225,141,2.6
19,149,Plymouth,1998,12656,12292,364,2.9
19,151,Pocahontas,1998,4217,4117,100,2.4
19,153,Polk,1998,215459,210709,4750,2.2
19,155,Pottawattamie,1998,48328,47033,1295,2.7
19,157,Poweshiek,1998,10357,10019,338,3.3
19,159,Ringgold,1998,2548,2464,84,3.3
19,161,Sac,1998,6025,5832,193,3.2
19,163,Scott,1998,86827,84433,2394,2.8
19,165,Shelby,1998,6852,6677,175,2.6
19,167,Sioux,1998,17814,17319,495,2.8
19,169,Story,1998,46195,44998,1197,2.6
19,171,Tama,1998,9197,8925,272,3.0
19,173,Taylor,1998,3286,3170,116,3.5
19,175,Union,1998,6567,6328,239,3.6
19,177,Van Buren,1998,4277,4155,122,2.9
19,179,Wapello,1998,17704,16989,715,4.0
19,181,Warren,1998,23542,23071,471,2.0
19,183,Washington,1998,11410,11123,287,2.5
19,185,Wayne,1998,3038,2916,122,4.0
19,187,Webster,1998,20457,19841,616,3.0
19,189,Winnebago,1998,6589,6434,155,2.4
19,191,Winneshiek,1998,12114,11649,465,3.8
19,193,Woodbury,1998,55329,53682,1647,3.0
19,195,Worth,1998,4168,4035,133,3.2
19,197,Wright,1998,6970,6798,172,2.5
20,1,Allen,1998,7336,6979,357,4.9
20,3,Anderson,1998,3818,3602,216,5.7
20,5,Atchison,1998,8592,8146,446,5.2
20,7,Barber,1998,2464,2364,100,4.1
20,9,Barton,1998,14864,14339,525,3.5
20,11,Bourbon,1998,6953,6607,346,5.0
20,13,Brown,1998,5657,5385,272,4.8
20,15,Butler,1998,31466,30491,975,3.1
20,17,Chase,1998,1521,1454,67,4.4
20,19,Chautauqua,1998,1709,1605,104,6.1
20,21,Cherokee,1998,10193,9584,609,6.0
20,23,Cheyenne,1998,1566,1538,28,1.8
20,25,Clark,1998,1338,1313,25,1.9
20,27,Clay,1998,4694,4554,140,3.0
20,29,Cloud,1998,4927,4769,158,3.2
20,31,Coffey,1998,4174,3933,241,5.8
20,33,Comanche,1998,995,975,20,2.0
20,35,Cowley,1998,17736,16732,1004,5.7
20,37,Crawford,1998,17982,17169,813,4.5
20,39,Decatur,1998,1663,1615,48,2.9
20,41,Dickinson,1998,10357,10030,327,3.2
20,43,Doniphan,1998,4336,4084,252,5.8
20,45,Douglas,1998,54100,51815,2285,4.2
20,47,Edwards,1998,1731,1680,51,2.9
20,49,Elk,1998,1299,1233,66,5.1
20,51,Ellis,1998,17353,16852,501,2.9
20,53,Ellsworth,1998,2819,2747,72,2.6
20,55,Finney,1998,19788,19230,558,2.8
20,57,Ford,1998,15703,15317,386,2.5
20,59,Franklin,1998,13287,12620,667,5.0
20,61,Geary,1998,10193,9503,690,6.8
20,63,Gove,1998,1460,1419,41,2.8
20,65,Graham,1998,1536,1490,46,3.0
20,67,Grant,1998,4026,3866,160,4.0
20,69,Gray,1998,3161,3086,75,2.4
20,71,Greeley,1998,809,779,30,3.7
20,73,Greenwood,1998,3206,3042,164,5.1
20,75,Hamilton,1998,1240,1215,25,2.0
20,77,Harper,1998,2959,2891,68,2.3
20,79,Harvey,1998,17567,17103,464,2.6
20,81,Haskell,1998,2059,2004,55,2.7
20,83,Hodgeman,1998,1039,1017,22,2.1
20,85,Jackson,1998,8331,7988,343,4.1
20,87,Jefferson,1998,10218,9757,461,4.5
20,89,Jewell,1998,2066,2013,53,2.6
20,91,Johnson,1998,259388,252840,6548,2.5
20,93,Kearny,1998,2137,2081,56,2.6
20,95,Kingman,1998,4205,4079,126,3.0
20,97,Kiowa,1998,1593,1557,36,2.3
20,99,Labette,1998,11408,10826,582,5.1
20,101,Lane,1998,1082,1051,31,2.9
20,103,Leavenworth,1998,28633,27392,1241,4.3
20,105,Lincoln,1998,1794,1739,55,3.1
20,107,Linn,1998,3297,3008,289,8.8
20,109,Logan,1998,1568,1530,38,2.4
20,111,Lyon,1998,19793,19066,727,3.7
20,113,McPherson,1998,15855,15426,429,2.7
20,115,Marion,1998,6759,6597,162,2.4
20,117,Marshall,1998,5871,5707,164,2.8
20,119,Meade,1998,2139,2096,43,2.0
20,121,Miami,1998,13824,13326,498,3.6
20,123,Mitchell,1998,3735,3666,69,1.8
20,125,Montgomery,1998,18463,17544,919,5.0
20,127,Morris,1998,3084,2973,111,3.6
20,129,Morton,1998,1861,1819,42,2.3
20,131,Nemaha,1998,5449,5302,147,2.7
20,133,Neosho,1998,8462,8081,381,4.5
20,135,Ness,1998,1877,1812,65,3.5
20,137,Norton,1998,3097,3034,63,2.0
20,139,Osage,1998,9744,9185,559,5.7
20,141,Osborne,1998,2276,2222,54,2.4
20,143,Ottawa,1998,3090,2992,98,3.2
20,145,Pawnee,1998,3736,3652,84,2.2
20,147,Phillips,1998,3141,3047,94,3.0
20,149,Pottawatomie,1998,10903,10550,353,3.2
20,151,Pratt,1998,4948,4828,120,2.4
20,153,Rawlins,1998,1489,1451,38,2.6
20,155,Reno,1998,32676,31442,1234,3.8
20,157,Republic,1998,2984,2908,76,2.5
20,159,Rice,1998,4810,4604,206,4.3
20,161,Riley,1998,30871,29664,1207,3.9
20,163,Rooks,1998,2863,2755,108,3.8
20,165,Rush,1998,1872,1813,59,3.2
20,167,Russell,1998,3580,3459,121,3.4
20,169,Saline,1998,29988,28991,997,3.3
20,171,Scott,1998,2675,2612,63,2.4
20,173,Sedgwick,1998,235282,227737,7545,3.2
20,175,Seward,1998,10786,10454,332,3.1
20,177,Shawnee,1998,89688,85817,3871,4.3
20,179,Sheridan,1998,1461,1423,38,2.6
20,181,Sherman,1998,4019,3931,88,2.2
20,183,Smith,1998,2302,2255,47,2.0
20,185,Stafford,1998,2425,2362,63,2.6
20,187,Stanton,1998,1082,1060,22,2.0
20,189,Stevens,1998,2779,2717,62,2.2
20,191,Sumner,1998,13580,13201,379,2.8
20,193,Thomas,1998,4578,4468,110,2.4
20,195,Trego,1998,1884,1837,47,2.5
20,197,Wabaunsee,1998,3470,3313,157,4.5
20,199,Wallace,1998,844,828,16,1.9
20,201,Washington,1998,3384,3278,106,3.1
20,203,Wichita,1998,1219,1179,40,3.3
20,205,Wilson,1998,5192,4956,236,4.5
20,207,Woodson,1998,1567,1468,99,6.3
20,209,Wyandotte,1998,76320,70558,5762,7.5
21,1,Adair,1998,7827,6615,1212,15.5
21,3,Allen,1998,8622,8266,356,4.1
21,5,Anderson,1998,9769,9439,330,3.4
21,7,Ballard,1998,4146,3914,232,5.6
21,9,Barren,1998,18574,17796,778,4.2
21,11,Bath,1998,5776,5473,303,5.2
21,13,Bell,1998,9900,9287,613,6.2
21,15,Boone,1998,43853,42631,1222,2.8
21,17,Bourbon,1998,9914,9667,247,2.5
21,19,Boyd,1998,22492,21106,1386,6.2
21,21,Boyle,1998,14295,13847,448,3.1
21,23,Bracken,1998,3856,3696,160,4.1
21,25,Breathitt,1998,4160,3835,325,7.8
21,27,Breckinridge,1998,7795,7369,426,5.5
21,29,Bullitt,1998,32701,31787,914,2.8
21,31,Butler,1998,5773,5419,354,6.1
21,33,Caldwell,1998,6371,6039,332,5.2
21,35,Calloway,1998,17746,16856,890,5.0
21,37,Campbell,1998,45419,43869,1550,3.4
21,39,Carlisle,1998,2683,2548,135,5.0
21,41,Carroll,1998,5023,4761,262,5.2
21,43,Carter,1998,11691,10383,1308,11.2
21,45,Casey,1998,6955,6352,603,8.7
21,47,Christian,1998,27210,26108,1102,4.0
21,49,Clark,1998,16210,15676,534,3.3
21,51,Clay,1998,7147,6663,484,6.8
21,53,Clinton,1998,4566,4285,281,6.2
21,55,Crittenden,1998,4047,3787,260,6.4
21,57,Cumberland,1998,2757,2592,165,6.0
21,59,Daviess,1998,49014,46826,2188,4.5
21,61,Edmonson,1998,4899,4567,332,6.8
21,63,Elliott,1998,2876,2484,392,13.6
21,65,Estill,1998,5860,5532,328,5.6
21,67,Fayette,1998,141256,138449,2807,2.0
21,69,Fleming,1998,5954,5625,329,5.5
21,71,Floyd,1998,13894,12975,919,6.6
21,73,Franklin,1998,24573,23870,703,2.9
21,75,Fulton,1998,3671,3319,352,9.6
21,77,Gallatin,1998,3581,3445,136,3.8
21,79,Garrard,1998,7262,7069,193,2.7
21,81,Grant,1998,9940,9499,441,4.4
21,83,Graves,1998,17170,16207,963,5.6
21,85,Grayson,1998,12038,11333,705,5.9
21,87,Green,1998,4696,3889,807,17.2
21,89,Greenup,1998,16488,15514,974,5.9
21,91,Hancock,1998,4033,3810,223,5.5
21,93,Hardin,1998,36352,34563,1789,4.9
21,95,Harlan,1998,9384,8256,1128,12.0
21,97,Harrison,1998,7535,7228,307,4.1
21,99,Hart,1998,7967,7557,410,5.1
21,101,Henderson,1998,23989,22513,1476,6.2
21,103,Henry,1998,6810,6517,293,4.3
21,105,Hickman,1998,2459,2336,123,5.0
21,107,Hopkins,1998,19908,18944,964,4.8
21,109,Jackson,1998,6865,6564,301,4.4
21,111,Jefferson,1998,370536,357591,12945,3.5
21,113,Jessamine,1998,20404,20068,336,1.6
21,115,Johnson,1998,9577,8973,604,6.3
21,117,Kenton,1998,78956,76437,2519,3.2
21,119,Knott,1998,5844,5479,365,6.2
21,121,Knox,1998,10992,10330,662,6.0
21,123,Larue,1998,6234,5986,248,4.0
21,125,Laurel,1998,22295,21135,1160,5.2
21,127,Lawrence,1998,5287,4774,513,9.7
21,129,Lee,1998,2511,2361,150,6.0
21,131,Leslie,1998,4505,4254,251,5.6
21,133,Letcher,1998,7566,7005,561,7.4
21,135,Lewis,1998,5070,4470,600,11.8
21,137,Lincoln,1998,10897,10487,410,3.8
21,139,Livingston,1998,4862,4584,278,5.7
21,141,Logan,1998,13075,12600,475,3.6
21,143,Lyon,1998,3311,3126,185,5.6
21,145,McCracken,1998,33384,31938,1446,4.3
21,147,McCreary,1998,6244,5729,515,8.2
21,149,McLean,1998,4645,4322,323,7.0
21,151,Madison,1998,35317,34467,850,2.4
21,153,Magoffin,1998,5052,4382,670,13.3
21,155,Marion,1998,10304,9671,633,6.1
21,157,Marshall,1998,14531,13645,886,6.1
21,159,Martin,1998,2986,2663,323,10.8
21,161,Mason,1998,8437,8177,260,3.1
21,163,Meade,1998,10735,10314,421,3.9
21,165,Menifee,1998,2908,2713,195,6.7
21,167,Mercer,1998,10846,10485,361,3.3
21,169,Metcalfe,1998,4881,4656,225,4.6
21,171,Monroe,1998,5133,4949,184,3.6
21,173,Montgomery,1998,12418,11911,507,4.1
21,175,Morgan,1998,5049,4635,414,8.2
21,177,Muhlenberg,1998,12384,11494,890,7.2
21,179,Nelson,1998,18551,17601,950,5.1
21,181,Nicholas,1998,3247,3127,120,3.7
21,183,Ohio,1998,10117,9378,739,7.3
21,185,Oldham,1998,24128,23682,446,1.8
21,187,Owen,1998,4349,4185,164,3.8
21,189,Owsley,1998,1702,1622,80,4.7
21,191,Pendleton,1998,6528,6289,239,3.7
21,193,Perry,1998,11790,11013,777,6.6
21,195,Pike,1998,27171,25428,1743,6.4
21,197,Powell,1998,6580,6218,362,5.5
21,199,Pulaski,1998,26027,24547,1480,5.7
21,201,Robertson,1998,999,957,42,4.2
21,203,Rockcastle,1998,6091,5811,280,4.6
21,205,Rowan,1998,9258,8926,332,3.6
21,207,Russell,1998,6258,4652,1606,25.7
21,209,Scott,1998,17126,16777,349,2.0
21,211,Shelby,1998,16939,16574,365,2.2
21,213,Simpson,1998,7855,7601,254,3.2
21,215,Spencer,1998,4872,4726,146,3.0
21,217,Taylor,1998,11259,8707,2552,22.7
21,219,Todd,1998,5354,5178,176,3.3
21,221,Trigg,1998,5745,5529,216,3.8
21,223,Trimble,1998,3166,3023,143,4.5
21,225,Union,1998,5774,5410,364,6.3
21,227,Warren,1998,48910,46833,2077,4.2
21,229,Washington,1998,6082,5884,198,3.3
21,231,Wayne,1998,8103,7233,870,10.7
21,233,Webster,1998,5553,5237,316,5.7
21,235,Whitley,1998,13893,13132,761,5.5
21,237,Wolfe,1998,3364,3207,157,4.7
21,239,Woodford,1998,13315,13104,211,1.6
22,1,Acadia Parish,1998,23436,22081,1355,5.8
22,3,Allen Parish,1998,8974,8380,594,6.6
22,5,Ascension Parish,1998,33307,31746,1561,4.7
22,7,Assumption Parish,1998,9703,9189,514,5.3
22,9,Avoyelles Parish,1998,15821,14708,1113,7.0
22,11,Beauregard Parish,1998,12088,11260,828,6.8
22,13,Bienville Parish,1998,5500,4938,562,10.2
22,15,Bossier Parish,1998,45217,42831,2386,5.3
22,17,Caddo Parish,1998,116872,109940,6932,5.9
22,19,Calcasieu Parish,1998,88428,83962,4466,5.1
22,21,Caldwell Parish,1998,4027,3694,333,8.3
22,23,Cameron Parish,1998,4106,3941,165,4.0
22,25,Catahoula Parish,1998,4868,4398,470,9.7
22,27,Claiborne Parish,1998,5920,5464,456,7.7
22,29,Concordia Parish,1998,8452,7260,1192,14.1
22,31,De Soto Parish,1998,10801,10062,739,6.8
22,33,East Baton Rouge Parish,1998,203928,195773,8155,4.0
22,35,East Carroll Parish,1998,3080,2657,423,13.7
22,37,East Feliciana Parish,1998,7443,7022,421,5.7
22,39,Evangeline Parish,1998,11949,11332,617,5.2
22,41,Franklin Parish,1998,9678,8674,1004,10.4
22,43,Grant Parish,1998,6497,6002,495,7.6
22,45,Iberia Parish,1998,33521,30982,2539,7.6
22,47,Iberville Parish,1998,12291,11423,868,7.1
22,49,Jackson Parish,1998,5944,5577,367,6.2
22,51,Jefferson Parish,1998,242255,231298,10957,4.5
22,53,Jefferson Davis Parish,1998,11754,11057,697,5.9
22,55,Lafayette Parish,1998,97263,93456,3807,3.9
22,57,Lafourche Parish,1998,42656,41387,1269,3.0
22,59,LaSalle Parish,1998,5347,5016,331,6.2
22,61,Lincoln Parish,1998,18633,18138,495,2.7
22,63,Livingston Parish,1998,41494,39428,2066,5.0
22,65,Madison Parish,1998,5417,4774,643,11.9
22,67,Morehouse Parish,1998,12167,10787,1380,11.3
22,69,Natchitoches Parish,1998,17111,16098,1013,5.9
22,71,Orleans Parish,1998,207076,193285,13791,6.7
22,73,Ouachita Parish,1998,68431,64923,3508,5.1
22,75,Plaquemines Parish,1998,11091,10487,604,5.4
22,77,Pointe Coupee Parish,1998,9434,8766,668,7.1
22,79,Rapides Parish,1998,58193,55235,2958,5.1
22,81,Red River Parish,1998,3300,2879,421,12.8
22,83,Richland Parish,1998,8053,7266,787,9.8
22,85,Sabine Parish,1998,9026,8293,733,8.1
22,87,St. Bernard Parish,1998,32447,30596,1851,5.7
22,89,St. Charles Parish,1998,23658,22453,1205,5.1
22,91,St. Helena Parish,1998,3802,3580,222,5.8
22,93,St. James Parish,1998,8727,8065,662,7.6
22,95,St. John the Baptist Parish,1998,20125,18675,1450,7.2
22,97,St. Landry Parish,1998,32159,29862,2297,7.1
22,99,St. Martin Parish,1998,21653,20181,1472,6.8
22,101,St. Mary Parish,1998,25617,23746,1871,7.3
22,103,St. Tammany Parish,1998,93372,89607,3765,4.0
22,105,Tangipahoa Parish,1998,42497,39301,3196,7.5
22,107,Tensas Parish,1998,3063,2825,238,7.8
22,109,Terrebonne Parish,1998,49001,47382,1619,3.3
22,111,Union Parish,1998,11840,11229,611,5.2
22,113,Vermilion Parish,1998,22912,21378,1534,6.7
22,115,Vernon Parish,1998,17237,16207,1030,6.0
22,117,Washington Parish,1998,16301,15088,1213,7.4
22,119,Webster Parish,1998,19008,17464,1544,8.1
22,121,West Baton Rouge Parish,1998,9798,9341,457,4.7
22,123,West Carroll Parish,1998,5224,4560,664,12.7
22,125,West Feliciana Parish,1998,3651,3455,196,5.4
22,127,Winn Parish,1998,6521,6104,417,6.4
23,1,Androscoggin,1998,58076,55272,2804,4.8
23,3,Aroostook,1998,37347,34689,2658,7.1
23,5,Cumberland,1998,140284,136805,3479,2.5
23,7,Franklin,1998,14449,13461,988,6.8
23,9,Hancock,1998,27361,25962,1399,5.1
23,11,Kennebec,1998,59181,56020,3161,5.3
23,13,Knox,1998,19904,19233,671,3.4
23,15,Lincoln,1998,17032,16460,572,3.4
23,17,Oxford,1998,26429,24812,1617,6.1
23,19,Penobscot,1998,75261,71812,3449,4.6
23,21,Piscataquis,1998,8303,7754,549,6.6
23,23,Sagadahoc,1998,15539,15038,501,3.2
23,25,Somerset,1998,25549,23599,1950,7.6
23,27,Waldo,1998,20458,19401,1057,5.2
23,29,Washington,1998,16280,14718,1562,9.6
23,31,York,1998,94049,91090,2959,3.1
24,1,Allegany,1998,32812,30067,2745,8.4
24,3,Anne Arundel,1998,254325,246079,8246,3.2
24,5,Baltimore,1998,394287,376915,17372,4.4
24,9,Calvert,1998,37262,36015,1247,3.3
24,11,Caroline,1998,16111,15451,660,4.1
24,13,Carroll,1998,81410,78954,2456,3.0
24,15,Cecil,1998,41294,38683,2611,6.3
24,17,Charles,1998,60856,59026,1830,3.0
24,19,Dorchester,1998,16079,14607,1472,9.2
24,21,Frederick,1998,99248,96550,2698,2.7
24,23,Garrett,1998,14397,12924,1473,10.2
24,25,Harford,1998,113577,108730,4847,4.3
24,27,Howard,1998,139406,136165,3241,2.3
24,29,Kent,1998,10493,9896,597,5.7
24,31,Montgomery,1998,470125,459919,10206,2.2
24,33,Prince George's,1998,441224,423139,18085,4.1
24,35,Queen Anne's,1998,20949,20201,748,3.6
24,37,St. Mary's,1998,46589,44867,1722,3.7
24,39,Somerset,1998,11931,10874,1057,8.9
24,41,Talbot,1998,19018,18326,692,3.6
24,43,Washington,1998,68844,66079,2765,4.0
24,45,Wicomico,1998,49156,46663,2493,5.1
24,47,Worcester,1998,25475,23023,2452,9.6
24,510,Baltimore city,1998,298259,272494,25765,8.6
25,1,Barnstable,1998,106978,101633,5345,5.0
25,3,Berkshire,1998,66317,63687,2630,4.0
25,5,Bristol,1998,268772,255298,13474,5.0
25,7,Dukes,1998,9419,9038,381,4.0
25,9,Essex,1998,373420,359460,13960,3.7
25,11,Franklin,1998,38465,37190,1275,3.3
25,13,Hampden,1998,214669,205401,9268,4.3
25,15,Hampshire,1998,82546,80260,2286,2.8
25,17,Middlesex,1998,829001,808328,20673,2.5
25,19,Nantucket/town,1998,6489,6376,113,1.7
25,21,Norfolk,1998,364878,355705,9173,2.5
25,23,Plymouth,1998,248640,239832,8808,3.5
25,25,Suffolk,1998,345351,333063,12288,3.6
25,27,Worcester,1998,376611,363638,12973,3.4
26,1,Alcona,1998,5012,4670,342,6.8
26,3,Alger,1998,4315,4094,221,5.1
26,5,Allegan,1998,55500,53998,1502,2.7
26,7,Alpena,1998,16118,15048,1070,6.6
26,9,Antrim,1998,10275,9670,605,5.9
26,11,Arenac,1998,6914,6421,493,7.1
26,13,Baraga,1998,4307,4023,284,6.6
26,15,Barry,1998,31712,30794,918,2.9
26,17,Bay,1998,55241,52696,2545,4.6
26,19,Benzie,1998,7685,7249,436,5.7
26,21,Berrien,1998,82401,78933,3468,4.2
26,23,Branch,1998,21382,20615,767,3.6
26,25,Calhoun,1998,68456,65881,2575,3.8
26,27,Cass,1998,26198,25302,896,3.4
26,29,Charlevoix,1998,13908,13232,676,4.9
26,31,Cheboygan,1998,12526,11291,1235,9.9
26,33,Chippewa,1998,17525,16170,1355,7.7
26,35,Clare,1998,10467,9688,779,7.4
26,37,Clinton,1998,34126,33111,1015,3.0
26,39,Crawford,1998,5543,5221,322,5.8
26,41,Delta,1998,18990,17809,1181,6.2
26,43,Dickinson,1998,14113,13454,659,4.7
26,45,Eaton,1998,55752,54128,1624,2.9
26,47,Emmet,1998,17340,16116,1224,7.1
26,49,Genesee,1998,200436,189274,11162,5.6
26,51,Gladwin,1998,9163,8473,690,7.5
26,53,Gogebic,1998,7984,7398,586,7.3
26,55,Grand Traverse,1998,44969,43415,1554,3.5
26,57,Gratiot,1998,19164,18230,934,4.9
26,59,Hillsdale,1998,23515,22743,772,3.3
26,61,Houghton,1998,17309,16426,883,5.1
26,63,Huron,1998,18094,17369,725,4.0
26,65,Ingham,1998,152979,148219,4760,3.1
26,67,Ionia,1998,27370,26157,1213,4.4
26,69,Iosco,1998,11683,10893,790,6.8
26,71,Iron,1998,5559,5222,337,6.1
26,73,Isabella,1998,31782,30861,921,2.9
26,75,Jackson,1998,76038,73372,2666,3.5
26,77,Kalamazoo,1998,127037,123793,3244,2.6
26,79,Kalkaska,1998,7653,7168,485,6.3
26,81,Kent,1998,318161,309378,8783,2.8
26,83,Keweenaw,1998,852,775,77,9.0
26,85,Lake,1998,3247,2998,249,7.7
26,87,Lapeer,1998,43972,41772,2200,5.0
26,89,Leelanau,1998,11057,10702,355,3.2
26,91,Lenawee,1998,46973,45549,1424,3.0
26,93,Livingston,1998,78817,76783,2034,2.6
26,95,Luce,1998,2722,2516,206,7.6
26,97,Mackinac,1998,7341,6672,669,9.1
26,99,Macomb,1998,435578,419505,16073,3.7
26,101,Manistee,1998,10327,9660,667,6.5
26,103,Marquette,1998,31900,30367,1533,4.8
26,105,Mason,1998,13971,13116,855,6.1
26,107,Mecosta,1998,17837,17152,685,3.8
26,109,Menominee,1998,12812,12146,666,5.2
26,111,Midland,1998,42689,41445,1244,2.9
26,113,Missaukee,1998,6445,6066,379,5.9
26,115,Monroe,1998,72558,70400,2158,3.0
26,117,Montcalm,1998,25603,24164,1439,5.6
26,119,Montmorency,1998,3538,3145,393,11.1
26,121,Muskegon,1998,82233,78804,3429,4.2
26,123,Newaygo,1998,20593,19202,1391,6.8
26,125,Oakland,1998,669168,649674,19494,2.9
26,127,Oceana,1998,13926,12947,979,7.0
26,129,Ogemaw,1998,8557,7969,588,6.9
26,131,Ontonagon,1998,3075,2824,251,8.2
26,133,Osceola,1998,10841,10211,630,5.8
26,135,Oscoda,1998,3425,3167,258,7.5
26,137,Otsego,1998,13122,12570,552,4.2
26,139,Ottawa,1998,135770,132516,3254,2.4
26,141,Presque Isle,1998,6165,5514,651,10.6
26,143,Roscommon,1998,8015,7440,575,7.2
26,145,Saginaw,1998,100856,96398,4458,4.4
26,147,St. Clair,1998,79704,75582,4122,5.2
26,149,St. Joseph,1998,32283,31240,1043,3.2
26,151,Sanilac,1998,20989,19903,1086,5.2
26,153,Schoolcraft,1998,4264,3875,389,9.1
26,155,Shiawassee,1998,36432,34638,1794,4.9
26,157,Tuscola,1998,27970,26560,1410,5.0
26,159,Van Buren,1998,36715,35163,1552,4.2
26,161,Washtenaw,1998,171653,168597,3056,1.8
26,163,Wayne,1998,956818,909377,47441,5.0
26,165,Wexford,1998,14442,13323,1119,7.7
27,1,Aitkin,1998,6037,5558,479,7.9
27,3,Anoka,1998,178205,174579,3626,2.0
27,5,Becker,1998,13850,13039,811,5.9
27,7,Beltrami,1998,19791,18852,939,4.7
27,9,Benton,1998,20050,19380,670,3.3
27,11,Big Stone,1998,2824,2720,104,3.7
27,13,Blue Earth,1998,33574,32867,707,2.1
27,15,Brown,1998,15115,14532,583,3.9
27,17,Carlton,1998,15864,15105,759,4.8
27,19,Carver,1998,39327,38577,750,1.9
27,21,Cass,1998,12133,11424,709,5.8
27,23,Chippewa,1998,7016,6723,293,4.2
27,25,Chisago,1998,21189,20544,645,3.0
27,27,Clay,1998,30139,29489,650,2.2
27,29,Clearwater,1998,4053,3594,459,11.3
27,31,Cook,1998,2973,2854,119,4.0
27,33,Cottonwood,1998,5598,5305,293,5.2
27,35,Crow Wing,1998,27491,26187,1304,4.7
27,37,Dakota,1998,212815,208820,3995,1.9
27,39,Dodge,1998,8982,8675,307,3.4
27,41,Douglas,1998,16890,16353,537,3.2
27,43,Faribault,1998,8061,7764,297,3.7
27,45,Fillmore,1998,10091,9769,322,3.2
27,47,Freeborn,1998,16641,16220,421,2.5
27,49,Goodhue,1998,23842,23220,622,2.6
27,51,Grant,1998,2826,2687,139,4.9
27,53,Hennepin,1998,654552,641389,13163,2.0
27,55,Houston,1998,11105,10803,302,2.7
27,57,Hubbard,1998,8431,7995,436,5.2
27,59,Isanti,1998,15706,15200,506,3.2
27,61,Itasca,1998,19707,18357,1350,6.9
27,63,Jackson,1998,6380,6176,204,3.2
27,65,Kanabec,1998,7170,6723,447,6.2
27,67,Kandiyohi,1998,21781,21129,652,3.0
27,69,Kittson,1998,2309,2176,133,5.8
27,71,Koochiching,1998,6586,6122,464,7.0
27,73,Lac qui Parle,1998,3867,3755,112,2.9
27,75,Lake,1998,5641,5407,234,4.1
27,77,Lake of the Woods,1998,2519,2417,102,4.0
27,79,Le Sueur,1998,14706,14220,486,3.3
27,81,Lincoln,1998,3156,3054,102,3.2
27,83,Lyon,1998,15179,14778,401,2.6
27,85,McLeod,1998,21204,20584,620,2.9
27,87,Mahnomen,1998,2247,2050,197,8.8
27,89,Marshall,1998,4609,4179,430,9.3
27,91,Martin,1998,11325,10949,376,3.3
27,93,Meeker,1998,9546,9064,482,5.0
27,95,Mille Lacs,1998,9279,8682,597,6.4
27,97,Morrison,1998,15317,14429,888,5.8
27,99,Mower,1998,19070,18663,407,2.1
27,101,Murray,1998,4388,4196,192,4.4
27,103,Nicollet,1998,18642,18318,324,1.7
27,105,Nobles,1998,9710,9299,411,4.2
27,107,Norman,1998,3428,3248,180,5.3
27,109,Olmsted,1998,71356,70171,1185,1.7
27,111,Otter Tail,1998,27462,26322,1140,4.2
27,113,Pennington,1998,8136,7755,381,4.7
27,115,Pine,1998,11302,10596,706,6.2
27,117,Pipestone,1998,5116,4978,138,2.7
27,119,Polk,1998,16871,16262,609,3.6
27,121,Pope,1998,5586,5406,180,3.2
27,123,Ramsey,1998,282135,276035,6100,2.2
27,125,Red Lake,1998,1901,1739,162,8.5
27,127,Redwood,1998,9165,8907,258,2.8
27,129,Renville,1998,8317,7944,373,4.5
27,131,Rice,1998,28861,28035,826,2.9
27,133,Rock,1998,4747,4574,173,3.6
27,135,Roseau,1998,9111,8758,353,3.9
27,137,St. Louis,1998,103923,99729,4194,4.0
27,139,Scott,1998,47059,46024,1035,2.2
27,141,Sherburne,1998,33003,32130,873,2.6
27,143,Sibley,1998,6678,6405,273,4.1
27,145,Stearns,1998,75243,72931,2312,3.1
27,147,Steele,1998,19709,19249,460,2.3
27,149,Stevens,1998,5600,5457,143,2.6
27,151,Swift,1998,5655,5479,176,3.1
27,153,Todd,1998,9366,8856,510,5.4
27,155,Traverse,1998,1858,1782,76,4.1
27,157,Wabasha,1998,12450,12128,322,2.6
27,159,Wadena,1998,7024,6677,347,4.9
27,161,Waseca,1998,9701,9421,280,2.9
27,163,Washington,1998,115126,113108,2018,1.8
27,165,Watonwan,1998,5703,5537,166,2.9
27,167,Wilkin,1998,3981,3896,85,2.1
27,169,Winona,1998,28468,27816,652,2.3
27,171,Wright,1998,47447,46109,1338,2.8
27,173,Yellow Medicine,1998,5382,5188,194,3.6
28,1,Adams,1998,14759,13555,1204,8.2
28,3,Alcorn,1998,14688,13711,977,6.7
28,5,Amite,1998,5615,5382,233,4.1
28,7,Attala,1998,7685,7000,685,8.9
28,9,Benton,1998,3298,3104,194,5.9
28,11,Bolivar,1998,16831,15380,1451,8.6
28,13,Calhoun,1998,6375,5987,388,6.1
28,15,Carroll,1998,4326,4093,233,5.4
28,17,Chickasaw,1998,7880,7181,699,8.9
28,19,Choctaw,1998,2962,2767,195,6.6
28,21,Claiborne,1998,3498,3131,367,10.5
28,23,Clarke,1998,8659,8179,480,5.5
28,25,Clay,1998,8939,8141,798,8.9
28,27,Coahoma,1998,11730,10538,1192,10.2
28,29,Copiah,1998,11149,10294,855,7.7
28,31,Covington,1998,8348,7865,483,5.8
28,33,DeSoto,1998,53012,51538,1474,2.8
28,35,Forrest,1998,33722,32531,1191,3.5
28,37,Franklin,1998,3309,3065,244,7.4
28,39,George,1998,8227,7614,613,7.5
28,41,Greene,1998,5382,4997,385,7.2
28,43,Grenada,1998,10050,9473,577,5.7
28,45,Hancock,1998,17351,16732,619,3.6
28,47,Harrison,1998,83300,80120,3180,3.8
28,49,Hinds,1998,128829,123671,5158,4.0
28,51,Holmes,1998,7142,6350,792,11.1
28,53,Humphreys,1998,4807,4287,520,10.8
28,55,Issaquena,1998,675,586,89,13.2
28,57,Itawamba,1998,11156,10561,595,5.3
28,59,Jackson,1998,67215,64639,2576,3.8
28,61,Jasper,1998,7899,7508,391,4.9
28,63,Jefferson,1998,2457,2054,403,16.4
28,65,Jefferson Davis,1998,4807,4304,503,10.5
28,67,Jones,1998,30993,29977,1016,3.3
28,69,Kemper,1998,4414,4009,405,9.2
28,71,Lafayette,1998,17179,16853,326,1.9
28,73,Lamar,1998,17409,16939,470,2.7
28,75,Lauderdale,1998,34978,33015,1963,5.6
28,77,Lawrence,1998,5328,5028,300,5.6
28,79,Leake,1998,9805,9330,475,4.8
28,81,Lee,1998,39393,37790,1603,4.1
28,83,Leflore,1998,15292,13937,1355,8.9
28,85,Lincoln,1998,13662,12989,673,4.9
28,87,Lowndes,1998,27630,25548,2082,7.5
28,89,Madison,1998,36975,35842,1133,3.1
28,91,Marion,1998,10684,10057,627,5.9
28,93,Marshall,1998,14087,13291,796,5.7
28,95,Monroe,1998,15318,13761,1557,10.2
28,97,Montgomery,1998,5427,5093,334,6.2
28,99,Neshoba,1998,16371,15764,607,3.7
28,101,Newton,1998,8525,8078,447,5.2
28,103,Noxubee,1998,4483,4032,451,10.1
28,105,Oktibbeha,1998,20688,20153,535,2.6
28,107,Panola,1998,12736,11665,1071,8.4
28,109,Pearl River,1998,19962,19136,826,4.1
28,111,Perry,1998,4166,3881,285,6.8
28,113,Pike,1998,16422,15627,795,4.8
28,115,Pontotoc,1998,13160,12660,500,3.8
28,117,Prentiss,1998,12243,11357,886,7.2
28,119,Quitman,1998,3268,2923,345,10.6
28,121,Rankin,1998,60139,58822,1317,2.2
28,123,Scott,1998,11926,11422,504,4.2
28,125,Sharkey,1998,2549,2221,328,12.9
28,127,Simpson,1998,10580,9568,1012,9.6
28,129,Smith,1998,6032,5808,224,3.7
28,131,Stone,1998,5281,5022,259,4.9
28,133,Sunflower,1998,10605,9372,1233,11.6
28,135,Tallahatchie,1998,5274,4635,639,12.1
28,137,Tate,1998,10536,10080,456,4.3
28,139,Tippah,1998,10423,9777,646,6.2
28,141,Tishomingo,1998,9237,8213,1024,11.1
28,143,Tunica,1998,5087,4710,377,7.4
28,145,Union,1998,12155,11702,453,3.7
28,147,Walthall,1998,5927,5574,353,6.0
28,149,Warren,1998,26216,24933,1283,4.9
28,151,Washington,1998,28454,25881,2573,9.0
28,153,Wayne,1998,8779,8205,574,6.5
28,155,Webster,1998,4498,4295,203,4.5
28,157,Wilkinson,1998,3339,3003,336,10.1
28,159,Winston,1998,7771,7195,576,7.4
28,161,Yalobusha,1998,4988,4702,286,5.7
28,163,Yazoo,1998,9559,8790,769,8.0
29,1,Adair,1998,14435,14081,354,2.5
29,3,Andrew,1998,8373,8074,299,3.6
29,5,Atchison,1998,3330,3259,71,2.1
29,7,Audrain,1998,13367,12927,440,3.3
29,9,Barry,1998,15508,14788,720,4.6
29,11,Barton,1998,7339,7126,213,2.9
29,13,Bates,1998,7569,7151,418,5.5
29,15,Benton,1998,6224,5829,395,6.3
29,17,Bollinger,1998,5412,5120,292,5.4
29,19,Boone,1998,85619,84366,1253,1.5
29,21,Buchanan,1998,42472,40469,2003,4.7
29,23,Butler,1998,20283,19336,947,4.7
29,25,Caldwell,1998,3328,3088,240,7.2
29,27,Callaway,1998,21974,21210,764,3.5
29,29,Camden,1998,17375,16469,906,5.2
29,31,Cape Girardeau,1998,37770,36475,1295,3.4
29,33,Carroll,1998,4989,4735,254,5.1
29,35,Carter,1998,2835,2690,145,5.1
29,37,Cass,1998,44963,43619,1344,3.0
29,39,Cedar,1998,5593,5356,237,4.2
29,41,Chariton,1998,4003,3793,210,5.2
29,43,Christian,1998,27552,26614,938,3.4
29,45,Clark,1998,3705,3498,207,5.6
29,47,Clay,1998,106698,103869,2829,2.7
29,49,Clinton,1998,9821,9462,359,3.7
29,51,Cole,1998,40930,39959,971,2.4
29,53,Cooper,1998,8720,8394,326,3.7
29,55,Crawford,1998,10405,9758,647,6.2
29,57,Dade,1998,3462,3296,166,4.8
29,59,Dallas,1998,6688,6379,309,4.6
29,61,Daviess,1998,3743,3574,169,4.5
29,63,DeKalb,1998,4897,4713,184,3.8
29,65,Dent,1998,6910,6505,405,5.9
29,67,Douglas,1998,5730,5320,410,7.2
29,69,Dunklin,1998,15148,14172,976,6.4
29,71,Franklin,1998,48051,45962,2089,4.3
29,73,Gasconade,1998,7906,7590,316,4.0
29,75,Gentry,1998,3688,3580,108,2.9
29,77,Greene,1998,127465,123757,3708,2.9
29,79,Grundy,1998,4972,4783,189,3.8
29,81,Harrison,1998,4465,4328,137,3.1
29,83,Henry,1998,10573,10101,472,4.5
29,85,Hickory,1998,2811,2597,214,7.6
29,87,Holt,1998,2696,2598,98,3.6
29,89,Howard,1998,4883,4711,172,3.5
29,91,Howell,1998,18159,17229,930,5.1
29,93,Iron,1998,4458,4113,345,7.7
29,95,Jackson,1998,370096,354765,15331,4.1
29,97,Jasper,1998,56798,54752,2046,3.6
29,99,Jefferson,1998,105033,100837,4196,4.0
29,101,Johnson,1998,24033,23469,564,2.3
29,103,Knox,1998,2039,1965,74,3.6
29,105,Laclede,1998,16454,15556,898,5.5
29,107,Lafayette,1998,16795,16142,653,3.9
29,109,Lawrence,1998,15951,15204,747,4.7
29,111,Lewis,1998,5795,5588,207,3.6
29,113,Lincoln,1998,18625,17783,842,4.5
29,115,Linn,1998,6696,6201,495,7.4
29,117,Livingston,1998,7689,7433,256,3.3
29,119,McDonald,1998,8920,8494,426,4.8
29,121,Macon,1998,7766,7356,410,5.3
29,123,Madison,1998,4637,4345,292,6.3
29,125,Maries,1998,4600,4422,178,3.9
29,127,Marion,1998,16169,15455,714,4.4
29,129,Mercer,1998,1639,1589,50,3.1
29,131,Miller,1998,11869,11128,741,6.2
29,133,Mississippi,1998,6222,5743,479,7.7
29,135,Moniteau,1998,7556,7301,255,3.4
29,137,Monroe,1998,4489,4249,240,5.3
29,139,Montgomery,1998,6083,5695,388,6.4
29,141,Morgan,1998,8714,8263,451,5.2
29,143,New Madrid,1998,9046,8377,669,7.4
29,145,Newton,1998,28588,27318,1270,4.4
29,147,Nodaway,1998,13124,12935,189,1.4
29,149,Oregon,1998,4532,4325,207,4.6
29,151,Osage,1998,7509,7278,231,3.1
29,153,Ozark,1998,4292,4034,258,6.0
29,155,Pemiscot,1998,8732,7948,784,9.0
29,157,Perry,1998,11248,10957,291,2.6
29,159,Pettis,1998,22347,21379,968,4.3
29,161,Phelps,1998,20434,19796,638,3.1
29,163,Pike,1998,8058,7661,397,4.9
29,165,Platte,1998,44004,42947,1057,2.4
29,167,Polk,1998,12501,11975,526,4.2
29,169,Pulaski,1998,12462,11779,683,5.5
29,171,Putnam,1998,1978,1887,91,4.6
29,173,Ralls,1998,5451,5207,244,4.5
29,175,Randolph,1998,10904,10325,579,5.3
29,177,Ray,1998,11663,11148,515,4.4
29,179,Reynolds,1998,3396,3229,167,4.9
29,181,Ripley,1998,5530,5264,266,4.8
29,183,St. Charles,1998,158651,154325,4326,2.7
29,185,St. Clair,1998,3964,3769,195,4.9
29,186,Ste. Genevieve,1998,9222,8854,368,4.0
29,187,St. Francois,1998,26060,24498,1562,6.0
29,189,St. Louis,1998,564874,546973,17901,3.2
29,195,Saline,1998,12323,11911,412,3.3
29,197,Schuyler,1998,2512,2413,99,3.9
29,199,Scotland,1998,2171,2094,77,3.5
29,201,Scott,1998,20637,19618,1019,4.9
29,203,Shannon,1998,4165,3908,257,6.2
29,205,Shelby,1998,3579,3435,144,4.0
29,207,Stoddard,1998,13556,12574,982,7.2
29,209,Stone,1998,14171,12606,1565,11.0
29,211,Sullivan,1998,4180,4068,112,2.7
29,213,Taney,1998,30547,27959,2588,8.5
29,215,Texas,1998,9433,8679,754,8.0
29,217,Vernon,1998,9323,8966,357,3.8
29,219,Warren,1998,12645,12076,569,4.5
29,221,Washington,1998,10154,9375,779,7.7
29,223,Wayne,1998,3514,3164,350,10.0
29,225,Webster,1998,14295,13795,500,3.5
29,227,Worth,1998,903,857,46,5.1
29,229,Wright,1998,7187,6703,484,6.7
29,510,St. Louis city,1998,160370,148088,12282,7.7
30,1,Beaverhead,1998,5144,4910,234,4.5
30,3,Big Horn,1998,5211,4739,472,9.1
30,5,Blaine,1998,2928,2658,270,9.2
30,7,Broadwater,1998,2135,2014,121,5.7
30,9,Carbon,1998,4736,4449,287,6.1
30,11,Carter,1998,1005,973,32,3.2
30,13,Cascade,1998,38105,35993,2112,5.5
30,15,Chouteau,1998,2829,2739,90,3.2
30,17,Custer,1998,6183,5880,303,4.9
30,19,Daniels,1998,1319,1282,37,2.8
30,21,Dawson,1998,4940,4733,207,4.2
30,23,Deer Lodge,1998,3905,3614,291,7.5
30,25,Fallon,1998,1732,1673,59,3.4
30,27,Fergus,1998,6351,5943,408,6.4
30,29,Flathead,1998,37985,34975,3010,7.9
30,31,Gallatin,1998,40351,39091,1260,3.1
30,33,Garfield,1998,965,929,36,3.7
30,35,Glacier,1998,5634,4822,812,14.4
30,37,Golden Valley,1998,526,492,34,6.5
30,39,Granite,1998,1207,1099,108,8.9
30,41,Hill,1998,9190,8620,570,6.2
30,43,Jefferson,1998,5044,4801,243,4.8
30,45,Judith Basin,1998,1149,1098,51,4.4
30,47,Lake,1998,11225,10393,832,7.4
30,49,Lewis and Clark,1998,27954,26605,1349,4.8
30,51,Liberty,1998,1148,1109,39,3.4
30,53,Lincoln,1998,7395,6427,968,13.1
30,55,McCone,1998,1247,1199,48,3.8
30,57,Madison,1998,3750,3588,162,4.3
30,59,Meagher,1998,1000,946,54,5.4
30,61,Mineral,1998,1707,1522,185,10.8
30,63,Missoula,1998,51830,49622,2208,4.3
30,65,Musselshell,1998,1956,1811,145,7.4
30,67,Park,1998,10527,9947,580,5.5
30,69,Petroleum,1998,322,305,17,5.3
30,71,Phillips,1998,2495,2280,215,8.6
30,73,Pondera,1998,3347,3171,176,5.3
30,75,Powder River,1998,1298,1253,45,3.5
30,77,Powell,1998,2509,2374,135,5.4
30,79,Prairie,1998,684,640,44,6.4
30,81,Ravalli,1998,16930,15729,1201,7.1
30,83,Richland,1998,5652,5304,348,6.2
30,85,Roosevelt,1998,4105,3728,377,9.2
30,87,Rosebud,1998,4301,3938,363,8.4
30,89,Sanders,1998,4055,3627,428,10.6
30,91,Sheridan,1998,2151,2049,102,4.7
30,93,Silver Bow,1998,17857,16814,1043,5.8
30,95,Stillwater,1998,4175,3974,201,4.8
30,97,Sweet Grass,1998,1780,1700,80,4.5
30,99,Teton,1998,3264,3138,126,3.9
30,101,Toole,1998,2865,2759,106,3.7
30,103,Treasure,1998,475,449,26,5.5
30,105,Valley,1998,4446,4250,196,4.4
30,107,Wheatland,1998,1374,1279,95,6.9
30,109,Wibaux,1998,603,565,38,6.3
30,111,Yellowstone,1998,69550,66479,3071,4.4
31,1,Adams,1998,15867,15549,318,2.0
31,3,Antelope,1998,3016,2913,103,3.4
31,5,Arthur,1998,206,202,4,1.9
31,7,Banner,1998,444,434,10,2.3
31,9,Blaine,1998,364,356,8,2.2
31,11,Boone,1998,2884,2818,66,2.3
31,13,Box Butte,1998,6624,6311,313,4.7
31,15,Boyd,1998,1105,1078,27,2.4
31,17,Brown,1998,1760,1711,49,2.8
31,19,Buffalo,1998,24377,23727,650,2.7
31,21,Burt,1998,3594,3467,127,3.5
31,23,Butler,1998,4252,4134,118,2.8
31,25,Cass,1998,12960,12660,300,2.3
31,27,Cedar,1998,4794,4666,128,2.7
31,29,Chase,1998,1918,1882,36,1.9
31,31,Cherry,1998,3310,3234,76,2.3
31,33,Cheyenne,1998,5200,5095,105,2.0
31,35,Clay,1998,3508,3437,71,2.0
31,37,Colfax,1998,5068,4936,132,2.6
31,39,Cuming,1998,5228,5134,94,1.8
31,41,Custer,1998,5488,5387,101,1.8
31,43,Dakota,1998,10511,10214,297,2.8
31,45,Dawes,1998,4702,4542,160,3.4
31,47,Dawson,1998,13123,12760,363,2.8
31,49,Deuel,1998,900,875,25,2.8
31,51,Dixon,1998,2492,2425,67,2.7
31,53,Dodge,1998,19636,19075,561,2.9
31,55,Douglas,1998,258267,251844,6423,2.5
31,57,Dundy,1998,1091,1074,17,1.6
31,59,Fillmore,1998,3096,3041,55,1.8
31,61,Franklin,1998,1627,1586,41,2.5
31,63,Frontier,1998,1533,1492,41,2.7
31,65,Furnas,1998,2551,2508,43,1.7
31,67,Gage,1998,12685,12443,242,1.9
31,69,Garden,1998,1058,1035,23,2.2
31,71,Garfield,1998,1032,1005,27,2.6
31,73,Gosper,1998,1359,1338,21,1.5
31,75,Grant,1998,369,362,7,1.9
31,77,Greeley,1998,1528,1484,44,2.9
31,79,Hall,1998,31497,30701,796,2.5
31,81,Hamilton,1998,5481,5385,96,1.8
31,83,Harlan,1998,1752,1708,44,2.5
31,85,Hayes,1998,502,481,21,4.2
31,87,Hitchcock,1998,1608,1563,45,2.8
31,89,Holt,1998,6435,6255,180,2.8
31,91,Hooker,1998,392,381,11,2.8
31,93,Howard,1998,3554,3464,90,2.5
31,95,Jefferson,1998,4018,3933,85,2.1
31,97,Johnson,1998,1882,1770,112,6.0
31,99,Kearney,1998,3682,3616,66,1.8
31,101,Keith,1998,4513,4386,127,2.8
31,103,Keya Paha,1998,444,436,8,1.8
31,105,Kimball,1998,1994,1955,39,2.0
31,107,Knox,1998,4738,4589,149,3.1
31,109,Lancaster,1998,144512,141494,3018,2.1
31,111,Lincoln,1998,18621,17995,626,3.4
31,113,Logan,1998,470,460,10,2.1
31,115,Loup,1998,382,372,10,2.6
31,117,McPherson,1998,326,322,4,1.2
31,119,Madison,1998,20681,19887,794,3.8
31,121,Merrick,1998,4662,4567,95,2.0
31,123,Morrill,1998,2733,2633,100,3.7
31,125,Nance,1998,1730,1684,46,2.7
31,127,Nemaha,1998,4141,3952,189,4.6
31,129,Nuckolls,1998,2280,2231,49,2.1
31,131,Otoe,1998,7814,7593,221,2.8
31,133,Pawnee,1998,1525,1482,43,2.8
31,135,Perkins,1998,1491,1454,37,2.5
31,137,Phelps,1998,5105,4993,112,2.2
31,139,Pierce,1998,4146,4050,96,2.3
31,141,Platte,1998,17817,17220,597,3.4
31,143,Polk,1998,2359,2311,48,2.0
31,145,Red Willow,1998,5913,5751,162,2.7
31,147,Richardson,1998,4443,4215,228,5.1
31,149,Rock,1998,909,879,30,3.3
31,151,Saline,1998,7022,6913,109,1.6
31,153,Sarpy,1998,61106,60054,1052,1.7
31,155,Saunders,1998,10560,10302,258,2.4
31,157,Scotts Bluff,1998,18245,17465,780,4.3
31,159,Seward,1998,9324,9097,227,2.4
31,161,Sheridan,1998,2894,2814,80,2.8
31,163,Sherman,1998,1488,1449,39,2.6
31,165,Sioux,1998,780,770,10,1.3
31,167,Stanton,1998,3454,3356,98,2.8
31,169,Thayer,1998,3246,3186,60,1.8
31,171,Thomas,1998,460,441,19,4.1
31,173,Thurston,1998,2981,2724,257,8.6
31,175,Valley,1998,2506,2445,61,2.4
31,177,Washington,1998,10956,10750,206,1.9
31,179,Wayne,1998,5892,5702,190,3.2
31,181,Webster,1998,1815,1776,39,2.1
31,183,Wheeler,1998,340,334,6,1.8
31,185,York,1998,9240,9111,129,1.4
32,1,Churchill,1998,10222,9589,633,6.2
32,3,Clark,1998,663793,637005,26788,4.0
32,5,Douglas,1998,18281,17374,907,5.0
32,7,Elko,1998,22318,21075,1243,5.6
32,9,Esmeralda,1998,585,529,56,9.6
32,11,Eureka,1998,1014,960,54,5.3
32,13,Humboldt,1998,8931,8361,570,6.4
32,15,Lander,1998,3080,2771,309,10.0
32,17,Lincoln,1998,1196,1125,71,5.9
32,19,Lyon,1998,13123,12168,955,7.3
32,21,Mineral,1998,2566,2396,170,6.6
32,23,Nye,1998,15206,14602,604,4.0
32,27,Pershing,1998,2606,2516,90,3.5
32,29,Storey,1998,1587,1522,65,4.1
32,31,Washoe,1998,186384,179510,6874,3.7
32,33,White Pine,1998,3790,3575,215,5.7
32,510,Carson City,1998,23453,22147,1306,5.6
33,1,Belknap,1998,30365,29613,752,2.5
33,3,Carroll,1998,21839,21284,555,2.5
33,5,Cheshire,1998,38973,37806,1167,3.0
33,7,Coos,1998,17076,16403,673,3.9
33,9,Grafton,1998,43346,42403,943,2.2
33,11,Hillsborough,1998,203254,197928,5326,2.6
33,13,Merrimack,1998,74445,72725,1720,2.3
33,15,Rockingham,1998,153621,148210,5411,3.5
33,17,Strafford,1998,57658,56065,1593,2.8
33,19,Sullivan,1998,21216,20652,564,2.7
34,1,Atlantic,1998,129959,119907,10052,7.7
34,3,Bergen,1998,448519,432341,16178,3.6
34,5,Burlington,1998,226956,219304,7652,3.4
34,7,Camden,1998,260909,249235,11674,4.5
34,9,Cape May,1998,46564,41699,4865,10.4
34,11,Cumberland,1998,66244,60356,5888,8.9
34,13,Essex,1998,371013,350348,20665,5.6
34,15,Gloucester,1998,132223,126245,5978,4.5
34,17,Hudson,1998,287033,266301,20732,7.2
34,19,Hunterdon,1998,69617,68104,1513,2.2
34,21,Mercer,1998,170288,163317,6971,4.1
34,23,Middlesex,1998,407478,392383,15095,3.7
34,25,Monmouth,1998,309720,297329,12391,4.0
34,27,Morris,1998,262741,255494,7247,2.8
34,29,Ocean,1998,213561,203367,10194,4.8
34,31,Passaic,1998,235053,221427,13626,5.8
34,33,Salem,1998,32466,30811,1655,5.1
34,35,Somerset,1998,169122,164873,4249,2.5
34,37,Sussex,1998,76560,73814,2746,3.6
34,39,Union,1998,267343,254607,12736,4.8
34,41,Warren,1998,51441,49381,2060,4.0
35,1,Bernalillo,1998,290092,277117,12975,4.5
35,3,Catron,1998,1180,1038,142,12.0
35,5,Chaves,1998,26774,24124,2650,9.9
35,6,Cibola,1998,11450,10436,1014,8.9
35,7,Colfax,1998,6619,6188,431,6.5
35,9,Curry,1998,19982,19070,912,4.6
35,11,De Baca,1998,1034,974,60,5.8
35,13,Dona Ana,1998,68500,62607,5893,8.6
35,15,Eddy,1998,24376,22666,1710,7.0
35,17,Grant,1998,13080,12167,913,7.0
35,19,Guadalupe,1998,1887,1693,194,10.3
35,21,Harding,1998,439,415,24,5.5
35,23,Hidalgo,1998,2664,2524,140,5.3
35,25,Lea,1998,25085,23612,1473,5.9
35,27,Lincoln,1998,7594,7224,370,4.9
35,28,Los Alamos,1998,10364,10172,192,1.9
35,29,Luna,1998,11601,8531,3070,26.5
35,31,McKinley,1998,25355,23238,2117,8.3
35,33,Mora,1998,1759,1415,344,19.6
35,35,Otero,1998,20419,19170,1249,6.1
35,37,Quay,1998,4630,4401,229,4.9
35,39,Rio Arriba,1998,19207,17466,1741,9.1
35,41,Roosevelt,1998,7709,7444,265,3.4
35,43,Sandoval,1998,43323,41116,2207,5.1
35,45,San Juan,1998,50501,46309,4192,8.3
35,47,San Miguel,1998,12329,11293,1036,8.4
35,49,Santa Fe,1998,64602,62275,2327,3.6
35,51,Sierra,1998,4430,4256,174,3.9
35,53,Socorro,1998,6478,6058,420,6.5
35,55,Taos,1998,13505,11830,1675,12.4
35,57,Torrance,1998,6387,6038,349,5.5
35,59,Union,1998,2024,1940,84,4.2
35,61,Valencia,1998,29238,27707,1531,5.2
36,1,Albany,1998,159747,154972,4775,3.0
36,3,Allegany,1998,23705,21932,1773,7.5
36,5,Bronx,1998,482094,434531,47563,9.9
36,7,Broome,1998,99302,95290,4012,4.0
36,9,Cattaraugus,1998,41690,38677,3013,7.2
36,11,Cayuga,1998,38732,36709,2023,5.2
36,13,Chautauqua,1998,68722,65095,3627,5.3
36,15,Chemung,1998,45601,43689,1912,4.2
36,17,Chenango,1998,24277,22901,1376,5.7
36,19,Clinton,1998,40015,37566,2449,6.1
36,21,Columbia,1998,33434,32337,1097,3.3
36,23,Cortland,1998,23908,22102,1806,7.6
36,25,Delaware,1998,21207,20243,964,4.5
36,27,Dutchess,1998,120424,116355,4069,3.4
36,29,Erie,1998,472905,448775,24130,5.1
36,31,Essex,1998,18482,16990,1492,8.1
36,33,Franklin,1998,21411,19713,1698,7.9
36,35,Fulton,1998,27026,25352,1674,6.2
36,37,Genesee,1998,32741,31015,1726,5.3
36,39,Greene,1998,21954,20748,1206,5.5
36,41,Hamilton,1998,2506,2225,281,11.2
36,43,Herkimer,1998,31606,29767,1839,5.8
36,45,Jefferson,1998,44507,40363,4144,9.3
36,47,Kings,1998,1002313,909470,92843,9.3
36,49,Lewis,1998,12213,11165,1048,8.6
36,51,Livingston,1998,35271,33491,1780,5.0
36,53,Madison,1998,35946,34323,1623,4.5
36,55,Monroe,1998,390726,376623,14103,3.6
36,57,Montgomery,1998,23892,22458,1434,6.0
36,59,Nassau,1998,696513,675908,20605,3.0
36,61,New York,1998,852356,795400,56956,6.7
36,63,Niagara,1998,111820,104462,7358,6.6
36,65,Oneida,1998,113226,108442,4784,4.2
36,67,Onondaga,1998,236826,228613,8213,3.5
36,69,Ontario,1998,54679,52522,2157,3.9
36,71,Orange,1998,159030,153591,5439,3.4
36,73,Orleans,1998,21534,20383,1151,5.3
36,75,Oswego,1998,57416,54123,3293,5.7
36,77,Otsego,1998,31744,30159,1585,5.0
36,79,Putnam,1998,53933,52499,1434,2.7
36,81,Queens,1998,1022986,952755,70231,6.9
36,83,Rensselaer,1998,80991,77723,3268,4.0
36,85,Richmond,1998,202936,189086,13850,6.8
36,87,Rockland,1998,147500,142519,4981,3.4
36,89,St. Lawrence,1998,52014,47890,4124,7.9
36,91,Saratoga,1998,105659,102004,3655,3.5
36,93,Schenectady,1998,73975,70993,2982,4.0
36,95,Schoharie,1998,15310,14553,757,4.9
36,97,Schuyler,1998,8886,8359,527,5.9
36,99,Seneca,1998,15710,14942,768,4.9
36,101,Steuben,1998,48405,45494,2911,6.0
36,103,Suffolk,1998,723177,697429,25748,3.6
36,105,Sullivan,1998,31623,29678,1945,6.2
36,107,Tioga,1998,26698,25700,998,3.7
36,109,Tompkins,1998,50501,49026,1475,2.9
36,111,Ulster,1998,82491,79610,2881,3.5
36,113,Warren,1998,32344,30322,2022,6.3
36,115,Washington,1998,29073,27671,1402,4.8
36,117,Wayne,1998,50804,48394,2410,4.7
36,119,Westchester,1998,453765,438659,15106,3.3
36,121,Wyoming,1998,20879,19274,1605,7.7
36,123,Yates,1998,13478,12959,519,3.9
37,1,Alamance,1998,67428,65462,1966,2.9
37,3,Alexander,1998,17313,16915,398,2.3
37,5,Alleghany,1998,5629,5410,219,3.9
37,7,Anson,1998,11291,10373,918,8.1
37,9,Ashe,1998,11371,10528,843,7.4
37,11,Avery,1998,7921,7634,287,3.6
37,13,Beaufort,1998,20551,18891,1660,8.1
37,15,Bertie,1998,8968,8433,535,6.0
37,17,Bladen,1998,20199,18982,1217,6.0
37,19,Brunswick,1998,33166,31442,1724,5.2
37,21,Buncombe,1998,104999,102166,2833,2.7
37,23,Burke,1998,43739,42225,1514,3.5
37,25,Cabarrus,1998,66140,64543,1597,2.4
37,27,Caldwell,1998,41086,40060,1026,2.5
37,29,Camden,1998,3210,3109,101,3.1
37,31,Carteret,1998,30070,28685,1385,4.6
37,33,Caswell,1998,12964,12606,358,2.8
37,35,Catawba,1998,75750,73693,2057,2.7
37,37,Chatham,1998,26724,26180,544,2.0
37,39,Cherokee,1998,11492,10792,700,6.1
37,41,Chowan,1998,6586,6387,199,3.0
37,43,Clay,1998,4187,4057,130,3.1
37,45,Cleveland,1998,46250,43677,2573,5.6
37,47,Columbus,1998,23596,21707,1889,8.0
37,49,Craven,1998,37708,36026,1682,4.5
37,51,Cumberland,1998,119990,114979,5011,4.2
37,53,Currituck,1998,9097,8849,248,2.7
37,55,Dare,1998,18030,17013,1017,5.6
37,57,Davidson,1998,80681,78378,2303,2.9
37,59,Davie,1998,17768,17289,479,2.7
37,61,Duplin,1998,22113,20573,1540,7.0
37,63,Durham,1998,117243,114658,2585,2.2
37,65,Edgecombe,1998,25841,23382,2459,9.5
37,67,Forsyth,1998,156072,151815,4257,2.7
37,69,Franklin,1998,23476,22844,632,2.7
37,71,Gaston,1998,99500,96035,3465,3.5
37,73,Gates,1998,4642,4498,144,3.1
37,75,Graham,1998,4122,3730,392,9.5
37,77,Granville,1998,23462,22779,683,2.9
37,79,Greene,1998,9185,8837,348,3.8
37,81,Guilford,1998,222404,216415,5989,2.7
37,83,Halifax,1998,22972,20946,2026,8.8
37,85,Harnett,1998,37778,36346,1432,3.8
37,87,Haywood,1998,24944,23391,1553,6.2
37,89,Henderson,1998,37373,36396,977,2.6
37,91,Hertford,1998,10311,9848,463,4.5
37,93,Hoke,1998,11657,11064,593,5.1
37,95,Hyde,1998,3102,2878,224,7.2
37,97,Iredell,1998,62309,60636,1673,2.7
37,99,Jackson,1998,16375,15635,740,4.5
37,101,Johnston,1998,59595,58145,1450,2.4
37,103,Jones,1998,4527,4322,205,4.5
37,105,Lee,1998,29390,28346,1044,3.6
37,107,Lenoir,1998,30352,28522,1830,6.0
37,109,Lincoln,1998,31977,30899,1078,3.4
37,111,McDowell,1998,20820,19990,830,4.0
37,113,Macon,1998,14079,13367,712,5.1
37,115,Madison,1998,9307,9011,296,3.2
37,117,Martin,1998,11616,10667,949,8.2
37,119,Mecklenburg,1998,363769,355268,8501,2.3
37,121,Mitchell,1998,7296,6745,551,7.6
37,123,Montgomery,1998,11995,11464,531,4.4
37,125,Moore,1998,30351,29115,1236,4.1
37,127,Nash,1998,44315,41848,2467,5.6
37,129,New Hanover,1998,81754,78700,3054,3.7
37,131,Northampton,1998,8431,7784,647,7.7
37,133,Onslow,1998,48144,46408,1736,3.6
37,135,Orange,1998,64132,63272,860,1.3
37,137,Pamlico,1998,5635,5403,232,4.1
37,139,Pasquotank,1998,15308,14625,683,4.5
37,141,Pender,1998,16813,15903,910,5.4
37,143,Perquimans,1998,4786,4589,197,4.1
37,145,Person,1998,17945,17133,812,4.5
37,147,Pitt,1998,66889,63882,3007,4.5
37,149,Polk,1998,7802,7638,164,2.1
37,151,Randolph,1998,71758,69727,2031,2.8
37,153,Richmond,1998,19620,17924,1696,8.6
37,155,Robeson,1998,56102,51745,4357,7.8
37,157,Rockingham,1998,46448,43914,2534,5.5
37,159,Rowan,1998,65227,63391,1836,2.8
37,161,Rutherford,1998,30224,28694,1530,5.1
37,163,Sampson,1998,23888,22639,1249,5.2
37,165,Scotland,1998,17754,16259,1495,8.4
37,167,Stanly,1998,27550,26590,960,3.5
37,169,Stokes,1998,23362,22816,546,2.3
37,171,Surry,1998,35965,34608,1357,3.8
37,173,Swain,1998,5853,5087,766,13.1
37,175,Transylvania,1998,11684,11401,283,2.4
37,177,Tyrrell,1998,1910,1752,158,8.3
37,179,Union,1998,59945,58555,1390,2.3
37,181,Vance,1998,19558,18175,1383,7.1
37,183,Wake,1998,348848,343367,5481,1.6
37,185,Warren,1998,7319,6802,517,7.1
37,187,Washington,1998,6106,5644,462,7.6
37,189,Watauga,1998,23375,22931,444,1.9
37,191,Wayne,1998,49728,47510,2218,4.5
37,193,Wilkes,1998,32480,31602,878,2.7
37,195,Wilson,1998,36493,33909,2584,7.1
37,197,Yadkin,1998,18505,18025,480,2.6
37,199,Yancey,1998,6590,6193,397,6.0
38,1,Adams,1998,1434,1399,35,2.4
38,3,Barnes,1998,5798,5641,157,2.7
38,5,Benson,1998,2854,2632,222,7.8
38,7,Billings,1998,517,495,22,4.3
38,9,Bottineau,1998,3400,3268,132,3.9
38,11,Bowman,1998,1832,1794,38,2.1
38,13,Burke,1998,1035,1000,35,3.4
38,15,Burleigh,1998,40363,39317,1046,2.6
38,17,Cass,1998,73743,72650,1093,1.5
38,19,Cavalier,1998,2511,2437,74,2.9
38,21,Dickey,1998,2864,2807,57,2.0
38,23,Divide,1998,1157,1131,26,2.2
38,25,Dunn,1998,1992,1917,75,3.8
38,27,Eddy,1998,1386,1314,72,5.2
38,29,Emmons,1998,2024,1949,75,3.7
38,31,Foster,1998,2217,2169,48,2.2
38,33,Golden Valley,1998,899,871,28,3.1
38,35,Grand Forks,1998,36880,36081,799,2.2
38,37,Grant,1998,1474,1431,43,2.9
38,39,Griggs,1998,1640,1605,35,2.1
38,41,Hettinger,1998,1330,1287,43,3.2
38,43,Kidder,1998,1437,1377,60,4.2
38,45,LaMoure,1998,2300,2244,56,2.4
38,47,Logan,1998,1118,1097,21,1.9
38,49,McHenry,1998,2877,2739,138,4.8
38,51,McIntosh,1998,1744,1702,42,2.4
38,53,McKenzie,1998,3168,3058,110,3.5
38,55,McLean,1998,4540,4266,274,6.0
38,57,Mercer,1998,4853,4509,344,7.1
38,59,Morton,1998,13838,13358,480,3.5
38,61,Mountrail,1998,3004,2830,174,5.8
38,63,Nelson,1998,1686,1622,64,3.8
38,65,Oliver,1998,1088,1039,49,4.5
38,67,Pembina,1998,5087,4791,296,5.8
38,69,Pierce,1998,2453,2381,72,2.9
38,71,Ramsey,1998,6500,6300,200,3.1
38,73,Ransom,1998,2743,2682,61,2.2
38,75,Renville,1998,1394,1361,33,2.4
38,77,Richland,1998,9570,9317,253,2.6
38,79,Rolette,1998,5633,4972,661,11.7
38,81,Sargent,1998,2449,2398,51,2.1
38,83,Sheridan,1998,686,655,31,4.5
38,85,Sioux,1998,1682,1573,109,6.5
38,87,Slope,1998,398,387,11,2.8
38,89,Stark,1998,12966,12538,428,3.3
38,91,Steele,1998,1103,1085,18,1.6
38,93,Stutsman,1998,11920,11629,291,2.4
38,95,Towner,1998,1445,1408,37,2.6
38,97,Traill,1998,3797,3680,117,3.1
38,99,Walsh,1998,6295,6037,258,4.1
38,101,Ward,1998,29483,28596,887,3.0
38,103,Wells,1998,2515,2427,88,3.5
38,105,Williams,1998,9969,9572,397,4.0
39,1,Adams,1998,11368,10004,1364,12.0
39,3,Allen,1998,50478,47726,2752,5.5
39,5,Ashland,1998,25550,24385,1165,4.6
39,7,Ashtabula,1998,47258,43956,3302,7.0
39,9,Athens,1998,26573,25146,1427,5.4
39,11,Auglaize,1998,24210,23099,1111,4.6
39,13,Belmont,1998,32435,30508,1927,5.9
39,15,Brown,1998,19508,18416,1092,5.6
39,17,Butler,1998,180856,174160,6696,3.7
39,19,Carroll,1998,13590,12869,721,5.3
39,21,Champaign,1998,18878,18053,825,4.4
39,23,Clark,1998,68532,65241,3291,4.8
39,25,Clermont,1998,93282,89630,3652,3.9
39,27,Clinton,1998,25266,24439,827,3.3
39,29,Columbiana,1998,52475,49254,3221,6.1
39,31,Coshocton,1998,17662,16619,1043,5.9
39,33,Crawford,1998,21777,20343,1434,6.6
39,35,Cuyahoga,1998,680833,662430,18403,2.7
39,37,Darke,1998,29119,27591,1528,5.2
39,39,Defiance,1998,21498,20289,1209,5.6
39,41,Delaware,1998,54416,53311,1105,2.0
39,43,Erie,1998,41820,39539,2281,5.5
39,45,Fairfield,1998,64590,62451,2139,3.3
39,47,Fayette,1998,14826,14198,628,4.2
39,49,Franklin,1998,582067,565396,16671,2.9
39,51,Fulton,1998,22813,21859,954,4.2
39,53,Gallia,1998,14571,13267,1304,8.9
39,55,Geauga,1998,47649,46802,847,1.8
39,57,Greene,1998,71836,69248,2588,3.6
39,59,Guernsey,1998,18945,17243,1702,9.0
39,61,Hamilton,1998,434416,417550,16866,3.9
39,63,Hancock,1998,40807,39389,1418,3.5
39,65,Hardin,1998,15433,14780,653,4.2
39,67,Harrison,1998,6718,6290,428,6.4
39,69,Henry,1998,15314,14410,904,5.9
39,71,Highland,1998,19191,18122,1069,5.6
39,73,Hocking,1998,12237,11408,829,6.8
39,75,Holmes,1998,18138,17532,606,3.3
39,77,Huron,1998,30141,27407,2734,9.1
39,79,Jackson,1998,14423,13292,1131,7.8
39,81,Jefferson,1998,30416,28346,2070,6.8
39,83,Knox,1998,26581,25175,1406,5.3
39,85,Lake,1998,126579,123819,2760,2.2
39,87,Lawrence,1998,26795,24860,1935,7.2
39,89,Licking,1998,70386,67295,3091,4.4
39,91,Logan,1998,26535,25559,976,3.7
39,93,Lorain,1998,141224,136831,4393,3.1
39,95,Lucas,1998,228956,214971,13985,6.1
39,97,Madison,1998,20210,19626,584,2.9
39,99,Mahoning,1998,118893,110677,8216,6.9
39,101,Marion,1998,31642,30133,1509,4.8
39,103,Medina,1998,78050,76496,1554,2.0
39,105,Meigs,1998,8598,7578,1020,11.9
39,107,Mercer,1998,20210,18619,1591,7.9
39,109,Miami,1998,50332,48303,2029,4.0
39,111,Monroe,1998,6020,5424,596,9.9
39,113,Montgomery,1998,281920,269170,12750,4.5
39,115,Morgan,1998,4971,4234,737,14.8
39,117,Morrow,1998,13652,12799,853,6.2
39,119,Muskingum,1998,42502,39512,2990,7.0
39,121,Noble,1998,5537,5076,461,8.3
39,123,Ottawa,1998,20821,19348,1473,7.1
39,125,Paulding,1998,9980,9445,535,5.4
39,127,Perry,1998,14509,13317,1192,8.2
39,129,Pickaway,1998,24334,23419,915,3.8
39,131,Pike,1998,11814,10652,1162,9.8
39,133,Portage,1998,82008,78553,3455,4.2
39,135,Preble,1998,21774,20806,968,4.4
39,137,Putnam,1998,20514,19612,902,4.4
39,139,Richland,1998,61434,57398,4036,6.6
39,141,Ross,1998,35238,32950,2288,6.5
39,143,Sandusky,1998,32495,30346,2149,6.6
39,145,Scioto,1998,33252,29738,3514,10.6
39,147,Seneca,1998,29320,27420,1900,6.5
39,149,Shelby,1998,28375,27206,1169,4.1
39,151,Stark,1998,188515,179827,8688,4.6
39,153,Summit,1998,278265,265739,12526,4.5
39,155,Trumbull,1998,113277,105895,7382,6.5
39,157,Tuscarawas,1998,44314,41768,2546,5.7
39,159,Union,1998,17697,17126,571,3.2
39,161,Van Wert,1998,16276,15627,649,4.0
39,163,Vinton,1998,3825,3361,464,12.1
39,165,Warren,1998,76499,73997,2502,3.3
39,167,Washington,1998,32402,30381,2021,6.2
39,169,Wayne,1998,56492,54425,2067,3.7
39,171,Williams,1998,21013,20012,1001,4.8
39,173,Wood,1998,66055,63599,2456,3.7
39,175,Wyandot,1998,12437,11821,616,5.0
40,1,Adair,1998,9200,8581,619,6.7
40,3,Alfalfa,1998,2569,2514,55,2.1
40,5,Atoka,1998,4884,4689,195,4.0
40,7,Beaver,1998,2865,2761,104,3.6
40,9,Beckham,1998,9595,9214,381,4.0
40,11,Blaine,1998,4658,4502,156,3.3
40,13,Bryan,1998,16811,16351,460,2.7
40,15,Caddo,1998,12883,12235,648,5.0
40,17,Canadian,1998,45421,44328,1093,2.4
40,19,Carter,1998,20594,19311,1283,6.2
40,21,Cherokee,1998,17851,17109,742,4.2
40,23,Choctaw,1998,5555,4983,572,10.3
40,25,Cimarron,1998,1816,1764,52,2.9
40,27,Cleveland,1998,110465,107287,3178,2.9
40,29,Coal,1998,2557,2345,212,8.3
40,31,Comanche,1998,40898,39006,1892,4.6
40,33,Cotton,1998,2232,2107,125,5.6
40,35,Craig,1998,6757,6573,184,2.7
40,37,Creek,1998,33183,31959,1224,3.7
40,39,Custer,1998,12174,11693,481,4.0
40,41,Delaware,1998,17192,16450,742,4.3
40,43,Dewey,1998,2082,2002,80,3.8
40,45,Ellis,1998,1684,1603,81,4.8
40,47,Garfield,1998,28028,27052,976,3.5
40,49,Garvin,1998,11343,10610,733,6.5
40,51,Grady,1998,20296,19267,1029,5.1
40,53,Grant,1998,2392,2332,60,2.5
40,55,Greer,1998,2606,2511,95,3.6
40,57,Harmon,1998,1368,1304,64,4.7
40,59,Harper,1998,1743,1689,54,3.1
40,61,Haskell,1998,4956,4415,541,10.9
40,63,Hughes,1998,5472,5044,428,7.8
40,65,Jackson,1998,12766,12204,562,4.4
40,67,Jefferson,1998,3239,3093,146,4.5
40,69,Johnston,1998,4743,4462,281,5.9
40,71,Kay,1998,22423,20867,1556,6.9
40,73,Kingfisher,1998,7059,6858,201,2.8
40,75,Kiowa,1998,4692,4485,207,4.4
40,77,Latimer,1998,4451,3878,573,12.9
40,79,Le Flore,1998,19771,18368,1403,7.1
40,81,Lincoln,1998,14017,13367,650,4.6
40,83,Logan,1998,14234,13744,490,3.4
40,85,Love,1998,3837,3657,180,4.7
40,87,McClain,1998,12952,12551,401,3.1
40,89,McCurtain,1998,15135,13953,1182,7.8
40,91,McIntosh,1998,7829,7223,606,7.7
40,93,Major,1998,4026,3890,136,3.4
40,95,Marshall,1998,5192,4908,284,5.5
40,97,Mayes,1998,14939,14290,649,4.3
40,99,Murray,1998,5595,5233,362,6.5
40,101,Muskogee,1998,31593,29632,1961,6.2
40,103,Noble,1998,5855,5669,186,3.2
40,105,Nowata,1998,3660,3467,193,5.3
40,107,Okfuskee,1998,4154,3882,272,6.5
40,109,Oklahoma,1998,327262,315671,11591,3.5
40,111,Okmulgee,1998,14632,13357,1275,8.7
40,113,Osage,1998,20297,19561,736,3.6
40,115,Ottawa,1998,13073,12217,856,6.5
40,117,Pawnee,1998,6251,5894,357,5.7
40,119,Payne,1998,35844,35227,617,1.7
40,121,Pittsburg,1998,17430,16084,1346,7.7
40,123,Pontotoc,1998,16872,16038,834,4.9
40,125,Pottawatomie,1998,28561,27177,1384,4.8
40,127,Pushmataha,1998,5112,4783,329,6.4
40,129,Roger Mills,1998,2057,1972,85,4.1
40,131,Rogers,1998,35528,34413,1115,3.1
40,133,Seminole,1998,10104,9184,920,9.1
40,135,Sequoyah,1998,17472,15974,1498,8.6
40,137,Stephens,1998,18157,17210,947,5.2
40,139,Texas,1998,13924,13570,354,2.5
40,141,Tillman,1998,3706,3519,187,5.0
40,143,Tulsa,1998,297896,288911,8985,3.0
40,145,Wagoner,1998,28662,27800,862,3.0
40,147,Washington,1998,18713,18050,663,3.5
40,149,Washita,1998,5034,4842,192,3.8
40,151,Woods,1998,4486,4367,119,2.7
40,153,Woodward,1998,9494,9051,443,4.7
41,1,Baker,1998,7649,6962,687,9.0
41,3,Benton,1998,42523,41166,1357,3.2
41,5,Clackamas,1998,195523,188500,7023,3.6
41,7,Clatsop,1998,17809,16739,1070,6.0
41,9,Columbia,1998,22793,21603,1190,5.2
41,11,Coos,1998,27870,24995,2875,10.3
41,13,Crook,1998,7651,6907,744,9.7
41,15,Curry,1998,8557,7761,796,9.3
41,17,Deschutes,1998,56876,52768,4108,7.2
41,19,Douglas,1998,46377,41915,4462,9.6
41,21,Gilliam,1998,1235,1167,68,5.5
41,23,Grant,1998,4279,3683,596,13.9
41,25,Harney,1998,4024,3712,312,7.8
41,27,Hood River,1998,11274,10232,1042,9.2
41,29,Jackson,1998,89302,82928,6374,7.1
41,31,Jefferson,1998,8520,7941,579,6.8
41,33,Josephine,1998,29158,26495,2663,9.1
41,35,Klamath,1998,29002,26202,2800,9.7
41,37,Lake,1998,3494,3066,428,12.2
41,39,Lane,1998,164618,155263,9355,5.7
41,41,Lincoln,1998,21881,20103,1778,8.1
41,43,Linn,1998,53941,49186,4755,8.8
41,45,Malheur,1998,14784,13430,1354,9.2
41,47,Marion,1998,140010,131678,8332,6.0
41,49,Morrow,1998,4288,3899,389,9.1
41,51,Multnomah,1998,369209,351924,17285,4.7
41,53,Polk,1998,30689,29128,1561,5.1
41,55,Sherman,1998,1076,1018,58,5.4
41,57,Tillamook,1998,11325,10607,718,6.3
41,59,Umatilla,1998,35289,33054,2235,6.3
41,61,Union,1998,12653,11747,906,7.2
41,63,Wallowa,1998,3650,3268,382,10.5
41,65,Wasco,1998,12212,11255,957,7.8
41,67,Washington,1998,245169,235862,9307,3.8
41,69,Wheeler,1998,617,560,57,9.2
41,71,Yamhill,1998,42288,40372,1916,4.5
42,1,Adams,1998,42593,40823,1770,4.2
42,3,Allegheny,1998,658807,631644,27163,4.1
42,5,Armstrong,1998,32122,29866,2256,7.0
42,7,Beaver,1998,87121,82723,4398,5.0
42,9,Bedford,1998,25607,23980,1627,6.4
42,11,Berks,1998,186525,178387,8138,4.4
42,13,Blair,1998,63701,60456,3245,5.1
42,15,Bradford,1998,28152,26804,1348,4.8
42,17,Bucks,1998,328708,316710,11998,3.7
42,19,Butler,1998,88877,85049,3828,4.3
42,21,Cambria,1998,67098,62554,4544,6.8
42,23,Cameron,1998,2795,2605,190,6.8
42,25,Carbon,1998,27558,25558,2000,7.3
42,27,Centre,1998,66764,64879,1885,2.8
42,29,Chester,1998,235092,228628,6464,2.7
42,31,Clarion,1998,19314,18269,1045,5.4
42,33,Clearfield,1998,38629,35474,3155,8.2
42,35,Clinton,1998,17625,16399,1226,7.0
42,37,Columbia,1998,33592,31633,1959,5.8
42,39,Crawford,1998,42579,40418,2161,5.1
42,41,Cumberland,1998,123598,120371,3227,2.6
42,43,Dauphin,1998,141340,136851,4489,3.2
42,45,Delaware,1998,281974,270786,11188,4.0
42,47,Elk,1998,18482,17355,1127,6.1
42,49,Erie,1998,141779,134336,7443,5.2
42,51,Fayette,1998,58009,53802,4207,7.3
42,53,Forest,1998,1757,1603,154,8.8
42,55,Franklin,1998,67151,64514,2637,3.9
42,57,Fulton,1998,6884,6579,305,4.4
42,59,Greene,1998,16656,15302,1354,8.1
42,61,Huntingdon,1998,19059,17467,1592,8.4
42,63,Indiana,1998,37685,34863,2822,7.5
42,65,Jefferson,1998,22030,20474,1556,7.1
42,67,Juniata,1998,10200,9381,819,8.0
42,69,Lackawanna,1998,106575,100354,6221,5.8
42,71,Lancaster,1998,246851,239643,7208,2.9
42,73,Lawrence,1998,41032,38595,2437,5.9
42,75,Lebanon,1998,67029,64674,2355,3.5
42,77,Lehigh,1998,158089,151220,6869,4.3
42,79,Luzerne,1998,158911,148553,10358,6.5
42,81,Lycoming,1998,58180,54789,3391,5.8
42,83,McKean,1998,21731,20313,1418,6.5
42,85,Mercer,1998,58456,55949,2507,4.3
42,87,Mifflin,1998,22232,20776,1456,6.5
42,89,Monroe,1998,52796,49296,3500,6.6
42,91,Montgomery,1998,403912,390787,13125,3.2
42,93,Montour,1998,8670,8401,269,3.1
42,95,Northampton,1998,131885,126081,5804,4.4
42,97,Northumberland,1998,44180,41474,2706,6.1
42,99,Perry,1998,24661,23804,857,3.5
42,101,Philadelphia/city,1998,646647,605766,40881,6.3
42,103,Pike,1998,18385,17575,810,4.4
42,105,Potter,1998,8746,8122,624,7.1
42,107,Schuylkill,1998,67988,63287,4701,6.9
42,109,Snyder,1998,19129,18186,943,4.9
42,111,Somerset,1998,37601,35173,2428,6.5
42,113,Sullivan,1998,2767,2583,184,6.6
42,115,Susquehanna,1998,18562,17579,983,5.3
42,117,Tioga,1998,19943,18816,1127,5.7
42,119,Union,1998,18585,17874,711,3.8
42,121,Venango,1998,26690,25238,1452,5.4
42,123,Warren,1998,21031,20048,983,4.7
42,125,Washington,1998,97436,92430,5006,5.1
42,127,Wayne,1998,19138,17845,1293,6.8
42,129,Westmoreland,1998,185274,175493,9781,5.3
42,131,Wyoming,1998,15470,14346,1124,7.3
42,133,York,1998,195664,188342,7322,3.7
44,1,Bristol,1998,26950,26017,933,3.5
44,3,Kent,1998,91483,87544,3939,4.3
44,5,Newport,1998,41854,39995,1859,4.4
44,7,Providence,1998,304145,288920,15225,5.0
44,9,Washington,1998,67753,65498,2255,3.3
45,1,Abbeville,1998,12690,12098,592,4.7
45,3,Aiken,1998,62967,60218,2749,4.4
45,5,Allendale,1998,4974,4684,290,5.8
45,7,Anderson,1998,84811,82417,2394,2.8
45,9,Bamberg,1998,7616,7149,467,6.1
45,11,Barnwell,1998,11570,10845,725,6.3
45,13,Beaufort,1998,49766,48760,1006,2.0
45,15,Berkeley,1998,62152,60476,1676,2.7
45,17,Calhoun,1998,6806,6487,319,4.7
45,19,Charleston,1998,158555,154098,4457,2.8
45,21,Cherokee,1998,25665,24733,932,3.6
45,23,Chester,1998,15731,14404,1327,8.4
45,25,Chesterfield,1998,20020,18523,1497,7.5
45,27,Clarendon,1998,12413,11638,775,6.2
45,29,Colleton,1998,15449,14788,661,4.3
45,31,Darlington,1998,31155,29257,1898,6.1
45,33,Dillon,1998,14644,13667,977,6.7
45,35,Dorchester,1998,42849,41568,1281,3.0
45,37,Edgefield,1998,9317,8922,395,4.2
45,39,Fairfield,1998,10927,10072,855,7.8
45,41,Florence,1998,63135,60410,2725,4.3
45,43,Georgetown,1998,25087,23186,1901,7.6
45,45,Greenville,1998,193203,189483,3720,1.9
45,47,Greenwood,1998,34142,32468,1674,4.9
45,49,Hampton,1998,8654,8228,426,4.9
45,51,Horry,1998,101203,97528,3675,3.6
45,53,Jasper,1998,7934,7677,257,3.2
45,55,Kershaw,1998,23111,22054,1057,4.6
45,57,Lancaster,1998,28936,27640,1296,4.5
45,59,Laurens,1998,28949,28073,876,3.0
45,61,Lee,1998,8114,7449,665,8.2
45,63,Lexington,1998,118592,116601,1991,1.7
45,65,McCormick,1998,4143,3804,339,8.2
45,67,Marion,1998,16216,14770,1446,8.9
45,69,Marlboro,1998,11782,10402,1380,11.7
45,71,Newberry,1998,18010,17108,902,5.0
45,73,Oconee,1998,28481,27515,966,3.4
45,75,Orangeburg,1998,41183,38308,2875,7.0
45,77,Pickens,1998,56488,55007,1481,2.6
45,79,Richland,1998,158808,155396,3412,2.1
45,81,Saluda,1998,8940,8574,366,4.1
45,83,Spartanburg,1998,132609,128392,4217,3.2
45,85,Sumter,1998,46888,44804,2084,4.4
45,87,Union,1998,15166,14215,951,6.3
45,89,Williamsburg,1998,14478,12905,1573,10.9
45,91,York,1998,86525,83472,3053,3.5
46,3,Aurora,1998,1344,1305,39,2.9
46,5,Beadle,1998,9139,8773,366,4.0
46,7,Bennett,1998,1009,970,39,3.9
46,9,Bon Homme,1998,3103,3046,57,1.8
46,11,Brookings,1998,16092,15847,245,1.5
46,13,Brown,1998,21107,20613,494,2.3
46,15,Brule,1998,2620,2529,91,3.5
46,17,Buffalo,1998,817,737,80,9.8
46,19,Butte,1998,3788,3625,163,4.3
46,21,Campbell,1998,858,829,29,3.4
46,23,Charles Mix,1998,4583,4397,186,4.1
46,25,Clark,1998,1949,1887,62,3.2
46,27,Clay,1998,7029,6961,68,1.0
46,29,Codington,1998,14924,14435,489,3.3
46,31,Corson,1998,1534,1437,97,6.3
46,33,Custer,1998,3357,3213,144,4.3
46,35,Davison,1998,10221,9990,231,2.3
46,37,Day,1998,3033,2851,182,6.0
46,39,Deuel,1998,2411,2332,79,3.3
46,41,Dewey,1998,2447,2086,361,14.8
46,43,Douglas,1998,1642,1595,47,2.9
46,45,Edmunds,1998,2232,2196,36,1.6
46,47,Fall River,1998,3433,3326,107,3.1
46,49,Faulk,1998,1167,1140,27,2.3
46,51,Grant,1998,4332,4149,183,4.2
46,53,Gregory,1998,2533,2449,84,3.3
46,55,Haakon,1998,1096,1058,38,3.5
46,57,Hamlin,1998,2571,2501,70,2.7
46,59,Hand,1998,2057,2004,53,2.6
46,61,Hanson,1998,1727,1688,39,2.3
46,63,Harding,1998,758,734,24,3.2
46,65,Hughes,1998,9722,9504,218,2.2
46,67,Hutchinson,1998,3841,3756,85,2.2
46,69,Hyde,1998,914,887,27,3.0
46,71,Jackson,1998,1110,1052,58,5.2
46,73,Jerauld,1998,1147,1115,32,2.8
46,75,Jones,1998,787,763,24,3.0
46,77,Kingsbury,1998,2687,2581,106,3.9
46,79,Lake,1998,6207,6052,155,2.5
46,81,Lawrence,1998,11309,10836,473,4.2
46,83,Lincoln,1998,12193,12029,164,1.3
46,85,Lyman,1998,2446,2332,114,4.7
46,87,McCook,1998,2460,2389,71,2.9
46,89,McPherson,1998,1252,1226,26,2.1
46,91,Marshall,1998,2261,2169,92,4.1
46,93,Meade,1998,12380,12010,370,3.0
46,95,Mellette,1998,696,647,49,7.0
46,97,Miner,1998,1265,1221,44,3.5
46,99,Minnehaha,1998,87829,86290,1539,1.8
46,101,Moody,1998,3733,3551,182,4.9
46,102,Oglala Lakota,1998,3236,2825,411,12.7
46,103,Pennington,1998,47107,45892,1215,2.6
46,105,Perkins,1998,1924,1867,57,3.0
46,107,Potter,1998,1464,1416,48,3.3
46,109,Roberts,1998,4794,4523,271,5.7
46,111,Sanborn,1998,1479,1432,47,3.2
46,115,Spink,1998,3510,3383,127,3.6
46,117,Stanley,1998,1862,1814,48,2.6
46,119,Sully,1998,869,842,27,3.1
46,121,Todd,1998,2843,2620,223,7.8
46,123,Tripp,1998,3567,3467,100,2.8
46,125,Turner,1998,4116,4017,99,2.4
46,127,Union,1998,7097,6870,227,3.2
46,129,Walworth,1998,3086,2977,109,3.5
46,135,Yankton,1998,11220,10959,261,2.3
46,137,Ziebach,1998,688,605,83,12.1
47,1,Anderson,1998,35690,34345,1345,3.8
47,3,Bedford,1998,18054,17073,981,5.4
47,5,Benton,1998,7526,6935,591,7.9
47,7,Bledsoe,1998,4107,3936,171,4.2
47,9,Blount,1998,50851,49156,1695,3.3
47,11,Bradley,1998,43750,42025,1725,3.9
47,13,Campbell,1998,16981,15853,1128,6.6
47,15,Cannon,1998,4946,4630,316,6.4
47,17,Carroll,1998,13242,12082,1160,8.8
47,19,Carter,1998,25961,24581,1380,5.3
47,21,Cheatham,1998,19340,18909,431,2.2
47,23,Chester,1998,8298,7953,345,4.2
47,25,Claiborne,1998,12627,12033,594,4.7
47,27,Clay,1998,2727,2355,372,13.6
47,29,Cocke,1998,16636,15323,1313,7.9
47,31,Coffee,1998,23112,21962,1150,5.0
47,33,Crockett,1998,7265,6791,474,6.5
47,35,Cumberland,1998,20976,19749,1227,5.8
47,37,Davidson,1998,307256,299070,8186,2.7
47,39,Decatur,1998,5734,5230,504,8.8
47,41,DeKalb,1998,8270,7726,544,6.6
47,43,Dickson,1998,21692,20948,744,3.4
47,45,Dyer,1998,18478,17665,813,4.4
47,47,Fayette,1998,14175,13600,575,4.1
47,49,Fentress,1998,6806,6174,632,9.3
47,51,Franklin,1998,18669,17799,870,4.7
47,53,Gibson,1998,21982,20644,1338,6.1
47,55,Giles,1998,15750,15095,655,4.2
47,57,Grainger,1998,10125,9613,512,5.1
47,59,Greene,1998,35160,32868,2292,6.5
47,61,Grundy,1998,5622,5250,372,6.6
47,63,Hamblen,1998,30202,28819,1383,4.6
47,65,Hamilton,1998,148515,142855,5660,3.8
47,67,Hancock,1998,2808,2637,171,6.1
47,69,Hardeman,1998,9689,8508,1181,12.2
47,71,Hardin,1998,12632,11706,926,7.3
47,73,Hawkins,1998,23820,22655,1165,4.9
47,75,Haywood,1998,8673,7778,895,10.3
47,77,Henderson,1998,14368,13239,1129,7.9
47,79,Henry,1998,14848,13798,1050,7.1
47,81,Hickman,1998,8204,7618,586,7.1
47,83,Houston,1998,2815,2491,324,11.5
47,85,Humphreys,1998,8108,7517,591,7.3
47,87,Jackson,1998,4690,4281,409,8.7
47,89,Jefferson,1998,23658,22486,1172,5.0
47,91,Johnson,1998,7332,6778,554,7.6
47,93,Knox,1998,202742,196253,6489,3.2
47,95,Lake,1998,2548,2297,251,9.9
47,97,Lauderdale,1998,10074,9219,855,8.5
47,99,Lawrence,1998,21904,19893,2011,9.2
47,101,Lewis,1998,4380,3883,497,11.3
47,103,Lincoln,1998,14362,13537,825,5.7
47,105,Loudon,1998,20467,19796,671,3.3
47,107,McMinn,1998,22192,20785,1407,6.3
47,109,McNairy,1998,12186,11416,770,6.3
47,111,Macon,1998,8181,7684,497,6.1
47,113,Madison,1998,50131,48384,1747,3.5
47,115,Marion,1998,12439,11722,717,5.8
47,117,Marshall,1998,12521,11943,578,4.6
47,119,Maury,1998,37083,35700,1383,3.7
47,121,Meigs,1998,4715,4324,391,8.3
47,123,Monroe,1998,17995,16871,1124,6.2
47,125,Montgomery,1998,56443,54380,2063,3.7
47,127,Moore,1998,2973,2885,88,3.0
47,129,Morgan,1998,6858,6350,508,7.4
47,131,Obion,1998,15318,14492,826,5.4
47,133,Overton,1998,9962,9247,715,7.2
47,135,Perry,1998,3803,3533,270,7.1
47,137,Pickett,1998,2186,2058,128,5.9
47,139,Polk,1998,6975,6551,424,6.1
47,141,Putnam,1998,31298,29937,1361,4.3
47,143,Rhea,1998,11861,10933,928,7.8
47,145,Roane,1998,26309,24947,1362,5.2
47,147,Robertson,1998,28658,27648,1010,3.5
47,149,Rutherford,1998,95259,92459,2800,2.9
47,151,Scott,1998,8533,7949,584,6.8
47,153,Sequatchie,1998,4842,4556,286,5.9
47,155,Sevier,1998,35370,32955,2415,6.8
47,157,Shelby,1998,445470,428159,17311,3.9
47,159,Smith,1998,9740,9362,378,3.9
47,161,Stewart,1998,3294,2953,341,10.4
47,163,Sullivan,1998,75264,72301,2963,3.9
47,165,Sumner,1998,69198,66835,2363,3.4
47,167,Tipton,1998,22517,21486,1031,4.6
47,169,Trousdale,1998,2049,1865,184,9.0
47,171,Unicoi,1998,7944,7518,426,5.4
47,173,Union,1998,7792,7458,334,4.3
47,175,Van Buren,1998,2419,2251,168,6.9
47,177,Warren,1998,19638,18418,1220,6.2
47,179,Washington,1998,52130,50334,1796,3.4
47,181,Wayne,1998,7754,6690,1064,13.7
47,183,Weakley,1998,17483,16486,997,5.7
47,185,White,1998,11434,10788,646,5.6
47,187,Williamson,1998,65894,64781,1113,1.7
47,189,Wilson,1998,47338,45711,1627,3.4
48,1,Anderson,1998,20995,19757,1238,5.9
48,3,Andrews,1998,5540,5089,451,8.1
48,5,Angelina,1998,36352,34203,2149,5.9
48,7,Aransas,1998,9672,9074,598,6.2
48,9,Archer,1998,4173,4026,147,3.5
48,11,Armstrong,1998,980,959,21,2.1
48,13,Atascosa,1998,16717,15908,809,4.8
48,15,Austin,1998,12634,12217,417,3.3
48,17,Bailey,1998,3543,3316,227,6.4
48,19,Bandera,1998,6730,6503,227,3.4
48,21,Bastrop,1998,26970,26126,844,3.1
48,23,Baylor,1998,1819,1721,98,5.4
48,25,Bee,1998,11102,10448,654,5.9
48,27,Bell,1998,93642,89517,4125,4.4
48,29,Bexar,1998,662715,636555,26160,3.9
48,31,Blanco,1998,3764,3679,85,2.3
48,33,Borden,1998,406,398,8,2.0
48,35,Bosque,1998,6604,6324,280,4.2
48,37,Bowie,1998,39441,36049,3392,8.6
48,39,Brazoria,1998,105786,99149,6637,6.3
48,41,Brazos,1998,73843,72548,1295,1.8
48,43,Brewster,1998,5190,5060,130,2.5
48,45,Briscoe,1998,930,895,35,3.8
48,47,Brooks,1998,3004,2725,279,9.3
48,49,Brown,1998,17008,16177,831,4.9
48,51,Burleson,1998,7001,6705,296,4.2
48,53,Burnet,1998,13587,13093,494,3.6
48,55,Caldwell,1998,15758,15139,619,3.9
48,57,Calhoun,1998,9423,8774,649,6.9
48,59,Callahan,1998,5974,5730,244,4.1
48,61,Cameron,1998,127796,111267,16529,12.9
48,63,Camp,1998,5463,5006,457,8.4
48,65,Carson,1998,3160,3035,125,4.0
48,67,Cass,1998,15979,14574,1405,8.8
48,69,Castro,1998,4155,3963,192,4.6
48,71,Chambers,1998,11813,11292,521,4.4
48,73,Cherokee,1998,20904,20007,897,4.3
48,75,Childress,1998,3187,3051,136,4.3
48,77,Clay,1998,5376,5202,174,3.2
48,79,Cochran,1998,1441,1360,81,5.6
48,81,Coke,1998,1528,1479,49,3.2
48,83,Coleman,1998,3704,3354,350,9.4
48,85,Collin,1998,261839,256418,5421,2.1
48,87,Collingsworth,1998,1551,1525,26,1.7
48,89,Colorado,1998,8228,7912,316,3.8
48,91,Comal,1998,37898,36860,1038,2.7
48,93,Comanche,1998,6872,6601,271,3.9
48,95,Concho,1998,1502,1462,40,2.7
48,97,Cooke,1998,16870,16300,570,3.4
48,99,Coryell,1998,21293,20333,960,4.5
48,101,Cottle,1998,837,790,47,5.6
48,103,Crane,1998,2187,2054,133,6.1
48,105,Crockett,1998,2117,2013,104,4.9
48,107,Crosby,1998,2952,2726,226,7.7
48,109,Culberson,1998,1247,1142,105,8.4
48,111,Dallam,1998,3656,3534,122,3.3
48,113,Dallas,1998,1196110,1150533,45577,3.8
48,115,Dawson,1998,5971,5592,379,6.3
48,117,Deaf Smith,1998,8102,7490,612,7.6
48,119,Delta,1998,2725,2622,103,3.8
48,121,Denton,1998,237705,232807,4898,2.1
48,123,DeWitt,1998,8627,8230,397,4.6
48,125,Dickens,1998,1009,962,47,4.7
48,127,Dimmit,1998,3707,3087,620,16.7
48,129,Donley,1998,1484,1408,76,5.1
48,131,Duval,1998,5044,4405,639,12.7
48,133,Eastland,1998,8892,8445,447,5.0
48,135,Ector,1998,63687,59378,4309,6.8
48,137,Edwards,1998,845,792,53,6.3
48,139,Ellis,1998,53964,51944,2020,3.7
48,141,El Paso,1998,291292,260617,30675,10.5
48,143,Erath,1998,16489,16005,484,2.9
48,145,Falls,1998,7010,6677,333,4.8
48,147,Fannin,1998,13137,12523,614,4.7
48,149,Fayette,1998,10461,10174,287,2.7
48,151,Fisher,1998,1772,1695,77,4.3
48,153,Floyd,1998,3430,3154,276,8.0
48,155,Foard,1998,806,774,32,4.0
48,157,Fort Bend,1998,180874,175657,5217,2.9
48,159,Franklin,1998,4458,4259,199,4.5
48,161,Freestone,1998,7552,7127,425,5.6
48,163,Frio,1998,6410,5833,577,9.0
48,165,Gaines,1998,6845,6492,353,5.2
48,167,Galveston,1998,124087,115590,8497,6.8
48,169,Garza,1998,2037,1896,141,6.9
48,171,Gillespie,1998,10390,10199,191,1.8
48,173,Glasscock,1998,662,647,15,2.3
48,175,Goliad,1998,2756,2652,104,3.8
48,177,Gonzales,1998,7416,7118,298,4.0
48,179,Gray,1998,10520,10004,516,4.9
48,181,Grayson,1998,50538,48016,2522,5.0
48,183,Gregg,1998,59580,55274,4306,7.2
48,185,Grimes,1998,8912,8471,441,4.9
48,187,Guadalupe,1998,41794,40694,1100,2.6
48,189,Hale,1998,17397,16321,1076,6.2
48,191,Hall,1998,1667,1544,123,7.4
48,193,Hamilton,1998,4075,3908,167,4.1
48,195,Hansford,1998,2494,2427,67,2.7
48,197,Hardeman,1998,1998,1883,115,5.8
48,199,Hardin,1998,23504,21964,1540,6.6
48,201,Harris,1998,1754576,1677455,77121,4.4
48,203,Harrison,1998,28222,26036,2186,7.7
48,205,Hartley,1998,2951,2905,46,1.6
48,207,Haskell,1998,2633,2531,102,3.9
48,209,Hays,1998,50568,49150,1418,2.8
48,211,Hemphill,1998,1925,1870,55,2.9
48,213,Henderson,1998,29762,28490,1272,4.3
48,215,Hidalgo,1998,195622,159951,35671,18.2
48,217,Hill,1998,15962,15329,633,4.0
48,219,Hockley,1998,11141,10448,693,6.2
48,221,Hood,1998,16724,15983,741,4.4
48,223,Hopkins,1998,16066,15253,813,5.1
48,225,Houston,1998,8871,8510,361,4.1
48,227,Howard,1998,14276,13566,710,5.0
48,229,Hudspeth,1998,1435,1391,44,3.1
48,231,Hunt,1998,35566,34108,1458,4.1
48,233,Hutchinson,1998,9787,9212,575,5.9
48,235,Irion,1998,765,744,21,2.7
48,237,Jack,1998,3594,3474,120,3.3
48,239,Jackson,1998,8557,8241,316,3.7
48,241,Jasper,1998,15012,13278,1734,11.6
48,243,Jeff Davis,1998,1532,1498,34,2.2
48,245,Jefferson,1998,117247,108996,8251,7.0
48,247,Jim Hogg,1998,2175,1953,222,10.2
48,249,Jim Wells,1998,17161,15643,1518,8.8
48,251,Johnson,1998,59749,57631,2118,3.5
48,253,Jones,1998,10317,9963,354,3.4
48,255,Karnes,1998,6174,5918,256,4.1
48,257,Kaufman,1998,32229,30811,1418,4.4
48,259,Kendall,1998,12620,12290,330,2.6
48,261,Kenedy,1998,240,232,8,3.3
48,263,Kent,1998,448,434,14,3.1
48,265,Kerr,1998,17716,17251,465,2.6
48,267,Kimble,1998,2405,2350,55,2.3
48,269,King,1998,125,116,9,7.2
48,271,Kinney,1998,1127,1027,100,8.9
48,273,Kleberg,1998,13362,12442,920,6.9
48,275,Knox,1998,2098,1995,103,4.9
48,277,Lamar,1998,21841,20340,1501,6.9
48,279,Lamb,1998,6615,6180,435,6.6
48,281,Lampasas,1998,7702,7359,343,4.5
48,283,La Salle,1998,2952,2691,261,8.8
48,285,Lavaca,1998,9323,9110,213,2.3
48,287,Lee,1998,7218,6940,278,3.9
48,289,Leon,1998,5894,5493,401,6.8
48,291,Liberty,1998,28757,26812,1945,6.8
48,293,Limestone,1998,9264,8784,480,5.2
48,295,Lipscomb,1998,1588,1548,40,2.5
48,297,Live Oak,1998,4527,4327,200,4.4
48,299,Llano,1998,5301,5123,178,3.4
48,301,Loving,1998,82,74,8,9.8
48,303,Lubbock,1998,122886,118630,4256,3.5
48,305,Lynn,1998,2963,2820,143,4.8
48,307,McCulloch,1998,3766,3520,246,6.5
48,309,McLennan,1998,100636,96173,4463,4.4
48,311,McMullen,1998,279,268,11,3.9
48,313,Madison,1998,4202,4054,148,3.5
48,315,Marion,1998,3880,3486,394,10.2
48,317,Martin,1998,1715,1629,86,5.0
48,319,Mason,1998,1544,1502,42,2.7
48,321,Matagorda,1998,16983,14975,2008,11.8
48,323,Maverick,1998,18450,13585,4865,26.4
48,325,Medina,1998,15726,14975,751,4.8
48,327,Menard,1998,1114,1073,41,3.7
48,329,Midland,1998,64437,61666,2771,4.3
48,331,Milam,1998,9652,9212,440,4.6
48,333,Mills,1998,2322,2253,69,3.0
48,335,Mitchell,1998,3476,3206,270,7.8
48,337,Montague,1998,7545,7205,340,4.5
48,339,Montgomery,1998,137659,132989,4670,3.4
48,341,Moore,1998,9376,9075,301,3.2
48,343,Morris,1998,6568,5705,863,13.1
48,345,Motley,1998,605,583,22,3.6
48,347,Nacogdoches,1998,25333,24146,1187,4.7
48,349,Navarro,1998,21307,20193,1114,5.2
48,351,Newton,1998,5875,5146,729,12.4
48,353,Nolan,1998,7452,6962,490,6.6
48,355,Nueces,1998,146662,136378,10284,7.0
48,357,Ochiltree,1998,5155,4993,162,3.1
48,359,Oldham,1998,1144,1106,38,3.3
48,361,Orange,1998,41804,37886,3918,9.4
48,363,Palo Pinto,1998,12589,11902,687,5.5
48,365,Panola,1998,8097,7297,800,9.9
48,367,Parker,1998,41020,39809,1211,3.0
48,369,Parmer,1998,4445,4309,136,3.1
48,371,Pecos,1998,6759,6287,472,7.0
48,373,Polk,1998,15063,14119,944,6.3
48,375,Potter,1998,55146,51953,3193,5.8
48,377,Presidio,1998,3747,2619,1128,30.1
48,379,Rains,1998,3817,3650,167,4.4
48,381,Randall,1998,57614,56650,964,1.7
48,383,Reagan,1998,1950,1826,124,6.4
48,385,Real,1998,1253,1204,49,3.9
48,387,Red River,1998,6087,5677,410,6.7
48,389,Reeves,1998,6784,6032,752,11.1
48,391,Refugio,1998,2973,2828,145,4.9
48,393,Roberts,1998,488,468,20,4.1
48,395,Robertson,1998,6454,6131,323,5.0
48,397,Rockwall,1998,21304,20836,468,2.2
48,399,Runnels,1998,5203,4966,237,4.6
48,401,Rusk,1998,20907,19641,1266,6.1
48,403,Sabine,1998,4095,3723,372,9.1
48,405,San Augustine,1998,3419,3172,247,7.2
48,407,San Jacinto,1998,8234,7874,360,4.4
48,409,San Patricio,1998,29865,27763,2102,7.0
48,411,San Saba,1998,2556,2452,104,4.1
48,413,Schleicher,1998,1523,1457,66,4.3
48,415,Scurry,1998,8099,7658,441,5.4
48,417,Shackelford,1998,1412,1334,78,5.5
48,419,Shelby,1998,9574,8967,607,6.3
48,421,Sherman,1998,1417,1391,26,1.8
48,423,Smith,1998,89699,84977,4722,5.3
48,425,Somervell,1998,2029,1876,153,7.5
48,427,Starr,1998,21792,15699,6093,28.0
48,429,Stephens,1998,4307,4108,199,4.6
48,431,Sterling,1998,697,673,24,3.4
48,433,Stonewall,1998,743,698,45,6.1
48,435,Sutton,1998,2211,2115,96,4.3
48,437,Swisher,1998,3717,3572,145,3.9
48,439,Tarrant,1998,758745,732903,25842,3.4
48,441,Taylor,1998,60700,58454,2246,3.7
48,443,Terrell,1998,530,506,24,4.5
48,445,Terry,1998,5791,5371,420,7.3
48,447,Throckmorton,1998,773,755,18,2.3
48,449,Titus,1998,12762,11911,851,6.7
48,451,Tom Green,1998,52330,50140,2190,4.2
48,453,Travis,1998,450261,437309,12952,2.9
48,455,Trinity,1998,4791,4527,264,5.5
48,457,Tyler,1998,6482,5936,546,8.4
48,459,Upshur,1998,17040,15855,1185,7.0
48,461,Upton,1998,1631,1535,96,5.9
48,463,Uvalde,1998,11347,10158,1189,10.5
48,465,Val Verde,1998,17916,16183,1733,9.7
48,467,Van Zandt,1998,19918,19071,847,4.3
48,469,Victoria,1998,43394,41361,2033,4.7
48,471,Walker,1998,23324,22802,522,2.2
48,473,Waller,1998,12554,11993,561,4.5
48,475,Ward,1998,4714,4330,384,8.1
48,477,Washington,1998,15044,14663,381,2.5
48,479,Webb,1998,72666,65700,6966,9.6
48,481,Wharton,1998,19117,18038,1079,5.6
48,483,Wheeler,1998,2800,2706,94,3.4
48,485,Wichita,1998,61544,58467,3077,5.0
48,487,Wilbarger,1998,7249,7008,241,3.3
48,489,Willacy,1998,7398,5814,1584,21.4
48,491,Williamson,1998,136836,134150,2686,2.0
48,493,Wilson,1998,15082,14625,457,3.0
48,495,Winkler,1998,3161,2865,296,9.4
48,497,Wise,1998,22993,22249,744,3.2
48,499,Wood,1998,13749,12970,779,5.7
48,501,Yoakum,1998,3447,3201,246,7.1
48,503,Young,1998,8313,7788,525,6.3
48,505,Zapata,1998,4689,4144,545,11.6
48,507,Zavala,1998,4390,3441,949,21.6
49,1,Beaver,1998,2509,2392,117,4.7
49,3,Box Elder,1998,19360,18474,886,4.6
49,5,Cache,1998,44747,43421,1326,3.0
49,7,Carbon,1998,9891,9295,596,6.0
49,9,Daggett,1998,425,409,16,3.8
49,11,Davis,1998,120879,116936,3943,3.3
49,13,Duchesne,1998,6131,5691,440,7.2
49,15,Emery,1998,4239,3917,322,7.6
49,17,Garfield,1998,2750,2518,232,8.4
49,19,Grand,1998,5344,4968,376,7.0
49,21,Iron,1998,14950,14392,558,3.7
49,23,Juab,1998,3630,3472,158,4.4
49,25,Kane,1998,2716,2614,102,3.8
49,27,Millard,1998,4728,4513,215,4.5
49,29,Morgan,1998,3694,3555,139,3.8
49,31,Piute,1998,527,503,24,4.6
49,33,Rich,1998,983,951,32,3.3
49,35,Salt Lake,1998,484280,468764,15516,3.2
49,37,San Juan,1998,4996,4607,389,7.8
49,39,Sanpete,1998,9030,8505,525,5.8
49,41,Sevier,1998,8326,7958,368,4.4
49,43,Summit,1998,14201,13590,611,4.3
49,45,Tooele,1998,12040,11461,579,4.8
49,47,Uintah,1998,10918,10283,635,5.8
49,49,Utah,1998,165705,160774,4931,3.0
49,51,Wasatch,1998,6210,5918,292,4.7
49,53,Washington,1998,37303,35967,1336,3.6
49,55,Wayne,1998,1489,1401,88,5.9
49,57,Weber,1998,101545,96887,4658,4.6
50,1,Addison,1998,19622,18907,715,3.6
50,3,Bennington,1998,20197,19394,803,4.0
50,5,Caledonia,1998,15162,14425,737,4.9
50,7,Chittenden,1998,89691,87629,2062,2.3
50,9,Essex,1998,2853,2680,173,6.1
50,11,Franklin,1998,23305,22515,790,3.4
50,13,Grand Isle,1998,3363,3204,159,4.7
50,15,Lamoille,1998,11955,11382,573,4.8
50,17,Orange,1998,15880,15451,429,2.7
50,19,Orleans,1998,12347,11457,890,7.2
50,21,Rutland,1998,32925,31621,1304,4.0
50,23,Washington,1998,31307,30004,1303,4.2
50,25,Windham,1998,23901,23139,762,3.2
50,27,Windsor,1998,31847,30987,860,2.7
51,1,Accomack,1998,14474,13564,910,6.3
51,3,Albemarle,1998,39842,39399,443,1.1
51,5,Alleghany,1998,8529,8104,425,5.0
51,7,Amelia,1998,5069,4939,130,2.6
51,9,Amherst,1998,14401,14088,313,2.2
51,11,Appomattox,1998,5679,5458,221,3.9
51,13,Arlington,1998,106406,104711,1695,1.6
51,15,Augusta,1998,31212,30547,665,2.1
51,17,Bath,1998,2325,2188,137,5.9
51,19,Bedford,1998,32763,32023,740,2.3
51,21,Bland,1998,3496,3354,142,4.1
51,23,Botetourt,1998,16672,16287,385,2.3
51,25,Brunswick,1998,7363,7063,300,4.1
51,27,Buchanan,1998,8945,7717,1228,13.7
51,29,Buckingham,1998,6195,5886,309,5.0
51,31,Campbell,1998,26217,25517,700,2.7
51,33,Caroline,1998,10150,9664,486,4.8
51,35,Carroll,1998,13764,13049,715,5.2
51,36,Charles City,1998,3740,3623,117,3.1
51,37,Charlotte,1998,6017,5805,212,3.5
51,41,Chesterfield,1998,139974,137148,2826,2.0
51,43,Clarke,1998,6435,6319,116,1.8
51,45,Craig,1998,2185,2039,146,6.7
51,47,Culpeper,1998,15995,15674,321,2.0
51,49,Cumberland,1998,3760,3658,102,2.7
51,51,Dickenson,1998,5730,4851,879,15.3
51,53,Dinwiddie,1998,12092,11788,304,2.5
51,57,Essex,1998,4345,4114,231,5.3
51,59,Fairfax,1998,525407,517450,7957,1.5
51,61,Fauquier,1998,27880,27410,470,1.7
51,63,Floyd,1998,6477,6294,183,2.8
51,65,Fluvanna,1998,9375,9241,134,1.4
51,67,Franklin,1998,24440,23793,647,2.6
51,69,Frederick,1998,33077,32271,806,2.4
51,71,Giles,1998,8356,7764,592,7.1
51,73,Gloucester,1998,17965,17539,426,2.4
51,75,Goochland,1998,9023,8841,182,2.0
51,77,Grayson,1998,8238,7805,433,5.3
51,79,Greene,1998,7421,7320,101,1.4
51,81,Greensville,1998,5474,5279,195,3.6
51,83,Halifax,1998,17991,16736,1255,7.0
51,85,Hanover,1998,46001,45233,768,1.7
51,87,Henrico,1998,137696,134905,2791,2.0
51,89,Henry,1998,27907,26865,1042,3.7
51,91,Highland,1998,1268,1227,41,3.2
51,93,Isle of Wight,1998,15113,14659,454,3.0
51,95,James City,1998,24525,24058,467,1.9
51,97,King and Queen,1998,2925,2838,87,3.0
51,99,King George,1998,8419,8220,199,2.4
51,101,King William,1998,6272,6088,184,2.9
51,103,Lancaster,1998,5062,4554,508,10.0
51,105,Lee,1998,9871,9115,756,7.7
51,107,Loudoun,1998,83502,82504,998,1.2
51,109,Louisa,1998,9370,8953,417,4.5
51,111,Lunenburg,1998,4596,4333,263,5.7
51,113,Madison,1998,8291,8139,152,1.8
51,115,Mathews,1998,4629,4512,117,2.5
51,117,Mecklenburg,1998,14946,14298,648,4.3
51,119,Middlesex,1998,4862,4762,100,2.1
51,121,Montgomery,1998,37121,36432,689,1.9
51,125,Nelson,1998,7018,6825,193,2.8
51,127,New Kent,1998,6810,6643,167,2.5
51,131,Northampton,1998,5158,4891,267,5.2
51,133,Northumberland,1998,5155,4718,437,8.5
51,135,Nottoway,1998,6422,6192,230,3.6
51,137,Orange,1998,11106,10821,285,2.6
51,139,Page,1998,11747,11194,553,4.7
51,141,Patrick,1998,9134,8760,374,4.1
51,143,Pittsylvania,1998,31016,29482,1534,4.9
51,145,Powhatan,1998,10690,10503,187,1.7
51,147,Prince Edward,1998,8144,7776,368,4.5
51,149,Prince George,1998,11902,11555,347,2.9
51,153,Prince William,1998,137323,134692,2631,1.9
51,155,Pulaski,1998,16620,15978,642,3.9
51,157,Rappahannock,1998,4175,4059,116,2.8
51,159,Richmond,1998,3966,3785,181,4.6
51,161,Roanoke,1998,48691,47930,761,1.6
51,163,Rockbridge,1998,9731,9525,206,2.1
51,165,Rockingham,1998,36745,36287,458,1.2
51,167,Russell,1998,14104,12868,1236,8.8
51,169,Scott,1998,9536,8826,710,7.4
51,171,Shenandoah,1998,17385,16934,451,2.6
51,173,Smyth,1998,16576,15708,868,5.2
51,175,Southampton,1998,7751,7521,230,3.0
51,177,Spotsylvania,1998,42661,41939,722,1.7
51,179,Stafford,1998,44765,44090,675,1.5
51,181,Surry,1998,2488,2298,190,7.6
51,183,Sussex,1998,5768,5547,221,3.8
51,185,Tazewell,1998,19746,18117,1629,8.2
51,187,Warren,1998,14777,14370,407,2.8
51,191,Washington,1998,25175,23954,1221,4.9
51,193,Westmoreland,1998,7319,6930,389,5.3
51,195,Wise,1998,14799,13342,1457,9.8
51,197,Wythe,1998,14175,13588,587,4.1
51,199,York,1998,28563,28026,537,1.9
51,510,Alexandria city,1998,72625,71058,1567,2.2
51,520,Bristol city,1998,7956,7617,339,4.3
51,530,Buena Vista city,1998,3333,3247,86,2.6
51,540,Charlottesville city,1998,18365,18061,304,1.7
51,550,Chesapeake city,1998,105462,102772,2690,2.6
51,570,Colonial Heights city,1998,8558,8327,231,2.7
51,580,Covington city,1998,3418,3232,186,5.4
51,590,Danville city,1998,25467,24006,1461,5.7
51,595,Emporia city,1998,2633,2527,106,4.0
51,600,Fairfax city,1998,12370,12218,152,1.2
51,610,Falls Church city,1998,5752,5630,122,2.1
51,620,Franklin city,1998,3774,3635,139,3.7
51,630,Fredericksburg city,1998,9670,9340,330,3.4
51,640,Galax city,1998,3290,3187,103,3.1
51,650,Hampton city,1998,66459,64099,2360,3.6
51,660,Harrisonburg city,1998,18142,17903,239,1.3
51,670,Hopewell city,1998,10851,10402,449,4.1
51,678,Lexington city,1998,2902,2852,50,1.7
51,680,Lynchburg city,1998,29633,28872,761,2.6
51,683,Manassas city,1998,18318,17986,332,1.8
51,685,Manassas Park city,1998,4183,4115,68,1.6
51,690,Martinsville city,1998,6847,6494,353,5.2
51,700,Newport News city,1998,84508,81250,3258,3.9
51,710,Norfolk city,1998,84856,80574,4282,5.0
51,720,Norton city,1998,1480,1378,102,6.9
51,730,Petersburg city,1998,15949,15061,888,5.6
51,735,Poquoson city,1998,6093,5964,129,2.1
51,740,Portsmouth city,1998,45106,42774,2332,5.2
51,750,Radford city,1998,6472,6305,167,2.6
51,760,Richmond city,1998,94839,91313,3526,3.7
51,770,Roanoke city,1998,49805,48423,1382,2.8
51,775,Salem city,1998,13815,13492,323,2.3
51,790,Staunton city,1998,11501,11243,258,2.2
51,800,Suffolk city,1998,30073,28971,1102,3.7
51,810,Virginia Beach city,1998,212432,206820,5612,2.6
51,820,Waynesboro city,1998,9104,8854,250,2.7
51,830,Williamsburg city,1998,6097,5774,323,5.3
51,840,Winchester city,1998,13307,12929,378,2.8
53,1,Adams,1998,9322,8380,942,10.1
53,3,Asotin,1998,12883,12389,494,3.8
53,5,Benton,1998,73732,69097,4635,6.3
53,7,Chelan,1998,36660,33639,3021,8.2
53,9,Clallam,1998,25398,23501,1897,7.5
53,11,Clark,1998,184901,177015,7886,4.3
53,13,Columbia,1998,1543,1374,169,11.0
53,15,Cowlitz,1998,43680,40493,3187,7.3
53,17,Douglas,1998,20318,18992,1326,6.5
53,19,Ferry,1998,2793,2489,304,10.9
53,21,Franklin,1998,23443,21211,2232,9.5
53,23,Garfield,1998,1110,1068,42,3.8
53,25,Grant,1998,38657,35320,3337,8.6
53,27,Grays Harbor,1998,27864,25229,2635,9.5
53,29,Island,1998,29818,28836,982,3.3
53,31,Jefferson,1998,10224,9577,647,6.3
53,33,King,1998,966641,932930,33711,3.5
53,35,Kitsap,1998,94246,89593,4653,4.9
53,37,Kittitas,1998,15480,14598,882,5.7
53,39,Klickitat,1998,9173,8245,928,10.1
53,41,Lewis,1998,31111,28440,2671,8.6
53,43,Lincoln,1998,5116,4863,253,4.9
53,45,Mason,1998,20679,19375,1304,6.3
53,47,Okanogan,1998,24021,21610,2411,10.0
53,49,Pacific,1998,8508,7707,801,9.4
53,51,Pend Oreille,1998,4316,3820,496,11.5
53,53,Pierce,1998,343915,329207,14708,4.3
53,55,San Juan,1998,6128,5868,260,4.2
53,57,Skagit,1998,49391,46073,3318,6.7
53,59,Skamania,1998,4375,3960,415,9.5
53,61,Snohomish,1998,319294,307919,11375,3.6
53,63,Spokane,1998,214637,204873,9764,4.5
53,65,Stevens,1998,17965,16430,1535,8.5
53,67,Thurston,1998,104661,99842,4819,4.6
53,69,Wahkiakum,1998,1963,1843,120,6.1
53,71,Walla Walla,1998,27578,25800,1778,6.4
53,73,Whatcom,1998,81743,77284,4459,5.5
53,75,Whitman,1998,19824,19451,373,1.9
53,77,Yakima,1998,118817,107052,11765,9.9
54,1,Barbour,1998,6133,5415,718,11.7
54,3,Berkeley,1998,34199,32865,1334,3.9
54,5,Boone,1998,8128,7297,831,10.2
54,7,Braxton,1998,5172,4612,560,10.8
54,9,Brooke,1998,11388,10729,659,5.8
54,11,Cabell,1998,42368,40157,2211,5.2
54,13,Calhoun,1998,2541,2137,404,15.9
54,15,Clay,1998,4072,3622,450,11.1
54,17,Doddridge,1998,3330,3070,260,7.8
54,19,Fayette,1998,17757,16107,1650,9.3
54,21,Gilmer,1998,2736,2522,214,7.8
54,23,Grant,1998,4515,4073,442,9.8
54,25,Greenbrier,1998,14914,13727,1187,8.0
54,27,Hampshire,1998,8740,8208,532,6.1
54,29,Hancock,1998,15115,14274,841,5.6
54,31,Hardy,1998,6878,6586,292,4.2
54,33,Harrison,1998,34295,31833,2462,7.2
54,35,Jackson,1998,12916,11991,925,7.2
54,37,Jefferson,1998,20975,20317,658,3.1
54,39,Kanawha,1998,103944,99035,4909,4.7
54,41,Lewis,1998,6921,6335,586,8.5
54,43,Lincoln,1998,6909,6116,793,11.5
54,45,Logan,1998,14046,12503,1543,11.0
54,47,McDowell,1998,7454,6574,880,11.8
54,49,Marion,1998,23609,21744,1865,7.9
54,51,Marshall,1998,15912,14929,983,6.2
54,53,Mason,1998,8946,7846,1100,12.3
54,55,Mercer,1998,28024,26529,1495,5.3
54,57,Mineral,1998,12075,11235,840,7.0
54,59,Mingo,1998,8755,7565,1190,13.6
54,61,Monongalia,1998,37716,36375,1341,3.6
54,63,Monroe,1998,5152,4866,286,5.6
54,65,Morgan,1998,6012,5804,208,3.5
54,67,Nicholas,1998,10475,9531,944,9.0
54,69,Ohio,1998,24291,23202,1089,4.5
54,71,Pendleton,1998,3776,3637,139,3.7
54,73,Pleasants,1998,3301,2934,367,11.1
54,75,Pocahontas,1998,4267,3891,376,8.8
54,77,Preston,1998,12474,11600,874,7.0
54,79,Putnam,1998,26227,24994,1233,4.7
54,81,Raleigh,1998,34453,31887,2566,7.4
54,83,Randolph,1998,13139,11953,1186,9.0
54,85,Ritchie,1998,4119,3658,461,11.2
54,87,Roane,1998,6311,5594,717,11.4
54,89,Summers,1998,4338,3924,414,9.5
54,91,Taylor,1998,6941,6396,545,7.9
54,93,Tucker,1998,3539,3145,394,11.1
54,95,Tyler,1998,4085,3736,349,8.5
54,97,Upshur,1998,10524,9772,752,7.1
54,99,Wayne,1998,16761,15660,1101,6.6
54,101,Webster,1998,2999,2726,273,9.1
54,103,Wetzel,1998,7351,6584,767,10.4
54,105,Wirt,1998,1901,1621,280,14.7
54,107,Wood,1998,43728,40925,2803,6.4
54,109,Wyoming,1998,8386,7602,784,9.3
55,1,Adams,1998,8203,7853,350,4.3
55,3,Ashland,1998,8067,7452,615,7.6
55,5,Barron,1998,24526,23499,1027,4.2
55,7,Bayfield,1998,7481,6998,483,6.5
55,9,Brown,1998,133244,129695,3549,2.7
55,11,Buffalo,1998,8042,7802,240,3.0
55,13,Burnett,1998,7112,6819,293,4.1
55,15,Calumet,1998,25224,24544,680,2.7
55,17,Chippewa,1998,30885,29734,1151,3.7
55,19,Clark,1998,16780,15826,954,5.7
55,21,Columbia,1998,27481,26293,1188,4.3
55,23,Crawford,1998,10364,9970,394,3.8
55,25,Dane,1998,263009,259039,3970,1.5
55,27,Dodge,1998,48206,46875,1331,2.8
55,29,Door,1998,15723,14915,808,5.1
55,31,Douglas,1998,23158,22079,1079,4.7
55,33,Dunn,1998,22425,21714,711,3.2
55,35,Eau Claire,1998,52437,50914,1523,2.9
55,37,Florence,1998,1776,1656,120,6.8
55,39,Fond du Lac,1998,55093,53426,1667,3.0
55,41,Forest,1998,4620,4276,344,7.4
55,43,Grant,1998,24919,23930,989,4.0
55,45,Green,1998,19006,18381,625,3.3
55,47,Green Lake,1998,10672,10164,508,4.8
55,49,Iowa,1998,13969,13522,447,3.2
55,51,Iron,1998,3228,2979,249,7.7
55,53,Jackson,1998,11639,11169,470,4.0
55,55,Jefferson,1998,42107,40975,1132,2.7
55,57,Juneau,1998,10967,10251,716,6.5
55,59,Kenosha,1998,81663,78996,2667,3.3
55,61,Kewaunee,1998,11066,10702,364,3.3
55,63,La Crosse,1998,60827,59169,1658,2.7
55,65,Lafayette,1998,8117,7833,284,3.5
55,67,Langlade,1998,9478,8930,548,5.8
55,69,Lincoln,1998,15470,14735,735,4.8
55,71,Manitowoc,1998,45765,44204,1561,3.4
55,73,Marathon,1998,73737,71171,2566,3.5
55,75,Marinette,1998,21468,20237,1231,5.7
55,77,Marquette,1998,7171,6752,419,5.8
55,78,Menominee,1998,2524,2309,215,8.5
55,79,Milwaukee,1998,483757,465006,18751,3.9
55,81,Monroe,1998,19994,19128,866,4.3
55,83,Oconto,1998,15781,14984,797,5.1
55,85,Oneida,1998,20448,19502,946,4.6
55,87,Outagamie,1998,102010,99259,2751,2.7
55,89,Ozaukee,1998,48719,47681,1038,2.1
55,91,Pepin,1998,3443,3298,145,4.2
55,93,Pierce,1998,20667,20106,561,2.7
55,95,Polk,1998,22495,21600,895,4.0
55,97,Portage,1998,37658,36204,1454,3.9
55,99,Price,1998,7593,7111,482,6.3
55,101,Racine,1998,93600,89866,3734,4.0
55,103,Richland,1998,8898,8562,336,3.8
55,105,Rock,1998,80049,76832,3217,4.0
55,107,Rusk,1998,7164,6745,419,5.8
55,109,St. Croix,1998,33311,32439,872,2.6
55,111,Sauk,1998,33839,32716,1123,3.3
55,113,Sawyer,1998,9227,8663,564,6.1
55,115,Shawano,1998,21111,20261,850,4.0
55,117,Sheboygan,1998,61767,60326,1441,2.3
55,119,Taylor,1998,10495,9976,519,4.9
55,121,Trempealeau,1998,14530,13921,609,4.2
55,123,Vernon,1998,14064,13479,585,4.2
55,125,Vilas,1998,11141,10629,512,4.6
55,127,Walworth,1998,52407,51069,1338,2.6
55,129,Washburn,1998,7853,7395,458,5.8
55,131,Washington,1998,67877,66099,1778,2.6
55,133,Waukesha,1998,213675,208834,4841,2.3
55,135,Waupaca,1998,26834,25976,858,3.2
55,137,Waushara,1998,10601,10074,527,5.0
55,139,Winnebago,1998,96878,94313,2565,2.6
55,141,Wood,1998,40412,38628,1784,4.4
56,1,Albany,1998,17672,17303,369,2.1
56,3,Big Horn,1998,5819,5450,369,6.3
56,5,Campbell,1998,19352,18417,935,4.8
56,7,Carbon,1998,8354,7907,447,5.4
56,9,Converse,1998,6662,6312,350,5.3
56,11,Crook,1998,3011,2850,161,5.3
56,13,Fremont,1998,17729,16334,1395,7.9
56,15,Goshen,1998,6498,6196,302,4.6
56,17,Hot Springs,1998,2424,2313,111,4.6
56,19,Johnson,1998,3781,3627,154,4.1
56,21,Laramie,1998,39660,38239,1421,3.6
56,23,Lincoln,1998,6373,5974,399,6.3
56,25,Natrona,1998,33447,31642,1805,5.4
56,27,Niobrara,1998,1292,1256,36,2.8
56,29,Park,1998,15331,14625,706,4.6
56,31,Platte,1998,4493,4274,219,4.9
56,33,Sheridan,1998,13749,13042,707,5.1
56,35,Sublette,1998,3067,2969,98,3.2
56,37,Sweetwater,1998,21315,20167,1148,5.4
56,39,Teton,1998,11131,10900,231,2.1
56,41,Uinta,1998,10855,10238,617,5.7
56,43,Washakie,1998,4965,4671,294,5.9
56,45,Weston,1998,3293,3134,159,4.8
72,1,Adjuntas Municipio,1998,5810,4719,1091,18.8
72,3,Aguada Municipio,1998,15740,12747,2993,19.0
72,5,Aguadilla Municipio,1998,22693,18680,4013,17.7
72,7,Aguas Buenas Municipio,1998,9231,8038,1193,12.9
72,9,Aibonito Municipio,1998,10834,9550,1284,11.9
72,11,Anasco Municipio,1998,10911,8884,2027,18.6
72,13,Arecibo Municipio,1998,31069,25856,5213,16.8
72,15,Arroyo Municipio,1998,5459,4396,1063,19.5
72,17,Barceloneta Municipio,1998,8483,6796,1687,19.9
72,19,Barranquitas Municipio,1998,6864,5660,1204,17.5
72,21,Bayamon Municipio,1998,87335,79969,7366,8.4
72,23,Cabo Rojo Municipio,1998,16779,14702,2077,12.4
72,25,Caguas Municipio,1998,59336,52741,6595,11.1
72,27,Camuy Municipio,1998,9791,8373,1418,14.5
72,29,Canovanas Municipio,1998,17219,15108,2111,12.3
72,31,Carolina Municipio,1998,79965,72649,7316,9.1
72,33,Catano Municipio,1998,9985,9014,971,9.7
72,35,Cayey Municipio,1998,17453,15109,2344,13.4
72,37,Ceiba Municipio,1998,5713,4892,821,14.4
72,39,Ciales Municipio,1998,4456,3421,1035,23.2
72,41,Cidra Municipio,1998,16738,15040,1698,10.1
72,43,Coamo Municipio,1998,9535,7855,1680,17.6
72,45,Comerio Municipio,1998,5631,4950,681,12.1
72,47,Corozal Municipio,1998,9938,8967,971,9.8
72,49,Culebra Municipio,1998,807,749,58,7.2
72,51,Dorado Municipio,1998,10906,9761,1145,10.5
72,53,Fajardo Municipio,1998,13788,11392,2396,17.4
72,54,Florida Municipio,1998,2973,2271,702,23.6
72,55,Guanica Municipio,1998,6255,4839,1416,22.6
72,57,Guayama Municipio,1998,11564,9202,2362,20.4
72,59,Guayanilla Municipio,1998,7962,6737,1225,15.4
72,61,Guaynabo Municipio,1998,41733,39349,2384,5.7
72,63,Gurabo Municipio,1998,12203,10707,1496,12.3
72,65,Hatillo Municipio,1998,11320,9754,1566,13.8
72,67,Hormigueros Municipio,1998,7105,6189,916,12.9
72,69,Humacao Municipio,1998,20588,17071,3517,17.1
72,71,Isabela Municipio,1998,13769,10937,2832,20.6
72,73,Jayuya Municipio,1998,4181,3496,685,16.4
72,75,Juana Diaz Municipio,1998,14186,11453,2733,19.3
72,77,Juncos Municipio,1998,12749,11098,1651,13.0
72,79,Lajas Municipio,1998,8734,7244,1490,17.1
72,81,Lares Municipio,1998,9385,7836,1549,16.5
72,83,Las Marias Municipio,1998,3156,2485,671,21.3
72,85,Las Piedras Municipio,1998,10602,8967,1635,15.4
72,87,Loiza Municipio,1998,8433,7361,1072,12.7
72,89,Luquillo Municipio,1998,6633,5376,1257,19.0
72,91,Manati Municipio,1998,13949,11275,2674,19.2
72,93,Maricao Municipio,1998,2254,1853,401,17.8
72,95,Maunabo Municipio,1998,2988,2198,790,26.4
72,97,Mayaguez Municipio,1998,36660,30892,5768,15.7
72,99,Moca Municipio,1998,13333,10896,2437,18.3
72,101,Morovis Municipio,1998,9933,8361,1572,15.8
72,103,Naguabo Municipio,1998,7262,6058,1204,16.6
72,105,Naranjito Municipio,1998,7195,6304,891,12.4
72,107,Orocovis Municipio,1998,5555,4549,1006,18.1
72,109,Patillas Municipio,1998,6122,4868,1254,20.5
72,111,Penuelas Municipio,1998,7933,6341,1592,20.1
72,113,Ponce Municipio,1998,59783,50837,8946,15.0
72,115,Quebradillas Municipio,1998,8077,7015,1062,13.1
72,117,Rincon Municipio,1998,5774,4790,984,17.0
72,119,Rio Grande Municipio,1998,17689,15097,2592,14.7
72,121,Sabana Grande Municipio,1998,8542,7216,1326,15.5
72,123,Salinas Municipio,1998,8280,6553,1727,20.9
72,125,San German Municipio,1998,13572,11184,2388,17.6
72,127,San Juan Municipio,1998,164682,149729,14953,9.1
72,129,San Lorenzo Municipio,1998,13056,10732,2324,17.8
72,131,San Sebastian Municipio,1998,13049,9849,3200,24.5
72,133,Santa Isabel Municipio,1998,6096,4632,1464,24.0
72,135,Toa Alta Municipio,1998,20578,18938,1640,8.0
72,137,Toa Baja Municipio,1998,35374,32374,3000,8.5
72,139,Trujillo Alto Municipio,1998,30187,28169,2018,6.7
72,141,Utuado Municipio,1998,8737,7349,1388,15.9
72,143,Vega Alta Municipio,1998,11444,10137,1307,11.4
72,145,Vega Baja Municipio,1998,20719,16863,3856,18.6
72,147,Vieques Municipio,1998,2677,2381,296,11.1
72,149,Villalba Municipio,1998,6146,4845,1301,21.2
72,151,Yabucoa Municipio,1998,12987,10178,2809,21.6
72,153,Yauco Municipio,1998,14106,11209,2897,20.5
1,1,Autauga,1999,22533,21678,855,3.8
1,3,Baldwin,1999,71240,68880,2360,3.3
1,5,Barbour,1999,13423,12779,644,4.8
1,7,Bibb,1999,7217,6726,491,6.8
1,9,Blount,1999,24079,23407,672,2.8
1,11,Bullock,1999,4473,4028,445,9.9
1,13,Butler,1999,9908,8560,1348,13.6
1,15,Calhoun,1999,54606,51831,2775,5.1
1,17,Chambers,1999,16522,15749,773,4.7
1,19,Cherokee,1999,10222,9720,502,4.9
1,21,Chilton,1999,18691,17981,710,3.8
1,23,Choctaw,1999,5828,5295,533,9.1
1,25,Clarke,1999,13637,12470,1167,8.6
1,27,Clay,1999,6653,6293,360,5.4
1,29,Cleburne,1999,7263,6951,312,4.3
1,31,Coffee,1999,21986,20951,1035,4.7
1,33,Colbert,1999,25466,23648,1818,7.1
1,35,Conecuh,1999,5927,5376,551,9.3
1,37,Coosa,1999,5293,5000,293,5.5
1,39,Covington,1999,17140,15741,1399,8.2
1,41,Crenshaw,1999,5411,4812,599,11.1
1,43,Cullman,1999,39673,38123,1550,3.9
1,45,Dale,1999,21361,20331,1030,4.8
1,47,Dallas,1999,19693,17546,2147,10.9
1,49,DeKalb,1999,32623,31353,1270,3.9
1,51,Elmore,1999,30652,29632,1020,3.3
1,53,Escambia,1999,16536,15488,1048,6.3
1,55,Etowah,1999,49659,46219,3440,6.9
1,57,Fayette,1999,7884,7121,763,9.7
1,59,Franklin,1999,16904,15666,1238,7.3
1,61,Geneva,1999,10724,9920,804,7.5
1,63,Greene,1999,3108,2724,384,12.4
1,65,Hale,1999,7048,6519,529,7.5
1,67,Henry,1999,6457,6121,336,5.2
1,69,Houston,1999,45339,43653,1686,3.7
1,71,Jackson,1999,25812,24112,1700,6.6
1,73,Jefferson,1999,334042,322633,11409,3.4
1,75,Lamar,1999,7217,6540,677,9.4
1,77,Lauderdale,1999,41262,38671,2591,6.3
1,79,Lawrence,1999,16652,15666,986,5.9
1,81,Lee,1999,48988,47273,1715,3.5
1,83,Limestone,1999,29133,28075,1058,3.6
1,85,Lowndes,1999,4171,3650,521,12.5
1,87,Macon,1999,7699,7052,647,8.4
1,89,Madison,1999,143647,138984,4663,3.2
1,91,Marengo,1999,11113,10531,582,5.2
1,93,Marion,1999,16159,14869,1290,8.0
1,95,Marshall,1999,40214,37729,2485,6.2
1,97,Mobile,1999,199797,189686,10111,5.1
1,99,Monroe,1999,9685,8530,1155,11.9
1,101,Montgomery,1999,110684,106529,4155,3.8
1,103,Morgan,1999,56823,54404,2419,4.3
1,105,Perry,1999,4595,4173,422,9.2
1,107,Pickens,1999,8611,7719,892,10.4
1,109,Pike,1999,13728,12983,745,5.4
1,111,Randolph,1999,9325,8770,555,6.0
1,113,Russell,1999,25720,24478,1242,4.8
1,115,St. Clair,1999,31620,30530,1090,3.4
1,117,Shelby,1999,83020,81650,1370,1.7
1,119,Sumter,1999,5524,4928,596,10.8
1,121,Talladega,1999,34439,32367,2072,6.0
1,123,Tallapoosa,1999,19956,18921,1035,5.2
1,125,Tuscaloosa,1999,83986,81516,2470,2.9
1,127,Walker,1999,28779,26991,1788,6.2
1,129,Washington,1999,6008,5281,727,12.1
1,131,Wilcox,1999,3825,3283,542,14.2
1,133,Winston,1999,12465,11678,787,6.3
2,13,Aleutians East Borough,1999,1560,1504,56,3.6
2,16,Aleutians West Census Area,1999,2036,1899,137,6.7
2,20,Anchorage Borough/municipality,1999,142335,135852,6483,4.6
2,50,Bethel Census Area,1999,6337,5797,540,8.5
2,60,Bristol Bay Borough,1999,502,456,46,9.2
2,68,Denali Borough,1999,1149,1051,98,8.5
2,70,Dillingham Census Area,1999,1813,1680,133,7.3
2,90,Fairbanks North Star Borough,1999,43606,40995,2611,6.0
2,100,Haines Borough,1999,1246,1112,134,10.8
2,110,Juneau Borough/city,1999,17170,16310,860,5.0
2,122,Kenai Peninsula Borough,1999,21994,19576,2418,11.0
2,130,Ketchikan Gateway Borough,1999,7607,7063,544,7.2
2,150,Kodiak Island Borough,1999,6834,6337,497,7.3
2,158,Kusilvak Census Area,1999,2200,1879,321,14.6
2,164,Lake and Peninsula Borough,1999,612,566,46,7.5
2,170,Matanuska-Susitna Borough,1999,29748,27302,2446,8.2
2,180,Nome Census Area,1999,3151,2785,366,11.6
2,185,North Slope Borough,1999,3117,2869,248,8.0
2,188,Northwest Arctic Borough,1999,2055,1773,282,13.7
2,201,Prince of Wales-Outer Ketchikan Census Area,1999,3213,2785,428,13.3
2,220,Sitka Borough/city,1999,4327,4100,227,5.2
2,232,Skagway-Hoonah-Angoon Census Area,1999,2077,1925,152,7.3
2,240,Southeast Fairbanks Census Area,1999,2575,2315,260,10.1
2,261,Valdez-Cordova Census Area,1999,5082,4625,457,9.0
2,280,Wrangell-Petersburg Census Area,1999,3543,3231,312,8.8
2,282,Yakutat Borough/city,1999,302,276,26,8.6
2,290,Yukon-Koyukuk Census Area,1999,2105,1811,294,14.0
4,1,Apache,1999,22786,19532,3254,14.3
4,3,Cochise,1999,41772,39331,2441,5.8
4,5,Coconino,1999,62845,58533,4312,6.9
4,7,Gila,1999,18910,17529,1381,7.3
4,9,Graham,1999,11247,10276,971,8.6
4,11,Greenlee,1999,4408,4017,391,8.9
4,12,La Paz,1999,7263,6667,596,8.2
4,13,Maricopa,1999,1589856,1542094,47762,3.0
4,15,Mohave,1999,65841,62713,3128,4.8
4,17,Navajo,1999,33877,29333,4544,13.4
4,19,Pima,1999,404731,391894,12837,3.2
4,21,Pinal,1999,63506,59990,3516,5.5
4,23,Santa Cruz,1999,14269,11856,2413,16.9
4,25,Yavapai,1999,71019,68565,2454,3.5
4,27,Yuma,1999,70219,49238,20981,29.9
5,1,Arkansas,1999,10850,10313,537,4.9
5,3,Ashley,1999,11046,10148,898,8.1
5,5,Baxter,1999,14511,13952,559,3.9
5,7,Benton,1999,68822,67290,1532,2.2
5,9,Boone,1999,14893,14075,818,5.5
5,11,Bradley,1999,4485,4083,402,9.0
5,13,Calhoun,1999,2295,2084,211,9.2
5,15,Carroll,1999,11876,11350,526,4.4
5,17,Chicot,1999,6386,5800,586,9.2
5,19,Clark,1999,11947,11598,349,2.9
5,21,Clay,1999,8177,7651,526,6.4
5,23,Cleburne,1999,9729,9352,377,3.9
5,25,Cleveland,1999,3811,3597,214,5.6
5,27,Columbia,1999,11590,10881,709,6.1
5,29,Conway,1999,9331,8688,643,6.9
5,31,Craighead,1999,43346,41931,1415,3.3
5,33,Crawford,1999,25111,24226,885,3.5
5,35,Crittenden,1999,22984,21983,1001,4.4
5,37,Cross,1999,8201,7667,534,6.5
5,39,Dallas,1999,3611,3328,283,7.8
5,41,Desha,1999,7170,6502,668,9.3
5,43,Drew,1999,10027,9355,672,6.7
5,45,Faulkner,1999,43329,41980,1349,3.1
5,47,Franklin,1999,7726,7459,267,3.5
5,49,Fulton,1999,4198,4032,166,4.0
5,51,Garland,1999,36496,34854,1642,4.5
5,53,Grant,1999,7466,7135,331,4.4
5,55,Greene,1999,18797,17888,909,4.8
5,57,Hempstead,1999,11569,10918,651,5.6
5,59,Hot Spring,1999,12322,11783,539,4.4
5,61,Howard,1999,6973,6602,371,5.3
5,63,Independence,1999,17290,16476,814,4.7
5,65,Izard,1999,4378,4198,180,4.1
5,67,Jackson,1999,8026,7251,775,9.7
5,69,Jefferson,1999,37020,34221,2799,7.6
5,71,Johnson,1999,10773,10379,394,3.7
5,73,Lafayette,1999,3482,3221,261,7.5
5,75,Lawrence,1999,7436,6952,484,6.5
5,77,Lee,1999,4611,4267,344,7.5
5,79,Lincoln,1999,5381,5100,281,5.2
5,81,Little River,1999,5606,5271,335,6.0
5,83,Logan,1999,9722,9216,506,5.2
5,85,Lonoke,1999,26444,25787,657,2.5
5,87,Madison,1999,6760,6524,236,3.5
5,89,Marion,1999,6250,6053,197,3.2
5,91,Miller,1999,17624,16653,971,5.5
5,93,Mississippi,1999,27076,24134,2942,10.9
5,95,Monroe,1999,4089,3807,282,6.9
5,97,Montgomery,1999,4040,3894,146,3.6
5,99,Nevada,1999,5010,4713,297,5.9
5,101,Newton,1999,2987,2811,176,5.9
5,103,Ouachita,1999,11520,10499,1021,8.9
5,105,Perry,1999,3643,3420,223,6.1
5,107,Phillips,1999,9639,8896,743,7.7
5,109,Pike,1999,4950,4717,233,4.7
5,111,Poinsett,1999,10675,10031,644,6.0
5,113,Polk,1999,9415,9052,363,3.9
5,115,Pope,1999,27525,26325,1200,4.4
5,117,Prairie,1999,4002,3778,224,5.6
5,119,Pulaski,1999,195021,188329,6692,3.4
5,121,Randolph,1999,7967,7427,540,6.8
5,123,St. Francis,1999,12468,11342,1126,9.0
5,125,Saline,1999,42397,41303,1094,2.6
5,127,Scott,1999,4994,4861,133,2.7
5,129,Searcy,1999,3000,2779,221,7.4
5,131,Sebastian,1999,56500,54575,1925,3.4
5,133,Sevier,1999,6953,6638,315,4.5
5,135,Sharp,1999,6310,5991,319,5.1
5,137,Stone,1999,5237,4985,252,4.8
5,139,Union,1999,21132,19862,1270,6.0
5,141,Van Buren,1999,6216,5861,355,5.7
5,143,Washington,1999,78728,76722,2006,2.5
5,145,White,1999,32055,30543,1512,4.7
5,147,Woodruff,1999,3947,3542,405,10.3
5,149,Yell,1999,9447,9071,376,4.0
6,1,Alameda,1999,715700,690619,25081,3.5
6,3,Alpine,1999,494,448,46,9.3
6,5,Amador,1999,13551,12918,633,4.7
6,7,Butte,1999,85712,79837,5875,6.9
6,9,Calaveras,1999,14498,13478,1020,7.0
6,11,Colusa,1999,8739,7339,1400,16.0
6,13,Contra Costa,1999,487305,472338,14967,3.1
6,15,Del Norte,1999,9892,9093,799,8.1
6,17,El Dorado,1999,79398,76275,3123,3.9
6,19,Fresno,1999,378465,326958,51507,13.6
6,21,Glenn,1999,10412,9233,1179,11.3
6,23,Humboldt,1999,59919,56021,3898,6.5
6,25,Imperial,1999,55353,42214,13139,23.7
6,27,Inyo,1999,7148,6737,411,5.7
6,29,Kern,1999,279360,247224,32136,11.5
6,31,Kings,1999,42957,37271,5686,13.2
6,33,Lake,1999,23593,21741,1852,7.8
6,35,Lassen,1999,11083,10297,786,7.1
6,37,Los Angeles,1999,4575741,4305175,270566,5.9
6,39,Madera,1999,52920,46733,6187,11.7
6,41,Marin,1999,134409,131769,2640,2.0
6,43,Mariposa,1999,6658,6160,498,7.5
6,45,Mendocino,1999,41632,38791,2841,6.8
6,47,Merced,1999,83885,72576,11309,13.5
6,49,Modoc,1999,4000,3655,345,8.6
6,51,Mono,1999,6150,5733,417,6.8
6,53,Monterey,1999,187901,169691,18210,9.7
6,55,Napa,1999,62299,60227,2072,3.3
6,57,Nevada,1999,43605,41812,1793,4.1
6,59,Orange,1999,1463186,1423834,39352,2.7
6,61,Placer,1999,120140,116222,3918,3.3
6,63,Plumas,1999,9450,8591,859,9.1
6,65,Riverside,1999,692556,654371,38185,5.5
6,67,Sacramento,1999,582982,558096,24886,4.3
6,69,San Benito,1999,26287,24151,2136,8.1
6,71,San Bernardino,1999,750160,713517,36643,4.9
6,73,San Diego,1999,1353815,1311447,42368,3.1
6,75,San Francisco/city,1999,418504,405586,12918,3.1
6,77,San Joaquin,1999,250700,228414,22286,8.9
6,79,San Luis Obispo,1999,111416,107765,3651,3.3
6,81,San Mateo,1999,395944,388054,7890,2.0
6,83,Santa Barbara,1999,197988,190207,7781,3.9
6,85,Santa Clara,1999,959967,930487,29480,3.1
6,87,Santa Cruz,1999,139038,130144,8894,6.4
6,89,Shasta,1999,72299,67152,5147,7.1
6,91,Sierra,1999,1626,1476,150,9.2
6,93,Siskiyou,1999,17622,15783,1839,10.4
6,95,Solano,1999,189292,180492,8800,4.6
6,97,Sonoma,1999,249378,242582,6796,2.7
6,99,Stanislaus,1999,202539,180942,21597,10.7
6,101,Sutter,1999,35670,30980,4690,13.1
6,103,Tehama,1999,24207,22561,1646,6.8
6,105,Trinity,1999,4862,4296,566,11.6
6,107,Tulare,1999,165180,137649,27531,16.7
6,109,Tuolumne,1999,19862,18548,1314,6.6
6,111,Ventura,1999,395237,376077,19160,4.8
6,113,Yolo,1999,90921,86921,4000,4.4
6,115,Yuba,1999,20530,18113,2417,11.8
8,1,Adams,1999,183321,178195,5126,2.8
8,3,Alamosa,1999,8316,7876,440,5.3
8,5,Arapahoe,1999,293213,286716,6497,2.2
8,7,Archuleta,1999,4750,4559,191,4.0
8,9,Baca,1999,2382,2322,60,2.5
8,11,Bent,1999,2246,2169,77,3.4
8,13,Boulder,1999,169568,164837,4731,2.8
8,14,Broomfield/city,1999,19208,18823,385,2.0
8,15,Chaffee,1999,7909,7649,260,3.3
8,17,Cheyenne,1999,1289,1242,47,3.6
8,19,Clear Creek,1999,5363,5205,158,2.9
8,21,Conejos,1999,3771,3493,278,7.4
8,23,Costilla,1999,1396,1233,163,11.7
8,25,Crowley,1999,1381,1320,61,4.4
8,27,Custer,1999,1818,1773,45,2.5
8,29,Delta,1999,11194,10666,528,4.7
8,31,Denver/city,1999,284839,275605,9234,3.2
8,33,Dolores,1999,721,660,61,8.5
8,35,Douglas,1999,95804,94454,1350,1.4
8,37,Eagle,1999,21457,20899,558,2.6
8,39,Elbert,1999,12441,12084,357,2.9
8,41,El Paso,1999,267248,258055,9193,3.4
8,43,Fremont,1999,17915,17190,725,4.0
8,45,Garfield,1999,23648,22967,681,2.9
8,47,Gilpin,1999,3365,3289,76,2.3
8,49,Grand,1999,6178,6033,145,2.3
8,51,Gunnison,1999,8283,7876,407,4.9
8,53,Hinsdale,1999,639,623,16,2.5
8,55,Huerfano,1999,3773,3561,212,5.6
8,57,Jackson,1999,920,875,45,4.9
8,59,Jefferson,1999,315017,307907,7110,2.3
8,61,Kiowa,1999,856,820,36,4.2
8,63,Kit Carson,1999,3775,3689,86,2.3
8,65,Lake,1999,3255,3087,168,5.2
8,67,La Plata,1999,25006,24014,992,4.0
8,69,Larimer,1999,145302,140666,4636,3.2
8,71,Las Animas,1999,6875,6507,368,5.4
8,73,Lincoln,1999,2707,2665,42,1.6
8,75,Logan,1999,10191,9845,346,3.4
8,77,Mesa,1999,60560,58201,2359,3.9
8,79,Mineral,1999,435,422,13,3.0
8,81,Moffat,1999,6443,6076,367,5.7
8,83,Montezuma,1999,12083,11462,621,5.1
8,85,Montrose,1999,15922,15048,874,5.5
8,87,Morgan,1999,13118,12698,420,3.2
8,89,Otero,1999,9061,8619,442,4.9
8,91,Ouray,1999,1868,1798,70,3.7
8,93,Park,1999,8281,8024,257,3.1
8,95,Phillips,1999,2100,2064,36,1.7
8,97,Pitkin,1999,9246,8930,316,3.4
8,99,Prowers,1999,7245,7025,220,3.0
8,101,Pueblo,1999,62145,59047,3098,5.0
8,103,Rio Blanco,1999,3159,3030,129,4.1
8,105,Rio Grande,1999,5151,4778,373,7.2
8,107,Routt,1999,11579,11253,326,2.8
8,109,Saguache,1999,2855,2608,247,8.7
8,111,San Juan,1999,298,262,36,12.1
8,113,San Miguel,1999,4756,4550,206,4.3
8,115,Sedgwick,1999,1229,1198,31,2.5
8,117,Summit,1999,13196,12896,300,2.3
8,119,Teller,1999,13890,13405,485,3.5
8,121,Washington,1999,2443,2382,61,2.5
8,123,Weld,1999,88571,85282,3289,3.7
8,125,Yuma,1999,4579,4466,113,2.5
9,1,Fairfield,1999,454159,444035,10124,2.2
9,3,Hartford,1999,423448,412017,11431,2.7
9,5,Litchfield,1999,102077,99973,2104,2.1
9,7,Middlesex,1999,83898,82114,1784,2.1
9,9,New Haven,1999,418668,407636,11032,2.6
9,11,New London,1999,133771,130344,3427,2.6
9,13,Tolland,1999,71287,69963,1324,1.9
9,15,Windham,1999,56717,55084,1633,2.9
10,1,Kent,1999,70152,67656,2496,3.6
10,3,New Castle,1999,258109,250382,7727,3.0
10,5,Sussex,1999,71860,68968,2892,4.0
11,1,District of Colu,1999,305391,285335,20056,6.6
12,1,Alachua,1999,109850,107345,2505,2.3
12,3,Baker,1999,9115,8793,322,3.5
12,5,Bay,1999,69036,64552,4484,6.5
12,7,Bradford,1999,10113,9755,358,3.5
12,9,Brevard,1999,215386,206450,8936,4.1
12,11,Broward,1999,802284,767579,34705,4.3
12,13,Calhoun,1999,5026,4675,351,7.0
12,15,Charlotte,1999,50268,48581,1687,3.4
12,17,Citrus,1999,37903,36040,1863,4.9
12,19,Clay,1999,74462,72428,2034,2.7
12,21,Collier,1999,99582,95629,3953,4.0
12,23,Columbia,1999,25382,24202,1180,4.6
12,27,DeSoto,1999,9237,8604,633,6.9
12,29,Dixie,1999,3860,3647,213,5.5
12,31,Duval,1999,398748,385547,13201,3.3
12,33,Escambia,1999,125405,120650,4755,3.8
12,35,Flagler,1999,18351,17725,626,3.4
12,37,Franklin,1999,4761,4528,233,4.9
12,39,Gadsden,1999,20641,19856,785,3.8
12,41,Gilchrist,1999,4676,4483,193,4.1
12,43,Glades,1999,3975,3668,307,7.7
12,45,Gulf,1999,5558,4756,802,14.4
12,47,Hamilton,1999,3569,3323,246,6.9
12,49,Hardee,1999,9862,8803,1059,10.7
12,51,Hendry,1999,16356,14229,2127,13.0
12,53,Hernando,1999,49902,48135,1767,3.5
12,55,Highlands,1999,27071,25112,1959,7.2
12,57,Hillsborough,1999,573993,558031,15962,2.8
12,59,Holmes,1999,6839,6440,399,5.8
12,61,Indian River,1999,47430,43649,3781,8.0
12,63,Jackson,1999,18674,17407,1267,6.8
12,65,Jefferson,1999,5062,4835,227,4.5
12,67,Lafayette,1999,3066,2993,73,2.4
12,69,Lake,1999,96141,93540,2601,2.7
12,71,Lee,1999,187066,181944,5122,2.7
12,73,Leon,1999,135649,132095,3554,2.6
12,75,Levy,1999,13480,13026,454,3.4
12,77,Liberty,1999,2403,2282,121,5.0
12,79,Madison,1999,7716,7417,299,3.9
12,81,Manatee,1999,125736,122766,2970,2.4
12,83,Marion,1999,102650,98677,3973,3.9
12,85,Martin,1999,50503,47842,2661,5.3
12,86,Miami-Dade,1999,1094656,1040611,54045,4.9
12,87,Monroe,1999,47918,46778,1140,2.4
12,89,Nassau,1999,30153,29091,1062,3.5
12,91,Okaloosa,1999,84220,81286,2934,3.5
12,93,Okeechobee,1999,16513,15190,1323,8.0
12,95,Orange,1999,510156,495243,14913,2.9
12,97,Osceola,1999,88313,85785,2528,2.9
12,99,Palm Beach,1999,529882,501422,28460,5.4
12,101,Pasco,1999,142695,137960,4735,3.3
12,103,Pinellas,1999,487519,473376,14143,2.9
12,105,Polk,1999,209898,199031,10867,5.2
12,107,Putnam,1999,29086,27531,1555,5.3
12,109,St. Johns,1999,64262,62619,1643,2.6
12,111,St. Lucie,1999,81393,73563,7830,9.6
12,113,Santa Rosa,1999,55790,53489,2301,4.1
12,115,Sarasota,1999,157212,153597,3615,2.3
12,117,Seminole,1999,226583,220127,6456,2.8
12,119,Sumter,1999,14806,14370,436,2.9
12,121,Suwannee,1999,13875,13299,576,4.2
12,123,Taylor,1999,7638,7052,586,7.7
12,125,Union,1999,3597,3497,100,2.8
12,127,Volusia,1999,181440,175443,5997,3.3
12,129,Wakulla,1999,11450,11081,369,3.2
12,131,Walton,1999,16579,15931,648,3.9
12,133,Washington,1999,10054,9617,437,4.3
13,1,Appling,1999,8238,7451,787,9.6
13,3,Atkinson,1999,3369,3170,199,5.9
13,5,Bacon,1999,4311,4013,298,6.9
13,7,Baker,1999,1633,1523,110,6.7
13,9,Baldwin,1999,17714,16687,1027,5.8
13,11,Banks,1999,6404,6173,231,3.6
13,13,Barrow,1999,21399,20786,613,2.9
13,15,Bartow,1999,40357,38826,1531,3.8
13,17,Ben Hill,1999,9622,9036,586,6.1
13,19,Berrien,1999,6832,6394,438,6.4
13,21,Bibb,1999,70621,67062,3559,5.0
13,23,Bleckley,1999,5776,5531,245,4.2
13,25,Brantley,1999,5955,5560,395,6.6
13,27,Brooks,1999,7731,7398,333,4.3
13,29,Bryan,1999,11312,10958,354,3.1
13,31,Bulloch,1999,26739,26080,659,2.5
13,33,Burke,1999,8759,7945,814,9.3
13,35,Butts,1999,8581,8231,350,4.1
13,37,Calhoun,1999,2425,2215,210,8.7
13,39,Camden,1999,17008,16405,603,3.5
13,43,Candler,1999,4100,3883,217,5.3
13,45,Carroll,1999,45077,43127,1950,4.3
13,47,Catoosa,1999,27297,26467,830,3.0
13,49,Charlton,1999,3853,3683,170,4.4
13,51,Chatham,1999,107620,103066,4554,4.2
13,53,Chattahoochee,1999,2455,2294,161,6.6
13,55,Chattooga,1999,12113,11647,466,3.8
13,57,Cherokee,1999,82115,80530,1585,1.9
13,59,Clarke,1999,46836,45571,1265,2.7
13,61,Clay,1999,1560,1462,98,6.3
13,63,Clayton,1999,125135,120921,4214,3.4
13,65,Clinch,1999,3496,3375,121,3.5
13,67,Cobb,1999,359440,350593,8847,2.5
13,69,Coffee,1999,21000,20021,979,4.7
13,71,Colquitt,1999,19487,18321,1166,6.0
13,73,Columbia,1999,45705,44344,1361,3.0
13,75,Cook,1999,7918,7546,372,4.7
13,77,Coweta,1999,46469,45227,1242,2.7
13,79,Crawford,1999,5675,5437,238,4.2
13,81,Crisp,1999,9971,9406,565,5.7
13,83,Dade,1999,7584,7312,272,3.6
13,85,Dawson,1999,10411,10145,266,2.6
13,87,Decatur,1999,12022,11378,644,5.4
13,89,DeKalb,1999,361909,348275,13634,3.8
13,91,Dodge,1999,9853,9367,486,4.9
13,93,Dooly,1999,4722,4424,298,6.3
13,95,Dougherty,1999,45495,41858,3637,8.0
13,97,Douglas,1999,52458,51003,1455,2.8
13,99,Early,1999,4718,4315,403,8.5
13,101,Echols,1999,1274,1219,55,4.3
13,103,Effingham,1999,18674,18092,582,3.1
13,105,Elbert,1999,8832,8200,632,7.2
13,107,Emanuel,1999,8696,7815,881,10.1
13,109,Evans,1999,4844,4661,183,3.8
13,111,Fannin,1999,8945,8560,385,4.3
13,113,Fayette,1999,50989,50094,895,1.8
13,115,Floyd,1999,45429,43326,2103,4.6
13,117,Forsyth,1999,55080,54237,843,1.5
13,119,Franklin,1999,10278,9947,331,3.2
13,121,Fulton,1999,405637,390650,14987,3.7
13,123,Gilmer,1999,8423,8122,301,3.6
13,125,Glascock,1999,992,924,68,6.9
13,127,Glynn,1999,35938,34805,1133,3.2
13,129,Gordon,1999,22507,21404,1103,4.9
13,131,Grady,1999,9320,8505,815,8.7
13,133,Greene,1999,5922,5582,340,5.7
13,135,Gwinnett,1999,341940,334222,7718,2.3
13,137,Habersham,1999,15955,15406,549,3.4
13,139,Hall,1999,72327,70528,1799,2.5
13,141,Hancock,1999,3996,3508,488,12.2
13,143,Haralson,1999,9617,9163,454,4.7
13,145,Harris,1999,12289,11964,325,2.6
13,147,Hart,1999,9705,9323,382,3.9
13,149,Heard,1999,4840,4534,306,6.3
13,151,Henry,1999,63138,61934,1204,1.9
13,153,Houston,1999,50396,48482,1914,3.8
13,155,Irwin,1999,5051,4827,224,4.4
13,157,Jackson,1999,22548,21765,783,3.5
13,159,Jasper,1999,4813,4631,182,3.8
13,161,Jeff Davis,1999,5358,4993,365,6.8
13,163,Jefferson,1999,7522,6553,969,12.9
13,165,Jenkins,1999,4502,4299,203,4.5
13,167,Johnson,1999,3557,3258,299,8.4
13,169,Jones,1999,11704,11224,480,4.1
13,171,Lamar,1999,6913,6521,392,5.7
13,173,Lanier,1999,3583,3442,141,3.9
13,175,Laurens,1999,22939,21206,1733,7.6
13,177,Lee,1999,12171,11638,533,4.4
13,179,Liberty,1999,17188,16152,1036,6.0
13,181,Lincoln,1999,3463,3099,364,10.5
13,183,Long,1999,3668,3563,105,2.9
13,185,Lowndes,1999,43451,41608,1843,4.2
13,187,Lumpkin,1999,10878,10650,228,2.1
13,189,McDuffie,1999,9886,9248,638,6.5
13,191,McIntosh,1999,4605,4417,188,4.1
13,193,Macon,1999,5372,4910,462,8.6
13,195,Madison,1999,13813,13405,408,3.0
13,197,Marion,1999,3441,3272,169,4.9
13,199,Meriwether,1999,9189,8685,504,5.5
13,201,Miller,1999,3195,3046,149,4.7
13,205,Mitchell,1999,11956,11054,902,7.5
13,207,Monroe,1999,7727,7316,411,5.3
13,209,Montgomery,1999,3876,3503,373,9.6
13,211,Morgan,1999,7214,6946,268,3.7
13,213,Murray,1999,19437,18840,597,3.1
13,215,Muscogee,1999,87829,83211,4618,5.3
13,217,Newton,1999,30511,29519,992,3.3
13,219,Oconee,1999,13673,13479,194,1.4
13,221,Oglethorpe,1999,6067,5881,186,3.1
13,223,Paulding,1999,42994,42146,848,2.0
13,225,Peach,1999,10926,10308,618,5.7
13,227,Pickens,1999,11118,10843,275,2.5
13,229,Pierce,1999,7428,7051,377,5.1
13,231,Pike,1999,6452,6198,254,3.9
13,233,Polk,1999,16316,15397,919,5.6
13,235,Pulaski,1999,4635,4416,219,4.7
13,237,Putnam,1999,9623,9306,317,3.3
13,239,Quitman,1999,1276,1229,47,3.7
13,241,Rabun,1999,7363,7162,201,2.7
13,243,Randolph,1999,3219,2940,279,8.7
13,245,Richmond,1999,81532,76582,4950,6.1
13,247,Rockdale,1999,39495,38540,955,2.4
13,249,Schley,1999,1829,1748,81,4.4
13,251,Screven,1999,5933,5514,419,7.1
13,253,Seminole,1999,4488,4282,206,4.6
13,255,Spalding,1999,29405,28232,1173,4.0
13,257,Stephens,1999,12070,11496,574,4.8
13,259,Stewart,1999,2352,2216,136,5.8
13,261,Sumter,1999,15536,14610,926,6.0
13,263,Talbot,1999,2866,2689,177,6.2
13,265,Taliaferro,1999,763,722,41,5.4
13,267,Tattnall,1999,7381,6966,415,5.6
13,269,Taylor,1999,3911,3677,234,6.0
13,271,Telfair,1999,4956,4383,573,11.6
13,273,Terrell,1999,3973,3590,383,9.6
13,275,Thomas,1999,22086,20977,1109,5.0
13,277,Tift,1999,20859,19865,994,4.8
13,279,Toombs,1999,12735,11506,1229,9.7
13,281,Towns,1999,4012,3855,157,3.9
13,283,Treutlen,1999,2946,2584,362,12.3
13,285,Troup,1999,30920,29494,1426,4.6
13,287,Turner,1999,4324,3898,426,9.9
13,289,Twiggs,1999,4131,3859,272,6.6
13,291,Union,1999,7729,7479,250,3.2
13,293,Upson,1999,13064,12139,925,7.1
13,295,Walker,1999,31929,30706,1223,3.8
13,297,Walton,1999,30106,29158,948,3.1
13,299,Ware,1999,15544,14754,790,5.1
13,301,Warren,1999,2676,2405,271,10.1
13,303,Washington,1999,9813,9109,704,7.2
13,305,Wayne,1999,11850,11116,734,6.2
13,307,Webster,1999,1165,1106,59,5.1
13,309,Wheeler,1999,2061,1832,229,11.1
13,311,White,1999,9336,8927,409,4.4
13,313,Whitfield,1999,46388,45215,1173,2.5
13,315,Wilcox,1999,3448,3265,183,5.3
13,317,Wilkes,1999,5657,5341,316,5.6
13,319,Wilkinson,1999,4690,4276,414,8.8
13,321,Worth,1999,9410,8727,683,7.3
15,1,Hawaii,1999,70490,64782,5708,8.1
15,3,Honolulu/city,1999,431115,411392,19723,4.6
15,7,Kauai,1999,29377,27279,2098,7.1
15,9,Maui,1999,72688,68844,3844,5.3
16,1,Ada,1999,166743,161479,5264,3.2
16,3,Adams,1999,1617,1382,235,14.5
16,5,Bannock,1999,39368,37359,2009,5.1
16,7,Bear Lake,1999,2959,2827,132,4.5
16,9,Benewah,1999,4436,3894,542,12.2
16,11,Bingham,1999,21977,20900,1077,4.9
16,13,Blaine,1999,11133,10729,404,3.6
16,15,Boise,1999,2475,2293,182,7.4
16,17,Bonner,1999,17463,15850,1613,9.2
16,19,Bonneville,1999,46566,44929,1637,3.5
16,21,Boundary,1999,4482,4084,398,8.9
16,23,Butte,1999,1599,1537,62,3.9
16,25,Camas,1999,412,395,17,4.1
16,27,Canyon,1999,63739,60777,2962,4.6
16,29,Caribou,1999,3111,2929,182,5.9
16,31,Cassia,1999,9691,9057,634,6.5
16,33,Clark,1999,555,536,19,3.4
16,35,Clearwater,1999,4084,3551,533,13.1
16,37,Custer,1999,2007,1850,157,7.8
16,39,Elmore,1999,9254,8670,584,6.3
16,41,Franklin,1999,4651,4492,159,3.4
16,43,Fremont,1999,4827,4506,321,6.7
16,45,Gem,1999,6273,5854,419,6.7
16,47,Gooding,1999,6630,6400,230,3.5
16,49,Idaho,1999,6277,5626,651,10.4
16,51,Jefferson,1999,10316,9875,441,4.3
16,53,Jerome,1999,8968,8576,392,4.4
16,55,Kootenai,1999,55944,51624,4320,7.7
16,57,Latah,1999,14905,14433,472,3.2
16,59,Lemhi,1999,3861,3561,300,7.8
16,61,Lewis,1999,1543,1442,101,6.5
16,63,Lincoln,1999,1873,1775,98,5.2
16,65,Madison,1999,10463,10203,260,2.5
16,67,Minidoka,1999,9843,9124,719,7.3
16,69,Nez Perce,1999,23426,22533,893,3.8
16,71,Oneida,1999,1738,1672,66,3.8
16,73,Owyhee,1999,4412,4225,187,4.2
16,75,Payette,1999,10204,9470,734,7.2
16,77,Power,1999,3472,3229,243,7.0
16,79,Shoshone,1999,6568,5829,739,11.3
16,81,Teton,1999,3098,2992,106,3.4
16,83,Twin Falls,1999,32326,30812,1514,4.7
16,85,Valley,1999,4056,3691,365,9.0
16,87,Washington,1999,4638,4261,377,8.1
17,1,Adams,1999,37360,36160,1200,3.2
17,3,Alexander,1999,4245,3970,275,6.5
17,5,Bond,1999,8303,7992,311,3.7
17,7,Boone,1999,22219,21330,889,4.0
17,9,Brown,1999,3119,3026,93,3.0
17,11,Bureau,1999,19236,18416,820,4.3
17,13,Calhoun,1999,3375,3230,145,4.3
17,15,Carroll,1999,9117,8636,481,5.3
17,17,Cass,1999,7421,7063,358,4.8
17,19,Champaign,1999,97882,95648,2234,2.3
17,21,Christian,1999,19313,18350,963,5.0
17,23,Clark,1999,10500,10139,361,3.4
17,25,Clay,1999,7373,6845,528,7.2
17,27,Clinton,1999,17487,16874,613,3.5
17,29,Coles,1999,28245,27394,851,3.0
17,31,Cook,1999,2727371,2588118,139253,5.1
17,33,Crawford,1999,9964,9388,576,5.8
17,35,Cumberland,1999,5721,5512,209,3.7
17,37,DeKalb,1999,49436,47727,1709,3.5
17,39,De Witt,1999,8411,7954,457,5.4
17,41,Douglas,1999,12777,12390,387,3.0
17,43,DuPage,1999,536738,520625,16113,3.0
17,45,Edgar,1999,10602,10215,387,3.7
17,47,Edwards,1999,3790,3565,225,5.9
17,49,Effingham,1999,18849,18114,735,3.9
17,51,Fayette,1999,10845,10202,643,5.9
17,53,Ford,1999,6748,6508,240,3.6
17,55,Franklin,1999,17037,15826,1211,7.1
17,57,Fulton,1999,14460,13527,933,6.5
17,59,Gallatin,1999,2843,2670,173,6.1
17,61,Greene,1999,7601,7281,320,4.2
17,63,Grundy,1999,19712,18326,1386,7.0
17,65,Hamilton,1999,3741,3496,245,6.5
17,67,Hancock,1999,12879,12461,418,3.2
17,69,Hardin,1999,1882,1765,117,6.2
17,71,Henderson,1999,5141,4970,171,3.3
17,73,Henry,1999,27522,26238,1284,4.7
17,75,Iroquois,1999,16343,15613,730,4.5
17,77,Jackson,1999,30562,29474,1088,3.6
17,79,Jasper,1999,4033,3751,282,7.0
17,81,Jefferson,1999,18872,17858,1014,5.4
17,83,Jersey,1999,10738,10255,483,4.5
17,85,Jo Daviess,1999,13294,12784,510,3.8
17,87,Johnson,1999,5097,4819,278,5.5
17,89,Kane,1999,226235,217518,8717,3.9
17,91,Kankakee,1999,52474,49893,2581,4.9
17,93,Kendall,1999,30717,29769,948,3.1
17,95,Knox,1999,29793,28736,1057,3.5
17,97,Lake,1999,331857,321807,10050,3.0
17,99,LaSalle,1999,57631,54320,3311,5.7
17,101,Lawrence,1999,6783,6332,451,6.6
17,103,Lee,1999,18363,17689,674,3.7
17,105,Livingston,1999,20762,20153,609,2.9
17,107,Logan,1999,14432,13961,471,3.3
17,109,McDonough,1999,16952,16563,389,2.3
17,111,McHenry,1999,140929,135872,5057,3.6
17,113,McLean,1999,91867,90026,1841,2.0
17,115,Macon,1999,60994,58325,2669,4.4
17,117,Macoupin,1999,23334,22248,1086,4.7
17,119,Madison,1999,131048,125755,5293,4.0
17,121,Marion,1999,21067,19854,1213,5.8
17,123,Marshall,1999,6684,6425,259,3.9
17,125,Mason,1999,8453,7954,499,5.9
17,127,Massac,1999,8113,7775,338,4.2
17,129,Menard,1999,6293,6086,207,3.3
17,131,Mercer,1999,9399,8830,569,6.1
17,133,Monroe,1999,14511,14130,381,2.6
17,135,Montgomery,1999,15761,14831,930,5.9
17,137,Morgan,1999,19193,18535,658,3.4
17,139,Moultrie,1999,8147,7927,220,2.7
17,141,Ogle,1999,28302,27241,1061,3.7
17,143,Peoria,1999,95622,91913,3709,3.9
17,145,Perry,1999,9016,8322,694,7.7
17,147,Piatt,1999,8404,8138,266,3.2
17,149,Pike,1999,9230,8800,430,4.7
17,151,Pope,1999,1804,1678,126,7.0
17,153,Pulaski,1999,3182,2939,243,7.6
17,155,Putnam,1999,3247,3101,146,4.5
17,157,Randolph,1999,14287,13629,658,4.6
17,159,Richland,1999,9151,8580,571,6.2
17,161,Rock Island,1999,77142,73161,3981,5.2
17,163,St. Clair,1999,117504,111557,5947,5.1
17,165,Saline,1999,10622,9896,726,6.8
17,167,Sangamon,1999,101157,97816,3341,3.3
17,169,Schuyler,1999,4428,4234,194,4.4
17,171,Scott,1999,2968,2829,139,4.7
17,173,Shelby,1999,11729,11159,570,4.9
17,175,Stark,1999,2987,2845,142,4.8
17,177,Stephenson,1999,25683,24372,1311,5.1
17,179,Tazewell,1999,71565,68949,2616,3.7
17,181,Union,1999,8542,7982,560,6.6
17,183,Vermilion,1999,39200,37099,2101,5.4
17,185,Wabash,1999,4983,4561,422,8.5
17,187,Warren,1999,10243,9920,323,3.2
17,189,Washington,1999,9355,9052,303,3.2
17,191,Wayne,1999,8390,7849,541,6.4
17,193,White,1999,7401,6960,441,6.0
17,195,Whiteside,1999,32370,31115,1255,3.9
17,197,Will,1999,255376,244142,11234,4.4
17,199,Williamson,1999,28992,27435,1557,5.4
17,201,Winnebago,1999,150752,144460,6292,4.2
17,203,Woodford,1999,19453,18933,520,2.7
18,1,Adams,1999,16480,16124,356,2.2
18,3,Allen,1999,176583,171515,5068,2.9
18,5,Bartholomew,1999,39643,38832,811,2.0
18,7,Benton,1999,5460,5294,166,3.0
18,9,Blackford,1999,6485,6205,280,4.3
18,11,Boone,1999,24969,24556,413,1.7
18,13,Brown,1999,8871,8670,201,2.3
18,15,Carroll,1999,12497,12235,262,2.1
18,17,Cass,1999,20142,19517,625,3.1
18,19,Clark,1999,53403,51978,1425,2.7
18,21,Clay,1999,12532,12031,501,4.0
18,23,Clinton,1999,15996,15607,389,2.4
18,25,Crawford,1999,5374,5076,298,5.5
18,27,Daviess,1999,13876,13434,442,3.2
18,29,Dearborn,1999,23945,23195,750,3.1
18,31,Decatur,1999,17092,16776,316,1.8
18,33,DeKalb,1999,22013,21343,670,3.0
18,35,Delaware,1999,61305,59297,2008,3.3
18,37,Dubois,1999,23355,22881,474,2.0
18,39,Elkhart,1999,98019,95947,2072,2.1
18,41,Fayette,1999,11057,10508,549,5.0
18,43,Floyd,1999,39307,38413,894,2.3
18,45,Fountain,1999,8746,8411,335,3.8
18,47,Franklin,1999,11079,10716,363,3.3
18,49,Fulton,1999,10063,9677,386,3.8
18,51,Gibson,1999,16901,16169,732,4.3
18,53,Grant,1999,33253,31962,1291,3.9
18,55,Greene,1999,14513,13649,864,6.0
18,57,Hamilton,1999,99051,97895,1156,1.2
18,59,Hancock,1999,30758,30173,585,1.9
18,61,Harrison,1999,19116,18634,482,2.5
18,63,Hendricks,1999,54839,53984,855,1.6
18,65,Henry,1999,24510,23531,979,4.0
18,67,Howard,1999,42329,41236,1093,2.6
18,69,Huntington,1999,20501,19902,599,2.9
18,71,Jackson,1999,21787,21281,506,2.3
18,73,Jasper,1999,14510,13938,572,3.9
18,75,Jay,1999,10888,10450,438,4.0
18,77,Jefferson,1999,13688,13213,475,3.5
18,79,Jennings,1999,14732,14410,322,2.2
18,81,Johnson,1999,63430,62306,1124,1.8
18,83,Knox,1999,19275,18646,629,3.3
18,85,Kosciusko,1999,38431,37566,865,2.3
18,87,LaGrange,1999,17600,17159,441,2.5
18,89,Lake,1999,226144,216752,9392,4.2
18,91,LaPorte,1999,53593,51736,1857,3.5
18,93,Lawrence,1999,22926,21777,1149,5.0
18,95,Madison,1999,65319,63257,2062,3.2
18,97,Marion,1999,448316,436092,12224,2.7
18,99,Marshall,1999,25014,24390,624,2.5
18,101,Martin,1999,5159,4960,199,3.9
18,103,Miami,1999,15683,15112,571,3.6
18,105,Monroe,1999,61770,60379,1391,2.3
18,107,Montgomery,1999,18086,17521,565,3.1
18,109,Morgan,1999,35955,35097,858,2.4
18,111,Newton,1999,6512,6279,233,3.6
18,113,Noble,1999,24583,23744,839,3.4
18,115,Ohio,1999,2688,2603,85,3.2
18,117,Orange,1999,8883,8281,602,6.8
18,119,Owen,1999,11001,10608,393,3.6
18,121,Parke,1999,7777,7520,257,3.3
18,123,Perry,1999,9129,8612,517,5.7
18,125,Pike,1999,6419,6179,240,3.7
18,127,Porter,1999,76763,74504,2259,2.9
18,129,Posey,1999,13992,13593,399,2.9
18,131,Pulaski,1999,6230,5809,421,6.8
18,133,Putnam,1999,16980,16659,321,1.9
18,135,Randolph,1999,11516,10779,737,6.4
18,137,Ripley,1999,13718,13284,434,3.2
18,139,Rush,1999,10137,9852,285,2.8
18,141,St. Joseph,1999,136378,132257,4121,3.0
18,143,Scott,1999,11239,10909,330,2.9
18,145,Shelby,1999,23627,22933,694,2.9
18,147,Spencer,1999,11974,11508,466,3.9
18,149,Starke,1999,10888,10384,504,4.6
18,151,Steuben,1999,17892,17387,505,2.8
18,153,Sullivan,1999,9605,9098,507,5.3
18,155,Switzerland,1999,3726,3574,152,4.1
18,157,Tippecanoe,1999,75236,73673,1563,2.1
18,159,Tipton,1999,8827,8631,196,2.2
18,161,Union,1999,3944,3825,119,3.0
18,163,Vanderburgh,1999,91719,88912,2807,3.1
18,165,Vermillion,1999,7796,7397,399,5.1
18,167,Vigo,1999,49934,47828,2106,4.2
18,169,Wabash,1999,17621,17086,535,3.0
18,171,Warren,1999,3973,3860,113,2.8
18,173,Warrick,1999,29458,28657,801,2.7
18,175,Washington,1999,11839,11307,532,4.5
18,177,Wayne,1999,38218,36915,1303,3.4
18,179,Wells,1999,14653,14314,339,2.3
18,181,White,1999,13744,13299,445,3.2
18,183,Whitley,1999,16766,16352,414,2.5
19,1,Adair,1999,4464,4353,111,2.5
19,3,Adams,1999,2295,2236,59,2.6
19,5,Allamakee,1999,7537,7237,300,4.0
19,7,Appanoose,1999,6806,6521,285,4.2
19,9,Audubon,1999,3502,3413,89,2.5
19,11,Benton,1999,11691,11362,329,2.8
19,13,Black Hawk,1999,68364,65586,2778,4.1
19,15,Boone,1999,14291,13989,302,2.1
19,17,Bremer,1999,12597,12226,371,2.9
19,19,Buchanan,1999,11076,10648,428,3.9
19,21,Buena Vista,1999,11080,10838,242,2.2
19,23,Butler,1999,7748,7387,361,4.7
19,25,Calhoun,1999,4899,4756,143,2.9
19,27,Carroll,1999,12672,12381,291,2.3
19,29,Cass,1999,7630,7377,253,3.3
19,31,Cedar,1999,9532,9292,240,2.5
19,33,Cerro Gordo,1999,26155,25447,708,2.7
19,35,Cherokee,1999,6947,6787,160,2.3
19,37,Chickasaw,1999,7726,7459,267,3.5
19,39,Clarke,1999,4581,4417,164,3.6
19,41,Clay,1999,10083,9846,237,2.4
19,43,Clayton,1999,10469,10001,468,4.5
19,45,Clinton,1999,26728,25741,987,3.7
19,47,Crawford,1999,8911,8701,210,2.4
19,49,Dallas,1999,20898,20547,351,1.7
19,51,Davis,1999,4217,4057,160,3.8
19,53,Decatur,1999,3679,3513,166,4.5
19,55,Delaware,1999,9573,9185,388,4.1
19,57,Des Moines,1999,23541,22780,761,3.2
19,59,Dickinson,1999,9780,9533,247,2.5
19,61,Dubuque,1999,49199,47818,1381,2.8
19,63,Emmet,1999,5580,5387,193,3.5
19,65,Fayette,1999,11277,10864,413,3.7
19,67,Floyd,1999,7822,7536,286,3.7
19,69,Franklin,1999,5982,5785,197,3.3
19,71,Fremont,1999,3874,3791,83,2.1
19,73,Greene,1999,5042,4889,153,3.0
19,75,Grundy,1999,6244,6079,165,2.6
19,77,Guthrie,1999,6059,5923,136,2.2
19,79,Hamilton,1999,8745,8557,188,2.1
19,81,Hancock,1999,7149,7018,131,1.8
19,83,Hardin,1999,9453,9165,288,3.0
19,85,Harrison,1999,7863,7670,193,2.5
19,87,Henry,1999,11054,10735,319,2.9
19,89,Howard,1999,5630,5476,154,2.7
19,91,Humboldt,1999,5576,5464,112,2.0
19,93,Ida,1999,4138,4048,90,2.2
19,95,Iowa,1999,9419,9257,162,1.7
19,97,Jackson,1999,10560,10140,420,4.0
19,99,Jasper,1999,19390,18996,394,2.0
19,101,Jefferson,1999,9774,9451,323,3.3
19,103,Johnson,1999,68292,66841,1451,2.1
19,105,Jones,1999,9732,9457,275,2.8
19,107,Keokuk,1999,5152,4914,238,4.6
19,109,Kossuth,1999,8776,8509,267,3.0
19,111,Lee,1999,19254,18474,780,4.1
19,113,Linn,1999,114313,112143,2170,1.9
19,115,Louisa,1999,5529,5339,190,3.4
19,117,Lucas,1999,4095,3955,140,3.4
19,119,Lyon,1999,5588,5484,104,1.9
19,121,Madison,1999,7670,7420,250,3.3
19,123,Mahaska,1999,11724,11449,275,2.3
19,125,Marion,1999,18305,17896,409,2.2
19,127,Marshall,1999,20559,20079,480,2.3
19,129,Mills,1999,6368,6243,125,2.0
19,131,Mitchell,1999,5519,5350,169,3.1
19,133,Monona,1999,5068,4905,163,3.2
19,135,Monroe,1999,4184,4056,128,3.1
19,137,Montgomery,1999,5926,5730,196,3.3
19,139,Muscatine,1999,21741,21117,624,2.9
19,141,O'Brien,1999,7894,7716,178,2.3
19,143,Osceola,1999,3960,3864,96,2.4
19,145,Page,1999,9057,8828,229,2.5
19,147,Palo Alto,1999,5451,5312,139,2.5
19,149,Plymouth,1999,13129,12796,333,2.5
19,151,Pocahontas,1999,4140,3995,145,3.5
19,153,Polk,1999,214631,210365,4266,2.0
19,155,Pottawattamie,1999,48598,47593,1005,2.1
19,157,Poweshiek,1999,10331,10032,299,2.9
19,159,Ringgold,1999,2639,2564,75,2.8
19,161,Sac,1999,5963,5803,160,2.7
19,163,Scott,1999,86205,83471,2734,3.2
19,165,Shelby,1999,6955,6786,169,2.4
19,167,Sioux,1999,17785,17334,451,2.5
19,169,Story,1999,46347,45329,1018,2.2
19,171,Tama,1999,9167,8888,279,3.0
19,173,Taylor,1999,3395,3283,112,3.3
19,175,Union,1999,6586,6334,252,3.8
19,177,Van Buren,1999,4169,4042,127,3.0
19,179,Wapello,1999,17500,16798,702,4.0
19,181,Warren,1999,23375,22948,427,1.8
19,183,Washington,1999,11283,11001,282,2.5
19,185,Wayne,1999,2999,2908,91,3.0
19,187,Webster,1999,20306,19721,585,2.9
19,189,Winnebago,1999,6608,6477,131,2.0
19,191,Winneshiek,1999,12880,12463,417,3.2
19,193,Woodbury,1999,54160,52763,1397,2.6
19,195,Worth,1999,4074,3956,118,2.9
19,197,Wright,1999,6765,6601,164,2.4
20,1,Allen,1999,7221,6837,384,5.3
20,3,Anderson,1999,3956,3756,200,5.1
20,5,Atchison,1999,8788,8386,402,4.6
20,7,Barber,1999,2423,2360,63,2.6
20,9,Barton,1999,14568,14053,515,3.5
20,11,Bourbon,1999,6818,6492,326,4.8
20,13,Brown,1999,5851,5377,474,8.1
20,15,Butler,1999,31574,30522,1052,3.3
20,17,Chase,1999,1463,1405,58,4.0
20,19,Chautauqua,1999,1691,1597,94,5.6
20,21,Cherokee,1999,10150,9666,484,4.8
20,23,Cheyenne,1999,1553,1524,29,1.9
20,25,Clark,1999,1313,1291,22,1.7
20,27,Clay,1999,4808,4655,153,3.2
20,29,Cloud,1999,4921,4762,159,3.2
20,31,Coffey,1999,4120,3914,206,5.0
20,33,Comanche,1999,1010,995,15,1.5
20,35,Cowley,1999,17471,16711,760,4.4
20,37,Crawford,1999,18301,17605,696,3.8
20,39,Decatur,1999,1635,1599,36,2.2
20,41,Dickinson,1999,10293,9959,334,3.2
20,43,Doniphan,1999,4220,3971,249,5.9
20,45,Douglas,1999,54929,52862,2067,3.8
20,47,Edwards,1999,1668,1624,44,2.6
20,49,Elk,1999,1325,1265,60,4.5
20,51,Ellis,1999,16726,16293,433,2.6
20,53,Ellsworth,1999,2870,2798,72,2.5
20,55,Finney,1999,19579,19002,577,2.9
20,57,Ford,1999,15526,15180,346,2.2
20,59,Franklin,1999,13025,12533,492,3.8
20,61,Geary,1999,9957,9260,697,7.0
20,63,Gove,1999,1490,1462,28,1.9
20,65,Graham,1999,1539,1500,39,2.5
20,67,Grant,1999,3802,3645,157,4.1
20,69,Gray,1999,3224,3157,67,2.1
20,71,Greeley,1999,813,788,25,3.1
20,73,Greenwood,1999,3156,2986,170,5.4
20,75,Hamilton,1999,1231,1213,18,1.5
20,77,Harper,1999,2971,2874,97,3.3
20,79,Harvey,1999,17474,16934,540,3.1
20,81,Haskell,1999,2120,2072,48,2.3
20,83,Hodgeman,1999,1073,1050,23,2.1
20,85,Jackson,1999,8807,8525,282,3.2
20,87,Jefferson,1999,9585,9243,342,3.6
20,89,Jewell,1999,2030,1992,38,1.9
20,91,Johnson,1999,266827,261014,5813,2.2
20,93,Kearny,1999,2069,2012,57,2.8
20,95,Kingman,1999,4207,4063,144,3.4
20,97,Kiowa,1999,1666,1635,31,1.9
20,99,Labette,1999,11542,11011,531,4.6
20,101,Lane,1999,1115,1080,35,3.1
20,103,Leavenworth,1999,28906,27828,1078,3.7
20,105,Lincoln,1999,1800,1763,37,2.1
20,107,Linn,1999,3264,3025,239,7.3
20,109,Logan,1999,1606,1574,32,2.0
20,111,Lyon,1999,19694,18976,718,3.6
20,113,McPherson,1999,15978,15599,379,2.4
20,115,Marion,1999,7039,6864,175,2.5
20,117,Marshall,1999,5927,5758,169,2.9
20,119,Meade,1999,2216,2167,49,2.2
20,121,Miami,1999,14198,13747,451,3.2
20,123,Mitchell,1999,3752,3680,72,1.9
20,125,Montgomery,1999,18600,17650,950,5.1
20,127,Morris,1999,3106,3008,98,3.2
20,129,Morton,1999,1717,1675,42,2.4
20,131,Nemaha,1999,5572,5418,154,2.8
20,133,Neosho,1999,8771,8357,414,4.7
20,135,Ness,1999,1831,1783,48,2.6
20,137,Norton,1999,3137,3089,48,1.5
20,139,Osage,1999,9826,9368,458,4.7
20,141,Osborne,1999,2265,2218,47,2.1
20,143,Ottawa,1999,3128,3041,87,2.8
20,145,Pawnee,1999,3764,3683,81,2.2
20,147,Phillips,1999,3169,3104,65,2.1
20,149,Pottawatomie,1999,10849,10581,268,2.5
20,151,Pratt,1999,4828,4707,121,2.5
20,153,Rawlins,1999,1530,1487,43,2.8
20,155,Reno,1999,32674,31540,1134,3.5
20,157,Republic,1999,3031,2972,59,1.9
20,159,Rice,1999,4672,4490,182,3.9
20,161,Riley,1999,30186,29166,1020,3.4
20,163,Rooks,1999,2967,2882,85,2.9
20,165,Rush,1999,1852,1794,58,3.1
20,167,Russell,1999,3484,3363,121,3.5
20,169,Saline,1999,30288,29407,881,2.9
20,171,Scott,1999,2665,2618,47,1.8
20,173,Sedgwick,1999,236022,226690,9332,4.0
20,175,Seward,1999,10856,10507,349,3.2
20,177,Shawnee,1999,88747,85543,3204,3.6
20,179,Sheridan,1999,1467,1440,27,1.8
20,181,Sherman,1999,4165,4091,74,1.8
20,183,Smith,1999,2398,2360,38,1.6
20,185,Stafford,1999,2391,2329,62,2.6
20,187,Stanton,1999,1094,1069,25,2.3
20,189,Stevens,1999,2759,2693,66,2.4
20,191,Sumner,1999,13851,13320,531,3.8
20,193,Thomas,1999,4654,4565,89,1.9
20,195,Trego,1999,1857,1794,63,3.4
20,197,Wabaunsee,1999,3598,3475,123,3.4
20,199,Wallace,1999,861,845,16,1.9
20,201,Washington,1999,3386,3289,97,2.9
20,203,Wichita,1999,1302,1264,38,2.9
20,205,Wilson,1999,5471,5285,186,3.4
20,207,Woodson,1999,1576,1489,87,5.5
20,209,Wyandotte,1999,75397,70563,4834,6.4
21,1,Adair,1999,7518,6828,690,9.2
21,3,Allen,1999,8692,8233,459,5.3
21,5,Anderson,1999,9974,9679,295,3.0
21,7,Ballard,1999,4229,3971,258,6.1
21,9,Barren,1999,18727,17755,972,5.2
21,11,Bath,1999,5832,5471,361,6.2
21,13,Bell,1999,10077,9519,558,5.5
21,15,Boone,1999,45869,44632,1237,2.7
21,17,Bourbon,1999,10006,9763,243,2.4
21,19,Boyd,1999,22391,20865,1526,6.8
21,21,Boyle,1999,14442,13978,464,3.2
21,23,Bracken,1999,3938,3781,157,4.0
21,25,Breathitt,1999,4220,3863,357,8.5
21,27,Breckinridge,1999,7766,7278,488,6.3
21,29,Bullitt,1999,34025,32954,1071,3.1
21,31,Butler,1999,5893,5562,331,5.6
21,33,Caldwell,1999,6483,6180,303,4.7
21,35,Calloway,1999,17735,16980,755,4.3
21,37,Campbell,1999,45380,43898,1482,3.3
21,39,Carlisle,1999,2774,2600,174,6.3
21,41,Carroll,1999,5037,4825,212,4.2
21,43,Carter,1999,12022,10485,1537,12.8
21,45,Casey,1999,6680,6180,500,7.5
21,47,Christian,1999,27776,26711,1065,3.8
21,49,Clark,1999,16599,16066,533,3.2
21,51,Clay,1999,7309,6803,506,6.9
21,53,Clinton,1999,5505,5289,216,3.9
21,55,Crittenden,1999,3993,3768,225,5.6
21,57,Cumberland,1999,2874,2683,191,6.6
21,59,Daviess,1999,49871,47318,2553,5.1
21,61,Edmonson,1999,5041,4756,285,5.7
21,63,Elliott,1999,2777,2388,389,14.0
21,65,Estill,1999,5752,5479,273,4.7
21,67,Fayette,1999,143670,140842,2828,2.0
21,69,Fleming,1999,6214,5941,273,4.4
21,71,Floyd,1999,13682,12619,1063,7.8
21,73,Franklin,1999,24739,24126,613,2.5
21,75,Fulton,1999,3370,3017,353,10.5
21,77,Gallatin,1999,3704,3575,129,3.5
21,79,Garrard,1999,7478,7279,199,2.7
21,81,Grant,1999,10141,9746,395,3.9
21,83,Graves,1999,17507,16520,987,5.6
21,85,Grayson,1999,12322,11557,765,6.2
21,87,Green,1999,4256,3669,587,13.8
21,89,Greenup,1999,16510,15448,1062,6.4
21,91,Hancock,1999,4148,3724,424,10.2
21,93,Hardin,1999,36768,34689,2079,5.7
21,95,Harlan,1999,9134,8121,1013,11.1
21,97,Harrison,1999,7390,7074,316,4.3
21,99,Hart,1999,7934,7525,409,5.2
21,101,Henderson,1999,23883,22855,1028,4.3
21,103,Henry,1999,7481,7216,265,3.5
21,105,Hickman,1999,2493,2340,153,6.1
21,107,Hopkins,1999,19508,18381,1127,5.8
21,109,Jackson,1999,6841,6511,330,4.8
21,111,Jefferson,1999,375805,361618,14187,3.8
21,113,Jessamine,1999,20954,20639,315,1.5
21,115,Johnson,1999,9216,8545,671,7.3
21,117,Kenton,1999,79353,76830,2523,3.2
21,119,Knott,1999,5852,5361,491,8.4
21,121,Knox,1999,11190,10566,624,5.6
21,123,Larue,1999,6280,5980,300,4.8
21,125,Laurel,1999,23123,22055,1068,4.6
21,127,Lawrence,1999,5565,4966,599,10.8
21,129,Lee,1999,2470,2327,143,5.8
21,131,Leslie,1999,4409,4155,254,5.8
21,133,Letcher,1999,7854,7133,721,9.2
21,135,Lewis,1999,4729,4067,662,14.0
21,137,Lincoln,1999,10990,10551,439,4.0
21,139,Livingston,1999,4916,4656,260,5.3
21,141,Logan,1999,13121,12669,452,3.4
21,143,Lyon,1999,3346,3182,164,4.9
21,145,McCracken,1999,33560,32299,1261,3.8
21,147,McCreary,1999,6311,5885,426,6.8
21,149,McLean,1999,4511,4196,315,7.0
21,151,Madison,1999,36362,35409,953,2.6
21,153,Magoffin,1999,5101,4409,692,13.6
21,155,Marion,1999,10965,10363,602,5.5
21,157,Marshall,1999,14658,13834,824,5.6
21,159,Martin,1999,3085,2699,386,12.5
21,161,Mason,1999,8522,8263,259,3.0
21,163,Meade,1999,10884,10405,479,4.4
21,165,Menifee,1999,2910,2715,195,6.7
21,167,Mercer,1999,10905,10563,342,3.1
21,169,Metcalfe,1999,4963,4609,354,7.1
21,171,Monroe,1999,5414,4735,679,12.5
21,173,Montgomery,1999,12734,12086,648,5.1
21,175,Morgan,1999,4939,4552,387,7.8
21,177,Muhlenberg,1999,12585,11528,1057,8.4
21,179,Nelson,1999,18842,17718,1124,6.0
21,181,Nicholas,1999,3117,2990,127,4.1
21,183,Ohio,1999,9994,9155,839,8.4
21,185,Oldham,1999,25129,24647,482,1.9
21,187,Owen,1999,4304,4173,131,3.0
21,189,Owsley,1999,1735,1643,92,5.3
21,191,Pendleton,1999,6658,6402,256,3.8
21,193,Perry,1999,11631,10718,913,7.8
21,195,Pike,1999,27311,25231,2080,7.6
21,197,Powell,1999,6415,6044,371,5.8
21,199,Pulaski,1999,25985,24750,1235,4.8
21,201,Robertson,1999,1049,999,50,4.8
21,203,Rockcastle,1999,6215,5878,337,5.4
21,205,Rowan,1999,9395,9040,355,3.8
21,207,Russell,1999,5769,5073,696,12.1
21,209,Scott,1999,18080,17728,352,1.9
21,211,Shelby,1999,17892,17464,428,2.4
21,213,Simpson,1999,8251,7985,266,3.2
21,215,Spencer,1999,5260,5082,178,3.4
21,217,Taylor,1999,9695,8179,1516,15.6
21,219,Todd,1999,5305,5144,161,3.0
21,221,Trigg,1999,5908,5728,180,3.0
21,223,Trimble,1999,3159,3071,88,2.8
21,225,Union,1999,6182,5798,384,6.2
21,227,Warren,1999,49588,47929,1659,3.3
21,229,Washington,1999,5728,5505,223,3.9
21,231,Wayne,1999,8031,7500,531,6.6
21,233,Webster,1999,5464,5078,386,7.1
21,235,Whitley,1999,14353,13509,844,5.9
21,237,Wolfe,1999,3295,3129,166,5.0
21,239,Woodford,1999,13459,13240,219,1.6
22,1,Acadia Parish,1999,23171,21476,1695,7.3
22,3,Allen Parish,1999,9680,9077,603,6.2
22,5,Ascension Parish,1999,35006,33514,1492,4.3
22,7,Assumption Parish,1999,8938,8313,625,7.0
22,9,Avoyelles Parish,1999,15946,15048,898,5.6
22,11,Beauregard Parish,1999,12362,11554,808,6.5
22,13,Bienville Parish,1999,5472,5121,351,6.4
22,15,Bossier Parish,1999,45553,43621,1932,4.2
22,17,Caddo Parish,1999,115199,110270,4929,4.3
22,19,Calcasieu Parish,1999,89493,85036,4457,5.0
22,21,Caldwell Parish,1999,4265,3921,344,8.1
22,23,Cameron Parish,1999,3807,3623,184,4.8
22,25,Catahoula Parish,1999,4825,4368,457,9.5
22,27,Claiborne Parish,1999,5653,5234,419,7.4
22,29,Concordia Parish,1999,8300,7296,1004,12.1
22,31,De Soto Parish,1999,11161,10497,664,5.9
22,33,East Baton Rouge Parish,1999,206944,199879,7065,3.4
22,35,East Carroll Parish,1999,3017,2641,376,12.5
22,37,East Feliciana Parish,1999,7433,7081,352,4.7
22,39,Evangeline Parish,1999,11956,11306,650,5.4
22,41,Franklin Parish,1999,9754,9010,744,7.6
22,43,Grant Parish,1999,6901,6448,453,6.6
22,45,Iberia Parish,1999,32170,29751,2419,7.5
22,47,Iberville Parish,1999,12798,12003,795,6.2
22,49,Jackson Parish,1999,5615,5327,288,5.1
22,51,Jefferson Parish,1999,240788,230686,10102,4.2
22,53,Jefferson Davis Parish,1999,11358,10596,762,6.7
22,55,Lafayette Parish,1999,95162,91292,3870,4.1
22,57,Lafourche Parish,1999,41347,39858,1489,3.6
22,59,LaSalle Parish,1999,5245,4866,379,7.2
22,61,Lincoln Parish,1999,19172,18728,444,2.3
22,63,Livingston Parish,1999,43668,41619,2049,4.7
22,65,Madison Parish,1999,5396,4982,414,7.7
22,67,Morehouse Parish,1999,11860,10688,1172,9.9
22,69,Natchitoches Parish,1999,17809,16930,879,4.9
22,71,Orleans Parish,1999,203516,192071,11445,5.6
22,73,Ouachita Parish,1999,69333,66821,2512,3.6
22,75,Plaquemines Parish,1999,11107,10470,637,5.7
22,77,Pointe Coupee Parish,1999,9547,8978,569,6.0
22,79,Rapides Parish,1999,59640,57106,2534,4.2
22,81,Red River Parish,1999,3286,3034,252,7.7
22,83,Richland Parish,1999,8163,7542,621,7.6
22,85,Sabine Parish,1999,8467,7948,519,6.1
22,87,St. Bernard Parish,1999,32046,30441,1605,5.0
22,89,St. Charles Parish,1999,23946,22712,1234,5.2
22,91,St. Helena Parish,1999,3866,3678,188,4.9
22,93,St. James Parish,1999,8988,8133,855,9.5
22,95,St. John the Baptist Parish,1999,20294,18838,1456,7.2
22,97,St. Landry Parish,1999,31365,29135,2230,7.1
22,99,St. Martin Parish,1999,20871,19663,1208,5.8
22,101,St. Mary Parish,1999,23613,21119,2494,10.6
22,103,St. Tammany Parish,1999,94997,91758,3239,3.4
22,105,Tangipahoa Parish,1999,43509,40790,2719,6.2
22,107,Tensas Parish,1999,3091,2894,197,6.4
22,109,Terrebonne Parish,1999,47510,45576,1934,4.1
22,111,Union Parish,1999,12448,11960,488,3.9
22,113,Vermilion Parish,1999,21715,20263,1452,6.7
22,115,Vernon Parish,1999,16994,16047,947,5.6
22,117,Washington Parish,1999,16146,15237,909,5.6
22,119,Webster Parish,1999,18766,17618,1148,6.1
22,121,West Baton Rouge Parish,1999,9853,9456,397,4.0
22,123,West Carroll Parish,1999,5276,4581,695,13.2
22,125,West Feliciana Parish,1999,3669,3511,158,4.3
22,127,Winn Parish,1999,6383,6001,382,6.0
23,1,Androscoggin,1999,59685,57327,2358,4.0
23,3,Aroostook,1999,37596,35515,2081,5.5
23,5,Cumberland,1999,141661,138421,3240,2.3
23,7,Franklin,1999,14979,13955,1024,6.8
23,9,Hancock,1999,28372,26910,1462,5.2
23,11,Kennebec,1999,59562,56911,2651,4.5
23,13,Knox,1999,19903,19321,582,2.9
23,15,Lincoln,1999,17537,17035,502,2.9
23,17,Oxford,1999,26403,24677,1726,6.5
23,19,Penobscot,1999,77245,74017,3228,4.2
23,21,Piscataquis,1999,8312,7736,576,6.9
23,23,Sagadahoc,1999,16257,15774,483,3.0
23,25,Somerset,1999,25711,23842,1869,7.3
23,27,Waldo,1999,21662,20739,923,4.3
23,29,Washington,1999,16404,14972,1432,8.7
23,31,York,1999,97667,94951,2716,2.8
24,1,Allegany,1999,32163,29912,2251,7.0
24,3,Anne Arundel,1999,257207,250162,7045,2.7
24,5,Baltimore,1999,394213,379781,14432,3.7
24,9,Calvert,1999,38024,37063,961,2.5
24,11,Caroline,1999,15876,15366,510,3.2
24,13,Carroll,1999,82774,80766,2008,2.4
24,15,Cecil,1999,41496,39641,1855,4.5
24,17,Charles,1999,62065,60547,1518,2.4
24,19,Dorchester,1999,15420,14315,1105,7.2
24,21,Frederick,1999,101024,98874,2150,2.1
24,23,Garrett,1999,13468,12353,1115,8.3
24,25,Harford,1999,114484,110899,3585,3.1
24,27,Howard,1999,143905,141403,2502,1.7
24,29,Kent,1999,10024,9651,373,3.7
24,31,Montgomery,1999,476201,467651,8550,1.8
24,33,Prince George's,1999,441499,426339,15160,3.4
24,35,Queen Anne's,1999,21387,20797,590,2.8
24,37,St. Mary's,1999,49625,48109,1516,3.1
24,39,Somerset,1999,11369,10525,844,7.4
24,41,Talbot,1999,18847,18325,522,2.8
24,43,Washington,1999,67992,65730,2262,3.3
24,45,Wicomico,1999,47419,45264,2155,4.5
24,47,Worcester,1999,24818,22667,2151,8.7
24,510,Baltimore city,1999,288787,268168,20619,7.1
25,1,Barnstable,1999,109550,104738,4812,4.4
25,3,Berkshire,1999,66425,63861,2564,3.9
25,5,Bristol,1999,270198,257537,12661,4.7
25,7,Dukes,1999,9546,9172,374,3.9
25,9,Essex,1999,377950,364298,13652,3.6
25,11,Franklin,1999,38846,37668,1178,3.0
25,13,Hampden,1999,214373,205495,8878,4.1
25,15,Hampshire,1999,83175,81060,2115,2.5
25,17,Middlesex,1999,838583,817068,21515,2.6
25,19,Nantucket/town,1999,6610,6494,116,1.8
25,21,Norfolk,1999,367021,358045,8976,2.4
25,23,Plymouth,1999,252472,243964,8508,3.4
25,25,Suffolk,1999,346963,334673,12290,3.5
25,27,Worcester,1999,377013,363880,13133,3.5
26,1,Alcona,1999,4951,4589,362,7.3
26,3,Alger,1999,4397,4159,238,5.4
26,5,Allegan,1999,57100,55582,1518,2.7
26,7,Alpena,1999,16004,15045,959,6.0
26,9,Antrim,1999,10525,9917,608,5.8
26,11,Arenac,1999,6959,6493,466,6.7
26,13,Baraga,1999,4354,4077,277,6.4
26,15,Barry,1999,32652,31755,897,2.7
26,17,Bay,1999,55408,52957,2451,4.4
26,19,Benzie,1999,7860,7459,401,5.1
26,21,Berrien,1999,83238,80165,3073,3.7
26,23,Branch,1999,22628,21892,736,3.3
26,25,Calhoun,1999,69430,66754,2676,3.9
26,27,Cass,1999,26761,25935,826,3.1
26,29,Charlevoix,1999,14244,13566,678,4.8
26,31,Cheboygan,1999,12491,11280,1211,9.7
26,33,Chippewa,1999,17669,16487,1182,6.7
26,35,Clare,1999,10799,10027,772,7.1
26,37,Clinton,1999,34306,33602,704,2.1
26,39,Crawford,1999,5669,5329,340,6.0
26,41,Delta,1999,19112,17980,1132,5.9
26,43,Dickinson,1999,14172,13480,692,4.9
26,45,Eaton,1999,55901,54694,1207,2.2
26,47,Emmet,1999,18052,16890,1162,6.4
26,49,Genesee,1999,194711,184786,9925,5.1
26,51,Gladwin,1999,9026,8416,610,6.8
26,53,Gogebic,1999,7955,7445,510,6.4
26,55,Grand Traverse,1999,45334,43821,1513,3.3
26,57,Gratiot,1999,19578,18768,810,4.1
26,59,Hillsdale,1999,24357,23621,736,3.0
26,61,Houghton,1999,17287,16544,743,4.3
26,63,Huron,1999,17837,17028,809,4.5
26,65,Ingham,1999,152346,148508,3838,2.5
26,67,Ionia,1999,27490,26385,1105,4.0
26,69,Iosco,1999,11574,10707,867,7.5
26,71,Iron,1999,5558,5209,349,6.3
26,73,Isabella,1999,32710,31774,936,2.9
26,75,Jackson,1999,77145,74742,2403,3.1
26,77,Kalamazoo,1999,128487,125057,3430,2.7
26,79,Kalkaska,1999,7680,7244,436,5.7
26,81,Kent,1999,325655,316359,9296,2.9
26,83,Keweenaw,1999,869,800,69,7.9
26,85,Lake,1999,3437,3180,257,7.5
26,87,Lapeer,1999,45274,43268,2006,4.4
26,89,Leelanau,1999,11104,10767,337,3.0
26,91,Lenawee,1999,48050,46469,1581,3.3
26,93,Livingston,1999,82408,80414,1994,2.4
26,95,Luce,1999,2617,2418,199,7.6
26,97,Mackinac,1999,7392,6736,656,8.9
26,99,Macomb,1999,447714,431725,15989,3.6
26,101,Manistee,1999,10892,10288,604,5.5
26,103,Marquette,1999,32461,30773,1688,5.2
26,105,Mason,1999,14204,13400,804,5.7
26,107,Mecosta,1999,17914,17232,682,3.8
26,109,Menominee,1999,12871,12296,575,4.5
26,111,Midland,1999,43207,42050,1157,2.7
26,113,Missaukee,1999,6935,6566,369,5.3
26,115,Monroe,1999,74665,72515,2150,2.9
26,117,Montcalm,1999,25262,23891,1371,5.4
26,119,Montmorency,1999,3543,3165,378,10.7
26,121,Muskegon,1999,83944,80330,3614,4.3
26,123,Newaygo,1999,20615,19283,1332,6.5
26,125,Oakland,1999,686162,666978,19184,2.8
26,127,Oceana,1999,14194,13233,961,6.8
26,129,Ogemaw,1999,8803,8238,565,6.4
26,131,Ontonagon,1999,3006,2757,249,8.3
26,133,Osceola,1999,10703,10145,558,5.2
26,135,Oscoda,1999,3634,3368,266,7.3
26,137,Otsego,1999,13319,12744,575,4.3
26,139,Ottawa,1999,140436,137013,3423,2.4
26,141,Presque Isle,1999,6219,5602,617,9.9
26,143,Roscommon,1999,8130,7563,567,7.0
26,145,Saginaw,1999,101059,96925,4134,4.1
26,147,St. Clair,1999,82323,78382,3941,4.8
26,149,St. Joseph,1999,32766,31799,967,3.0
26,151,Sanilac,1999,20807,19580,1227,5.9
26,153,Schoolcraft,1999,4297,3924,373,8.7
26,155,Shiawassee,1999,36412,34920,1492,4.1
26,157,Tuscola,1999,27726,26319,1407,5.1
26,159,Van Buren,1999,37083,35616,1467,4.0
26,161,Washtenaw,1999,174743,171830,2913,1.7
26,163,Wayne,1999,970540,925292,45248,4.7
26,165,Wexford,1999,15297,14366,931,6.1
27,1,Aitkin,1999,6060,5616,444,7.3
27,3,Anoka,1999,182648,178744,3904,2.1
27,5,Becker,1999,14179,13412,767,5.4
27,7,Beltrami,1999,19947,18957,990,5.0
27,9,Benton,1999,21019,20392,627,3.0
27,11,Big Stone,1999,2733,2631,102,3.7
27,13,Blue Earth,1999,33617,32860,757,2.3
27,15,Brown,1999,15013,14491,522,3.5
27,17,Carlton,1999,16031,15370,661,4.1
27,19,Carver,1999,40767,39934,833,2.0
27,21,Cass,1999,12538,11811,727,5.8
27,23,Chippewa,1999,6958,6625,333,4.8
27,25,Chisago,1999,21929,21247,682,3.1
27,27,Clay,1999,30265,29541,724,2.4
27,29,Clearwater,1999,4146,3684,462,11.1
27,31,Cook,1999,3074,2964,110,3.6
27,33,Cottonwood,1999,5694,5450,244,4.3
27,35,Crow Wing,1999,27991,26782,1209,4.3
27,37,Dakota,1999,217262,213389,3873,1.8
27,39,Dodge,1999,9080,8796,284,3.1
27,41,Douglas,1999,16794,16238,556,3.3
27,43,Faribault,1999,8140,7839,301,3.7
27,45,Fillmore,1999,10008,9688,320,3.2
27,47,Freeborn,1999,16633,16199,434,2.6
27,49,Goodhue,1999,23377,22711,666,2.8
27,51,Grant,1999,2850,2699,151,5.3
27,53,Hennepin,1999,659365,645467,13898,2.1
27,55,Houston,1999,11350,10966,384,3.4
27,57,Hubbard,1999,8385,7984,401,4.8
27,59,Isanti,1999,16199,15649,550,3.4
27,61,Itasca,1999,20038,18638,1400,7.0
27,63,Jackson,1999,6113,5924,189,3.1
27,65,Kanabec,1999,6933,6490,443,6.4
27,67,Kandiyohi,1999,21580,20851,729,3.4
27,69,Kittson,1999,2341,2197,144,6.2
27,71,Koochiching,1999,6510,6087,423,6.5
27,73,Lac qui Parle,1999,3763,3639,124,3.3
27,75,Lake,1999,5664,5459,205,3.6
27,77,Lake of the Woods,1999,2531,2415,116,4.6
27,79,Le Sueur,1999,14742,14259,483,3.3
27,81,Lincoln,1999,3033,2922,111,3.7
27,83,Lyon,1999,15010,14622,388,2.6
27,85,McLeod,1999,21009,20353,656,3.1
27,87,Mahnomen,1999,2227,2066,161,7.2
27,89,Marshall,1999,4600,4158,442,9.6
27,91,Martin,1999,11039,10668,371,3.4
27,93,Meeker,1999,9462,8968,494,5.2
27,95,Mille Lacs,1999,9429,8857,572,6.1
27,97,Morrison,1999,14859,13971,888,6.0
27,99,Mower,1999,19045,18651,394,2.1
27,101,Murray,1999,4356,4182,174,4.0
27,103,Nicollet,1999,18475,18134,341,1.8
27,105,Nobles,1999,9661,9364,297,3.1
27,107,Norman,1999,3371,3202,169,5.0
27,109,Olmsted,1999,73906,72472,1434,1.9
27,111,Otter Tail,1999,27579,26430,1149,4.2
27,113,Pennington,1999,8093,7631,462,5.7
27,115,Pine,1999,11262,10568,694,6.2
27,117,Pipestone,1999,4961,4822,139,2.8
27,119,Polk,1999,17056,16443,613,3.6
27,121,Pope,1999,5468,5304,164,3.0
27,123,Ramsey,1999,282999,276670,6329,2.2
27,125,Red Lake,1999,1888,1716,172,9.1
27,127,Redwood,1999,8926,8679,247,2.8
27,129,Renville,1999,8143,7769,374,4.6
27,131,Rice,1999,28416,27610,806,2.8
27,133,Rock,1999,4728,4598,130,2.7
27,135,Roseau,1999,8994,8638,356,4.0
27,137,St. Louis,1999,103605,99559,4046,3.9
27,139,Scott,1999,49411,48337,1074,2.2
27,141,Sherburne,1999,34657,33776,881,2.5
27,143,Sibley,1999,6565,6307,258,3.9
27,145,Stearns,1999,78169,75941,2228,2.9
27,147,Steele,1999,19571,19094,477,2.4
27,149,Stevens,1999,5576,5420,156,2.8
27,151,Swift,1999,5547,5335,212,3.8
27,153,Todd,1999,9298,8827,471,5.1
27,155,Traverse,1999,1747,1652,95,5.4
27,157,Wabasha,1999,12687,12393,294,2.3
27,159,Wadena,1999,7181,6806,375,5.2
27,161,Waseca,1999,9667,9368,299,3.1
27,163,Washington,1999,118743,116656,2087,1.8
27,165,Watonwan,1999,5773,5559,214,3.7
27,167,Wilkin,1999,4036,3948,88,2.2
27,169,Winona,1999,28119,27396,723,2.6
27,171,Wright,1999,49068,47706,1362,2.8
27,173,Yellow Medicine,1999,5309,5086,223,4.2
28,1,Adams,1999,14565,13299,1266,8.7
28,3,Alcorn,1999,15093,14311,782,5.2
28,5,Amite,1999,5734,5452,282,4.9
28,7,Attala,1999,7743,7088,655,8.5
28,9,Benton,1999,3201,2999,202,6.3
28,11,Bolivar,1999,16721,15483,1238,7.4
28,13,Calhoun,1999,6217,5958,259,4.2
28,15,Carroll,1999,4444,4214,230,5.2
28,17,Chickasaw,1999,7686,7203,483,6.3
28,19,Choctaw,1999,3094,2857,237,7.7
28,21,Claiborne,1999,3408,3057,351,10.3
28,23,Clarke,1999,8853,8217,636,7.2
28,25,Clay,1999,8940,8281,659,7.4
28,27,Coahoma,1999,11676,10622,1054,9.0
28,29,Copiah,1999,11109,10139,970,8.7
28,31,Covington,1999,8289,7824,465,5.6
28,33,DeSoto,1999,54894,53531,1363,2.5
28,35,Forrest,1999,33420,32288,1132,3.4
28,37,Franklin,1999,3438,3159,279,8.1
28,39,George,1999,8576,7966,610,7.1
28,41,Greene,1999,5301,4926,375,7.1
28,43,Grenada,1999,10106,9566,540,5.3
28,45,Hancock,1999,18480,17748,732,4.0
28,47,Harrison,1999,86054,83073,2981,3.5
28,49,Hinds,1999,126309,121070,5239,4.1
28,51,Holmes,1999,7009,5794,1215,17.3
28,53,Humphreys,1999,4812,4338,474,9.9
28,55,Issaquena,1999,646,550,96,14.9
28,57,Itawamba,1999,11307,10819,488,4.3
28,59,Jackson,1999,70373,67685,2688,3.8
28,61,Jasper,1999,8217,7820,397,4.8
28,63,Jefferson,1999,2674,2198,476,17.8
28,65,Jefferson Davis,1999,4796,3998,798,16.6
28,67,Jones,1999,31243,30190,1053,3.4
28,69,Kemper,1999,4501,3951,550,12.2
28,71,Lafayette,1999,17658,17340,318,1.8
28,73,Lamar,1999,17722,17204,518,2.9
28,75,Lauderdale,1999,34717,32744,1973,5.7
28,77,Lawrence,1999,5273,4879,394,7.5
28,79,Leake,1999,9446,8872,574,6.1
28,81,Lee,1999,40576,39033,1543,3.8
28,83,Leflore,1999,15511,14216,1295,8.3
28,85,Lincoln,1999,13997,13325,672,4.8
28,87,Lowndes,1999,26912,25348,1564,5.8
28,89,Madison,1999,37271,36120,1151,3.1
28,91,Marion,1999,10666,9977,689,6.5
28,93,Marshall,1999,13730,12893,837,6.1
28,95,Monroe,1999,15226,14114,1112,7.3
28,97,Montgomery,1999,5459,5130,329,6.0
28,99,Neshoba,1999,15845,15097,748,4.7
28,101,Newton,1999,8496,7936,560,6.6
28,103,Noxubee,1999,4579,4062,517,11.3
28,105,Oktibbeha,1999,21238,20772,466,2.2
28,107,Panola,1999,12524,11509,1015,8.1
28,109,Pearl River,1999,20019,19201,818,4.1
28,111,Perry,1999,4117,3815,302,7.3
28,113,Pike,1999,16661,15802,859,5.2
28,115,Pontotoc,1999,13624,13167,457,3.4
28,117,Prentiss,1999,12478,11707,771,6.2
28,119,Quitman,1999,3302,3014,288,8.7
28,121,Rankin,1999,60700,59395,1305,2.1
28,123,Scott,1999,12299,11885,414,3.4
28,125,Sharkey,1999,2526,2073,453,17.9
28,127,Simpson,1999,9851,9229,622,6.3
28,129,Smith,1999,5790,5568,222,3.8
28,131,Stone,1999,5080,4818,262,5.2
28,133,Sunflower,1999,10972,9885,1087,9.9
28,135,Tallahatchie,1999,5342,4832,510,9.5
28,137,Tate,1999,10437,9837,600,5.7
28,139,Tippah,1999,9946,9463,483,4.9
28,141,Tishomingo,1999,9436,8684,752,8.0
28,143,Tunica,1999,5710,5344,366,6.4
28,145,Union,1999,12599,12123,476,3.8
28,147,Walthall,1999,5933,5592,341,5.7
28,149,Warren,1999,26527,25329,1198,4.5
28,151,Washington,1999,26998,24449,2549,9.4
28,153,Wayne,1999,8481,7943,538,6.3
28,155,Webster,1999,4397,4168,229,5.2
28,157,Wilkinson,1999,3002,2544,458,15.3
28,159,Winston,1999,7715,7222,493,6.4
28,161,Yalobusha,1999,4682,4304,378,8.1
28,163,Yazoo,1999,9389,8623,766,8.2
29,1,Adair,1999,14201,13954,247,1.7
29,3,Andrew,1999,8515,8281,234,2.7
29,5,Atchison,1999,3194,3130,64,2.0
29,7,Audrain,1999,13320,12982,338,2.5
29,9,Barry,1999,15704,15161,543,3.5
29,11,Barton,1999,7454,7273,181,2.4
29,13,Bates,1999,7609,7299,310,4.1
29,15,Benton,1999,6176,5839,337,5.5
29,17,Bollinger,1999,5546,5334,212,3.8
29,19,Boone,1999,85258,84265,993,1.2
29,21,Buchanan,1999,42834,41330,1504,3.5
29,23,Butler,1999,20077,19299,778,3.9
29,25,Caldwell,1999,3228,3081,147,4.6
29,27,Callaway,1999,22031,21509,522,2.4
29,29,Camden,1999,17743,16956,787,4.4
29,31,Cape Girardeau,1999,38652,37659,993,2.6
29,33,Carroll,1999,4979,4791,188,3.8
29,35,Carter,1999,2823,2651,172,6.1
29,37,Cass,1999,46173,45111,1062,2.3
29,39,Cedar,1999,5240,5062,178,3.4
29,41,Chariton,1999,4244,4080,164,3.9
29,43,Christian,1999,28883,28211,672,2.3
29,45,Clark,1999,3773,3601,172,4.6
29,47,Clay,1999,108818,106329,2489,2.3
29,49,Clinton,1999,10012,9723,289,2.9
29,51,Cole,1999,41010,40255,755,1.8
29,53,Cooper,1999,8607,8366,241,2.8
29,55,Crawford,1999,9956,9467,489,4.9
29,57,Dade,1999,3467,3339,128,3.7
29,59,Dallas,1999,6682,6418,264,4.0
29,61,Daviess,1999,3605,3490,115,3.2
29,63,DeKalb,1999,4888,4758,130,2.7
29,65,Dent,1999,6582,6190,392,6.0
29,67,Douglas,1999,5687,5394,293,5.2
29,69,Dunklin,1999,14494,13793,701,4.8
29,71,Franklin,1999,48330,46713,1617,3.3
29,73,Gasconade,1999,8038,7813,225,2.8
29,75,Gentry,1999,3705,3615,90,2.4
29,77,Greene,1999,128176,125362,2814,2.2
29,79,Grundy,1999,5047,4896,151,3.0
29,81,Harrison,1999,4472,4371,101,2.3
29,83,Henry,1999,10862,10471,391,3.6
29,85,Hickory,1999,2910,2761,149,5.1
29,87,Holt,1999,2791,2701,90,3.2
29,89,Howard,1999,4769,4611,158,3.3
29,91,Howell,1999,17998,17317,681,3.8
29,93,Iron,1999,4247,3950,297,7.0
29,95,Jackson,1999,367922,355434,12488,3.4
29,97,Jasper,1999,56453,54882,1571,2.8
29,99,Jefferson,1999,105700,102450,3250,3.1
29,101,Johnson,1999,23582,23088,494,2.1
29,103,Knox,1999,2043,1992,51,2.5
29,105,Laclede,1999,16429,15748,681,4.1
29,107,Lafayette,1999,16827,16255,572,3.4
29,109,Lawrence,1999,16297,15756,541,3.3
29,111,Lewis,1999,5746,5572,174,3.0
29,113,Lincoln,1999,18953,18373,580,3.1
29,115,Linn,1999,6617,6246,371,5.6
29,117,Livingston,1999,7464,7283,181,2.4
29,119,McDonald,1999,8659,8344,315,3.6
29,121,Macon,1999,7737,7436,301,3.9
29,123,Madison,1999,4454,4206,248,5.6
29,125,Maries,1999,4560,4425,135,3.0
29,127,Marion,1999,16037,15474,563,3.5
29,129,Mercer,1999,1660,1613,47,2.8
29,131,Miller,1999,11869,11319,550,4.6
29,133,Mississippi,1999,6093,5784,309,5.1
29,135,Moniteau,1999,7545,7357,188,2.5
29,137,Monroe,1999,4619,4427,192,4.2
29,139,Montgomery,1999,5832,5587,245,4.2
29,141,Morgan,1999,8665,8322,343,4.0
29,143,New Madrid,1999,8797,8347,450,5.1
29,145,Newton,1999,28462,27486,976,3.4
29,147,Nodaway,1999,13167,13010,157,1.2
29,149,Oregon,1999,4540,4360,180,4.0
29,151,Osage,1999,7662,7336,326,4.3
29,153,Ozark,1999,4171,3986,185,4.4
29,155,Pemiscot,1999,8562,7998,564,6.6
29,157,Perry,1999,11214,10980,234,2.1
29,159,Pettis,1999,22237,21402,835,3.8
29,161,Phelps,1999,20551,20041,510,2.5
29,163,Pike,1999,8276,7966,310,3.7
29,165,Platte,1999,44948,44107,841,1.9
29,167,Polk,1999,12638,12255,383,3.0
29,169,Pulaski,1999,12545,11797,748,6.0
29,171,Putnam,1999,2009,1945,64,3.2
29,173,Ralls,1999,5614,5414,200,3.6
29,175,Randolph,1999,11265,10837,428,3.8
29,177,Ray,1999,11682,11225,457,3.9
29,179,Reynolds,1999,3276,3134,142,4.3
29,181,Ripley,1999,5541,5307,234,4.2
29,183,St. Charles,1999,162713,159445,3268,2.0
29,185,St. Clair,1999,3957,3797,160,4.0
29,186,Ste. Genevieve,1999,9079,8786,293,3.2
29,187,St. Francois,1999,25200,23789,1411,5.6
29,189,St. Louis,1999,562568,547662,14906,2.6
29,195,Saline,1999,12272,11963,309,2.5
29,197,Schuyler,1999,2455,2375,80,3.3
29,199,Scotland,1999,2254,2191,63,2.8
29,201,Scott,1999,20922,20099,823,3.9
29,203,Shannon,1999,4099,3893,206,5.0
29,205,Shelby,1999,3542,3349,193,5.4
29,207,Stoddard,1999,13555,12928,627,4.6
29,209,Stone,1999,14127,13043,1084,7.7
29,211,Sullivan,1999,4112,4034,78,1.9
29,213,Taney,1999,30418,28570,1848,6.1
29,215,Texas,1999,9257,8488,769,8.3
29,217,Vernon,1999,9233,8978,255,2.8
29,219,Warren,1999,12982,12561,421,3.2
29,221,Washington,1999,9840,9155,685,7.0
29,223,Wayne,1999,3529,3266,263,7.5
29,225,Webster,1999,14732,14330,402,2.7
29,227,Worth,1999,866,835,31,3.6
29,229,Wright,1999,7380,7010,370,5.0
29,510,St. Louis city,1999,156147,146264,9883,6.3
30,1,Beaverhead,1999,5104,4855,249,4.9
30,3,Big Horn,1999,5373,4844,529,9.8
30,5,Blaine,1999,2951,2700,251,8.5
30,7,Broadwater,1999,2116,1991,125,5.9
30,9,Carbon,1999,4811,4548,263,5.5
30,11,Carter,1999,1068,1042,26,2.4
30,13,Cascade,1999,36975,34944,2031,5.5
30,15,Chouteau,1999,2903,2811,92,3.2
30,17,Custer,1999,6016,5745,271,4.5
30,19,Daniels,1999,1302,1261,41,3.1
30,21,Dawson,1999,5016,4809,207,4.1
30,23,Deer Lodge,1999,3899,3586,313,8.0
30,25,Fallon,1999,1714,1617,97,5.7
30,27,Fergus,1999,6350,6009,341,5.4
30,29,Flathead,1999,37533,34846,2687,7.2
30,31,Gallatin,1999,42016,40810,1206,2.9
30,33,Garfield,1999,1060,1027,33,3.1
30,35,Glacier,1999,5441,4648,793,14.6
30,37,Golden Valley,1999,574,541,33,5.7
30,39,Granite,1999,1221,1127,94,7.7
30,41,Hill,1999,8912,8382,530,5.9
30,43,Jefferson,1999,5070,4838,232,4.6
30,45,Judith Basin,1999,1218,1163,55,4.5
30,47,Lake,1999,12270,11487,783,6.4
30,49,Lewis and Clark,1999,27687,26408,1279,4.6
30,51,Liberty,1999,1217,1163,54,4.4
30,53,Lincoln,1999,7010,6128,882,12.6
30,55,McCone,1999,1294,1245,49,3.8
30,57,Madison,1999,3956,3774,182,4.6
30,59,Meagher,1999,1068,1000,68,6.4
30,61,Mineral,1999,1658,1496,162,9.8
30,63,Missoula,1999,53040,51082,1958,3.7
30,65,Musselshell,1999,1824,1671,153,8.4
30,67,Park,1999,10248,9671,577,5.6
30,69,Petroleum,1999,368,346,22,6.0
30,71,Phillips,1999,2416,2222,194,8.0
30,73,Pondera,1999,3420,3255,165,4.8
30,75,Powder River,1999,1297,1248,49,3.8
30,77,Powell,1999,2518,2389,129,5.1
30,79,Prairie,1999,679,651,28,4.1
30,81,Ravalli,1999,17458,16385,1073,6.1
30,83,Richland,1999,5668,5267,401,7.1
30,85,Roosevelt,1999,4315,3882,433,10.0
30,87,Rosebud,1999,4530,4178,352,7.8
30,89,Sanders,1999,4260,3860,400,9.4
30,91,Sheridan,1999,2164,2041,123,5.7
30,93,Silver Bow,1999,17407,16419,988,5.7
30,95,Stillwater,1999,4691,4493,198,4.2
30,97,Sweet Grass,1999,1793,1731,62,3.5
30,99,Teton,1999,3462,3336,126,3.6
30,101,Toole,1999,2954,2840,114,3.9
30,103,Treasure,1999,504,482,22,4.4
30,105,Valley,1999,4299,4096,203,4.7
30,107,Wheatland,1999,1264,1187,77,6.1
30,109,Wibaux,1999,587,563,24,4.1
30,111,Yellowstone,1999,70757,67844,2913,4.1
31,1,Adams,1999,15951,15614,337,2.1
31,3,Antelope,1999,3138,3031,107,3.4
31,5,Arthur,1999,200,196,4,2.0
31,7,Banner,1999,429,418,11,2.6
31,9,Blaine,1999,388,380,8,2.1
31,11,Boone,1999,2982,2905,77,2.6
31,13,Box Butte,1999,6565,6260,305,4.6
31,15,Boyd,1999,1143,1104,39,3.4
31,17,Brown,1999,1793,1723,70,3.9
31,19,Buffalo,1999,25053,24288,765,3.1
31,21,Burt,1999,3535,3383,152,4.3
31,23,Butler,1999,4288,4169,119,2.8
31,25,Cass,1999,13106,12798,308,2.4
31,27,Cedar,1999,4698,4575,123,2.6
31,29,Chase,1999,1966,1927,39,2.0
31,31,Cherry,1999,3457,3383,74,2.1
31,33,Cheyenne,1999,5420,5286,134,2.5
31,35,Clay,1999,3527,3446,81,2.3
31,37,Colfax,1999,4914,4798,116,2.4
31,39,Cuming,1999,5404,5294,110,2.0
31,41,Custer,1999,5544,5423,121,2.2
31,43,Dakota,1999,10398,10112,286,2.8
31,45,Dawes,1999,4701,4516,185,3.9
31,47,Dawson,1999,13309,12927,382,2.9
31,49,Deuel,1999,899,868,31,3.4
31,51,Dixon,1999,2493,2425,68,2.7
31,53,Dodge,1999,19554,19006,548,2.8
31,55,Douglas,1999,259564,252584,6980,2.7
31,57,Dundy,1999,1094,1073,21,1.9
31,59,Fillmore,1999,3191,3117,74,2.3
31,61,Franklin,1999,1638,1597,41,2.5
31,63,Frontier,1999,1537,1495,42,2.7
31,65,Furnas,1999,2525,2459,66,2.6
31,67,Gage,1999,12479,12125,354,2.8
31,69,Garden,1999,1113,1087,26,2.3
31,71,Garfield,1999,1006,985,21,2.1
31,73,Gosper,1999,1331,1309,22,1.7
31,75,Grant,1999,356,348,8,2.2
31,77,Greeley,1999,1415,1364,51,3.6
31,79,Hall,1999,31347,30342,1005,3.2
31,81,Hamilton,1999,5495,5382,113,2.1
31,83,Harlan,1999,1753,1703,50,2.9
31,85,Hayes,1999,476,459,17,3.6
31,87,Hitchcock,1999,1600,1563,37,2.3
31,89,Holt,1999,6773,6582,191,2.8
31,91,Hooker,1999,432,422,10,2.3
31,93,Howard,1999,3557,3444,113,3.2
31,95,Jefferson,1999,4085,3968,117,2.9
31,97,Johnson,1999,2218,2132,86,3.9
31,99,Kearney,1999,3798,3716,82,2.2
31,101,Keith,1999,4627,4499,128,2.8
31,103,Keya Paha,1999,479,466,13,2.7
31,105,Kimball,1999,1968,1932,36,1.8
31,107,Knox,1999,4835,4672,163,3.4
31,109,Lancaster,1999,145396,142095,3301,2.3
31,111,Lincoln,1999,17530,16977,553,3.2
31,113,Logan,1999,445,436,9,2.0
31,115,Loup,1999,404,396,8,2.0
31,117,McPherson,1999,299,296,3,1.0
31,119,Madison,1999,20038,19218,820,4.1
31,121,Merrick,1999,4609,4504,105,2.3
31,123,Morrill,1999,2760,2654,106,3.8
31,125,Nance,1999,1715,1661,54,3.1
31,127,Nemaha,1999,3970,3800,170,4.3
31,129,Nuckolls,1999,2287,2239,48,2.1
31,131,Otoe,1999,7761,7531,230,3.0
31,133,Pawnee,1999,1635,1589,46,2.8
31,135,Perkins,1999,1526,1487,39,2.6
31,137,Phelps,1999,5044,4940,104,2.1
31,139,Pierce,1999,4066,3949,117,2.9
31,141,Platte,1999,17391,16815,576,3.3
31,143,Polk,1999,2376,2329,47,2.0
31,145,Red Willow,1999,6071,5912,159,2.6
31,147,Richardson,1999,4415,4174,241,5.5
31,149,Rock,1999,889,853,36,4.0
31,151,Saline,1999,7129,6993,136,1.9
31,153,Sarpy,1999,62168,60916,1252,2.0
31,155,Saunders,1999,10199,9922,277,2.7
31,157,Scotts Bluff,1999,18532,17774,758,4.1
31,159,Seward,1999,9295,9057,238,2.6
31,161,Sheridan,1999,2911,2826,85,2.9
31,163,Sherman,1999,1475,1433,42,2.8
31,165,Sioux,1999,768,753,15,2.0
31,167,Stanton,1999,3306,3207,99,3.0
31,169,Thayer,1999,3328,3260,68,2.0
31,171,Thomas,1999,481,455,26,5.4
31,173,Thurston,1999,2868,2563,305,10.6
31,175,Valley,1999,2510,2449,61,2.4
31,177,Washington,1999,11028,10805,223,2.0
31,179,Wayne,1999,6429,6211,218,3.4
31,181,Webster,1999,1791,1752,39,2.2
31,183,Wheeler,1999,413,400,13,3.1
31,185,York,1999,9222,9090,132,1.4
32,1,Churchill,1999,10030,9247,783,7.8
32,3,Clark,1999,706438,678665,27773,3.9
32,5,Douglas,1999,19294,18460,834,4.3
32,7,Elko,1999,21825,20791,1034,4.7
32,9,Esmeralda,1999,658,593,65,9.9
32,11,Eureka,1999,929,893,36,3.9
32,13,Humboldt,1999,8426,7933,493,5.9
32,15,Lander,1999,2741,2509,232,8.5
32,17,Lincoln,1999,1114,1052,62,5.6
32,19,Lyon,1999,14261,13217,1044,7.3
32,21,Mineral,1999,2139,1978,161,7.5
32,23,Nye,1999,16110,15387,723,4.5
32,27,Pershing,1999,2368,2287,81,3.4
32,29,Storey,1999,1661,1603,58,3.5
32,31,Washoe,1999,187738,181465,6273,3.3
32,33,White Pine,1999,3462,3344,118,3.4
32,510,Carson City,1999,24338,23454,884,3.6
33,1,Belknap,1999,30018,29288,730,2.4
33,3,Carroll,1999,21377,20828,549,2.6
33,5,Cheshire,1999,38765,37700,1065,2.7
33,7,Coos,1999,16679,15978,701,4.2
33,9,Grafton,1999,43991,43149,842,1.9
33,11,Hillsborough,1999,206228,200536,5692,2.8
33,13,Merrimack,1999,74844,73241,1603,2.1
33,15,Rockingham,1999,164311,158982,5329,3.2
33,17,Strafford,1999,57733,56318,1415,2.5
33,19,Sullivan,1999,21430,20834,596,2.8
34,1,Atlantic,1999,130129,121143,8986,6.9
34,3,Bergen,1999,449130,433161,15969,3.6
34,5,Burlington,1999,229057,221718,7339,3.2
34,7,Camden,1999,261187,249481,11706,4.5
34,9,Cape May,1999,46350,41844,4506,9.7
34,11,Cumberland,1999,66138,60763,5375,8.1
34,13,Essex,1999,374725,354205,20520,5.5
34,15,Gloucester,1999,133672,127931,5741,4.3
34,17,Hudson,1999,287381,267345,20036,7.0
34,19,Hunterdon,1999,71657,70236,1421,2.0
34,21,Mercer,1999,174888,168345,6543,3.7
34,23,Middlesex,1999,415449,400604,14845,3.6
34,25,Monmouth,1999,314195,302206,11989,3.8
34,27,Morris,1999,268353,261195,7158,2.7
34,29,Ocean,1999,216528,207011,9517,4.4
34,31,Passaic,1999,236383,222090,14293,6.0
34,33,Salem,1999,32190,30723,1467,4.6
34,35,Somerset,1999,174553,170525,4028,2.3
34,37,Sussex,1999,78115,75539,2576,3.3
34,39,Union,1999,270162,257673,12489,4.6
34,41,Warren,1999,52898,50807,2091,4.0
35,1,Bernalillo,1999,290802,279611,11191,3.8
35,3,Catron,1999,1149,1036,113,9.8
35,5,Chaves,1999,25804,23664,2140,8.3
35,6,Cibola,1999,11147,10261,886,7.9
35,7,Colfax,1999,6791,6418,373,5.5
35,9,Curry,1999,19747,18925,822,4.2
35,11,De Baca,1999,1025,981,44,4.3
35,13,Dona Ana,1999,70893,65246,5647,8.0
35,15,Eddy,1999,24007,22062,1945,8.1
35,17,Grant,1999,12840,11737,1103,8.6
35,19,Guadalupe,1999,1884,1730,154,8.2
35,21,Harding,1999,427,413,14,3.3
35,23,Hidalgo,1999,2505,2261,244,9.7
35,25,Lea,1999,24476,22192,2284,9.3
35,27,Lincoln,1999,7566,7253,313,4.1
35,28,Los Alamos,1999,10384,10221,163,1.6
35,29,Luna,1999,11315,8646,2669,23.6
35,31,McKinley,1999,25309,23506,1803,7.1
35,33,Mora,1999,1745,1451,294,16.8
35,35,Otero,1999,20830,19807,1023,4.9
35,37,Quay,1999,4594,4418,176,3.8
35,39,Rio Arriba,1999,19785,18342,1443,7.3
35,41,Roosevelt,1999,7615,7355,260,3.4
35,43,Sandoval,1999,44421,42629,1792,4.0
35,45,San Juan,1999,50081,46274,3807,7.6
35,47,San Miguel,1999,12074,11231,843,7.0
35,49,Santa Fe,1999,65116,63260,1856,2.9
35,51,Sierra,1999,4145,4012,133,3.2
35,53,Socorro,1999,6475,6133,342,5.3
35,55,Taos,1999,13076,11559,1517,11.6
35,57,Torrance,1999,6533,6216,317,4.9
35,59,Union,1999,2034,1980,54,2.7
35,61,Valencia,1999,29901,28587,1314,4.4
36,1,Albany,1999,158762,154268,4494,2.8
36,3,Allegany,1999,23478,21713,1765,7.5
36,5,Bronx,1999,483068,443298,39770,8.2
36,7,Broome,1999,99066,95033,4033,4.1
36,9,Cattaraugus,1999,41623,38692,2931,7.0
36,11,Cayuga,1999,38467,36516,1951,5.1
36,13,Chautauqua,1999,67211,63819,3392,5.0
36,15,Chemung,1999,45038,42901,2137,4.7
36,17,Chenango,1999,24411,23005,1406,5.8
36,19,Clinton,1999,40221,37640,2581,6.4
36,21,Columbia,1999,34074,33036,1038,3.0
36,23,Cortland,1999,22975,21417,1558,6.8
36,25,Delaware,1999,21075,19993,1082,5.1
36,27,Dutchess,1999,121543,117430,4113,3.4
36,29,Erie,1999,467758,443876,23882,5.1
36,31,Essex,1999,18471,16927,1544,8.4
36,33,Franklin,1999,22286,20571,1715,7.7
36,35,Fulton,1999,27040,25429,1611,6.0
36,37,Genesee,1999,32298,30632,1666,5.2
36,39,Greene,1999,21900,20734,1166,5.3
36,41,Hamilton,1999,2606,2337,269,10.3
36,43,Herkimer,1999,31402,29777,1625,5.2
36,45,Jefferson,1999,44645,40592,4053,9.1
36,47,Kings,1999,1006682,926500,80182,8.0
36,49,Lewis,1999,12341,11257,1084,8.8
36,51,Livingston,1999,35015,33303,1712,4.9
36,53,Madison,1999,36091,34440,1651,4.6
36,55,Monroe,1999,386802,372006,14796,3.8
36,57,Montgomery,1999,23742,22254,1488,6.3
36,59,Nassau,1999,700045,679461,20584,2.9
36,61,New York,1999,863123,812353,50770,5.9
36,63,Niagara,1999,110076,103409,6667,6.1
36,65,Oneida,1999,113680,109151,4529,4.0
36,67,Onondaga,1999,236040,227852,8188,3.5
36,69,Ontario,1999,54468,52201,2267,4.2
36,71,Orange,1999,160979,155135,5844,3.6
36,73,Orleans,1999,21367,20253,1114,5.2
36,75,Oswego,1999,57780,54169,3611,6.2
36,77,Otsego,1999,32087,30437,1650,5.1
36,79,Putnam,1999,55338,53766,1572,2.8
36,81,Queens,1999,1036623,973349,63274,6.1
36,83,Rensselaer,1999,80373,77253,3120,3.9
36,85,Richmond,1999,207533,195470,12063,5.8
36,87,Rockland,1999,148549,143504,5045,3.4
36,89,St. Lawrence,1999,52052,47784,4268,8.2
36,91,Saratoga,1999,106556,103079,3477,3.3
36,93,Schenectady,1999,72851,70310,2541,3.5
36,95,Schoharie,1999,15322,14526,796,5.2
36,97,Schuyler,1999,9128,8607,521,5.7
36,99,Seneca,1999,15949,15087,862,5.4
36,101,Steuben,1999,48249,45535,2714,5.6
36,103,Suffolk,1999,731672,705693,25979,3.6
36,105,Sullivan,1999,31599,29771,1828,5.8
36,107,Tioga,1999,26687,25694,993,3.7
36,109,Tompkins,1999,52129,50693,1436,2.8
36,111,Ulster,1999,83579,80636,2943,3.5
36,113,Warren,1999,32095,30229,1866,5.8
36,115,Washington,1999,28790,27490,1300,4.5
36,117,Wayne,1999,50678,48184,2494,4.9
36,119,Westchester,1999,455075,439779,15296,3.4
36,121,Wyoming,1999,20873,19395,1478,7.1
36,123,Yates,1999,13681,13130,551,4.0
37,1,Alamance,1999,68156,66448,1708,2.5
37,3,Alexander,1999,17743,17347,396,2.2
37,5,Alleghany,1999,5936,5741,195,3.3
37,7,Anson,1999,10722,9949,773,7.2
37,9,Ashe,1999,11778,10987,791,6.7
37,11,Avery,1999,8127,7848,279,3.4
37,13,Beaufort,1999,20645,19039,1606,7.8
37,15,Bertie,1999,8861,8349,512,5.8
37,17,Bladen,1999,20439,19380,1059,5.2
37,19,Brunswick,1999,34917,33426,1491,4.3
37,21,Buncombe,1999,104869,102437,2432,2.3
37,23,Burke,1999,43880,42748,1132,2.6
37,25,Cabarrus,1999,69257,67836,1421,2.1
37,27,Caldwell,1999,41250,40468,782,1.9
37,29,Camden,1999,3302,3215,87,2.6
37,31,Carteret,1999,30128,28901,1227,4.1
37,33,Caswell,1999,13418,13119,299,2.2
37,35,Catawba,1999,76556,75005,1551,2.0
37,37,Chatham,1999,27328,26841,487,1.8
37,39,Cherokee,1999,11965,11114,851,7.1
37,41,Chowan,1999,6727,6516,211,3.1
37,43,Clay,1999,4319,4185,134,3.1
37,45,Cleveland,1999,45187,42796,2391,5.3
37,47,Columbus,1999,23215,21084,2131,9.2
37,49,Craven,1999,38033,36394,1639,4.3
37,51,Cumberland,1999,122812,117984,4828,3.9
37,53,Currituck,1999,9312,9091,221,2.4
37,55,Dare,1999,18543,17636,907,4.9
37,57,Davidson,1999,81515,79568,1947,2.4
37,59,Davie,1999,18195,17716,479,2.6
37,61,Duplin,1999,22941,21473,1468,6.4
37,63,Durham,1999,118755,116238,2517,2.1
37,65,Edgecombe,1999,25196,23045,2151,8.5
37,67,Forsyth,1999,156606,152856,3750,2.4
37,69,Franklin,1999,24126,23490,636,2.6
37,71,Gaston,1999,101778,97973,3805,3.7
37,73,Gates,1999,4805,4668,137,2.9
37,75,Graham,1999,3874,3540,334,8.6
37,77,Granville,1999,23504,22761,743,3.2
37,79,Greene,1999,9398,8944,454,4.8
37,81,Guilford,1999,224780,219152,5628,2.5
37,83,Halifax,1999,23081,21366,1715,7.4
37,85,Harnett,1999,36849,35560,1289,3.5
37,87,Haywood,1999,24746,23732,1014,4.1
37,89,Henderson,1999,38986,38042,944,2.4
37,91,Hertford,1999,10737,10302,435,4.1
37,93,Hoke,1999,12304,11431,873,7.1
37,95,Hyde,1999,3194,2987,207,6.5
37,97,Iredell,1999,65038,63483,1555,2.4
37,99,Jackson,1999,16569,15916,653,3.9
37,101,Johnston,1999,62014,60784,1230,2.0
37,103,Jones,1999,4579,4318,261,5.7
37,105,Lee,1999,27080,26165,915,3.4
37,107,Lenoir,1999,30628,28610,2018,6.6
37,109,Lincoln,1999,32721,31756,965,2.9
37,111,McDowell,1999,20675,19808,867,4.2
37,113,Macon,1999,14268,13731,537,3.8
37,115,Madison,1999,9277,9013,264,2.8
37,117,Martin,1999,11630,10629,1001,8.6
37,119,Mecklenburg,1999,377841,369897,7944,2.1
37,121,Mitchell,1999,7353,6862,491,6.7
37,123,Montgomery,1999,12273,11747,526,4.3
37,125,Moore,1999,30867,29771,1096,3.6
37,127,Nash,1999,44579,42190,2389,5.4
37,129,New Hanover,1999,83607,80979,2628,3.1
37,131,Northampton,1999,8547,7972,575,6.7
37,133,Onslow,1999,50147,48336,1811,3.6
37,135,Orange,1999,65292,64525,767,1.2
37,137,Pamlico,1999,5645,5424,221,3.9
37,139,Pasquotank,1999,15593,15019,574,3.7
37,141,Pender,1999,17379,16530,849,4.9
37,143,Perquimans,1999,4895,4749,146,3.0
37,145,Person,1999,17681,16911,770,4.4
37,147,Pitt,1999,70000,66818,3182,4.5
37,149,Polk,1999,8266,8001,265,3.2
37,151,Randolph,1999,73118,71106,2012,2.8
37,153,Richmond,1999,19629,18335,1294,6.6
37,155,Robeson,1999,55387,50787,4600,8.3
37,157,Rockingham,1999,46247,43947,2300,5.0
37,159,Rowan,1999,67081,64995,2086,3.1
37,161,Rutherford,1999,29792,27602,2190,7.4
37,163,Sampson,1999,24193,23032,1161,4.8
37,165,Scotland,1999,17939,16774,1165,6.5
37,167,Stanly,1999,27898,26876,1022,3.7
37,169,Stokes,1999,23769,23210,559,2.4
37,171,Surry,1999,35479,34142,1337,3.8
37,173,Swain,1999,6176,5483,693,11.2
37,175,Transylvania,1999,11597,11379,218,1.9
37,177,Tyrrell,1999,1898,1736,162,8.5
37,179,Union,1999,63275,61981,1294,2.0
37,181,Vance,1999,20116,18665,1451,7.2
37,183,Wake,1999,360221,355090,5131,1.4
37,185,Warren,1999,7417,6943,474,6.4
37,187,Washington,1999,6334,5944,390,6.2
37,189,Watauga,1999,23906,23558,348,1.5
37,191,Wayne,1999,50383,48261,2122,4.2
37,193,Wilkes,1999,33736,32837,899,2.7
37,195,Wilson,1999,37861,34916,2945,7.8
37,197,Yadkin,1999,18767,18261,506,2.7
37,199,Yancey,1999,6781,6437,344,5.1
38,1,Adams,1999,1389,1353,36,2.6
38,3,Barnes,1999,5706,5541,165,2.9
38,5,Benson,1999,2792,2584,208,7.4
38,7,Billings,1999,520,496,24,4.6
38,9,Bottineau,1999,3355,3208,147,4.4
38,11,Bowman,1999,1819,1779,40,2.2
38,13,Burke,1999,1013,978,35,3.5
38,15,Burleigh,1999,40161,39167,994,2.5
38,17,Cass,1999,72993,71799,1194,1.6
38,19,Cavalier,1999,2505,2432,73,2.9
38,21,Dickey,1999,2917,2872,45,1.5
38,23,Divide,1999,1120,1092,28,2.5
38,25,Dunn,1999,1950,1868,82,4.2
38,27,Eddy,1999,1309,1240,69,5.3
38,29,Emmons,1999,2043,1966,77,3.8
38,31,Foster,1999,2321,2267,54,2.3
38,33,Golden Valley,1999,921,886,35,3.8
38,35,Grand Forks,1999,35724,34868,856,2.4
38,37,Grant,1999,1550,1496,54,3.5
38,39,Griggs,1999,1582,1549,33,2.1
38,41,Hettinger,1999,1342,1295,47,3.5
38,43,Kidder,1999,1459,1394,65,4.5
38,45,LaMoure,1999,2276,2218,58,2.5
38,47,Logan,1999,1135,1115,20,1.8
38,49,McHenry,1999,2780,2643,137,4.9
38,51,McIntosh,1999,1724,1686,38,2.2
38,53,McKenzie,1999,3199,3072,127,4.0
38,55,McLean,1999,4542,4250,292,6.4
38,57,Mercer,1999,4642,4339,303,6.5
38,59,Morton,1999,13690,13195,495,3.6
38,61,Mountrail,1999,3079,2874,205,6.7
38,63,Nelson,1999,1585,1517,68,4.3
38,65,Oliver,1999,1049,997,52,5.0
38,67,Pembina,1999,4962,4674,288,5.8
38,69,Pierce,1999,2577,2499,78,3.0
38,71,Ramsey,1999,6396,6195,201,3.1
38,73,Ransom,1999,2748,2684,64,2.3
38,75,Renville,1999,1365,1330,35,2.6
38,77,Richland,1999,9499,9246,253,2.7
38,79,Rolette,1999,5732,4993,739,12.9
38,81,Sargent,1999,2564,2517,47,1.8
38,83,Sheridan,1999,712,667,45,6.3
38,85,Sioux,1999,1674,1560,114,6.8
38,87,Slope,1999,413,391,22,5.3
38,89,Stark,1999,12545,12048,497,4.0
38,91,Steele,1999,1097,1085,12,1.1
38,93,Stutsman,1999,11759,11463,296,2.5
38,95,Towner,1999,1357,1324,33,2.4
38,97,Traill,1999,3813,3696,117,3.1
38,99,Walsh,1999,6344,6096,248,3.9
38,101,Ward,1999,28918,28007,911,3.2
38,103,Wells,1999,2580,2480,100,3.9
38,105,Williams,1999,9477,8939,538,5.7
39,1,Adams,1999,11749,10528,1221,10.4
39,3,Allen,1999,51357,48689,2668,5.2
39,5,Ashland,1999,26001,24819,1182,4.5
39,7,Ashtabula,1999,47271,44256,3015,6.4
39,9,Athens,1999,26658,25234,1424,5.3
39,11,Auglaize,1999,24770,23704,1066,4.3
39,13,Belmont,1999,32335,30377,1958,6.1
39,15,Brown,1999,19975,18798,1177,5.9
39,17,Butler,1999,185494,178969,6525,3.5
39,19,Carroll,1999,13635,12835,800,5.9
39,21,Champaign,1999,18758,17979,779,4.2
39,23,Clark,1999,68211,64898,3313,4.9
39,25,Clermont,1999,95162,91312,3850,4.0
39,27,Clinton,1999,25204,24279,925,3.7
39,29,Columbiana,1999,52681,49321,3360,6.4
39,31,Coshocton,1999,17684,16515,1169,6.6
39,33,Crawford,1999,21656,20316,1340,6.2
39,35,Cuyahoga,1999,686180,665042,21138,3.1
39,37,Darke,1999,29483,27889,1594,5.4
39,39,Defiance,1999,21166,20188,978,4.6
39,41,Delaware,1999,58038,56873,1165,2.0
39,43,Erie,1999,41958,39959,1999,4.8
39,45,Fairfield,1999,66591,64521,2070,3.1
39,47,Fayette,1999,15657,15012,645,4.1
39,49,Franklin,1999,591222,574840,16382,2.8
39,51,Fulton,1999,23408,22377,1031,4.4
39,53,Gallia,1999,15067,13725,1342,8.9
39,55,Geauga,1999,48848,47821,1027,2.1
39,57,Greene,1999,72220,69590,2630,3.6
39,59,Guernsey,1999,19054,17238,1816,9.5
39,61,Hamilton,1999,431994,414998,16996,3.9
39,63,Hancock,1999,41958,40670,1288,3.1
39,65,Hardin,1999,15495,14895,600,3.9
39,67,Harrison,1999,6811,6323,488,7.2
39,69,Henry,1999,15890,14918,972,6.1
39,71,Highland,1999,19238,18211,1027,5.3
39,73,Hocking,1999,11981,11033,948,7.9
39,75,Holmes,1999,18750,18136,614,3.3
39,77,Huron,1999,30195,27761,2434,8.1
39,79,Jackson,1999,14489,13366,1123,7.8
39,81,Jefferson,1999,29835,27592,2243,7.5
39,83,Knox,1999,26234,24822,1412,5.4
39,85,Lake,1999,128649,125274,3375,2.6
39,87,Lawrence,1999,26980,24868,2112,7.8
39,89,Licking,1999,71684,68770,2914,4.1
39,91,Logan,1999,28321,27435,886,3.1
39,93,Lorain,1999,143033,138432,4601,3.2
39,95,Lucas,1999,230091,216933,13158,5.7
39,97,Madison,1999,20534,19959,575,2.8
39,99,Mahoning,1999,116878,109760,7118,6.1
39,101,Marion,1999,31388,30071,1317,4.2
39,103,Medina,1999,81079,79124,1955,2.4
39,105,Meigs,1999,8517,7453,1064,12.5
39,107,Mercer,1999,19930,18202,1728,8.7
39,109,Miami,1999,50543,48401,2142,4.2
39,111,Monroe,1999,5906,5290,616,10.4
39,113,Montgomery,1999,277942,266303,11639,4.2
39,115,Morgan,1999,4758,4019,739,15.5
39,117,Morrow,1999,14204,13391,813,5.7
39,119,Muskingum,1999,43218,40065,3153,7.3
39,121,Noble,1999,5601,5099,502,9.0
39,123,Ottawa,1999,20924,19455,1469,7.0
39,125,Paulding,1999,9929,9438,491,4.9
39,127,Perry,1999,14501,13213,1288,8.9
39,129,Pickaway,1999,24614,23732,882,3.6
39,131,Pike,1999,11677,10591,1086,9.3
39,133,Portage,1999,83022,79407,3615,4.4
39,135,Preble,1999,21186,20239,947,4.5
39,137,Putnam,1999,20579,19741,838,4.1
39,139,Richland,1999,61855,57492,4363,7.1
39,141,Ross,1999,34537,32602,1935,5.6
39,143,Sandusky,1999,32044,30169,1875,5.9
39,145,Scioto,1999,33013,29937,3076,9.3
39,147,Seneca,1999,28476,26820,1656,5.8
39,149,Shelby,1999,28135,26881,1254,4.5
39,151,Stark,1999,187433,178228,9205,4.9
39,153,Summit,1999,280666,267642,13024,4.6
39,155,Trumbull,1999,112128,105661,6467,5.8
39,157,Tuscarawas,1999,44244,41747,2497,5.6
39,159,Union,1999,17881,17323,558,3.1
39,161,Van Wert,1999,16651,15994,657,3.9
39,163,Vinton,1999,3772,3292,480,12.7
39,165,Warren,1999,80372,77825,2547,3.2
39,167,Washington,1999,32354,30257,2097,6.5
39,169,Wayne,1999,57217,54996,2221,3.9
39,171,Williams,1999,21044,20004,1040,4.9
39,173,Wood,1999,67426,64877,2549,3.8
39,175,Wyandot,1999,12299,11684,615,5.0
40,1,Adair,1999,8980,8489,491,5.5
40,3,Alfalfa,1999,2534,2490,44,1.7
40,5,Atoka,1999,4943,4770,173,3.5
40,7,Beaver,1999,2667,2569,98,3.7
40,9,Beckham,1999,9859,9393,466,4.7
40,11,Blaine,1999,4596,4433,163,3.5
40,13,Bryan,1999,16810,16397,413,2.5
40,15,Caddo,1999,13049,12528,521,4.0
40,17,Canadian,1999,46770,45861,909,1.9
40,19,Carter,1999,20302,19280,1022,5.0
40,21,Cherokee,1999,18505,17881,624,3.4
40,23,Choctaw,1999,5524,5160,364,6.6
40,25,Cimarron,1999,1757,1716,41,2.3
40,27,Cleveland,1999,113344,110967,2377,2.1
40,29,Coal,1999,2519,2358,161,6.4
40,31,Comanche,1999,41575,40055,1520,3.7
40,33,Cotton,1999,2193,2071,122,5.6
40,35,Craig,1999,6707,6531,176,2.6
40,37,Creek,1999,33687,32484,1203,3.6
40,39,Custer,1999,12025,11626,399,3.3
40,41,Delaware,1999,17609,16977,632,3.6
40,43,Dewey,1999,1990,1912,78,3.9
40,45,Ellis,1999,1650,1578,72,4.4
40,47,Garfield,1999,27529,26689,840,3.1
40,49,Garvin,1999,10969,10315,654,6.0
40,51,Grady,1999,19420,18568,852,4.4
40,53,Grant,1999,2239,2181,58,2.6
40,55,Greer,1999,2498,2422,76,3.0
40,57,Harmon,1999,1263,1220,43,3.4
40,59,Harper,1999,1749,1693,56,3.2
40,61,Haskell,1999,4912,4573,339,6.9
40,63,Hughes,1999,5434,5015,419,7.7
40,65,Jackson,1999,12842,12415,427,3.3
40,67,Jefferson,1999,3144,3030,114,3.6
40,69,Johnston,1999,4927,4728,199,4.0
40,71,Kay,1999,22056,20603,1453,6.6
40,73,Kingfisher,1999,6743,6562,181,2.7
40,75,Kiowa,1999,4756,4593,163,3.4
40,77,Latimer,1999,4634,4255,379,8.2
40,79,Le Flore,1999,20067,18972,1095,5.5
40,81,Lincoln,1999,14282,13689,593,4.2
40,83,Logan,1999,14569,14206,363,2.5
40,85,Love,1999,3799,3649,150,3.9
40,87,McClain,1999,13386,13069,317,2.4
40,89,McCurtain,1999,15513,14492,1021,6.6
40,91,McIntosh,1999,8049,7548,501,6.2
40,93,Major,1999,3933,3812,121,3.1
40,95,Marshall,1999,5417,5193,224,4.1
40,97,Mayes,1999,16066,15418,648,4.0
40,99,Murray,1999,5437,5090,347,6.4
40,101,Muskogee,1999,31937,30547,1390,4.4
40,103,Noble,1999,5733,5592,141,2.5
40,105,Nowata,1999,3753,3569,184,4.9
40,107,Okfuskee,1999,3717,3502,215,5.8
40,109,Oklahoma,1999,333630,324404,9226,2.8
40,111,Okmulgee,1999,14364,13316,1048,7.3
40,113,Osage,1999,20351,19609,742,3.6
40,115,Ottawa,1999,13386,12729,657,4.9
40,117,Pawnee,1999,6440,6105,335,5.2
40,119,Payne,1999,37672,37196,476,1.3
40,121,Pittsburg,1999,18055,16925,1130,6.3
40,123,Pontotoc,1999,17249,16675,574,3.3
40,125,Pottawatomie,1999,29002,27929,1073,3.7
40,127,Pushmataha,1999,5003,4740,263,5.3
40,129,Roger Mills,1999,1980,1912,68,3.4
40,131,Rogers,1999,36850,35732,1118,3.0
40,133,Seminole,1999,10056,9347,709,7.1
40,135,Sequoyah,1999,17401,16525,876,5.0
40,137,Stephens,1999,17964,16839,1125,6.3
40,139,Texas,1999,14234,13926,308,2.2
40,141,Tillman,1999,3538,3391,147,4.2
40,143,Tulsa,1999,301592,291721,9871,3.3
40,145,Wagoner,1999,29058,28270,788,2.7
40,147,Washington,1999,19232,18458,774,4.0
40,149,Washita,1999,4940,4753,187,3.8
40,151,Woods,1999,4420,4336,84,1.9
40,153,Woodward,1999,8892,8374,518,5.8
41,1,Baker,1999,7404,6788,616,8.3
41,3,Benton,1999,40066,38898,1168,2.9
41,5,Clackamas,1999,196950,189275,7675,3.9
41,7,Clatsop,1999,17574,16612,962,5.5
41,9,Columbia,1999,23238,21881,1357,5.8
41,11,Coos,1999,27401,25048,2353,8.6
41,13,Crook,1999,7849,7181,668,8.5
41,15,Curry,1999,8559,7951,608,7.1
41,17,Deschutes,1999,58810,55193,3617,6.2
41,19,Douglas,1999,45812,41859,3953,8.6
41,21,Gilliam,1999,1206,1141,65,5.4
41,23,Grant,1999,4039,3565,474,11.7
41,25,Harney,1999,4091,3785,306,7.5
41,27,Hood River,1999,11085,10144,941,8.5
41,29,Jackson,1999,90321,84510,5811,6.4
41,31,Jefferson,1999,8720,8176,544,6.2
41,33,Josephine,1999,29509,27069,2440,8.3
41,35,Klamath,1999,28885,26433,2452,8.5
41,37,Lake,1999,3391,3055,336,9.9
41,39,Lane,1999,165808,157024,8784,5.3
41,41,Lincoln,1999,21353,19747,1606,7.5
41,43,Linn,1999,53174,49014,4160,7.8
41,45,Malheur,1999,14687,13336,1351,9.2
41,47,Marion,1999,142441,133913,8528,6.0
41,49,Morrow,1999,4140,3699,441,10.7
41,51,Multnomah,1999,369766,351207,18559,5.0
41,53,Polk,1999,31268,29676,1592,5.1
41,55,Sherman,1999,1053,997,56,5.3
41,57,Tillamook,1999,11432,10848,584,5.1
41,59,Umatilla,1999,36977,34600,2377,6.4
41,61,Union,1999,12400,11685,715,5.8
41,63,Wallowa,1999,3535,3232,303,8.6
41,65,Wasco,1999,12356,11438,918,7.4
41,67,Washington,1999,249088,239422,9666,3.9
41,69,Wheeler,1999,598,542,56,9.4
41,71,Yamhill,1999,42781,40810,1971,4.6
42,1,Adams,1999,42907,41316,1591,3.7
42,3,Allegheny,1999,659835,633826,26009,3.9
42,5,Armstrong,1999,31902,29849,2053,6.4
42,7,Beaver,1999,87283,83019,4264,4.9
42,9,Bedford,1999,26501,24892,1609,6.1
42,11,Berks,1999,186756,179025,7731,4.1
42,13,Blair,1999,64510,61518,2992,4.6
42,15,Bradford,1999,28145,26955,1190,4.2
42,17,Bucks,1999,334250,322597,11653,3.5
42,19,Butler,1999,90792,86968,3824,4.2
42,21,Cambria,1999,66714,62764,3950,5.9
42,23,Cameron,1999,2856,2621,235,8.2
42,25,Carbon,1999,27764,25875,1889,6.8
42,27,Centre,1999,66346,64521,1825,2.8
42,29,Chester,1999,241264,234894,6370,2.6
42,31,Clarion,1999,19445,18471,974,5.0
42,33,Clearfield,1999,38186,35201,2985,7.8
42,35,Clinton,1999,18157,17113,1044,5.7
42,37,Columbia,1999,33489,31711,1778,5.3
42,39,Crawford,1999,42632,40268,2364,5.5
42,41,Cumberland,1999,123468,120003,3465,2.8
42,43,Dauphin,1999,141245,135818,5427,3.8
42,45,Delaware,1999,283165,272401,10764,3.8
42,47,Elk,1999,18192,17073,1119,6.2
42,49,Erie,1999,143300,135993,7307,5.1
42,51,Fayette,1999,58309,54246,4063,7.0
42,53,Forest,1999,1852,1710,142,7.7
42,55,Franklin,1999,66030,62941,3089,4.7
42,57,Fulton,1999,6716,6430,286,4.3
42,59,Greene,1999,16393,15169,1224,7.5
42,61,Huntingdon,1999,19203,17557,1646,8.6
42,63,Indiana,1999,36993,34425,2568,6.9
42,65,Jefferson,1999,21819,20271,1548,7.1
42,67,Juniata,1999,10514,9880,634,6.0
42,69,Lackawanna,1999,105653,100062,5591,5.3
42,71,Lancaster,1999,248519,241651,6868,2.8
42,73,Lawrence,1999,41120,38738,2382,5.8
42,75,Lebanon,1999,66361,64277,2084,3.1
42,77,Lehigh,1999,159838,153462,6376,4.0
42,79,Luzerne,1999,157639,148222,9417,6.0
42,81,Lycoming,1999,57634,54681,2953,5.1
42,83,McKean,1999,21555,20386,1169,5.4
42,85,Mercer,1999,59000,55984,3016,5.1
42,87,Mifflin,1999,22232,20710,1522,6.8
42,89,Monroe,1999,53457,50126,3331,6.2
42,91,Montgomery,1999,408794,396381,12413,3.0
42,93,Montour,1999,8807,8578,229,2.6
42,95,Northampton,1999,133470,128073,5397,4.0
42,97,Northumberland,1999,44294,42025,2269,5.1
42,99,Perry,1999,24567,23617,950,3.9
42,101,Philadelphia/city,1999,643091,603213,39878,6.2
42,103,Pike,1999,19126,18452,674,3.5
42,105,Potter,1999,9349,8850,499,5.3
42,107,Schuylkill,1999,68735,63958,4777,6.9
42,109,Snyder,1999,19355,18538,817,4.2
42,111,Somerset,1999,37846,35636,2210,5.8
42,113,Sullivan,1999,2572,2410,162,6.3
42,115,Susquehanna,1999,19176,18217,959,5.0
42,117,Tioga,1999,19808,18867,941,4.8
42,119,Union,1999,18969,18389,580,3.1
42,121,Venango,1999,26699,25113,1586,5.9
42,123,Warren,1999,20590,19753,837,4.1
42,125,Washington,1999,98142,93367,4775,4.9
42,127,Wayne,1999,19923,18698,1225,6.1
42,129,Westmoreland,1999,185968,176835,9133,4.9
42,131,Wyoming,1999,15348,14476,872,5.7
42,133,York,1999,198703,191501,7202,3.6
44,1,Bristol,1999,27150,26289,861,3.2
44,3,Kent,1999,92716,89018,3698,4.0
44,5,Newport,1999,43266,41660,1606,3.7
44,7,Providence,1999,307075,292773,14302,4.7
44,9,Washington,1999,69722,67474,2248,3.2
45,1,Abbeville,1999,12271,11594,677,5.5
45,3,Aiken,1999,63597,60713,2884,4.5
45,5,Allendale,1999,4837,4488,349,7.2
45,7,Anderson,1999,84518,82060,2458,2.9
45,9,Bamberg,1999,7753,7134,619,8.0
45,11,Barnwell,1999,11466,10647,819,7.1
45,13,Beaufort,1999,51350,50247,1103,2.1
45,15,Berkeley,1999,64736,62526,2210,3.4
45,17,Calhoun,1999,6877,6412,465,6.8
45,19,Charleston,1999,160610,155662,4948,3.1
45,21,Cherokee,1999,25792,24731,1061,4.1
45,23,Chester,1999,15906,14563,1343,8.4
45,25,Chesterfield,1999,20235,18859,1376,6.8
45,27,Clarendon,1999,12972,12054,918,7.1
45,29,Colleton,1999,15258,14466,792,5.2
45,31,Darlington,1999,30969,28808,2161,7.0
45,33,Dillon,1999,14262,12951,1311,9.2
45,35,Dorchester,1999,44157,42756,1401,3.2
45,37,Edgefield,1999,9381,8896,485,5.2
45,39,Fairfield,1999,10786,9841,945,8.8
45,41,Florence,1999,63147,59940,3207,5.1
45,43,Georgetown,1999,24781,22767,2014,8.1
45,45,Greenville,1999,193253,188852,4401,2.3
45,47,Greenwood,1999,33245,31128,2117,6.4
45,49,Hampton,1999,8664,8192,472,5.4
45,51,Horry,1999,104033,100242,3791,3.6
45,53,Jasper,1999,8060,7789,271,3.4
45,55,Kershaw,1999,23016,21907,1109,4.8
45,57,Lancaster,1999,29359,28209,1150,3.9
45,59,Laurens,1999,27706,26709,997,3.6
45,61,Lee,1999,8263,7628,635,7.7
45,63,Lexington,1999,121169,118908,2261,1.9
45,65,McCormick,1999,4131,3667,464,11.2
45,67,Marion,1999,16636,14607,2029,12.2
45,69,Marlboro,1999,11712,10345,1367,11.7
45,71,Newberry,1999,18033,17221,812,4.5
45,73,Oconee,1999,28734,27644,1090,3.8
45,75,Orangeburg,1999,41821,37347,4474,10.7
45,77,Pickens,1999,56388,54616,1772,3.1
45,79,Richland,1999,160834,156709,4125,2.6
45,81,Saluda,1999,8988,8550,438,4.9
45,83,Spartanburg,1999,132774,127442,5332,4.0
45,85,Sumter,1999,46998,44605,2393,5.1
45,87,Union,1999,15195,14161,1034,6.8
45,89,Williamsburg,1999,14773,13003,1770,12.0
45,91,York,1999,89156,85754,3402,3.8
46,3,Aurora,1999,1395,1366,29,2.1
46,5,Beadle,1999,8733,8489,244,2.8
46,7,Bennett,1999,1071,1019,52,4.9
46,9,Bon Homme,1999,3148,3087,61,1.9
46,11,Brookings,1999,16983,16738,245,1.4
46,13,Brown,1999,20913,20436,477,2.3
46,15,Brule,1999,2629,2535,94,3.6
46,17,Buffalo,1999,839,754,85,10.1
46,19,Butte,1999,3800,3652,148,3.9
46,21,Campbell,1999,888,862,26,2.9
46,23,Charles Mix,1999,4492,4350,142,3.2
46,25,Clark,1999,1997,1910,87,4.4
46,27,Clay,1999,7859,7803,56,0.7
46,29,Codington,1999,14632,14125,507,3.5
46,31,Corson,1999,1614,1495,119,7.4
46,33,Custer,1999,3525,3380,145,4.1
46,35,Davison,1999,10253,10029,224,2.2
46,37,Day,1999,3015,2810,205,6.8
46,39,Deuel,1999,2502,2409,93,3.7
46,41,Dewey,1999,2419,2117,302,12.5
46,43,Douglas,1999,1643,1607,36,2.2
46,45,Edmunds,1999,2214,2173,41,1.9
46,47,Fall River,1999,3361,3236,125,3.7
46,49,Faulk,1999,1207,1181,26,2.2
46,51,Grant,1999,4243,4085,158,3.7
46,53,Gregory,1999,2599,2492,107,4.1
46,55,Haakon,1999,1123,1088,35,3.1
46,57,Hamlin,1999,2578,2498,80,3.1
46,59,Hand,1999,2061,2020,41,2.0
46,61,Hanson,1999,1755,1716,39,2.2
46,63,Harding,1999,768,739,29,3.8
46,65,Hughes,1999,10047,9842,205,2.0
46,67,Hutchinson,1999,3858,3762,96,2.5
46,69,Hyde,1999,911,890,21,2.3
46,71,Jackson,1999,1129,1062,67,5.9
46,73,Jerauld,1999,1315,1285,30,2.3
46,75,Jones,1999,827,805,22,2.7
46,77,Kingsbury,1999,2609,2494,115,4.4
46,79,Lake,1999,6160,6010,150,2.4
46,81,Lawrence,1999,10481,10100,381,3.6
46,83,Lincoln,1999,12951,12763,188,1.5
46,85,Lyman,1999,2465,2353,112,4.5
46,87,McCook,1999,2496,2438,58,2.3
46,89,McPherson,1999,1293,1263,30,2.3
46,91,Marshall,1999,2296,2163,133,5.8
46,93,Meade,1999,13553,13190,363,2.7
46,95,Mellette,1999,750,701,49,6.5
46,97,Miner,1999,1404,1355,49,3.5
46,99,Minnehaha,1999,89420,87923,1497,1.7
46,101,Moody,1999,3654,3469,185,5.1
46,102,Oglala Lakota,1999,3246,2840,406,12.5
46,103,Pennington,1999,47090,45972,1118,2.4
46,105,Perkins,1999,2003,1942,61,3.0
46,107,Potter,1999,1456,1405,51,3.5
46,109,Roberts,1999,4813,4562,251,5.2
46,111,Sanborn,1999,1499,1459,40,2.7
46,115,Spink,1999,3568,3451,117,3.3
46,117,Stanley,1999,1888,1847,41,2.2
46,119,Sully,1999,874,850,24,2.7
46,121,Todd,1999,2932,2726,206,7.0
46,123,Tripp,1999,3547,3445,102,2.9
46,125,Turner,1999,4210,4125,85,2.0
46,127,Union,1999,7219,7028,191,2.6
46,129,Walworth,1999,3129,3031,98,3.1
46,135,Yankton,1999,11339,11100,239,2.1
46,137,Ziebach,1999,697,603,94,13.5
47,1,Anderson,1999,35849,34564,1285,3.6
47,3,Bedford,1999,18031,17127,904,5.0
47,5,Benton,1999,7594,6982,612,8.1
47,7,Bledsoe,1999,3957,3821,136,3.4
47,9,Blount,1999,52071,50159,1912,3.7
47,11,Bradley,1999,43567,42039,1528,3.5
47,13,Campbell,1999,17193,15887,1306,7.6
47,15,Cannon,1999,5071,4850,221,4.4
47,17,Carroll,1999,12723,11547,1176,9.2
47,19,Carter,1999,25901,24620,1281,4.9
47,21,Cheatham,1999,19958,19525,433,2.2
47,23,Chester,1999,8460,8135,325,3.8
47,25,Claiborne,1999,13376,12811,565,4.2
47,27,Clay,1999,2742,2421,321,11.7
47,29,Cocke,1999,16782,15655,1127,6.7
47,31,Coffee,1999,22889,21919,970,4.2
47,33,Crockett,1999,7424,7029,395,5.3
47,35,Cumberland,1999,21340,20333,1007,4.7
47,37,Davidson,1999,308319,299551,8768,2.8
47,39,Decatur,1999,5553,5160,393,7.1
47,41,DeKalb,1999,8156,7662,494,6.1
47,43,Dickson,1999,22170,21476,694,3.1
47,45,Dyer,1999,18708,17828,880,4.7
47,47,Fayette,1999,14670,14139,531,3.6
47,49,Fentress,1999,6681,5977,704,10.5
47,51,Franklin,1999,18475,17659,816,4.4
47,53,Gibson,1999,21519,20170,1349,6.3
47,55,Giles,1999,16472,15835,637,3.9
47,57,Grainger,1999,10357,9924,433,4.2
47,59,Greene,1999,36220,34218,2002,5.5
47,61,Grundy,1999,5544,5222,322,5.8
47,63,Hamblen,1999,30571,29266,1305,4.3
47,65,Hamilton,1999,152127,147214,4913,3.2
47,67,Hancock,1999,2790,2613,177,6.3
47,69,Hardeman,1999,9551,8674,877,9.2
47,71,Hardin,1999,12394,11544,850,6.9
47,73,Hawkins,1999,24216,22968,1248,5.2
47,75,Haywood,1999,8492,7740,752,8.9
47,77,Henderson,1999,14598,13730,868,5.9
47,79,Henry,1999,14635,13689,946,6.5
47,81,Hickman,1999,7964,7506,458,5.8
47,83,Houston,1999,2752,2499,253,9.2
47,85,Humphreys,1999,8064,7516,548,6.8
47,87,Jackson,1999,4682,4283,399,8.5
47,89,Jefferson,1999,24515,23513,1002,4.1
47,91,Johnson,1999,7395,6700,695,9.4
47,93,Knox,1999,203020,197901,5119,2.5
47,95,Lake,1999,2580,2421,159,6.2
47,97,Lauderdale,1999,10143,9303,840,8.3
47,99,Lawrence,1999,20984,18689,2295,10.9
47,101,Lewis,1999,4212,3816,396,9.4
47,103,Lincoln,1999,14404,13819,585,4.1
47,105,Loudon,1999,20951,20334,617,2.9
47,107,McMinn,1999,21948,20688,1260,5.7
47,109,McNairy,1999,11821,11237,584,4.9
47,111,Macon,1999,8379,8027,352,4.2
47,113,Madison,1999,51100,49416,1684,3.3
47,115,Marion,1999,12783,12175,608,4.8
47,117,Marshall,1999,12390,11942,448,3.6
47,119,Maury,1999,37837,36523,1314,3.5
47,121,Meigs,1999,4722,4358,364,7.7
47,123,Monroe,1999,19067,18080,987,5.2
47,125,Montgomery,1999,59214,57417,1797,3.0
47,127,Moore,1999,2900,2837,63,2.2
47,129,Morgan,1999,6952,6447,505,7.3
47,131,Obion,1999,15623,14691,932,6.0
47,133,Overton,1999,9846,9292,554,5.6
47,135,Perry,1999,3854,3567,287,7.4
47,137,Pickett,1999,2221,2082,139,6.3
47,139,Polk,1999,6912,6566,346,5.0
47,141,Putnam,1999,31638,30220,1418,4.5
47,143,Rhea,1999,12335,11629,706,5.7
47,145,Roane,1999,24993,23862,1131,4.5
47,147,Robertson,1999,29688,28733,955,3.2
47,149,Rutherford,1999,98698,96150,2548,2.6
47,151,Scott,1999,8951,8196,755,8.4
47,153,Sequatchie,1999,4943,4748,195,3.9
47,155,Sevier,1999,36167,33840,2327,6.4
47,157,Shelby,1999,449707,433046,16661,3.7
47,159,Smith,1999,9817,9447,370,3.8
47,161,Stewart,1999,3470,3193,277,8.0
47,163,Sullivan,1999,75418,72390,3028,4.0
47,165,Sumner,1999,70338,68471,1867,2.7
47,167,Tipton,1999,22828,22080,748,3.3
47,169,Trousdale,1999,2112,2000,112,5.3
47,171,Unicoi,1999,8033,7577,456,5.7
47,173,Union,1999,7952,7676,276,3.5
47,175,Van Buren,1999,2410,2261,149,6.2
47,177,Warren,1999,19591,18715,876,4.5
47,179,Washington,1999,52628,50744,1884,3.6
47,181,Wayne,1999,7614,6708,906,11.9
47,183,Weakley,1999,17074,16043,1031,6.0
47,185,White,1999,11460,10940,520,4.5
47,187,Williamson,1999,69964,68666,1298,1.9
47,189,Wilson,1999,48787,47481,1306,2.7
48,1,Anderson,1999,20511,19227,1284,6.3
48,3,Andrews,1999,5314,4699,615,11.6
48,5,Angelina,1999,35866,33687,2179,6.1
48,7,Aransas,1999,9731,9157,574,5.9
48,9,Archer,1999,4075,3942,133,3.3
48,11,Armstrong,1999,1034,1017,17,1.6
48,13,Atascosa,1999,17935,17180,755,4.2
48,15,Austin,1999,13495,12971,524,3.9
48,17,Bailey,1999,3482,3303,179,5.1
48,19,Bandera,1999,6905,6717,188,2.7
48,21,Bastrop,1999,28281,27559,722,2.6
48,23,Baylor,1999,1741,1666,75,4.3
48,25,Bee,1999,10925,10250,675,6.2
48,27,Bell,1999,94410,91145,3265,3.5
48,29,Bexar,1999,671705,649521,22184,3.3
48,31,Blanco,1999,3933,3848,85,2.2
48,33,Borden,1999,394,385,9,2.3
48,35,Bosque,1999,7264,7001,263,3.6
48,37,Bowie,1999,39226,36971,2255,5.7
48,39,Brazoria,1999,104860,97626,7234,6.9
48,41,Brazos,1999,75791,74439,1352,1.8
48,43,Brewster,1999,5247,5116,131,2.5
48,45,Briscoe,1999,914,879,35,3.8
48,47,Brooks,1999,3146,2833,313,9.9
48,49,Brown,1999,17192,16520,672,3.9
48,51,Burleson,1999,6832,6516,316,4.6
48,53,Burnet,1999,14060,13671,389,2.8
48,55,Caldwell,1999,16277,15706,571,3.5
48,57,Calhoun,1999,9663,9087,576,6.0
48,59,Callahan,1999,6157,5885,272,4.4
48,61,Cameron,1999,127484,114705,12779,10.0
48,63,Camp,1999,5402,5040,362,6.7
48,65,Carson,1999,3182,3051,131,4.1
48,67,Cass,1999,15481,14309,1172,7.6
48,69,Castro,1999,3733,3565,168,4.5
48,71,Chambers,1999,11808,11284,524,4.4
48,73,Cherokee,1999,20840,19953,887,4.3
48,75,Childress,1999,3024,2923,101,3.3
48,77,Clay,1999,5578,5416,162,2.9
48,79,Cochran,1999,1331,1256,75,5.6
48,81,Coke,1999,1579,1535,44,2.8
48,83,Coleman,1999,3332,3113,219,6.6
48,85,Collin,1999,280980,275118,5862,2.1
48,87,Collingsworth,1999,1490,1474,16,1.1
48,89,Colorado,1999,8354,8032,322,3.9
48,91,Comal,1999,39763,38758,1005,2.5
48,93,Comanche,1999,6650,6421,229,3.4
48,95,Concho,1999,1564,1524,40,2.6
48,97,Cooke,1999,17150,16616,534,3.1
48,99,Coryell,1999,21520,20693,827,3.8
48,101,Cottle,1999,838,795,43,5.1
48,103,Crane,1999,2023,1842,181,8.9
48,105,Crockett,1999,2048,1879,169,8.3
48,107,Crosby,1999,2728,2548,180,6.6
48,109,Culberson,1999,1243,1141,102,8.2
48,111,Dallam,1999,3665,3566,99,2.7
48,113,Dallas,1999,1211140,1167527,43613,3.6
48,115,Dawson,1999,6114,5701,413,6.8
48,117,Deaf Smith,1999,7896,7430,466,5.9
48,119,Delta,1999,3401,3282,119,3.5
48,121,Denton,1999,251871,246976,4895,1.9
48,123,DeWitt,1999,8449,8060,389,4.6
48,125,Dickens,1999,873,825,48,5.5
48,127,Dimmit,1999,3681,3094,587,15.9
48,129,Donley,1999,1547,1491,56,3.6
48,131,Duval,1999,5058,4286,772,15.3
48,133,Eastland,1999,9032,8598,434,4.8
48,135,Ector,1999,61280,54790,6490,10.6
48,137,Edwards,1999,795,746,49,6.2
48,139,Ellis,1999,55983,54220,1763,3.1
48,141,El Paso,1999,289403,261639,27764,9.6
48,143,Erath,1999,16552,16134,418,2.5
48,145,Falls,1999,7449,7168,281,3.8
48,147,Fannin,1999,12963,12239,724,5.6
48,149,Fayette,1999,10849,10515,334,3.1
48,151,Fisher,1999,1653,1586,67,4.1
48,153,Floyd,1999,3210,3002,208,6.5
48,155,Foard,1999,854,835,19,2.2
48,157,Fort Bend,1999,188895,182777,6118,3.2
48,159,Franklin,1999,4554,4375,179,3.9
48,161,Freestone,1999,7483,7142,341,4.6
48,163,Frio,1999,6154,5691,463,7.5
48,165,Gaines,1999,6743,6372,371,5.5
48,167,Galveston,1999,122758,114588,8170,6.7
48,169,Garza,1999,1994,1875,119,6.0
48,171,Gillespie,1999,10303,10073,230,2.2
48,173,Glasscock,1999,699,681,18,2.6
48,175,Goliad,1999,2695,2576,119,4.4
48,177,Gonzales,1999,7519,7274,245,3.3
48,179,Gray,1999,9720,9028,692,7.1
48,181,Grayson,1999,50774,48460,2314,4.6
48,183,Gregg,1999,59321,54797,4524,7.6
48,185,Grimes,1999,8986,8344,642,7.1
48,187,Guadalupe,1999,43258,42178,1080,2.5
48,189,Hale,1999,16990,16132,858,5.1
48,191,Hall,1999,1610,1524,86,5.3
48,193,Hamilton,1999,4016,3855,161,4.0
48,195,Hansford,1999,2468,2379,89,3.6
48,197,Hardeman,1999,1920,1827,93,4.8
48,199,Hardin,1999,23752,21879,1873,7.9
48,201,Harris,1999,1772079,1687283,84796,4.8
48,203,Harrison,1999,27737,25771,1966,7.1
48,205,Hartley,1999,3012,2973,39,1.3
48,207,Haskell,1999,2724,2612,112,4.1
48,209,Hays,1999,53131,51673,1458,2.7
48,211,Hemphill,1999,1879,1823,56,3.0
48,213,Henderson,1999,30462,29376,1086,3.6
48,215,Hidalgo,1999,195835,166991,28844,14.7
48,217,Hill,1999,16309,15722,587,3.6
48,219,Hockley,1999,10902,10159,743,6.8
48,221,Hood,1999,17400,16752,648,3.7
48,223,Hopkins,1999,15803,15106,697,4.4
48,225,Houston,1999,9180,8776,404,4.4
48,227,Howard,1999,13723,12891,832,6.1
48,229,Hudspeth,1999,1457,1406,51,3.5
48,231,Hunt,1999,36481,35052,1429,3.9
48,233,Hutchinson,1999,9348,8621,727,7.8
48,235,Irion,1999,702,672,30,4.3
48,237,Jack,1999,3507,3356,151,4.3
48,239,Jackson,1999,8520,8233,287,3.4
48,241,Jasper,1999,14709,12922,1787,12.1
48,243,Jeff Davis,1999,1862,1822,40,2.1
48,245,Jefferson,1999,117216,107455,9761,8.3
48,247,Jim Hogg,1999,2276,2001,275,12.1
48,249,Jim Wells,1999,17175,15254,1921,11.2
48,251,Johnson,1999,62364,60240,2124,3.4
48,253,Jones,1999,9877,9527,350,3.5
48,255,Karnes,1999,5774,5539,235,4.1
48,257,Kaufman,1999,33557,32210,1347,4.0
48,259,Kendall,1999,13629,13323,306,2.2
48,261,Kenedy,1999,228,221,7,3.1
48,263,Kent,1999,443,431,12,2.7
48,265,Kerr,1999,17595,17212,383,2.2
48,267,Kimble,1999,2388,2322,66,2.8
48,269,King,1999,124,119,5,4.0
48,271,Kinney,1999,1126,1036,90,8.0
48,273,Kleberg,1999,12920,12055,865,6.7
48,275,Knox,1999,1956,1847,109,5.6
48,277,Lamar,1999,22321,20965,1356,6.1
48,279,Lamb,1999,6480,6009,471,7.3
48,281,Lampasas,1999,8058,7797,261,3.2
48,283,La Salle,1999,2893,2640,253,8.7
48,285,Lavaca,1999,9520,9324,196,2.1
48,287,Lee,1999,7211,6951,260,3.6
48,289,Leon,1999,6354,5938,416,6.5
48,291,Liberty,1999,29606,27386,2220,7.5
48,293,Limestone,1999,9204,8802,402,4.4
48,295,Lipscomb,1999,1517,1465,52,3.4
48,297,Live Oak,1999,4407,4217,190,4.3
48,299,Llano,1999,5619,5472,147,2.6
48,301,Loving,1999,76,67,9,11.8
48,303,Lubbock,1999,123988,120348,3640,2.9
48,305,Lynn,1999,2887,2755,132,4.6
48,307,McCulloch,1999,3720,3521,199,5.3
48,309,McLennan,1999,102157,98706,3451,3.4
48,311,McMullen,1999,282,268,14,5.0
48,313,Madison,1999,4278,4124,154,3.6
48,315,Marion,1999,3893,3537,356,9.1
48,317,Martin,1999,1782,1681,101,5.7
48,319,Mason,1999,1560,1519,41,2.6
48,321,Matagorda,1999,16374,14658,1716,10.5
48,323,Maverick,1999,18323,14326,3997,21.8
48,325,Medina,1999,15960,15405,555,3.5
48,327,Menard,1999,1045,1012,33,3.2
48,329,Midland,1999,61402,57077,4325,7.0
48,331,Milam,1999,9500,9106,394,4.1
48,333,Mills,1999,2348,2299,49,2.1
48,335,Mitchell,1999,3370,3148,222,6.6
48,337,Montague,1999,7375,7033,342,4.6
48,339,Montgomery,1999,144348,139457,4891,3.4
48,341,Moore,1999,9295,9006,289,3.1
48,343,Morris,1999,6352,5643,709,11.2
48,345,Motley,1999,590,581,9,1.5
48,347,Nacogdoches,1999,25433,24432,1001,3.9
48,349,Navarro,1999,21693,20710,983,4.5
48,351,Newton,1999,5844,5030,814,13.9
48,353,Nolan,1999,7130,6703,427,6.0
48,355,Nueces,1999,146808,136971,9837,6.7
48,357,Ochiltree,1999,5280,5060,220,4.2
48,359,Oldham,1999,1233,1207,26,2.1
48,361,Orange,1999,41899,37540,4359,10.4
48,363,Palo Pinto,1999,12384,11850,534,4.3
48,365,Panola,1999,8093,7282,811,10.0
48,367,Parker,1999,42849,41661,1188,2.8
48,369,Parmer,1999,4464,4348,116,2.6
48,371,Pecos,1999,6737,6165,572,8.5
48,373,Polk,1999,15087,14217,870,5.8
48,375,Potter,1999,55702,52399,3303,5.9
48,377,Presidio,1999,3511,2437,1074,30.6
48,379,Rains,1999,3720,3574,146,3.9
48,381,Randall,1999,58023,57171,852,1.5
48,383,Reagan,1999,1892,1724,168,8.9
48,385,Real,1999,1342,1296,46,3.4
48,387,Red River,1999,5986,5686,300,5.0
48,389,Reeves,1999,7313,6476,837,11.4
48,391,Refugio,1999,2900,2738,162,5.6
48,393,Roberts,1999,434,422,12,2.8
48,395,Robertson,1999,6329,6028,301,4.8
48,397,Rockwall,1999,22738,22261,477,2.1
48,399,Runnels,1999,5194,4946,248,4.8
48,401,Rusk,1999,21081,19834,1247,5.9
48,403,Sabine,1999,4079,3676,403,9.9
48,405,San Augustine,1999,3163,2954,209,6.6
48,407,San Jacinto,1999,8623,8275,348,4.0
48,409,San Patricio,1999,30222,28261,1961,6.5
48,411,San Saba,1999,2581,2455,126,4.9
48,413,Schleicher,1999,1500,1413,87,5.8
48,415,Scurry,1999,7427,6824,603,8.1
48,417,Shackelford,1999,1339,1268,71,5.3
48,419,Shelby,1999,9383,8728,655,7.0
48,421,Sherman,1999,1513,1493,20,1.3
48,423,Smith,1999,90236,86304,3932,4.4
48,425,Somervell,1999,2058,1946,112,5.4
48,427,Starr,1999,21459,16101,5358,25.0
48,429,Stephens,1999,4157,3968,189,4.5
48,431,Sterling,1999,672,644,28,4.2
48,433,Stonewall,1999,696,657,39,5.6
48,435,Sutton,1999,2051,1901,150,7.3
48,437,Swisher,1999,3606,3463,143,4.0
48,439,Tarrant,1999,778844,754111,24733,3.2
48,441,Taylor,1999,59921,57648,2273,3.8
48,443,Terrell,1999,706,676,30,4.2
48,445,Terry,1999,5647,5241,406,7.2
48,447,Throckmorton,1999,743,721,22,3.0
48,449,Titus,1999,12676,11941,735,5.8
48,451,Tom Green,1999,50418,48209,2209,4.4
48,453,Travis,1999,464826,453795,11031,2.4
48,455,Trinity,1999,5812,5503,309,5.3
48,457,Tyler,1999,6455,5870,585,9.1
48,459,Upshur,1999,17077,16006,1071,6.3
48,461,Upton,1999,1577,1455,122,7.7
48,463,Uvalde,1999,11042,10141,901,8.2
48,465,Val Verde,1999,18174,16621,1553,8.5
48,467,Van Zandt,1999,20508,19814,694,3.4
48,469,Victoria,1999,43344,41499,1845,4.3
48,471,Walker,1999,23508,22991,517,2.2
48,473,Waller,1999,12933,12243,690,5.3
48,475,Ward,1999,4369,3848,521,11.9
48,477,Washington,1999,14942,14530,412,2.8
48,479,Webb,1999,73108,66745,6363,8.7
48,481,Wharton,1999,19418,18350,1068,5.5
48,483,Wheeler,1999,2758,2637,121,4.4
48,485,Wichita,1999,60259,57333,2926,4.9
48,487,Wilbarger,1999,7440,7251,189,2.5
48,489,Willacy,1999,6936,5765,1171,16.9
48,491,Williamson,1999,148696,146250,2446,1.6
48,493,Wilson,1999,15706,15292,414,2.6
48,495,Winkler,1999,3061,2638,423,13.8
48,497,Wise,1999,23467,22778,689,2.9
48,499,Wood,1999,13988,13286,702,5.0
48,501,Yoakum,1999,3575,3221,354,9.9
48,503,Young,1999,8261,7812,449,5.4
48,505,Zapata,1999,4573,3956,617,13.5
48,507,Zavala,1999,4217,3475,742,17.6
49,1,Beaver,1999,2468,2378,90,3.6
49,3,Box Elder,1999,18375,17552,823,4.5
49,5,Cache,1999,45282,44117,1165,2.6
49,7,Carbon,1999,9909,9249,660,6.7
49,9,Daggett,1999,448,433,15,3.3
49,11,Davis,1999,124936,120958,3978,3.2
49,13,Duchesne,1999,5963,5427,536,9.0
49,15,Emery,1999,4033,3752,281,7.0
49,17,Garfield,1999,2886,2664,222,7.7
49,19,Grand,1999,5585,5231,354,6.3
49,21,Iron,1999,15155,14625,530,3.5
49,23,Juab,1999,3620,3449,171,4.7
49,25,Kane,1999,2809,2704,105,3.7
49,27,Millard,1999,4655,4460,195,4.2
49,29,Morgan,1999,3572,3434,138,3.9
49,31,Piute,1999,540,508,32,5.9
49,33,Rich,1999,995,960,35,3.5
49,35,Salt Lake,1999,491326,475634,15692,3.2
49,37,San Juan,1999,5045,4666,379,7.5
49,39,Sanpete,1999,8980,8511,469,5.2
49,41,Sevier,1999,8458,8116,342,4.0
49,43,Summit,1999,14736,14063,673,4.6
49,45,Tooele,1999,12294,11653,641,5.2
49,47,Uintah,1999,11201,10450,751,6.7
49,49,Utah,1999,170741,165718,5023,2.9
49,51,Wasatch,1999,6451,6146,305,4.7
49,53,Washington,1999,38817,37490,1327,3.4
49,55,Wayne,1999,1490,1407,83,5.6
49,57,Weber,1999,103101,98696,4405,4.3
50,1,Addison,1999,20270,19625,645,3.2
50,3,Bennington,1999,20516,19759,757,3.7
50,5,Caledonia,1999,15291,14659,632,4.1
50,7,Chittenden,1999,90656,88911,1745,1.9
50,9,Essex,1999,2919,2746,173,5.9
50,11,Franklin,1999,23915,23183,732,3.1
50,13,Grand Isle,1999,3510,3338,172,4.9
50,15,Lamoille,1999,12017,11525,492,4.1
50,17,Orange,1999,15942,15562,380,2.4
50,19,Orleans,1999,12571,11790,781,6.2
50,21,Rutland,1999,32119,30873,1246,3.9
50,23,Washington,1999,31971,30888,1083,3.4
50,25,Windham,1999,23714,23030,684,2.9
50,27,Windsor,1999,32027,31207,820,2.6
51,1,Accomack,1999,14819,13889,930,6.3
51,3,Albemarle,1999,40146,39705,441,1.1
51,5,Alleghany,1999,8233,7774,459,5.6
51,7,Amelia,1999,5163,5037,126,2.4
51,9,Amherst,1999,14751,14498,253,1.7
51,11,Appomattox,1999,5443,5232,211,3.9
51,13,Arlington,1999,107300,105643,1657,1.5
51,15,Augusta,1999,32033,31297,736,2.3
51,17,Bath,1999,2402,2291,111,4.6
51,19,Bedford,1999,33654,32994,660,2.0
51,21,Bland,1999,3494,3341,153,4.4
51,23,Botetourt,1999,16747,16453,294,1.8
51,25,Brunswick,1999,7705,7399,306,4.0
51,27,Buchanan,1999,8393,7252,1141,13.6
51,29,Buckingham,1999,6028,5784,244,4.0
51,31,Campbell,1999,26626,26053,573,2.2
51,33,Caroline,1999,10616,10274,342,3.2
51,35,Carroll,1999,14008,13079,929,6.6
51,36,Charles City,1999,3776,3674,102,2.7
51,37,Charlotte,1999,6097,5910,187,3.1
51,41,Chesterfield,1999,141806,139151,2655,1.9
51,43,Clarke,1999,6524,6429,95,1.5
51,45,Craig,1999,2089,2002,87,4.2
51,47,Culpeper,1999,16330,16011,319,2.0
51,49,Cumberland,1999,3811,3737,74,1.9
51,51,Dickenson,1999,5406,4747,659,12.2
51,53,Dinwiddie,1999,12196,11895,301,2.5
51,57,Essex,1999,4390,4194,196,4.5
51,59,Fairfax,1999,539868,531632,8236,1.5
51,61,Fauquier,1999,28688,28280,408,1.4
51,63,Floyd,1999,6817,6523,294,4.3
51,65,Fluvanna,1999,9685,9577,108,1.1
51,67,Franklin,1999,25251,24246,1005,4.0
51,69,Frederick,1999,32787,32121,666,2.0
51,71,Giles,1999,8469,7961,508,6.0
51,73,Gloucester,1999,18132,17719,413,2.3
51,75,Goochland,1999,9137,8988,149,1.6
51,77,Grayson,1999,8305,7839,466,5.6
51,79,Greene,1999,7750,7643,107,1.4
51,81,Greensville,1999,5439,5279,160,2.9
51,83,Halifax,1999,18470,17323,1147,6.2
51,85,Hanover,1999,47723,47033,690,1.4
51,87,Henrico,1999,139406,136766,2640,1.9
51,89,Henry,1999,27687,25957,1730,6.2
51,91,Highland,1999,1269,1236,33,2.6
51,93,Isle of Wight,1999,15211,14816,395,2.6
51,95,James City,1999,25230,24748,482,1.9
51,97,King and Queen,1999,2926,2836,90,3.1
51,99,King George,1999,8690,8527,163,1.9
51,101,King William,1999,6302,6154,148,2.3
51,103,Lancaster,1999,5176,4685,491,9.5
51,105,Lee,1999,9588,8752,836,8.7
51,107,Loudoun,1999,90910,89924,986,1.1
51,109,Louisa,1999,9691,9359,332,3.4
51,111,Lunenburg,1999,4798,4571,227,4.7
51,113,Madison,1999,8786,8635,151,1.7
51,115,Mathews,1999,4667,4566,101,2.2
51,117,Mecklenburg,1999,15098,14305,793,5.3
51,119,Middlesex,1999,5121,5014,107,2.1
51,121,Montgomery,1999,37929,37249,680,1.8
51,125,Nelson,1999,7264,7110,154,2.1
51,127,New Kent,1999,6968,6837,131,1.9
51,131,Northampton,1999,5298,5065,233,4.4
51,133,Northumberland,1999,5332,4931,401,7.5
51,135,Nottoway,1999,6772,6591,181,2.7
51,137,Orange,1999,11076,10804,272,2.5
51,139,Page,1999,12014,11546,468,3.9
51,141,Patrick,1999,9017,8534,483,5.4
51,143,Pittsylvania,1999,31528,29734,1794,5.7
51,145,Powhatan,1999,11191,11017,174,1.6
51,147,Prince Edward,1999,8202,7919,283,3.5
51,149,Prince George,1999,12150,11810,340,2.8
51,153,Prince William,1999,142913,140262,2651,1.9
51,155,Pulaski,1999,17047,16310,737,4.3
51,157,Rappahannock,1999,4009,3931,78,1.9
51,159,Richmond,1999,4052,3872,180,4.4
51,161,Roanoke,1999,48090,47466,624,1.3
51,163,Rockbridge,1999,10286,10076,210,2.0
51,165,Rockingham,1999,37624,37159,465,1.2
51,167,Russell,1999,14157,13012,1145,8.1
51,169,Scott,1999,9293,8696,597,6.4
51,171,Shenandoah,1999,17648,17161,487,2.8
51,173,Smyth,1999,16619,15631,988,5.9
51,175,Southampton,1999,8572,8299,273,3.2
51,177,Spotsylvania,1999,44728,44040,688,1.5
51,179,Stafford,1999,46907,46220,687,1.5
51,181,Surry,1999,2414,2232,182,7.5
51,183,Sussex,1999,6303,6122,181,2.9
51,185,Tazewell,1999,19593,18238,1355,6.9
51,187,Warren,1999,15129,14737,392,2.6
51,191,Washington,1999,24967,23854,1113,4.5
51,193,Westmoreland,1999,7371,7000,371,5.0
51,195,Wise,1999,14860,13541,1319,8.9
51,197,Wythe,1999,14334,13759,575,4.0
51,199,York,1999,28908,28339,569,2.0
51,510,Alexandria city,1999,74778,73145,1633,2.2
51,520,Bristol city,1999,7697,7425,272,3.5
51,530,Buena Vista city,1999,3394,3306,88,2.6
51,540,Charlottesville city,1999,18262,17948,314,1.7
51,550,Chesapeake city,1999,106744,104045,2699,2.5
51,570,Colonial Heights city,1999,8445,8240,205,2.4
51,580,Covington city,1999,3326,3082,244,7.3
51,590,Danville city,1999,25304,23681,1623,6.4
51,595,Emporia city,1999,2510,2395,115,4.6
51,600,Fairfax city,1999,12371,12263,108,0.9
51,610,Falls Church city,1999,5852,5778,74,1.3
51,620,Franklin city,1999,3985,3813,172,4.3
51,630,Fredericksburg city,1999,9582,9307,275,2.9
51,640,Galax city,1999,3248,3107,141,4.3
51,650,Hampton city,1999,66633,64031,2602,3.9
51,660,Harrisonburg city,1999,18723,18488,235,1.3
51,670,Hopewell city,1999,10712,10281,431,4.0
51,678,Lexington city,1999,3026,2983,43,1.4
51,680,Lynchburg city,1999,29794,29172,622,2.1
51,683,Manassas city,1999,18900,18599,301,1.6
51,685,Manassas Park city,1999,4282,4229,53,1.2
51,690,Martinsville city,1999,6851,6180,671,9.8
51,700,Newport News city,1999,84711,81410,3301,3.9
51,710,Norfolk city,1999,83874,79635,4239,5.1
51,720,Norton city,1999,1452,1345,107,7.4
51,730,Petersburg city,1999,15678,14875,803,5.1
51,735,Poquoson city,1999,6143,6011,132,2.1
51,740,Portsmouth city,1999,44397,42229,2168,4.9
51,750,Radford city,1999,6663,6482,181,2.7
51,760,Richmond city,1999,93990,90827,3163,3.4
51,770,Roanoke city,1999,49017,47786,1231,2.5
51,775,Salem city,1999,13481,13270,211,1.6
51,790,Staunton city,1999,11544,11288,256,2.2
51,800,Suffolk city,1999,30863,29825,1038,3.4
51,810,Virginia Beach city,1999,212805,207301,5504,2.6
51,820,Waynesboro city,1999,9296,9039,257,2.8
51,830,Williamsburg city,1999,6153,5809,344,5.6
51,840,Winchester city,1999,13032,12713,319,2.4
53,1,Adams,1999,8863,7935,928,10.5
53,3,Asotin,1999,12767,12339,428,3.4
53,5,Benton,1999,74672,70551,4121,5.5
53,7,Chelan,1999,35872,32795,3077,8.6
53,9,Clallam,1999,26450,24560,1890,7.1
53,11,Clark,1999,187836,180471,7365,3.9
53,13,Columbia,1999,1562,1383,179,11.5
53,15,Cowlitz,1999,43607,40559,3048,7.0
53,17,Douglas,1999,19991,18635,1356,6.8
53,19,Ferry,1999,2714,2417,297,10.9
53,21,Franklin,1999,23744,21514,2230,9.4
53,23,Garfield,1999,1124,1082,42,3.7
53,25,Grant,1999,39285,35630,3655,9.3
53,27,Grays Harbor,1999,27213,24965,2248,8.3
53,29,Island,1999,30902,29743,1159,3.8
53,31,Jefferson,1999,11377,10722,655,5.8
53,33,King,1999,968263,936308,31955,3.3
53,35,Kitsap,1999,98563,93732,4831,4.9
53,37,Kittitas,1999,15473,14617,856,5.5
53,39,Klickitat,1999,9038,8185,853,9.4
53,41,Lewis,1999,31220,28599,2621,8.4
53,43,Lincoln,1999,4891,4646,245,5.0
53,45,Mason,1999,20241,18968,1273,6.3
53,47,Okanogan,1999,22320,20164,2156,9.7
53,49,Pacific,1999,8097,7407,690,8.5
53,51,Pend Oreille,1999,4392,3952,440,10.0
53,53,Pierce,1999,347655,331980,15675,4.5
53,55,San Juan,1999,6780,6533,247,3.6
53,57,Skagit,1999,52517,49238,3279,6.2
53,59,Skamania,1999,4237,3882,355,8.4
53,61,Snohomish,1999,326148,312909,13239,4.1
53,63,Spokane,1999,220058,208679,11379,5.2
53,65,Stevens,1999,17613,16103,1510,8.6
53,67,Thurston,1999,106382,101593,4789,4.5
53,69,Wahkiakum,1999,1987,1859,128,6.4
53,71,Walla Walla,1999,27555,25729,1826,6.6
53,73,Whatcom,1999,85656,81283,4373,5.1
53,75,Whitman,1999,19731,19376,355,1.8
53,77,Yakima,1999,115954,104470,11484,9.9
54,1,Barbour,1999,6071,5417,654,10.8
54,3,Berkeley,1999,34977,33722,1255,3.6
54,5,Boone,1999,7981,7111,870,10.9
54,7,Braxton,1999,5241,4686,555,10.6
54,9,Brooke,1999,11315,10624,691,6.1
54,11,Cabell,1999,42526,40377,2149,5.1
54,13,Calhoun,1999,2620,2164,456,17.4
54,15,Clay,1999,4206,3753,453,10.8
54,17,Doddridge,1999,3265,3073,192,5.9
54,19,Fayette,1999,17302,15562,1740,10.1
54,21,Gilmer,1999,2636,2388,248,9.4
54,23,Grant,1999,4405,4035,370,8.4
54,25,Greenbrier,1999,15417,14176,1241,8.0
54,27,Hampshire,1999,8669,8256,413,4.8
54,29,Hancock,1999,15020,14090,930,6.2
54,31,Hardy,1999,7246,6966,280,3.9
54,33,Harrison,1999,34215,31881,2334,6.8
54,35,Jackson,1999,12644,11711,933,7.4
54,37,Jefferson,1999,21329,20730,599,2.8
54,39,Kanawha,1999,105227,100357,4870,4.6
54,41,Lewis,1999,7071,6501,570,8.1
54,43,Lincoln,1999,6938,6132,806,11.6
54,45,Logan,1999,13097,11526,1571,12.0
54,47,McDowell,1999,7421,6369,1052,14.2
54,49,Marion,1999,23878,22014,1864,7.8
54,51,Marshall,1999,16022,15019,1003,6.3
54,53,Mason,1999,8970,7804,1166,13.0
54,55,Mercer,1999,28054,26717,1337,4.8
54,57,Mineral,1999,12365,11505,860,7.0
54,59,Mingo,1999,8450,7209,1241,14.7
54,61,Monongalia,1999,38376,37103,1273,3.3
54,63,Monroe,1999,5295,5071,224,4.2
54,65,Morgan,1999,6114,5960,154,2.5
54,67,Nicholas,1999,10840,9807,1033,9.5
54,69,Ohio,1999,24241,23269,972,4.0
54,71,Pendleton,1999,3946,3767,179,4.5
54,73,Pleasants,1999,2810,2568,242,8.6
54,75,Pocahontas,1999,4251,3889,362,8.5
54,77,Preston,1999,12682,11906,776,6.1
54,79,Putnam,1999,27223,25980,1243,4.6
54,81,Raleigh,1999,34578,32089,2489,7.2
54,83,Randolph,1999,13503,12508,995,7.4
54,85,Ritchie,1999,4278,3868,410,9.6
54,87,Roane,1999,6149,5403,746,12.1
54,89,Summers,1999,4311,3922,389,9.0
54,91,Taylor,1999,6992,6452,540,7.7
54,93,Tucker,1999,3421,3112,309,9.0
54,95,Tyler,1999,4217,3909,308,7.3
54,97,Upshur,1999,10317,9550,767,7.4
54,99,Wayne,1999,16823,15795,1028,6.1
54,101,Webster,1999,3041,2752,289,9.5
54,103,Wetzel,1999,7724,6906,818,10.6
54,105,Wirt,1999,1953,1668,285,14.6
54,107,Wood,1999,43446,41155,2291,5.3
54,109,Wyoming,1999,8142,7292,850,10.4
55,1,Adams,1999,8004,7702,302,3.8
55,3,Ashland,1999,7845,7256,589,7.5
55,5,Barron,1999,23815,22882,933,3.9
55,7,Bayfield,1999,7365,6943,422,5.7
55,9,Brown,1999,135952,132784,3168,2.3
55,11,Buffalo,1999,7917,7684,233,2.9
55,13,Burnett,1999,7111,6787,324,4.6
55,15,Calumet,1999,25264,24687,577,2.3
55,17,Chippewa,1999,30903,29767,1136,3.7
55,19,Clark,1999,15871,15085,786,5.0
55,21,Columbia,1999,26864,25845,1019,3.8
55,23,Crawford,1999,10012,9643,369,3.7
55,25,Dane,1999,264681,261024,3657,1.4
55,27,Dodge,1999,48218,47003,1215,2.5
55,29,Door,1999,15580,14901,679,4.4
55,31,Douglas,1999,22728,21783,945,4.2
55,33,Dunn,1999,22068,21395,673,3.0
55,35,Eau Claire,1999,52493,51092,1401,2.7
55,37,Florence,1999,1750,1635,115,6.6
55,39,Fond du Lac,1999,54373,52859,1514,2.8
55,41,Forest,1999,4488,4252,236,5.3
55,43,Grant,1999,24171,23323,848,3.5
55,45,Green,1999,18390,17797,593,3.2
55,47,Green Lake,1999,10530,10107,423,4.0
55,49,Iowa,1999,13715,13307,408,3.0
55,51,Iron,1999,3277,3085,192,5.9
55,53,Jackson,1999,12555,12150,405,3.2
55,55,Jefferson,1999,42315,41286,1029,2.4
55,57,Juneau,1999,10647,9939,708,6.6
55,59,Kenosha,1999,82325,79635,2690,3.3
55,61,Kewaunee,1999,10637,10339,298,2.8
55,63,La Crosse,1999,60601,58818,1783,2.9
55,65,Lafayette,1999,7600,7328,272,3.6
55,67,Langlade,1999,9335,8852,483,5.2
55,69,Lincoln,1999,14652,13980,672,4.6
55,71,Manitowoc,1999,44746,43146,1600,3.6
55,73,Marathon,1999,73585,71407,2178,3.0
55,75,Marinette,1999,21270,20277,993,4.7
55,77,Marquette,1999,7030,6662,368,5.2
55,78,Menominee,1999,2556,2358,198,7.7
55,79,Milwaukee,1999,480589,462043,18546,3.9
55,81,Monroe,1999,19722,18950,772,3.9
55,83,Oconto,1999,15858,15154,704,4.4
55,85,Oneida,1999,20504,19607,897,4.4
55,87,Outagamie,1999,102134,99562,2572,2.5
55,89,Ozaukee,1999,49151,48216,935,1.9
55,91,Pepin,1999,3248,3118,130,4.0
55,93,Pierce,1999,20757,20236,521,2.5
55,95,Polk,1999,22127,21318,809,3.7
55,97,Portage,1999,37086,35862,1224,3.3
55,99,Price,1999,7140,6651,489,6.8
55,101,Racine,1999,93102,88967,4135,4.4
55,103,Richland,1999,8392,8100,292,3.5
55,105,Rock,1999,79542,76332,3210,4.0
55,107,Rusk,1999,7170,6833,337,4.7
55,109,St. Croix,1999,33766,32977,789,2.3
55,111,Sauk,1999,34444,33501,943,2.7
55,113,Sawyer,1999,9355,8870,485,5.2
55,115,Shawano,1999,20349,19628,721,3.5
55,117,Sheboygan,1999,62276,61021,1255,2.0
55,119,Taylor,1999,10353,9950,403,3.9
55,121,Trempealeau,1999,14197,13664,533,3.8
55,123,Vernon,1999,13732,13186,546,4.0
55,125,Vilas,1999,11269,10785,484,4.3
55,127,Walworth,1999,53179,51896,1283,2.4
55,129,Washburn,1999,7858,7414,444,5.7
55,131,Washington,1999,68671,67125,1546,2.3
55,133,Waukesha,1999,216447,211907,4540,2.1
55,135,Waupaca,1999,26195,25329,866,3.3
55,137,Waushara,1999,10400,9930,470,4.5
55,139,Winnebago,1999,95933,93763,2170,2.3
55,141,Wood,1999,39949,38494,1455,3.6
56,1,Albany,1999,18387,18058,329,1.8
56,3,Big Horn,1999,5818,5447,371,6.4
56,5,Campbell,1999,19763,18768,995,5.0
56,7,Carbon,1999,8440,8008,432,5.1
56,9,Converse,1999,6696,6359,337,5.0
56,11,Crook,1999,3081,2930,151,4.9
56,13,Fremont,1999,18102,16755,1347,7.4
56,15,Goshen,1999,6561,6322,239,3.6
56,17,Hot Springs,1999,2448,2325,123,5.0
56,19,Johnson,1999,3932,3799,133,3.4
56,21,Laramie,1999,40212,38839,1373,3.4
56,23,Lincoln,1999,6654,6258,396,6.0
56,25,Natrona,1999,33962,32162,1800,5.3
56,27,Niobrara,1999,1335,1298,37,2.8
56,29,Park,1999,15458,14766,692,4.5
56,31,Platte,1999,4678,4475,203,4.3
56,33,Sheridan,1999,13779,13123,656,4.8
56,35,Sublette,1999,3161,3046,115,3.6
56,37,Sweetwater,1999,20755,19492,1263,6.1
56,39,Teton,1999,11712,11455,257,2.2
56,41,Uinta,1999,10575,9857,718,6.8
56,43,Washakie,1999,4913,4602,311,6.3
56,45,Weston,1999,3381,3200,181,5.4
72,1,Adjuntas Municipio,1999,5396,4510,886,16.4
72,3,Aguada Municipio,1999,13954,11517,2437,17.5
72,5,Aguadilla Municipio,1999,20088,16759,3329,16.6
72,7,Aguas Buenas Municipio,1999,9301,8340,961,10.3
72,9,Aibonito Municipio,1999,10018,9062,956,9.5
72,11,Anasco Municipio,1999,10735,8830,1905,17.7
72,13,Arecibo Municipio,1999,29934,25675,4259,14.2
72,15,Arroyo Municipio,1999,5173,4316,857,16.6
72,17,Barceloneta Municipio,1999,8354,7064,1290,15.4
72,19,Barranquitas Municipio,1999,6118,5249,869,14.2
72,21,Bayamon Municipio,1999,88228,81917,6311,7.2
72,23,Cabo Rojo Municipio,1999,16619,14447,2172,13.1
72,25,Caguas Municipio,1999,60234,54206,6028,10.0
72,27,Camuy Municipio,1999,9652,8341,1311,13.6
72,29,Canovanas Municipio,1999,17284,15287,1997,11.6
72,31,Carolina Municipio,1999,80984,74136,6848,8.5
72,33,Catano Municipio,1999,9891,9065,826,8.4
72,35,Cayey Municipio,1999,17301,15066,2235,12.9
72,37,Ceiba Municipio,1999,5732,5102,630,11.0
72,39,Ciales Municipio,1999,4412,3611,801,18.2
72,41,Cidra Municipio,1999,16699,15106,1593,9.5
72,43,Coamo Municipio,1999,9023,7647,1376,15.2
72,45,Comerio Municipio,1999,5430,4844,586,10.8
72,47,Corozal Municipio,1999,9935,9056,879,8.8
72,49,Culebra Municipio,1999,784,747,37,4.7
72,51,Dorado Municipio,1999,11264,10293,971,8.6
72,53,Fajardo Municipio,1999,13538,11512,2026,15.0
72,54,Florida Municipio,1999,2928,2308,620,21.2
72,55,Guanica Municipio,1999,6207,4981,1226,19.8
72,57,Guayama Municipio,1999,11098,9213,1885,17.0
72,59,Guayanilla Municipio,1999,7957,6719,1238,15.6
72,61,Guaynabo Municipio,1999,41849,39790,2059,4.9
72,63,Gurabo Municipio,1999,12131,10803,1328,10.9
72,65,Hatillo Municipio,1999,11318,9849,1469,13.0
72,67,Hormigueros Municipio,1999,6922,5988,934,13.5
72,69,Humacao Municipio,1999,20613,17615,2998,14.5
72,71,Isabela Municipio,1999,12694,10271,2423,19.1
72,73,Jayuya Municipio,1999,4268,3758,510,11.9
72,75,Juana Diaz Municipio,1999,14069,11851,2218,15.8
72,77,Juncos Municipio,1999,12917,11467,1450,11.2
72,79,Lajas Municipio,1999,8897,7578,1319,14.8
72,81,Lares Municipio,1999,9106,7777,1329,14.6
72,83,Las Marias Municipio,1999,3080,2020,1060,34.4
72,85,Las Piedras Municipio,1999,10624,9091,1533,14.4
72,87,Loiza Municipio,1999,8380,7341,1039,12.4
72,89,Luquillo Municipio,1999,6495,5420,1075,16.6
72,91,Manati Municipio,1999,14005,11657,2348,16.8
72,93,Maricao Municipio,1999,2070,1759,311,15.0
72,95,Maunabo Municipio,1999,2692,2004,688,25.6
72,97,Mayaguez Municipio,1999,35167,29670,5497,15.6
72,99,Moca Municipio,1999,12156,9927,2229,18.3
72,101,Morovis Municipio,1999,9944,8700,1244,12.5
72,103,Naguabo Municipio,1999,7118,6135,983,13.8
72,105,Naranjito Municipio,1999,7038,6301,737,10.5
72,107,Orocovis Municipio,1999,5366,4626,740,13.8
72,109,Patillas Municipio,1999,5743,4718,1025,17.8
72,111,Penuelas Municipio,1999,8034,6341,1693,21.1
72,113,Ponce Municipio,1999,59070,51391,7679,13.0
72,115,Quebradillas Municipio,1999,7783,6735,1048,13.5
72,117,Rincon Municipio,1999,5641,4731,910,16.1
72,119,Rio Grande Municipio,1999,17681,15437,2244,12.7
72,121,Sabana Grande Municipio,1999,8387,7247,1140,13.6
72,123,Salinas Municipio,1999,7939,6551,1388,17.5
72,125,San German Municipio,1999,13442,11343,2099,15.6
72,127,San Juan Municipio,1999,164351,151566,12785,7.8
72,129,San Lorenzo Municipio,1999,13110,11127,1983,15.1
72,131,San Sebastian Municipio,1999,12475,9726,2749,22.0
72,133,Santa Isabel Municipio,1999,5652,4469,1183,20.9
72,135,Toa Alta Municipio,1999,20898,19449,1449,6.9
72,137,Toa Baja Municipio,1999,35474,32884,2590,7.3
72,139,Trujillo Alto Municipio,1999,30862,28785,2077,6.7
72,141,Utuado Municipio,1999,8418,7152,1266,15.0
72,143,Vega Alta Municipio,1999,11539,10554,985,8.5
72,145,Vega Baja Municipio,1999,19705,17046,2659,13.5
72,147,Vieques Municipio,1999,2662,2310,352,13.2
72,149,Villalba Municipio,1999,6143,5018,1125,18.3
72,151,Yabucoa Municipio,1999,12428,10158,2270,18.3
72,153,Yauco Municipio,1999,13706,11408,2298,16.8
